Silhouette	Art
Khalifa Haftar	1943 births, Living people, Libyan people, Generals
Minka Kelly	1980 births, Living people, American movie actors, American television actors, American voice actors, Models from Los Angeles, California, Actors from Chicago, Actors from Los Angeles, California, Actors from Albuquerque, New Mexico
Kempele	1867 establishments in Finland, Municipalities of Northern Ostrobothnia
United States National Economic Council	Executive branch of the United States government, Directors of the National Economic Council
Robert Rubin	1938 births, Living people, United States Secretaries of the Treasury, Directors of the National Economic Council, Jewish American politicians, Yale University alumni, Harvard University alumni, Businesspeople from New York City, Politicians from New York City, US Democratic Party politicians
Stephen Friedman	1937 births, Living people, Directors of the National Economic Council, Businesspeople from New York City, Politicians from New York City, US Republican Party politicians
Mickey Kantor	1939 births, Living people, United States Secretaries of Commerce, United States Trade Representatives, Jewish American politicians, Businesspeople from Tennessee, Politicians from Nashville, Tennessee, US Democratic Party politicians
John Albert Knebel	1936 births, Living people, United States Secretaries of Agriculture, Politicians from Tulsa, Oklahoma, US Republican Party politicians
Stratigraphic column	Geology
Norman R. Augustine	1935 births, Living people, United States Secretaries of the Army, American educators, Businesspeople from Denver, Colorado
Gordon R. England	1937 births, Living people, United States Secretaries of the Navy, Businesspeople from Baltimore, Maryland, Politicians from Baltimore, Maryland, US Republican Party politicians
Hansford T. Johnson	Living people, 1936 births, American military personnel of the Vietnam War, United States Secretaries of the Navy, People from South Carolina
Robert B. Pirie Jr.	1933 births, Living people, United States Secretaries of the Navy, Politicians from San Diego, California, Military people from California
Thomas C. Reed	1934 births, Living people, United States Secretaries of the Air Force, Politicians from New York City, US Republican Party politicians
Shristi Shrestha	1989 births, Nepalese beauty pageant winners, Miss Nepal winners, Nepalese actors, Living people, Nepalese models
Edward C. Aldridge Jr.	United States Secretaries of the Air Force, 1938 births, Living people, Politicians from Houston, Texas, US Republican Party politicians
Gordon R. Sullivan	1937 births, Living people, United States Secretaries of the Army, People from Boston, Massachusetts, American military personnel of the Vietnam War
Merrill McPeak	1936 births, Living people, United States Secretaries of the Air Force, American military personnel of the Vietnam War, People from Oregon, Military people from California
Donald Rice	1939 births, Living people, Businesspeople from California, United States Secretaries of the Air Force, People from Santa Monica, California, Businesspeople from Maryland
James G. Roche	1939 births, Living people, United States Secretaries of the Air Force, People from Elgin, Illinois, Politicians from New York City, Politicians from Illinois, US Democratic Party politicians
Lawrence J. Delaney	Living people, 1935 births, Engineers from New York, Businesspeople from New York, Scientists from New York, United States Secretaries of the Air Force
A Regular Epic Final Battle	2017 television episodes
Potomac, Maryland	Census-designated places in Maryland, Montgomery County, Maryland
Millennium University	2004 establishments in Asia, Colleges and universities in Bangladesh, Buildings and structures in Bangladesh, Dhaka
Chen Meng	1994 births, Living people, Chinese table tennis players
William Wilfred Campbell	1860 births, 1918 deaths, Writers from Ontario, Canadian poets
Nischal Basnet	1980 births, Living people, Nepalese movie actors, People from Kathmandu, Nepalese movie directors, Nepalese movie producers, Nepalese singers
Van Horne House	National Register of Historic Places, Jersey City, New Jersey, Houses in the United States, Buildings and structures in New Jersey
Jean-Claude Servan-Schreiber	1918 births, 2018 deaths, French centenarians, French journalists, Politicians from Paris, Writers from Paris
Brij Bhushan Kabra	1937 births, 2018 deaths, Deaths from multiple organ failure, Indian musicians, Guitarists
Patrick F. McManus	1933 births, 2018 deaths, American columnists, Writers from Idaho
Antonio Salandra	Leaders of political parties, Prime Ministers of Italy, 1853 births, 1931 deaths
Scooter Libby	1950 births, Living people, American lawyers, American criminals, Businesspeople from New Haven, Connecticut, Writers from New Haven, Connecticut, Politicians from New Haven, Connecticut, US Republican Party politicians
Paddington 2	2017 comedy movies, 2010s sequel movies, British comedy movies, Movies based on books
James Beevers	1979 births, British Olympians, Living people, Fencers
Hugh Bonneville	1963 births, Living people, Actors from London, British movie actors, British stage actors, British television actors, British voice actors, People from Paddington
Ishani Shrestha	1991 births, Living people, Nepalese beauty pageant winners, Miss Nepal winners, Nepalese models, People from Kathmandu
Ben Whishaw	1980 births, Living people, Actors who played Q, BAFTA Award winning actors, English LGBT people, English movie actors, English stage actors, English television actors, English voice actors, Gay men, LGBT actors, People from Bedfordshire
Delma	Companies of Switzerland, 20th century establishments in Switzerland, 1924 establishments in Europe, Canton of Bern
Subin Limbu	1991 births, Living people, Nepalese beauty pageant winners, Nepalese models, Miss Nepal winners
Evana Manandhar	1991 births, Nepalese beauty pageant winners, Living people, Nepalese models, People from Kathmandu, Miss Nepal winners
Moyar River	Rivers of Tamil Nadu
List of rivers of Tamil Nadu	Rivers of Tamil Nadu
Amaravati River	Rivers of Tamil Nadu
Arjuna River	Rivers of Tamil Nadu
Arani River	Rivers of Tamil Nadu
Zoran Krasić	1956 births, 2018 deaths, Serbian politicians, Civil servants
Warren, Connecticut	Towns in Connecticut
Angbu-ilgu	clocks
Prinsha Shrestha	1992 births, Living people, Beauty pageant winners, People from Kathmandu, Nepalese models
Kringresande register	Sweden
Bhavani River	Rivers of Tamil Nadu
Sonie Rajbhandari	Nepalese beauty pageant winners, People from Kathmandu, Nepalese models, Living people
Bambar River	Rivers of Tamil Nadu
Uppar River	Rivers of Tamil Nadu
Upper Gundar River	Rivers of Tamil Nadu
Valavaikkal River	Rivers of Tamil Nadu
Vennaaru River	Rivers of Tamil Nadu
Vettar River	Rivers of Tamil Nadu
Veera Chozhan River	Rivers of Tamil Nadu
Vashista River	Rivers of Tamil Nadu
List of rivers of Puducherry	Rivers of Puducherry, Lists of rivers of Asia
Nandalar River	Rivers of Tamil Nadu, Rivers of Puducherry
Irena Santor	1934 births, Polish singers, Polish actors, Living people
Hotarubi no Mori e	2011 romance movies, 2002 manga, 2011 manga, 2011 anime, Japanese-language movies, Japanese movies
Joseph A. Bracken	1930 births, Living people, American theologians, American Roman Catholics, Writers from Chicago
Charles Curran	1934 births, Living people, American theologians, American educators, American Roman Catholics, Writers from New York, People from Rochester, New York
Roger T. Forster	1933 births, Living people, Alumni of the University of Cambridge, Christian theologians, English Protestants, English theologians, Evangelicals, Writers from London
John Mbiti	1931 births, 2019 deaths, 20th century philosophers, Academics, Alumni of the University of Cambridge, Anglican priests, Christian theologians, Kenyan people, Translators
Jürgen Moltmann	1926 births, Living people, German theologians, German Protestants, People from Hamburg
Eugene H. Peterson	1932 births, 2018 deaths, Deaths from congestive heart failure, People with Alzheimer's disease, American Presbyterians, American poets, American educators, American theologians, Writers from Washington
John Shelby Spong	1931 births, 2021 deaths, American Christians, American theologians, American feminists, Writers from Charlotte, North Carolina, Writers from Newark, New Jersey, Deaths from stroke
Joy Laville	1923 births, 2018 deaths, Deaths from myocardial infarction, English artists, Mexican people
Isabella Biagini	1943 births, 2018 deaths, Deaths from stroke, Italian movie actors, Italian television actors, Italian stage actors, Actors from Rome
Jean-Claude Malgoire	1940 births, 2018 deaths, Deaths from stomach cancer, Cancer deaths in France, French conductors, French educators
Warfarin	Drugs, Blood
2018 bombing of Damascus and Homs	2018 in Asia, 2010s explosions in Asia, Attacks on buildings and structures in 2018, 21st century in Syria, April 2018 events, Damascus, Donald Trump, Explosions in 2018
Vestal Virgin	Roman mythology, Roman people
St. Mary's School	Schools in New Hampshire, 1886 establishments in the United States, 1880s establishments in New Hampshire, 1964 disestablishments, 1960s disestablishments in the United States, Disestablishments in New Hampshire
Upper Gilmanton	Cities in New Hampshire, 1727 establishments, 1720s establishments in the Thirteen Colonies, 1859 establishments in the United States, 19th-century establishments in New Hampshire, 1860s disestablishments in the United States, Disestablishments in New Hampshire
Halberstadt CL.II	World War I aircraft, 1917 establishments in Europe, 1910s establishments in Germany
Art Bell	1945 births, 2018 deaths, Deaths from COPD, American radio personalities, American military personnel of the Vietnam War, Libertarians, Businesspeople from North Carolina, Businesspeople from Nevada, Writers from North Carolina, Writers from Nevada
Vanjiar River	Rivers of Puducherry, Rivers of Tamil Nadu
Franciszek Pieczka	1928 births, Living people, Polish movie actors, Polish television actors, Polish stage actors
Puravadayanar River	Rivers of Puducherry, Rivers of Tamil Nadu
List of rivers of West Bengal	Rivers of West Bengal
Adi Ganga	Rivers of West Bengal
Ajay River	Rivers of Bihar, Rivers of Jharkhand, Rivers of West Bengal
Auranga River (Jharkhand)	Rivers of Jharkhand
Burhi Gandak River	Rivers of Bihar
Maggie De Block	1962 births, Living people, Government ministers of Belgium, Open Vlaamse Liberalen en Democraten politicians, People from Flemish Brabant, Women politicians
Lisbet Palme	1931 births, 2018 deaths, First Ladies, Swedish people, Swedish psychologist
Assassination of Olof Palme	1986 in Europe, 1980s in Sweden, Assassinations in Europe, February events, Unsolved murders
Xavier Trias	1946 births, Living people, Mayors of Barcelona
Canadian Rockies	Mountains of Canada
Amaro Pargo	1678 births, 1747 deaths, Pirates, People from the Canary Islands, Mysterious people
List of large temple tanks	Temple tanks in India
Haridra Nadhi	Temple tanks in India
Chandra Theertham (Karaikal)	Temple tanks in India
Stefano Zappalà	1941 births, 2018 deaths, Italian politicians, MEPs for Italy, Deaths from respiratory failure
Methoxyflurane	Analgesics
Paolo and Vittorio Taviani	1929 births, 1931 births, Living people, 2018 deaths, Sibling duos, Italian movie directors, Italian screenwriters, Cardiovascular disease deaths in Italy, People from Tuscany
Jon Michelet	1944 births, 2018 deaths, Deaths from kidney cancer, Norwegian writers, Novelists, Norwegian journalists
Mental capacity	Medicine, Health, Law
Judy Kennedy	1944 births, 2018 deaths, Deaths from ovarian cancer, Cancer deaths in New York, American mayors, Politicians from Idaho, Politicians from Oregon, Politicians from New York, Writers from Idaho, Writers from New York, Writers from Oregon, Businesspeople from New York, Businesspeople from Idaho, Businesspeople from Oregon, People from Newburgh, New York, US Democratic Party politicians
Newburgh, New York	Cities in New York
Spencertown, New York	Hamlets in New York
Colony of Aden	Yemen, 1937 establishments in Asia, 1937 establishments in the United Kingdom, 1963 disestablishments in the United Kingdom, 1960s disestablishments in Asia
Alfred M. Gray Jr.	1928 births, Living people, American military personnel of the Korean War, American military personnel of the Vietnam War, People from New Jersey
Baker City, Oregon	Cities in Oregon, County seats in Oregon
Ivan Mauger	1933 births, 2018 deaths, New Zealand sportspeople
Big Timber, Montana	Cities in Montana, County seats in Montana
Bourbonnais, Illinois	Villages in Illinois
Dana Rohrabacher	1947 births, Living people, United States representatives from California, Writers from California, American conservatives, US Republican Party politicians
Randy Neugebauer	1949 births, Living people, United States representatives from Texas, American conservatives, Politicians from St. Louis, Missouri, US Republican Party politicians
John Oliver	Emmy Award winners, 1977 births, Living people, English comedians, English television writers, English television producers, English movie actors, English television actors, English voice actors, English television presenters, English television personalities, Political commentators, Actors from Birmingham, Writers from Birmingham
Chris Rea	1951 births, Living people, English singer-songwriters, English rock guitarists, English rock singers, English pop singers, English pianists, English pop musicians, People with cancer, Musicians from Yorkshire, Writers from Yorkshire, Cancer survivors
Carnavalito	Festivals, Colombian culture, Masterpieces of the Oral and Intangible Heritage of Humanity, 1966 establishments in South America, 20th-century establishments in Colombia
Arrival of the Castañeda Family	Festivals, Colombian culture, Masterpieces of the Oral and Intangible Heritage of Humanity, 1929 establishments, 1920s establishments in Colombia
Whites' Day	Festivals, Colombian culture, Masterpieces of the Oral and Intangible Heritage of Humanity, 1912 establishments, 1910s establishments in Colombia
Great Parade	Festivals, Colombian culture, Masterpieces of the Oral and Intangible Heritage of Humanity, 1926 establishments, 1920s establishments in Colombia
Karen Karapetyan	Prime Ministers of Armenia, 1964 births, Living people
Violette Szabo	1921 births, 1945 deaths, People from Paris, George Cross holders, Victims of Nazism, British people, Spies
Upper Arlington, Ohio	Cities in Ohio
Charleston (dance)	Dance types
Divi filius	Religious terminology, Latin words and phrases
Ankita Lokhande	1984 births, Living people, Indian television actors, Actors from Mumbai, Indian movie actors
Hal Greer	1936 births, 2018 deaths, African-American basketball players, Philadelphia 76ers players, Sportspeople from West Virginia, People from Huntington, West Virginia, National Basketball Association players with retired numbers, American basketball players
Huntington, West Virginia	Cities in West Virginia, County seats in West Virginia
Gerald Nachman	1938 births, 2018 deaths, Deaths from frontotemporal dementia, Disease-related deaths in San Francisco, American television writers, American journalists, American columnists, American novelists, American critics, Writers from San Francisco, Writers from Oakland, California
Michael Halliday	1925 births, 2018 deaths, Linguists, Australian educators, Writers from Leeds
Jacques Tixier	1925 births, 2018 deaths, French educators, French historians, French writers, French archaeologists
Waqar Ahmad Shah	1943 births, 2018 deaths, Deaths from bladder cancer, Cancer deaths in India, Politicians from Uttar Pradesh, Civil servants
Harry Anderson	1952 births, 2018 deaths, Deaths from influenza, Deaths from stroke, Cardiovascular disease deaths in North Carolina, Infectious disease deaths in the United States, American movie actors, American television actors, American voice actors, American television personalities, American magicians, American comedians, Actors from Rhode Island, Actors from New Orleans, Louisiana, Actors from Oregon, Actors from North Carolina, People from Ashland, Oregon, People from Asheville, North Carolina, People from Newport, Rhode Island
Jaime Thorne León	1943 births, 2018 deaths, Deaths from brain cancer, Peruvian politicians, Civil servants, Peruvian lawyers, People from Lima
Nyack, New York	Villages in New York
Zee TV	Indian television, Television channels
Antonio Bernocchi	1859 births, 1930 deaths, Italian businesspeople, Italian philanthropists
Karl-Heinz von Hassel	1939 births, 2016 deaths, German movie actors, Actors from Hamburg, Disease-related deaths in Germany
Balod district	Districts of India, Chhattisgarh
Nayatol	Villages in Bihar
Buruli ulcer	Infectious diseases
Deborah Coleman	1956 births, 2018 deaths, Deaths from bronchopneumonia, American blues musicians, American guitarists, American singer-songwriters, Musicians from Virginia, Singers from Virginia
Dona Ivone Lara	1921 births, 2018 deaths, Deaths from cardiac arrest, Brazilian singers, Composers, People from Rio de Janeiro
Big Tom	1936 births, 2018 deaths, Irish singers, Irish guitarists, Saxophonists, Country singers, Country musicians
Carl Kasell	1934 births, 2018 deaths, Deaths from Alzheimer's disease, Disease-related deaths in Maryland, American journalists, American radio personalities, American game show hosts, American autobiographers, Writers from North Carolina
SS Vita Nova	Italian football clubs, 1910 establishments in Italy, 1926 disestablishments, 1943 establishments in Europe, 1940s establishments in Italy, 1950 disestablishments, 1920s disestablishments in Italy, 1950s disestablishments in Italy
SS Pro Ponte	Italian football clubs, 1926 establishments in Italy, 1943 disestablishments in Europe, 1940s disestablishments in Italy
US Ponte San Pietro	Italian football clubs, 1950 establishments in Europe, 1950s establishments in Italy, 2007 disestablishments in Europe, 2000s disestablishments in Italy
US Sportiva Ponte San Pietro Isola	Italian football clubs, 2007 establishments in Europe, 2000s establishments in Italy
Katmai National Park	National parks in the United States, IUCN Category VI
Yushan (mountain)	Mountains of Asia, Geography of Taiwan
Etsuko Ichihara	1936 births, 2019 deaths, Deaths from heart failure, Japanese movie actors, Japanese television actors, Japanese voice actors, Japanese stage actors, People from Chiba Prefecture
Henri Landwirth	1927 births, 2018 deaths, Deaths from mesothelioma, Cancer deaths in Florida, Naturalized citizens of the United States, American philanthropists, Holocaust survivors, People from Orlando, Florida, Businesspeople from Florida, People from Antwerp
Lía Bermúdez	1930 births, Living people, Sculptors, People from Caracas
2018–19 Premier League	2018 in association football, 2019 in association football, Premier League
2018 UEFA Champions League Final	2018 in association football, UEFA Champions League
Olympique Antibes	French football clubs, 1912 establishments in France, 1933 disestablishments in Europe, 1930s disestablishments in France
R.C. Paris	French football clubs, 1932 establishments in Europe, 1930s establishments in France, 1966 disestablishments, 1960s disestablishments in Europe, 1983 establishments in Europe, 1980s establishments in France, 1987 disestablishments in Europe, 1980s disestablishments in France, 1999 establishments in France, 2005 disestablishments in Europe, 2000s disestablishments in France
Special Operations Executive	Organisations based in the United Kingdom
Boreads	Greek mythology, Winds
2018 Pacific hurricane season	Pacific hurricane seasons
Berkeley County, West Virginia	West Virginia counties, 1772 establishments in the Thirteen Colonies
Robert Holmes (American football)	1945 births, 2018 deaths, Deaths from eye neoplasm, Cancer deaths in Canada, Kansas City Chiefs players, Tennessee Titans players, San Diego Chargers players, Sportspeople from Texas, People from Huntsville, Texas
Huntsville, Texas	Cities in Texas, County seats in Texas
Igor Chislenko	1939 births, 1994 deaths, Soviet sportspeople, Sportspeople from Moscow, Russian footballers, 1962 FIFA World Cup players, 1966 FIFA World Cup players
Frank Drowota	1938 births, 2018 deaths, American lawyers, Politicians from Kentucky, Politicians from Nashville, Tennessee
Paul Singer (economist)	2018 deaths, 1932 births, Austrian educators, Economists, Brazilian educators, People from São Paulo
Vel Phillips	1923 births, 2018 deaths, American lawyers, American civil rights activists, Politicians from Milwaukee, Wisconsin, US Democratic Party politicians
Grashof number	Numbers, Fluid mechanics, Thermodynamics, Heat transfer
Pectoralis major muscle	Muscles
Seigneur	1789 disestablishments, 18th century in France, History of France, Society, Nobility
Fire blanket	Firefighting, Home
Control Machete	Musical groups established in 1996, 1990s Mexican music groups, 2000s Mexican music groups, Mexican rap music groups, Musical groups disestablished in 2004, 1996 establishments in North America, 1990s establishments in Mexico, 2000s disestablishments in Mexico
Intel Core i9	Computer processors
Kinto Sol	1990s Mexican music groups, 2000s Mexican music groups, Mexican rap music groups, 2010s music groups, Musical groups established in 1999, Mexican musical groups, 1990s establishments in Mexico
Cartel de Santa	Musical groups established in 1996, 1990s Mexican music groups, 2000s Mexican music groups, Mexican rap music groups, 1996 establishments in North America, 1990s establishments in Mexico
Dharius	Mexican rap musicians, 1984 births
Cordyceps	Fungi, Parasitoids
Brookfield, Connecticut	Towns in Connecticut
Lynn Stout	1957 births, 2018 deaths, American educators, Cancer deaths in California, Writers from California
Platonic crystal	Physics
T. V. R. Shenoy	1941 births, 2018 deaths, Indian writers, Indian journalists, Columnists, People from Kerala
Henk Schouten	1932 births, 2018 deaths, Cancer deaths in the Netherlands, Deaths from pancreatic cancer, Dutch footballers, Sportspeople from Rotterdam
Cornelius Jakobs	1924 births, 2018 deaths, Religious leaders, People from Tallinn
Call for the Dead	British novels
A Murder of Quality	British novels, 1962 books
The Spy Who Came in from the Cold	British novels
Luis Montes Mieza	1949 births, 2018 deaths, Deaths from myocardial infarction, Cardiovascular disease deaths in Spain, Spanish people, Activists, Spanish physicians
Walter Moody	1935 births, 2018 deaths, Executed American people, American murderers, People from Georgia (U.S. state)
Piccolo trumpet	Musical instruments
Jim Halpert	The Office (U.S. TV series) characters
Alex Janvier	1935 births, Living people, Artists
Bled	Towns in Slovenia
Robert L. Butler	1927 births, 2019 deaths, American mayors, American lawyers, Politicians from Illinois, US Republican Party politicians
Luisa Pastor Lillo	1948 births, 2018 deaths, Cancer deaths in Spain, Spanish politicians, Mayors
Jeanne Wilson	1926 births, 2018 deaths, American swimmers, American Olympians, Sportspeople from Chicago
Roy Bentley	1924 births, 2018 deaths, English footballers, English football managers, People from Bristol
Pedro Erquicia	1943 births, 2018 deaths, Spanish journalists, Spanish television personalities, Television presenters, Television producers
Rajinder Sachar	1923 births, 2018 deaths, Deaths from pneumonia, Disease-related deaths in India, Indian writers, Indian politicians, Pakistani politicians, Indian lawyers, Indian judges, Pakistani judges, Political activists, Political writers, People from New Delhi
Jaroslav Seifert	1901 births, 1986 deaths, Czech poets, Journalists, Writers from Prague
Pavel Šrut	1940 births, 2018 deaths, Deaths from myocardial infarction, Czech poets, Czech educators, Children's writers, Novelists, Translators, Writers from Prague
Shane Yarran	1989 births, 2018 deaths, Suicides in Australia, Australian rules footballers, Sportspeople from Western Australia
No Tears Left to Cry	2018 songs, Dance-pop songs, Disco songs, R&B songs, Ariana Grande songs
Jörg Schüttauf	1961 births, Living people, German movie actors, German television actors, German stage actors
Jesper Christensen	1948 births, Living people, Actors who played in James Bond movies, Danish movie actors, Danish television actors, Danish stage actors, People from Copenhagen
Udo Kier	1944 births, Living people, German movie actors, German television actors, German stage actors, German voice actors, People from Cologne
Lafcadio Hearn	1850 births, 1904 deaths, Japanese writers, Waseda University faculty
Kevin Austin	1973 births, 2018 deaths, Deaths from pancreatic cancer, English footballers, Trinidad and Tobago footballers, Sportspeople from London
Gabriel Byrne	Golden Globe Award winning actors, 1950 births, Living people, Irish movie actors, Irish television actors, Irish stage actors, Irish voice actors, Irish movie directors, Irish movie producers, Irish screenwriters, Actors from Dublin, Writers from Dublin
Reg Smythe	1917 births, 1998 deaths, Deaths from lung cancer, Cartoonists, British artists, British writers
Pancreatitis	Inflammation
Democratic Governors Association	United States Democratic Party, 1983 establishments in the United States, Political organizations based in Washington, D.C., 1980s establishments in Washington, D.C.
Hayatabad	Peshawar
Mitzi Hoag	1932 births, 2019 deaths, American movie actors, American television actors, American stage actors, American voice actors, Actors from New York City, Actors from Illinois
Michael Gross	Drama Desk Award winners, 1947 births, Living people, Yale University alumni, American video game actors, American movie actors, American television actors, American stage actors, American voice actors, Actors from Chicago
Cation	Physical chemistry
Westwood Memorial Park Cemetery	Cemeteries in the United States, Los Angeles
Marathon Media Group	Television, Companies of France
Procoptodon	Macropods, Extinct species
Microatoll	Ecology
Fang Bo	1992 births, Living people, Chinese table tennis players
Chiyo Miyako	1901 births, Japanese supercentenarians, 2018 deaths, Deaths from natural causes
Bob Braden	1934 births, 2018 deaths, Deaths from myelodysplastic syndrome, American computer scientists, American educators
Constantine II of Greece	1940 births, Living people, Olympic gold medalists, Kings of Greece
Virginia Dighero	1891 births, 2005 deaths, Supercentenarians, Italian people, Deaths from cardiovascular disease
George I of Greece	1845 births, 1913 deaths, Assassinated people, Deaths by firearm, Generals, People from Copenhagen, Kings of Greece
Monroe, Ohio	Cities in Ohio
Ricardo Lagos	1936 births, Living people, Presidents of Chile, Chilean lawyers, Activists, Chilean economists, Chilean educators
Eduardo Frei Ruiz-Tagle	1941 births, Living people, Presidents of Chile, Chilean engineers, Presidents of the Senate of Chile
With Chronos’ Permit	1995 books, Fantasy books, Novels
Rekawka	Festivals in Europe, Kraków
Guantanamo Bay detention camp	2002 establishments in North America, Prisoners of war
Hedylidae	Butterflies
Hon-Kawagoe Station	Railway stations in Saitama Prefecture
Kawagoe Station	Railway stations in Saitama Prefecture
Zubby Michael	1985 births, Nigerian actors, Movie producers, Movie directors
Fukaya Station	Railway stations in Saitama Prefecture
Kwame Raoul	1964 births, Living people, American lawyers, DePaul University alumni, Politicians from Chicago, US Democratic Party politicians
Al Swift	Emmy Award winners, 1935 births, 2018 deaths, Deaths from pulmonary fibrosis, Disease-related deaths in Virginia, American radio personalities, United States representatives from Washington, People from Tacoma, Washington, US Democratic Party politicians
Firmin Le Bourhis	1950 births, 2018 deaths, Deaths from myocardial infarction, Cardiovascular disease deaths in France, French novelists
Nelson Pereira dos Santos	1928 births, 2018 deaths, Deaths from liver cancer, Deaths from multiple organ failure, Brazilian movie directors, People from São Paulo
Ted Koppel	Emmy Award winners, 1940 births, British television presenters, British journalists, Naturalized citizens of the United States, American television presenters, American journalists, Writers from Lancashire
Harvey Levin	1950 births, Living people, Actors from Los Angeles, California, American lawyers, American movie actors, American television actors, American television presenters, American television producers, Businesspeople from Los Angeles, California, Fox News people, Gay Jews, Jewish American actors, Jewish American writers, Jewish businesspeople, Jewish lawyers, LGBT actors, LGBT lawyers, LGBT people from Los Angeles, California, LGBT writers, Television personalities from Los Angeles, California, Writers from Los Angeles, California
James Rothman	1950 births, Living people, American biologists, American chemists, Scientists from Massachusetts, People from Haverhill, Massachusetts
Randy Schekman	1948 births, Living people, American biologists, Scientists from Minnesota, People from Saint Paul, Minnesota
Edvard Moser	1962 births, Living people, Norwegian scientists, Neuroscientists, Physiologists
Satoshi Ōmura	1935 births, Living people, Japanese biologists, Japanese chemists, University of Tokyo alumni
Jeffrey C. Hall	1945 births, Living people, American biologists, American geneticists, Scientists from New York City
Michael Rosbash	1944 births, Living people, American biologists, American geneticists, American Nobel Prize winners, Jewish American academics, Jewish American scientists, Jewish Nobel Prize winners, Scientists from Kansas City, Missouri
Michael W. Young	1949 births, Living people, American biologists, American geneticists, Scientists from Florida, Writers from Miami, Florida
Graceland Cemetery	Cemeteries in Chicago, Landmarks in Chicago, 1860 establishments in the United States, 1860s establishments in Illinois
Rosehill Cemetery	Cemeteries in Chicago, 1864 establishments in the United States, 1860s establishments in Illinois
Westlawn Cemetery	Cemeteries in the United States, 1937 establishments in the United States, 1930s establishments in Illinois
Oak Woods Cemetery	Cemeteries in Chicago, 1853 establishments in the United States, 1850s establishments in Illinois
Mircea Eliade	1907 births, 1986 deaths, Burials at Oak Woods Cemetery, Deaths from stroke, Cardiovascular disease deaths in Chicago, Romanian writers, Romanian historians, Critics, Essayists, Novelists, Philosophers, People from Bucharest
John G. Shedd	1850 births, 1926 deaths, Deaths from aortic aneurysm, Cardiovascular disease deaths in Chicago, Burials at Oak Woods Cemetery, American philosophers, Businesspeople from Chicago, Businesspeople from New Hampshire
Vandiyur Mariamman Teppakulam	Temple tanks in India
Mahamaham tank, Kumbakonam	Temple tanks in India
Wu Yang	1992 births, Living people, Sportswomen, Chinese table tennis players
Global cooling	Climate change
Tachikawa Station	Railway stations in Tokyo
Nissan Leaf	Nissan automobiles, Electric vehicles, 2010s automobiles
Prince Louis of Cambridge	2018 births, Living people, House of Windsor, Royalty from London
Satyameva Jayati	2018 Indian television series debuts
Armen Sarkissian	1952 births, Living people, Presidents of Armenia, Prime Ministers of Armenia, Ambassadors to the United Kingdom, Current national leaders
Dave Nelson	1944 births, 2018 deaths, Deaths from liver cancer, African-American baseball players, American television presenters, Baseball coaches, Chicago White Sox players, Cleveland Indians players, Texas Rangers players, Kansas City Royals players, Sportspeople from Oklahoma, People from Lawton, Oklahoma
Nino Khurtsidze	1975 births, 2018 deaths, Deaths from cancer, Sportspeople from Georgia (country), Chess players
3 (Britney Spears song)	Britney Spears songs, Dance-pop songs, Pop songs, 2009 songs
Aloadae	Greek legendary creatures
Béla Magyari	1949 births, 2018 deaths, Military people, Hungarian engineers, People from Budapest
Pamela Gidley	1965 births, 2018 deaths, American movie actors, American television actors, American voice actors, American video game actors, Models from Massachusetts, Actors from Massachusetts
Inupiat language	Alaska
2018 Toronto van attack	2018 in North America, 2010s in Toronto, April 2018 events, Mass murder in 2018, Mass murder in North America, Massacres, Murder in Canada
Seemarekha	Indian television series, 2017 Indian television series debuts
Bob Dorough	1923 births, 2018 deaths, Deaths from prostate cancer, Cancer deaths in Pennsylvania, American pianists, American singer-songwriters, American jazz musicians, American composers, American record producers, Musicians from Arkansas, Writers from Arkansas, Singers from Arkansas
Kader Khan	1937 births, 2018 deaths, Deaths from progressive supranuclear palsy, Disease-related deaths in Canada, Indian comedians, Indian actors, Indian writers, Indian movie directors, Afghan writers, Canadian movie actors, Canadian television actors, Canadian voice actors, Canadian screenwriters, Canadian movie directors, Canadian comedians, People from Kabul
Port scanner	Computer networking, Software, Computer security
Caesarea	Towns in Asia, Settlements in Israel
Andre Wisdom	1993 births, English footballers, Liverpool F.C. players, FC Red Bull Salzburg players, People from Leeds, Living people, Premier League players
Coprolite	Paleontology
Joo Se-hyuk	1980 births, Living people, South Korean table tennis players, Medalists at the 2012 Summer Olympics, Competitors at the 2016 Summer Olympics, Competitors at the 2012 Summer Olympics
Gold Marilyn Monroe (Andy Warhol)	Pages created with the Article Wizard from 2018
Ankylopollexia	Dinosaurs, Ornithischia
Bayannurosaurus	Ornithischia, Fossil taxa described in 2018
Military Occupational Specialty	Military of the United States
Hoyt Patrick Taylor Jr.	1924 births, 2018 deaths, American military personnel of the Korean War, American military personnel of World War II, Lieutenant Governors of North Carolina, US Democratic Party politicians, American lawyers
Saat Bhai Champa	2017 Indian television series debuts
Haddon Donald	1917 births, 2018 deaths, New Zealand businesspeople, Centenarians, Military personnel of World War II, Politicians from North Island
Evan Jenkins	1960 births, Living people, American judges, University of Florida alumni, United States representatives from West Virginia, State legislators of the United States, US Democratic Party politicians, US Republican Party politicians, American Presbyterians
King Edward Medical University	1860 establishments in Asia, Medical education, Colleges and universities in Pakistan, Lahore, 1860s establishments in Pakistan
University of Health Sciences	Medical education, Colleges and universities in Pakistan, 2002 establishments in Asia, Lahore, 2000s establishments in Pakistan
College of Physicians and Surgeons Pakistan	Medical education, Colleges and universities in Pakistan, Lahore
Dinu C. Giurescu	1927 births, 2018 deaths, Deaths from myocardial infarction, Romanian politicians, Romanian historians
Paul Gray (songwriter)	1963 births, 2018 deaths, Deaths from multiple myeloma, Cancer deaths in Australia, Australian singer-songwriters, Australian pianists, Record producers
Hariton Pushwagner	1940 births, 2018 deaths, Deaths from lung cancer, Artists, People from Oslo
Victor J. Kemper	Emmy Award winners, 1927 births, Living people, American cinematographers, People from Newark, New Jersey
Stan Dragoti	1932 births, 2018 deaths, Deaths from pneumonia, Disease-related deaths in Los Angeles, Movie directors from New York City
List of largest Hindu temples	Hindu temples
Libido	Psychology, Sexuality
Kumbakonam	Thanjavur District, Towns in India
Papanasam Taluk	Taluks of Thanjavur district
List of cities in Tamil Nadu by population	Tamil Nadu
Boston crab	Professional wrestling moves
Mamluk dynasty (Delhi)	Mamluk dynasty (Delhi)
Lee Sang-su	1990 births, Living people, South Korean table tennis players
Battle of Stoney Creek	1813, Battles involving the United Kingdom, Battles involving the United States, 19th century in Canada, June events
Leaf miner	Insects, Parasitism, Plant tissues
Gul Circle MRT station	Mass Rapid Transit (Singapore) stations
Iskandar Puteri	Cities in Malaysia
Producer gas	Fuel
Rajendra Prasad	Presidents of India, People from Bihar
List of presidents of India	Presidents of India, Lists of politicians, Lists of Indian people
Al-Nusra Front	Establishments in Syria, 2012 establishments in Asia
Rajapalaiyam	Virudhunagar District
Neyveli	Cuddalore district
South Canara District	Districts of Madras Presidency
Beary language	Languages of India
National Film Award for Best Feature Film in Tamil	Cinema of India
Joker (2016 movie)	Tamil-language movies
Dubreuillosaurus	Megalosauridae, Jurassic dinosaurs
Woh Apna Sa (TV series)	2017 Indian television series debuts, Hindi-language television series
Condorraptor	Megalosauridae, Jurassic dinosaurs
Marshosaurus	Theropods
Hans-Reinhard Koch	1929 births, 2018 deaths, Deaths from cerebral hemorrhage, Cardiovascular disease deaths in Germany, German Roman Catholics, Roman Catholic bishops, People from Thuringia
Piatnitzkysaurus	Jurassic dinosaurs
Shuhrat Abbosov	1931 births, 2018 deaths, Uzbekistani people, Screenwriters, Movie directors, Movie producers, Movie actors
Palaeoscincus	Ankylosauria
Philibert Randriambololona	1927 births, 2018 deaths, Malagasy people, Roman Catholic archbishops
Thespesius	Ornithopods
Niederschönenfeld	Donau-Ries
Bob Pickens	1943 births, 2018 deaths, Chicago Bears players, American Olympians, Sportspeople from Chicago
Huguette Tourangeau	1940 births, 2018 deaths, Canadian singers, Sopranos, People from Montreal
Leland B. Yeager	1924 births, 2018 deaths, American economists, American educators, Scientists from Illinois, Writers from Illinois, People from Oak Park, Illinois
Jerry Sandusky	1944 births, Living people, American autobiographers, American people convicted of assault, American philanthropists, American football coaches, American rapists, American sex offenders, Writers from Pennsylvania, Sportspeople from Pennsylvania, Criminals from Pennsylvania
Peter Madsen	Living people, 1971 births, Danish scientists, People convicted of manslaughter, People convicted of assault, Engineers, Danish businesspeople, People from Copenhagen
Abbas (photographer)	1944 births, 2018 deaths, Deaths from diabetes, Iranian people, Photojournalists
Adebayo Adedeji	1930 births, 2018 deaths, Nigerian politicians, Economists, Educators
Inuka	1990 births, 2018 deaths, Deaths by euthanasia, Individual animals, Singapore
Animal euthanasia	Euthanasia, Animals
Harry Kim (politician)	1939 births, Living people, American mayors, American military personnel of the Vietnam War, Independent politicians in the United States, Politicians from Hawaii
Tarcisio Bertone	1934 births, Living people, Cardinals of the Roman Catholic Church, Diplomats, Italian Roman Catholics, People from Turin
Shivakumara Swami	1907 births, 2019 deaths, Deaths from respiratory tract infection, Indian activists, Indian educators, Religious leaders, Indian philanthropists, Supercentenarians
Masazō Nonaka	1905 births, 2019 deaths, Japanese supercentenarians
Guru Somasundaram	Indian movie actors
Haikyu!!	Manga series
Perseids	Meteorites, Astronomical phenomena
Leonids	Astronomical phenomena
Dwayne Bravo	West Indies cricketers
Cleveland-Lloyd Dinosaur Quarry	Jurassic, Dinosaurs of North America, Geological formations
Anglo-Zanzibar War	Wars involving the United Kingdom
Guhyasamāja Tantra	Tibetan Buddhism
Music sequencer	Electronic musical instruments, Music software, Sound
Shearography	Materials science
Edith Wilmans	1882 births, Texas, American lawyers, 1966 deaths, Women lawyers
Urvashi Vaid	1958 births, Activists, Living people
Coherence (physics)	Optics, Electromagnetic radiation
Rosie Hackett	1883 births, Irish people, 1976 deaths
Indigenous peoples in Brazil	Brazil
Božidar Smiljanić	1936 births, 2018 deaths, Croatian actors, Movie actors, People from Zagreb
Jerrold Meinwald	1927 births, 2018 deaths, American chemists, Scientists from New York City, Writers from New York City
Lloyd John Ogilvie	1930 births, 2019 deaths, American Presbyterians, People from Kenosha, Wisconsin
Daniel Coughlin	1934 births, Living people, American Roman Catholics, People from Chicago
Shelburne, Vermont	Towns in Vermont
Cheltenham	Spa towns in the United Kingdom, Towns in Gloucestershire
Imperial Cricket Conference	1909 establishments, 1965 disestablishments
International Cricket Conference	1965 establishments, 1989 disestablishments
Battle of Fulford	Battles involving England, 1066 in England, Battles of the Middle Ages
Sayyid dynasty	Sayyid Dynasty
Yang Ha-eun	1994 births, Living people, South Korean table tennis players, People from Seoul
Muhammad Shah (Sayyid dynasty)	Sayyid Dynasty
Alam Shah	Sayyid Dynasty
Nasir-ud-Din Mahmud Shah Tughluq	Tughlaq dynasty
Lerwick	Port cities and towns of Scotland, County towns, Parishes, Shetland
Gianfranco Parolini	1925 births, 2018 deaths, Italian movie directors, People from Rome
Montfaucon-d'Argonne	Communes in Meuse
Saint-Bernard, Haut-Rhin	Communes in Haut-Rhin
Saint-Cosme	Communes in Haut-Rhin
Winkel, Haut-Rhin	Communes in Haut-Rhin
Sigolsheim	Former communes in Haut-Rhin, 2016 disestablishments in France
Something Just Like This	Coldplay songs, 2017 songs, Electronic music
Robert Wilkie	1962 births, Living people, American lawyers, United States Secretaries of Veterans Affairs, Politicians from North Carolina, People from Frankfurt, US Republican Party politicians
Frank Capra	Academy Award winning directors, Golden Globe Award winning directors, 1897 births, 1991 deaths, Deaths from heart failure, Cardiovascular disease deaths in California, Naturalized citizens of the United States, Anti-Communists, American engineers, American movie directors, American movie producers, American screenwriters, American military personnel of World War I, American military personnel of World War II, Italian movie directors, Italian movie producers, Italian screenwriters, People from Sicily
Titusville, Pennsylvania	Cities in Pennsylvania
University of Calcutta	Colleges and universities in India, 1857 establishments, 19th century establishments in India, 1850s establishments in Asia
Colin Miller	1964 births, Living people, Canadian footballers, Scottish footballers, Sportspeople from Vancouver
United Nations Economic Commission for Africa	1958 establishments, United Nations
Elvira Orphée	1922 births, 2018 deaths, Argentine writers
Roy Young (musician)	1937 births, 2018 deaths, English rock singers, English pianists, Singers from London, Musicians from London
James H. Cone	1936 births, 2018 deaths, American educators, American theologians, American Christians, Writers from Arkansas
Alfie Evans case	2016 births, 2018 deaths, Disease-related deaths in England, 2017 in the United Kingdom, People from Liverpool
Natasha Chandel	Canadian actors, Actors from Los Angeles, California, Year of birth missing (living people), Living people
James Hylton	1934 births, 2018 deaths, Road accident deaths in the United States, American racecar drivers, NASCAR drivers, Sportspeople from Virginia
Art Paul	1925 births, 2018 deaths, Deaths from pneumonia, Disease-related deaths in Chicago, Illinois, American military personnel of World War II, Artists from Chicago
Art Shay	1922 births, 2018 deaths, Deaths from heart failure, Cardiovascular disease deaths in Illinois, American military personnel of World War II, American autobiographers, American photographers, Writers from New York City, Writers from Chicago
Deerfield, Illinois	Villages in Illinois, Settlements in Cook County, Illinois, Suburbs of Chicago, Illinois
Karl Toft	1936 births, 2018 deaths, Deaths from lung cancer, Cancer deaths in Canada, People convicted of assault, Gay men, Canadian LGBT people, People from New Brunswick
Paul Junger Witt	Emmy Award winners, 1941 births, 2018 deaths, Deaths from lymphoma, Cancer deaths in Los Angeles, American television producers, Movie directors from New York City
2018 inter-Korean summit	2018 in Asia, 2010s in North Korea, 2010s in South Korea, April 2018 events, Kim Jong-un
Richard Belzer	1944 births, Living people, American movie actors, American television actors, American stage actors, American voice actors, Jewish American comedians, Jewish American actors, American television personalities, American radio personalities, American television presenters, American comedians, Democrats (United States), Actors from Bridgeport, Connecticut, Writers from Connecticut
John Ziegler Jr.	1934 births, 2018 deaths, People from Grosse Pointe, Michigan, Sportspeople from Michigan
Gil Stein (ice hockey)	1928 births, Living people, American lawyers, Sportspeople from Philadelphia, Pennsylvania, Writers from Philadelphia, Pennsylvania
Adam Silver	1962 births, Living people, Businesspeople from New York City, American lawyers, People from Rye, New York
David Stern	1942 births, 2020 deaths, Deaths from cerebral hemorrhage, Cardiovascular disease deaths in New York City, American lawyers, Businesspeople from New York City, Businesspeople from New Jersey, People from Teaneck, New Jersey
Rob Manfred	Living people, 1958 births, American Roman Catholics, American lawyers, Businesspeople from New York
Paul Tagliabue	1940 births, Living people, American lawyers, Businesspeople from New Jersey, Sportspeople from New Jersey, People from Jersey City, New Jersey
Fred Hoiberg	1972 births, Living people, Chicago Bulls players, Indiana Pacers players, Minnesota Timberwolves players, Chicago Bulls head coaches, Sportspeople from Nebraska, People from Lincoln, Nebraska
Rick Renteria	1961 births, Living people, Pittsburgh Pirates players, Seattle Mariners players, Florida Marlins players, Chicago Cubs managers, Sportspeople from California
Matt Nagy	1978 births, Living people, Philadelphia Eagles players, National Football League coaches, Sportspeople from New Jersey
Dave O'Neal	1937 births, 2021 deaths, Businesspeople from Illinois, Politicians from Illinois, Lieutenant Governors of Illinois, US Republican Party politicians, People from Belleville, Illinois
Kim Song-i	North Korea, Living people, 1994 births, Table tennis, Olympic bronze medalists
Tughlaqabad Fort	Tughlaq dynasty
Shihabuddin Omar	1310s births, 1310s deaths, Sultans, Khalji dynasty, Indian people
Pedestrian crossing	Roads, Street furniture
Myocyte	Muscle tissue, Cells
Sadegh Hedayat	1903 births, 1951 deaths, Iranian writers, Agnostics, Novelists, Short story writers, Translators, Burials at Père Lachaise Cemetery, People from Tehran
Harry Potter and the Deathly Hallows – Part 2	2011 movies, 2010s fantasy movies, Harry Potter movies, Movies based on books, Movies directed by David Yates, Warner Bros. movies, Movies about giants
Ri Myong-sun	People from Pyongyang, 1992 births, Sportswomen, Living people, Table tennis players, Olympians
Kings XI Punjab	Kings XI Punjab, 2008 establishments in India
Ilfis	Rivers of Switzerland, Canton of Bern
Miele	1899 establishments in Germany, Companies of Germany, North Rhine-Westphalia
Michael Martin, Baron Martin of Springburn	1945 births, 2018 deaths, Former Speakers of the House of Commons of the United Kingdom, People from Glasgow
Lester James Peries	1919 births, 2018 deaths, Screenwriters, Sri Lankan movie directors, Movie producers
Sumitra Peries	1934 births, Living people, Sri Lankan movie directors, Ambassadors to the United Nations, Ambassadors to France
Ri Sol-ju	1980s births, Living people, Singers, North Korean people, Kim Jong-un
Faure Gnassingbé	1966 births, Living people, Presidents of Togo, Current national leaders
Taro Kono	1963 births, Living people, Japanese politicians
Heiko Maas	1966 births, Living people, Politicians of the Social Democratic Party of Germany, Members of the German Bundestag, Politicians from Saarland
Ingemar Hedberg	1920 births, 2019 deaths, Swedish Olympians, Olympic silver medalists, Sportspeople from Stockholm
Mozambican Civil War	Mozambique, Civil wars, 1977, 1992, Cold War, 20th century in Africa
Sovereign (British coin)	British currency, Gold, Coins
La rosa de Guadalupe	2008 television series debuts, Mexican television series, Telenovelas, 2008 establishments in North America, 2000s establishments in Mexico
Álvaro Noboa	1950 births, Living people, Ecuadorian politicians, Ecuadorian businesspeople, People from Guayaquil
Napoleon Chagnon	1938 births, 2019 deaths, American educators, American anthropologists, Writers from Michigan, Scientists from Michigan, People from Traverse City, Michigan
Pornhub	2007 establishments in Canada, MindGeek, Pornography, Websites
Angélica María	1944 births, Living people, American singer-songwriters, American movie actors, American television actors, Mexican movie actors, Mexican television actors, Mexican singer-songwriters, Actors from New Orleans, Louisiana, Writers from New Orleans, Louisiana, Singers from Louisiana
Angélica Vale	1975 births, Living people, Mexican movie actors, Mexican television actors, Mexican voice actors, Mexican singer-songwriters, Mexican comedians, Naturalized citizens of the United States, American movie actors, American television actors, American voice actors, American singer-songwriters, American comedians, Actors from Mexico City
Marco Antonio Solís	1959 births, Living people, Mexican singer-songwriters, Mexican movie actors, Mexican television actors, Mexican voice actors, Mexican musicians, Guitarists, Composers, Record producers
Benny Fredriksson	1959 births, 2018 deaths, Actors who committed suicide, Swedish movie actors, Swedish television actors, Swedish stage actors, Swedish businesspeople, Actors from Stockholm
Corticosteroid	Steroid hormones
V. V. Giri	Presidents of India, Governors of Karnataka, Governors of Kerala
Fakhruddin Ali Ahmed	Presidents of India, 1905 births, 1977 deaths
Edappadi K. Palaniswami	Tamil Nadu politicians
M. K. Alagiri	Tamil Nadu politicians, 1951 births, Living people
Dinakaran	Tamil Nadu
Dina Thanthi	Tamil Nadu, Tamil language, Newspapers published in India, 1942 establishments
Chinese mystery snail	Gastropods
Younian dialect	Chinese language
Brad Williamson (ice hockey)	1977 births, American Hockey League players, Canadian ice hockey defencemen, ECHL players, Ice hockey people from Ontario, International Hockey League (1945–2001) players, Living people, People from Thunder Bay, United States Hockey League players
Loretta Sanchez	1960 births, Politicians from California, Living people
Ignazio Cassis	1961 births, Physicians, Swiss politicians, Living people, Ticino
Computer-aided design	Computer science, Design
Kitzbühel	Cities and towns in Tyrol (state), Ski areas and resorts in Austria
Dii Consentes	Roman gods and goddesses
Candy Lightner	1946 births, Living people, American activists, People from California
Michiko Nishiura Weglyn	1926 births, 1999 deaths, Activists, American activists, People from Stockton, California
Sandra Cisneros	1954 births, Living people, Writers from Chicago
Gertrude Caroline Ederle	1905 births, American swimmers, American activists, 2003 deaths
Sarah Winnemucca Hopkins	1891 deaths, American activists, Native American people
Emmabuntüs	Linux distributions, Debian-based Linux distributions, X86-64 Linux distributions, Live CD
Agildo Ribeiro	1932 births, 2018 deaths, Deaths from heart failure, Brazilian movie actors, People from Rio de Janeiro
Derek Keys	1931 births, 2018 deaths, South African politicians, South African businesspeople
Deaths in May 2018	2018 deaths, May 2018 events
Pik Botha	1932 births, 2018 deaths, South African politicians
Rose Laurens	1953 births, 2018 deaths, French pop singers, French songwriters, Writers from Paris
Santa Clarita Diet	American horror television series, American comedy television series, Television series set in Los Angeles County, California, 2010s American television series debuts, 2010s American television series endings, Netflix original shows, English-language television programs
Henderson waves	Bridges, Buildings and structures in Singapore
Aileen Hernandez	1926 births, 2017 deaths, African-American people, American feminists, American civil rights activists, California State University, People from Brooklyn, Deaths from dementia
Jody Williams	1950 births, Living people, Activists, American activists
Irene Natividad	1948 births, Living people, Activists, American activists
Nikki Giovanni	1943 births, African American writers, American activists, American educators, American poets, Writers from Ohio, People from Knoxville, Tennessee, Writers from Tennessee, Living people
Miriam Makeba	1932 births, 2008 deaths, American activists, South African entertainers
Fannie Lou Hamer	1917 births, 1977 deaths, Activists, American activists
Ella Baker	1903 births, 1986 deaths, American civil rights activists, American human rights activists, African-American people
Amina al-Said	1914 births, 1995 deaths, American activists
Fred Quimby	1886 births, 1965 deaths, Deaths from myocardial infarction, Cardiovascular disease deaths in California, American animators, American movie producers, Businesspeople from Minnesota
Eric Yarrow	1920 births, 2018 deaths, British businesspeople, British military personnel of World War II, People from Surrey
Anita Ellis	1920 births, Living people, Naturalized citizens of the United States, Canadian movie actors, Canadian television actors, Canadian stage actors, Canadian voice actors, Canadian radio actors, Canadian singers, American movie actors, American television actors, American stage actors, American voice actors, American radio actors, American aviators, People with Alzheimer's disease, Actors from Montreal, Actors from Manhattan, Singers from New York City
Lydia Wideman	1920 births, 2019 deaths, Finnish Olympians, Olympic gold medalists, Skiers
Durward Knowles	1917 births, 2018 deaths, Deaths from renal failure, Olympic gold medalists, Olympic bronze medalists, Centenarians, Bahamian people
Gudrun Zapf-von Hesse	1918 births, 2019 deaths, German centenarians, Designers, German educators, Writers from Frankfurt
Laban movement analysis	Dance, Notation
Kirsty Sword Gusmão	1966 births, Living people, Activists, East Timorese people, Australian people
Wendy Wasserstein	1950 births, 2006 deaths, American feminists, American playwrights, Cancer deaths in New York, Deaths from lymphoma, Jewish American academics, Jewish American writers, Jewish feminists, Pulitzer Prize winners, Writers from Brooklyn, Yale University alumni
Gloria Molina	1948 births, Living people, American activists, Politicians from Los Angeles, California
Anjali Gopalan	1957 births, Living people, Indian activists
Winona LaDuke	1959 births, Living people, American activists, Native American people
Elaine H. Kim	1942 births, Living people, Academics, Activists, American activists
Ruth Sienkiewicz-Mercer	1950 births, 1988 deaths, Activists, American activists, People with disabilities
Maureen Orcutt	1907 births, 2007 deaths, Competitors in athletics, Activists, American activists
Patrisse Cullors	1984 births, Living people, African-American people, American civil rights activists, American LGBT rights activists, Black Lives Matter
Russalka	History of Russia, Warships
CAD/CAM	Computer science, Design, Manufacturing
French Chess Federation	Chess organizations, Sport in France
French Chess Championship	Chess competitions, Sport in France
Manuel Turizo	2000 births, Living people, Colombian singers
Joel Kovel	1936 births, 2018 deaths, American environmentalists, American political writers, American political activists, American educators, Writers from New York City
Point Pelee National Park	National parks in Canada, Dark-sky preserves, 1918 establishments, 1910s establishments in Canada, Geography of Ontario
Max Berrú	1942 births, 2018 deaths, Deaths from multiple myeloma, Chilean entertainers, Chilean singers, Musicians, Singers, Chilean businesspeople, Ecuadorian entertainers, Ecuadorian businesspeople
Wanda Wiłkomirska	1929 births, 2018 deaths, Polish musicians, Violinists, Polish educators, People from Warsaw
Morton, Minnesota	Cities in Minnesota
Tuas Link MRT station	Mass Rapid Transit (Singapore) stations
Alstom Metropolis C830C	MRT Singapore, Rolling stock
Clementi rail accident	Railway accidents in Asia
Devbhumi Dwarka district	Districts of Gujarat
Matthew Meselson	1930 births, Living people, Jewish American scientists, American geneticists, Foreign Members of the Royal Society, American biologists, University of Chicago alumni, Harvard University faculty
Graham Fellows	1959 births, Living people, People from Manchester, English comedians, English musicians, English voice actors
Siri von Essen	1850s births, 1912 deaths, Finnish actors, Nobility, Swedish stage actors
Austroasiatic languages	Languages of Asia
Hans-Rudolf Merz	1942 births, Living people, Presidents of the Swiss Confederation
Wolf Children	Animated movies, Japanese movies
Danone	1919 establishments, Companies of France, Food companies of Europe
RÚV	1930 establishments in Europe, Television channels, Radio stations in Europe, Reykjavík, 20th century establishments in Iceland
Sweetener (album)	Pop albums, Trap albums, Hip hop albums, R&B albums, 2018 albums, Ariana Grande albums
Elmar Altvater	1938 births, 2018 deaths, German educators, German political scientists, Political writers, German writers
Chuck Missler	1934 births, 2018 deaths, American Christians, American educators, Engineers from Illinois, American radio personalities, Writers from Illinois, Businesspeople from Illinois, Scientists from Illinois
Universo 2000	1963 births, 2018 deaths, Deaths from myocardial infarction, Mexican professional wrestlers
Gord Brown	1960 births, 2018 deaths, Deaths from myocardial infarction, Cardiovascular disease deaths in Canada, Politicians from Toronto
Vadim Mulerman	1938 births, 2018 deaths, Soviet singers, Cancer deaths in New York City
Wang Danfeng	1924 births, 2018 deaths, Chinese movie actors, Chinese television actors, Chinese stage actors, People from Shanghai
Kent Osborne	Emmy Award winners, 1969 births, Living people, Adventure Time, American movie actors, American television actors, American voice actors, American television writers, American television producers, American television directors, Screenwriters from New Jersey, Movie producers from New Jersey, Actors from New Jersey, Writers from Vermont, Actors from Vermont
Burgettstown, Pennsylvania	Boroughs in Pennsylvania
James W. Carroll	Living people, American lawyers, Directors of the Office of National Drug Control Policy, US Republican Party politicians
Lee P. Brown	1937 births, Living people, American lawyers, Businesspeople from Houston, Texas, Businesspeople from Oklahoma, Mayors of Houston, Directors of the Office of National Drug Control Policy, Politicians from Oklahoma, US Democratic Party politicians
Barry McCaffrey	1942 births, Living people, Purple Heart recipients, American military personnel of the Vietnam War, American political writers, Harvard University alumni, Directors of the Office of National Drug Control Policy, Politicians from Massachusetts, Writers from Massachusetts
John P. Walters	1952 births, Living people, Directors of the Office of National Drug Control Policy, Politicians from Michigan, US Republican Party politicians
Gil Kerlikowske	1949 births, Living people, Directors of the Office of National Drug Control Policy, Politicians from Florida, US Democratic Party politicians
Michael Botticelli	1958 births, Living people, Directors of the Office of National Drug Control Policy, LGBT politicians, Gay men, LGBT people from New York, Politicians from New York, US Democratic Party politicians
Jefferson County, West Virginia	West Virginia counties
Tormentor (Slayer song)	Songs, Thrash metal bands
The Daily Star (Bangladesh)	1991 establishments in Asia, Bangladesh, 20th century establishments in Bangladesh, English-language newspapers published in Asia
Star Showbiz	Magazines of Bangladesh
Dhaka Courier	1984 establishments in Asia, Magazines of Bangladesh
Forum (Bangladesh)	1969 establishments in Asia, 2013 disestablishments, Magazines of Bangladesh, Pakistan
ATN News	2010 establishments in Asia, Dhaka, Bangladesh, 21st century establishments in Bangladesh
República (Nepalese newspaper)	2009 establishments in Asia, Establishments in Nepal, Newspapers in Asia
Singapore Pro Wrestling	Professional wrestling promotions, Singaporean companies
Ice planet	Types of planet
Rice flour	Flour, Rice
Ice giant	Astronomical objects, Solar System, Types of planet
The Yachts	1970s British music groups, Musical groups from Liverpool, English pop music groups, New wave bands
Chicago "L"	Transport in Chicago, Rapid transit systems in the United States
Chaz Jankel	1953 births, English guitarists, English pianists, English songwriters, Living people, Musicians from London, Singers from London
English Chess Federation	Chess organizations
Ancient Beringian	Pre-Columbian cultures
Windows 3.1x	Microsoft operating systems
Oleg Anofriyev	1930 births, 2018 deaths, Russian composers, Russian movie actors, Russian movie directors, Russian singers, Soviet movie actors, Soviet singers, Russian voice actors, Russian stage actors, Songwriters
Tony Cucchiara	1937 births, 2018 deaths, Italian singers, Italian composers, Italian playwrights, Songwriters, People from Sicily
Khorramshahr	Cities in Iran
Bill Torrey	1934 births, 2018 deaths, Canadian businesspeople, People from Montreal
Afonso Dhlakama	1953 births, 2018 deaths, Deaths from myocardial infarction, Generals, Roman Catholics, Anti-Communists, Mozambican people, African politicians
Khouzestan Province	Provinces of Iran
Transport in Singapore	Transport in Singapore
Isabela Garcia	1967 births, Living people, Brazilian television actors, Brazilian movie actors, Brazilian stage actors, People from Rio de Janeiro
Signs of Life (1968 movie)	1968 drama movies, World War II movies, Movies set in Greece, Mental disorders in fiction, German movies, Movies directed by Werner Herzog
US Salernitana	Italian football clubs, 1919 establishments in Italy, 1922 disestablishments in Europe, 1920s disestablishments in Italy, 1945 establishments in Italy, 1977 disestablishments in Europe, 1970s disestablishments in Italy
SS Salernitanaudax	Italian football clubs, 1922 establishments in Italy, 1920s disestablishments in Italy, 1927 disestablishments
USF Salernitana	Italian football clubs, 1927 establishments in Europe, 1920s establishments in Italy, 1945 disestablishments in Italy
Plastic pollution	Pollution
Hans Scholl	1918 births, 1943 deaths, Munich, World War II people
Ernst Heinrich Weber	1795 births, 1878 deaths, Foreign Members of the Royal Society, German doctors, German psychologists
Tarte Tatin	French food, Apple products, Desserts, Pies
Flatboat	Ship types
Pierre-Louis Maupertuis	1698 births, 1759 deaths, French scientists, French physicists, French astronomers, French biologists, French philosophers, French writers, Members of the Académie française, Fellows of the Royal Society
Matthew Webb	British swimmers, 1848 births, 1883 deaths
Magnosaurus	Theropods, Dinosaurs
CGP Grey	American YouTubers, Living people, Podcasters, Year of birth missing (living people)
Chuandongocoelurus	Tetanurans
Wolfgang Völz	1930 births, 2018 deaths, German stage actors, German movie actors, German television actors, German voice actors, People from Gdańsk
Poekilopleuron	Tetanurans, Theropods
Donald McHenry	1936 births, African-American people, American diplomats, People from East St. Louis, Illinois, United States Ambassadors to the United Nations, Living people
Wellston High School	Schools in Ohio
Herman Krebbers	1923 births, 2018 deaths, Dutch musicians, People from Overijssel, Violinists
Reece Thompson	1988 births, Canadian child actors, Canadian movie actors, Canadian television actors, Canadian voice actors, Actors from British Columbia, Living people
Abi Ofarim	1937 births, 2018 deaths, Israeli singers, Israeli musicians, Dancers
Henryk Skolimowski	1930 births, 2018 deaths, Polish writers, Polish educators, Philosophers, People from Warsaw
Eric Koch	1919 births, 2018 deaths, German educators, German novelists, German Jews, Canadian educators, Canadian novelists, People from Frankfurt
Geneviève Claisse	1935 births, 2018 deaths, French painters
Anatole Katok	1944 births, 2018 deaths, American mathematicians, American educators, Russian mathematicians, Russian educators, Writers from Washington, D.C.
John Treacher	1924 births, 2018 deaths, British businesspeople, British military personnel of World War II
London Junior Cup	Football competitions
William Reynolds (actor)	1931 births, Living people, American movie actors, American television actors, American stage actors, Actors from Los Angeles, California
Danville, Pennsylvania	Boroughs in Pennsylvania, County seats in Pennsylvania
Ignacio Zaragoza	1829 births, 1862 deaths, Deaths from typhoid fever, Generals, Mexican politicians
Shazam! (movie)	2019 movies, DC Extended Universe movies, American action comedy movies, American science fiction movies, American adventure movies, Warner Bros. movies, New Line Cinema movies, 2010s superhero movies, Movies set in 2018
Wonder Woman 1984	2020 movies, 2020s superhero movies, Movies directed by Patty Jenkins, Wonder Woman movies, DC Extended Universe movies, American action comedy movies, American science fiction movies, American adventure movies, Movies composed by Hans Zimmer, Warner Bros. movies, Movies set in the 1980s, American superhero movies
Under Mango Tree	New Delhi, 2010s establishments in India, Architects
Duriavenator	Tetanurans, Theropods, Jurassic dinosaurs
Penshurst, New South Wales	Sydney
Mingguang	Cities in China
Bad News Game	2018 video games
Alexander Tschäppät	1952 births, 2018 deaths, Cancer deaths in Switzerland, Swiss politicians, Mayors
Cercopithecus	Old World monkeys
Michele Castoro	1952 births, 2018 deaths, Deaths from pancreatic cancer, Cancer deaths in Italy, Archbishops, Italian Roman Catholics
Bank of America Corporate Center	Buildings and structures in North Carolina
Big Flow Music	Mexican rap music groups, 2010s music groups, 2013 establishments, Musical groups established in 2013, 2010s establishments in Mexico
Active fault	Faults, Earthquakes
Chun-Li (song)	Nicki Minaj songs, 2018 songs, Hip hop songs
Yeovil Town L.F.C.	English football clubs, 1990 establishments in the United Kingdom
Lake Albert (Africa)	Lakes of Africa, Uganda, Democratic Republic of the Congo
Chiemsee	Lakes of Europe, Geography of Bavaria
Lake Neuchâtel	Lakes of Bern, Canton of Fribourg, Vaud, Canton of Neuchâtel
Yverdon-les-Bains	Municipalities of Vaud, Cities in Switzerland, Spa towns
Chêne-Pâquier	Municipalities of Vaud
1811-12 New Madrid Earthquake	Earthquakes in the United States, 1810s in the United States, 1811, 1812, Articles on pre-1900 earthquakes
José María Íñigo	1942 births, 2018 deaths, Deaths from lung cancer, Cancer deaths in Spain, Eurovision Song Contest presenters, Spanish journalists, People from Bilbao
Richard John Garcia	1947 births, 2018 deaths, Deaths from Alzheimer's disease, Disease-related deaths in California, Bishops, American Roman Catholics, People from San Francisco
Monterey, California	Cities in California, Settlements in Monterey County, California
George V. Murry	1948 births, 2020 deaths, Deaths from acute myeloid leukemia, American Roman Catholics, Bishops, People from Youngstown, Ohio, People from Camden, New Jersey
Blaxploitation	African-American history, Genres, Movies
Jordan Nikolić	1933 births, 2018 deaths, Deaths from COPD, Serbian singers, Kosovan singers
Earl Balfour	1933 births, 2018 deaths, Deaths from prostate cancer, Cancer deaths in Canada, Canadian ice hockey forwards, Chicago Blackhawks players, Toronto Maple Leafs players, Sportspeople from Toronto, American Hockey League players, Ontario Hockey League players
Esther Ofarim	1941 births, Living people, Israeli singers, Israeli writers, Israeli musicians, Eurovision Song Contest entrants, Songwriters
Mel Lastman	1933 births, Living people, Mayors of Toronto
Mayor of Toronto	Mayors of Toronto
David Crombie	1936 births, Living people, Mayors of Toronto, Privy Councillors (Canada), Members of the House of Commons of Canada from Ontario
Art Eggleton	1943 births, Living people, Mayors of Toronto, Privy Councillors (Canada)
Martha MacIsaac	1984 births, Canadian voice actors, Living people
Jerrod Carmichael	Living people, 1987 births, American stand-up comedians, American television producers, American television writers
Cirilo Bautista	1941 births, 2018 deaths, Deaths from neuroendocrine cancer, Filipino writers, Poets, Novelists, Critics, Filipino educators, People from Manila
Ben Miller	1966 births, Living people, English movie actors, English television actors, English stage actors, English voice actors, English television personalities, English television directors, Comedians from London, Actors from London
Noah Taylor	1969 births, Living people, English movie actors, English television actors, English stage actors, English voice actors, Australian movie actors, Australian television actors, Australian stage actors, Australian voice actors, Actors from London
Freddie Highmore	Saturn Award winners, 1992 births, Living people, English movie actors, English television actors, English stage actors, English voice actors, English child actors, English television directors, English television producers, Screenwriters from London, Actors from London
William Gillock	1917 births, 1993 deaths, American composers
Naser Cheshm Azar	1950 births, 2018 deaths, Deaths from myocardial infarction, Iranian musicians, Asian pianists, Composers
Renate Dorrestein	1954 births, 2018 deaths, Deaths from esophageal cancer, Dutch journalists, Dutch novelists, Feminist writers, Writers from Amsterdam
Paolo Ferrari	1929 births, 2018 deaths, Deaths from pneumonia, Disease-related deaths in Italy, Italian movie actors, Italian television actors, Radio actors, Actors from Brussels
Tarcisio Gitti	1936 births, 2018 deaths, Deaths from Parkinson's disease, Disease-related deaths in Italy, Italian lawyers, Italian politicians
Khaled Mohieddin	1922 births, 2018 deaths, Deaths from congestive heart failure, Egyptian politicians, Generals, Communists
Flula Borg	1982 births, Living people, German comedians, German musicians, Actors from Bavaria, DJs
2019 Monster Energy NASCAR Cup Series	Monster Energy NASCAR Cup Series races
Natalia Cordova-Buckley	1982 births, Living people, Mexican movie actors, Mexican television actors, Mexican voice actors, Actors from Mexico City
Nabih Berri	1938 births, Living people, Lebanese politicians
Saad Hariri	1970 births, Living people, Prime Ministers of Lebanon
Émile Lahoud	1936 births, Living people, Presidents of Lebanon, Military people
Paul Goma	1935 births, 2020 deaths, Deaths from the COVID-19 pandemic in France, Political activists, Political writers, Critics, Moldovan people, Romanian writers, Novelists, Essayists, Anti-Communists
Simon MacCorkindale	1952 births, 2010 deaths, Deaths from colorectal cancer, Cancer deaths in London, British movie actors, British television actors, British stage actors, British movie directors, British movie producers, British television producers, British screenwriters, British composers, Actors from Cambridgeshire
George Raft	1901 births, 1980 deaths, Deaths from leukemia, Cancer deaths in Los Angeles, American movie actors, American television actors, American stage actors, American radio actors, American dancers, Comedians from New York City, Actors from New York City
Buona Vista MRT station	Mass Rapid Transit (Singapore) stations
Wilson Frost	1925 births, 2018 deaths, American lawyers, Chicago City Council members, US Democratic Party politicians
Ray Szmanda	1926 births, 2018 deaths, Deaths from pneumonia, Disease-related deaths in Wisconsin, Accidental deaths from falls in the United States, American radio personalities, American television personalities, American television presenters, American movie actors, Actors from Milwaukee, Wisconsin
Chase Bank	Banks of the United States, 2000 establishments in the United States
JPMorgan Chase	Companies based in New York City, Slavers
Timeline of prehistoric Britain	Great Britain
Swanscombe Heritage Park	Archaeological sites in England, Hominins, Tools
Happisburgh	Villages in Norfolk, Archaeological sites in England, Civil parishes in England
Firuz Shah Tughluq	Tughlaq dynasty, 1300s births, 1380s deaths, Muslims, Indian people
Alpine orogeny	Geography of Europe, Orogenies
Rockstar North	Video game companies, Edinburgh, 1984 establishments in the United Kingdom, 20th century establishments in Scotland
Charles W. Steger	1947 births, 2018 deaths, American architects, Engineers from Virginia, American educators, People from Richmond, Virginia
Ermanno Olmi	1931 births, 2018 deaths, Disease-related deaths in Italy, Italian movie directors, Italian screenwriters
Jesús Kumate Rodríguez	1924 births, 2018 deaths, Deaths from respiratory failure, Disease-related deaths in Mexico, Mexican politicians, Mexican physicians
Won't You Be My Neighbor? (movie)	2018 movies, English-language movies, American documentary movies, Fred Rogers
Joe Negri	1926 births, Living people, American educators, American jazz musicians, American guitarists, Musicians from Pittsburgh, Pennsylvania
François Clemmons	1945 births, Living people, African-American singers, LGBT actors, LGBT singers, LGBT writers, Gay men, American playwrights, American television actors, American educators, LGBT people from Alabama, Actors from Birmingham, Alabama, Writers from Alabama, Singers from Alabama
Middlebury, Vermont	Towns in Vermont, County seats in Vermont
Antigo, Wisconsin	Cities in Wisconsin, County seats in Wisconsin, Langlade County, Wisconsin
2018 lower Puna eruption	2018 disasters, Disasters in the United States, 2018 in Hawaii, May 2018 events, June 2018 events, July 2018 events, August 2018 events
2018 Hawaii earthquake	2018 in Hawaii, Earthquakes in the United States, May 2018 events, 2018 earthquakes, 2018 in the United States
Stickler syndrome	Genetic disorders, Ophthalmology, Rheumatology, Syndromes
Peter Temple-Morris	1938 births, 2018 deaths, People from Cardiff, UK MPs 1974, UK MPs 1997–2001
Maurane	1960 births, 2018 deaths, Deaths from cardiac arrest, Belgian movie actors, Belgian singers
Eric Schneiderman	1954 births, Living people, American lawyers, Politicians from New York City, US Democratic Party politicians
Sanjeev Bhaskar	1963 births, Living people, Actors from London, British educators, British movie actors, British stage actors, British television actors, British television presenters, British television writers, British voice actors, Comedians from London, Writers from London
Damietta Governorate	Governorates of Egypt
Alexandria Governorate	Governorates of Egypt
ISG Luxury Management	Education, Schools in Switzerland, Schools in France
Solnhofen	Towns in Bavaria, Weißenburg-Gunzenhausen
PBS Kids Go!	PBS Kids shows
Möttingen	Donau-Ries
Tagmersheim	Donau-Ries
Jack Evans (ice hockey)	1928 births, 1996 deaths, American Hockey League players, Canadian ice hockey defencemen, Chicago Blackhawks players, Deaths from prostate cancer, Ice hockey people from Alberta, Naturalized citizens of Canada, New York Rangers players, Stanley Cup champions, Welsh ice hockey players
Saturnalia	Holidays, Ancient Rome
Long Valley Caldera	Calderas, Geography of California
Panphagia	Sauropodomorphs
Temptation of Christ	Gospels, Jesus Christ
Eric Geboers	1962 births, 2018 deaths, Belgian sportspeople, People from Limburg (Belgium)
Atlanta Motor Speedway	Auto racing, Sports in Atlanta, Georgia, 1960 establishments in the United States, 1960s establishments in Georgia (U.S. state)
Juan Morano	1941 births, 2018 deaths, Spanish politicians, Mayors, People from Madrid
Lara Saint Paul	1946 births, 2018 deaths, Italian singers, Deaths from cancer, Italian television presenters, Record producers
Lionel Hampton	1908 births, 2002 deaths, Deaths from heart failure, Cardiovascular disease deaths in New York City, American pianists, American composers, American philanthropists, American bandleaders, American jazz musicians, American movie actors, Actors from Louisville, Kentucky
Teddy Wilson	1912 births, 1986 deaths, Deaths from stomach cancer, Cancer deaths in Connecticut, American jazz musicians, American pianists, Musicians from New Jersey, Musicians from Austin, Texas
Randy Meisner	1946 births, Living people, American musicians, American singers, American songwriters, Entertainers from Nebraska
Arc welding	Electricity, Metals
Rösti	Root vegetables, Swiss food
Edeka	1890s establishments in Germany, 1898 establishments in Europe, Supermarkets of Germany, Hamburg
Osijek	Cities in Croatia
Maribor	Cities in Slovenia
Krasnoyarsk	Capital cities in Russia, Siberia
Klaus Dede	1935 births, 2018 deaths, German journalists, German writers, People from Lower Saxony
Hildisvíni	Norse mythology, Pigs
Hnöss	Norse gods and goddesses
Love & Basketball	2000 romance movies, 2000 drama movies, 2000s romantic drama movies, 2000s sports drama movies, American romantic drama movies, American sports drama movies, American independent movies, Basketball movies
Aracely Arámbula	Mexican actors, 1975 births, Living people, Mexican television actors
Bonds Cay, The Bahamas	Caribbean islands, Islands of the Bahamas
Nikol Pashinyan	1975 births, Living people, Prime Ministers of Armenia, Current national leaders
Anwar Ibrahim	1947 births, Living people, Deputy Prime Ministers of Malaysia, Criminals
János Juszkó	1939 births, 2018 deaths, Cyclists, Olympians, Hungarian sportspeople
Miki Muster	1925 births, 2018 deaths, Deaths from Alzheimer's disease, Slovenian people, Educators, Illustrators, Cartoonists, Animators
Gözleme	Savoury pies, Turkish food
Colour theory	Color
Hurricane Nate	Hurricanes in the United States, 2017 in the United States
Cindy Ashton	Musicians from Toronto, Living people, Year of birth missing (living people)
Kim Heechul	1983 births, Living people
Kevin Systrom	1983 births, American billionaires, American computer scientists, Engineers from Massachusetts, Living people, Stanford University alumni, American chief executives, Businesspeople from California, Google
Jerry Doyle	1956 births, 2016 deaths, Deaths from cirrhosis, American political commentators, American radio personalities, American television actors, American voice actors, Libertarians, Actors from New Jersey
Forrest Mars Jr.	1931 births, 2016 deaths, American billionaires, Businesspeople from Illinois, Businesspeople from Virginia, People from Oak Park, Illinois, Republicans (United States), Deaths from myocardial infarction
Pierre Fauchon	1929 births, 2016 deaths, French politicians
Robert Fano	1917 births, 2016 deaths, American computer scientists, American engineers, Italian Jews, Jewish American academics, Jewish American scientists, Massachusetts Institute of Technology alumni, Massachusetts Institute of Technology faculty, Naturalized citizens of the United States, People from Turin, Refugees
Jerzy Bahr	1944 births, 2016 deaths, Ambassadors of Poland, Cancer deaths in Poland, People from Kraków
Carmen Hernández	1930 births, 2016 deaths, Spanish Roman Catholics, Activists, Feminists
Mu Zi	Female athletes, 1989 births, Living people, Chinese table tennis players
Victor P. Whittaker	1919 births, 2016 deaths, British biochemists
David Huddleston	1930 births, 2016 deaths, American movie actors, American television actors, American military people, Actors from Virginia, Disease-related deaths in the United States
Ivo Pitanguy	1926 births, 2016 deaths, Surgeons, Deaths from myocardial infarction, People from Belo Horizonte
Vander Lee	1966 births, 2016 deaths, Singer-songwriters, People from Belo Horizonte, Deaths from myocardial infarction
Diamond Skulls	1980s thriller movies, 1989 drama movies, British thriller movies, British drama movies
Note-taking	Writing
Jamal Naji	1954 births, 2018 deaths, Deaths from stroke, Novelists, Palestinian people, Jordanian people
Crosbie E. Saint	1936 births, 2018 deaths, Deaths from stroke, American military personnel of the Vietnam War, People from New York
Mustafa Nur-Ul Islam	1927 births, 2018 deaths, Deaths from multiple organ failure, Bangladeshi people, Bangladeshi educators
David Goodall (botanist)	1914 births, 2018 deaths, Australian activists, British activists, British botanists, Deaths by euthanasia, Drug-related suicides, Ecologists, English centenarians, Scientists from London, Writers from London
Don Blankenship	1950 births, Living people, 2020 United States presidential candidates, Businesspeople from Kentucky, Businesspeople from West Virginia, American criminals, Politicians from Kentucky, Politicians from West Virginia, US Republican Party politicians
Evgeni Vasiukov	1933 births, 2018 deaths, Deaths from myocardial infarction, Chess grandmasters, Sportspeople from Moscow
Big Bully Busick	1954 births, 2018 deaths, Deaths from spinal cancer, American professional wrestlers, Sportspeople from Ohio, People from Steubenville, Ohio
Weirton, West Virginia	Cities in West Virginia
Lorraine Hansberry	1930 births, 1965 deaths, Deaths from pancreatic cancer, Cancer deaths in New York City, American essayists, Democrats (United States), American atheists, LGBT writers, LGBT people from Chicago, Lesbian feminists, American feminist writers, American playwrights, American civil rights activists, American LGBT rights activists, African American writers, Journalists from Chicago
Stacy Martin	1991 births, Living people, French movie actors, English movie actors, Actors from Paris, Actors from London
2018 North Korea–United States summit	2018 in Asia, Donald Trump, Events in Singapore, Kim Jong-un
Stopover, Kentucky	Unincorporated communities in Kentucky
Vocabulario de la Lengua Bicol	Vocabulary
Shark finning	Fishing
Siti Hasmah Mohamad Ali	1926 births, Living people, First Ladies, Malaysian people
Sirikit	1932 births, Living people, Kings and queens, Thai people
Vello Asi	1927 births, 2016 deaths, Estonian people
Egyptian Army	Armies, Egypt
Mohamed Aboutrika	1978 births, Egyptian Muslims, Egyptian footballers, Living people, Egypt international footballers
Caelus	Greek gods and goddesses
List of members of the European Parliament for the United Kingdom, 2014–19	MEPs for the United Kingdom
List of twin towns and sister cities in Switzerland	Cities in Switzerland
Clash Royale	Card games, IOS games, Android (operating system) games, 2016 video games, Real-time strategy video games
Camaloon	2011 establishments in Europe, Stationery, 21st century establishments in Spain
Gilles Deleuze	1925 births, 1995 deaths, French philosophers, French people
Destin Onka Malonga	1988 births, 2016 deaths, African footballers, Republic of the Congo, Accidental deaths in France
Jean-Claude Wicky	1946 births, 2016 deaths, Swiss people, Photographers
Little Shop of Horrors	1986 comedy movies, 1986 horror movies, 1980s musical movies, English-language movies, American musical comedy movies
James Alan McPherson	1943 births, 2016 deaths, African American writers, Short story writers, Pulitzer Prize winners, Harvard University alumni, People from Savannah, Georgia, Writers from Georgia (U.S. state), Writers from Iowa, People from Iowa City, Iowa, Deaths from pneumonia
Mahasweta Devi	1926 births, 2016 deaths, Indian educators, Indian novelists, Human rights activists, Short story writers, Biographers, Deaths from multiple organ failure, West Bengal
Ed Ross	1965 births, 2016 deaths, American photographers, Road accident deaths, People from California, Mendocino County, California
Scott Hutchison	1981 births, 2018 deaths, Scottish singer-songwriters, Guitarists, Artists
Adam Parfrey	1957 births, 2018 deaths, American journalists, American novelists, American editors, Writers from New York City
Mikhail Alperin	1956 births, 2018 deaths, Deaths from aortic dissection, Soviet musicians, Educators, Jazz musicians, Pianists, Musicians from Oslo
Bobby Cannavale	Emmy Award winning actors, 1970 births, Drama Desk Award winners, Living people, American movie actors, American television actors, American stage actors, American voice actors, Actors from New Jersey, People from Union City, New Jersey
La Venganza de Cucamonga	Mexican music, Hard rock albums
Ulla Sallert	1923 births, 2018 deaths, Swedish movie actors, Swedish stage actors, Singers from Stockholm, Actors from Stockholm
Captain (United States O-3)	United States Army, Military ranks
First Motion Picture Unit	World War II, United States Army
Lake Maracaibo	Lagoons, Venezuela, Lakes of South America
Marina del Rey, California	Unincorporated communities in California, Census-designated places in California, Settlements in Los Angeles County, California
George Pell	1941 births, Living people, Australian criminals, Australian Roman Catholics, Cardinals of the Roman Catholic Church, Child sexual abusers, People from Ballarat
Roger Mahony	1936 births, Living people, Cardinals of the Roman Catholic Church, Bishops, American Roman Catholics, People from Los Angeles, California
Francis Arinze	1932 births, Living people, Cardinals of the Roman Catholic Church, Nigerian people
Newton, Kansas	County seats in Kansas
Bad Blood (2003)	World Wrestling Entertainment pay-per-view events, 2003 in professional wrestling, 2003 in Texas
Roadblock (March 2016)	World Wrestling Entertainment pay-per-view events, 2016 in sports, 2010s in Canada, 2016
Arthur Levitt	1931 births, Living people, People from Brooklyn, Jewish American politicians, Members of the U.S. Securities and Exchange Commission, American journalists, US Democratic Party politicians, Businesspeople from New York City, Politicians from New York City, Writers from New York City
William H. Donaldson	1931 births, Living people, Members of the U.S. Securities and Exchange Commission, Yale University alumni, Politicians from Buffalo, New York, Businesspeople from New York, US Republican Party politicians
David Sturtevant Ruder	Members of the U.S. Securities and Exchange Commission, 1929 births, 2020 deaths, American lawyers, American educators, Politicians from Wisconsin, US Republican Party politicians
Gérard Genette	1930 births, 2018 deaths, French educators, French socialists, French literary critics, Writers from Paris
Manchalloor	Villages in Kollam district
Yeroor	Villages in Kollam district
Manappally	Villages in Kollam district
Kundayam	Villages in Kollam district
Panampatta	Villages in Kollam district
National Association of Broadcasters	Television, Radio, 1923 establishments in the United States, 1920s establishments in Illinois, History of Chicago
University of Sarajevo	1949 establishments in Europe, Colleges and universities in Europe, Sarajevo, 1940s establishments in Bosnia and Herzegovina
Rasmussen Reports	2003 establishments in the United States, New Jersey
California Highway Patrol	California
People's Park (Berkeley)	Parks in the United States, Geography of California, Berkeley, California, 1960s establishments in California
Stanley Falkow	1934 births, 2018 deaths, Deaths from myelodysplastic syndrome, Disease-related deaths in California, American biologists, Scientists from New York, American educators, People from Albany, New York
Collared dove	Doves, National symbols of Pakistan, Pakistani culture
Antonio Mercero	Goya Award winners, Emmy Award winning directors, 1936 births, 2018 deaths, Deaths from Alzheimer's disease, Spanish screenwriters, Spanish movie directors, Television directors
Hossam Hassan	1966 births, 1990 FIFA World Cup players, Egyptian footballers, Living people, People from Cairo, Egypt international footballers
Nikah	Islamic law, Marriage
Reykjavík University	1998 establishments in Europe, Colleges and universities in Europe, Reykjavík
Richard Fagan	1947 births, 2016 deaths, American songwriters, Singers from Nashville, Tennessee, American country guitarists, American pianists, American country singers, American singer-songwriters, Deaths from liver cancer, Cancer deaths in Tennessee, Musicians from Philadelphia, Pennsylvania, Musicians from Nashville, Tennessee, Writers from Nashville, Tennessee
Artur Correia	1950 births, 2016 deaths, Portuguese footballers, People from Lisbon, Deaths from stroke
Domiati	Cheeses
Mate Rimac	Living people, Croatian people, Business people, Inventors
Pennzoil 400 (Las Vegas)	NASCAR tracks, 1998 establishments in the United States, 20th-century establishments in Nevada, Monster Energy NASCAR Cup Series races
Dennis Nilsen	1945 births, 2018 deaths, British people convicted of murder, British serial killers, Gay men, LGBT criminals, People convicted of attempted murder, People who died in prison custody, Scottish LGBT people
Kevin Tierney	1950 births, 2018 deaths, Cancer deaths in Quebec, Canadian movie producers, Canadian screenwriters, Canadian television producers, Irish writers, Writers from Montreal
Maria Lourdes Sereno	1960 births, Living people, Chief Justices of the Supreme Court of the Philippines, Filipino lawyers, People from Manila, Women lawyers, Women judges
Bluefield, West Virginia	Cities in West Virginia
Come Home to Mama	2012 albums
I Know You're Married But I've Got Feelings Too	2008 albums
We Are Born	2010 albums
Some People Have Real Problems	2008 albums
Slender Man stabbing	2014 crimes, 2014 in the United States, 2010s crimes in the United States, 21st century in Wisconsin, May 2014 events
Kasamh Se	Indian television series
Randalummoodu	Villages in Kollam district
Panaveli	Villages in Kollam district
Vilakkuvettom	Villages in Kollam district
Kandachira	Villages in Kollam district
Kannanalloor	Villages in Kollam district
Neduvannoor	Villages in Kollam district
Pathanapuram Block Panchayat	Kerala
Umayanalloor	Villages in Kollam district
Alappad	Villages in Kollam district
Ochira	Towns in India, Settlements in Kerala
THKO	Politics of Turkey, Communist parties, 1970 establishments, 20th century establishments in Turkey, 1972 disestablishments
Damietta	Cities in Egypt
Jim Ratcliffe	1952 births, Living people, British businesspeople
Sooranad	Villages in Kollam district
Mynagappally	Villages in Kollam district
Kafr Saad	Cities in Egypt
Sasthamkotta	Villages in Kollam district
Poruvazhy	Villages in Kollam district
Kunnathur, Kerala	Villages in Kollam district
West Kallada	Villages in Kollam district
Bruno Tomberg	Living people, 1926 births
Egyptian Navy	Navies
Andrew Upton	1966 births, Australian screenwriters, Australian movie directors, Australian playwrights, Living people, Writers from New South Wales
Netta Barzilai	1993 births, Living people, Eurovision Song Contest winners, Israeli singers, People from Tel Aviv
Donald Gary Young	1949 births, 2018 deaths, Businesspeople from Salt Lake City, Utah, Deaths from stroke
Edgardo Angara	1934 births, 2018 deaths, Deaths from myocardial infarction, Filipino lawyers, Presidents of the Senate of the Philippines, Minority leaders of the Senate of the Philippines, Recipients of the Order of the Rising Sun
Baadur Tsuladze	1935 births, 2018 deaths, Actors from Georgia (country), Movie producers from Georgia (country), Movie directors from Georgia (country), Screenwriters from Georgia (country)
Pattazhy	Villages in Kollam district
Pattazhy Vadakkekkara	Villages in Kollam district
Cuckoo bee	Bees, Parasitism
Lubec	Towns in Maine
Canaan (Maine)	Towns in Maine
Eurovision Song Contest 2019	2010s in Israel, 2019 in Europe, 2019 in entertainment, Eurovision Song Contest, Tel Aviv
Ria Vedder-Wubben	1951 births, 2016 deaths, Christian Democratic Appeal politicians, Dutch Roman Catholics, Dutch women politicians, Members of the Senate of the Netherlands, Politicians from The Hague
Millennium Island	Islands of Oceania
Winglet	Aircraft
Inigo Jones	English architects, People from London, 1573 births, 1652 deaths
Catatumbo River	Rivers of Venezuela, Rivers of Colombia
Vilakkudy	Villages in Kollam district
Pidavoor	Villages in Kollam district
Piravanthur	Villages in Kollam district
Punnala	Villages in Kollam district
Gennadi Gusarov	1937 births, 2014 deaths, Soviet sportspeople, Sportspeople from Moscow, Russian footballers, 1958 FIFA World Cup players, 1962 FIFA World Cup players
Thalavoor	Villages in Kollam district
Pathanapuram	Towns in India, Settlements in Kerala
Wow... The Story	2000 albums
Ghetto Story	2006 albums
Duckweed	Araceae, Aquatic plants
Henry Lee III	1756 births, 1818 deaths, American Revolutionary War, American generals, Congressional Gold Medal recipients, Freemasons, Governors of Virginia, People from Alexandria, Virginia, Princeton University alumni, United States representatives from Virginia
Omar Gaber	1992 births, Egyptian footballers, Living people, Egypt international footballers
Trnovac (Vrbanja)	Rivers of Bosnia and Herzegovina
Hossam Ashour	1986 births, Egyptian footballers, Living people, Egypt international footballers
Lopača (Vrbanja)	Rivers of Bosnia and Herzegovina
Aplastic anemia	Blood disorders
Hezbe Wahdat	Politics of Afghanistan
Hana to Yume	Manga
Overboard (2018 movie)	2018 comedy movies, 2010s romantic comedy movies, American romantic comedy movies, Lionsgate movies
How to Be a Latin Lover	2017 comedy movies, Lionsgate movies
False color	Color, Photography
Arthur Barnard	1929 births, 2018 deaths, American Olympic bronze medalists, Sportspeople from Seattle, Washington
Will Alsop	1947 births, 2018 deaths, English architects, People from Northampton
Richard Lester	1932 births, Living people, American movie directors, People from Philadelphia, Pennsylvania
Glenn Branca	1948 births, 2018 deaths, Deaths from throat cancer, American composers, American guitarists, Musicians from Pennsylvania
Lay ministry	Church organization, Christian terminology
Epitácio Cafeteira	1924 births, 2018 deaths, Deaths from pneumonia, Brazilian politicians
Steve Hogan	1948 births, 2018 deaths, American mayors, Deaths from cancer, Politicians from Colorado, Politicians from Nebraska, People from Lincoln, Nebraska, US Republican Party politicians
Franz Marc	1880 births, 1916 deaths, German painters, People from Munich
Margot Kidder	Emmy Award winning actors, Saturn Award winners, 1948 births, 2018 deaths, Drug-related suicides in the United States, Naturalized citizens of the United States, People with bipolar disorder, American movie actors, American television actors, American voice actors, American stage actors, American environmentalists, American autobiographers, American LGBT rights activists, American atheists, Canadian movie actors, Canadian television actors, Canadian voice actors, Canadian stage actors, Canadian activists, Writers from Montana, Democrats (United States), Actors from Montana
María Elena Meneses Rocha	1961 births, 2018 deaths, Deaths from surgical complications, Mexican journalists, Mexican educators, People from Monterrey, Writers from Mexico City
E. C. George Sudarshan	1931 births, 2018 deaths, Indian scientists, Indian academics, Physicists, People from Kerala
Roy J. Glauber	1925 births, 2018 deaths, American physicists, American educators, Scientists from New York City, Harvard University faculty
Abdallah Said	1985 births, Egyptian footballers, Living people, Egypt international footballers
Quim Torra	1962 births, Living people, Spanish lawyers, Presidents of the Government of Catalonia
Waleed Al-Husseini	1989 births, Living people, Activists, Atheists, Bloggers, Essayists, Former Muslims, Palestinian Muslims, Writers
Amelita Ramos	1926 births, Living people, First Ladies and First Gentlemen of the Philippines
Jose Miguel Arroyo	1945 births, Living people, Filipino lawyers, First Ladies and First Gentlemen of the Philippines
Loi Ejercito	1931 births, Living people, First Ladies and First Gentlemen of the Philippines
President of the Philippines	Presidents of the Philippines
Vice President of the Philippines	Vice Presidents of the Philippines
Teofisto Guingona Jr.	1928 births, Living people, Vice Presidents of the Philippines, Presidents pro tempore of the Senate of the Philippines, Minority leaders of the Senate of the Philippines, Majority leaders of the Senate of the Philippines
Neri Oxman	1976 births, Living people, Naturalized citizens of the United States, Israeli Jews, American Jews, American architects, American educators, People from Haifa, Scientists from Massachusetts, Businesspeople from Massachusetts
Cecilia Suárez	Emmy Award winning actors, 1971 births, Living people, Mexican movie actors, Mexican television actors, Mexican voice actors
Elsa Raven	1929 births, 2020 deaths, American movie actors, American television actors, Actors from South Carolina, People from Charleston, South Carolina
Isidor Straus	1845 births, 1912 deaths, Victims of the RMS Titanic, German businesspeople, German politicians, Naturalized citizens of the United States, United States representatives from New York, US Democratic Party politicians, Businesspeople from New York City, Politicians from New York City
Clint Capela	1994 births, Living people, Basketball players, Swiss sportspeople, People from Geneva, Houston Rockets players
Benjamin Guggenheim	1865 births, 1912 deaths, Victims of the RMS Titanic, Businesspeople from Philadelphia, Pennsylvania
Ida Straus	1849 births, 1912 deaths, Victims of the RMS Titanic, German Jews, American Jews, People from Worms, Germany
Luigi Gatti	1875 births, 1912 deaths, Victims of the RMS Titanic, Italian businesspeople
Edward Austin Kent	1854 births, 1912 deaths, Victims of the RMS Titanic, American architects, Businesspeople from Maine, Businesspeople from Buffalo, New York, People from Bangor, Maine
Sidney Leslie Goodwin	1910 births, 1912 deaths, Victims of the RMS Titanic
Frank M. Warren Sr.	1848 births, 1912 deaths, Victims of the RMS Titanic, Businesspeople from Portland, Oregon, Businesspeople from Maine
Thomas Byles	1870 births, 1912 deaths, Victims of the RMS Titanic, English Roman Catholics, Roman Catholic priests, People from Leeds
Cyst	Tissues
Walter Reed National Military Medical Center	Buildings and structures in Maryland, Hospitals in the United States
President of Israel	Presidents of Israel
Prokopis Pavlopoulos	1950 births, Living people, Presidents of Greece, Greek lawyers, Greek educators
President of Greece	Presidents of Greece
B Flow	Living people, Musicians, 1986 births, Singers, Zambian people
2017–18 UEFA Champions League	UEFA Champions League seasons, 2017 in association football, 2018 in association football
Essam El-Hadary	1973 births, Egyptian footballers, Living people, Egypt international footballers
Shukhov Lab	Colleges and universities in Russia, Buildings and structures in Moscow, 2010s establishments in Europe, 21st century establishments in Russia
Patrick Morrisey	1967 births, Living people, Attorneys general, Politicians from West Virginia, US Republican Party politicians
Adinad	Villages in Kollam district
Karunagappally	Settlements in Kerala, Municipalities
Thazhava	Villages in Kollam district
Pavumba	Villages in Kollam district
Thodiyoor	Villages in Kollam district
Kallelibhagom	Villages in Kollam district
Saint Petersburg Central Bus Terminal	Buildings and structures in Saint Petersburg, Bus transport
Koronadal	Cities in the Philippines, Establishments in the Philippines
Kahoot!	Learning
List of British pornographic actors	British actors, Pornographic actors, Lists of entertainers, United Kingdom-related lists
Open Shortest Path First	Computer networking
Serekunda	Cities in the Gambia
Ayman Hefny	1985 births, Egyptian footballers, Living people
An-Nasai	Muslims, History of Islam, Hadith scholars
Labor Management Relations Act of 1947	1947 in the United States, United States federal legislation
House Un-American Activities Committee	1938 establishments in the United States, 1975 disestablishments, Cold War, United States House of Representatives, 1970s disestablishments in the United States
Ahmed Salah Hosny	1979 births, Egyptian footballers, Living people
American Conservative Union	20th-century establishments in Virginia, 1964 establishments in the United States, Political organizations based in the United States, Conservatism
Frank Quilici	1939 births, 2018 deaths, Minnesota Twins players, Sportspeople from Chicago
Jlloyd Samuel	1981 births, 2018 deaths, Road accident deaths in the United Kingdom, Trinidad and Tobago footballers
Chuck Knox	1932 births, 2018 deaths, Deaths from dementia, American football coaches, Sportspeople from Pittsburgh, Pennsylvania
UNB (group)	K-pop music groups, South Korean boy bands, 2018 establishments in Asia, 2010s establishments in South Korea
And TV	Indian television, Television channels, 2015 establishments in India
List Of Programs Broadcast By &TV	Indian television
Waaris	2010s television series, 2016 Indian television series debuts, Hindi-language television series, Drama television series
Boyhood (EP)	2018 albums
Thevalakkara	Villages in Kollam district
Chavara	Villages in India
Neendakara	Villages in Kollam district
Clappana	Villages in Kollam district
Kulasekharapuram	Villages in Kollam district
Ayanivelikulangara	Villages in Kollam district
Panmana	Villages in Kollam district
Vadakkumthala	Villages in Kollam district
Tri-State Tornado	Tornadoes in the United States, 1920s in the United States, 1925, 20th century in Kentucky, 20th century in Kansas, 20th century in Alabama, 20th century in Tennessee
Kevin Kamenetz	1957 births, 2018 deaths, Deaths from cardiopulmonary arrest, American lawyers, Politicians from Maryland, US Democratic Party politicians
Peter Mayer	1936 births, 2018 deaths, Deaths from amyloidosis, Disease-related deaths in New York City, Naturalized citizens of the United States, Businesspeople from London, Businesspeople from New York City
Ken Hodgkisson	1933 births, 2018 deaths, English footballers, English football managers
Graham Lovett	1947 births, 2018 deaths, English footballers, Sportspeople from Birmingham
William Vance	1935 births, 2018 deaths, Deaths from Parkinson's disease, Disease-related deaths in Spain, Belgian artists, Comics artists
Roberto Farias	1932 births, 2018 deaths, Deaths from stomach cancer, Cancer deaths in Brazil, Brazilian movie directors, Brazilian movie producers, Brazilian screenwriters, People from Rio de Janeiro
Lochearn, Maryland	Census-designated places in Maryland, Unincorporated communities in Maryland
Towson, Maryland	Census-designated places in Maryland, County seats in Maryland, Unincorporated communities in Maryland
Caribou, Maine	Cities in Maine
Hilario Davide Jr.	1935 births, Living people, Filipino lawyers, Chief Justices of the Supreme Court of the Philippines, Minority leaders of the House of Representatives of the Philippines
Chief Justice of the Supreme Court of the Philippines	Chief Justices of the Supreme Court of the Philippines
Antonio Carpio	1949 births, Living people, Filipino lawyers, Chief Justices of the Supreme Court of the Philippines
President of the Senate of the Philippines	Presidents of the Senate of the Philippines
Koko Pimentel	1964 births, Living people, Filipino lawyers, Presidents of the Senate of the Philippines
House of Representatives of the Philippines	Politics of the Philippines
Speaker of the House of Representatives of the Philippines	Speakers of the House of Representatives of the Philippines
Feliciano Belmonte Jr.	People from Quezon City, 1936 births, Living people, Speakers of the House of Representatives of the Philippines, Minority leaders of the House of Representatives of the Philippines
Jose de Venecia Jr.	1936 births, Living people, Speakers of the House of Representatives of the Philippines
Pantaleon Alvarez	1958 births, Living people, Speakers of the House of Representatives of the Philippines
Supreme Court of the Philippines	Politics of the Philippines, National supreme courts
Congress of the Philippines	Politics of the Philippines
Global Communicorp UK	Companies of the United Kingdom
Content and language integrated learning	Language education
Interior gateway protocol	Computer networking
SOLID (object-oriented design)	Acronyms, Computer programming
Ama, his wife and a panther	Vietnamese animated movies, 1990s animated movies
Công dân hành khúc	National anthems, Vietnamese music
Dancing skeleton	Vietnamese animated movies, 1990s animated movies
Belling the Cat (movie)	2014 animated movies, Vietnamese animated movies
Manhoa	Arts of Vietnam, Comic books
Từ Thức married a fairy	Vietnamese animated movies, 1990s animated movies‎
Chavara Thekkumbhagom	Villages in Kollam district
Agkistrodon contortrix	Snakes
Stendal	Towns in Saxony-Anhalt
Tale of Catfish and Toad	Vietnamese animated movies, 1990s animated movies‎
Tale of Gióng the Saint	Vietnamese animated movies, 1970 movies
Tale of moon rabbits	Vietnamese animated movies, 1960s movies
The babygirl and the flowerpot	Vietnamese animated movies, 1971 movies
The Welldeserved Fox	Vietnamese animated movies, 1959 movies
Hare and Wolf	Vietnamese animated movies, 1990s animated television series, 2000s animated television series
Republic of Vietnam Military Forces	History of Vietnam, Vietnam War, 1955 establishments in Asia, 1975 disestablishments
Pentti Siimes	1929 births, 2016 deaths, Finnish movie actors, People from Helsinki
Thread snake	Snakes
Ophidiophobia	Snakes, Phobias
Eric Swalwell	1980 births, Living people, 2020 United States presidential candidates, American lawyers, United States representatives from California, Politicians from Iowa, US Democratic Party politicians
Dil Se Dil Tak	2017 Indian television series debuts, Hindi-language television series, 2018 television series endings, 2018 disestablishments in India
Bengt Nilsson	1934 births, 2018 deaths, Swedish sportspeople, High jumpers, Olympians
Michael Slive	1940 births, 2018 deaths, Deaths from prostate cancer, American educators, American lawyers, Businesspeople from New York, Sportspeople from New York, People from Utica, New York
Utica, New York	Cities in New York, County seats in New York
State College, Pennsylvania	Boroughs in Pennsylvania
Bassetki	Archaeological sites in Iraq
Brahmagupta	590s births, 660s deaths, Indian mathematicians, Astronomers
Fuke Zen	Buddhism, Japan
Orrery	Scientific modeling, Machines, 1704
Clockwork	Motors, Clocks
Analogue computer	Computing, Engineering
Tiger keelback	Colubrids
Mike Braun	1954 births, Living people, United States senators from Indiana, Harvard University alumni, Businesspeople from Indiana, Politicians from Indiana, State legislators of the United States, US Republican Party politicians
Flying snake	Snakes
Adichanalloor	Villages in Kollam district
Alayamon	Villages in Kollam district
Dixon, California	1878 establishments in California, Cities in California, Cities in the San Francisco Bay Area, Settlements in Solano County, California
Malaise	Diseases and disorders, Emotions
Discovery Bay, California	Census-designated places in California, Settlements in Contra Costa County, California, Cities in the San Francisco Bay Area
Alberto Giacometti	1901 births, 1966 deaths, Swiss sculptors, Swiss painters, Graubünden, Printmakers
M46 Patton	Tanks
Salinas, California	1874 establishments in California, Cities in California, County seats in California, Settlements in Monterey County, California
Spes	Roman gods and goddesses
Egyptian Premier League	Football leagues, Sport in Egypt
Faiyum	Cities in Egypt
Donald Moffat	1930 births, 2018 deaths, Deaths from stroke, Cardiovascular disease deaths in New York, Naturalized citizens of the United States, English movie actors, English television actors, English stage actors, American movie actors, American television actors, American stage actors, Actors from Devon
Kenji Sahara	1932 births, Living people, Japanese movie actors
François de Candie	Nobility
House of Candia	Noble families
Mansoura, Egypt	Cities in Egypt, 1219 establishments, 13th-century establishments in Africa, Establishments in Egypt
Alimukku	Villages in Kollam district
Alumpeedika	Villages in Kollam district
Anchalumoodu	Villages in Kollam district
Tiger snake	Elapidae
Jasmine Thompson	2000 births, 2000 albums, Entertainers from London, Living people, English songwriters, English singers
Eduard Mudrik	1939 births, 2017 deaths, Soviet sportspeople, Sportspeople from Moscow, Russian footballers
Northern water snake	Snakes
Battle of Blair Mountain	Battles, Labor, 20th century in West Virginia, 1921 in the United States
Palamedes (video game)	1990 video games, Arcade games, Game Boy games, Nintendo Entertainment System games, Video games developed in Japan
Wallis and Futuna national football team	National football teams, Football in France, Wallis and Futuna
Monaco national football team	National football teams, Monaco
List of entries in the Eurovision Song Contest	Eurovision Song Contest, Music-related lists
Women in the American Revolution	American Revolutionary War, Women
Hugo Guerra	1966 births, 2018 deaths, Uruguayan footballers, Deaths from cardiac arrest
Guaviare Department	Departments of Colombia
Santa Fe High School shooting	2018 crimes in the United States, 2010s crimes in Texas, Mass shootings in Texas, Massacres in the United States, May 2018 events
Santa Fe, Texas	Cities in Texas
Razia Sultan	Hindi-language television series, Indian television series, 2015 Indian television series debuts, 2015 television series endings, 2010s disestablishments in India
Dimitrij Ovtcharov	1988 births, Living people, German table tennis players, Sportspeople from Kiev, Competitors at the 2016 Summer Olympics, Competitors at the 2012 Summer Olympics
The Lena Goldfield incident, 1912	1912, Siberia, 1910s in Russia
Lucian Pintilie	1933 births, 2018 deaths, Romanian movie directors, Romanian screenwriters, Romanian movie producers
Arackal	Villages in Kollam district
Aryankavu	Villages in Kollam district
Reckitt Benckiser	1999 establishments in the United Kingdom, Companies listed on the London Stock Exchange, Companies of the United Kingdom
Slough	Unitary authorities, Towns in Berkshire
Ayiranalloor	Villages in Kollam district
Edakkidom	Villages in Kollam district
Lake Morat	Lakes of Switzerland, Canton of Fribourg, Vaud
Edamon	Villages in Kollam district
Edamulackal	Villages in Kollam district
Elamad	Villages in Kollam district
Elampal	Villages in India
Elampalloor	Villages in Kollam district
Lake Onega	Lakes of Russia
Elikkattoor	Villages in Kollam district
Ezhukone	Villages in Kollam district
Flag of Connecticut	United States state flags, Connecticut
Flag of Nevada	United States state flags, Nevada
Harriet Bosse	1878 births, 1961 deaths, Norwegian movie actors, Norwegian stage actors, Actors from Oslo
Hereward the Wake	11th century, English people
Curtis Hanson	1945 births, 2016 deaths, Academy Award winning writers, Writers from Nevada, Writers from Los Angeles, California, Movie directors from Los Angeles, California, Deaths from dementia
Lincoln, Missouri	Cities in Missouri
Karlsruhe, North Dakota	Cities in North Dakota
Pleasanton, California	1890s establishments in California, 1894 establishments in the United States, Cities in California, Cities in the San Francisco Bay Area, Settlements in Alameda County, California
Juan de Pareja	Spanish painters, 1600s births, 1670 deaths
Guardafui Channel	Straits, Somalia
RATP Group	Paris, Public transport
Mohamed Barakat	1976 births, Egyptian footballers, Living people, Egypt international footballers
Ahmed Hassan	1975 births, Egyptian footballers, Living people, Egypt international footballers
Pitié-Salpêtrière Hospital	Buildings and structures in Paris, Hospitals in France
Ahmed El Sakka	1973 births, Living people, Egyptian actors, People from Cairo
Amr Waked	1973 births, Living people, People from Cairo
Cubana de Aviación Flight 972	2018 in North America, 2010s in Cuba, 2018 aviation disasters, May 2018 events
Amir Ganiel	1963 births, 2018 deaths, Jewish Israeli sportspeople, People from Jerusalem, Surgeons, Swimmers
François Bréda	1956 births, 2018 deaths, Romanian writers, Essayists, Poets, Critics, Romanian historians
Gérard Jouannest	1933 births, 2018 deaths, French composers, French pianists
Eloísa Mafalda	1924 births, 2018 deaths, Deaths from respiratory failure, Disease-related deaths in Brazil, Brazilian movie actors, Brazilian television actors
Diana E. Murphy	1934 births, 2018 deaths, Deaths from congestive heart failure, American judges, Politicians from Minnesota, US Democratic Party politicians, Women judges
Nicole Fontaine	1942 births, 2018 deaths, Former MEPs, French lawyers, MEPs for France, Presidents of the European Parliament
Klaus Hänsch	1938 births, Living people, MEPs for Germany, Presidents of the European Parliament
Boyan Petrov	1973 births, 2018 deaths, People declared dead in absentia, Bulgarian people, Mountain climbers, Zoologists
Mehdi Tabatabaei	1936 births, 2018 deaths, Deaths from lung disease, Iranian politicians
John Carrick	1918 births, 2018 deaths, Military personnel of World War II, Politicians from Sydney
Akhzivland	Micronations, Israel, 1971 establishments in Asia
Ayad Futayyih Al-Rawi	1942 births, 2018 deaths, Deaths from stroke, Iraqi politicians, Generals, Criminals
Voorhees Township, New Jersey	Townships in New Jersey
Faribault, Minnesota	Cities in Minnesota, County seats in Minnesota
Michael Luscombe	1953 births, 2018 deaths, Australian businesspeople, Deaths from Creutzfeldt–Jakob disease
Kristin Nelson	2018 deaths, 1945 births, Deaths from myocardial infarction, American movie actors, American television actors, American painters, Writers from Los Angeles County, California, Actors from Burbank, California
Harvey Hall	1941 births, 2018 deaths, Deaths from Creutzfeldt–Jakob disease, Disease-related deaths in California, American mayors, American philanthropists, Businesspeople from California, Politicians from California, People from Bakersfield, California, US Republican Party politicians
Maya Jribi	1960 births, 2018 deaths, Deaths from pancreatic cancer, Tunisian politicians
Reggie Lucas	1953 births, 2018 deaths, Cardiovascular disease deaths in New York City, American record producers, American songwriters, Grammy Award winners, Musicians from New York City, Businesspeople from New York City
Bobby Winkles	1930 births, 2020 deaths, Chicago White Sox, Oakland Athletics, American baseball players, Baseball coaches, Sportspeople from Arkansas, Sportspeople from Chicago
Petrissa Solja	1994 births, Living people, Sportswomen, German table tennis players, German Olympians
Tomokazu Harimoto	Living people, 2003 births, People from Sendai, Table tennis players
Afrojack	1987 births, Living people, DJs, Dutch musicians, Record producers
Types of buses	Buses
Nandi (bull)	Hindu mythology
Kenneth Baker, Baron Baker of Dorking	1934 births, Living people, British politicians
May Blood, Baroness Blood	1938 births, Living people, British politicians, People from Belfast
Elizabeth Butler-Sloss, Baroness Butler-Sloss	1933 births, Living people, British judges, English politicians, People from Buckinghamshire, Women judges
Jane Campbell, Baroness Campbell of Surbiton	1959 births, Living people, English activists, People with disabilities, Politicians from London
Audrey Emerton, Baroness Emerton	1935 births, Living people, British politicians
Trixie Gardner, Baroness Gardner of Parkes	1927 births, Living people, Australian politicians, British politicians
Llin Golding, Baroness Golding	1933 births, Living people, British politicians
Elspeth Howe	1932 births, Living people, British politicians
Rosalind Howells, Baroness Howells of St Davids	1931 births, Living people, Grenadian people, British politicians, British educators
Malamel	Villages in Kollam district
Joan Seccombe, Baroness Seccombe	1930 births, Living people, British politicians
Martin Hoffman	1929 births, 2018 deaths, British Jews, British sportspeople, Contract bridge players, Czech Jews, Czechoslovak people, Holocaust survivors, Jewish sportspeople, Naturalised citizens of the United Kingdom, Sportspeople from Prague
Eastern hognose snake	Colubrids
Billy Cannon	1937 births, 2018 deaths, Oakland Raiders players, Tennessee Titans players, Kansas City Chiefs players, Sportspeople from Mississippi, Sportspeople from Louisiana, Heisman Trophy winners
St. Francisville, Louisiana	Towns in Louisiana, Parish seats in Louisiana
2019–20 UEFA Champions League	UEFA Champions League seasons
Jaroslav Brabec	1949 births, 2018 deaths, Czech sportspeople, Olympians, People from Prague
Yan An	1993 births, Living people, Chinese table tennis players
Terence Higgins, Baron Higgins	1928 births, Living people, British politicians, British sportspeople
Rodney Elton, 2nd Baron Elton	1930 births, Living people, British politicians
Robin Eames	1936 births, Living people, Anglican archbishops, Anglican priests, British Anglicans, British priests, Northern Irish Christians, People from Belfast
Robert Dixon-Smith, Baron Dixon-Smith	1934 births, Living people, British politicians
Simon Brown, Baron Brown of Eaton-under-Heywood	1937 births, Living people, British politicians, British lawyers
Michael Brougham, 5th Baron Brougham and Vaux	1938 births, Living people, British politicians
William Bradshaw, Baron Bradshaw	1936 births, Living people, British politicians
Alec Broers, Baron Broers	Living people, 1938 births, British engineers
Robert Armstrong, Baron Armstrong of Ilminster	1927 births, 2020 deaths, British politicians
Robert Hughes, Baron Hughes of Woodside	1932 births, Living people, British politicians, British activists
Garry's Mod	Shooter video games
Post-credits scene	Movie industry
Nu-Venture	Bus transport
San Leandro, California	1870s establishments in California, 1872 establishments in the United States, Cities in California, Cities in the San Francisco Bay Area, Settlements in Alameda County, California
Old Greenwich, Connecticut	Census-designated places in Connecticut
Muqtada al-Sadr	1973 births, Living people, Iraqi politicians, Military people, Political activists, Communists
John Milnor	Fields Medalists, Wolf Prize winners, Abel Prize winners, 1931 births, Living people, American mathematicians, American educators, Writers from New Jersey, Scientists from New Jersey, People from Orange, New Jersey
Abel Prize	Abel Prize
Wolf Prize	Awards, Israeli culture
Jean-Pierre Serre	Wolf Prize winners, Fields Medalists, Abel Prize winners, 1926 births, Living people, French mathematicians
Michael Atiyah	Abel Prize winners, Fields Medalists, 1929 births, 2019 deaths, English mathematicians, Scientists from London
Yves Meyer	French mathematicians, Abel Prize winners, 1939 births, Living people
Isadore Singer	1924 births, 2021 deaths, Abel Prize winners, American mathematicians, Scientists from Detroit, Michigan
Lennart Carleson	Living people, 1928 births, Wolf Prize winners, Abel Prize winners, Mathematicians, Scientists from Stockholm
Zendaya	1996 births, Living people, African American actors, American child singers, Actors from Oakland, California, American child actors, American movie actors, American pop musicians, American R&B singers, American television actors, Emmy Award winning actors, American video game actors
S. R. Srinivasa Varadhan	1940 births, Living people, Naturalized citizens of the United States, Indian mathematicians, American mathematicians, Abel Prize winners
John G. Thompson	1932 births, Living people, American mathematicians, Wolf Prize winners, Fields Medalists, Abel Prize winners, Scientists from Kansas
Jacques Tits	1930 births, Living people, Belgian scientists, Mathematicians, Abel Prize winners
Mikhail Leonidovich Gromov	1943 births, Living people, Jewish Wolf Prize winners, Abel Prize winners, Russian mathematicians, American Jews, American mathematicians, Naturalized citizens of the United States
John Tate	1925 births, 2019 deaths, Abel Prize winners, Wolf Prize winners, Harvard University alumni, Princeton University alumni, American mathematicians, Writers from Minneapolis, Minnesota, Harvard University faculty
Endre Szemerédi	1940 births, Living people, Abel Prize winners, Naturalized citizens of the United States, Hungarian scientists, American mathematicians, People from Budapest
Sir Des Champs	2006 births, 2018 deaths, Deaths in sport, Racehorses
Ernst Sieber	1927 births, 2018 deaths, Swiss politicians, Swiss philanthropists
Koo Bon-moo	1945 births, 2018 deaths, Deaths from brain cancer, South Korean businesspeople
2016 Pacific hurricane season	2016 in weather, Pacific hurricane seasons
John Spencer, 8th Earl Spencer	1924 births, 1992 deaths, Deaths from myocardial infarction, People from London
Wang Qishan	1948 births, Living people, Vice presidents, Chinese politicians, Communists, Mayors, People from Beijing
2018 FIFA World Cup knockout stage	2018 FIFA World Cup, 2018 in Russia
Petru Pascari	1929 births, Living people, Prime ministers, Moldovan people, Soviet politicians
Jim Taylor	1935 births, 2018 deaths, Businesspeople from Louisiana, Green Bay Packers players, New Orleans Saints players, Sportspeople from Louisiana, People from Baton Rouge, Louisiana
Hugh McElhenny	1928 births, Living people, San Francisco 49ers players, New York Giants players, Detroit Lions players, Minnesota Vikings players, Sportspeople from Los Angeles, California
John Brodie	1935 births, Living people, San Francisco 49ers players, American golfers, American television presenters, Sportspeople from California
2018 FIFA World Cup Group A	2018 FIFA World Cup
2018 FIFA World Cup Group B	2018 FIFA World Cup
2018 FIFA World Cup Group C	2018 FIFA World Cup
2018 FIFA World Cup Group D	2018 FIFA World Cup
2018 FIFA World Cup Group E	2018 FIFA World Cup
2018 FIFA World Cup Group F	2018 FIFA World Cup
Hiss	Animal communication, Snakes
2018 FIFA World Cup Group G	2018 FIFA World Cup
2018 FIFA World Cup Group H	2018 FIFA World Cup
Malumel	Villages in Kollam district
Fatima (given name)	Given names
Manampuzha	Villages in Kollam district
Axa	1816 establishments in Europe, 19th century establishments in France, Companies of France, Insurance companies, Paris
2018 FIFA World Cup seeding	2018 FIFA World Cup, Moscow, 2018 in Russia
Fujitsu	1935 establishments in Japan, Technology companies of Japan, Electronics companies, Companies listed on the Tokyo Stock Exchange
2018–19 UEFA Champions League group stage	2018–19 UEFA Champions League
National City, California	1868 establishments in California, 1887 establishments in California, Cities in California, Settlements in San Diego County, California
List of Coronation Street characters	Lists of television characters, British soap operas, Television lists, Coronation Street, Greater Manchester
La Mesa, California	1912 establishments in California, Cities in California, Settlements in San Diego County, California
Flag of Northern Ireland	National flags, Northern Ireland, Flags of the United Kingdom
Time in Switzerland	Time by country, Switzerland
T. H. White	1906 births, 1964 deaths, Deaths from heart failure, English historians, English novelists, English science fiction writers, People from Bombay
Edith Wharton	1862 births, 1937 deaths, Deaths from stroke, Deaths from myocardial infarction, American historians, American novelists, Writers from New York City
Yrsa Stenius	1945 births, 2018 deaths, Swedish journalists, People from Helsinki
Roland Vogt	1941 births, 2018 deaths, German politicians
Richard N. Goodwin	1931 births, 2018 deaths, Cancer deaths in Massachusetts, American political writers, Politicians from Boston, Massachusetts, Writers from Boston, Massachusetts
António Arnault	1936 births, 2018 deaths, Portuguese politicians, Civil servants, Portuguese writers, Portuguese lawyers, Essayists
Dovey Johnson Roundtree	1914 births, 2018 deaths, American centenarians, American civil rights activists, American lawyers, Businesspeople from Charlotte, North Carolina
Anna Maria Ferrero	1934 births, 2018 deaths, Italian movie actors, Actors from Rome
Jean Sorel	1934 births, Living people, French movie actors, French television actors, French stage actors, Actors from Marseille
The Day of the Jackal (movie)	1973 thriller movies, British thriller movies, French thriller movies, Movies based on books, Movies directed by Fred Zinnemann, Political movies
Hydrofluorocarbon	Chemical compounds, Atmosphere
Antaeus Group	1990s establishments in China, 1992 establishments in Asia, Companies of China
2018–19 UEFA Champions League	2018–19 UEFA Champions League, August 2018 events, July 2018 events, June 2018 events
Management buyout	Finance, Management
Mancode	Villages in Kollam district
Mathra	Villages in Kollam district
WeberHaus	Companies of Germany
Mayyanad	Villages in Kollam district
Meenad	Villages in Kollam district
Timo Boll	Living people, 1981 births, German table tennis players, People from Düsseldorf, German Olympic bronze medalists, German Olympic silver medalists
Jack Günthard	1920 births, 2016 deaths, Gymnasts, Medalists at the 1952 Summer Olympics, Swiss Olympic medalists, Olympic gold medalists, Olympic silver medalists
Marks & Spencer	Companies listed on the London Stock Exchange, Supermarkets of the United Kingdom, 1884 establishments in the United Kingdom
General Data Protection Regulation	European Union, Law
Alberto Dines	1932 births, 2018 deaths, Deaths from pneumonia, Brazilian writers, Brazilian journalists, Brazilian educators, People from Rio de Janeiro
James, Viscount Severn	2007 births, Living people, British royalty, House of Windsor, People from Surrey
Júlio Pomar	1926 births, 2018 deaths, Portuguese painters, Illustrators, People from Lisbon
President of Venezuela	Presidents of Venezuela
Blue Edwards	1965 births, Living people, African-American basketball players, Sportspeople from North Carolina, Sportspeople from Washington, D.C., Boston Celtics players, Miami Heat players, Milwaukee Bucks players, Utah Jazz players, Vancouver Grizzlies players, American basketball players
13 Reasons Why	2010s American drama television series, American teen drama television series, LGBT drama television series, Rape in fiction, Netflix original shows, English-language television programs
John Hasler	1974 births, Living people, Actors from London, English child actors, English movie actors, English television actors, English voice actors
Faith Whittlesey	1939 births, 2018 deaths, Cancer deaths in Washington, D.C., State legislators of the United States, Ambassadors of the United States, Politicians from New Jersey, Politicians from Pennsylvania, Politicians from Washington, D.C., People from Jersey City, New Jersey, US Republican Party politicians
Hartford, Illinois	Villages in Illinois
Erik Lidbom	Living people, Swedish people, Songwriters
Purple music	Vietnamese music
Ampharos	Pokémon monsters
Paul Bogle	Jamaican people
Prime Minister of Jamaica	Prime Ministers of Jamaica
Spanish Town	Towns in Jamaica, 1534 establishments, 1530s establishments in North America, Establishments in Jamaica
Palmar plate	Limbs and extremities
Metacarpophalangeal joint	Limbs and extremities
Alpine fault	New Zealand, Plate tectonics
Arianrhod	Gods and goddesses, Welsh culture
Vice President of South Sudan	South Sudan, Vice presidents
Taban Deng Gai	South Sudan, Vice presidents, African politicians, Living people, Year of birth missing (living people), South Sudanese people
List of Walt Disney Animation Studios films	Lists of movies, Disney animated movies
Human reproduction	Biological reproduction
Gigantspinosaurus	Stegosaurs, Jurassic dinosaurs
Lophorhothon	Hadrosauridae, Cretaceous dinosaurs
Nipah virus disease	Infectious diseases, Diseases caused by viruses
Assassination of Mahatma Gandhi	Assassinations, January events, 1948 in Asia, 1940s in India
Tsintaosaurus	Hadrosauridae, Cretaceous dinosaurs
Back to You (Selena Gomez song)	2018 songs, Selena Gomez songs
Donji Kraji	History of Bosnia and Herzegovina, Regions of Europe
Joseph G. Clemons	1928 births, 2018 deaths, Deaths from pneumonia, American military personnel of the Vietnam War, People from Cleveland, Ohio
Doğan Babacan	1929 births, 2018 deaths, Turkish sportspeople, People from Istanbul
Rolf Sand	1920 births, 2018 deaths, Norwegian movie actors, Norwegian television actors, Norwegian stage actors, Actors from Oslo
Luis Posada Carriles	1928 births, 2018 deaths, Deaths from throat cancer, Cancer deaths in Florida, Spies, Anti-Communists, Cuban military people
Kings XI Punjab in 2008	Kings XI Punjab, 2008 in sports, 2008 in India
Kings XI Punjab in 2014	Kings XI Punjab, 2014 in sports, 2014 in India
Antipyretic	Analgesics, Biochemistry, Pharmacology
Adamantisaurus	Titanosaurs, Cretaceous dinosaurs
Daniel Robin	1943 births, 2018 deaths, Wrestlers, French Olympians, 1972 Summer Olympics, Medalists at the 1968 Summer Olympics
Feng Tianwei	Singaporean people, 1986 births, Olympic medalists, Table tennis players, Living people
Kem Ley	1970 births, 2016 deaths, Cambodian people, Assassinated people, Human rights activists, Physicians, Deaths by firearm, Murder victims
2018–19 UEFA Europa League	2018–19 UEFA Europa League, 2018–19 in UEFA football
Borut Pahor	1963 births, Living people, Presidents of Slovenia, Prime Ministers of Slovenia, Members of the European Parliament, Current national leaders
Helen Dixon	Irish people, Year of birth missing (living people)
2018–19 UEFA Europa League group stage	2018–19 UEFA Europa League, 2018 in sports, Sport in Europe
Guy Verhofstadt	1953 births, Living people, Brexit, Flemish politicians, Government ministers of Belgium, MEPs for Belgium, Open Vlaamse Liberalen en Democraten politicians, People from East Flanders, Prime Ministers of Belgium
London Wall	City of London, Roman Empire
Mahmoud Hassan (footballer)	1994 births, Egyptian footballers, Living people, Egypt international footballers
Computer terminal	Computer hardware
Saad Samir	1989 births, Egyptian footballers, Living people, Egypt international footballers
Basem Morsy	1992 births, Egyptian footballers, Living people, Egypt international footballers
Melila	Villages in Kollam district
Mylakkadu	Villages in Kollam district
Mylom	Villages in Kollam district
2018 UEFA Super Cup	UEFA Super Cup, 2018–19 in UEFA football, 2018 in association football, August 2018 events, Sport in Estonia, Tallinn
Four (One Direction album)	One Direction albums
Lovelace (movie)	2010s biographical movies, 2013 drama movies, American biographical movies, American drama movies, American independent movies
2017–18 UEFA Champions League knockout phase	UEFA Champions League, 2018 in association football, 2017 in association football, 2018 in Europe, 2017 in Europe
Omoyele Sowore	1971 births, Living people
Grace Dieu (ship)	Ships
Presque Isle Air Force Base	Buildings and structures in Maine, 1961 disestablishments, 1960s disestablishments in the United States
Hosur	Krishnagiri district
Vikramasingapuram	Tirunelveli District
Messina FC	Italian football clubs, 1900 establishments in Italy, 1997 disestablishments in Europe, 1990s disestablishments in Italy
Sayed Moawad	1979 births, Egyptian footballers, Living people, Egypt international footballers
Amr Warda	1993 births, Egyptian footballers, Living people, Egypt international footballers
Tarek Hamed	1988 births, Egyptian footballers, Living people, Egypt international footballers
Bioaccumulation	Ecology, Environmental chemistry
Evelyn Omavowan Oboro	Nigerian politicians, 1972 births
Alesso	1991 births, Living people, Swedish record producers, DJs
It's Like That	Mariah Carey songs, Electronic music, R&B songs, 2005 songs
Form taxon	Taxonomy
Neutron moderator	Nuclear physics
Svetlin Rusev	1933 births, 2018 deaths, Bulgarian people, Artists
Bonnie Somerville	1974 births, Living people, American movie actors, American television actors, American voice actors, Singers from New York City, Actors from New York City
Roger Piantoni	1931 births, 2018 deaths, French footballers
Wheeler, Texas	Cities in Texas, County seats in Texas
Naser Malek Motiei	1930 births, 2018 deaths, Deaths from renal failure, Movie actors, Television actors, People from Tehran
Dominique Colonna	1928 births, Living people, French footballers, French football managers
Piet Kee	1927 births, 2018 deaths, Dutch composers, Dutch musicians, Organists, People from Zaanstad
TotalBiscuit	1984 births, 2018 deaths, Deaths from colorectal cancer, Internet celebrities, YouTube, Critics, Activists, British people
Roblimo	1952 births, 2018 deaths, Deaths from myocardial infarction, Cardiovascular disease deaths in Florida, American journalists, Writers from Maryland, Writers from Florida
Elkridge, Maryland	Unincorporated communities in Maryland, Census-designated places in Maryland
Daniela Samulski	1984 births, 2018 deaths, Deaths from stomach cancer, Cancer deaths in Germany, German Olympians, German swimmers, Sportspeople from Berlin
Richard Peck	1934 births, 2018 deaths, Cancer deaths in New York City, American children's writers, American novelists, Writers from Chicago
Cliff Jackson (footballer)	1941 births, 2018 deaths, English footballers, People from Swindon, Association football forwards, Crystal Palace F.C. players
Over the Edge (1999)	World Wrestling Entertainment pay-per-view events, 1999 in the United States, 1990s in Missouri
László Tábori	1931 births, 2018 deaths, Hungarian sportspeople, American Olympians, Naturalized citizens of the United States, Sportspeople from Los Angeles, California
WTTW	American television stations, Chicago, Illinois
Antonio Horvath	1950 births, 2018 deaths, Deaths from lymphoma, Chilean politicians, People from Santiago
Sergio Graziani	1930 births, 2018 deaths, Italian actors, Italian voice actors, People from Udine
Eric McLuhan	1941 births, 2018 deaths, Deaths from cardiac arrest, Canadian critics, Canadian educators, Ecologists
Balkavi Bairagi	1931 births, 2018 deaths, Deaths from myocardial infarction, Indian politicians, Indian poets
Ted Dabney	1937 births, 2018 deaths, Deaths from esophageal cancer, Cancer deaths in Los Angeles, Engineers from California, Businesspeople from San Francisco
Clearfield, Utah	Cities in Utah
Larry Leach	1936 births, 2018 deaths, Boston Bruins players, Canadian ice hockey centres, Sportspeople from Saskatchewan
Sheldon Adelson	1933 births, 2021 deaths, American philanthropists, American billionaires, Businesspeople from Boston, Massachusetts, Businesspeople from Las Vegas, Nevada, Republicans (United States), Deaths from non-Hodgkin lymphoma
James Patterson	1947 births, Living people, American novelists, American children's writers, American philanthropists, Writers from New York, Businesspeople from New York
Heavy water	Water, Nuclear physics
Mahomet, Illinois	Towns in Illinois
Harry Kane	1993 births, English footballers, Living people, 2018 FIFA World Cup players, People from Waltham Forest (London borough), Sportspeople from London, Tottenham Hotspur F.C. players, UEFA Euro 2016 players, Premier League players
God's Plan (song)	Drake songs, 2018 songs, Hip hop songs
Pathetic fallacy	Literary terms
Bank One Ballpark	Sports in Phoenix, Arizona, 1998 establishments in the United States, 1990s establishments in Arizona, 2005 disestablishments in the United States, 2000s disestablishments in Arizona
Glendale Arena	Buildings and structures in Arizona, 2003 establishments in Arizona, 2007 disestablishments in the United States, 2000s disestablishments in Arizona
Professor Farnsworth	Fictional characters introduced in 1999, Futurama characters
Pierre Bellemare	1929 births, 2018 deaths, French movie actors, French television actors, French voice actors, French novelists, French television presenters, French radio personalities, French movie producers, French movie directors
Dick Quax	1948 births, 2018 deaths, Deaths from throat cancer, New Zealand politicians, New Zealand sportspeople, Olympic silver medalists, People from Alkmaar, Sportspeople from North Holland
Train to Busan	South Korean movies, Zombie movies, Action thriller movies, 2016 movies, Apocalyptic movies
Gong Yoo	1979 births, Living people, South Korean actors, South Korean models, People from Busan
Jung Yu-mi	1983 births, Living people, South Korean actors, People from Busan
Kim Su-an	2006 births, Living people, South Korean actors, Child actors
Choi Woo-shik	1990 births, Living people, South Korean actors, People from Seoul
Ahn So-hee	1992 births, Living people, South Korean actors, South Korean singers, People from Seoul
Ma Dong-seok	1971 births, Living people, American movie actors, American television actors, South Korean actors
Kim Eui-sung	1965 births, Living people, South Korean actors
Quaternary sector	Economies by country
Kyocera Arena	2005 establishments in South America, 2000s establishments in Brazil, 2008 disestablishments, Disestablishments in Brazil
United Independent Broadcasters	Columbia Broadcasting System, Viacom, 1927 establishments in the United States, 1920s disestablishments in the United States, 1927 disestablishments
Columbia Phonographic Broadcasting System	Columbia Broadcasting System, Viacom, 1927 establishments in the United States, 1920s disestablishments in the United States, 1928 disestablishments
Georgetown College (Georgetown University)	1789 establishments in the United States, 18th-century establishments in Washington, D.C.
Racial profiling	Police, Law, Race
Australian Broadcasting Company	1923 establishments in Oceania, 1920s establishments in Australia, 1932 disestablishments, 1930s disestablishments in Australia
Australian Broadcasting Commission	1932 establishments, 1930s establishments in Australia, 1983 disestablishments, 1980s disestablishments in Australia
Bola Ige	2001 deaths
Bagualosaurus	Sauropods, Saurischia, Triassic dinosaurs, Dinosaurs of South America, Fossil taxa described in 2018
Darwinsaurus	Cretaceous dinosaurs, Ornithopods
Hypselospinus	Cretaceous dinosaurs, Ornithopods
Carnelian	Minerals, Gemstones
Aly Lotfy Mahmoud	1935 births, 2018 deaths, Prime Ministers of Egypt
Ahmed Shafik	1941 births, Living people, Prime Ministers of Egypt, People from Cairo
Prime Minister of Egypt	Prime Ministers of Egypt
Sherif Ismail	1955 births, Living people, Engineers, Prime Ministers of Egypt, People from Cairo
Ahmed Nazif	1952 births, Living people, Prime Ministers of Egypt, People from Cairo
Ibrahim Mahlab	1949 births, Living people, Prime Ministers of Egypt
Allyn Ann McLerie	1926 births, 2018 deaths, Deaths from Alzheimer's disease, Naturalized citizens of the United States, Canadian movie actors, Canadian television actors, Canadian stage actors, Canadian singers, American movie actors, American television actors, American stage actors, American dancers, Actors from Quebec, Actors from Brooklyn, Singers from New York City
North Bend, Washington	Cities in Washington (U.S. state)
Algoa Bay	Bays, Geography of South Africa
Ceratopsidae	Ceratopsia, Cretaceous dinosaurs
Aeolosaurus	Cretaceous dinosaurs, Sauropods
Agilisaurus	Ornithopods, Jurassic dinosaurs
Agujaceratops	Ceratopsia, Cretaceous dinosaurs
Alaskacephale	Cretaceous dinosaurs
Albisaurus	Archosaurs
Alectrosaurus	Cretaceous dinosaurs, Theropods
1984 Carolinas tornado outbreak	Tornadoes in the United States, 1984 in the United States, 1980s in North Carolina, 20th century in South Carolina
1988 Raleigh tornado	Tornadoes in the United States, 1988 in the United States, 1980s in North Carolina
Pippo Caruso	1935 births, 2018 deaths, Italian composers, Conductors
Serge Dassault	1925 births, 2018 deaths, Deaths from myocardial infarction, Cardiovascular disease deaths in France, Billionaires, French businesspeople, Politicians from Paris
Neale Cooper	1963 births, 2018 deaths, Deaths from cardiac arrest, Scottish footballers, Scottish football managers, People from Aberdeen
President of Egypt	Presidents of Egypt
Prime Minister of Sweden	Prime Ministers of Sweden
Prime Minister of Norway	Prime Ministers of Norway
Kjell Magne Bondevik	1947 births, Living people, Prime Ministers of Norway
António Costa	1961 births, Living people, Prime Ministers of Portugal, Mayors, People from Lisbon, Current national leaders
Prime Minister of Portugal	Prime Ministers of Portugal
Francisco Pinto Balsemão	1937 births, Living people, Portuguese businesspeople, Journalists, People from Lisbon, Prime Ministers of Portugal
Rodney Frelinghuysen	1946 births, Living people, United States representatives from New Jersey, Politicians from New York City, US Republican Party politicians
Hal Rogers	1937 births, Living people, American lawyers, United States representatives from Kentucky, US Republican Party politicians
Dave Obey	1938 births, Living people, United States representatives from Wisconsin, Politicians from Oklahoma, US Democratic Party politicians
Jerry Lewis (California politician)	1934 births, 2021 deaths, United States representatives from California, Politicians from Seattle, Washington, US Republican Party politicians
Dick Gephardt	1941 births, Living people, United States representatives from Missouri, 1988 United States presidential candidates, 2004 United States presidential candidates, Businesspeople from St. Louis, Missouri, Politicians from St. Louis, Missouri, US Democratic Party politicians, Majority leaders of the United States House of Representatives, Minority leaders of the United States House of Representatives
President of Portugal	Presidents of Portugal
Brown School	1838 establishments in the United States, 1830s establishments in North Carolina, 1841 disestablishments, 19th-century disestablishments in North Carolina, 1840s disestablishments in the United States
Jorge Sampaio	1939 births, 2021 deaths, Deaths from respiratory failure, Presidents of Portugal, Mayors, Portuguese lawyers, People from Lisbon
Athol Fugard	1932 births, Living people, South African actors, South African writers, Activists, Political writers, Playwrights, Novelists, Educators
Union Institute	1841 establishments in the United States, 1840s establishments in North Carolina, 1851 disestablishments, 19th-century disestablishments in North Carolina, 1850s disestablishments in the United States
Normal College	1851 establishments in the United States, 19th-century establishments in North Carolina, 1859 disestablishments, 19th-century disestablishments in North Carolina, 1850s disestablishments in the United States
Trinity College (Duke)	1859 establishments in North Carolina, 20th-century disestablishments in North Carolina, 1924 disestablishments in the United States
Matra Racing	French football clubs, 1987 establishments in France, 1989 disestablishments in Europe, 1980s disestablishments in France
Justin Moore	Republicans (United States), American country singers, American singer-songwriters, American country guitarists, Musicians from Arkansas, Singers from Arkansas, Writers from Arkansas, Living people, 1984 births
Cornelia Frances	1941 births, 2018 deaths, Deaths from bladder cancer, Cancer deaths in Sydney, English movie actors, English television actors, English stage actors, English voice actors, Australian movie actors, Australian television actors, Australian stage actors, Australian voice actors, Actors from Liverpool, Actors from Sydney
Donald H. Peterson	1933 births, 2018 deaths, Deaths from Alzheimer's disease, Deaths from bone cancer, Disease-related deaths in Texas, Cancer deaths in Texas, American astronauts, American military people, Scientists from Mississippi, People from Winona, Mississippi
Winona, Mississippi	Cities in Mississippi, County seats in Mississippi
Mainichi Orions	1950 establishments in Japan, 1958 disestablishments, 1950s disestablishments in Asia, 20th century disestablishments in Japan
Like I Love You	2002 songs
Daimai Orions	1958 establishments in Asia, 1950s establishments in Japan, 1964 disestablishments, 1960s disestablishments in Asia, 20th century disestablishments in Japan
Tokyo Orions	1964 establishments in Asia, 1960s establishments in Japan, 1969 disestablishments, 1960s disestablishments in Asia, 20th century disestablishments in Japan
Lotte Orions	1969 establishments in Asia, 1960s establishments in Japan, 1992 disestablishments in Japan
Taiheiyo Baseball Union	1949 establishments in Asia, 1940s establishments in Japan, 1980 disestablishments, 1980s disestablishments in Asia, 20th century disestablishments in Japan
Serpent (musical instrument)	Musical instruments
Niigata Eleven S.C.	1955 establishments in Japan, 1994 disestablishments, 1990s disestablishments in Japan
Albireo Niigata F.C.	1995 establishments in Japan, 1996 disestablishments, 1990s disestablishments in Japan
Fujitsu S.C.	1955 establishments in Japan, 1995 disestablishments, 1990s disestablishments in Japan
Xbox	Xbox
2017–18 UEFA Europa League knockout phase	2017–18 UEFA Europa League
Arrow's impossibility theorem	Economics
2018 Liège attack	2018 crimes in Europe, 2010s in Belgium, 2010s murders in Europe, Islamic terrorist incidents in Europe, May 2018 events, Murder in 2018, Murders by blade weapons, Murders by firearm, Terrorist incidents in 2018
Stranger than Fiction (2006 movie)	2000s fantasy movies, 2006 comedy-drama movies, American fantasy movies, American comedy-drama movies, Movies shot in Chicago, Illinois, Movies set in Chicago, Illinois, English-language movies, Columbia Pictures movies, Movies directed by Marc Forster
Rifat Hadžiselimović	1944 births, Living people, Geneticists, Bosnia and Herzegovina scientists
Mike Parson	1955 births, Living people, American military people, Governors of Missouri, US Republican Party politicians, Lieutenant Governors of Missouri
Chicago Outfit	Criminals from Chicago, 20th century in Chicago
Eduardo López de Romaña	1847 births, 1912 deaths, Presidents of Peru
Oobi	English-language television programs
Tim Lagasse	1969 births, American entertainers, Puppeteers, People from Milford, Connecticut, Living people
Otto von Guericke	1602 births, 1686 deaths, German physicists, German writers, German politicians
Hamlet chicken processing plant fire	1991 in the United States, 1990s in North Carolina, Building and structure fires, Disasters in the 1990s, Fires in the United States, September events
Madiha Yousri	1921 births, 2018 deaths, Deaths from cardiovascular disease, Egyptian actors, People from Cairo
Jürgen Marcus	1948 births, 2018 deaths, Deaths from COPD, Disease-related deaths in Germany, German singers, Eurovision Song Contest entrants
Yoseph Imry	1939 births, 2018 deaths, Hebrew University of Jerusalem alumni, Israeli academics, Israeli Jews, Israeli scientists, Jewish academics, Jewish scientists, Jewish Wolf Prize winners, People from Tel Aviv, Physicists
Semavi Eyice	People from Istanbul, 1922 births, 2018 deaths, Archaeologists, Turkish historians, Turkish educators
Arkady Babchenko	1977 births, Living people, Russian journalists, Critics, Political writers, Writers from Moscow
Joseph Lombardo	1929 births, 2019 deaths, People convicted of manslaughter, Chicago Outfit mobsters, Criminals from Chicago
Joseph Andriacchi	1932 births, Living people, Chicago Outfit mobsters, Criminals from Chicago
Peter DiFronzo	1933 births, 2020 deaths, Chicago Outfit mobsters, Criminals from Chicago, Deaths from the COVID-19 pandemic in the United States, Deaths from pneumonia
John DiFronzo	1928 births, 2018 deaths, Deaths from Alzheimer's disease, Disease-related deaths in Illinois, Mobsters, Chicago Outfit mobsters
Sam Giancana	1908 births, 1975 deaths, Murders by firearm in the United States, Burials at Mount Carmel Cemetery (Hillside), Chicago Outfit mobsters, Assassinated people
Mostafa Fathi	1994 births, Egyptian footballers, Living people
Antonio Pujía	1929 births, 2018 deaths, Deaths from colorectal cancer, Cancer deaths in Argentina, Italian educators, Italian sculptors, Argentine sculptors
Webster, Texas	Cities in Texas
Haskell, Texas	Cities in Texas, County seats in Texas
2018 UEFA Europa League Final	2017–18 UEFA Europa League
El Lago, Texas	Cities in Texas
Eric Sevareid	Peabody Award winners, Emmy Award winners, 1912 births, 1992 deaths, Deaths from stomach cancer, Cancer deaths in Washington, D.C., American television presenters, American novelists, Writers from North Dakota, Writers from Minnesota, Journalists from Minnesota
Columbia Heights, Minnesota	Cities in Minnesota
Velva, North Dakota	Cities in North Dakota, 1897 establishments in the United States, 1890s establishments in North Dakota
2017–18 UEFA Europa League	2017–18 UEFA Europa League, 2017–18 in UEFA football
Latchkey kid	Childhood, Family
Seattle–Tacoma International Airport	Airports in the United States, Buildings and structures in Washington, Transport in Washington
Pontiac's War	1760s in the Thirteen Colonies
Interbank Card Association	1966 establishments in the United States, 1960s establishments in New York (state), 1979 disestablishments in the United States, 1970s disestablishments in New York (state)
Google Assistant	Google, Artificial intelligence, Software
Gillespie Road station	Railway stations opened in 1906, 1906 establishments in England, 1932 disestablishments, 1930s disestablishments in England
Deaths in June 2018	2018 deaths, June 2018 events
Michel Stolker	1933 births, 2018, Deaths from hypertension, Dutch cyclists, Sportspeople from Utrecht (city)
Jan Janssen	1940 births, Living people, Dutch cyclists, Dutch Olympians, Sportspeople from South Holland, Tour de France winners
Navy Goal 2030	Bangladesh, Navies
2017–18 UEFA Europa League group stage	2017–18 UEFA Europa League
Hosny Abd Rabo	1984 births, Egyptian footballers, Living people, Egypt international footballers
Great Western Trains	1996 establishments in England, 1998 disestablishments, 1990s disestablishments in England
Los Supergenios de la Mesa Cuadrada	1968 establishments, 1960s establishments in Mexico, 1970 disestablishments, 1970s disestablishments in North America, 20th century disestablishments in Mexico
Chespirito y la Mesa Cuadrada	1970 establishments in North America, 1970s establishments in Mexico, 1971 disestablishments, 1970s disestablishments in North America, 20th century disestablishments in Mexico
Nidda (river)	Rivers of Germany, Geography of Hesse
Sando Gali	Settlements in Pakistan
Mohamed El-Shenawy	1988 births, Egyptian footballers, Living people, Egypt international footballers
Chuang Chih-Yuan	1981 births, Living people, Taiwanese people, Germany, Table tennis players, Competitors at the 2016 Summer Olympics, Competitors at the 2012 Summer Olympics
Hemet, California	1887 establishments in California, Cities in California, Settlements in Riverside County, California
Julian Sands	1958 births, English movie actors, English television actors, Living people, People from West Yorkshire
Colobops	Fossil taxa described in 2018, Archosaurs
Deinocheiridae	Cretaceous dinosaurs

