Ajaz Anwar	Pakistani painters, 1946 births, Living people
Lilo Pelekai	Animated characters, Disney characters, Fictional characters introduced in 2002, Lilo & Stitch
Thyreophora	Thyreophora
Knobbed whelk	Gastropods
Shasta County	Shasta County, California, 1850 establishments in California
Tehama County, California	Tehama County, California, 1856 establishments in California
Glenn County, California	Glenn County, California, 1891 establishments in California
Wells Fargo Plaza (Houston)	Buildings and structures in Houston, Texas, Skyscrapers in the United States, 1983 establishments in the United States, 1980s establishments in Texas
Comcast Center	Skyscrapers in the United States, Buildings and structures in Philadelphia, Pennsylvania
HCJB	Radio stations, Quito
Media studies	Media, Humanities, Social sciences, Interdisciplinary fields
Yosemite National Park	1890s establishments in California, 1890 establishments in the United States, National parks in the United States, World Heritage Sites in the United States, Wilderness Areas of the United States, Geography of California, Madera County, California, Mariposa County, California, Tuolumne County, California
Cliff	Landforms
Hurricane Bonnie (1998)	Hurricanes in the United States, 1998 in the United States, August events, 1990s in North Carolina, 20th century in Virginia
Tropical Storm Frances (1998)	Weather, Natural disasters in North America
Hurricane Georges	Hurricanes in the United States, 1998 in Florida, 20th century in Puerto Rico, 1990s in the Dominican Republic, 20th centuy in Haiti, 20th century in Cuba, 20th century in Mississippi, 1990s in Alabama, 20th century in Louisiana
Hurricane Mitch	1998 in Florida, 1990s in Mexico, Deadly storms, Category 5 Atlantic hurricanes, Hurricanes in Mexico, Hurricanes in the United States, 20th century in Belize, 20th century in Costa Rica, History of El Salvador, History of Honduras, 20th century in Jamaica, History of Nicaragua, 20th century in Panama, Hurricanes, Retired Atlantic Hurricanes
Georgy Zhukov	1896 births, 1974 deaths, Military personnel of World War I, Russian military people, Soviet generals, Soviet military personnel of World War II, Soviet politicians
Miacis	Fossils, Carnivora
Butte County, California	Butte County, California, 1850 establishments in California
California State Route 99	Roads in California, Central Valley of California, 1929 establishments in the United States, 1920s establishments in California
Pierce Brosnan	1953 births, Living people, Actors who played James Bond, American environmentalists, American movie actors, American movie producers, American stage actors, American television actors, American voice actors, Honorary Officers of the Order of the British Empire, Irish movie actors, Irish stage actors, Irish television actors, Irish voice actors, Naturalized citizens of the United States, People from County Louth
Daniel Craig	1968 births, Living people, Actors from Cheshire, Actors who played James Bond, English movie actors, English movie producers, English television actors, English voice actors, People from Chester
Bose–Einstein condensate	Quantum mechanics, States of matter
Coatbridge	Towns in North Lanarkshire
Formia	Cities in Lazio
Mrs Beeton	1836 births, 1865 deaths, British chefs, Disease-related deaths in England, Writers from London
Fleury-les-Aubrais	Communes in Loiret
South Region of Brazil	Regions of Brazil
Edmund Stoiber	1941 births, Living people, Ministers-President of Bavaria, Order of Merit of the Federal Republic of Germany, Politicians from Bavaria, Politicians of the Christian Social Union of Bavaria
California Aqueduct	Central Valley of California, Water infrastructure
Aqueduct	Water infrastructure
Orange County, California	1889 establishments in the United States, Orange County, California, 1880s establishments in California
České Budějovice	Cities in the Czech Republic
Karlovy Vary	Spa towns in the Czech Republic, Cities in the Czech Republic
Dracophyllum	Dracophyllum, Ericaceae
Dragonball Evolution	2009 movies, Chinese movies, American action movies, 20th Century Fox movies, Apocalyptic movies
Rikki-Tikki-Tavi	British short stories
5335 Damocles	Asteroids
Colusa County, California	1850 establishments in California, Colusa County, California
San Gabriel River	Rivers of Los Angeles County, California, Orange County, California
Los Angeles River	Rivers of Los Angeles County, California, Geography of Los Angeles, California
Fantasia (movie)	1940 movies, American family movies, American musical fantasy movies, Disney animated movies, English-language movies, Movies set in prehistory, Movies about animals, Movies about dinosaurs, United States National Film Registry movies
Santa Ana River	Rivers of Los Angeles County, California, San Bernardino County, California, Riverside County, California, Orange County, California
Aliso Creek	Rivers of California, Orange County, California
San Juan Creek	Rivers of California, Orange County, California
Bakersfield, California	Cities in the Central Valley of California, Bakersfield, California, County seats in California, 1873 establishments in the United States, 1870s establishments in California
Windows Mail	Microsoft software, E-mail
Chord progression	Music theory
Interstate 81	Interstate Highways
Twelvers	Islamic denominations
Interstate 91	Interstate Highways
Connecticut River	Springfield, Massachusetts, Rivers of Vermont, Geography of New Hampshire, Rivers of Connecticut, Geography of Massachusetts
Postage stamp block	Postage stamps
Great Basin	Western United States, Drainage basins
Bougainvillea	Caryophyllales
North Region of Brazil	Regions of Brazil
Northeast India	Northeast India
Hallertau	Geography of Bavaria
Conficker	Malware
Gilbertese language	Micronesian languages, Fiji, Kiribati, Nauru, Marshall Islands, Solomon Islands, Tuvalu, Vanuatu
Positivism	Philosophical movements and positions, Ethics
Norton Internet Security	Antivirus software
Ottauquechee River	Rivers of Vermont
San Diego Creek	Rivers of California, Orange County, California
Gateshead F.C.	English football clubs
Ragdoll Productions	1984 establishments in the United Kingdom, Companies of the United Kingdom, Television
Fun and Fancy Free	1947 movies, 1940s comedy movies, 1940s musical movies, American comedy movies, American family movies, American musical movies, Disney animated movies, Movies about animals, Movies composed by Oliver Wallace
Melody Time	1948 movies, Disney animated movies, English-language movies, American family movies, American musical movies, Movies composed by Oliver Wallace, American drama movies, 1940s comedy movies, Fantasy movies
Antimetabole	Linguistics
Karachi Division	Divisions of Sindh, Divisions of British India
Santa Margarita River	Rivers of California, Riverside County, California, San Diego County, California
Ray Comfort	1949 births, Living people, American Evangelicals, Christian ministers, Christian writers, Evangelists, Jewish American writers, Naturalized citizens of the United States, Oceanic Jews, People from Christchurch
Flaming Gorge Dam	Dams in the United States, Buildings and structures in Utah, 20th-century establishments in Utah
Salton Sea	Lakes of the United States, Bodies of water of California, Imperial County, California, Riverside County, California
Endorheic basin	Drainage basins, Lakes
Great Salt Lake	Lakes of the United States, Geography of Utah
Rainy Lake	Lakes of the United States, Lakes of Canada
Roy McKie	Year of birth missing (living people), American illustrators
Sika deer	Mammals of Asia
Tulsa Public Schools	Oklahoma, Stubs
Zenobia (plant)	Zenobia (Ericaceae), Ericaceae, Shrubs
Hyperbolic geometry	Geometry
Parallel postulate	Geometry
City of London School	1442 establishments, 1440s establishments in England, Schools in London
Pedro Antonio de Alarcón	Spanish writers, 1833 births, 1891 deaths
Bobby Moore	1941 births, 1993 deaths, 1962 FIFA World Cup players, 1966 FIFA World Cup players, 1970 FIFA World Cup players, Cancer deaths in England, Deaths from colorectal cancer, English footballers, English football managers, Sportspeople from Essex
Wat Tyler	1341 births, 1381 deaths, Deaths by blade weapons, Murder victims, People from Kent
San Juan Province (Dominican Republic)	Provinces of the Dominican Republic, 1938 establishments in the Dominican Republic
San Luis Rey River	Rivers of California, San Diego County, California
Forth Rail Bridge	Bridges in the United Kingdom, Steel bridges, Cantilever bridges, Buildings and structures in Scotland, 1890 establishments in the United Kingdom, 1890s establishments in Scotland
New River	Rivers of California, Rivers of Mexico, Imperial County, California
Gravitational wave	Relativity, Wave physics, Binary stars, Gravitation, Astrophysics
Silver Street railway station	Railway stations in Enfield, London Travelcard zone 3, Railway stations served by National Express East Anglia
Rock pigeon	Columbiformes
Twelfth Night	Plays by William Shakespeare
Hinckley	Towns in Leicestershire
Quokka	Macropods, Marsupials of Australia
Salzburgerland	Salzburgerland
A Mathematician's Apology	Non-fiction books, Mathematics literature
White Hart Lane railway station	Railway stations in Haringey, Transport in Haringey, Railway stations served by National Express East Anglia, 1872 establishments in England, Railway stations opened in 1872
Bruce Grove railway station	Railway stations in Haringey, Transport in Haringey, Railway stations opened in 1872, 1872 establishments in England
Public transport in Enfield	Transport in Enfield
List of London railway stations	Lists of railway stations in the United Kingdom, Rail transport in London, London-related lists
Seven Sisters station	Victoria Line stations, Transport in Haringey, Railway stations in Haringey, Railway stations opened in 1872, 1872 establishments in England
Paw	Animal anatomy
Xenu	Scientology
Charlotte, Princess Royal	1766 births, 1828 deaths, Princesses Royal, House of Hanover
William IX, Count of Poitiers	1153 births, 1156 deaths, House of Plantagenet
Henry the Young King	1155 births, 1183 deaths, Deaths from dysentery
Marguerite of France	1157 births, 1197 deaths, French princesses, House of Plantagenet, Kings and Queens consort of England
Rod cell	Vision
Photoreceptor cell	Vision
Three Gorges Dam	Buildings and structures in China, Dams, 2012 establishments in Asia, 2010s establishments in China
Ericaceae	Ericaceae
Alternation of generations	Botany, Plant anatomy, Classical genetics, Biological reproduction
John of Gaunt	House of Plantagenet, English Dukes, Knights of the Garter, 1399 deaths, 1340 births, People from Ghent
Edmund of Langley, 1st Duke of York	1341 births, 1402 deaths, English Dukes
Guinea (British coin)	British currency, England
Muntjac	Deer
Chorale	Musical forms, Christian music
Heathers	1989 comedy movies, 1989 drama movies, 1980s black comedy movies, 1989 comedy-drama movies, 1980s crime drama movies, 1980s satirical movies, 1980s teen comedy movies, 1980s teen drama movies, American comedy-drama movies, American crime drama movies, American satirical movies, American teen comedy movies, American teen drama movies, Turkish movies, English-language movies, Movies about bullying, Movies about murderers, Movies about revenge, Movies about suburbia, Movies set in Ohio, Suicide in fiction, American independent movies
Mariano Pernía	1977 births, Living people, Spanish footballers, Sportspeople from Buenos Aires
Carlos Marchena	1979 births, Living people, Spanish footballers
David Albelda	1977 births, Living people, Spanish footballers
Xavi	1980 births, Living people, Spanish footballers
José Antonio Reyes	1983 births, 2019 deaths, Road accident deaths, Spanish footballers
Antonio López Guerrero	1981 births, Living people, Spanish footballers
Andrés Iniesta	1984 births, Living people, Spanish footballers
Sergio Ramos	1986 births, Living people, Spanish footballers, FIFA World Cup players
Juan Gutiérrez Moreno	1976 births, Living people, Spanish footballers, People from Cádiz
David Villa	1981 births, Living people, Spanish footballers
Pablo Ibáñez	1981 births, Living people, Spanish footballers
José Manuel Reina	1982 births, Living people, Spanish footballers, Sportspeople from Madrid
Plate block	Postage stamps
Singapore Chinese Orchestra	Singapore
Alfred, Duke of Saxe-Coburg and Gotha	1844 births, 1900 deaths, British royalty, Cancer deaths in Germany, Deaths from throat cancer, Knights Grand Commander of the Order of the Indian Empire, Knights of Justice of the Order of St John, Royalty from Berkshire
Hillsborough disaster	1989 disasters, 1980s disasters in Europe, 1980s in England, April events, Disasters in the United Kingdom, Football in England, Police misconduct, Sheffield
Hillsborough Stadium	1899 establishments in England, Football stadiums in England, Sheffield
Liverpool Street station	Rail transport stations in London fare zone 1
Floriana F.C.	1894 establishments in Europe, Football clubs, Sport in Malta
Testimonial match	Football (soccer) terminology
World record	Everyday life
George V of Hanover	1819 births, 1878 deaths, Kings and Queens of Hanover, German nobility
Ubuntu-restricted-extras	Linux software
Elizabeth Woodville	1437 births, 1492 deaths, House of York, Kings and Queens consort of England, People from Northamptonshire
Suffolk County Council	Suffolk
Groundskeeper	Occupations, Gardening
Forth Road Bridge	Bridges in the United Kingdom, Steel bridges, Buildings and structures in Scotland, Suspension bridges, 1963 establishments in the United Kingdom, 20th century establishments in Scotland
Yankee Stadium	Major League Baseball venues, Sports buildings in New York City, The Bronx, 2009 establishments in New York (state)
Citi Field	Former Major League Baseball venues, Sports in New York City, Buildings and structures in New York City, New York Mets, 2006 establishments in New York (state), Queens (New York City)
Cabo San Lucas	Baja California Sur, Cities in Mexico
Diatomyidae	Rodents
Thom Yorke	1968 births, Living people, English pianists, English rock guitarists, English rock musicians, English rock singers, Entertainers from Northamptonshire, People from Northamptonshire, Radiohead
Laotian rock rat	Rodents
Santa Susana Mountains	Mountains of California, Geography of Los Angeles, California, Ventura County, California
Fakir	Islamic denominations, India
Curro Torres	1976 births, Living people, Spanish footballers
Juan Francisco García	1976 births, Living people, Spanish footballers
Iván Helguera	1975 births, Living people, Spanish footballers
Javier de Pedro	1973 births, Living people, Spanish footballers
Albert Luque	1978 births, Living people, Spanish footballers
Ricardo López Felipe	1971 births, Living people, Spanish association football goalkeepers, Sportspeople from Madrid
Enrique Romero	1971 births, Living people, Spanish footballers, People from Jerez de la Frontera
Sergio González	1976 births, Living people, Spanish footballers, Spanish football managers
Pedro Contreras	1972 births, Living people, Spanish association football goalkeepers, Sportspeople from Madrid
José Antonio Camacho	1955 births, Living people, Spanish footballers, Spanish football managers
Kwangmyŏngsŏng-2	North Korea
Slash (punctuation)	Punctuation
Backslash	Punctuation, Symbols, Typography
Hohenstein-Ernstthal	Zwickau Rural District
1M1 Records	Australian record labels, 1988 establishments in Australia
Lupe Fiasco	1982 births, Living people, Grammy Award winners, Musicians from Chicago
12 Apostles (record label)	British record labels, American record labels, Indie music record labels, 2000 establishments, Independent record labels
12 Inch Records	Independent record labels, Indie music record labels
12 Tónar	Independent record labels, Indie music record labels, 1998 establishments in Europe, Reykjavík, 20th century establishments in Iceland
12k	American record labels, Independent record labels, Electronic music record labels, Companies based in New York City, 1997 establishments in the United States, 1990s establishments in New York (state)
13th Planet Records	American record labels, El Paso, Texas, 2004 establishments in the United States, 2000s establishments in Texas
Dave Heineman	1948 births, Living people, Governors of Nebraska, Lieutenant Governors of Nebraska
Paulínia	Cities in São Paulo (state)
Alpha particle	Subatomic particles
Greenpeace	International environmental organizations, 1971 establishments in Canada
Albert, Manitoba	Settlements in Manitoba
Alexander, Manitoba	Settlements in Manitoba
Alonsa, Manitoba	Settlements in Manitoba
Altona, Manitoba	Settlements in Manitoba
Angusville, Manitoba	Settlements in Manitoba
Anola, Manitoba	Towns in Manitoba
Arborg, Manitoba	Towns in Manitoba
Argyle, Manitoba	Settlements in Manitoba
Lowestoft	Towns in Suffolk, Civil parishes in Suffolk, Ports and harbours of the United Kingdom
Ashern	Settlements in Manitoba
Austin, Manitoba	Towns in Manitoba
Badger, Manitoba	Towns in Manitoba
Bakers Narrows, Manitoba	Settlements in Manitoba
Baldur, Manitoba	Settlements in Manitoba
Beausejour, Manitoba	Towns in Manitoba
Benito, Manitoba	Settlements in Manitoba
Seal (device)	Authentication methods, Writing
The Attitude Era	Timelines, WWF Attitude Era
Eggnog	Drinks
Binscarth, Manitoba	Settlements in Manitoba
Birch River, Manitoba	Settlements in Manitoba
Birtle, Manitoba	Towns in Manitoba
Amenia (town), New York	Towns in New York, Dutchess County, New York
Beekman, New York	Towns in New York, Dutchess County, New York
Clinton, Dutchess County, New York	Towns in New York, Dutchess County, New York
Dover, New York	Towns in New York, Dutchess County, New York
East Fishkill, New York	Towns in New York, Dutchess County, New York
Fishkill (town), New York	Towns in New York, Dutchess County, New York
Hyde Park, New York	Towns in New York, Dutchess County, New York
Dol2day	Web 2.0, Social networking, Radio
LaGrange, New York	Towns in New York, Dutchess County, New York
Milan, New York	Towns in New York, Dutchess County, New York
North East, New York	Towns in New York, Dutchess County, New York
Pawling (town), New York	Towns in New York, Dutchess County, New York
Pine Plains (town), New York	Towns in New York, Dutchess County, New York
Dutchess County, New York	Dutchess County, New York, 1683 establishments in the Thirteen Colonies, 17th-century establishments in New York
Pleasant Valley (town), New York	Towns in New York, Dutchess County, New York
Poughkeepsie (town), New York	Towns in New York, Dutchess County, New York
Red Hook, New York	Towns in New York, Dutchess County, New York
Rhinebeck (town), New York	Towns in New York, Dutchess County, New York
Stanford, New York	Towns in New York, Dutchess County, New York
Szczecin-Goleniów "Solidarność" Airport	Buildings and structures in Poland, Airports in Europe, Transport in Poland
Census-designated place	Census-designated places
Ecdysozoa	Groups of phyla
Shoot	Botany, Plant anatomy
Association football pitch	Association football
State Bank of Pakistan	Pakistan, Banks
List of tallest buildings in Thailand	Lists of tallest buildings, Buildings and structures in Thailand, Asia-related lists
Ape Escape 2	2003 video games, PlayStation 2 games, PlayStation 4 games, Ubisoft games, Video game sequels
Andoni Zubizarreta	1961 births, Living people, Spanish association football goalkeepers
Albert Ferrer	1970 births, Living people, Spanish footballers, Spanish football managers, Eredivisie managers, Sportspeople from Barcelona
Agustín Aranzábal	1973 births, Living people, Spanish footballers
Rafael Alkorta	1968 births, Living people, Spanish footballers, People from Bilbao
Abelardo Fernández	1970 births, Living people, Spanish footballers
Juan Antonio Pizzi	1968 births, Living people, Spanish footballers, Spanish football managers, People from Santa Fe, Argentina
Alfonso Pérez	1972 births, Living people, Spanish footballers
Sergi Barjuán	1971 births, Living people, Spanish footballers
Iván Campo	1974 births, Living people, Spanish footballers
Carlos Aguilera Marín	1969 births, Living people, Spanish footballers, Sportspeople from Madrid
Albert Celades	1975 births, Living people, Spanish footballers, Sportspeople from Barcelona
Joseba Etxeberria	1977 births, Living people, Spanish footballers
Guillermo Amor	1967 births, Living people, Spanish footballers
Kiko	1972 births, Living people, Spanish footballers, People from Jerez de la Frontera
José Francisco Molina	1970 births, Living people, Spanish association football goalkeepers, People from Valencia
Javier Clemente	1950 births, Living people, Spanish footballers
Jorge Otero	1969 births, Living people, Spanish footballers
Francisco José Camarasa	1967 births, Living people, Spanish footballers
Ion Andoni Goikoetxea	1965 births, Living people, Spanish footballers, People from Pamplona
José Mari Bakero	1963 births, Living people, Spanish footballers, Spanish football managers
Juanele	1971 births, Living people, Spanish footballers
José Luis Caminero	1967 births, Living people, Spanish footballers, Sportspeople from Madrid
Felipe Miñambres	1965 births, Living people, Spanish footballers, Spanish football managers
Voro	1963 births, Living people, Spanish footballers, Spanish football managers, People from Valencia
Julio Salinas	1962 births, Living people, Spanish footballers, People from Bilbao
Julen Lopetegui	1966 births, Living people, Spanish association football goalkeepers, Spanish football managers
Glendale, California	Glendale, California
Retrograde amnesia	Symptoms, Amnesia
Tujunga Wash	Rivers of Los Angeles County, California
Apostasy in Islam	Islam
Arroyo Seco	Rivers of Los Angeles County, California
Rio Hondo (California)	Rivers of Los Angeles County, California
Sacramento County, California	Sacramento County, California, 1850 establishments in California
Norman Borlaug	1914 births, 2009 deaths, Scientists from Iowa, American Nobel Prize winners, Green thinkers, Deaths from lymphoma
Leandro de Moratín	1760 births, 1828 deaths, Spanish writers
Sporting CP	1900s establishments in Portugal, 1906 establishments in Europe, Portuguese football clubs, Lisbon
Sacriston	Villages in England, Settlements in County Durham
Luis de León	1527 births, 1591 deaths, Spanish poets
Classical conditioning	Psychology, Experiments
Bill Dodgin, Sr.	1909 births, 1999 deaths, English football managers, English footballers
Arthur Nikisch	1855 births, 1922 deaths, Hungarian conductors
Compton, California	Cities in California, Settlements in Los Angeles County, California, 1888 establishments in the United States, 1880s establishments in California
Sibi Division	Divisions of Balochistan (Pakistan)
Quetta Division	Divisions of Balochistan (Pakistan), Divisions of British India, Quetta
Zhob Division	Divisions of Balochistan (Pakistan)
Rawalpindi Division	Rawalpindi Division, Divisions of British India
Sargodha Division	Sargodha Division, Divisions of British India
Faisalabad Division	Faisalabad Division
Billups Neon Crossing Signal	Rail infrastructure, Rail technologies
Metacarpal bones	Bones, Limbs and extremities
Calcareous sponge	Sponges
Richea	Richea, Ericaceae
New Age	Spirituality
Sone Aluko	1989 births, Living people, English footballers, Nigerian footballers, Premier League players, People from Hounslow (London borough), Sportspeople from London
Tilia nasczokinii	Tilia nasczokinii, Malvaceae, Siberia
Chendo	1961 births, Living people, Spanish footballers
Manuel Jiménez Jiménez	1964 births, Living people, Spanish footballers, 1990 FIFA World Cup players, Spanish football managers
Genar Andrinúa	1964 births, Living people, Spanish footballers
Manuel Sanchís Hontiyuelo	1965 births, Living people, Spanish footballers, Sportspeople from Madrid
Rafael Martín Vázquez	1965 births, Living people, Spanish footballers, Sportspeople from Madrid
Miguel Pardeza	1965 births, Living people, Spanish footballers
Quique Sánchez Flores	1965 births, Living people, Spanish footballers, Spanish football managers, Sportspeople from Madrid
Fernando Gómez Colomer	1965 births, Living people, Spanish footballers, People from Valencia
Francisco Villarroya	1966 births, Living people, Spanish footballers, People from Zaragoza
Juan Carlos Ablanedo	1963 births, Living people, Spanish association football goalkeepers
Alberto Górriz	1958 births, Living people, Spanish footballers
Roberto Fernández Bonillo	1962 births, Living people, Spanish footballers
Rafael Paz	1965 births, Living people, Spanish footballers, People from Granada
Manolo	1965 births, Living people, Spanish footballers, People from Extremadura
José Manuel Ochotorena	1961 births, Living people, Spanish association football goalkeepers
Ron McGovney	1963 births, Living people, Bassists
Tyrannosauridae	Tyrannosaurids
Kyle Martino	1981 births, Living people, Sportspeople from Atlanta, Georgia, American footballers
US Airways Flight 1549	Aviation
Drum and bass	Music genres
John F. Kennedy International Airport	1948 establishments in the United States, 1940s establishments in New York (state), Airports in New York, Buildings and structures in New York City, John F. Kennedy, Queens (New York City)
Otto Klemperer	1885 births, 1973 deaths, American composers, American conductors, German composers, German conductors, Israeli Jews, Jewish American musicians, Jewish German musicians, Naturalized citizens of Israel, Naturalized citizens of the United States, People from former German territories, People from Wrocław
Stamford Hill railway station	Railway stations in Hackney, Transport in Hackney, London Travelcard zone 3, Railway stations opened in 1872, Railway stations served by National Express East Anglia, Buildings and structures in Hackney, 1872 establishments in England
Aum Shinrikyo	New religious movements, Organisations based in Japan, Religious violence, Cults
Elysian Valley, Los Angeles	Neighborhoods of Los Angeles
Glen Canyon	Geography of Arizona, Canyons, Geography of Utah, Landforms of the United States
Woodstock, Ontario	Cities in Ontario, 1800 establishments, 1800s establishments in Canada
Nortel	1895 establishments, 1890s establishments in Canada, Technology companies of Canada, Montreal, Ottawa, 2009 disestablishments, 2000s disestablishments in Canada, 2009 in Canada
North Magnetic Pole	Geography
Upper Canada College	1829 establishments, Schools in Canada, 1820s establishments in Canada
First Canadian Place	Skyscrapers in Canada, Buildings and structures in Toronto
Communications Security Establishment Canada	Intelligence agencies, Government agencies of Canada
Government Communications Headquarters	Government agencies of the United Kingdom, Intelligence agencies
Canadian Forces	Military of Canada
Canadian Security Intelligence Service	Government agencies of Canada, Intelligence agencies
Tomás Reñones	1960 births, Living people, Spanish footballers, People from Santiago de Compostela
Antonio Maceda	1957 births, Living people, Spanish footballers, Spanish football managers
Víctor Muñoz	1957 births, Living people, Spanish footballers, Spanish football managers, People from Zaragoza
Rafael Gordillo	1957 births, Living people, Spanish footballers
Juan Antonio Señor	1958 births, Living people, Spanish footballers, Spanish football managers, Sportspeople from Madrid
Francisco José Carrasco	1959 births, Living people, Spanish footballers, Spanish football managers, People from Alicante
Julio Alberto Moreno	1958 births, Living people, Spanish footballers
Quique Setién	1958 births, Living people, Spanish footballers, Spanish football managers
Javier Urruticoechea	1952 births, 2001 deaths, Spanish footballers
Ricardo Gallego	1959 births, Living people, Spanish footballers, Sportspeople from Madrid
Hipólito Rincón	1957 births, Living people, Spanish footballers
Francisco López Alfaro	1962 births, Living people, Spanish footballers, People from Seville
Ramon Maria Calderé	1959 births, Living people, Spanish footballers
Eloy	1964 births, Living people, Spanish footballers
Miguel Muñoz	1922 births, 1990 deaths, Spanish footballers, Spanish football managers, Sportspeople from Madrid
Runes	Runes
Janko Prunk	1942 births, Living people, Historians, People from Ljubljana, Slovenian politicians
Washington and Lee University	Colleges and universities in Virginia
Mojibake	Computer science, Encodings
Chauffeur	Personal service occupations, Automobiles
Mauro Maur	1958 births, Living people, Classical musicians, Trumpeters, Italian musicians, People from Trieste
Visual cortex	Vision, Anatomy of the brain
Driver's license	Law
Asda	1965 establishments in the United Kingdom, Leeds, Shops, Supermarkets of the United Kingdom
Neofelis	Felines
San Gabriel Mountains	Mountains of California, Geography of Los Angeles County, California, San Bernardino County, California
Video conference	Telecommunications
Acryl	Chemical compounds
Kirriemuir	Towns in Scotland
The Lizzie McGuire Movie	2003 comedy movies, American comedy movies, Disney movies, Movies set in Rome
Luis Arconada	1954 births, Living people, Spanish footballers
Miguel Ángel Alonso	1953 births, Living people, Spanish footballers, Spanish football managers
Miguel Tendillo	1961 births, Living people, Spanish footballers, People from Valencia
José Ramón Alexanko	1956 births, Living people, Spanish footballers, Spanish football managers
Juan Gómez González	1954 births, 1992 deaths, Spanish footballers, Spanish football managers
Joaquín Alonso	1956 births, Living people, Spanish footballers
Jesús María Satrústegui	1954 births, Living people, Spanish footballers
Jesús María Zamora	1955 births, Living people, Spanish footballers
Roberto López Ufarte	1958 births, Living people, Spanish footballers
Santiago Urquiaga	1958 births, Living people, Spanish footballers
Manuel Jiménez Abalo	1956 births, Living people, Spanish footballers
Enrique Saura	1954 births, Living people, Spanish footballers
José Vicente Sánchez	1956 births, Living people, Spanish footballers
Pedro Uralde	1958 births, Living people, Spanish footballers
Santillana	1952 births, Living people, Spanish footballers
Quini	1949 births, 2018 deaths, Deaths from myocardial infarction, Spanish footballers, People from Oviedo
Miguel Ángel González	1947 births, Living people, Spanish association football goalkeepers
José Santamaría	1929 births, Living people, Uruguayan footballers, Uruguayan football managers, Spanish footballers, Spanish football managers, Sportspeople from Montevideo
Kirchberg, Saxony	Zwickau Rural District
Meerane	Zwickau Rural District
Peter Fox (musician)	1971 births, Living people, German musicians
True parrots	True parrots
Chuang Tzu	Chinese philosophers, Taoism, 369 BC births, 286 BC deaths
Year-round school	Education
Leo Borchard	1899 births, 1945 deaths, Deaths by firearm in Germany, German conductors, Musicians from Moscow, People from Saint Petersburg, Russian conductors
Felix Weingartner	1863 births, 1942 deaths, 20th century composers, Austrian pianists, Austrian composers, Austrian conductors, Romantic composers
1978 Atlantic hurricane season	Atlantic hurricane seasons, 1978
Griffith Park	Parks in the United States, Geography of Los Angeles, California
Lake Powell	Lakes of the United States
Alaska Range	Mountain ranges of Alaska
Brooks Range	Mountain ranges of Alaska
Prince Edward, Duke of York and Albany	1739 births, 1767 deaths, House of Hanover, Royalty from London, People buried in Westminster Abbey, British Dukes and Duchesses
Union Vale, New York	Towns in New York, Dutchess County, New York
Wappinger, New York	Towns in New York, Dutchess County, New York
Washington, New York	Towns in New York, Dutchess County, New York
Fishkill, New York	Villages in New York, Dutchess County, New York
Millbrook, New York	Dutchess County, New York, Villages in New York, 1890s establishments in New York (state), 1895 establishments in the United States
Millerton, New York	Villages in New York, Dutchess County, New York
Pawling (village), New York	Villages in New York, Dutchess County, New York
Red Hook (village), New York	Villages in New York, Dutchess County, New York
Rhinebeck (village), New York	Villages in New York, Dutchess County, New York
Tivoli, New York	Villages in New York, Dutchess County, New York
Wappingers Falls, New York	Villages in New York, Dutchess County, New York
Grand Slam (Professional Wrestling)	Professional wrestling
Joseph Schumpeter	1883 births, 1950 deaths, American academics, American economists, American political scientists, Austrian scientists, Czech people, German academics, German scientists, Government ministers of Austria, Naturalized citizens of the United States
B. J. Habibie	Muslims, Presidents of Indonesia, Vice-Presidents of Indonesia, Deaths from heart failure, Deaths from cardiomyopathy, 1936 births, 2019 deaths
Vexillology	Heraldry
Southern Tenant Farmers Union	Unions
Fjuckby	Settlements in Uppsala County
Copa del Rey	Football competitions, 1903 establishments in Europe, Football in Spain, 1900s establishments in Spain
Kobuk River	Rivers of Alaska
Reichstag (institution)	Parliaments, Reichstag
Hippocampus	Anatomy of the brain, Physiology
Superparamagnetism	Magnetism
Safety	Safety
Heidi	1882 books, Children's books
Hans von Bülow	1830 births, 1894 deaths, German conductors, German pianists, People from Dresden
Augustus d'Este	1794 births, 1848 deaths, British nobility
Michael Dennis Morgan	1946 births, Living people, Sportspeople from Sydney, Rowing, Australian Olympic silver medalists
Robert Trujillo	American guitarists, Musicians from California, 1964 births, Living people, People from Santa Monica, California
President of Indonesia	Presidents of Indonesia
Sergiu Celibidache	1912 births, 1996 deaths, Conductors
Ludwig von Brenner	1833 births, 1902 deaths, German composers, German conductors
Claudio Abbado	1933 births, 2014 deaths, Cancer survivors, Italian conductors, Order of Merit of the Federal Republic of Germany, People from Milan
Vernier scale	Tools
Project AWARE	International environmental organizations, 1989 establishments in the United States
EarthEcho International	International environmental organizations, Non-profit organizations of Washington, D.C.
Prince William, Duke of Cambridge	1982 births, Living people, British Army officers, English Anglicans, House of Windsor, People educated at Eton College, People from Paddington, Princes and princesses, Privy Councillors (UK), Royalty from London, Royal Navy officers, United Kingdom Dukes
Simon Rattle	1955 births, British conductors, Living people, People from Liverpool, Commanders of the Order of the British Empire, Knights Bachelor
2020	2020
Adhan	Islam
Tiger quoll	Mammals of Australia, Dasyuromorphia
Ken Whisenhunt	Atlanta Falcons players, National Football League coaches, Washington Redskins players, New York Jets players, American football coaches, Sportspeople from Georgia (U.S. state), People from Augusta, Georgia, Living people, 1962 births, American football tight ends
Louisa Maria Teresa Stuart	1692 births, 1712 deaths, House of Stuart
Casa Colorada	Buildings and structures in Chile
El Seibo Province	Provinces of the Dominican Republic, 1844 establishments in the Dominican Republic
Al-Masjid al-Nabawi	Holy places in Islam, Medina, Mosques in Saudi Arabia, Religion in Saudi Arabia, 1817 establishments, 1810s establishments in Asia
Sarvestan palace	Buildings and structures in Iran, 5th century establishments in Asia, Establishments in Iran
Hypostyle	Architecture
Sacred architecture	Architecture
Iwan	Architecture
Hassan II Mosque	Buildings and structures in Morocco, Casablanca, Mosques, 1993 establishments in Africa, 20th-century establishments in Morocco
Missa in angustiis	Masses (music), Compositions by Joseph Haydn
Victoria, Princess Royal	Cancer deaths in Germany, Deaths from breast cancer, Kings and Queens of Prussia, Princesses Royal, Royalty from London, 1840 births, 1901 deaths, Kings and Queens consort, Crown Princes and Princesses of Prussia
Prince Arthur, Duke of Connaught and Strathearn	1850 births, 1942 deaths, House of Windsor, United Kingdom Dukes, United Kingdom Earls, Knights of the Garter, Knights of the Thistle, Knights Grand Cross of the Order of St Michael and St George, Knights Grand Commander of the Order of the Star of India, Knights Grand Commander of the Order of the Indian Empire, Knights Grand Cross of the Royal Victorian Order, Knights Grand Cross of the Order of the Bath, Privy Councillors (UK), Bailiffs Grand Cross of the Order of St John
Prince Leopold, Duke of Albany	1853 births, 1884 deaths, British royalty, House of Saxe-Coburg and Gotha
Royal Concertgebouw Orchestra	Orchestras, Dutch music, Amsterdam
GNU GRUB	GNU project
Mother Goose	Poetry
Tripe	Animal anatomy, Offal
Fruiterer	Food-related occupations
Jig	Dances
Ischaemia	Diseases and disorders of the cardiovascular system
Angina pectoris	Heart disease
Wahhabi	Islamic denominations
Muawiyah I	Muslims, 602 births, 680 deaths
Bell tower	Bells, Towers
Muezzin	Islam, Religious occupations
Iqama	Islam
Aleppo	Aleppo
Mihrab	Mosques, Islamic architecture
Culver City, California	Culver City, California
Majority rule	Voting systems
Jama Masjid	Mosques in India, Mughal architecture, 1656 establishments, 17th century establishments in India
2006 Jama Masjid explosions	Disasters in India, 2006 in Asia, 2000s in India
Babri Mosque	Mosques in India, Mughal architecture, 16th century establishments in India, 1992 disestablishments, 1990s disestablishments in Asia, 20th century disestablishments in India, 1527 establishments, 1520s establishments in Asia
Wudu	Islamic culture
7 July 2005 London bombings	July 2005 London bombings, 2005 crimes, 2005 in England, 2000s explosions, 2000s murders in Europe, 21st century in London, Attacks on buildings and structures in London, Attacks on buildings and structures in the 2000s, Explosions in London, Islamic terrorist incidents in the 2000s, Islamic terrorist incidents in the United Kingdom, July events, Mass murder in London, Mass murder in the 2000s, Suicide bombings in Europe, Suicide in the 2000s, Terrorist incidents in London
Maliki	Islamic denominations
Madh'hab	Islam
Masjid al-Haram	Mecca, Mosques in Saudi Arabia, Religion in Saudi Arabia, 7th-century establishments in Asia, 1571 establishments
Islamic calligraphy	Islamic culture, Writing
Decorum	Poetry
Carsten Niebuhr	1733 births, German mathematicians, 1815 deaths
Madrasa	Educational institutions
Umar	Sahaba, Caliphs, Muslims, People from Mecca, 6th century births, 640s deaths
Prince Josias of Saxe-Coburg-Saalfeld	1737 births, 1815 deaths
2006 al-Askari mosque bombing	2006 crimes, 2006 in Asia, 2000s explosions, 21st century in Iraq, Attacks on mosques, Attacks on religious buildings and structures in Asia, Explosions in Asia, February 2006 events, Terrorist incidents in the 2000s
Jumu'ah	Islam
Sunrise	Parts of a day
Hanafi	Schools of Islamic law
Baitul Mukarram	Mosques in Bangladesh, Dhaka, National symbols of Bangladesh
Musalla	Islam
Shafi`i	Islam, Islamic denominations, Indonesia
Hanbali	Schools of Islamic law
Minbar	Islamic architecture
Iman (concept)	Islam
Maghrib	Islam
Voter registration	Voting systems
Petition	Law, Religion
Texaco Cup	Football competitions
Rous Cup	Football competitions
Taça de Portugal	Football competitions, Football in Portugal
Finsbury Park Mosque	Buildings and structures in London, London Borough of Islington, Mosques
Primeira Liga	Football leagues, Football in Portugal, 1934 establishments in Europe, 20th century establishments in Portugal
Peaceful coexistence	Cold War, International relations, History of the People's Republic of China, Peace
UEFA Cup Winners' Cup	Football competitions, UEFA, 1960 establishments in Europe, 1999 disestablishments in Europe
Shiraz	Cities in Iran, Fars Province
Carlsberg	Danish culture, Companies of Europe, 1847 establishments in Europe, 19th century establishments in Denmark
English Football Hall of Fame	Football in England, Sports halls of fame
Email headers	E-mail
Esfahān	Cities in Iran, Isfahan Province
Residentie Orchestra	Orchestras, Dutch music, The Hague
Al-Azhar University	Buildings and structures in Cairo, Colleges and universities in Africa, Islamic organizations, Mosques, Religion in Egypt, 10th-century establishments in Africa, Establishments in Egypt, 975 establishments
Imam Ali Mosque	Mosques in Iraq
Imam Reza shrine	Religious buildings, Buildings and structures in Iran
Qibla	Islam
Terracotta Army	World Heritage Sites in Asia, Archaeology, Ceramics, Afterlife, Statues
Iftar	Ramadan
Potluck	Food and drink, Social events
Khatib	Islam
Khutbah	Islam
Gymnasium	Sports buildings
Sulayman Pasha Mosque	1528 establishments, Buildings and structures in Cairo, Mosques, Religion in Egypt, Establishments in Egypt
Nasir al-Mulk Mosque	Buildings and structures in Iran, Mosques in Asia
Vault (architecture)	Architectural elements
Jannah	Islam
Salat al-Janazah	Islam
Sunnah salat	Islam
Eid al-Adha	Islamic culture, Islamic festivals
Salat al Eid	Islam
Convention center	Convention and exhibition centers
Al Abbas Mosque	Mosques in Iraq
Suhoor	Islam, Arabic words and phrases
Fajr	Islam
Isha'a	Islam
Laylat al-Qadr	Islam, Arabic words and phrases
Itikaf	Islam, Arabic words and phrases
Saturn's Norse group of satellites	Saturn's moons
Marcelo H. del Pilar	1850 births, 1896 deaths, Filipino journalists, Spanish writers
Slut	Pejoratives, Words, English profanity
King Fahd Mosque, Culver City	Buildings and structures in California, Culver City, California, Islam in the United States, Mosques
Jewish Defense League	1968 establishments in the United States, Nationalist organizations in North America, Terrorism, Zionism, Arab–Israeli conflict, Organizations based in the United States, Judaism in the United States
Hassan Bek Mosque	Arab–Israeli conflict, Buildings and structures in Tel Aviv, History of Palestine, Holy places in Islam, Mosques, Religion in Israel, 1916 establishments, 1910s establishments in Israel
Cultural center	Cultural organizations, Buildings and structures
Fahd of Saudi Arabia	1921 births, 2005 deaths, Deaths from pneumonia, Disease-related deaths in Saudi Arabia, Kings of Saudi Arabia
History of saffron cultivation	Iridaceae, Spices
Ain al-Yaqeen	Magazines of Asia
Bombay riots	1992 in Asia, 1993 crimes, 1990s riots, 1990s in India, December events, January events, Mass murder in Asia, Mass murder in the 1990s, Mumbai, Murder in India
Hindu temple	Hindu temples
1993 Bombay bombings	1990s explosions, 1990s in India, Attacks on buildings and structures in Asia, Attacks on hotels, Car and truck bombings in Asia, March events, Mass murder in 1993, Mass murder in Asia, Mumbai, Murder in India, Terrorist incidents in Asia, Terrorist incidents in the 1990s
Clifford Edmund Bosworth	1928 births, Living people, British historians, People from South Yorkshire
Encyclopaedia of Islam	Encyclopedias
Al-Mawardi	972 births, 1058 deaths
Religious studies	Interdisciplinary fields, Academic disciplines
Pitch (baseball)	Baseball
Dida	1973 births, Living people, Brazilian footballers
Juan Silveira dos Santos	1979 births, Living people, Footballers from Rio de Janeiro
Kaká	1982 births, Living people, Brazilian footballers, People from Brasília
Zé Roberto	1974 births, Living people, Brazilian footballers
Erich Hartmann	1922 births, 1993 deaths, Colonels, German aviators, German military personnel of World War II, People from Baden-Württemberg, Prisoners of war
Cicinho	1980 births, Living people, Brazilian footballers
Luisão	1982 births, Living people, Brazilian footballers
Cristiano Marques Gomes	1977 births, Living people, Brazilian footballers
Gilberto	1976 births, Living people, Footballers from Rio de Janeiro
Gilberto Silva	1976 births, Living people, Brazilian footballers
Mineiro	1975 births, Living people, Brazilian footballers, People from Porto Alegre
Juninho Pernambucano	1975 births, Living people, Brazilian footballers, People from Recife
Preveza	Cities in Greece
Ricardinho	1976 births, Living people, Brazilian footballers, Brazilian football managers
Frederico Chaves Guedes	1983 births, Living people, Brazilian footballers
Júlio César (football goalkeeper, born 1979)	1979 births, Living people, Brazilian association football goalkeepers
Robinho	1984 births, Living people, Brazilian footballers
Carlos Alberto Parreira	1943 births, Living people, Footballers from Rio de Janeiro
Marcos Roberto Silveira Reis	1973 births, Living people, Brazilian association football goalkeepers
Roque Júnior	1976 births, Living people, Brazilian footballers
Edmílson Gomes	1976 births, Living people, Brazilian footballers
Juliano Belletti	1976 births, Living people, Brazilian footballers
Ânderson Polga	1979 births, Living people, Brazilian footballers
José Kléberson	1979 births, Living people, Brazilian footballers
Jenílson Ângelo de Souza	1973 births, Living people, Brazilian footballers
Denílson de Oliveira Araújo	1977 births, Living people, Brazilian footballers
Vampeta	1974 births, Living people, Brazilian footballers
Edílson	1970 births, Living people, Brazilian footballers, People from Salvador, Bahia
Luiz Bombonato Goulart	1975 births, Living people, Brazilian footballers
Luiz Felipe Scolari	1948 births, Living people, Brazilian footballers, Brazilian football managers
Cláudio Taffarel	1966 births, Living people, Brazilian footballers, Rio Grande do Sul
Aldair	1965 births, Living people, Brazilian footballers
Júnior Baiano	1970 births, Living people, Brazilian footballers
Corfu (city)	Cities in Greece
Giovanni Silva de Oliveira	1972 births, Living people, Brazilian footballers
Carlos Germano	1970 births, Living people, Brazilian association football goalkeepers
José Carlos de Almeida	1968 births, Living people, Brazilian footballers
Marcelo Gonçalves Costa Lopes	1966 births, Living people, Footballers from Rio de Janeiro
André Cruz	1968 births, Living people, Brazilian footballers
Doriva	1972 births, Living people, Brazilian footballers, Brazilian football managers
Mário Zagallo	1931 births, Living people, Footballers from Maceió, Brazilian football managers
Edessa	Cities in Greece
Ermoupolis	Cities in Greece
Hanged, drawn and quartered	Capital punishment
Australian Film Institute Awards	Entertainment awards, Movie awards, Australian culture
Reichsminister	History of Germany
Illustration	Graphics, Communication
Nile crocodile	Crocodilia
Reichswehr	Military of Germany, 1920s in Germany, 1930s in Germany
Debra Messing	Actors from Brooklyn, American movie actors, American television actors, American television producers, American voice actors, Emmy Award winning actors, Jewish American actors, New York University alumni, 1968 births, Living people
Anti-capitalism	Political geography, Capitalism, Political movements
Bernard Hellring	1950s births, 1971 deaths, American inventors, Sportspeople from New Jersey, Road accident deaths in New Jersey
WHSV-TV	American television stations, Virginia
Altron (video game company)	Video game companies, Technology companies of Japan
Maplewood, New Jersey	Townships in New Jersey
Mickey's House of Villains	Disney animated movies, Disney direct-to-video movies
Courtyard	Architectural elements
Methylphenidate	Drugs used in psychiatry, Drugs
Dopamine	Molecular biology, Biochemistry
Raining Blood	1986 songs, Slayer songs
Acer saccharinum	Plants of North America, Sapindaceae, Trees
Melanoma	Cancer
La Vega Province	Provinces of the Dominican Republic, 1844 establishments in the Dominican Republic
Gujranwala Division	Gujranwala Division
Daniel Barenboim	1942 births, Living people, Argentine Jews, Argentine pianists, Grammy Award winners, Israeli conductors, Jewish Israeli musicians, Naturalized citizens of Israel, Order of Merit of the Federal Republic of Germany, Palestinian people, People from Buenos Aires, Spanish musicians
West-Eastern Divan Orchestra	Youth orchestras, Seville
Gustav Mahler Youth Orchestra	Youth orchestras
India-Taiwan relations	Taiwan, Foreign relations of India
Sikkimese people	Ethnic groups in Asia, Sikkim
Old Delhi	Cities in India, 1639 establishments, 17th century establishments in India
Doaba	Punjab, India
Crassulaceae	Saxifragales
Assassination of Abraham Lincoln	1865 in the United States, 19th century in Washington, D.C., Abraham Lincoln, American Civil War, April events, Assassinations in the United States, Crime in Washington, D.C., Murder in the 19th century
Lars Løkke Rasmussen	1964 births, Living people, Prime Ministers of Denmark
Mos Def	American rap musicians from New York, American movie actors, Singers from New York City, Actors from New York City, 1973 births, Living people
Stagflation	Inflation
Cleveland Orchestra	American orchestras, Cleveland, Ohio, 1918 establishments in the United States, 1910s establishments in Ohio
Boston Symphony Orchestra	American orchestras, 1881 establishments in the United States, 19th-century establishments in Massachusetts
Light music	Music genres
Royal Australian Air Force	Military of Australia, Air forces
Nonthaburi (province)	Provinces of Thailand
Bridge to Terabithia (2007 movie)	2007 movies, 2000s fantasy movies, American fantasy movies, Movies based on books, New Zealand movies
Waldviertel	Regions of Austria, Lower Austria
Eternal flame	Monuments and memorials, Tombs of Unknown Soldiers
Terrestrial planet	Terrestrial planets
Dave Thomas	American chief executives, 1932 births, 2002 deaths, Deaths from neuroendocrine cancer, Cancer deaths in Florida, Businesspeople from New Jersey
Cheating	Adultery, Sociology
Caroline Kennedy	American lawyers, Writers from New York City, US Democratic Party politicians, John F. Kennedy, Children of Presidents of the United States, Columbia University alumni, Kennedy family, 1957 births, Living people, Ambassadors of the United States to Japan
Supercopa de España	Football competitions
Steve Staunton	1969 births, Living people, Irish footballers, People from County Louth
UEFA Euro 2004	2004 in Europe, 2004 in association football, Sport in Portugal, UEFA European Championship, 2000s in Portugal, June 2014 events, July 2014 events
BBC Sports Personality of the Year Lifetime Achievement Award	BBC, Sports trophies and awards
Freedom of the City	Awards
Mania	Bipolar disorder
Chicago Symphony Orchestra	American orchestras, Music in Chicago, 1891 establishments in the United States, 1890s establishments in Illinois
Pittsburgh Symphony Orchestra	American orchestras, 1895 establishments in the United States, 1890s establishments in Pennsylvania
Andrea del Verrocchio	1430s births, 1488 deaths, People from Florence, 15th century Italian painters, Italian sculptors
Toxoplasma	Apicomplexa, Parasites
Thai Airways	Airlines of Asia, Bangkok, Star Alliance, Transport in Thailand, 1960 establishments in Asia, 20th century establishments in Thailand, IATA members
Falklands War	1982, 1982 in the United Kingdom, 20th century in Argentina, Falkland Islands, Wars involving the United Kingdom, 1980s in South America
Red kangaroo	Macropods, Marsupials of Australia
Christ myth theory	Jesus Christ, Mythology, Pseudoscience
Wanker	Pejoratives
Urolagnia	Paraphilias, Sexual acts
BDSM	BDSM
Şalom	Turkish-language newspapers, 1947 establishments, Newspapers published in Turkey, Istanbul
Talmud	Judaism
Hibernate (OS feature)	Computing
Isospora belli	Apicomplexa
Return to the Blue Lagoon	1991 drama movies, 1991 romance movies, 1990s adventure movies, 1990s coming-of-age movies, 1990s romantic drama movies, 1990s sequel movies, 1990s teen drama movies, 1990s teen romance movies, American adventure movies, American coming-of-age movies, American romantic drama movies, American sequel movies, American teen drama movies, American teen romance movies, Coming-of-age drama movies, Coming-of-age romance movies, Movies set in islands, Movies with underwater settings, English-language movies
Tab (GUI)	Computers
Mark McGwire	1963 births, American League All-Stars, American Olympic silver medalists, Baseball players from California, Living people, Medalists at the 1984 Summer Olympics, National League All-Stars, Oakland Athletics players, People from Pomona, California, St. Louis Cardinals players
Cryptosporidium	Apicomplexa
Dodecahedron	Platonic solids
Jorginho	1964 births, Living people, Footballers from Rio de Janeiro, Brazilian football managers
Ricardo Roberto Barreto da Rocha	1962 births, Living people, Brazilian footballers, Brazilian football managers, People from Recife
Ronaldo Rodrigues de Jesus	1965 births, Living people, Brazilian footballers
Branco	1964 births, Living people, Brazilian footballers
Zinho	1967 births, Living people, Brazilian footballers, Brazilian football managers
Zetti	1965 births, Living people, Brazilian footballers, Brazilian football managers
Márcio Roberto dos Santos	1969 births, Living people, Brazilian footballers
Mazinho	1966 births, Living people, Brazilian footballers, Brazilian football managers
Paulo Sérgio Silvestre do Nascimento	1969 births, Living people, Brazilian footballers
Müller	1966 births, Living people, Brazilian footballers, Mato Grosso do Sul
Viola (footballer)	1969 births, Living people, Brazilian footballers
Gilmar Rinaldi	1959 births, Living people, Brazilian footballers, Rio Grande do Sul
Ricardo Gomes	1964 births, Living people, Footballers from Rio de Janeiro, Brazilian football managers
Alemão	1961 births, Living people, Brazilian footballers, Brazilian football managers
Valdo Filho	1964 births, Living people, Brazilian footballers
Silas (footballer)	1965 births, Living people, Brazilian footballers, Brazilian football managers
Acácio Cordeiro Barreto	1959 births, Living people, Brazilian footballers
Carlos Mozer	1960 births, Living people, Footballers from Rio de Janeiro
Renato Gaúcho	1962 births, Living people, Brazilian footballers, Brazilian football managers, Rio Grande do Sul
Tita	1958 births, Living people, Footballers from Rio de Janeiro, Brazilian football managers
Mauro Galvão	1961 births, Living people, Brazilian footballers, Brazilian football managers, People from Porto Alegre
José Carlos da Costa Araújo	1962 births, Living people, Footballers from Rio de Janeiro, Brazilian association football goalkeepers
Sebastião Lazaroni	1950 births, Living people, Brazilian footballers
Custer's Revenge	Atari 2600 games, 1982 video games
Myelodysplastic syndrome	Diseases, Blood
Bone marrow	Bones
Cyclospora cayetanensis	Apicomplexa
Stem cell	Developmental biology, Cells
Springbok	Mammals of Africa
Lythraceae	Myrtales
Textual criticism	Literature
Carlos Roberto Gallo	1956 births, Living people, Brazilian association football goalkeepers
Édson Boaro	1959 births, Living people, Brazilian footballers
Edino Nazareth Filho	1955 births, Living people, Footballers from Rio de Janeiro, Brazilian football managers
Leovegildo Lins da Gama Júnior	1954 births, Living people, Brazilian footballers, Paraíba
Walter Casagrande	1963 births, Living people, Brazilian footballers
Zico	1953 births, Living people, Footballers from Rio de Janeiro, Brazilian football managers, J1 League players, Japan Soccer League players, Kashima Antlers players, Japan national football team managers
Edivaldo Martins Fonseca	1962 births, 1993 deaths, Brazilian footballers
Paulo Vitor	1957 births, Living people, Brazilian association football goalkeepers, People from Belém
Josimar	1961 births, Living people, Footballers from Rio de Janeiro
Júlio César da Silva	1963 births, Living people, Brazilian footballers
Elzo Coelho	1961 births, Living people, Brazilian footballers
Telê Santana	1931 births, 2006 deaths, Brazilian footballers, Brazilian football managers
Race to Witch Mountain	2009 movies, English-language movies
OpenStreetMap	Road transport
San Francisco Symphony Orchestra	American orchestras, Music in San Francisco, 1911 establishments in the United States, 1910s establishments in California
Rammstein	1994 establishments in Germany, German heavy metal bands, Alternative metal bands, Musical groups established in 1994, 1990s German music groups, 2000s German music groups, 2010s German music groups
MythBusters	2003 American television series debuts, 2000s American television series, 2010s American television series, English-language television programs
Mountain Dew	Soft drinks
Sturt National Park	National parks in Australia, Protected areas of New South Wales, Ramsar sites
Costume drama	Performing arts, Drama
Wilsthorpe Community School	Schools in England
Meaghan Jette Martin	1992 births, Living people, Camp Rock
Beaker culture	Ethnic groups in Europe, Pottery, Archaeology
Adelardo López de Ayala	Spanish poets, 1828 births, 1879 deaths
Red mercury	Chemistry
Continuation War	World War II, 20th century in Finland, Wars involving the Soviet Union, 1940s in Europe
Los Angeles Philharmonic	American orchestras, Music in Los Angeles, California, 1919 establishments in the United States, 1910s establishments in California
Walt Disney Concert Hall	Concert halls in the United States, Buildings and structures in Los Angeles, California, Music in Los Angeles, California, 2003 establishments in California
Symphony Center	Concert halls in the United States, Buildings and structures in Chicago, Illinois
Sailboat	Boats
Galápagos Islands	World Heritage Sites in South America, Galápagos Islands
Helix pomatia	Gastropods
Field Marshal	Military ranks
Panzer	Tanks
Nathaniel Hawthorne	1804 births, 1864 deaths, 19th-century American novelists, People from Concord, New Hampshire, People from Salem, Massachusetts, Writers from Massachusetts, Ambassadors of the United States, American children's writers, American diplomats, American short story writers, Biographers, US Democratic Party politicians
Hemel Hempstead	Towns in Hertfordshire
Shock wave	Fluid mechanics
Intimacy (album)	Bloc Party albums
Wichita Recordings	British record labels
Shoreditch	Areas of London, London Borough of Hackney, London Borough of Tower Hamlets
Believe (song)	Rock songs, 2005 songs
The Chemical Brothers	English musical groups
Drowned in Sound	Music magazines
Music session	Music
Trash Aesthetics	2004 establishments in the United Kingdom, British record labels
So Here We Are	Bloc Party songs, 2005 songs
Designer	Designers
Push the Button	Trip hop albums
Silent Alarm Remixed	Rock albums, 2000s albums
Paul Epworth	1974 births, Living people, Best Original Song Academy Award-winning songwriters, British record producers, English songwriters, Golden Globe Award winning composers, Grammy Award winners
War Child	1993 establishments in the United Kingdom, Brit Award winners, Charities
The Streets	1994 establishments in England, 2010s disestablishments in the United Kingdom, 1990s British music groups, 2000s British music groups, 2010s British music groups, Brit Award winners, Rap music groups, Musical groups established in 1994, Musical groups disestablished in 2011, Musical groups from Birmingham, West Midlands, 21st century disestablishments in England
Jacknife Lee	Year of birth missing (living people), Living people, Irish musicians, guitarists
The Prayer	2007 songs, Bloc Party songs, Songs about drugs
I Still Remember (song)	Bloc Party songs, 2007 songs
Hunting for Witches	Bloc Party songs, 2007 songs
Flux (song)	Bloc Party songs, 2007 songs
BBC 6 Music	BBC radio
Sandy Cheeks	Fictional characters introduced in 1999, Fictional animals, SpongeBob SquarePants characters
Amenia (CDP), New York	Dutchess County, New York, Census-designated places in New York (state), Hamlets in New York
Arlington, New York	Census-designated places in New York (state), Hamlets in New York, Dutchess County, New York
Brinckerhoff, New York	Census-designated places in New York (state), Hamlets in New York, Dutchess County, New York
Maida Vale	Areas of London
T in the Park	Music festivals in Scotland
Argyll	Argyll
Topman	Clothing companies, Companies of the United Kingdom, 1978 establishments in the United Kingdom
Talons (song)	Bloc Party songs, 2008 songs
BBC Electric Proms	Music festivals in England, BBC
Splendour in the Grass	Music festivals, New South Wales, Australian music, 2001 establishments in Australia
Austin City Limits Music Festival	Austin, Texas, Music festivals in the United States
Austin City Limits	American television series, English-language television programs
Exmoor Singers	Choirs
Oxegen	Music festivals, Republic of Ireland, Festivals in Europe, 2004 establishments in Europe, 2013 disestablishments in Europe, 2000s establishments in the Republic of Ireland
Connect Music Festival	Music festivals in Scotland, Argyll
Virgin Mobile Festival	Rock festivals, Virgin Group, Music festivals in the United States
Syracuse University	Colleges and universities in New York, Atlantic Coast Conference, College Hockey America, Syracuse, New York, 1870 establishments in New York (state)
Q Awards	Music awards, British music, 1990 establishments in the United Kingdom
Great Pacific Garbage Patch	Pollution
Tiscali	Companies of Italy
Vice Records	Record labels
V2 Records	British record labels, Virgin Group
Amazon Kindle	Electronics, Amazon (company)
Basidiomycota	Fungi
Waldir Peres	1951 births, 2017 deaths, Deaths from myocardial infarction, Brazilian association football goalkeepers
José Leandro Ferreira	1959 births, Living people, Brazilian footballers
Luiz Carlos Ferreira	1958 births, Living people, Brazilian footballers
Paulo Isidoro	1953 births, Living people, Brazilian footballers, People from Belo Horizonte
Serginho Chulapa	1953 births, Living people, Brazilian footballers
Éder Aleixo de Assis	1957 births, Living people, Brazilian footballers
Paulo Sérgio de Oliveira Lima	1954 births, Living people, Footballers from Rio de Janeiro, Brazilian association football goalkeepers
Edevaldo de Freitas	1958 births, Living people, Brazilian footballers
Juninho Fonseca	1958 births, Living people, Brazilian footballers
Pedro Luís Vicençote	1957 births, Living people, Brazilian footballers
João Batista da Silva	1955 births, Living people, Brazilian footballers, People from Porto Alegre
Carlos Renato Frederico	1957 births, Living people, Brazilian footballers
Roberto Dinamite	1954 births, Living people, Brazilian footballers
Dirceu	1952 births, 1995 deaths, Footballers from Rio de Janeiro
Antônio Dias dos Santos	1948 births, 1999 deaths, Brazilian footballers
João Justino Amaral dos Santos	1954 births, Living people, Brazilian footballers
Zé Sérgio	1957 births, Living people, Brazilian footballers, Brazilian football managers
José Reinaldo de Lima	1957 births, Living people, Brazilian footballers
Roberto Rivelino	1946 births, Living people, Brazilian footballers
Nelinho	1950 births, Living people, Footballers from Rio de Janeiro
Abel Braga	1952 births, Living people, Footballers from Rio de Janeiro, Brazilian football managers
José Fernando Polozzi	1955 births, Living people, Brazilian footballers
José Rodrigues Neto	1949 births, 2019 deaths, Brazilian footballers, Brazilian football managers
Gilberto Alves	1950 births, Living people, Brazilian footballers, Brazilian football managers
Jorge Mendonça	1954 births, 2006 deaths, Brazilian footballers
Francisco Jezuíno Avanzi	1949 births, 2008 deaths, Brazilian footballers
Cláudio Coutinho	1939 births, 1981 deaths, Footballers from Rio de Janeiro
Technical drawing	Architecture, Manufacturing, Engineering, Occupations
Florence Nibart-Devouard	1968 births, Living people, People from Versailles, Wikimedia Foundation, Wikipedia people
La Altagracia Province	Provinces of the Dominican Republic, 1961 establishments in North America, 20th-century establishments in the Dominican Republic
Just Say No	Phrases, Nancy Reagan
La Romana Province	Provinces of the Dominican Republic, 1944 establishments in North America, 1940s establishments in the Dominican Republic
Bischofshofen	Cities and towns in Salzburg (state)
Freedom Party of Austria	1956 establishments in Europe, 20th century establishments in Austria, Conservative parties, Nationalist organizations in Europe, Political parties in Austria, Eurosceptic parties
The Greens – The Green Alternative	1993 establishments in Europe, 1990s establishments in Austria, Green political parties, Political parties in Austria
Cubicle	Rooms
Navel lint	Fibers
Viking Age	History of Europe
Collusion	Social sciences
Claret	French wines
Infinite monkey theorem	Mathematics
Ascomycota	Fungi
Random variable	Mathematics
María Trinidad Sánchez Province	Provinces of the Dominican Republic, 1959 establishments in North America, 1950s establishments in the Dominican Republic
Monseñor Nouel Province	Provinces of the Dominican Republic, 1982 establishments in North America, 1980s establishments in the Dominican Republic
Monte Cristi Province	Provinces of the Dominican Republic, 1879 establishments in North America, 19th-century establishments in the Spanish West Indies
Monte Plata Province	Provinces of the Dominican Republic, 1982 establishments in North America, 1980s establishments in the Dominican Republic
Luís Pereira	1949 births, Living people, Brazilian footballers
Marinho Peres	1947 births, Living people, Brazilian footballers, Brazilian football managers
José Maria Rodrigues Alves	1949 births, Living people, Brazilian footballers
Wilson da Silva Piazza	1943 births, Living people, Brazilian footballers
Marinho Chagas	1952 births, 2014 deaths, Brazilian footballers
Jairzinho	1944 births, Living people, Footballers from Rio de Janeiro, Brazilian football managers
Leivinha	1949 births, Living people, Brazilian footballers
César Augusto da Silva Lemos	1945 births, Living people, Brazilian footballers
Paulo César Lima	1949 births, Living people, Footballers from Rio de Janeiro
Renato Cunha Valle	1944 births, Living people, Footballers from Rio de Janeiro, Brazilian association football goalkeepers
Valdomiro Vaz Franco	1946 births, Living people, Brazilian footballers
Alfredo Mostarda Filho	1946 births, Living people, Brazilian footballers
Marco Antônio	1951 births, Living people, Brazilian footballers
Paulo César Carpegiani	1949 births, Living people, Brazilian footballers, Brazilian football managers
Ademir da Guia	1942 births, Living people, Footballers from Rio de Janeiro
Sebastião Miranda da Silva Filho	1952 births, Living people, Brazilian footballers
Jonas Eduardo Américo	1949 births, Living people, Brazilian footballers
Félix Miéli Venerando	1937 births, Living people, Brazilian association football goalkeepers
Hércules Brito Ruas	1939 births, Living people, Footballers from Rio de Janeiro
Clodoaldo	1949 births, Living people, Brazilian footballers, Sergipe
Gérson	1941 births, Living people, Brazilian footballers
Tostão	1947 births, Living people, Brazilian footballers, People from Belo Horizonte
Ado	1946 births, Living people, Brazilian footballers
Roberto Miranda	1944 births, Living people, Brazilian footballers
José Guilherme Baldocchi	1946 births, Living people, Brazilian footballers
José de Anchieta Fontana	1940 births, 1980 deaths, Brazilian footballers
Everaldo	1944 births, 1974 deaths, Brazilian footballers, People from Porto Alegre
Joel Camargo	1946 births, 2014 deaths, Deaths from renal failure, Brazilian footballers
Dadá Maravilha	1943 births, Living people, Footballers from Rio de Janeiro
Gylmar dos Santos Neves	1930 births, 2013 deaths, Brazilian association football goalkeepers
Djalma Santos	1929 births, 2013 deaths, Brazilian footballers, Deaths from pneumonia, Disease-related deaths in Brazil
José Maria Fidélis dos Santos	1944 births, Living people, Brazilian footballers
Hilderaldo Bellini	1930 births, 2014 deaths, Brazilian footballers, Deaths from Alzheimer's disease, Disease-related deaths in Brazil
Altair Gomes de Figueiredo	1938 births, 2019 deaths, Brazilian footballers
Orlando Peçanha de Carvalho	1935 births, Brazilian footballers
Paulo Henrique Souza de Oliveira	1943 births, Living people, Brazilian footballers
Rildo da Costa Menezes	1942 births, 2021 deaths, Brazilian footballers, People from Recife
Aílton Corrêa Arruda	1937 births, Living people, Brazilian association football goalkeepers, People from Recife
Denílson Custódio Machado	1943 births, Living people, Brazilian footballers
Antônio Lima dos Santos	1942 births, Living people, Brazilian footballers
Zito	1932 births, 2015 deaths, Deaths from stroke, Brazilian footballers
Alcindo Martha de Freitas	1945 births, Living people, Brazilian footballers
Silva Batuta	1940 births, 2020 deaths, Brazilian footballers
Adhemir de Barros	1942 births, Living people, Brazilian footballers
Vicente Feola	1909 births, 1975 deaths, Brazilian footballers
Countdown	Time
Higher	Education in Scotland
San Cristóbal Province	Provinces of the Dominican Republic, 1932 establishments in North America, 1930s establishments in the Dominican Republic
Reading F.C.	Premier League clubs, 1871 establishments in the United Kingdom
Oxalidales	Oxalidales
Edict of Nantes	Treaties, 1598, History of France
Cross product	Linear algebra, Vectors
Knowth	County Meath
Kill switch	Safety, Engineering
Communist Party of Bangladesh	Political parties in Bangladesh, Communist parties, 1968 establishments, 20th century establishments in Bangladesh
Trial by ordeal	Trials
Kurt von Schleicher	1882 births, 1934 deaths, Assassinated people, Chancellors of the Weimar Republic, German generals, German military personnel of World War I, German murder victims, Government ministers of the Weimar Republic, Ministers-President of Prussia, Murders by firearm in Germany, Politicians from Brandenburg, Victims of Nazism
Vienna Philharmonic	Orchestras, Vienna
Leipzig Gewandhaus Orchestra	German orchestras, Leipzig
Troll (internet)	Human behavior, Internet slang
Santalales	Santalales
Chivalry	Knights
Digraph (orthography)	Linguistics
Politika	Serbia, Newspapers in Europe, 1904 establishments in Europe, 20th century establishments in Serbia
Bože Pravde	Serbia, National anthems
Sremska Mitrovica	Cities in Serbia
Troll	Mythology
Dinornis	Ratites, Fossils, Struthioniformes, Extinct species
Moscow Symphony Orchestra	Russian music, Orchestras
Saint Petersburg Philharmonic Orchestra	Russian music, Saint Petersburg, Orchestras
Rob Tapert	1955 births, Living people, American movie producers, People from Michigan
NHK Symphony Orchestra	Orchestras
Israel Philharmonic Orchestra	Israeli music, Orchestras
Metropolitan Opera	Opera houses, Non-profit organizations of New York, Organizations in New York City, 1880 establishments in the United States, 1880s establishments in New York (state), Music in New York City
Mouthpiece (woodwind)	Woodwind instruments, Musical instrument construction
Orquesta Sinfónica Simón Bolívar	Youth orchestras
European Union Youth Orchestra	Youth orchestras
Wiener schnitzel	Meat dishes, German food, Austrian food
Gel	Physical chemistry, Materials
Mission San Luis Obispo de Tolosa	Churches in the United States, Museums in California, 1772 establishments in North America, History of California, 18th-century establishments in California
You Nazty Spy!	American movies, 1940 movies, Columbia Pictures movies, English-language movies
Mačvanska Mitrovica	Settlements in Serbia
Troll (movie)	1986 horror movies, American horror movies, Italian movies, American independent movies
Troll 2	English-language movies, 1990 horror movies, 1990 comedy movies, American horror movies, American comedy movies, Italian horror movies
Boris Tadić	1958 births, Living people, Presidents of Serbia, People from Sarajevo
.gu	Top-level domains
Swindon Town F.C.	English football clubs, Swindon, 1879 establishments in England
County Ground	Football stadiums in England, 1896 establishments in England
Coscoroba swan	Anatidae
Pitchfork Media	1995 establishments in Illinois, Companies based in Chicago, Illinois, Entertainment websites, Music critics
Ultratop	Belgian culture, Record charts
Paste (magazine)	Music magazines
Tambourine	Percussion instruments
Tachyon	Subatomic particles
Kenny Ortega	1950 births, Living people, American movie directors, People from Palo Alto, California
Gelatin	Proteins, Animal tissues
Christian naturism	Christian clothing, Christian movements and denominational families
Lake Eyre	Lakes of South Australia
Castanets	Percussion instruments
Peravia Province	Provinces of the Dominican Republic, 1944 establishments in North America, 1940s establishments in the Dominican Republic
Puerto Plata Province	Provinces of the Dominican Republic, 1865 establishments in North America, 1860s establishments in the Dominican Republic
Santo Domingo Province	Provinces of the Dominican Republic, 2001 establishments in the Dominican Republic
Vibraphone	Percussion instruments
Simon Doull	1969 births, Living people, New Zealand cricketers, Sports commentators, Sportspeople from Auckland
Oberlungwitz	Zwickau Rural District
Waldenburg, Saxony	Zwickau Rural District
Wildenfels	Zwickau Rural District
Wilkau-Haßlau	Zwickau Rural District
Hugh Laurie	1959 births, Living people, Actors from Oxfordshire, Alumni of the University of Cambridge, Blues musicians, English atheists, English movie actors, English singers, English television actors, English television directors, English television producers, English television writers, Musicians from Oxfordshire, People educated at Eton College, People from Oxford, Writers from Oxfordshire, Golden Globe Award winning actors, People's Choice Award winners
Mauro Ramos	1930 births, 2002 deaths, Brazilian footballers
Zózimo	1932 births, 1977 deaths, Brazilian footballers, Brazilian football managers, People from Salvador, Bahia
Juan Valera	Spanish novelists
Valdir Pereira	1929 births, 2001 deaths, Brazilian footballers, Brazilian football managers
Coutinho	1943 births, 2019 deaths, Deaths from myocardial infarction, Deaths from diabetes, Deaths from hypertension, Brazilian footballers
José Macia	1935 births, Living people, Brazilian footballers, Brazilian football managers
Jair Marinho	1936 births, 2020 deaths, Brazilian footballers
Jurandir de Freitas	1940 births, Living people, Brazilian footballers
Zequinha	1934 births, Living people, Brazilian footballers, People from Recife
Mengálvio Pedro Figueiró	1939 births, Living people, Brazilian footballers
Jair da Costa	1940 births, Living people, Brazilian footballers
Amarildo Tavares da Silveira	1939 births, Living people, Brazilian footballers
Carlos José Castilho	1927 births, 1987 deaths, Footballers from Rio de Janeiro, Brazilian association football goalkeepers
Aymoré Moreira	1908 births, 1998 deaths, Brazilian footballers, Brazilian football managers
Dino Sani	1932 births, Living people, Brazilian footballers
Oreco	1932 births, 1985 deaths, Brazilian footballers
Moacir Claudino Pinto	1936 births, Living people, Brazilian footballers
Newton de Sordi	1931 births, 2013 deaths, Brazilian footballers
Joel Antônio Martins	1931 births, 2003 deaths, Footballers from Rio de Janeiro
José Altafini	1938 births, Living people, Brazilian footballers, Italian footballers
Edvaldo Alves de Santa Rosa	1934 births, 2002 deaths, Footballers from Maceió
Brandãozinho	1925 births, 2000 deaths, Brazilian footballers, 1954 FIFA World Cup players
João Carlos Batista Pinheiro	1932 births, Living people, Brazilian footballers
José Carlos Bauer	1925 births, 2007 deaths, Brazilian footballers
Júlio Botelho	1929 births, 2003 deaths, Brazilian footballers
Baltazar	1926 births, 1997 deaths, Brazilian footballers
José Lázaro Robles	1924 births, 1996 deaths, Brazilian footballers
Francisco Rodrigues	1925 births, 1988 deaths, Brazilian footballers
Paulo Almeida Ribeiro	1932 births, 2007 deaths, Brazilian footballers, Brazilian football managers
Alfredo Ramos de Oliveira	1924 births, Living people, Brazilian footballers, Brazilian football managers
Ely do Amparo	1921 births, 1991 deaths, Brazilian footballers
Dequinha	1928 births, 1997 deaths, Brazilian footballers
Mauro Raphael	1933 births, 1995 deaths, Brazilian footballers
Humberto Tozzi	1934 births, 1980 deaths, Footballers from Rio de Janeiro
Índio (footballer, born 1931)	1931 births, 2020 deaths, Brazilian footballers
Rubens Josué da Costa	1928 births, 1991 deaths, Brazilian footballers
Caetano Silva	1930 births, 1979 deaths, Footballers from Rio de Janeiro, Brazilian association football goalkeepers
Luís Morais	1930 births, Brazilian association football goalkeepers, 2020 deaths
Zezé Moreira	1917 births, 1998 deaths, Brazilian footballers, Brazilian football managers
Adão Nunes Dornelles	1923 births, 1991 deaths, Brazilian footballers, People from Porto Alegre
Alfredo Ramos dos Santos	1920 births, Living people, Footballers from Rio de Janeiro
Augusto da Costa	1920 births, 2004 deaths, Footballers from Rio de Janeiro
Moacir Barbosa Nascimento	1921 births, 2000 deaths, Brazilian association football goalkeepers
Bigode	1922 births, 2003 deaths, Brazilian footballers, People from Belo Horizonte
Francisco Aramburu	1922 births, 1997 deaths, Brazilian footballers
Danilo Alvim	1920 births, 1996 deaths, Footballers from Rio de Janeiro, Brazilian football managers
Friaça	1924 births, 2009 deaths, Brazilian footballers
Jair da Rosa Pinto	1921 births, 2005 deaths, Brazilian footballers
Juvenal Amarijo	1923 births, 2009 deaths, Brazilian footballers
Manuel Marinho Alves	1925 births, 1961 deaths, Brazilian footballers
Olavo Rodrigues Barbosa	1923 births, 2010 deaths, Brazilian footballers, People from Porto Alegre
Alfredo Eduardo Barreto de Freitas Noronha	1918 births, 2003 deaths, Brazilian footballers, People from Porto Alegre
Rui Campos	1922 births, 2002 deaths, Brazilian footballers
Zizinho	1922 births, 2002 deaths, Brazilian footballers
Flávio Costa	1906 births, 1999 deaths, Brazilian footballers, Brazilian football managers
WrestleMania X	WrestleMania, Sports in New York City, 1994 in professional wrestling, 1994 in New York (state), 1990s in New York City, March events
Infantilism	Mental illnesses
GMA Dove Awards	Christian music
Cognitive distortions	Psychology
Swine influenza	Diseases caused by viruses, Zoonoses
Myers-Briggs Type Indicator	Psychology
Pragmatism	Epistemology, Philosophical movements and positions
Anal Cunt	1988 establishments in the United States, Musical groups established in 1988, 1980s establishments in Massachusetts, 2001 disestablishments in the United States, Musical groups disestablished in 2001, 2000s disestablishments in Massachusetts, Musical groups established in 2003, 2000s establishments in Massachusetts, Musical groups disestablished in 2011, 2011 disestablishments in the United States, 1980s American music groups, 1990s American music groups, 2000s American music groups, 2010s American music groups, American punk bands, Hardcore punk, Musical groups from Massachusetts
Country code top-level domain	Top-level domains, Country codes
Troll 3	English-language movies, 1990s horror movies, 1990 movies
Bouvet Island	Volcanoes, Bouvet Island, Uninhabited regions
Crossosomatales	Rosids
Waterfowl	Birds
Occidental College	Colleges and universities in Los Angeles, California, 1887 establishments in the United States, 1880s establishments in California
Afonso Guimarães da Silva	1912 births, 1997 deaths, Footballers from Rio de Janeiro
Pinheiro da Silva	1915 births, Living people, Brazilian footballers
Algisto Lorenzato	1910 births, 1960 deaths, Brazilian footballers
José Augusto Brandão	1910 births, 1989 deaths, Brazilian footballers
Hermínio de Brito	1911 births, Living people, Brazilian footballers
Domingos da Guia	1912 births, 2000 deaths, Deaths from stroke, Footballers from Rio de Janeiro
Hércules de Miranda	1912 births, 1982 deaths, Brazilian footballers
Euclydes Barbosa	1909 births, 1988 deaths, Brazilian footballers
José dos Santos Lopes	1911 births, 1996 deaths, Brazilian footballers
Luís Mesquita de Oliveira	1911 births, 1983 deaths, Footballers from Rio de Janeiro
Arthur Machado	1909 births, 1997 deaths, Brazilian footballers
Martim Mércio da Silveira	1911 births, 1972 deaths, Brazilian footballers
Álvaro Lopes Cançado	1912 births, 1984 deaths, Brazilian footballers
Niginho	1912 births, 1975 deaths, Brazilian footballers, People from Belo Horizonte
Rodolpho Barteczko	1910 births, 1988 deaths, Brazilian footballers, People from Curitiba
José Perácio	1917 births, 1977 deaths, Brazilian footballers
Roberto Emílio da Cunha	1913 births, Brazilian footballers, 1977 deaths
Romeu Pellicciari	1911 births, 1971 deaths, Brazilian footballers
Elba de Pádua Lima	1915 births, 1984 deaths, Brazilian footballers, Brazilian football managers
Walter de Souza Goulart	1913 births, Living people, Footballers from Rio de Janeiro, Brazilian association football goalkeepers
Zezé Procópio	1913 births, 1980 deaths, Brazilian footballers
Adhemar Pimenta	1896 births, 1970 deaths, Footballers from Rio de Janeiro
Ariel Nogueira	1910 births, Living people, Brazilian footballers
Armando dos Santos	1911 births, 1972 deaths, Brazilian footballers
Áttila de Carvalho	1910 births, Living people, Footballers from Rio de Janeiro
Heitor Canalli	1907 births, 1990 deaths, Brazilian footballers
Carvalho Leite	1912 births, 2004 deaths, Footballers from Rio de Janeiro
Germano Boettcher Sobrinho	1911 births, 1977 deaths, Footballers from Rio de Janeiro, Brazilian association football goalkeepers
Luis dos Santos Luz	1909 births, 1989 deaths, Brazilian footballers, People from Porto Alegre
Octacílio Pinheiro Guerra	1909 births, 1967 deaths, Brazilian footballers, People from Porto Alegre
Roberto Gomes Pedrosa	1913 births, 1954 deaths, Brazilian association football goalkeepers
Sylvio Hoffmann Mazzi	1908 births, 1991 deaths, Brazilian footballers
Alfredo Alves Tinoco	1904 births, 1975 deaths, Footballers from Rio de Janeiro
Wálter Guimarães	1912 births, 1997 deaths, Footballers from Rio de Janeiro
Waldemar de Brito	1913 births, 1979 deaths, Brazilian footballers
Luiz Vinhaes	1896 births, 1960 deaths, Footballers from Rio de Janeiro
Abraham Patusca da Silveira	1905 births, 1990 deaths, Brazilian footballers
Benedicto de Moraes Menezes	1906 births, Living people, Footballers from Rio de Janeiro
Humberto de Araújo Benevenuto	1903 births, Living people, Brazilian footballers
Alfredo Brilhante da Costa	1904 births, 1980 deaths, Footballers from Rio de Janeiro
Alfredo Almeida Rego	1903 births, Living people, Brazilian footballers
Fausto dos Santos	1905 births, 1939 deaths, Brazilian footballers
Fernando Guidicelli	1903 births, 1968 deaths, Footballers from Rio de Janeiro
Agostinho Fortes Filho	1901 births, 1966 deaths, Footballers from Rio de Janeiro
Hermógenes Fonseca	1908 births, Living people, Footballers from Rio de Janeiro
Luiz Gervazoni	1907 births, 1963 deaths, Footballers from Rio de Janeiro
Ivan Mariz	1910 births, 1982 deaths, Brazilian footballers, People from Belém
Joel de Oliveira Monteiro	1904 births, 1990 deaths, Footballers from Rio de Janeiro, Brazilian association football goalkeepers
Manoel de Aguiar Fagundes	1907 births, 1953 deaths, Brazilian footballers
Moderato Wisintainer	1902 births, 1986 deaths, Brazilian footballers
Nilo Murtinho Braga	1903 births, 1975 deaths, Footballers from Rio de Janeiro
Oscarino Costa Silva	1907 births, 1990 deaths, Brazilian footballers
Estanislau de Figueiredo Pamplona	1904 births, 1973 deaths, Brazilian footballers
Policarpo Ribeiro de Oliveira	1907 births, 1986 deaths, Brazilian footballers
Preguinho	1905 births, 1979 deaths, Footballers from Rio de Janeiro
Moacyr Siqueira de Queiroz	1902 births, 1992 deaths, Brazilian footballers
Teóphilo Bettencourt Pereira	1900 births, 1988 deaths, Brazilian footballers
Osvaldo Velloso de Barros	1908 births, Living people, Brazilian association football goalkeepers, Mato Grosso do Sul
José Luiz de Oliveira	1904 births, Living people, Footballers from Rio de Janeiro
Píndaro de Carvalho Rodrigues	1892 births, 1965 deaths, Brazilian footballers, Brazilian football managers
A Vindication of the Rights of Woman	Non-fiction books, 1792 books, Feminism
Jake Humphrey	1978 births, Living people, English television presenters, People from Cambridgeshire, People from Norwich, Television personalities from Norfolk
Pole position	Formula One
University of California, Los Angeles	University of California, Association of American Universities, Colleges and universities in Los Angeles, California, Pac-12 Conference, 1919 establishments in the United States, 1910s establishments in California
Steve Morse	American guitarists, 1954 births, Living people
Eric Johnson	1954 births, Living people, American rock guitarists, Musicians from Austin, Texas
Supercontinent	Supercontinents
Åland Islands	Åland Islands, Regions of Finland
Spatula	Food utensils
Tim Walberg	1951 births, Living people, US Republican Party politicians
Pork barrel	Politics
Liberation Tigers of Tamil Eelam	Politics of Sri Lanka, Nationalist organizations in Asia, Rebel militia groups in Asia, 1972 establishments in Asia, Tamils, Sri Lankan Civil War, 1970s establishments in Sri Lanka
Cape Morris Jesup	Geography of Greenland, Capes
Flying fish	Teleosts
Robert Huth	1984 births, Living people, German footballers, Sportspeople from Berlin
Sebastian Kehl	1980 births, Living people, German footballers, Sportspeople from Hesse
Jens Nowotny	1974 births, Living people, German footballers, Sportspeople from Baden-Württemberg
Oyster card	Transport in London
John Heisman	1869 births, 1936 deaths, College Football Hall of Fame, Sportspeople from Cleveland, Ohio, Heisman Trophy
Residency (medicine)	Medical education
Cymbal	Percussion instruments
Woodblock	Percussion instruments
Claves	Percussion instruments, Cuban music
Pacific Electric Railroad Bridge	Rail infrastructure, Bridges in the United States, Torrance, California, National Register of Historic Places, Transport in California, 1913 establishments in the United States, 1910s establishments in California
Eskdale	Towns in Victoria (Australia)
Anglerfish	Teleosts, Bioluminescent animals
Marko Rehmer	1972 births, Living people, East German sportspeople, German footballers, Sportspeople from Berlin
Frank Baumann	1975 births, Living people, German footballers, People from Würzburg, Sportspeople from Bavaria
Christian Ziege	1972 births, Living people, German footballers, Sportspeople from Berlin
Lars Ricken	1976 births, Living people, German footballers, People from Dortmund, Sportspeople from North Rhine-Westphalia
Marco Bode	1969 births, Living people, German footballers, Sportspeople from Lower Saxony
Jörg Böhme	1974 births, Living people, German footballers, Sportspeople from Saxony-Anhalt
Hans-Jörg Butt	1974 births, Living people, German association football goalkeepers, Sportspeople from Lower Saxony
Andreas Köpke	1962 births, Living people, 1990 FIFA World Cup players, 1994 FIFA World Cup players, 1998 FIFA World Cup players, German association football goalkeepers, People from Kiel, Sportspeople from Schleswig-Holstein
Christian Wörns	1972 births, Living people, 1998 FIFA World Cup players, German footballers, People from Mannheim, Sportspeople from Baden-Württemberg
Jörg Heinrich	1969 births, Living people, German footballers, Sportspeople from Brandenburg
Jürgen Kohler	1965 births, Living people, German footballers, German football managers, Sportspeople from Rhineland-Palatinate
Thomas Helmer	1965 births, Living people, German footballers, Sportspeople from North Rhine-Westphalia
Olaf Thon	1966 births, Living people, German footballers, People from Gelsenkirchen, Sportspeople from North Rhine-Westphalia
Andreas Möller	1967 births, Living people, German footballers, German football managers, Sportspeople from Frankfurt
Ulf Kirsten	1965 births, Living people, East German sportspeople, German footballers, Sportspeople from Saxony
Thomas Häßler	1966 births, Living people, German footballers, Sportspeople from Berlin
Olaf Marschall	1966 births, Living people, East German sportspeople, German footballers, Sportspeople from Saxony
Markus Babbel	1972 births, Living people, German footballers, German football managers, Sportspeople from Munich
Steffen Freund	1970 births, Living people, East German sportspeople, German footballers, Sportspeople from Brandenburg
Stefan Reuter	1966 births, Living people, German football managers, German footballers, Sportspeople from Bavaria
Michael Tarnat	1969 births, Living people, German footballers, Sportspeople from North Rhine-Westphalia
Berti Vogts	1946 births, Living people, German footballers, German football managers, Sportspeople from North Rhine-Westphalia
Stoke Newington railway station	Railway stations in Hackney, London Travelcard zone 2
Rectory Road railway station	Railway stations in Hackney, London Travelcard zone 2, Railway stations served by National Express East Anglia
University of Pittsburgh	Association of American Universities, Atlantic Coast Conference, Colleges and universities in Pennsylvania, Pittsburgh, Pennsylvania, 1787 establishments in the United States, 1780s establishments in Pennsylvania
Mascot	Mascots
Democratic Party (Serbia)	Socialist International, Social democratic parties, Political parties in Europe, Serbia
Federal Republic of Yugoslavia	Yugoslavia
Hackney Downs railway station	Railway stations in Hackney, Transport in Hackney, London Travelcard zone 2, Railway stations opened in 1872, Railway stations served by National Express East Anglia, 1872 establishments in England
StumbleUpon	Social networking
Cotton mouse	Rodents, Mammals of North America
Swine influenza virus	Viruses
Omid Djalili	1965 births, Living people, Actors from London, British stand-up comedians, Comedians from London, English movie actors, English television actors, English television writers, English voice actors, Iranian actors, People from Kensington and Chelsea (London borough), Writers from London
Chiron (mythology)	Greek legendary creatures
Kotor	Cities in Montenegro, Municipalities of Montenegro
Honey, I Shrunk the Kids	1989 comedy movies, American comedy movies, Disney movies
Clupeidae	Teleosts
List of mountains in Turkey	Mountains of Turkey, Geography-related lists, Turkey-related lists
Mahya Dağı	Mountains of Turkey
Süphan	Volcanoes of Asia, Mountains of Turkey
Wodonga, Victoria	Cities in Victoria
Bodo Illgner	1967 births, Living people, German association football goalkeepers, People from Koblenz, Sportspeople from Rhineland-Palatinate
Thomas Strunz	1968 births, Living people, German footballers, People from Duisburg, Sportspeople from North Rhine-Westphalia
Andreas Brehme	1960 births, Living people, German footballers, German football managers, Sportspeople from Hamburg
Karl-Heinz Riedle	1965 births, Living people, German footballers, German football managers, Sportspeople from Bavaria
Stefan Kuntz	1962 births, Living people, German footballers, German football managers, Sportspeople from Saarland
Thomas Berthold	1964 births, Living people, German footballers, People from Hanau, Sportspeople from Hesse
Maurizio Gaudino	1966 births, Living people, German footballers, Sportspeople from Baden-Württemberg
Matthias Sammer	1967 births, 1994 FIFA World Cup players, East German sportspeople, German footballers, German football managers, Living people, People from Dresden, Sportspeople from Saxony
Martin Wagner	1968 births, Living people, German footballers, Sportspeople from Baden-Württemberg
Stefan Effenberg	1968 births, Living people, German footballers, Sportspeople from Hamburg
Mario Basler	1968 births, Living people, German footballers, German football managers, Sportspeople from Rhineland-Palatinate
Klaus Augenthaler	1957 births, Living people, German football managers, German footballers, Sportspeople from Bavaria
Frank Mill	1958 births, Living people, 1984 Summer Olympics, 1990 FIFA World Cup players, German footballers, German Olympic bronze medalists, Medalists at the 1988 Summer Olympics, Sportspeople from Essen
Raimond Aumann	1963 births, Living people, German association football goalkeepers, People from Augsburg, Sportspeople from Bavaria
Paul Steiner	1957 births, Living people, German footballers, Sportspeople from Baden-Württemberg
Hans Pflügler	1960 births, Living people, German footballers, Sportspeople from Bavaria
Günter Hermann	1960 births, Living people, German footballers, Sportspeople from Lower Saxony
London Fields railway station	Railway stations in Hackney, Transport in Hackney, London Travelcard zone 2, Buildings and structures in Hackney, Railway stations opened in 1872, Railway stations served by National Express East Anglia, 1872 establishments in England
Orthomyxoviridae	Viruses
Cambridge Heath railway station	Transport in Tower Hamlets, London Travelcard zone 2, Railway stations opened in 1872, Railway stations served by National Express East Anglia, 1872 establishments in England
Bethnal Green railway station	Transport in Tower Hamlets, Railway stations opened in 1872, Railway stations served by National Express East Anglia, 1872 establishments in England
Moeller High School	Cincinnati, Ohio, Schools in Ohio, 1960 establishments in the United States, 1960s establishments in Ohio
No man's land	Law
Vetmedin	Drugs
Lohengrin (opera)	Compositions by Richard Wagner, Operas
Lohengrin	German literature, Arthurian legend, Fictional knights
Erik the Red	950 births, 1000s deaths, Norwegian explorers, Norwegian people, Icelandic people
Beuchat	1930s establishments in France, 1934 establishments in Europe, Companies of France, Marseille
Georges Beuchat	Divers, French inventors, 1910 births, 1992 deaths
2004 Madrid train bombings	2004 in Europe, 2000s explosions, 2000s in Spain, 2000s murders in Europe, Attacks on buildings and structures in Europe, Attacks on buildings and structures in the 2000s, Crime in Spain, Explosions in Europe, Islamic terrorist incidents in Europe, Islamic terrorist incidents in the 2000s, Madrid, March events, Mass murder in the 2000s, Massacres in Europe, Murder in 2004
Communes of the Aude department	Communes in Aude, Lists of communes of France
Aigues-Vives, Aude	Communes in Aude
Airoux	Communes in Aude
Ajac	Communes in Aude
Alairac	Communes in Aude
Alaigne	Communes in Aude
Albas, Aude	Communes in Aude
Albières	Communes in Aude
Alet-les-Bains	Communes in Aude
Alzonne	Communes in Aude
Antugnac	Communes in Aude
Aragon, Aude	Communes in Aude
Harald Schumacher	1954 births, Living people, German association football goalkeepers, Sportspeople from North Rhine-Westphalia
Hans-Peter Briegel	1955 births, Living people, German footballers, German football managers, People from Kaiserslautern, Sportspeople from Rhineland-Palatinate
Karlheinz Förster	1958 births, Living people, German footballers, Sportspeople from Baden-Württemberg
Matthias Herget	1955 births, Living people, German footballers, Sportspeople from Saxony
Norbert Eder	1955 births, 2019 deaths, German footballers, Sportspeople from Bavaria
Felix Magath	1953 births, Living people, German footballers, German football managers, Sportspeople from Bavaria
Uli Stein	1954 births, Living people, German football managers, German association football goalkeepers, Sportspeople from Hamburg
Karl Allgöwer	1957 births, Living people, German footballers, Sportspeople from Baden-Württemberg
Ditmar Jakobs	1953 births, 1986 FIFA World Cup players, German footballers, Living people, People from Oberhausen, Sportspeople from North Rhine-Westphalia
Uwe Rahn	1962 births, Living people, German footballers, People from Mannheim, Sportspeople from Baden-Württemberg
Klaus Allofs	1956 births, Living people, German footballers, People from Düsseldorf, Sportspeople from North Rhine-Westphalia
Dieter Hoeneß	1953 births, Living people, German footballers, People from Ulm, Sportspeople from Baden-Württemberg
Wolfgang Rolff	1959 births, Living people, German football managers, German footballers, Sportspeople from Lower Saxony
Eike Immel	1960 births, Living people, German association football goalkeepers, Sportspeople from Hesse
Bernd Förster	1956 births, Living people, German footballers, Sportspeople from Baden-Württemberg
Wolfgang Dremmler	1954 births, Living people, German footballers, Sportspeople from Lower Saxony
Klaus Fischer	1949 births, Living people, German footballers, German football managers, Sportspeople from Bavaria
Horst Hrubesch	1951 births, 1982 FIFA World Cup players, German football managers, German footballers, Living people, Sportspeople from North Rhine-Westphalia
Hansi Müller	1957 births, Living people, German footballers, Sportspeople from Stuttgart
Wilfried Hannes	1957 births, Living people, German footballers, Sportspeople from North Rhine-Westphalia
Uwe Reinders	1955 births, Living people, German footballers, German football managers, Sportspeople from Essen
Uli Stielike	1954 births, Living people, German football managers, German footballers, Sportspeople from Baden-Württemberg
Thomas Allofs	1959 births, Living people, German footballers, People from Düsseldorf, Sportspeople from North Rhine-Westphalia
Stephan Engels	1960 births, Living people, German footballers, Sportspeople from North Rhine-Westphalia
Holger Hieronymus	1959 births, Living people, German footballers, Sportspeople from Hamburg
Manfred Kaltz	1953 births, Living people, German footballers, People from Ludwigshafen, Sportspeople from Rhineland-Palatinate
Bernd Franke	1948 births, Living people, German association football goalkeepers, Sportspeople from Saarland
Jupp Derwall	1927 births, 2007 deaths, German footballers, German football managers, Sportspeople from North Rhine-Westphalia
Tibooburra, New South Wales	Towns in New South Wales
Helmeted honeyeater	Birds of Australia, Passeriformes
Arch Resources	Companies of the United States, 1997 establishments in the United States
National Fuel Gas	1902 establishments in the United States, 1900s establishments in New York (state), Companies of the United States
Canton, Ohio	Canton, Ohio, County seats in Ohio
Princess Mary Adelaide of Cambridge	1833 births, 1897 deaths, British royalty, House of Hanover
Isomorphism	Algebra
Automorphism	Algebra
Group center	Algebra
Caroline of Ansbach	1683 births, 1737 deaths, House of Hanover, House of Hohenzollern, Regents, People from Bavaria, People buried in Westminster Abbey, Kings and Queens consort
Coset	Algebra
Lagrange's theorem (group theory)	Algebra
Label (philately)	Philately
Liz Cohen	1973 births, Living people, American artists
Rainbow flag (LGBT)	LGBT, Flags, San Francisco, 1978 establishments in California
Program specification	Computer programming
Debugging	Software, Computer science
Hubble's law	Astrophysics, Cosmology
Carol Ann Duffy	1955 births, Living people, British playwrights, British poets laureate, LGBT playwrights, LGBT poets, People from Glasgow, People from Staffordshire, Scottish LGBT people, Scottish poets
East Turkestan	China
1977 Atlantic hurricane season	1977 Atlantic hurricane season
Ahmad Shah Durrani	Monarchs of Afghanistan, Pashtun people, 1720s births, 1773 deaths, Emperors and empresses, Muslims
Nemrut (volcano)	Volcanoes of Asia, Mountains of Turkey
Detective Conan	Anime
Mulhacén	Geography of Spain
Fedora Project	Linux
Maaloula	Cities in Syria
Juliana of the Netherlands	Kings and Queens of the Netherlands, Deaths from pneumonia, Deaths from dementia, 1909 births, 2004 deaths
George Szell	1897 births, 1970 deaths, American conductors, Entertainers from Budapest, Entertainers from Vienna, Hungarian conductors, Naturalized citizens of the United States
Duncan Forbes of Culloden	Scottish people, 1644 births, 1704 deaths
Coláiste an Phiarsaigh	Schools, County Cork
Annapurna I Main	Himalayas, Mountains of Nepal
History of Vietnam	History of Vietnam
Operation Cornflakes	Philately, World War II, Espionage, 1945 establishments
Wilhelmina of the Netherlands	Kings and Queens of the Netherlands, 1880 births, 1962 deaths
Eddie Fatu	1973 births, 2009 deaths, American professional wrestlers, Drug-related deaths, Former WWE wrestlers
William III of the Netherlands	1817 births, 1890 deaths, House of Orange-Nassau, Knights of the Garter, Knights of the Golden Fleece, Grand Dukes of Luxembourg
Susan B. Anthony	1820 births, 1906 deaths, American abolitionists, American civil rights activists, American feminists, American Protestants, Cardiovascular disease deaths in the United States, Deaths from heart failure, Deaths from pneumonia, People from Massachusetts, Unitarians
William II of the Netherlands	1792 births, 1849 deaths, Kings and Queens of the Netherlands, Grand Dukes of Luxembourg, People from The Hague
Grand Duchess Anna Pavlovna of Russia	1795 births, 1865 deaths, Russian grand dukes and duchesses, House of Holstein-Gottorp-Romanov, House of Orange-Nassau, Kings and Queens of the Netherlands, Kings and Queens consort
Prince Bernhard of the Netherlands	1911 births, 2004 deaths, Bailiffs Grand Cross of the Order of St John, Cancer deaths in the Netherlands, Deaths from lung cancer, Dutch lobbyists, Dutch military people, Dutch military personnel of World War II, Dutch royalty, German nobility, People from Jena, Princes and princesses
George Victor, Prince of Waldeck and Pyrmont	1831 births, 1893 deaths, Princes and princesses
Emma of Waldeck and Pyrmont	1858 births, 1934 deaths, House of Orange-Nassau, Regents, Deaths from bronchitis
Dajabón River	Rivers of the Dominican Republic
Vocational school	Types of educational institutions
Technical school	Types of educational institutions
Giardia lamblia	Parasites
Colloquialism	Language
Bernard Dietz	1948 births, Living people, German footballers, Sportspeople from North Rhine-Westphalia
Rolf Rüssmann	1950 births, 2009 deaths, German footballers, Sportspeople from North Rhine-Westphalia
Rainer Bonhof	1952 births, Living people, German footballers, Sportspeople from North Rhine-Westphalia
Rüdiger Abramczik	1956 births, Living people, German footballers, German football managers, People from Gelsenkirchen, Sportspeople from North Rhine-Westphalia
Herbert Zimmermann	1954 births, Living people, German footballers, Sportspeople from Rhineland-Palatinate
Heinz Flohe	1948 births, 2013 deaths, Deaths from stroke, German footballers, People from Cologne, Sportspeople from North Rhine-Westphalia
Hans-Georg Schwarzenbeck	1948 births, Living people, German footballers, Sportspeople from Munich
Harald Konopka	1952 births, Living people, German footballers, Sportspeople from North Rhine-Westphalia
Dieter Müller	1954 births, Living people, German footballers, Sportspeople from Hesse
Erich Beer	1946 births, Living people, German footballers, Sportspeople from Bavaria
Bernhard Cullmann	1949 births, Living people, German footballers, Sportspeople from Rhineland-Palatinate
Bernd Hölzenbein	1946 births, Living people, German footballers, Sportspeople from Hesse
Gerd Zewe	1950 births, Living people, German footballers, Sportspeople from Saarland
Ronald Worm	1953 births, Living people, German footballers, People from Duisburg, Sportspeople from North Rhine-Westphalia
Rudi Kargus	1952 births, Living people, German footballers, People from Worms, Germany, Sportspeople from Rhineland-Palatinate
Dieter Burdenski	1950 births, Living people, German association football goalkeepers, Sportspeople from Bremen (state)
Helmut Schön	1915 births, 1996 deaths, German football managers, German footballers, People from Dresden, Sportspeople from Saxony
Horst-Dieter Höttges	1943 births, Living people, German footballers, People from Mönchengladbach, Sportspeople from North Rhine-Westphalia
Herbert Wimmer	1944 births, Living people, German footballers, People from Liège (province)
Jürgen Grabowski	1944 births, Living people, German footballers, Sportspeople from Hesse
Günter Netzer	1944 births, Living people, German footballers, People from Mönchengladbach, Sportspeople from North Rhine-Westphalia
Jupp Heynckes	1945 births, Living people, German football managers, German footballers, People from Mönchengladbach, Sportspeople from North Rhine-Westphalia
Wolfgang Overath	1943 births, Living people, German footballers, Sportspeople from North Rhine-Westphalia
Uli Hoeneß	1952 births, Living people, 1972 Summer Olympics, 1974 FIFA World Cup players, German footballers, German Olympians, People from Ulm, Sportspeople from Baden-Württemberg
Dieter Herzog	1946 births, 1974 FIFA World Cup players, German footballers, Living people, People from Oberhausen, Sportspeople from North Rhine-Westphalia
Jupp Kapellmann	1949 births, Living people, German footballers, Sportspeople from North Rhine-Westphalia
Helmut Kremers	1949 births, Living people, German footballers, Sportspeople from North Rhine-Westphalia, People from Mönchengladbach
Norbert Nigbur	1948 births, Living people, German association football goalkeepers, People from Gelsenkirchen, Sportspeople from North Rhine-Westphalia
Wolfgang Kleff	1946 births, Living people, German association football goalkeepers, Sportspeople from North Rhine-Westphalia
Karl-Heinz Schnellinger	1939 births, Living people, German footballers, Sportspeople from North Rhine-Westphalia
Willi Schulz	1938 births, Living people, German footballers, People from Bochum, Sportspeople from North Rhine-Westphalia
Wolfgang Weber	1944 births, Living people, German footballers, German football managers, People from former German territories
Helmut Haller	1939 births, 2012 deaths, 1962 FIFA World Cup players, 1966 FIFA World Cup players, 1970 FIFA World Cup players, Deaths from dementia, Deaths from Parkinson's disease, Disease-related deaths in Germany, German footballers, People from Augsburg, Sportspeople from Bavaria
Sigfried Held	1942 births, Living people, German footballers, German football managers, People from former German territories
Klaus Fichtel	1944 births, Living people, German footballers, Sportspeople from North Rhine-Westphalia
Reinhard Libuda	1943 births, 1996 deaths, German footballers, Sportspeople from North Rhine-Westphalia
Bernd Patzke	1943 births, Living people, German footballers, German football managers, Sportspeople from Berlin
Max Lorenz	1939 births, Living people, German footballers, Sportspeople from Bremen (state)
Hannes Löhr	1942 births, 2016 deaths, German footballers, German football managers, Sportspeople from North Rhine-Westphalia
Klaus-Dieter Sieloff	1942 births, 2011 deaths, German footballers, People from former German territories
Peter Dietrich	1944 births, Living people, German footballers, Sportspeople from Hesse
Manfred Manglitz	1940 births, Living people, German association football goalkeepers, People from Cologne, Sportspeople from North Rhine-Westphalia
Horst Wolter	1942 births, Living people, German footballers, Sportspeople from Berlin
Cauldron	Everyday life
Frying pan	Cookware and bakeware
Huang Xianfan	1899 births, Chinese historians, Teachers, 1982 deaths, Chinese scholars
Anaxandridas II	525 BC deaths, Year of birth unknown, Ancient Greeks, Kings of Sparta
Foreign minister	Government occupations
Hans Tilkowski	1935 births, 2020 deaths, German football managers, German footballers, People from Dortmund, Sportspeople from North Rhine-Westphalia
Albert Brülls	1937 births, 2004 deaths, German footballers, German football managers, Sportspeople from North Rhine-Westphalia
Lothar Emmerich	1941 births, 2003 deaths, German footballers, German football managers, People from Dortmund, Sportspeople from North Rhine-Westphalia
Heinz Hornig	1937 births, Living people, German footballers, People from Gelsenkirchen, Sportspeople from North Rhine-Westphalia
Friedel Lutz	1939 births, Living people, German footballers, Sportspeople from Hesse
Wolfgang Paul (footballer)	1940 births, Living people, German footballers, Sportspeople from North Rhine-Westphalia
Werner Krämer	1940 births, 2010 deaths, German footballers, People from Duisburg, Sportspeople from North Rhine-Westphalia
Günter Bernard	1939 births, Living people, German footballers, Sportspeople from Bavaria
Jacobins	French Revolution
Classicism	Art movements
Tottenham Hale station	Railway stations in Haringey, Railway stations opened in 1840, Railway stations served by National Express East Anglia, Tottenham, Tube stations in Haringey, Victoria Line stations, 1840 establishments in England
Clapton railway station	Railway stations in Hackney, Transport in Hackney, London Travelcard zone 2, 1873 establishments in England, Railway stations served by National Express East Anglia, London Travelcard zone 3
List of Police Academy episodes	Lists of animated television series episodes, Police Academy
P versus NP	Conjectures, Computing
Backstreet Boys	1990s American music groups, 2000s American music groups, 2010s American music groups, American boy bands, American pop music groups, American R&B bands, Musical groups established in 1993, 1993 establishments in Florida, Musical groups from Orlando, Florida, Musical groups disestablished in 2001, 2001 disestablishments in the United States, 2000s disestablishments in Florida, Musical groups established in 2004, 2004 establishments in Florida
Brighton & Hove Albion F.C.	Premier League clubs, Brighton, 1901 establishments in England
Withdean Stadium	Football stadiums in England, Brighton
Isambard Kingdom Brunel	1806 births, 1859 deaths, British engineers, People from Portsmouth
Crab-eating Frog	Frogs
Humulus	Cannabaceae
Guillaume de Machaut	1377 deaths, Medieval composers, French composers, Medieval poets, French poets
Pérotin	Medieval composers, French composers
Stratford station	Jubilee Line stations, Docklands Light Railway stations, Central Line stations, Transport in Newham, London Overground stations, London Travelcard zone 3, Railway stations served by National Express East Anglia
Léonin	Medieval composers, French composers
Ipswich railway station	Railway stations in Suffolk, Ipswich, 1860 establishments in England
Dmitri Kabalevsky	1904 births, 1987 deaths, 20th century composers, Russian composers
Symphony No. 5 "Fate" (Beethoven)	Compositions by Ludwig van Beethoven, Symphonies
Spectrum of a ring	Geometry
Commutative ring	Algebra
Homotopy	Mathematics
Music school	Music education, Music schools
Turandot	Compositions by Giacomo Puccini, 1920s operas, 1926
Spontaneous human combustion	Death
Marsupial lion	Marsupials of Australia, Extinct species
Rooibos	Tea
Jill Biden	1951 births, Living people, American teachers, First Ladies of the United States, Second Ladies of the United States, Joe Biden
Herbert Erhardt	1930 births, 2010 deaths, 1954 FIFA World Cup players, 1958 FIFA World Cup players, 1962 FIFA World Cup players, German footballers, Sportspeople from Bavaria
Leo Wilden	1936 births, Living people, German footballers, Sportspeople from North Rhine-Westphalia
Horst Szymaniak	1934 births, 2009 deaths, German footballers, Sportspeople from North Rhine-Westphalia
Willi Koslowski	1937 births, Living people, German footballers, People from Gelsenkirchen, Sportspeople from North Rhine-Westphalia
Hans Schäfer	1927 births, 2017 deaths, German footballers, People from Cologne, Sportspeople from North Rhine-Westphalia
Hans Nowak	1937 births, Living people, German footballers, People from Gelsenkirchen, Sportspeople from North Rhine-Westphalia
Jürgen Kurbjuhn	1940 births, 2014 deaths, German footballers, People from former German territories
Jürgen Werner	1935 births, 2002 deaths, German footballers, Sportspeople from Hamburg
Willi Giesemann	1937 births, Living people, German footballers, Sportspeople from Lower Saxony
Hans Sturm	1935 births, 2007 deaths, German footballers, People from former German territories
Engelbert Kraus	1934 births, 2016 deaths, German footballers, Sportspeople from Hesse
Günther Herrmann	1939 births, Living people, German footballers, Sportspeople from Rhineland-Palatinate
Heinz Strehl	1938 births, 1986 deaths, German footballers, Sportspeople from Bavaria
Heinz Vollmar	1936 births, 1987 deaths, German footballers, Sportspeople from Saarland
Günter Sawitzki	1932 births, 2020 deaths, German footballers, Sportspeople from North Rhine-Westphalia
Wolfgang Fahrian	1941 births, Living people, German association football goalkeepers, Sportspeople from Baden-Württemberg
Sepp Herberger	1897 births, 1977 deaths, German football managers, German footballers, People from Mannheim, Sportspeople from Baden-Württemberg
Han Solo	Fictional characters introduced in 1977, Star Wars Anthology characters, Star Wars characters, Star Wars Skywalker Saga characters
Hibari Misora	Japanese movie actors, 1937 births, 1989 deaths, Singers from Kanagawa Prefecture
Northumberland Park railway station	Transport in Haringey, Railway stations in Haringey, Railway stations opened in 1840, Railway stations served by National Express East Anglia, London Travelcard zone 3
Angel Road railway station	Railway stations opened in 1840, Railway stations in Enfield, Railway stations served by National Express East Anglia, 1840 establishments in England
Taz-Mania	Animated television series, Fox television series, Television spin-offs, 1991 television series debuts, Kids WB series, Cartoon Network series, Spacetoon shows, 1993 television series endings, English-language television programs
Saint-Malo	Communes in Ille-et-Vilaine, Subprefectures in France
Snorks	Animated television series, English-language television programs, 1984 television series debuts, 1989 television series endings
First Lady	First Ladies
Groundhog Day	Holidays
Pre)thing	American rock bands, musical groups from California
Betulaceae	Betulaceae
Iznogoud	Animated television series, French television series, Comic books
Ponders End railway station	London Travelcard zone 5, Railway stations in Enfield, Railway stations opened in 1840, Railway stations served by National Express East Anglia
Brimsdown railway station	Railway stations in Enfield, 1884 establishments in England, Railway stations served by National Express East Anglia
Enfield Lock railway station	Railway stations in Enfield, London Travelcard zone 6, Railway stations served by National Express East Anglia, 1980s disestablishments in the United Kingdom, 20th century disestablishments in England
Waltham Cross railway station	Railway stations in Hertfordshire, Railway stations served by National Express East Anglia, 1840 establishments in England, Railway stations opened in 1840
Parbatya Chattagram Jana Sanghati Samiti	Chittagong Hill Tracts, Political parties in Bangladesh, 1973 establishments in Asia, 1970s establishments in Bangladesh
Fritz Herkenrath	1928 births, 2016 deaths, German footballers, People from Cologne, Sportspeople from North Rhine-Westphalia
Erich Juskowiak	1926 births, 1983 deaths, German footballers, People from Oberhausen, Sportspeople from North Rhine-Westphalia
Horst Eckel	1932 births, 1954 FIFA World Cup players, 1958 FIFA World Cup players, German footballers, Living people, Sportspeople from Rhineland-Palatinate
Heinz Wewers	1927 births, 2008 deaths, German footballers, Sportspeople from North Rhine-Westphalia
Georg Stollenwerk	1930 births, 2014 deaths, German footballers, Sportspeople from North Rhine-Westphalia
Helmut Rahn	1929 births, 2003 deaths, 1954 FIFA World Cup players, 1958 FIFA World Cup players, German footballers, Sportspeople from Essen
Fritz Walter	1920 births, 2002 deaths, German footballers, People from Kaiserslautern, Sportspeople from Rhineland-Palatinate
Aki Schmidt	1935 births, 2016 deaths, German footballers, People from Dortmund, Sportspeople from North Rhine-Westphalia
Bernhard Klodt	1926 births, 1996 deaths, German footballers, People from Gelsenkirchen, Sportspeople from North Rhine-Westphalia
Hans Cieslarczyk	1937 births, 2020 deaths, German footballers, Sportspeople from North Rhine-Westphalia
Alfred Kelbassa	1925 births, 1988 deaths, German footballers, People from Gelsenkirchen, Sportspeople from North Rhine-Westphalia
Rudi Hoffmann	1935 births, Living people, German footballers, Sportspeople from Baden-Württemberg
Wolfgang Peters	1929 births, 2003 deaths, German footballers
Hermann Nuber	1935 births, Living people, German footballers, Sportspeople from Hesse
Heinz Kwiatkowski	1926 births, 2008 deaths, German association football goalkeepers, People from Gelsenkirchen, Sportspeople from North Rhine-Westphalia
Fritz Laband	1925 births, 1982 deaths, German footballers, People from former German territories
Werner Kohlmeyer	1924 births, 1974 deaths, German footballers, People from Kaiserslautern, Sportspeople from Rhineland-Palatinate
Hans Bauer	1927 births, 1997 deaths, German footballers, Sportspeople from Munich
Josef Posipal	1927 births, 1997 deaths, German footballers, Romanian people
Karl Mai	1928 births, 1993 deaths, German footballers, Sportspeople from Bavaria
Paul Mebus	1920 births, 1993 deaths, German footballers, People from Düsseldorf, Sportspeople from North Rhine-Westphalia
Werner Liebrich	1927 births, 1995 deaths, German footballers, People from Kaiserslautern, Sportspeople from Rhineland-Palatinate
Karl-Heinz Metzner	1923 births, 1994 deaths, German footballers, Sportspeople from Hesse
Max Morlock	1925 births, 1994 deaths, German footballers, People from Nuremberg, Sportspeople from Bavaria
Ottmar Walter	1924 births, 2013 deaths, Deaths from Alzheimer's disease, German footballers, People from Kaiserslautern, Sportspeople from Rhineland-Palatinate
Richard Herrmann	1923 births, 1962 deaths, German footballers
Ulrich Biesinger	1933 births, 1954 FIFA World Cup players, German footballers, People from Augsburg, Sportspeople from Bavaria
Alfred Pfaff	1926 births, 2008 deaths, German footballers, Sportspeople from Frankfurt
Heinz Kubsch	1930 births, 1993 deaths, German association football goalkeepers, Sportspeople from Essen
Lee McKenzie	1977 births, Living people, British journalists
Man-in-the-middle attack	Computer security
Wahlenbergia	Campanulaceae
Jervis Bay Territory	States and territories of Australia
Loga (department)	Departments of Niger
Noble savage	History of ideas
Taro	Araceae
Campanulaceae	Campanulaceae
Cheshunt railway station	Railway stations in Hertfordshire, Railway stations served by National Express East Anglia, 1846 establishments in the United Kingdom, 1840s establishments in England
Theobalds Grove railway station	Railway stations in Hertfordshire, Railway stations opened in 1891, Railway stations served by National Express East Anglia, 1891 establishments in Europe, 1890s establishments in England, 1909 disestablishments, 1900s disestablishments in the United Kingdom, 20th century disestablishments in England, 1915 establishments, 1910s establishments in England, 1919 disestablishments, 1910s disestablishments in Europe, 1960 establishments in the United Kingdom, 1960s establishments in England
Turkey Street railway station	London Travelcard zone 6, Railway stations in Enfield, Railway stations opened in 1891, Railway stations served by National Express East Anglia
Southbury railway station	Railway stations in Enfield, London Travelcard zone 5, Railway stations opened in 1891, Railway stations served by National Express East Anglia
Blackhorse Road station	Victoria Line stations, Railway stations in Waltham Forest, London Overground stations, 1894 establishments in the United Kingdom
Walthamstow Central station	Victoria Line stations, Railway stations in Waltham Forest, Railway stations served by National Express East Anglia
Brixton tube station	Victoria Line stations, Transport in Lambeth, London Travelcard zone 2
Stockwell tube station	Northern Line stations, Victoria Line stations, Transport in Lambeth, London Travelcard zone 2
Vauxhall station	London Travelcard zone 1, London Travelcard zone 2, Railway stations in London, Victoria Line stations
Pimlico tube station	Victoria Line stations, Tube stations in the City of Westminster
London Victoria station	Railway stations in London, Circle Line stations, Victoria Line stations, London Travelcard zone 1
Green Park tube station	Victoria Line stations, Piccadilly Line stations, Jubilee Line stations, Tube stations in the City of Westminster, London Travelcard zone 1
Cristian Zaccardo	1981 births, Living people, Italian footballers
Fabio Grosso	1977 births, Living people, Italian footballers, Sportspeople from Rome
Daniele De Rossi	1983 births, Living people, Italian footballers, Sportspeople from Rome
Andrea Barzagli	1981 births, Living people, Italian footballers
Alberto Gilardino	1982 births, Living people, Italian footballers
Angelo Peruzzi	1970 births, Living people, Italian association football goalkeepers
Marco Amelia	1982 births, Living people, Italian association football goalkeepers
Vincenzo Iaquinta	1979 births, Living people, Italian footballers
Mauro Camoranesi	1976 births, Living people, Italian footballers
Gutter (philately)	Philately
Simone Barone	1978 births, Living people, Italian footballers
Simone Perrotta	1977 births, Living people, Italian footballers
Massimo Oddo	1976 births, Living people, Italian footballers
Marco Materazzi	1973 births, Living people, Italian footballers, Italian football managers, People from Lecce
Heating oil	Fossil fuels, Organic compounds, Oils
Oxford Circus tube station	Bakerloo Line stations, Victoria Line stations, Central Line stations, Tube stations in the City of Westminster, London Travelcard zone 1
Bishan	Places in Singapore
Warren Street tube station	Northern Line stations, Victoria Line stations, Tube stations in Camden, London Travelcard zone 1
King's Cross St. Pancras tube station	Circle Line stations, Hammersmith & City Line stations, Metropolitan Line stations, Northern Line stations, Piccadilly Line stations, Victoria Line stations, Tube stations in Camden, Railway stations opened in 1863, 1863 establishments in England, 1906 establishments in England, 1907 establishments in England, 1968 establishments in England
Highbury & Islington station	Victoria Line stations, Tube stations in Islington, London Overground stations, Railway stations in Islington, London Travelcard zone 2, Railway stations opened in 1872, Railway stations served by First Capital Connect, 1872 establishments in England
Finsbury Park station	Piccadilly Line stations, Victoria Line stations, Railway stations in Islington, Tube stations in Islington, 1861 establishments in the United Kingdom, Railway stations served by First Capital Connect, Railway stations in the United Kingdom, 1860s establishments in England
UK railway stations - A	Lists of railway stations in the United Kingdom
UK railway stations - B	Lists of railway stations in the United Kingdom
UK railway stations - C	Lists of railway stations in the United Kingdom
UK railway stations - D	Lists of railway stations in the United Kingdom
UK railway stations - Y	Lists of railway stations in the United Kingdom
Fareham	Towns in Hampshire
Frederick Douglass	1818 births, 1895 deaths, American abolitionists, African American writers, Ambassadors of the United States, American autobiographers, Writers from Maryland, Writers from New York, Slaves
Anti-psychiatry	Psychiatry
Oleaceae	Oleaceae
Karl Malone	1963 births, African-American basketball players, American Olympic gold medalists, Living people, Los Angeles Lakers players, Sportspeople from Louisiana, Utah Jazz players, National Basketball Association players with retired numbers, American basketball players
Vladislav F. Ribnikar	Serbian people
FreeNAS	Servers
Room on the 3rd Floor	McFly albums, 1999 albums, Debut albums, Pop rock albums
Wonderland (McFly album)	2005 albums, McFly albums
Just My Luck	2006 comedy movies, 2006 romance movies, 2000s fantasy-comedy movies, 2000s romantic comedy movies, 2000s teen comedy movies, 2000s teen romance movies, American fantasy-comedy movies, American romantic comedy movies, American teen comedy movies, American teen romance movies, English-language movies, Movies set in New York City
Motion in the Ocean	2006 albums, McFly albums
Darius Danesh	British television personalities, Musicians from Glasgow, Reality television participants, Scottish pop musicians, Scottish singers, Scottish stage actors, 1980 births, Living people
Hans Knappertsbusch	1888 births, 1965 deaths, German conductors, People from Wuppertal
Ernest Ansermet	1883 births, 1969 deaths, Conductors
Osgoode Hall Law School	Colleges and universities in Canada, Toronto
Ayaka Kimura	1981 births, Living people, Japanese movie actors, Japanese singers, Actors from Hyōgo Prefecture
Plantaginaceae	Plantaginaceae
Thinner	1984 books, 20th century American novels, English-language novels, Books by Stephen King
Carrie (novel)	1974 books, 20th century American novels, Books by Stephen King, Carrie, English-language novels, Borderline personality disorder in fiction, Horror novels, Rape in fiction, Telekinesis in fiction
Seiji Ozawa	1935 births, Conductors, Living people
List of cricket terms	Cricket lists, Sports words, Glossaries
Christian Panucci	1973 births, Living people, Italian footballers
Francesco Coco	1977 births, Living people, Italian footballers
Cristiano Zanetti	1977 births, Living people, Italian footballers
Cristiano Doni	1973 births, Living people, Italian footballers, Sportspeople from Rome
Christian Abbiati	1977 births, Living people, Italian footballers
Luigi Di Biagio	1971 births, Living people, Italian footballers, Sportspeople from Rome
Mark Iuliano	1973 births, Living people, Italian footballers
Angelo Di Livio	1966 births, Living people, Italian footballers, Sportspeople from Rome
Damiano Tommasi	1974 births, Living people, Italian footballers
Marco Delvecchio	1973 births, Living people, Italian footballers
Vincenzo Montella	1974 births, Living people, Italian footballers
Giovanni Trapattoni	1939 births, Living people, 1960 Summer Olympics, 1962 FIFA World Cup players, A.C. Milan players, Italian footballers, Italian football managers, Italian Olympians, Sportspeople from Lombardy
Gianluca Pessotto	1970 births, Living people, Italian footballers
Moreno Torricelli	1970 births, Living people, Italian footballers, Italian football managers
Gianluca Pagliuca	1966 births, Living people, Italian association football goalkeepers, Sportspeople from Emilia-Romagna, People from Bologna
Sandro Cois	1972 births, Living people, Italian footballers
Roberto Di Matteo	1970 births, Living people, Italian footballers, Italian football managers
Francesco Moriero	1969 births, Living people, Italian footballers, Italian football managers, People from Lecce
Enrico Chiesa	1970 births, Living people, Italian footballers, Italian football managers, People from Genoa
Cesare Maldini	1932 births, 1962 FIFA World Cup players, Italian footballers, Italian football managers, People from Trieste, Sportspeople from Friuli Venezia-Giulia
Reform Judaism	Jewish denominations, Judaism in Germany
Nickelback	1990s Canadian music groups, 2000s Canadian music groups, 2010s Canadian music groups, Alberta, Alternative metal bands, Canadian hard rock bands, Musical groups established in 1995, Post-grunge bands, Roadrunner Records, 1995 establishments in Canada
Watermael-Boitsfort	Municipalities of Brussels-Capital Region
Fanfare	Musical forms
Intensive care unit	Emergency services
The Wild	2006 animated movies, 2006 computer-animated movies, 2000s adventure movies, American adventure movies, American animated movies, Canadian animated movies, Disney animated movies, English-language movies, Movies about animals, Movies about lions, Movies set in Africa, Movies set in New York City, Buena Vista International movies
Hip dysplasia	Dogs, Diseases and disorders of joints
Walsall F.C.	English football clubs, 1888 establishments in England
Bescot Stadium	Football stadiums in England
Hearing dog	Working dogs, Service animals
Kid Cudi	1984 births, Living people, American rap musicians from Ohio, Singers from Cleveland, Ohio, People from Shaker Heights, Ohio
Kremlin	History of Russia
Surveillance	Espionage, Technology
Luigi Apolloni	1967 births, Living people, Italian footballers
Antonio Benarrivo	1968 births, Living people, Italian footballers
Lorenzo Minotti	1967 births, Living people, Italian footballers
Roberto Mussi	1963 births, Living people, Italian footballers
Mauro Tassotti	1960 births, Living people, Italian footballers, Italian football managers, Sportspeople from Rome
Luca Marchegiani	1966 births, Living people, Italian association football goalkeepers, People from Ancona
Nicola Berti	1967 births, Living people, Italian footballers
Antonio Conte	1969 births, Living people, Italian footballers, Italian football managers, People from Lecce
Roberto Donadoni	1963 births, Living people, Italian footballers, Italian football managers
Alberigo Evani	1963 births, Living people, Italian footballers, Italian football managers
Pierluigi Casiraghi	1969 births, Living people, Italian footballers, Sportspeople from Lombardy, People from Monza
Daniele Massaro	1961 births, Living people, Italian footballers, Sportspeople from Lombardy, People from Monza
Giuseppe Signori	1968 births, Living people, Italian footballers
Luca Bucci	1969 births, Living people, Italian association football goalkeepers, Sportspeople from Emilia-Romagna, People from Bologna
Arrigo Sacchi	1946 births, Living people, Italian footballers
Myalgia	Pain, Muscular system
Charlotte County, Florida	Florida counties, 1921 establishments in Florida
Citrus County, Florida	Florida counties, 1887 establishments in Florida
DeSoto County, Florida	Florida counties, 1887 establishments in Florida
Hardee County, Florida	Florida counties, 1921 establishments in Florida
Hernando County, Florida	Florida counties, 1840s establishments in Florida Territory, 1843 establishments in the United States
Highlands County, Florida	Florida counties, 1921 establishments in Florida
Lee County, Florida	Florida counties, 1873 establishments in the United States, 19th-century establishments in Florida
Levy County, Florida	Florida counties, 1845 establishments in the United States, 1840s establishments in Florida
Manatee County, Florida	Florida counties, 1855 establishments in the United States, 1850s establishments in Florida
Pasco County, Florida	Florida counties, 1887 establishments in Florida
Pinellas County, Florida	Florida counties, 1911 establishments in the United States, 1910s establishments in Florida
Sarasota County, Florida	Florida counties, 1921 establishments in Florida
Sumter County, Florida	Florida counties, 1853 establishments in Florida
Distribution (mathematics)	Mathematics
Achterhooks	German dialects, Indo-European languages
What I've Done	2007 songs, Linkin Park songs
Naxos Island	Islands of Greece
Blantyre	Settlements in Malawi, Cities in Africa
Walter Zenga	1960 births, Living people, Italian association football goalkeepers, Italian football managers
Luigi De Agostini	1961 births, Living people, Italian footballers, People from Udine
Ciro Ferrara	1967 births, Living people, Italian footballers, Italian football managers
Riccardo Ferri	1963 births, Living people, Italian footballers
Pietro Vierchowod	1959 births, Living people, Italian footballers, Italian football managers
Carlo Ancelotti	1959 births, Living people, 1986 FIFA World Cup players, 1990 FIFA World Cup players, Italian footballers, Italian football managers, Sportspeople from Emilia-Romagna
Fernando De Napoli	1964 births, Living people, Italian footballers
Stefano Tacconi	1957 births, Living people, Italian association football goalkeepers
Giuseppe Giannini	1964 births, Living people, Italian footballers, Italian football managers, Sportspeople from Rome
Giancarlo Marocchi	1965 births, Living people, Italian footballers
Andrea Carnevale	1961 births, Living people, Italian footballers
Roberto Mancini	1964 births, Living people, Italian footballers, Italian football managers
Salvatore Schillaci	1964 births, Living people, Italian footballers, People from Palermo
Aldo Serena	1960 births, Living people, Italian footballers
Azeglio Vicini	1933 births, 2018 deaths, Italian footballers, Italian football managers
Giovanni Galli	1958 births, Living people, 1982 FIFA World Cup players, 1986 FIFA World Cup players, Italian footballers, People from Pisa, Sportspeople from Tuscany
Antonio Cabrini	1957 births, Living people, Italian footballers, Italian football managers, People from Cremona
Fulvio Collovati	1957 births, Living people, Italian footballers
Sebastiano Nela	1961 births, Living people, Italian footballers
Gaetano Scirea	1953 births, 1989 deaths, Italian footballers
Roberto Tricella	1959 births, Living people, Italian footballers
Salvatore Bagni	1956 births, Living people, Italian footballers
Giuseppe Baresi	1958 births, Living people, Italian footballers
Franco Tancredi	1955 births, Living people, Italian association football goalkeepers
Antonio Di Gennaro	1958 births, Living people, Italian footballers
Marco Tardelli	1954 births, Living people, Italian footballers, Italian football managers
Bruno Conti	1955 births, Living people, Italian footballers
Alessandro Altobelli	1955 births, Living people, Italian footballers
Giuseppe Galderisi	1963 births, Living people, Italian footballers, Italian football managers
Enzo Bearzot	1927 births, 2010 deaths, Italian footballers, Italian football managers
Amorgos	Islands of Greece
Heraldry of León	Heraldry, Castile and León
Will County, Illinois	Illinois counties, 1836 establishments in Illinois
Jackson Township, Will County, Illinois	Townships in Illinois, 1849 establishments in the United States, 1840s establishments in Illinois
Channahon Township, Will County, Illinois	Townships in Illinois, 1849 establishments in the United States, 1840s establishments in Illinois
Macro photography	Photography
Zapata County, Texas	Texas counties, 1858 establishments in the United States, 1850s establishments in Texas
Zavala County, Texas	Texas counties, 1858 establishments in the United States, 1850s establishments in Texas
Ziebach County, South Dakota	South Dakota counties, 1911 establishments in South Dakota
Claudio Gentile	1953 births, Living people, Italian footballers, People from Tripoli
Giuseppe Dossena	1958 births, Living people, Italian footballers, Italian football managers, Sportspeople from Milan
Giampiero Marini	1951 births, Living people, Italian footballers, Lodi
Ivano Bordon	1951 births, Living people, Italian association football goalkeepers
Gabriele Oriali	1952 births, Living people, Italian footballers, Sportspeople from Lombardy, People from Como
Franco Causio	1949 births, Living people, Italian footballers, People from Lecce
Francesco Graziani	1952 births, Living people, Italian footballers
Franco Selvaggi	1953 births, Living people, Italian footballers
Monira Rahman	1966 births, Living people, Bangladeshi people
Aage Niels Bohr	1922 births, 2009 deaths, Danish scientists, People from Copenhagen, Physicists
Oestrogen	Biology, Steroid hormones
Hapax legomenon	Linguistics
Gulf of California	Gulfs, Pacific Ocean, Geography of Mexico
Jeff Lynne	English guitarists, English singers, English rock composers, Living people, English pop musicians, Rock musicians, 1947 births
Mauro Bellugi	1950 births, 2021 deaths, Italian footballers, Deaths from the COVID-19 pandemic in Italy
Antonello Cuccureddu	1949 births, Living people, Italian footballers, Italian football managers
Aldo Maldera	1953 births, 2012 deaths, Italian footballers
Lionello Manfredonia	1956 births, Living people, Italian footballers, Sportspeople from Rome
Romeo Benetti	1945 births, Living people, 1974 FIFA World Cup players, 1978 FIFA World Cup players, Italian footballers, People from Verona, Sportspeople from Veneto
Eraldo Pecci	1955 births, Living people, Italian footballers
Paolo Conti	1950 births, Living people, Italian association football goalkeepers
Patrizio Sala	1955 births, Living people, Italian footballers
Renato Zaccarelli	1951 births, Living people, Italian footballers, Italian football managers, People from Ancona
Claudio Sala	1947 births, Living people, Italian association football goalkeepers
Paolo Pulici	1950 births, Living people, Italian footballers
Palestinian people	Palestinian people
Theseus	Mythology
Alexey Rykov	People executed by firearm, Socialists, Heads of government of the Soviet Union, 1881 births, 1938 deaths
Luciano Spinosi	1950 births, Living people, Italian footballers, Sportspeople from Rome
Giacinto Facchetti	1942 births, 2006 deaths, Association football defenders, Association football full-backs, Cancer deaths in Italy, Deaths from pancreatic cancer, Italian footballers, People from Lombardy
Francesco Morini	1944 births, 2021 deaths, Italian footballers, Deaths from myocardial infarction
Tarcisio Burgnich	1939 births, 2021 deaths, Deaths from stroke, Italian football managers, Italian footballers
Sandro Mazzola	1942 births, Living people, Italian footballers
Giorgio Chinaglia	1947 births, 2012 deaths, 1974 FIFA World Cup players, Cardiovascular disease deaths in Florida, Deaths from myocardial infarction, Italian footballers, Sportspeople from Cardiff, Sportspeople from Tuscany
Luigi Riva	1944 births, Living people, Italian footballers
Enrico Albertosi	1939 births, Living people, Italian association football goalkeepers
Giuseppe Sabadini	1949 births, Living people, Italian footballers, Italian football managers
Giuseppe Wilson	1945 births, Living people, Italian footballers
Antonio Juliano	1943 births, Living people, Italian footballers
Luciano Re Cecconi	1948 births, 1977 deaths, Italian footballers
Pietro Anastasi	1948 births, 2020 deaths, Cancer deaths in Italy, Italian footballers
Roberto Boninsegna	1943 births, Living people, Italian footballers, Mantua
Luciano Castellini	1945 births, Living people, Italian association football goalkeepers, Italian football managers
Ferruccio Valcareggi	1919 births, 2005 deaths, Italian footballers, Italian football managers, People from Trieste
Frisia	History of Germany, History of the Netherlands
Ilmenau River	Geography of Lower Saxony, Rivers of Germany
Tulcea	Municipalities of Romania, County capitals of Romania
Octet	Numbers
Red beans and rice	American food, Rice dishes
Colombo, Paraná	Cities in Paraná State, 1890 establishments, 1890s establishments in Brazil
Milton Keynes Dons F.C.	English football clubs, Milton Keynes, 2004 establishments in England
Pinhais	Cities in Paraná State
Chlamydia trachomatis	Gram-negative bacteria
Baby hatch	Hospitals, Babies
Anonymous birth	Law, Family, Babies
Medemblik	Medemblik, Cities in the Netherlands, Settlements in North Holland
Charles, Duke of Guelders	1467 births, 1538 deaths, Dukes and duchesses, House of Egmond
Maarten van Rossum	Dutch military people
Warlord	People
Righteous Among the Nations	Righteous Among the Nations
Eurostar	Trains, High-speed rail, Transport in Europe
Fabrizio Poletti	1943 births, Living people, Italian footballers
Pierluigi Cera	1941 births, Living people, Italian footballers
Ugo Ferrante	1945 births, 2004 deaths, Italian footballers
Comunardo Niccolai	1946 births, Living people, Italian footballers
Roberto Rosato	1943 births, 2010 deaths, Italian footballers
Giorgio Puia	1938 births, Living people, Italian footballers
Mario Bertini	1944 births, Living people, Italian footballers
Angelo Domenghini	1941 births, Living people, Italian footballers, Italian football managers
Giancarlo De Sisti	1943 births, Living people, Italian footballers, Italian football managers, Sportspeople from Rome
Lido Vieri	1939 births, Living people, Italian association football goalkeepers, Italian football managers
Sergio Gori	1946 births, Living people, Italian footballers
Giuseppe Furino	1946 births, Living people, Italian footballers, People from Palermo
Pierino Prati	1946 births, 2020 deaths, Cancer deaths in Italy, Italian footballers
Puppy Linux	Linux distributions
Narwhal	Toothed whales
Vailala Madness	Cults
Agranulocytosis	Diseases
Tegan and Sara	1995 establishments in Canada, 1990s Canadian music groups, 2000s Canadian music groups, 2010s Canadian music groups, Calgary, Canadian feminists, Canadian LGBT people, Canadian rock bands, Indie bands, Lesbian feminists, LGBT musical groups, Musical groups established in 1995, New wave bands, Twin people from Canada
Bradshaw Trail	1862 establishments in the United States, Roads in California, Trails, 1860s establishments in California
Wiley's Well	Geography of California, Riverside County, California
Alphonse of Poitiers	French people, Crusaders
Willem-Alexander of the Netherlands	1967 births, Living people, Dutch Calvinists, Kings and Queens of the Netherlands, Order of Merit of the Federal Republic of Germany, People from Utrecht (city), Current national leaders
Karst Tates	1971 births, 2009 deaths, Dutch people, Murderers who committed suicide
List of counties of the United Kingdom	Counties of the United Kingdom, United Kingdom-related lists
Light-dependent reaction	Metabolism, Cellular respiration
Light-independent reaction	Metabolism, Cellular respiration
2008	2008
Falafel	Middle Eastern foods
Meze	Middle Eastern foods, Snack foods
Finger food	Foods
Risotto	Italian food, Rice dishes
Subscription	Business
European wildcat	Felines
Krebs cycle	Metabolism, Cellular respiration
Coenzyme A	Cellular respiration, Metabolism
Acetyl	Chemical compounds, Functional groups
Multiple birth	Biological reproduction
Skins (TV series)	2007 British television series debuts, 2013 television series endings, 2000s British drama television series, 2000s LGBT television series, 2000s teen television series, 2010s British drama television series, 2010s LGBT television series, 2010s teen television series, BAFTA Award winning programmes, Bristol, British LGBT television programmes, British teen television series, LGBT drama television series, British teen drama television series, English-language television programs
Roberto Anzolin	1938 births, 2017 deaths, Italian association football goalkeepers
Paolo Barison	1936 births, 1979 deaths, Italian footballers, Italian football managers
Giacomo Bulgarelli	1940 births, 2009 deaths, Italian footballers
Romano Fogli	1938 births, 2021 deaths, Italian footballers, Italian football managers
Aristide Guarneri	1938 births, Living people, 1966 FIFA World Cup players, Italian footballers, Italian football managers, People from Cremona, Sportspeople from Lombardy
Francesco Janich	1937 births, 2019 deaths, Italian footballers, People from Udine
Spartaco Landini	1944 births, Living people, Italian footballers
Gianfranco Leoncini	1939 births, 2019 deaths, Italian footballers, Sportspeople from Rome
Giovanni Lodetti	1942 births, Living people, Italian footballers
Gigi Meroni	1943 births, 1967 deaths, Italian footballers, Sportspeople from Lombardy, People from Como
Ezio Pascutti	1937 births, 2017 deaths, Italian footballers
Marino Perani	1939 births, 2017 deaths, Deaths from stroke, Italian footballers
Pierluigi Pizzaballa	1939 births, Living people, Italian association football goalkeepers
Francesco Rizzo	1943 births, Living people, Italian footballers
Sandro Salvadore	1939 births, 2007 deaths, Italian footballers
Edmondo Fabbri	1921 births, 1995 deaths, Italian footballers
Lorenzo Buffon	1929 births, Living people, Italian association football goalkeepers
Giacomo Losi	1935 births, Living people, Italian footballers
Luigi Radice	1935 births, 2018 deaths, Deaths from Alzheimer's disease, Italian footballers, Italian football managers
Bruno Mora	1937 births, 1986 deaths, Italian footballers
Humberto Maschio	1933 births, Living people, Argentine footballers, Italian footballers, Argentine football managers, Italian football managers
Giampaolo Menichelli	1938 births, Living people, Italian footballers, Sportspeople from Rome
Carlo Mattrel	1937 births, Living people, Italian association football goalkeepers
Angelo Sormani	1939 births, Living people, Italian footballers
Enzo Robotti	1935 births, Living people, Italian footballers, Italian football managers, People from Alessandria
Mario David	1934 births, 2005 deaths, Italian footballers, Italian football managers, People from Udine
Paride Tumburus	1939 births, 2015 deaths, 1960 Summer Olympics, 1962 FIFA World Cup players, Cardiovascular disease deaths in Italy, Deaths from myocardial infarction, Italian footballers, Sportspeople from Friuli Venezia-Giulia
Giorgio Ferrini	1907 births, 1982 deaths, Italian footballers, Italian football managers, Sportspeople from Piedmont, People from Alessandria
Paolo Mazza	1901 births, 1981 deaths, Italian footballers
Giovanni Ferrari	1939 births, 1976 deaths, Italian footballers, People from Trieste
Type I and type II errors	Statistics
Pita	Middle Eastern foods, Turkish food, Greek food, Azerbaijani food, Iranian food, Flatbreads
Easter Rising	20th century in Ireland, Irish republicanism, 20th century rebellions, Rebellions in Europe, Resistance to the British Empire, 1916 in Europe, April events
Kimora Lee Simmons	Participants in American reality television series, Television personalities from New York City, Businesspeople from St. Louis, Missouri, 1975 births, Living people
Phạm Duy	Composers, Vietnamese people, Deaths from liver disease, Deaths from cardiovascular disease, 1921 births, 2013 deaths
Camp Zama	Geography of Japan, Military of the United States
Icosagon	Polygons
Generic top-level domain	Top-level domains
Travian	2004 video games
Browser game	Internet, Types of video games, Video game genres
My Bloody Valentine	1980s Irish music groups, 1990s Irish music groups, 2000s Irish music groups, 2010s Irish music groups, Irish rock bands, Musical groups established in 1983, Musical groups from Dublin
President of Serbia	Presidents of Serbia
Animated cartoon	Animation
Shanti Bahini	Chittagong Hill Tracts, 1972 establishments in Asia, 1970s establishments in Bangladesh, 1997 disestablishments
Jagannath Azad	Pakistani people, 1918 births, 2004 deaths
Abu-Al-Asar Hafeez Jullundhri	1900 births, 1982 deaths, Pakistani people, Pakistani writers, Poets
Ahmed Ghulamali Chagla	1902 births, 1953 deaths, Pakistani people, Pakistani entertainers, People from Karachi
Weedy sea dragon	Fish of Australia
Guru Angad Dev	1504 births, 1539 deaths, Punjabi people, Sikhism
Cosmic microwave background radiation	Cosmology
Guru Ram Das	1534 births, 1581 deaths, Spiritual teachers, People from Lahore, Punjabi people, Sikhism
Guru Arjun Dev	Sikhism, 1563 births, 1606 deaths, Punjabi people
Juan Pablo Sorín	1976 births, Living people, Argentine footballers, Sportspeople from Buenos Aires
Fabricio Coloccini	1982 births, Living people, Argentine footballers, Córdoba, Argentina
Esteban Cambiasso	1980 births, Living people, Argentine footballers, Sportspeople from Buenos Aires
Gabriel Heinze	1978 births, Living people, Argentine footballers
Javier Mascherano	1984 births, Living people, Argentine footballers
Leo Franco	1977 births, Living people, Argentine footballers, Association football goalkeepers
Lionel Scaloni	1978 births, Living people, Argentine footballers
Rodrigo Palacio	1982 births, Living people, Argentine footballers
Gabriel Milito	1980 births, Living people, Argentine footballers
Leandro Cufré	1978 births, Living people, Argentine footballers
Maxi Rodríguez	1981 births, Living people, Argentine footballers
Lionel Messi	1987 births, Living people, Argentine footballers, Fraudsters, 2006 FIFA World Cup players, 2010 FIFA World Cup players, 2014 FIFA World Cup players, 2018 FIFA World Cup players, Association football forwards, Association football midfielders, Medalists at the 2008 Summer Olympics, Olympic gold medalists, Olympic medalists in football, UEFA Euro 2012 players
Julio Ricardo Cruz	1974 births, Living people, Argentine footballers
Nicolás Burdisso	1981 births, Living people, Argentine footballers
Lucho González	1981 births, Living people, Argentine footballers, Sportspeople from Buenos Aires
Oscar Ustari	1986 births, Living people, Argentine footballers, Association football goalkeepers
José Pekerman	1949 births, Living people, Argentine football managers, Argentine footballers, Argentine Jews, Jewish sportspeople
Brain Warp	Toys
Peter Pan	Fictional characters
Ashbourne	Towns in Derbyshire, Market towns in England
Michelle Richardson	Fictional British people, Television characters
Ittifaq party	Tatarstan, Nationalist organizations
Madagascar (1994 movie)	1994 drama movies, Cuban movies
Naegleria fowleri	Parasites, Protista
June McCarroll	1867 births, 1954 deaths, Safety
Milton Keynes Lightning	Ice hockey teams, Milton Keynes
King's Cross station	1852 establishments, 1850s establishments in England, Railway stations in London
Percy Jackson & the Olympians	Percy Jackson and the Olympians
Sakhalin	Pacific islands, Islands of Russia
Sopwith Camel	Military aviation, World War I aircraft, Aircraft
Celtic Christianity	Christianity of the Middle Ages, Irish culture, Christian denominations
Anne, Princess Royal	House of Windsor, Princesses Royal, Knights of the Garter, Knights of the Thistle, Knights Grand Cross of the Royal Victorian Order, Fellows of the Royal Society, Bailiffs Grand Cross of the Order of St John, Elizabeth II
Arkelstorp	Settlements in Skane County
Peter Phillips	1977 births, Living people, Royalty from London, House of Windsor, Alumni of the University of Exeter
Prince Edward, Earl of Wessex	1964 births, Living people, House of Windsor, United Kingdom Earls, Knights Grand Cross of the Royal Victorian Order, Knights of the Garter, British royalty, Elizabeth II
Salzach	Geography of Bavaria, Rivers of Austria, Rivers of Germany, Salzburgerland
Carlisle, Massachusetts	Towns in Massachusetts, 1650 establishments, 1650s establishments in Massachusetts
Geordi La Forge	Star Trek: The Next Generation characters
Methanol	Biofuels, Alcohols
Power over Ethernet	Computing
Modern history	History
Waterloo, Belgium	Municipalities of Walloon Brabant
Portuguese Empire	Colonialism, Overseas empires
Hundred Days	1815, 19th century in France, 1810s in Europe
Battle of the Teutoburg Forest	Battles of the Ancient World, Wars and battles of Ancient Rome, Germanic peoples, Battles involving Germany, Lower Saxony, 9, History of Germany
Organisation of Islamic Cooperation	1969 establishments, International organizations, Islamic organizations, Jeddah, Religion in Saudi Arabia, Members of the Organisation of Islamic Cooperation
Lamborghini	Lamborghini
Germán Burgos	1969 births, Living people, Argentine footballers, Association football goalkeepers
Mauricio Pochettino	1972 births, Living people, Argentine footballers, Argentine football managers
Matías Almeyda	1973 births, Living people, Argentine footballers
Javier Zanetti	1973 births, Living people, Argentine footballers, Sportspeople from Buenos Aires
Pablo Cavallero	1974 births, Living people, Argentine footballers, Association football goalkeepers
Diego Placente	1977 births, Living people, Argentine footballers, Sportspeople from Buenos Aires
Claudio Husaín	1974 births, Living people, Argentine footballers
Gustavo Adrián López	1973 births, Living people, Argentine footballers
Kily González	1974 births, Living people, Argentine footballers
Marcelo Gallardo	1976 births, Living people, Argentine footballers
Claudio Caniggia	1967 births, Living people, Argentine footballers
José Chamot	1969 births, Living people, Argentine footballers
Roberto Bonano	1970 births, Living people, Argentine footballers, Association football goalkeepers
Marcelo Bielsa	1955 births, Living people, Argentine footballers, Argentine football managers
Hyakunin Isshu	Card games
Japanese railways	Japanese railways
Usability	Terminology
Electro-optic modulator	Tools
Liquid crystal	Physics, Thermometers
Turing complete	Theoretical computer science
River Trent	Rivers of England
Kirkcudbrightshire	Kirkcudbrightshire
Kirkcudbright	Kirkcudbrightshire
Ayrshire	Ayrshire
Photographic filter	Photography
List of diplomatic missions in Russia	Russia-related lists
Nadia Comăneci	1961 births, Living people, Romanian gymnasts, Medalists at the 1976 Summer Olympics, Medalists at the 1980 Summer Olympics, Olympic bronze medalists, Olympic gold medalists, Olympic silver medalists
History of post-Soviet Russia	History of Russia
Hurricane Henriette (2007)	Hurricanes in Mexico, 2007 in the United States, 2007 in Mexico
Charles Stewart Parnell	1846 births, 1891 deaths, Irish politicians, People from County Wicklow
Haruki Murakami	Japanese writers, Living people, 1949 births, Asian translators, People from Kyoto Prefecture
Sinhala language	Sinhala language
Dhivehi	Indo-Aryan languages, Maldives, National symbols of the Maldives
Dera Ghazi Khan Division	Dera Ghazi Khan Division
Bahawalpur Division	Bahawalpur Division
Multan Division	Multan Division, Divisions of British India
Sahiwal Division	Sahiwal Division
Bannu Division	Districts of British India, Divisions of Khyber Pakhtunkhwa
Dera Ismail Khan Division	Divisions of Khyber Pakhtunkhwa, Divisions of British India
Kohat Division	Khyber Pakhtunkhwa
Malakand Division	Divisions of Balochistan (Pakistan), 2000 disestablishments, 2000s disestablishments in Asia
Mardan Division	Divisions of Khyber Pakhtunkhwa
Peshawar Division	Divisions of Khyber Pakhtunkhwa, Divisions of British India
Hyderabad Division	Divisions of Sindh, Divisions of British India
Bacchus	Roman gods and goddesses
SportsCenter	English-language television programs
Mythology (book)	Non-fiction books, 2007 books
Larkana Division	Divisions of Sindh
Tom Boonen	1980 births, Living people, Belgian cyclists, People from Antwerp (province)
Mirpur Khas Division	Divisions of Sindh
Sukkur Division	Divisions of Sindh, Divisions of British India
Baluchistan States Union	Former subdivisions of Pakistan, 20th century in Pakistan
Baluchistan (Chief commissioners province)	Provinces of British India
Interwar period	World War I, World War II, 1910s, 1920s, 1930s
Modernism	Art movements, Architectural styles, Literature, Philosophical movements and positions
Victorian era	History of the United Kingdom
De-Stalinization	1950s in the Soviet Union, 1960s, Politics of Russia
Pomelo	Citrus
Leiden University	1575 establishments, Colleges and universities in the Netherlands, Leiden, Establishments in the Netherlands, 1570s establishments in Europe
University of Amsterdam	1877 establishments in Europe, Amsterdam, Colleges and universities in the Netherlands, 19th century establishments in the Netherlands
Wouter Bos	1963 births, Living people, Deputy government ministers of the Netherlands, Deputy Prime Ministers of the Netherlands, Former leaders of political parties in the Netherlands, Former members of the House of Representatives of the Netherlands, Government ministers of the Netherlands, Labour Party (Netherlands) politicians, People from Vlaardingen, Politicians from South Holland
Hughes Medal	Science awards, Physics, Royal Society, 1902 establishments in Europe, 1900s establishments in the United Kingdom
J. J. Thomson	1856 births, 1940 deaths, British Nobel Prize winners, British physicists, Fellows of the Royal Society, Nuclear physicists, Order of Merit, People buried in Westminster Abbey, Presidents of the Royal Society
Johann Wilhelm Hittorf	1914 deaths, 1824 births, German physicists, People from Bonn
Flor-de-Lis	Folk music groups, Portuguese musicians
Gulf Air	Transport companies, Airlines of Asia, Bahrain
Terraforming	Space colonization
Felixstowe	Towns in Suffolk, Civil parishes in Suffolk, Port cities and towns of the North Sea, Port cities and towns of England, Suffolk Coastal
Malcolm Lowry	1909 births, 1957 deaths, British writers
Torn Curtain	1966 thriller movies, American thriller movies, Movies directed by Alfred Hitchcock, English-language movies, Universal Pictures movies
Frenzy	1972 movies, 1970s horror thriller movies, 1970s serial killer movies, British crime movies, British thriller movies, Crime thriller movies, English-language movies, Movies directed by Alfred Hitchcock, Movies set in London
Marnie	1960s crime drama movies, 1964 drama movies, American crime drama movies, American mystery movies, English-language movies, Movies based on books, Movies directed by Alfred Hitchcock, Rape in movies
Shadow of a Doubt	1943 movies, 1940s crime movies, 1940s thriller movies, American serial killer movies, American thriller movies, English-language movies, Movies directed by Alfred Hitchcock, Movies set in California, United States National Film Registry movies
Rope (movie)	1948 movies, 1940s crime movies, 1940s drama movies, American crime drama movies, American LGBT movies, English-language movies, LGBT crime movies, LGBT drama movies, Movies about murderers, Movies directed by Alfred Hitchcock, Movies set in Manhattan
Early modern period	Periods and ages in history
National Assembly	Legislatures
Kenneth Clarke	1940 births, Living people, Alumni of the University of Cambridge, Chancellors of the Exchequer, Conservative MPs (UK), Lord Chancellors, Members of the British House of Commons for English constituencies, Politicians from Nottinghamshire, UK MPs 1970–1974, UK MPs 1974, UK MPs 1974–1979, UK MPs 1979–1983, UK MPs 1983–1987, UK MPs 1987–1992, UK MPs 1992–1997, UK MPs 1997–2001, UK MPs 2001–2005, UK MPs 2005–2010, UK MPs 2010–2015, UK MPs 2015–2017, UK MPs 2017–2019
Swansea City A.F.C.	Premier League clubs, Swansea, 1912 establishments in the United Kingdom, 20th century establishments in Wales
Hartlepool United F.C.	1908 establishments in England, English football clubs, Hartlepool
Tippi Hedren	1930 births, Living people, Actors from Minnesota, American movie actors, American television actors
Japanese morning glory	Convolvulaceae
Pyrrhic victory	Battles of the Ancient World, Phrases
Iain Duncan Smith	1954 births, Living people, British Army officers, British Roman Catholics, Conservative MPs (UK), Leaders of the Conservative Party (UK), Leaders of the Opposition (United Kingdom), Members of the British House of Commons for English constituencies, Politicians from Edinburgh, Scottish Christians, Secretaries of State of the United Kingdom, UK MPs 1992–1997, UK MPs 1997–2001, UK MPs 2001–2005, UK MPs 2005–2010, UK MPs 2010–2015, UK MPs 2015–2017, UK MPs 2017–2019, UK MPs 2019–
Bill Hicks	1961 births, 1994 deaths, American stand-up comedians, Cancer deaths in the United States, Comedians from Georgia (U.S. state), Comedians from Texas, Deaths from pancreatic cancer, Disease-related deaths in Arkansas, Valdosta, Georgia
Gene Wilder	1933 births, 2016 deaths, American movie directors, American movie actors, American screenwriters, American stage actors, American television actors, American voice actors, Deaths from Alzheimer's disease, Disease-related deaths in Connecticut, Jewish American actors, Actors from Milwaukee, Wisconsin, People with cancer, Writers from Wisconsin
Exeter City F.C.	English football clubs, 1904 establishments in England
Die Lollipops	German pop music groups, Folk music groups, Children's musical groups
Water opossum	Marsupials of South America, Central America
Blazing Saddles	1974 comedy movies, 1970s western movies, United States National Film Registry movies, American comedy movies, American western movies, Movies directed by Mel Brooks
Alexander Rybak	1986 births, Living people, Eurovision Song Contest entrants, Norwegian composers, Norwegian singers, People from Minsk, Violinists, Eurovision Song Contest winners
Pika	Lagomorphs
Two-source hypothesis	Gospels
Favicon	Computers
Henry Rollins	1961 births, Living people, American movie actors, Singers from Washington, D.C., Writers from Washington, D.C., Actors from Washington, D.C., American bloggers
Tay-Sachs disease	Diseases
Joseph Swan	1828 births, 1914 deaths, English inventors, English physicists, English chemists, People from Sunderland, Legion of Honour
Atom Egoyan	1960 births, Living people, Canadian movie directors, Armenian movie directors, Armenian diaspora
Standard asteroid physical characteristics	Asteroids
Crowded House	1985 establishments in Australia, 1980s music groups, 1990s music groups, 2000s music groups, 2010s music groups, Australian rock bands, Musical groups from Melbourne
Amy Klobuchar	1960 births, Living people, 2020 United States presidential candidates, American Calvinists, American lawyers, Congregationalists, United States senators from Minnesota, University of Chicago alumni, US Democratic Party politicians, Yale University alumni, Breast cancer survivors
Maiden voyage	Ships, Travel
Riaz Shahid	1927 births, 1972 deaths, Cinema of Pakistan, Pakistani entertainers, People from Lahore
Neelo	2021 deaths, 1941 births, Deaths from cancer, Pakistani movie actors
High on Fire	American heavy metal bands, Musical groups from Oakland, California
Indian rhinoceros	Mammals of Asia, Rhinoceroses
Augusto Righi	1850 births, 1920 deaths, People from Bologna, Italian physicists
Fountain Hills	Towns in Arizona
Yu-Gi-Oh! (trading card game)	Yu-Gi-Oh!, Card games, 1999 establishments in Japan
Weston-on-Trent	Villages in Derbyshire
Kalmykia	Republics of Russia, Federal subjects of Russia
Sochi	Olympic cities, Sochi
Catherine II of Russia	Russian royalty, Russian Orthodox saints, Emperors and empresses, House of Holstein-Gottorp-Romanov, Deaths from stroke
Hiccups	Health
Napoleonic era	History of Europe, History of France
Socialist Federal Republic of Yugoslavia	Yugoslavia, Former federations, Former socialist republics, 1945 establishments in Europe, 1992 disestablishments in Europe
VIPoma	Health problems
2 Esdras	Old Testament books
Achlorhydria	Diseases and disorders of the digestive system
Adenoid	Head (body part)
Phlegm	Respiratory system
Mobile home	Home
Konstantin Rokossovsky	1896 births, 1968 deaths, Polish communist politicians, Politicians from Warsaw, Soviet generals, Soviet military personnel of World War II
Grand Theft Auto IV	2008 video games, PlayStation 3 games, Windows games, Xbox 360 games, Grand Theft Auto
Secure Digital card	Technology
Natasha Bedingfield	1981 births, Living people, English pop singers, English singer-songwriters, People from West Sussex, Singers from London, Singers from Sussex
Dje	Serbian language
Serbian Cyrillic alphabet	Cyrillic script, Serbian language
Rhinoceros (genus)	Rhinoceroses
Sumatran rhinoceros	Mammals of Asia
Integrated Services Digital Network	Computer networking
Werdenberg	Villages in St. Gallen
Édouard Manet	1832 births, 1883 deaths, Artists from Paris, Deaths from infectious disease, French painters
Khat	Celastrales, Drugs, Shrubs
Matsui Keishirō	1868 births, 1946 deaths, Japanese politicians, People from Osaka Prefecture
Country code	Internet, Country codes
National Capital Region (Canada)	Regions of Canada, Ottawa
Gatineau	Cities and towns in Quebec
Orientability	Geometry
Manzanillo, Colima	Cities in Mexico, Colima
Los Mochis	Cities in Mexico, Sinaloa
Real analysis	Mathematics
Cabo Corrientes	Geography of Mexico, Capes, Jalisco
Homeland	Cultural geography, Nationalism, Ethnicity
Strike (attack)	Violence
Mazatlán	Cities in Mexico, Sinaloa, 1530s establishments in Mexico, 1531 establishments
Rennet	Food ingredients
Kol people	Indian people, Ethnic groups in Bangladesh
Sena dynasty	History of Bangladesh, Royal dynasties
Pala Empire	Pala Empire
Tranquilliser	Drugs, Drugs used in psychiatry
Harsha	590 births, 647 deaths, Emperors and empresses, Indian monarchs
Las Bela (princely state)	Former subdivisions of Pakistan, Pakistani princely states
Maksim Mrvica	European pianists, Croatian people, Living people, 1975 births
Javan rhinoceros	Mammals of Asia
Wopke Eekhoff	1809 births, 1880 deaths, People from Leeuwarden, Writers from Friesland
Grote of Martinikerk	Churches in Europe, Buildings and structures in the Netherlands, Protestantism in the Netherlands, Súdwest-Fryslân
Middle East Broadcasting Center	Television networks, United Arab Emirates
Bumblebee	Bees
Italia 1	Television networks, Italian television
John Hoeven	1957 births, Living people, American Roman Catholics, US Republican Party politicians, Governors of North Dakota, United States senators from North Dakota, Bankers, People from Bismarck, North Dakota
Cosmopolitan distribution	Habitats
Bengali people	Ethnic groups in Bangladesh, Ethnic groups in India
Baloch people	Ethnic groups in Balochistan (Pakistan)
Iranian plateau	Landforms of Afghanistan, Landforms of Iran, Landforms of Pakistan, Plateaus
Punjabis	Ethnic groups in Pakistan
Treeshrew	Mammals
Al-Nassr	Saudi Arabian football clubs, Riyadh, 1955 establishments in Asia, 1950s establishments in Saudi Arabia
Grosvenor Bridge	Bridges in the United Kingdom, Buildings and structures in the City of Westminster, Transport in the City of Westminster, Steel bridges, Concrete bridges
Vauxhall Bridge	Bridges in the United Kingdom, Buildings and structures in the City of Westminster, Transport in the City of Westminster, Transport in Lambeth, Steel bridges, Stone bridges
Ambrose Burnside	1824 births, 1881 deaths, Businesspeople from Indiana, American Civil War generals, US Republican Party politicians, United States senators from Rhode Island, Governors of Rhode Island
List of crossings of the River Thames	Bridges in the United Kingdom, Bridges and tunnels in London, Tunnels underneath the River Thames, Lists about England, Transport lists
Railway Gazette International	Rail transport, Monthly magazines
Hainault tube station	Central Line stations, Rail transport in London, London Travelcard zone 4
Highland Football League	Football in Scotland
Meselson–Stahl experiment	Molecular biology, Experiments, DNA
Woodford tube station	Central Line stations, 1856 establishments in Europe, 1850s establishments in England
Abram Games	1914 births, 1996 deaths, English artists, Designers
Joan Waste	1534 births, 1556 deaths, Blind people, English Protestants, Executed English people, People from Derby
Vauxhall Gardens	London Borough of Lambeth, Botanical gardens in the United Kingdom
Vladimir Ashkenazy	1937 births, Living people, Russian pianists, Russian conductors
Tate	Art museums in the United Kingdom, Buildings and structures in England
Michael Tilson Thomas	1944 births, Living people, 20th century composers, American composers, American conductors, American Jews, LGBT people from California, American pianists, Gay men, Grammy Award winners, LGBT musicians, Musicians from Los Angeles, California
Dolphin Stadium	2006 establishments in the United States, 2000s establishments in Florida, 2008 disestablishments in the United States
Esa-Pekka Salonen	1958 births, 21st century composers, Finnish composers, Conductors, Living people, People from Helsinki
Emergency telephone	Telephone, Emergency services
F-Zero	Entertainment-related lists, Super Nintendo Entertainment System games
Gujarati people	Ethnic groups in Asia, Indian people, Gujarat
Arena da Baixada	Football stadiums in Brazil, Curitiba, 1914 establishments in Brazil
Steller's sea cow	Sirenia
Schinus areira	Anacardiaceae, Trees
Bilal ibn Ribah	578 births, 638 deaths, Islam
Aisha	Muslims, 604 births, 678 deaths, Family of Muhammad
Deputy	Occupations
André Previn	1929 births, 2019 deaths, 20th century composers, American composers, American conductors, American pianists, Entertainers from Berlin, German conductors, German pianists, Grammy Award winners, Naturalized citizens of the United States
Franz Welser-Möst	1960 births, Austrian conductors, Living people
Commerzbank Tower	Buildings and structures completed in the 1990s, Skyscrapers in Frankfurt, 1997 establishments in Germany
MesseTurm	1991 establishments in Europe, 1990s establishments in Germany, Buildings and structures completed in the 1990s, Skyscrapers in Frankfurt
Arrondissement of Belley	Arrondissements of France

