Dinesh D'Souza	1961 births, Living people, Naturalized citizens of the United States, American conservatives, Christian writers, American Christians, American political commentators, American political writers, American political activists, Indian writers, Movie directors from California, Criminals from California, Writers from San Diego, California, People from Mumbai
Irvington, New York	Villages in New York
Dobbs Ferry, New York	Villages in New York
Greenburgh, New York	Towns in New York
Harrison Schmitt	1935 births, Living people, Apollo astronauts, American educators, United States senators from New Mexico, US Republican Party politicians
Charles Duke	1935 births, Living people, Apollo astronauts, American aviators, American military people, Scientists from North Carolina, People from Charlotte, North Carolina
Jürgen Prochnow	1941 births, Living people, German movie actors, German television actors, German voice actors, German stage actors, Naturalized citizens of the United States, American movie actors, American television actors, American voice actors, American stage actors, Actors from Los Angeles, California, Actors from Berlin
Feedback (band)	20th century establishments in the Republic of Ireland, Musical groups established in 1976, Musical groups disestablished in the 1970s, 1977 disestablishments in Europe, 1976 establishments in Europe
Stuyvesant High School	1900s establishments in New York (state), 1904 establishments in the United States, Schools in New York
Michael D. Ford	1928 births, 2018 deaths, Academy Award winners, English artists
Aníbal Quijano	Sociologists, Peruvian people, Peruvian educators, 1928 births, 2018 deaths
Royalty payment	Economics
Barbara Nawrocka-Dońska	1924 births, 2018 deaths, Military personnel of World War II, Polish journalists, Polish educators, Feminists, Polish essayists, Writers from Warsaw
Tom Murphy (playwright)	1935 births, 2018 deaths, Irish playwrights, Irish novelists, Writers from Dublin
Mohamed Abdel-Shafy	1985 births, Egyptian footballers, Living people, Egypt international footballers
Karim-Mohamed Maamoun	1991 births, Living people, People from Cairo
Laurie Hernandez	2000 births, Living people, American Olympic gold medalists, American television actors, Sportspeople from New Jersey, Actors from New Jersey
Nicole Leach	1979 births, Living people, American movie actors, American television actors, American stage actors, American dancers, American activists, American jazz singers, Actors from New Jersey, Singers from New Jersey, People from Livingston, New Jersey
Shikabala	1986 births, Egyptian footballers, Living people, Egypt international footballers
Pelecanimimus	Theropods, Cretaceous dinosaurs
Ibrahim Salah	1987 births, Egyptian footballers, Living people, Egypt international footballers
Valchava	Former municipalities of Graubünden
Val Müstair	2009 establishments in Switzerland, Municipalities of Graubünden
Simon de Montfort	Parliaments, English Earls, French nobility
Richard Thompson (cartoonist)	1957 births, 2016 deaths, American cartoonists, American comics artists, American illustrators, People from Arlington, Virginia, People with Parkinson's disease
Mohamed Khan	1942 births, 2016 deaths, People from Cairo, British movie directors, Naturalised citizens of the United Kingdom
La Quinta, California	1982 establishments in California, Cities in California, Settlements in Riverside County, California
Mohamed Safwat	1990 births, Living people
Temecula, California	1850s establishments in California, 1859 establishments in the United States, 1989 establishments in California, Cities in California, Settlements in Riverside County, California
Pedro Sánchez	1972 births, Living people, Prime Ministers of Spain, Current national leaders, People from Madrid
John Julius Norwich	1929 births, 2018 deaths, English historians, English writers, English television personalities, English radio personalities
Jean-Claude Boulard	1943 births, 2018 deaths, Disease-related deaths in France, Mayors, French politicians
Jaime Camil	1973 births, Living people, Mexican movie actors, Mexican television actors, Mexican voice actors, Mexican stage actors, Mexican television presenters, Mexican singers, Actors from Mexico City
Nasirul Mulk	1950 births, Living people, Pakistani judges, Prime Ministers of Pakistan
Giuseppe Conte	1964 births, Living people, Prime Ministers of Italy
Enzo Moavero Milanesi	1954 births, Living people, Politicians from Rome
Eddy Clearwater	1935 births, 2018 deaths, Deaths from heart failure, Cardiovascular disease deaths in Illinois, American blues singers, American blues musicians, American guitarists, Musicians from Mississippi, Singers from Mississippi, Musicians from Illinois, Singers from Illinois, People from Skokie, Illinois
Rockin' Rebel	American professional wrestlers, Sportspeople from Philadelphia, Pennsylvania, Suicides by firearm in the United States, 1966 births, 2018 deaths
The First Snow of Winter	1998 movies, American movies, British movies, Christmas movies
Takeo Hoshi	Japanese economists, University of California, Japanese people
Karim Hossam	1994 births, Living people
Union Sportive Troyenne	1900 establishments in France, 1931 disestablishments, 1930s disestablishments in France
AS Troyes-Savinienne	1931 establishments in Europe, 1930s establishments in France, 1970 disestablishments, 1970s disestablishments in Europe, 20th century disestablishments in France
Troyes Aube Football	1970 establishments in France, 1986 disestablishments, 1980s disestablishments in France
Association Troyes Aube Champagne	1986 establishments in Europe, 1980s establishments in France, 2000 disestablishments in Europe, 20th century disestablishments in France
Espérance Sportive Troyes Aube Champagne	2000 establishments in Europe, 20th century establishments in France
Bunk'd	2010s American comedy television series, 2015 American television series debuts, American television spin-offs, Disney Channel shows, English-language television programs
Privateer	Piracy
Hugo Gaston	2000 births, Living people, French tennis players
Maurice Germot	1882 births, 1958 deaths, French tennis players, Sportspeople from Auvergne-Rhône-Alpes, French Olympians, Olympic gold medalists
Smilja Mučibabić	Bosnia and Herzegovina scientists, 1912 births, 2006 deaths, Educators, Ecologists
Shill	Words, Psychology, Advertising, Crime
Sam Morsy	1991 births, Egypt international footballers, Egyptian footballers, English footballers, Living people
List of Emmerdale characters	Lists of television characters, Television characters
Croton-on-Hudson, New York	Villages in New York
Gabès	Cities in Tunisia
1980 Kalamazoo tornado	Tornadoes in the United States
Poldy Bird	People from Buenos Aires, Argentine writers, Argentine poets, 2018 deaths, 1941 births
Jill Ker Conway	1934 births, 2018 deaths, Naturalized citizens of the United States, Australian historians, Australian educators, American historians, American educators, American autobiographers, Writers from New South Wales, Writers from Boston, Massachusetts
Hilmar Hoffmann	1925 births, 2018 deaths, Deaths from stroke, Cardiovascular disease deaths in Germany, German educators, German historians, Writers from Frankfurt
Andrée Lachapelle	1931 births, 2019 deaths, Deaths by euthanasia, Drug-related suicides, People with cancer, Canadian movie actors, Canadian television actors, Canadian stage actors, Actors from Montreal
Fredericksburg, Texas	Cities in Texas, County seats in Texas
Macon, Mississippi	Cities in Mississippi, County seats in Mississippi
Nakahara Prize	Japanese culture, 1995 establishments in Japan
Hitotsubashi University	1870s establishments in Japan, 1875 establishments in Asia, Colleges and universities in Tokyo
Sagiri Kitao	1972 births, Living people, People from Saitama Prefecture, Japanese economists, New York University alumni, Harvard University alumni, Waseda University alumni
Swann VR	Dementia
State College for Colored Students	1891 establishments in the United States, 19th-century establishments in Delaware, 1947 disestablishments in the United States
Delaware State College	1947 establishments in the United States, 20th-century establishments in Delaware, 1993 disestablishments in the United States
Irenäus Eibl-Eibesfeldt	1928 births, 2018 deaths, Austrian scientists, Ethologists, Austrian educators, Writers from Vienna
Life of the Party (movie)	2018 comedy movies, American comedy movies, Movies directed by Ben Falcone, Movies set in 2018
Gillian Jacobs	1982 births, Living people, American movie actors, American television actors, American voice actors, American stage actors, Actors from Pittsburgh, Pennsylvania
Keeping Up with the Joneses (movie)	2016 comedy movies, 2010s action comedy movies, 2010s spy movies, American action comedy movies, American spy movies
Masterminds (2016 movie)	American comedy movies, 2016 movies, Movies set in the 1990s, American heist movies
Adria Arjona	1992 births, Living people, American movie actors, American television actors, American voice actors, American video game actors, Guatemalan people, Puerto Rican actors
Matt Walsh (comedian)	1964 births, Living people, American movie actors, American television actors, American stage actors, American voice actors, Actors from Chicago, Movie directors from Chicago, Comedians from Chicago, Screenwriters from Chicago
The Boss (2016 movie)	Movies directed by Ben Falcone, 2016 comedy movies, American comedy movies, Movies set in Chicago, Illinois, Movies shot in Chicago, Illinois
Ben Falcone	1973 births, Living people, American movie actors, American television actors, American voice actors, Actors from Chicago, Comedians from Chicago, Movie directors from Chicago, Movie producers from Chicago, Screenwriters from Chicago
Bridesmaids (2011 movie)	2011 movies, American comedy movies, Movies set in Chicago, Illinois, Movies shot in Chicago, Illinois
The Nutcracker and the Four Realms	2018 movies, Movies based on books, American fantasy movies, English-language movies, American adventure movies, Movies directed by Lasse Hallström
Ahmed Sofa	1943 births, 2001 deaths, Bangladeshi writers
London Has Fallen	2016 movies, 2010s action thriller movies, American action thriller movies, Movies set in London, Drone movies
DuPage County, Illinois	DuPage County, Illinois, 1839 establishments in Illinois
Oak Brook, Illinois	Villages in Illinois, Suburbs of Chicago, Illinois, Settlements in Cook County, Illinois, Settlements in DuPage County, Illinois
Despicable Me 3	2017 comedy movies, 2017 animated movies, 2010s action comedy movies, American animated movies, American action comedy movies, Despicable Me, Universal Pictures movies, 2010s 3D movies, Computer-animated movies, American sequel movies, Movies set in Europe, Movies set in 1987, Movies set in California, Movies directed by Pierre Coffin
Ramnath Thakur	1950 births, Living people, Indian politicians
Janata Dal (United)	Political parties in India
Ahmed Elmohamady	1987 births, Aston Villa F.C. players, Egypt international footballers, Egyptian Muslims, Egyptian footballers, Living people
Penn Jillette	1955 births, Living people, American magicians, American movie actors, American television actors, American inventors, American television personalities, Comedians from Massachusetts, Actors from Massachusetts, Writers from Massachusetts, Movie directors from Massachusetts
Maxime Cadé	1994 births, French Olympians, Living people, Alumni of the Institut polytechnique des sciences avancées, Fencers
2018 FIFA World Cup statistics	2018 FIFA World Cup
Philippe Crébassa	Living people, Alumni of the École Polytechnique, Alumni of the École nationale de l'aviation civile, French aviators
Lion's Club	1910s establishments in Illinois, 1917 establishments in the United States, Organizations based in the United States
Álvaro Lapuerta	1927 births, 2018 deaths, Deaths from dementia, Spanish lawyers, Spanish politicians, People from Madrid
Miguel Obando y Bravo	1926 births, 2018 deaths, Deaths from myocardial infarction, Cardinals of the Roman Catholic Church, Anti-Communists, Nicaraguan people
1984 Barneveld tornado	Tornadoes in the United States
1980 Grand Island tornado	Tornado outbreaks, 1980 in the United States, 20th century in Nebraska
Oklahoma City Arena	2010 establishments in the United States, 21st-century establishments in Oklahoma, 2011 disestablishments in the United States
Asheville Altitude	2001 establishments in the United States, 21st-century establishments in North Carolina, 2005 disestablishments in the United States, 21st-century disestablishments in North Carolina
Emily Ratajkowski	1991 births, Living people, American movie actors, American television actors, American feminists, American models, American political activists, Actors from London, Actors from San Diego, California
Anna Karina	1940 births, 2019 deaths, Deaths from aneurysm, Danish movie actors, Danish television actors, Danish writers, Danish singers, French movie actors, French television actors, French stage actors, French movie directors, French screenwriters, French models, French singers
Thigh	Human body features
Michael A. Goorjian	1971 births, Living people, American movie actors, Actors from Oakland, California, American movie directors, American screenwriters, Emmy Award winners
2018 FIFA World Cup Final	2018 FIFA World Cup, 2018 in Russia, 21st century in Moscow
Brythonic languages	Celtic languages
List of Adobe software	Adobe software, Computer-related lists
Piotrowice (Otwock County)	Villages in Poland
1821 Norfolk and Long Island hurricane	Hurricanes in the United States, 1821 in the United States
Kunlun Fight	Kickboxing, Sport in China
Upper and Lower Egypt	Ancient Egypt
Tony Morphett	1938 births, 2018 deaths, Deaths from myocardial infarction, Cardiovascular disease deaths in Australia, Australian screenwriters, Television writers, People from New South Wales
Bernard E. Trainor	1928 births, 2018 deaths, Deaths from laryngeal cancer, Cancer deaths in Virginia, American military personnel of the Korean War, American military personnel of the Vietnam War, Journalists from New York City
Sterling, Virginia	Census-designated places in Virginia
Emil Wolf	1922 births, 2018 deaths, American physicists, Czech scientists, Naturalized citizens of the United States, Scientists from New York, Writers from New York, Writers from Prague
Vermont Republic	Former countries in North America, 1777 establishments, 1770s establishments in North America, 1791 disestablishments, Disestablishments in North America, American Revolutionary War
Robert Brylewski	1961 births, 2018 deaths, Polish singers, Songwriters, People from Warsaw
Mario Toros	1922 births, 2018 deaths, Italian politicians, People from Milan
Omar Razzaz	1960 births, Living people, Prime Ministers of Jordan
Adnan Badran	1935 births, Living people, Prime Ministers of Jordan
Mudar Badran	1934 births, Living people, Prime Ministers of Jordan
Zaid al-Rifai	1936 births, Living people, Prime Ministers of Jordan
Chicago Pride Parade	LGBT in the United States, Festivals in Chicago, June events, 1970 establishments in the United States, 1970s establishments in Illinois
Washington Square Park (Chicago)	Parks in Chicago, Landmarks in Chicago
Gold Coast Historic District (Chicago)	Neighborhoods in Chicago, Landmarks in Chicago
Harry R. Truman	1896 births, 1980 deaths, Deaths from natural disasters, American military personnel of World War I, Businesspeople from West Virginia, Businesspeople from Washington
David A. Johnston	1949 births, 1980 deaths, Deaths from natural disasters, Scientists from Chicago
Rosemont Theatre	Theatres in the United States, 1995 establishments in Illinois, Buildings and structures in Illinois
Donald E. Stephens Convention Center	Buildings and structures in Illinois, 1975 establishments in the United States, 1970s establishments in Illinois
Fashion Outlets of Chicago	Buildings and structures in Illinois, Malls, 2013 establishments in the United States, 2010s establishments in Illinois
Gurnee Mills	Buildings and structures in Illinois, Malls
Gurnee, Illinois	Villages in Illinois, Suburbs of Chicago, Illinois
Harlem Irving Plaza	Buildings and structures in Illinois, Malls
Joseph Atiyeh	1957 births, Wrestlers, Syrian Christians, Medalists at the 1984 Summer Olympics, Olympic silver medalists, Living people
Boleslaw II the Generous	1040s births, 1080s deaths, Polish dukes, Kings of Poland
Robert Lefkowitz	1943 births, American biochemists, American physicians, Jewish American scientists, Columbia University alumni, Scientists from New York City, Living people
Cricket Australia	Sport in Australia, Cricket, Sports organizations
Mars (chocolate bar)	Candy
Beaumont, California	1912 establishments in California, Cities in California, Settlements in Riverside County, California
Lassen County, California	Lassen County, California, 1860s establishments in California, 1864 establishments in the United States
List of current Atlantic Records artists	Atlantic Records artists
Subtropical Storm Alberto	Hurricanes in the United States, 2018 in the United States
Tim McInnerny	1956 births, Living people, English movie actors, English stage actors, English radio actors, English television actors, Actors from Gloucestershire
Doug Altman	1948 births, 2018 deaths, Deaths from colorectal cancer, British educators, Scientists from London
Pierre Carniti	1936 births, 2018 deaths, MEPs for Italy, Socialists, People from Lombardy
Kate Spade	1962 births, 2018 deaths, American fashion designers, Businesspeople from New York City, Businesspeople from Kansas City, Missouri, Suicide in 2018, Suicides by hanging in the United States
Isfahan Province	Isfahan Province
Zanjan Province	Provinces of Iran
Fars Province	Fars Province
Kurdistan Province	Kurdistan Province
2017 UEFA Super Cup	UEFA Super Cup, 2017–18 in UEFA football, 2017 in Europe, Sport in North Macedonia
Battle of Puebla	Battles involving France, 19th century in Mexico, 19th century in France, 1862, 1860s in North America, May events
T-Mobile Arena	21st century in Nevada, 2016 establishments in the United States, Sports buildings in the United States, Buildings and structures in Nevada
Jurong Region MRT line	Mass Rapid Transit (Singapore) lines
Best Buy	1960s establishments in Minnesota, 1966 establishments in the United States, Companies listed on the New York Stock Exchange, Companies of the United States, Shops, Minnesota
Bruno Poromaa	1936 births, 2016 deaths, Swedish politicians
1998 Stanley Cup Finals	Stanley Cup Finals, 1998 in ice hockey
Ghil'ad Zuckermann	1971 births, Living people, Alumni of the University of Cambridge, Alumni of the University of Oxford, Asian translators, Essayists, Hebrew language, Jewish academics, Jewish Israeli writers, Jewish scientists, Linguists, People from Tel Aviv, Tel Aviv University alumni
Climax	Narratology, Fiction
Fernando Mazariegos	1938 births, 2018 deaths, Deaths from cardiac arrest, Guatemalan people, Inventors
Brian Browne	1937 births, 2018 deaths, Deaths from lung cancer, Deaths from throat cancer, Canadian composers, Jazz pianists, Musicians from Montreal
Denman (horse)	2000 births, 2018 deaths, Deaths by euthanasia, Racehorses
Tinus Bosselaar	1936 births, 2018 deaths, Deaths from heart failure, Dutch footballers, Sportspeople from Rotterdam
Kira Muratova	1934 births, 2018 deaths, Deaths from stroke, Ukrainian movie directors, Ukrainian screenwriters, Ukrainian actors
Ralph Santolla	1969 births, 2018 deaths, Deaths from myocardial infarction, American heavy metal musicians, American guitarists, Musicians from Tampa, Florida
Zodiac Killer	1960s in California, 1970s in California, Murder in California, Murder in the 1960s, Murder in the 1970s, Unidentified serial killers
Wulingyuan	World Heritage Sites in China, Sandstones
Upland and lowland	Physical geography, Ecology
Channel 5 (British TV channel)	1997 establishments in the United Kingdom, British television channels
Kurt Marti	1921 births, 2017 deaths, Swiss writers, Poets, Theologians, People from Bern
Patrick Malo	1992 births, Living people, Burkinabé footballers, People from Ouagadougou
Golf Mill Shopping Center	Buildings and structures in Illinois, Malls
Baume-les-Dames	Communes in Doubs
Odinani	Religions, Nigerian culture
Acantholipan	Fossil taxa described in 2018, Ornithischia
Chvrches discography	Discographies
Tomodachi Life	Nintendo 3DS games, 2013 video games, Video games developed in Japan
David Douglas Duncan	1916 births, 2018 deaths, American photojournalists, American war correspondents, American military personnel of World War II, American military personnel of the Korean War, American centenarians, Writers from Kansas City, Missouri
Fu Da-ren	1933 births, 2018 deaths, Deaths by euthanasia, Activists, Television presenters, Writers, People with cancer, Taiwanese people, Deaths from pancreatic cancer
Arie den Hartog	1941 births, 2018 deaths, Dutch cyclists, Sportspeople from South Holland
Francis Smerecki	1949 births, 2018 deaths, French footballers, French football managers
Larry Cedar	1955 births, Living people, American movie actors, American voice actors, Actors from Los Angeles, California, American television actors
Anna Sewell	1820 births, 1878 deaths, English children's writers, English novelists, People from Norfolk
Thomas Clarkson	1760 births, 1846 deaths, Alumni of the University of Cambridge, British abolitionists, English activists, English Anglicans, People from Cambridgeshire
Umar Sheikh Mirza	1494 deaths, 1456 births, Asian people
Anthony Bourdain	1956 births, 2018 deaths, American chefs, American television presenters, Clio Award winners, Emmy Award winners, Suicide in 2018, Suicides by hanging, Television personalities from New York, Television personalities from New York City, Writers from New York, Writers from New York City
Stefan Weber	1946 births, 2018 deaths, Austrian educators, Singers from Vienna
Charles Krauthammer	Pulitzer Prize winners, 1950 births, 2018 deaths, Deaths from small intestine cancer, American columnists, American political commentators, American physicians, American political writers, American television news anchors, Jewish American writers, American conservatives, Cancer deaths in the United States, Fox News people, Writers from New York City
Eunice Lam	1943 births, 2018 deaths, Deaths from lung cancer, Asian writers, Socialites, Chinese businesspeople, Columnists, Essayists
J. B. Munro	1936 births, 2018 deaths, New Zealand politicians, Activists
Feng Ting-kuo	1950 births, 2018 deaths, Deaths from cardiac arrest, Taiwanese politicians
Junior Eurovision Song Contest 2007	2007 in Europe, 2007 in music, 2000s in the Netherlands, Rotterdam, Junior Eurovision Song Contest
Ondřej Palát	1991 births, American Hockey League players, Czech ice hockey players, Drummondville Voltigeurs players, Living people, Tampa Bay Lightning players
The Bones of What You Believe	2013 albums, Chvrches albums
Every Open Eye	2015 albums, Chvrches albums
Love Is Dead (Chvrches album)	2018 albums, Chvrches albums
UN declaration on Sexual orientation and Gender Identity	United Nations, Human rights
Indian Penal Code	India, Law
Pakistani nationality law	Pakistan, Law, Nationality, Rights
Child labour in Pakistan	Pakistan, Child labour
International Lesbian, Gay, Bisexual, Trans and Intersex Association	Human rights, LGBT rights
Sex work	Prostitution
Pravachanasara	Jainism, Religious texts
Palestinian National Authority	Politics of Palestine
Green Party of Pakistan	Political parties in Pakistan
Jus soli	Philosophical concepts
Oriental magpie-robin	Birds of Asia, National symbols of Bangladesh
Hylarana tytleri	Frogs, National symbols of Bangladesh
Keokradong	Bangladesh, National symbols of Bangladesh, Mountains of Asia
Nikolai Lugansky	1972 births, Living people, Musicians from Moscow
Sanqingshan	World Heritage Sites in China
Transcriptome	RNA
Exome	RNA
DNA damage theory of ageing	DNA, Gerontology
List of post towns in the United Kingdom	Postal services in the United Kingdom
List of most luminous stars	Astronomy lists, Star clusters, Milky Way, Local galaxies
Determiner	Parts of speech
Grammatical number	Linguistics
E4 (TV channel)	2001 establishments in the United Kingdom, British television channels, Channel 4
Carroll County, Georgia	1826 establishments in Georgia (U.S. state), Georgia (U.S. state) counties
Paulding County, Georgia	1832 establishments in Georgia (U.S. state), Georgia (U.S. state) counties
Cobb County, Georgia	1832 establishments in Georgia (U.S. state), Georgia (U.S. state) counties
Dhiraj Choudhury	1936 births, 2018 deaths, Indian painters
Franz M. Wuketits	1955 births, 2018 deaths, Austrian scientists, Biologists, Austrian educators
Per Ahlmark	1939 births, 2018 deaths, Politicians from Stockholm, Writers from Stockholm
Maria Bueno	1939 births, 2018 deaths, Deaths from Merkel-cell carcinoma, Deaths from oral cancer, Cancer deaths in Brazil, Tennis players, Brazilian sportspeople
Eunice Gayson	1928 births, 2018 deaths, English movie actors, English television actors, Actors from Surrey, Actresses who played Bond girls
Danny Kirwan	1950 births, 2018 deaths, Deaths from pneumonia, British singer-songwriters, British rock guitarists, Blues guitarists, Singers from London, Musicians from London, Writers from London
Liu Yichang	1918 births, 2018 deaths, Deaths from pneumonia, Asian writers, Novelists, Editors, Columnists, Publishers
Fadil Vokrri	1960 births, 2018 deaths, Deaths from cardiac arrest, Kosovan people, Footballers
Keith David	Emmy Award winning actors, 1956 births, Living people, American movie actors, American television actors, American stage actors, American voice actors, Actors from New York City
Town and Country, Missouri	Cities in Missouri
Vaginal tumors	Anatomy of the female reproductive system
The Loud House	2016 television series debuts, Nicktoons, 2010s American comedy television series, Television series about siblings, American animated television series, English-language television programs, Controversies, Flash animation
Jun Mizutani	Living people, Table tennis players, 1989 births, Iwate Prefecture, Japanese Olympic silver medalists, Japanese Olympic bronze medalists, Japanese sportspeople
Douglas County, Georgia	1870 establishments in Georgia (U.S. state), Georgia (U.S. state) counties
Recover EP	2013 albums, Chvrches albums
Barnum Brown	1873 births, 1963 deaths, American paleontologists
Darling in the Franxx	2010s drama television series, 2010s romance television series, 2010s science fiction television series, Science fiction anime and manga
Junior Eurovision Song Contest 2008	2008 in Europe, 2008 in music, Cyprus, Junior Eurovision Song Contest
Junior Eurovision Song Contest 2014	2014 in Europe, 2014 in music, Malta, Junior Eurovision Song Contest, November events
Matt Rosendale	1960 births, Living people, United States representatives from Montana, State legislators of the United States, US Republican Party politicians, Politicians from Baltimore, Maryland
Eluanbi Lighthouse	1882 establishments, Lighthouses, Buildings and structures in Taiwan
Tour guide	Occupations, Tourism
Charles Horioka	1956 births, Harvard University alumni, Living people, Japanese economists, American economists
Philippine National Railways	Establishments in the Philippines, 1890s establishments in Asia, 1892 establishments, Rail transport in Asia, Transport in the Philippines, Metro Manila
Tisha b'av	Jewish festivals and holidays
Insertion sort	Searching and sorting algorithms
Jānis Bojārs	1956 births, 2018 deaths, Latvian people, European sportspeople
Daugavpils	Cities in Latvia, Establishments in Latvia, 1270s establishments in Europe, 1275
Louvemont-Côte-du-Poivre	Communes in Meuse
Haumont-près-Samogneux	Communes in Meuse
Richard Biggs	1960 births, 2004 deaths, African American actors, American television actors, Actors from Columbus, Ohio, Deaths from aortic dissection, Disease-related deaths in California
Parahenodus	Sauropterygia, Fossil taxa described in 2018, Marine reptiles
2019 UEFA Europa League Final	2018–19 UEFA Europa League
Desert ecology	Ecology
1985 United States-Canada tornado outbreak	1985 in the United States, 1985 in Canada, Tornadoes in Canada, Tornadoes in the United States
Monosemy	Linguistics
Razan al-Najjar	1996 births, 2018 deaths, Murders by firearm, Activists, Palestinian people
Karl Fritz Lauer	1938 births, 2018 deaths, Romanian people, German educators, German scientists
Mateja Matevski	1929 births, 2018 deaths, Turkish writers, Poets, Critics, Essayists, People from Istanbul
Brazilian Space Agency	Space agencies, Brazil, 1961 establishments in South America, 1960s establishments in Brazil
Freddy Eugen	1941 births, 2018 deaths, Deaths from esophageal cancer, Danish sportspeople, Cyclists
John McKenzie	1937 births, 2018 deaths, Disease-related deaths in Massachusetts, Boston Bruins players, Chicago Blackhawks players, Detroit Red Wings players, New York Rangers players, Sportspeople from Alberta
Thomas Stuttaford	1931 births, 2018 deaths, British physicians, British columnists, Conservative MPs (UK)
Neal E. Boyd	1975 births, 2018 deaths, Deaths from heart failure, Deaths from renal failure, Disease-related deaths in Missouri, Republicans (United States), American pop singers, American television personalities, Singers from Missouri
Katarzyna Łaniewska	1933 births, 2020 deaths, Polish movie actors, Polish television actors, Polish stage actors, Political activists, Polish politicians, Political writers, People from Łódź
Andrzej Kopiczyński	1934 births, 2016 deaths, Deaths from Alzheimer's disease, Disease-related deaths in Poland, Polish movie actors, Polish television actors, Polish stage actors
Czterdziestolatek	1974 television series debuts, Comedy television series
Roman Kłosowski	1929 births, 2018 deaths, Deaths from pneumonia, Disease-related deaths in Poland, Polish movie actors, Polish television actors, Polish stage actors
Anna Seniuk	1942 births, Living people, Polish movie actors, Polish television actors, Polish stage actors, Polish voice actors, Polish radio actors
Irena Kwiatkowska	1912 births, 2011 deaths, Polish movie actors, Polish television actors, Polish stage actors, Polish radio actors, Polish comedians, Entertainers from Warsaw
Leonard Pietraszak	1936 births, Living people, Polish movie actors, Polish television actors
Tadeusz Pluciński	1926 births, 2019 deaths, People from Łódź, Polish movie actors, Polish radio actors, Polish stage actors, Polish television actors
2019 UEFA Super Cup	UEFA Super Cup
Jan Pietrzak	1937 births, Living people, Polish movie actors, Polish television actors, Polish singers, Songwriters, Columnists, Polish comedians, Writers from Warsaw, Politicians from Warsaw, Entertainers from Warsaw
Ignacy Gogolewski	1931 births, Living people, Polish movie actors, Polish stage actors, Polish television actors
Jan Kobuszewski	1934 births, 2019 deaths, Polish movie actors, Polish television actors, Polish voice actors, Polish stage actors, Polish comedians, Entertainers from Warsaw
Jan Kociniak	1937 births, 2007 deaths, Cancer deaths in Poland, Polish movie actors, Polish stage actors, Polish television actors, Polish voice actors, Polish comedians
Krzysztof Kowalewski	1937 births, 2021 deaths, Polish comedians, Polish movie actors, Polish television actors, Entertainers from Warsaw
Mateusz Morawiecki	1968 births, Living people, Prime Ministers of Poland, Current national leaders, Polish businesspeople, Polish lawyers, Polish economists, Polish historians, Polish writers
Flacăra-Unirea Târgu Jiu	1963 disestablishments, 1960s disestablishments in Europe
CIL Târgu-Jiu	1963 disestablishments, 1960s disestablishments in Europe
Erg	Units of measurement
2019 UEFA Champions League Final	2018–19 UEFA Champions League, June 2019 events
Jackie DeShannon	1944 births, American guitarists, American singer-songwriters, American pop singers, American pop musicians, Singers from Kentucky, Writers from Kentucky, Musicians from Kentucky, Singers from Illinois, People from Aurora, Illinois, Musicians from Illinois, Writers from Illinois, Living people
What the World Needs Now Is Love	Pop songs, 1965 songs
2019–20 UEFA Europa League	UEFA
2017–18 UEFA Champions League group stage	2017–18 UEFA Champions League
Qayamat Ki Raat	2018 Indian television series debuts, Indian television series
Victoria Kalima	1972 births, 2018 deaths, Zambian politicians
Jon Hiseman	1944 births, 2018 deaths, Deaths from brain cancer, English rock drummers, British engineers, Record producers, Jazz musicians, Blues musicians, Musicians from London
Lindsey Buckingham	1949 births, Living people, American rock guitarists, American pop musicians, American singer-songwriters, Musicians from San Francisco, Writers from San Francisco, Singers from California, People from Palo Alto, California
Amazonsaurus	Sauropods
Yazd Province	Provinces of Iran
Empress Masako	1963 births, Living people, Japanese imperial family, People from Tokyo, Crown Princes and Princesses of Japan
Aiko, Princess Toshi	2001 births, Living people, Crown Princes and Princesses of Japan, People from Tokyo
Gloria Warren	1926 births, 2021 deaths, American movie actors, Actors from Wilmington, Delaware, American pianists, Singers from Delaware, Musicians from Wilmington, Delaware, Actors from Delaware
Ron Holgate	Tony Award winning actors, 1937 births, Living people, American movie actors, American stage actors, People from Aberdeen, South Dakota, Actors from South Dakota, Singers from South Dakota
Spencer Bohren	1950 births, 2019 deaths, Deaths from prostate cancer, American blues singers, American educators, American singer-songwriters, American artists, American guitarists, Singers from Wyoming, Musicians from Wyoming, Writers from Wyoming, People from Casper, Wyoming
Michael Jagmin	1985 births, Living people, American rock singers, American rock musicians, American singer-songwriters, Musicians from Wyoming, Singers from Wyoming, Writers from Wyoming
Chris LeDoux	1948 births, 2005 deaths, Deaths from cholangiocarcinoma, Cancer deaths in the United States, American sculptors, American singer-songwriters, American country musicians, Musicians from Mississippi, Musicians from Wyoming, Singers from Mississippi, Singers from Wyoming, People from Biloxi, Mississippi, People from Casper, Wyoming, Writers from Wyoming
Rosie Hamlin	1945 births, 2017 deaths, American singer-songwriters, American pianists, Musicians from Oregon, Singers from Oregon, Musicians from Alaska, Singers from Alaska, Writers from Alaska, People from Anchorage, Alaska
Norma Zimmer	1923 births, 2011 deaths, American jazz singers, American movie actors, American voice actors, American television personalities, American radio actors, Actors from Idaho, Singers from Idaho
Josh Ritter	1976 births, Living people, American singer-songwriters, American guitarists, American pianists, American rock musicians, American rock singers, American folk singers, American folk musicians, Musicians from Idaho, Singers from Idaho, Musicians from Ohio, Singers from Ohio, Writers from Ohio, Writers from Idaho
Slim Andrews	Singers from Maine, Musicians from Maine, 1931 births, Living people, American television presenters, American country guitarists, American country singers, Singers from Boston, Massachusetts, Musicians from Boston, Massachusetts
Clarence White	1944 births, 1973 deaths, Road accident deaths in California, American country guitarists, American country singers, American bluegrass musicians, Musicians from Maine, Singers from Maine, People from Lewiston, Maine
Jam Software	1984 establishments in California, 1989 disestablishments in the United States, 1980s disestablishments in California
Lois Hart	Living people, 1950 births, Journalists from Georgia (U.S. state), American journalists
Corey Stewart	1968 births, Living people, Politicians from Virginia, People from Duluth, Minnesota, US Republican Party politicians
Lois Maxwell	1927 births, 2007 deaths, Actors from Ontario, Actresses who played Miss Moneypenny, Cancer deaths in Australia, Canadian movie actors, Canadian television actors, Canadian stage actors, Deaths from colorectal cancer, Golden Globe Award winning actors
Belen, New Mexico	Cities in New Mexico
Los Lunas, New Mexico	County seats in New Mexico, Villages in New Mexico
Bottineau, North Dakota	Cities in North Dakota, County seats in North Dakota
Saleh Ali al-Sammad	1979 births, 2018 deaths, Deaths by airstrike, Yemeni people, Asian politicians
Kelly Brook	1979 births, Living people, English television presenters
Bunschoten	Settlements in Utrecht (province), Villages in Europe, Municipalities of Utrecht (province)
Acquaviva (San Marino)	Municipalities of San Marino
Pentahedron	Polyhedra
Oscar Furlong	1927 births, 2018 deaths, Olympians, Argentine tennis players, Basketball players, Sportspeople from Buenos Aires
Denison Dam	Dams in the United States, Buildings and structures in Texas, Buildings and structures in Oklahoma, 1943 establishments in the United States, 20th-century establishments in Texas, 20th-century establishments in Oklahoma
Acre foot	Units of volume, Water infrastructure
Andropause	Male reproductive system
Adam Laxalt	1978 births, Living people, Attorneys general, Politicians from Nevada, People from Reno, Nevada, US Republican Party politicians
Arkangel de la Muerte	1966 births, 2018 deaths, Deaths from myocardial infarction, Mexican professional wrestlers
Anne Donovan	1961 births, 2018 deaths, Deaths from heart failure, American Olympic gold medalists, American basketball players, Sportspeople from New Jersey, People from Ridgewood, New Jersey
Ridgewood, New Jersey	Villages in the United States, Settlements in New Jersey
John O. Pastore	1907 births, 2000 deaths, Deaths from renal failure, United States senators from Rhode Island, Governors of Rhode Island, People from Providence, Rhode Island, People from Cranston, Rhode Island, US Democratic Party politicians, Lieutenant Governors of Rhode Island
SD Torpedo	1946 establishments in Europe, 1940s establishments in Bosnia and Herzegovina, 1947 disestablishments, 1940s disestablishments in Europe
SDM Sarajevo	1947 establishments, 1940s establishments in Bosnia and Herzegovina, 1949 disestablishments, 1940s disestablishments in Europe
Messier 32	Elliptical galaxies, Local galaxies
Barnard's galaxy	Barred spiral galaxies
Sushil Kumar Modi	1952 births, Living people, Indian politicians, People from Bihar, Bharatiya Janata Party politicians
Bilat Paswan Vihangam	1940 births, 2017 deaths, Indian politicians
Cheerleader effect	Psychology
Patna Junction railway station	Railway stations in Asia
Open set	Mathematics
Reinhard Hardegen	1913 births, 2018 deaths, Deaths from respiratory failure, Disease-related deaths in Germany, German military personnel of World War II, German centenarians, Nazi German politicians
Charles Vinci	1933 births, 2018 deaths, Deaths from congestive heart failure, American Olympic gold medalists, Weightlifters, Sportspeople from Cleveland, Ohio
Robert Downey Sr.	1936 births, 2021 deaths, Deaths from Parkinson's disease, American movie actors, American television actors, Actors from New York City, Screenwriters from New York City, Movie directors from New York City
Stanislav Govorukhin	1936 births, 2018 deaths, Deaths from myocardial infarction, Russian movie actors, Russian movie directors, Russian screenwriters, Russian politicians, Conservatives
Louis Sachar	1954 births, American children's writers, Jewish American writers, Living people
Alexander Rutskoy	1947 births, Living people, Military people, Vice presidents, Russian politicians
Wheeler Winston Dixon	1950 births, Living people, American historians, American educators, American movie critics, American editors, Movie directors from New Jersey, Screenwriters from New Jersey, Journalists from New Jersey
Pedro Pascal	1975 births, Living people, Naturalized citizens of the United States, Chilean movie actors, American movie actors, American television actors, American video game actors, American voice actors, Actors from San Antonio, Texas, Actors from New York City, People from Santiago
25 Canada Square	Banks, Buildings and structures in London, London Borough of Tower Hamlets, Skyscrapers
Vila Salazar	1975 disestablishments in Angola
Vila Luso	1975 disestablishments in Angola
Sá da Bandeira	1975 disestablishments in Angola
Janny Sikazwe	Living people, 1979 births
Deinococcus–Thermus	Gram-positive bacteria
Radioresistance	Ecology, Extremophiles
Andaman Islands	Andaman and Nicobar Islands
Alpine County, California	1860s establishments in California, 1864 establishments in the United States, Alpine County, California
Jan Mayensfield	Norway, Airports in Europe, 1960 establishments in Europe, 1960s establishments in Norway
Kiyonori Kikutake	1928 births, 2011 deaths, People from Fukuoka Prefecture, Japanese architects, Waseda University alumni
Mu Cephei	Red giants, Variable stars, Hypergiants
Enoch zu Guttenberg	1946 births, 2018 deaths, German conductors, People from Bavaria
Sonia Scurfield	1928 births, 2018 deaths, Deaths from stomach cancer, Cancer deaths in Canada, Canadian businesspeople, Sportspeople from Saskatchewan, Sportspeople from Calgary
Mongi Kooli	1930 births, 2018 deaths, Deaths from gallbladder cancer, Tunisian politicians, Ambassadors
Fazlullah (militant leader)	1974 births, 2018 deaths, Deaths by airstrike, Pakistani people, Military people, Radio personalities, Terrorists
Vincent R. Gray	1922 births, 2018 deaths, Deaths from pneumonia, British chemists, Critics, New Zealand scientists, Scientists from London, Writers from London
Frank Bresee	1929 births, 2018 deaths, Deaths from dementia, American radio personalities, American historians, Entertainers from Los Angeles, California
Richard Hadlee	1951 births, Living people, New Zealand cricketers, People with cancer
Jerry Butler	Rock and Roll Hall of Fame inductees, 1939 births, Living people, American R&B singers, American R&B musicians, American soul musicians, American funk musicians, American pianists, American funk singers, American guitarists, American saxophonists, American drummers, American television presenters, State legislators of the United States, African-American singers, African American musicians, African American writers, African American politicians, Singers from Mississippi, Musicians from Mississippi, Writers from Mississippi, Politicians from Mississippi, Singer-songwriters from Chicago, Musicians from Chicago, Television personalities from Chicago, Politicians from Chicago, US Democratic Party politicians
2019 Chicago mayoral election	2019 in the United States, 2010s in Chicago, April events, 2019 elections, February 2019 events, Mayoral elections in Chicago
Sunflower, Mississippi	Towns in Mississippi
Bose gas	Quantum mechanics
2018 FIFA World Cup disciplinary record	2018 FIFA World Cup, FIFA World Cup disciplinary records
Aram Shah	Mamluk dynasty (Delhi)
Katie Harman	Actors from Portland, Oregon, Miss America winners, 1980 births, Living people
Markleeville, California	1861 establishments in California, Settlements in Alpine County, California, Census-designated places in California, County seats in California
Amador County, California	Amador County, California, 1854 establishments in California
Norma Bessouet	1940 births, 2018 deaths, Deaths from breast cancer, Argentine painters, Sculptors, People from Buenos Aires
Wayne Flynt	1940 births, Living people, American historians, American editors, American educators, Writers from Alabama, Writers from Mississippi, People from Pontotoc, Mississippi
Beavis and Butt-Head Do America	1990s comedy movies, 1996 movies
Liberation (Christina Aguilera album)	Christina Aguilera albums, 2018 albums, Pop albums, Hip hop soul albums, R&B albums
Metropolitan Commuter Transportation Authority	1965 establishments in New York (state), 1968 disestablishments, 1960s disestablishments in New York (state)
Iowa Barnstormers	1995 establishments in the United States, 20th-century establishments in Iowa, 2001 disestablishments in the United States
Nova Odessa	Cities in São Paulo (state)
Nabil Fekir	1993 births, French footballers, 2018 FIFA World Cup players, Sportspeople from Lyon, Living people
Tekka Raja Badsha	Indian television series, 2010s comedy television series, 2010s drama television series, 2010s romance television series, 2018 Indian television series debuts
Inyo County, California	1866 establishments in California, Inyo County, California
The Kaze	1990s American music groups, Hip hop bands, Musical groups from Tennessee
Independence, California	1861 establishments in California, Census-designated places in California, County seats in California, Settlements in Inyo County, California
Abu Huzaifa al-Kanadi	Islamic State people, Murderers, Canadian people, Pakistani people, Pakistani military people, Canadian military people, Living people
Kyra Petrovskaya Wayne	1918 births, 2018 deaths, Deaths from respiratory failure, Disease-related deaths in Washington (state), Naturalized citizens of the United States, American novelists, Russian novelists, Soviet military personnel of World War II, Writers from Washington
Kingston, Washington	Census-designated places in Washington (state)
Edmonds, Washington	Cities in Washington (U.S. state)
Olympic Mountains	Geography of Washington (U.S. state), Mountains of the United States
Antônio Carlos Konder Reis	1924 births, 2018 deaths, Brazilian politicians
Martin Bregman	1926 births, 2018 deaths, Deaths from cerebral hemorrhage, Cardiovascular disease deaths in New York City, Movie producers from New York City
Alvarito	1936 births, 2018 deaths, Spanish footballers, Spanish football managers
Iván Duque Márquez	1976 births, Living people, Conservatives, People from Bogotá, Presidents of Colombia, Current national leaders, Economists
Zou people	Manipur, Indian people
Elizabeth Brackett	Peabody Award winners, 1941 births, 2018 deaths, Accidental deaths in Chicago, American television presenters, American political writers, Journalists from Chicago, Politicians from Chicago, US Democratic Party politicians
Chicago Lakefront Trail	Parks in Chicago
Burnham Park (Chicago)	Parks in Chicago
Norodom Ranariddh	1944 births, Living people, Princes and princesses, Prime Ministers of Cambodia
Tom Skilling	1952 births, Living people, American meteorologists, American columnists, Writers from Chicago, People from Aurora, Illinois
WGN-TV	American television stations, Chicago, Illinois
Don Sandburg	1930 births, 2018 deaths, Deaths from Alzheimer's disease, Disease-related deaths in Oregon, American television producers, American television actors, American television writers, Actors from Cincinnati, Ohio, Writers from Ohio
The Bozo Show	1960 television series debuts, 2001 television series endings, American children's television series, Television series set in Chicago, Illinois, English-language television programs
Ray Rayner	1919 births, 2004 deaths, Deaths from pneumonia, Disease-related deaths in Florida, American television presenters, Television personalities from New York City, Television personalities from Chicago
Bob Trendler	1912 births, 2011 deaths, Deaths from cardiopulmonary arrest, Cardiovascular disease deaths in Florida, American bandleaders, American songwriters, American television actors, Musicians from Ohio, Writers from Ohio, Actors from Cincinnati, Ohio, Musicians from Chicago, Writers from Chicago, Actors from Chicago
Ellenton, Florida	Census-designated places in Florida
Ned Locke	1919 births, 1992 deaths, Deaths from liver cancer, American television writers, American mayors, American television actors, Actors from Minnesota, Writers from Minnesota, Politicians from Minnesota, Actors from Chicago, Writers from Chicago, Radio personalities from Chicago, Television personalities from Chicago, Politicians from Chicago, Actors from Missouri, Writers from Missouri, Politicians from Missouri
Kimberling City, Missouri	Cities in Missouri
The Beverly Hillbillies	1960s television series debuts, American sitcoms, Television series set in Los Angeles, California, CBS network shows, English-language television programs
Irene Ryan	1902 births, 1973 deaths, Deaths from glioblastoma, Cancer deaths in California, Cardiovascular disease deaths in California, American movie actors, American television actors, American stage actors, American radio actors, Comedians from Texas, Actors from El Paso, Texas
Max Baer Jr.	1937 births, Living people, American movie actors, American television actors, American stage actors, American child actors, Actors from Oakland, California, Screenwriters from California, Movie directors from California, Movie producers from California, Businesspeople from California
Bob Bell	1922 births, 1997 deaths, Deaths from congestive heart failure, Cardiovascular disease deaths in California, American television actors, Actors from Michigan, Actors from Illinois, People from Flint, Michigan
Lake San Marcos, California	Census-designated places in California, Settlements in San Diego County, California
Frazier Thomas	1918 births, 1985 deaths, Deaths from stroke, Cardiovascular disease deaths in Chicago, American television writers, American television actors, American television producers, Writers from Indiana, Actors from Indiana, Television personalities from Chicago, Writers from Chicago
Bill Jackson (television personality)	1935 births, Living people, American television writers, American educators, American cartoonists, Writers from Missouri, Television personalities from Chicago, Writers from Chicago
Unionville, Missouri	Cities in Missouri, County seats in Missouri
Frances Horwich	1907 births, 2001 deaths, Deaths from congestive heart failure, American educators, Entertainers from Ohio, Television personalities from Chicago
Ottawa, Ohio	Villages in Ohio, County seats in Ohio
Fran Allison	1907 births, 1989 deaths, Deaths from myelodysplastic syndrome, Singers from Iowa, Singers from Chicago, Radio personalities from Chicago, Television personalities from Chicago
Mary Hartline	1926 births, 2020 deaths, Models from Chicago, Actors from Chicago, Television personalities from Chicago
Burr Tillstrom	1917 births, 1985 deaths, Deaths from heart failure, Cardiovascular disease deaths in California, American television producers, Television personalities from Chicago
Elaine Mulqueen	1932 births, 2012 deaths, Deaths from cancer of unknown primary origin, Cancer deaths in Chicago, Television personalities from Chicago, Models from Chicago
Western Sydney Airport	Airports in Australia, Buildings and structures in Sydney, Transport in Sydney
Llansantffraid F.C.	Welsh football clubs, 1959 establishments in the United Kingdom, 20th century establishments in Wales, 1997 disestablishments in Europe, 1990s disestablishments in the United Kingdom
Total Network Solutions F.C.	Welsh football clubs, 1997 establishments in the United Kingdom, 20th century establishments in Wales, 2006 disestablishments in the United Kingdom
Grape Vine, Texas	1854 establishments in the United States, 19th-century establishments in Texas, 1907 disestablishments, 1900s disestablishments in the United States, Disestablishments in Texas
Salvadoran Civil War	History of El Salvador, Civil wars
Cordaitales	Gymnosperms
Podocarpaceae	Gymnosperms
Hillary Clinton email controversy	Controversies in the United States
Lynden Pindling	1929 births, 2000 deaths, Deaths from prostate cancer, Protestants, Knights Commander of the Order of St Michael and St George, Privy Councillors (UK), Prime Ministers of the Bahamas
United States Space Force	Military of the United States, Military, Space
Walter Bahr	1927 births, 2018 deaths, Deaths from fractured hip, American footballers, American football managers, American Olympians, Sportspeople from Philadelphia, Pennsylvania
Boalsburg, Pennsylvania	Unincorporated communities in Pennsylvania, Census-designated places in Pennsylvania
Zhao Nanqi	1927 births, 2018 deaths, Communists, Korean politicians, Chinese politicians, Generals
Engelbert Humperdinck (singer)	1936 births, Living people, English pop singers, English pianists, Musicians from Leicestershire, People from Leicester
Kostas Politis	1942 births, 2018 deaths, Greek sportspeople, Basketball players, People from Athens
XXXTentacion	1998 births, 2018 deaths, Murders by firearm in Florida, American murder victims, American criminals, American rock singers, American R&B singers, American hip hop musicians, American rap musicians from Florida, Musicians from Florida, Singers from Florida, Writers from Florida
2003–04 Tampa Bay Lightning season	2003 in ice hockey, 2004 in ice hockey, National Hockey League team seasons, 2003 in Florida, 2004 in Florida, 2000s in Tampa, Florida, Tampa Bay Lightning
Bridget of Sweden	Christian saints, Christian mystics, 1303 births, 1373 deaths
Jayda Fransen	1986 births, Living people, British politicians, British Christians, Critics
British Fascism	Fascism, United Kingdom
Government Schools Teachers Association (GSTA)	Education in India, Delhi
Ajay Veer Yadav	1970 births, Politicians from Uttar Pradesh, Living people
Sarracenia purpurea	Carnivorous plants, Ericales
Say Something (A Great Big World song)	2013 songs, Christina Aguilera songs, Pop songs
Alaska Standard Time	Time zones, Alaska
Yvette Horner	1922 births, 2018 deaths, French musicians
Luis Carlos Galán	1943 births, 1989 deaths, Assassinated people, Colombian politicians, Murders by firearm
Rodrigo Lara	1946 births, 1984 deaths, Assassinated people, Murders by firearm, Colombian politicians, Colombian lawyers
Weather Center Live	The Weather Channel shows, 2009 establishments, English-language television programs
Ivan Drach	1936 births, 2018 deaths, Deaths from myocardial infarction, Ukrainian politicians, Political writers, Political activists, Ukrainian screenwriters, Critics, Poets
Bucky Pizzarelli	1926 births, 2020 deaths, Deaths from the COVID-19 pandemic in the United States, American jazz musicians, American guitarists, Musicians from New Jersey, People from Paterson, New Jersey
Pillowtalk	2016 songs, British music, English music, R&B songs
Ernesto Samper	1950 births, Living people, Presidents of Colombia, People from Bogotá
Álvaro Uribe	1952 births, Living people, Presidents of Colombia
Stephanie Sigman	1987 births, Living people, Naturalized citizens of the United States, Mexican movie actors, Mexican television actors, American movie actors, American television actors, Actresses who played Bond girls
Gabriela de la Garza	1976 births, Living people, Mexican movie actors, Mexican television actors, Actors from Mexico City
Narcos	2015 television series debuts, American drama television series, American crime television series, Netflix original shows, English-language television programs
Wagner Moura	Living people, 1976 births, Brazilian movie actors, Brazilian television actors, Brazilian stage actors
2019 FIFA Women's World Cup	FIFA Women's World Cup, 2019 FIFA Women's World Cup, 2019 in association football, Football in France, June 2019 events, July 2019 events
Gabriel Braga Nunes	1972 births, Living people, Brazilian movie actors, Brazilian television actors, People from São Paulo
Amador City, California	1853 establishments in California, Cities in California, Settlements in Amador County, California
Jackson, California	19th-century establishments in California, 1848 establishments in the United States, Cities in California, County seats in California, Settlements in Amador County, California
Flawil	Municipalities of St. Gallen, Cities in Switzerland
Ian Kinsler	Living people, 1982 births, American baseball players, Sportspeople from Arizona, People from Tucson, Arizona, Detroit Tigers players, Los Angeles Angels players, Texas Rangers players
Mike Trout	Living people, 1991 births, American baseball players, Sportspeople from New Jersey, Los Angeles Angels players, Los Angeles Angels of Anaheim players, American League All-Stars, People from New Jersey
Peter Dragone	Living people, Businesspeople from Boston, Massachusetts
Boyd Holbrook	1981 births, Living people, American movie actors, American television actors, Models from Kentucky, Actors from Kentucky
Igor Muradyan	1957 births, 2018 deaths, Armenian politicians, Political activists, Critics
Nathan Shaham	1925 births, 2018 deaths, Deaths from Alzheimer's disease, Disease-related deaths in Israel, Israeli Jews, Israeli writers
Stanley Cavell	1926 births, 2018 deaths, Deaths from heart failure, Cardiovascular disease deaths in Massachusetts, American Jews, American philosophers, American educators, American autobiographers, American critics, Writers from Massachusetts, Writers from Atlanta, Georgia, Writers from Sacramento, California, People from Brookline, Massachusetts
Roger Sessions	Pulitzer Prize winners, 1896 births, 1985 deaths, American composers, American educators, Yale University alumni, Writers from New York City, Writers from New Jersey, People from Princeton, New Jersey
Juilliard School	Schools in New York, 1905 establishments in the United States, 1900s establishments in New York (state)
J. L. Austin	1911 births, 1960 deaths, Deaths from lung cancer, British philosophers, British military personnel of World War II, Writers from Lancashire
Luis Guzmán	1956 births, Living people, Puerto Rican actors, American movie actors, American television actors, American voice actors, Actors from New York City, Actors from Vermont
Sutton, Vermont	Towns in Vermont
Paulina Gaitán	1992 births, Living people, Mexican movie actors, Mexican television actors, Actors from Mexico City
Necar Zadegan	1982 births, Living people, Naturalized citizens of the United States, German movie actors, German television actors, American movie actors, American television actors, People from Heidelberg, Actors from San Francisco
Raúl Méndez	1975 births, Living people, Mexican movie actors, Mexican television actors, Mexican stage actors, Mexican voice actors
Patrick St. Esprit	1954 births, Living people, American movie actors, American television actors, American voice actors, American video game actors, Actors from California
Dante Caputo	1943 births, 2018 deaths, Argentine academics, Cancer deaths in Argentina, Deaths from pancreatic cancer, Diplomats, Argentine politicians, Presidents of the United Nations General Assembly, People from Buenos Aires
Rudy Insanally	1936 births, Living people, Presidents of the United Nations General Assembly, Diplomats, Guyanese politicians
Didier Opertti	1937 births, Living people, Uruguayan politicians, People from Montevideo, Presidents of the United Nations General Assembly, Uruguayan lawyers
Princess Elisabeth of Denmark	1935 births, 2018 deaths, Danish royalty, Princes and princesses, People from Copenhagen
Frederik, Crown Prince of Denmark	1968 births, Living people, Danish royalty, Princes and princesses, People from Copenhagen
Hubert Green	1946 births, 2018 deaths, Deaths from throat cancer, Cancer deaths in Florida, American golfers, Sportspeople from Florida, Sportspeople from Birmingham, Alabama
Sándor Kányádi	1929 births, 2018 deaths, Deaths from respiratory tract infection, Romanian writers, Hungarian people, Poets, Translators
Abby Lee Miller	1966 births, Living people, American educators, American dancers, American television personalities, American fraudsters, People with cancer, Criminals from Pennsylvania, Writers from Pittsburgh, Pennsylvania
Koko (gorilla)	1971 births, 2018 deaths, Individual animals, Apes
Western lowland gorilla	Apes, Mammals of Africa
Western gorilla	Apes, Mammals of Africa
Cross River gorilla	Apes, Mammals of Africa
Eastern gorilla	Apes, Mammals of Africa
Eastern lowland gorilla	Apes, Mammals of Africa
Scott Dozier	1970 births, 2019 deaths, American people convicted of murder, American prisoners sentenced to death, Murderers who committed suicide, People from Las Vegas, Nevada, People who died in prison custody in the United States, People who committed suicide in prison custody, Suicides by hanging in the United States
Juan Segundo	1963 births, Living people, People from Los Angeles, California, American serial killers, American people convicted of manslaughter, American rapists, American sex offenders
Shawn Grate	1976 births, Living people, American serial killers, American kidnappers, American rapists, American people convicted of manslaughter, Criminals from Ohio
Marion, Ohio	Cities in Ohio, County seats in Ohio
Unity (game engine)	Video game technology
Somerville, Massachusetts	1630 establishments in Massachusetts, Cities in Massachusetts
Papal States	1870 disestablishments, Former theocracies, 750 establishments, Former monarchies, Vatican City, History of Italy
Munich, North Dakota	1904 establishments in the United States, Cities in North Dakota, 20th-century establishments in North Dakota
Constitution Party (United States)	1991 establishments in the United States, Political parties in the United States, Conservative parties
Willem Janszoon	1570 births, 1630 deaths, Dutch explorers, People from Amsterdam
Princess Eugenie	1990 births, Living people, British royalty, English people, House of Windsor, Princes and princesses
Small intestine cancer	Cancer
Armando Merodio	1935 births, 2018 deaths, Deaths from congestive heart failure, Sportspeople from Barcelona, Spanish footballers
Édouard-Jean Empain	1937 births, 2018 deaths, Belgian businesspeople, Cancer deaths in France, Deaths from thyroid cancer, French businesspeople, French crime victims, People from Budapest
Peter Hardeman Burnett	1807 births, 1895 deaths, Deaths from diabetes, American Roman Catholics, American lawyers, Governors of California, Politicians from Nashville, Tennessee, US Democratic Party politicians
Bill Speakman	1927 births, 2018 deaths, British military people, People from Cheshire
Ernie Hunt	1943 births, 2018 deaths, People from Swindon, English footballers, Deaths from Alzheimer's disease
Paul John Marx	1935 births, 2018 deaths, Deaths from cardiomyopathy, Roman Catholic bishops, French Roman Catholics, Papua New Guinean people
Stoke Ramblers F.C.	1863 establishments in England, 1878 disestablishments, 1870s disestablishments in the United Kingdom, Disestablishments in England
Stoke F.C.	1878 establishments in England, 1925 disestablishments in Europe, 1920s disestablishments in England
Jack Laxer	People from Los Angeles, California, American photographers, Deaths from pneumonia, Disease-related deaths in California, 1927 births, 2018 deaths
Theodore J. Sophocleus	1939 births, 2018 deaths, Deaths from heart failure, State legislators of the United States, Businesspeople from Baltimore, Maryland, Politicians from Baltimore, Maryland, US Democratic Party politicians, Pharmacists
Jan-Ove Waldner	Olympic gold medalists, Olympic silver medalists, Olympic bronze medalists, Living people, Table tennis players, Sportspeople from Stockholm, 1965 births
Kiminori Matsuyama	Japanese economists, Japanese people, Harvard University alumni
Ravensburg	1276 establishments, 13th-century establishments in Germany, 1803 disestablishments, 1800s disestablishments in Germany, 1270s establishments in Europe
Hurricane Bud (2018)	Hurricanes in Mexico, 2018 in Mexico
The Mighty B!	English-language television programs, 2008 television series debuts, 2011 television series endings
V354 Cephei	Red giants, Variable stars, Supergiants
Pollux (star)	Red giants
Grey DeLisle	1973 births, Living people, American movie actors, American television actors, American voice actors, American video game actors, American singer-songwriters, Actors from Monterey County, California, Singers from California, Writers from California
Basenji	Dog breeds
Arthur Eddington	1882 births, 1944 deaths, English astronomers, English mathematicians, English physicists
Alfred Jewel	Jewelry, Anglo-Saxons
List of people from Bihar	Lists of Indian people, Bihar
Mohali	Cities in India, Settlements in Punjab, India
2018 California gubernatorial election	November 2018 events, 2018 California elections
Sahibzada Ajit Singh Nagar district	Districts of Punjab, India
Muthuvan language	Dravidian languages
Diesel locomotive	Locomotives
Halina Aszkiełowicz-Wojno	1947 births, 2018 deaths, Polish volleyball players, Polish Olympic medalists, Medalists at the 1968 Summer Olympics, Olympic bronze medalists
FOXP2	Genetics
Langdon, North Dakota	1884 establishments in the United States, Cities in North Dakota, County seats in North Dakota, 1880s establishments in North Dakota
Hannah, North Dakota	1897 establishments in the United States, Cities in North Dakota, 1890s establishments in North Dakota
Magalì Vettorazzo	1942 births, 2018 deaths, Italian Olympians
Katriina Elovirta	1961 births, 2018 deaths, Finnish footballers
Laurence Street	1926 births, 2018 deaths, Australian judges, Politicians from Sydney
Nahum Korzhavin	1925 births, 2018 deaths, Naturalized citizens of the United States, Russian poets, American poets, Writers from Boston, Massachusetts, People from Kiev
Olga Krzyżanowska	1929 births, 2018 deaths, Deaths from respiratory failure, Disease-related deaths in Poland, Politicians from Warsaw
Dick Leitsch	1935 births, 2018 deaths, Gay men, Deaths from liver cancer, Cancer deaths in New York City, American journalists, LGBT people from New York City, Journalists from New York City, Writers from Louisville, Kentucky, American LGBT rights activists
Geoffrey Oryema	1953 births, 2018 deaths, Deaths from cardiac arrest, Ugandan people, French musicians, Guitarists
Vinnie Paul	1964 births, 2018 deaths, Deaths from cardiomyopathy, Deaths from coronary artery disease, American heavy metal musicians, American drummers, American guitarists, American songwriters, American record producers, Musicians from Texas, Writers from Texas, People from Abilene, Texas
Waldir Pires	1926 births, 2018 deaths, Deaths from multiple organ failure, Brazilian politicians
Koro Wētere	1935 births, 2018 deaths, New Zealand politicians
Lalu Prasad Yadav	Indian politicians, 1948 births, Living people, Bihar, People from Bihar
Bogie	Rail technologies
Nalchik	Spa towns
Elista	1865 establishments in Europe, 19th century establishments in Russia
Innamaadhoo (Raa Atoll)	Geography of the Maldives, Islands of Asia
Soglio, Switzerland	Former municipalities of Graubünden
Stampa	Former municipalities of Graubünden
Silvaplana	Municipalities of Graubünden
Ringsted	Cities in Denmark
Fontvieille, Monaco	Monaco
Basic income	Economics
Vladikavkaz	1784 establishments, Capitals of republics of Russia
Cryptocurrency	Cryptocurrency
Didcot, Newbury and Southampton Railway	Closed railway lines in South East England
David Plouffe	1967 births, Living people, Politicians from Wilmington, Delaware, US Democratic Party politicians
Duodecimal	Numerals, Systems
Alberto Fouilloux	1940 births, 2018 deaths, Deaths from lung cancer, Chilean footballers
Phan Huy Lê	Vietnamese people, Historians, Deaths from cardiovascular disease, 1934 births, 2018 deaths
Prime Minister of South Korea	Prime Ministers of South Korea
Lee Nak-yeon	1951 births, Living people, Prime Ministers of South Korea
Lee Hong-koo	Living people, 1934 births, Prime Ministers of South Korea
Lho Shin-yong	1930 births, 2019 deaths, Prime Ministers of South Korea
Violeta Rivas	Actors from Buenos Aires, Argentine singers, Pop singers, Deaths from stroke, 1937 births, 2018 deaths
Pavel Vranský	1921 births, Living people, Czech people, Generals
Nitish Kumar	1951 births, Indian politicians, Bihar, Living people, People from Bihar
Francine Muyumba	1987 births, People from the Democratic Republic of the Congo, Activists, Living people
Nickel–zinc battery	Batteries
University of Namibia	Windhoek, Colleges and universities in Africa
Depolarizer	Batteries
Fire-tube boiler	Boilers
Motor–generator	Electricity
AAR wheel arrangement	Locomotive classification systems, Rail transport
Ken Albiston	1926 births, 2018 deaths, Australian rules footballers, Sportspeople from Victoria (Australia)
Richard Benjamin Harrison	1941 births, 2018 deaths, Deaths from Parkinson's disease, Disease-related deaths in Nevada, American television personalities, Businesspeople from Virginia, People from North Carolina
Jamsheed Marker	1922 births, 2018 deaths, Pakistani politicians, Ambassadors to the United States
Francesco Forleo	1941 births, 2018 deaths, Italian politicians, Police officers, People from Turin, Deaths from dementia
Etna, California	1878 establishments in California, Cities in California, Settlements in Siskiyou County, California
Montague, California	1900s establishments in California, 1909 establishments in the United States, Cities in California, Settlements in Siskiyou County, California
Ismael Balkhi	1918 births, 1968 deaths, Hazara people, Hazara politicians, poets
Siskiyou County, California	1850s establishments in California, 1852 establishments in the United States, Siskiyou County, California
Yreka, California	1851 establishments in California, 1857 establishments in California, Cities in California, County seats in California, Settlements in Siskiyou County, California
Baikonur Cosmodrome	1955 establishments in Asia, Spaceports, Buildings and structures in Asia, Kazakhstan
Proton (rocket family)	Rockets, Russia
North British Locomotive Company	Locomotive manufacturers, 1903 establishments in the United Kingdom, 20th century establishments in Scotland, 1962 disestablishments, Defunct companies of the United Kingdom
Volatility	Finance
Josh Hawley	1979 births, Living people, United States senators from Missouri, Stanford University alumni, Yale University alumni, Attorneys general, Politicians from Missouri, US Republican Party politicians
Geoff Case	1935 births, 2018 deaths, Australian rules footballers, Sportspeople from Victoria (Australia)
Deanna Lund	1937 births, 2018 deaths, Deaths from pancreatic cancer, Cancer deaths in Los Angeles, American movie actors, American television actors, Actors from Illinois, People from Oak Park, Illinois
Constance Adams	Writers from Houston, Texas, American architects, Deaths from colorectal cancer, Cancer deaths in Texas, 1960s births, 2018 deaths
Tony Evers	1951 births, Living people, Governors of Wisconsin, Cancer survivors, American educators, Politicians from Wisconsin, US Democratic Party politicians
Grigory Barenblatt	1927 births, 2018 deaths, Russian mathematicians, Writers from Moscow
W. S. Merwin	1927 births, 2019 deaths, Deaths from myocardial infarction, Pulitzer Prize winners, American poets, Writers from New York City, Writers from Hawaii
Charles Simic	1938 births, Living people, Pulitzer Prize winners, American poets, Naturalized citizens of the United States, Writers from Illinois, Writers from New Hampshire, People from Oak Park, Illinois, People from Belgrade
Michelle Clunie	1969 births, Living people, American movie actors, American television actors, American voice actors, American activists, American dancers, Actors from Portland, Oregon
Creed discography	Discographies
R. Scott Bakker	1967 births, Living people, Canadian novelists, Canadian science fiction writers
Deneb	Northern pole stars, Supergiants
John Francis Jackson	1908 births, 1942 deaths, People from Brisbane, Australian military people, World War II people
Omokoroa	Settlements in New Zealand
Falcon 9	SpaceX, Rockets, United States
Distinguished Flying Cross (United Kingdom)	Military honors
Paterson Clarence Hughes	1917 births, 1940 deaths, Australian military people
Bamboo Airways	Airlines of Asia
Big Four British railway companies	Rail transport in Great Britain
London, Midland and Scottish Railway	Rail transport in Great Britain, 1923 establishments in the United Kingdom
Electro-diesel locomotive	Locomotives
Caledonian Sleeper	Rail transport in Great Britain
Christina Kirkman	1990s births, 1993 births, Comedians
1998 Kissimmee tornado outbreak	Tornadoes in the United States, 1998 in Florida, February events
Short (finance)	Finance, Stock market
Richard Girnt Butler	1918 births, 2004 deaths, Deaths from congestive heart failure, People from Denver, Colorado, American Christians, American conservatives, American military personnel of World War II, Writers from Colorado, Writers from Idaho
Alan Berg	1934 births, 1984 deaths, Murders by firearm in the United States, American crime victims, American lawyers, Jewish American writers, Journalists from Chicago, Radio personalities from Chicago, Writers from Denver, Colorado
North Barrington, Illinois	Villages in Illinois
Waco siege	1993 in the United States, Murders by firearm in the United States, 1990s in Texas, Waco, Texas
Lockport, New York	Cities in New York, County seats in New York
George Peabody	1795 births, 1869 deaths, Deaths from pneumonia, Disease-related deaths in London, American philanthropists, Businesspeople from Massachusetts, Slavers
Torque converter	Engineering
Bill Hendon	1944 births, 2018 deaths, Deaths from Parkinson's disease, United States representatives from North Carolina, American political writers, American political activists, Writers from North Carolina, People from Asheville, North Carolina, US Republican Party politicians
Forest City, North Carolina	Towns in North Carolina
Frank Heart	1929 births, 2018 deaths, Deaths from melanoma, Cancer deaths in Massachusetts, American computer scientists, Engineers from New York, Scientists from New York City, People from Yonkers, New York
Ljubuški	Settlements in Bosnia and Herzegovina
Blockchain	Computer science, Cryptocurrency
Supreme Court of India	National supreme courts, Government of India
Then Shall of the Mourning	American musical groups
Fabian strategy	War
Sainte-Croix-aux-Mines	Communes in Haut-Rhin
List of railway companies involved in the 1923 Grouping	Rail transport in Great Britain
Jagjivan Ram	1908 births, 1986 deaths, Indian activists, Bihar, People from Bihar, Indian Deputy Prime Ministers
Andrey Dementyev	1928 births, 2018 deaths, Deaths from prostate cancer, Russian poets, Soviet writers
Grade (slope)	Physical geography
Henri Namphy	1932 births, 2018 deaths, Deaths from lung cancer, Presidents of Haiti
Prosper Avril	Presidents of Haiti, Generals, 1937 births, Living people
President of Haiti	Presidents of Haiti
Jovenel Moïse	1968 births, 2021 deaths, Presidents of Haiti, Assassinated people, Murders by firearm
Vladimir Andreyevich Uspensky	2018 deaths, 1930 births, Deaths from heart failure, Russian mathematicians, Russian physicians, Russian physicists, Writers from Moscow
Alexandria Ocasio-Cortez	Alexandria Ocasio-Cortez, 1989 births, Living people, United States representatives from New York, American political activists, American progressives, Democratic socialists, American Roman Catholics, BBC 100 Women, American columnists, American LGBT rights activists, Writers from the Bronx, Politicians from New York City, US Democratic Party politicians, 21st-century American politicians, Twitch (service) streamers
Cambrian Railways	Rail transport in Great Britain
ECW CyberSlam (1996)	Extreme Championship Wrestling, 1996 in professional wrestling, 1996 in the United States, 1990s in Philadelphia
ECW CyberSlam (1997)	Extreme Championship Wrestling, 1997 in sports, 1997 in the United States, 1990s in Philadelphia, 1990s in New York City
ECW CyberSlam (1998)	Extreme Championship Wrestling, 1998 in sports, 1998 in the United States, 1990s in Philadelphia
ECW CyberSlam (1999)	Extreme Championship Wrestling, 1999 in professional wrestling, 1999 in the United States, 1990s in Philadelphia
ECW CyberSlam (2000)	Extreme Championship Wrestling, 2000 in sports, 2000 in the United States, 2000s in Philadelphia
London and North Western Railway	Rail transport in Great Britain
David Berkowitz	1953 births, Living people, American people convicted of manslaughter, American adoptees, American Christians, American serial killers, Criminals from New York City
Gary Ridgway	1949 births, Living people, American serial killers, American people convicted of manslaughter, American military personnel of the Vietnam War, People from Seattle, Washington, People from Salt Lake City, Utah
Lockdown (2005)	Total Nonstop Action Wrestling pay-per-view events, 2005 in professional wrestling, Sports in Orlando, Florida, 2005 in American television, 2005 in Orlando, Florida
Lockdown (2006)	Total Nonstop Action Wrestling pay-per-view events, 2006 in professional wrestling, Sports in Orlando, Florida, 2006 in American television, 2000s in Orlando, Florida
Donn Moomaw	1931 births, Living people, American football players, American Presbyterians, Sportspeople from California
Bruce Davison	Golden Globe Award winning actors, 1946 births, Living people, American movie actors, American television actors, American stage actors, American voice actors, American movie directors, American television directors, Actors from Philadelphia, Pennsylvania
Daniel Pilon	1940 births, 2018 deaths, Cancer deaths in Canada, Canadian movie actors, Canadian television actors, Canadian stage actors, Actors from Montreal
Fountain Hill, Arkansas	Towns in Arkansas
Abbas Alizada	Living people
FNaF World	Five Nights at Freddy's (series)
Freddy Fazbear's Pizzeria Simulator	Five Nights at Freddy's (series)
Scott Cawthon	1972 births, Living people, American animators, American Christians, American novelists, Five Nights at Freddy's (series), Writers from Texas
Midland Railway	Rail transport in Great Britain
Salado, Texas	Villages in Texas
Killeen, Texas	Cities in Texas
Temple, Texas	Cities in Texas
Belton, Texas	Cities in Texas, County seats in Texas
Clio, Alabama	Cities in Alabama
Great Northern Railway (Great Britain)	Rail transport in Great Britain, 1846 establishments in the United Kingdom
North Eastern Railway (UK)	Rail transport in Great Britain, 1854 establishments in Europe, 1850s establishments in the United Kingdom
George Steiner	1929 births, 2020 deaths, Naturalized citizens of the United States, French philosophers, French novelists, French educators, French Jews, French essayists, American philosophers, American novelists, American literary critics, American educators, American essayists, Holocaust survivors, Jewish American writers, Writers from New York City, Writers from New Jersey
The Turk	Hoaxes, Magic, Illusions, Chess
Wolfgang von Kempelen	1734 births, 1804 deaths, Inventors, People from Bratislava
Meadowbank Stadium	Stadiums in the United Kingdom, Buildings and structures in Scotland
Knight's tour	Chess, Puzzles
Derby railway station	Railway stations in England, Derby
Northern (train operating company)	Train operating companies, Rail transport in the United Kingdom
Great Central Railway	Rail transport in Great Britain, 1897 establishments in the United Kingdom
London and South Western Railway	Rail transport in Great Britain
Epitaph	Death customs, Writing
2020 UEFA Champions League Final	2020 in association football, August 2020 events, Football in Portugal, UEFA Champions League
John Napier	1550 births, 1617 deaths, British mathematicians
London, Brighton and South Coast Railway	Rail transport in Great Britain
Shoreham-by-Sea	Towns in West Sussex
South Eastern Railway (UK)	Rail transport in Great Britain
William Oughtred	1574 births, 1660 deaths, British mathematicians
London, Chatham and Dover Railway	Rail transport in Great Britain
South Eastern and Chatham Railway	Rail transport in Great Britain
Caledonian Railway	Rail transport in Great Britain
Lancashire and Yorkshire Railway	Rail transport in Great Britain
Aintree	Civil parishes in Merseyside
Stanley Anderson	1939 births, 2018 deaths, Deaths from brain cancer, American movie actors, American television actors, American stage actors, Actors from Montana, People from Billings, Montana
Josip Pirmajer	1944 births, 2018 deaths, Deaths from myocardial infarction, Slovenian footballers
Štefka Drolc	1923 births, 2018 deaths, Deaths from pneumonia, Slovenian actors, Movie actors, Stage actors, Television actors
Steve Soto	1963 births, 2018 deaths, American punk musicians, American guitarists, Musicians from California
Capital Gazette shooting	2018 crimes in the United States, 2010s in Maryland, Deaths by firearm in the United States, June 2018 events
Roger Stone	1952 births, Living people, American lobbyists, American political commentators, American political writers, Libertarians, People from Norwalk, Connecticut, Republicans (United States), Writers from Connecticut, Writers from Florida, Writers from New York
Ormskirk	Towns in Lancashire
Domenico Losurdo	1941 births, 2018 deaths, Deaths from esophageal cancer, Cancer deaths in Italy, Italian philosophers, Italian communists, Italian writers, Italian historians
St Helens, Merseyside	Towns in Merseyside
Brett Kavanaugh	1965 births, Living people, United States Supreme Court justices, American lawyers, Yale University alumni, Politicians from Maryland, Politicians from Washington, D.C., People from Bethesda, Maryland, US Republican Party politicians, American Roman Catholics
Impeachment of Bill Clinton	1998 in the United States, Bill Clinton
Kathleen Kraninger	1974 births, Living people, Directors of the Consumer Financial Protection Bureau, Politicians from Ohio, US Republican Party politicians
Stephen Miller	1985 births, Living people, Jewish American writers, American political writers, Writers from California, Politicians from California, People from Santa Monica, California, US Republican Party politicians
Lockdown (2014)	Total Nonstop Action Wrestling pay-per-view events, 2014 in professional wrestling, Sports in Miami, Florida, 2014 in American television, 2014 in Florida, 2010s in Miami, Florida
Goran Bunjevčević	1973 births, 2018 deaths, Deaths from stroke, Serbian footballers
Liverpool Overhead Railway	Electric railways in the United Kingdom
Chagrin Falls, Ohio	Villages in Ohio
Lockdown (2015)	Total Nonstop Action Wrestling pay-per-view events, 2015 in professional wrestling, Sports in New York City, 2015 in the United States, 2010s in New York City, April 2015 events
Lockdown (2007)	Total Nonstop Action Wrestling pay-per-view events, 2007 in professional wrestling, 2007 in American television, 2000s in Missouri
Johann Baptist Allgaier	1763 births, 1823 deaths, Deaths from edema, Chess players
Rob Hiaasen	1959 births, 2018 deaths, Deaths by firearm in the United States, American journalists, American crime victims, Writers from Florida, Writers from Maryland, People from Fort Lauderdale, Florida
Benjamin Jealous	1973 births, Living people, American political activists, American progressives, Politicians from California, Politicians from Maryland, US Democratic Party politicians
Jacky Rosen	1957 births, Living people, United States senators from Nevada, United States representatives from Nevada, Politicians from Chicago, US Democratic Party politicians
Jared Polis	1975 births, Living people, Governors of Colorado, United States representatives from Colorado, Gay men, LGBT businesspeople, LGBT politicians, American philanthropists, Businesspeople from Colorado, People from Boulder, Colorado, US Democratic Party politicians
Kalevi Sorsa	1930 births, 2004 deaths, Prime Ministers of Finland, Speakers of the Parliament of Finland
Hyacinthe Henri Boncourt	1840 deaths, Chess players
Aaron Alexandre	1766 births, 1850 deaths, British Jews, British chess players, French Jews, German Jews, German chess players, European writers
Stacey Abrams	1973 births, Living people, American lawyers, American novelists, Writers from Georgia (U.S. state), Businesspeople from Georgia (U.S. state), Politicians from Georgia (U.S. state), Writers from Wisconsin, Politicians from Wisconsin, People from Madison, Wisconsin, US Democratic Party politicians
Maryland Gazette	Newspapers in the United States, Maryland
The Capital	19th-century establishments in Maryland, 1884 establishments in the United States, Newspapers in the United States, Annapolis, Maryland
William Lewis (chess player)	1787 births, 1870 deaths, British chess players, Sportspeople from Birmingham
Mod (video games)	Video games
Land's End	Geography of Cornwall, Capes
Kenneth Matengu	Namibian people, 1978 births, Living people, Academics
Guizhou	Provinces of China
Ruwen Filus	1988 births, Living people, German table tennis players, Olympic medalists
Halewood	Towns in Merseyside, Civil parishes in Merseyside
Sefton, Merseyside	Civil parishes in Merseyside
Julian of Norwich	1340s births, 1410s deaths, People from Norwich, English people, English writers, Christian writers, Christian mystics, English Roman Catholics, Non-fiction books
Versoix	Municipalities of Geneva, Cities in Switzerland
Patrice Talon	1958 births, African businesspeople, Presidents of Benin, Roman Catholics, Current national leaders, Living people
November 1989 tornado outbreak	1989 in the United States, Tornadoes in the United States
Heysham	Villages in Lancashire
Big Bill Bissonnette	Musicians from New Orleans, Louisiana, American jazz musicians, American drummers, American trombonists, American record producers, 1937 births, 2018 deaths
National Railway Museum	Museums in the United Kingdom, York, National museums, Transport in England
Steven Hilliard Stern	1937 births, 2018 deaths, Deaths from stomach cancer, Cancer deaths in Los Angeles, Canadian movie directors, Canadian television directors, Canadian movie producers, Canadian television producers, Canadian television writers, Naturalized citizens of the United States, American television directors, American television producers, American television writers, Movie directors from Los Angeles, California, Movie producers from Los Angeles, California, Screenwriters from Los Angeles, California, Writers from Ontario
Kwesi Amissah-Arthur	1951 births, 2018 deaths, Deaths from myocardial infarction, Vice presidents, Educators, Economists, Ghanaian people, Ghanaian politicians
Nana Akufo-Addo	1944 births, Living people, Lawyers, Current national leaders, Presidents of Ghana
John Kufuor	1938 births, Living people, Presidents of Ghana, African Union chairpersons
Video chat	Telecommunications, Video chat
Napier Deltic	Motors
Walker Stapleton	1974 births, Living people, Alumni of the London School of Economics, Harvard University alumni, Politicians from Colorado, US Republican Party politicians, Bush family
Liliane Montevecchi	Tony Award winning actors, Drama Desk Award winners, 1932 births, 2018 deaths, Deaths from colorectal cancer, Cancer deaths in New York City, French movie actors, French television actors, French stage actors, French singers, French dancers, Italian movie actors, Italian television actors, Italian stage actors, Italian singers, Actors from Paris
Matt Cappotelli	1979 births, 2018 deaths, Deaths from glioblastoma, American professional wrestlers, Sportspeople from New York
Caledonia, New York	Towns in New York
Jerry Rawlings	1947 births, 2020 deaths, Deaths from the COVID-19 pandemic in Ghana, Presidents of Ghana, Generals
President of Ghana	Presidents of Ghana
Daytime television	Television genres
Ultimate Custom Night	Five Nights at Freddy's (series)
Sara Amelia Bernard	1992 births, Malaysian actors, Models, Muslims, Living people
Council of Foreign Ministers	1945
Metal rectifier	Electronic components, Rectifiers
Mercury-arc rectifier	Rectifiers, Electronic components
Gas turbine	Motors
Theorema egregium	Geometry
Borgo Maggiore	Municipalities of San Marino
Domagnano	Municipalities of San Marino
Fiorentino	Municipalities of San Marino
Faetano	Faetano, Municipalities of San Marino
Chiesanuova	Municipalities of San Marino
Montegiardino	Municipalities of San Marino
Two-stroke engine	Motors
Anchorite	Monks, Christian terminology, Christian religious occupations
North Downs Line	Rail transport in England, Railway lines of England
Jennings, Louisiana	Cities in Louisiana, Parish seats in Louisiana
Eastleigh	Towns in Hampshire
Dan Dawson	1981 births, Lacrosse, Sportspeople from Ontario, Living people
Nissan Stadium (Nashville)	National Football League venues, Sports in New Jersey, Buildings and structures in New Jersey, 2010 establishments in New Jersey, Nissan
Deaths in July 2018	2018 deaths, July 2018 events
James M. Keck	1921 births, 2018 deaths, Deaths from fractured hip, American military personnel of World War II, American military personnel of the Korean War, American military personnel of the Vietnam War, People from Scranton, Pennsylvania
Irena Szewińska	1946 births, 2018 deaths, Deaths from endometrial cancer, Polish Jews, Polish Olympic medalists, Polish sportspeople, Soviet sportspeople, Soviet Jews, Sprinters, Soviet Olympic gold medalists, Soviet Olympic silver medalists, Olympic bronze medalists, Cancer deaths in Poland, People from Saint Petersburg
José Antonio Zaldúa	1941 births, 2018 deaths, Spanish footballers
Jed Allan	1935 births, 2019 deaths, American movie actors, American television actors, American television presenters, Actors from New York City, Television personalities from New York
Fallon, Nevada	Cities in Nevada, County seats in Nevada
Illinois's 5th congressional district	Congressional districts of Illinois, 1843 establishments in the United States, 1840s establishments in Illinois
Joe Crowley	1962 births, Living people, United States representatives from New York, Politicians from New York City, US Democratic Party politicians, 21st-century American politicians, 20th-century American politicians
Dimbulukeni Nauyoma	1992 births, Living people, People from Windhoek, Activists
Pineberry	Fruits
Chrissy Metz	American television actors, Singers from Florida, Actors from Florida, 1980 births, Living people
George Kambala	People from Windhoek, 1992 births, Living people, Activists
Landover, Maryland	Census-designated places in Maryland
Maratha Empire	History of India
List of British heritage and private railways	Rail transport in Great Britain, Heritage railways in England
James S. Denton	1951 births, 2018 deaths, Deaths from prostate cancer, Cancer deaths in Washington, D.C., Publishers, American editors, Writers from New Jersey, Writers from Washington, D.C.
Florida Parishes	Regions of Louisiana
Peter Firmin	1928 births, 2018 deaths, British television producers, British artists, Animators, British illustrators, People from Essex
Paola Paternoster	1935 births, 2018 deaths, Deaths from colorectal cancer, Cancer deaths in Italy, Italian athletes, Italian Olympians, Sportspeople from Rome
Nicholls State University	Colleges and universities in Louisiana
Centreville, Mississippi	Towns in Mississippi
Amite City, Louisiana	Parish seats in Louisiana, Towns in Louisiana
Allen, Louisiana	Unincorporated communities in Natchitoches Parish, Louisiana
Scorpion (Drake album)	Drake albums, 2018 albums, Hip hop albums, R&B albums
Jacques François Mouret	1787 births, 1837 deaths, Chess players, French sportspeople
Benton, Louisiana	Parish seats in Louisiana, Towns in Louisiana
Dungeness Nuclear Power Station	Nuclear power stations in the United Kingdom
Magnox	Nuclear energy
Advanced gas-cooled reactor	Nuclear energy
Torness Nuclear Power Station	Nuclear power stations in the United Kingdom
Heysham nuclear power station	Nuclear power stations in the United Kingdom
Pressurized water reactor	Nuclear energy
The Mpemba effect	Water, Thermodynamics
Communications-based train control	Rail technologies
Rolling stock	Rolling stock, Rail transport
Armando (artist)	1929 births, 2018 deaths, Dutch painters, Sculptors, Writers from Amsterdam
François Corbier	1944 births, 2018 deaths, Cancer deaths in France, French songwriters, French television presenters, Guitarists, Musicians from Paris, Writers from Paris
Bozhidar Dimitrov	1945 births, 2018 deaths, Deaths from myocardial infarction, Bulgarian politicians, Historians
Shirley Huffman	1928 births, 2018 deaths, Deaths from natural causes, Disease-related deaths in California, American mayors, Politicians from Oregon, US Republican Party politicians
Dayton, Oregon	Cities in Oregon
Gillian Lynne	1926 births, 2018 deaths, Deaths from pneumonia, Disease-related deaths in London, English dancers, Choreographers, English stage actors, English television actors, English television directors, Ballerinas, Actors from London
Julian Tudor Hart	1927 births, 2018 deaths, British physicians, British communists, Politicians from London, Writers from London
President of Mexico	Presidents of Mexico
Ernesto Zedillo	1951 births, Living people, Presidents of Mexico, Mexican economists, Politicians from Mexico City
Carlos Salinas de Gortari	1948 births, Living people, Mexican economists, Presidents of Mexico
Gudrun Burwitz	1929 births, 2018 deaths, Nazis, People from Munich, Anti-Communists, Neo-Nazis
Denis Akiyama	1952 births, 2018 deaths, Canadian movie actors, Canadian television actors, Canadian voice actors, Canadian stage actors, Actors from Toronto
Toru Iwatani	1955 births, Living people, Japanese video game designers, People from Tokyo
Bryce Dallas Howard	1981 births, Living people, American movie actors, American television actors, American voice actors, American stage actors, Models from Los Angeles, California, American video game actors, American child actors, Movie directors from Los Angeles, California, Movie producers from Los Angeles, California, Writers from Los Angeles, California
Rafe Spall	1983 births, Living people, English movie actors, English television actors, English stage actors, English voice actors, English radio actors, Actors from London
Tank car	Rolling stock
BD Wong	Drama Desk Award winners, Tony Award winning actors, 1960 births, Living people, American movie actors, American television actors, American stage actors, American voice actors, American video game actors, Gay men, LGBT people from California, LGBT actors, Writers from San Francisco, Actors from San Francisco
Billy Kinard	1933 births, 2018 deaths, American football defensive ends, American football coaches, Cleveland Browns players, Green Bay Packers players, Sportspeople from Mississippi, People from Jackson, Mississippi
Daniella Pineda	1987 births, Living people, American movie actors, American television actors, Actors from Oakland, California, Comedians from California, Writers from California
Justice Smith	Living people, 1995 births, American movie actors, American television actors, American voice actors, Actors from Los Angeles, California
Hunterston B nuclear power station	Nuclear power stations in the United Kingdom
San Rafael, California	1874 establishments in California, Settlements in Marin County, California, Cities in California, Cities in the San Francisco Bay Area, County seats in California
2018 Mexican general election	2018 in Mexico, July 2018 events, Politics of Mexico
Beatriz Gutiérrez Müller	1969 births, Living people, Mexican journalists, Writers from Mexico City, First Ladies of Mexico
Margarita Zavala	1967 births, Living people, First Ladies of Mexico, Mexican lawyers, Politicians from Mexico City, Women lawyers
Democratic Socialists of America	Democratic socialists, Political organizations based in the United States, 1982 establishments in the United States
Carlos Ramirez-Rosa	1989 births, Living people, Gay men, LGBT politicians, LGBT people from Chicago, Democratic socialists, Chicago City Council members, US Democratic Party politicians
Henry Butler	1949 births, 2018 deaths, Deaths from colorectal cancer, Cancer deaths in New York City, African American musicians, American jazz musicians, American pianists, American photographers, American R&B musicians, Musicians from New Orleans, Louisiana, African-American photographers
Amy Coney Barrett	1972 births, Living people, American judges, American lawyers, American Roman Catholics, Politicians from Washington, D.C., Politicians from New Orleans, Louisiana, Women judges, United States Supreme Court justices
United Nations Economic and Social Council	Development, Economics organizations, United Nations
United Nations Trusteeship Council	United Nations
George Vancouver	English explorers, 1757 births, 1798 deaths
University of British Columbia	Vancouver, Colleges and universities in Canada, 1908 establishments in North America, 1900s establishments in Canada
Ricardo Anaya	1979 births, Living people, Mexican lawyers, Presidents of the Chamber of Deputies (Mexico)
José Antonio Meade	1969 births, Living people, Mexican lawyers, Diplomats, Mexican economists, Politicians from Mexico City
Jaime Rodríguez Calderón	1957 births, Living people, Mexican politicians
National Regeneration Movement	Political parties in Mexico
Grey Cup	1909 establishments in North America, Sports trophies and awards, Canadian football
National Action Party (Mexico)	1930s establishments in Mexico, 1939 establishments, Political parties in Mexico
Fraser River	Rivers of Canada
Seven Nation Army	2003 songs, Rock songs, Grammy Award winning songs
Institutional Revolutionary Party	1920s establishments in Mexico, 1929 establishments in North America, Political parties in Mexico
Amber Lee Connors	1991 births, Living people, American voice actors, American screenwriters, American video game actors, American television actors, American movie actors, Actors from Cleveland, Ohio, Actors from Dallas, Texas, Writers from Ohio, Writers from Texas
Virginia, Minnesota	Cities in Minnesota
Chaitali Das	Living people, Indian businesspeople, West Bengal, Business people
Cal 3	2018 California elections
Drover (company)	British transport companies
Bergün Filisur	Municipalities of Graubünden, 2010s establishments in Switzerland, 2018 establishments in Europe
Vicosoprano	Former municipalities of Graubünden
Bregaglia	Municipalities of Graubünden, 2010 establishments in Switzerland
S-chanf	Municipalities of Graubünden
Sils im Engadin/Segl	Municipalities of Graubünden
Ross, California	1908 establishments in California, Towns in California, Settlements in Marin County, California, Cities in the San Francisco Bay Area
Lake Brienz	Lakes of Bern
Nadine Trintignant	1934 births, Living people, French movie directors, French movie producers, French screenwriters, French novelists, Editors, People from Nice
Bill Watrous	1939 births, 2018 deaths, American jazz musicians, American trombonists, Musicians from Connecticut, Musicians from Los Angeles, California
Richard Swift (singer-songwriter)	1977 births, 2018 deaths, Deaths from hepatitis, American record producers, American singer-songwriters, Singers from California, Musicians from California, Writers from California
Michael Bell	1938 births, Living people, American voice actors, American movie actors, American television actors, American video game actors, American stage actors, American animal rights activists, Jewish American actors, Actors from New York City
David Durenberger	1934 births, Living people, United States senators from Minnesota, US Republican Party politicians, People from St. Cloud, Minnesota
Dennis DeConcini	1937 births, Living people, United States senators from Arizona, American philanthropists, American lawyers, American political writers, Writers from Arizona, People from Tucson, Arizona, US Democratic Party politicians
Ethiopian birr	Currency of Africa, Ethiopia
Puma (brand)	1920s establishments in Germany, 1924 establishments in Europe, Companies of Germany, Clothing companies, Bavaria
Munevera Zulfikarpašić	People from Sarajevo, 1918 births, 1999 deaths, Pharmacists
Military base	Military
J.Crew	1980s establishments in New York (state), 1983 establishments in the United States, American clothing companies, Companies based in New York City
Georgia Aquarium	2005 establishments in the United States, Aquariums, Buildings and structures in Atlanta, Georgia
Tom Holland	BAFTA Award winning actors, Saturn Award winners, 1997 births, Living people, English movie actors, English stage actors, English voice actors, English child actors, English dancers, Actors from London
Gun language	Languages of Benin
Bot	Software
Aphorism	Phrases, Literary terms
Henri Dirickx	1927 births, 2018 deaths, Belgian footballers, People from Antwerp (province)
Parson's Cause	History of Virginia
Hans Hürlimann	1918 births, 1994 deaths, Presidents of the Swiss Confederation, Canton of Zug
1946–47 Chicago Stags season	National Basketball Association seasons
Jagmeet Singh	1979 births, Living people, Politicians from Toronto, Members of the House of Commons of Canada from British Columbia
Ohio Fireworks Derecho	Weather events
Brad Dye	1933 births, 2018 deaths, Deaths from respiratory failure, Lieutenant Governors of Mississippi, US Democratic Party politicians
Ray Mabus	1948 births, Living people, Governors of Mississippi, United States Secretaries of the Navy, Ambassadors of the United States, Harvard University alumni, US Democratic Party politicians
Dick Feagler	1938 births, 2018 deaths, American columnists, American playwrights, American television personalities, American radio personalities, Writers from Cleveland, Ohio
Gordon Hillman	1943 births, 2018 deaths, Deaths from Parkinson's disease, Disease-related deaths in London, British botanists, British educators, British archaeologists
Patrick Finnegan	1949 births, 2018 deaths, Deaths from myocardial infarction, Cardiovascular disease deaths in Virginia, American generals, American educators, American lawyers, People from Baltimore, Maryland
Ángel Roberto Seifart	1941 births, 2018 deaths, Deaths from COPD, Judges, Vice presidents, People from Asunción
Mario Abdo Benítez	Living people, 1971 births, Presidents of Paraguay, Current national leaders, People from Asunción
Juan Carlos Wasmosy	1938 births, Living people, People from Asunción, Presidents of Paraguay, Engineers
Georges-Emmanuel Clancier	1914 births, 2018 deaths, Deaths from pneumonia, Disease-related deaths in Paris, French centenarians, French poets, French journalists, French novelists
President of Paraguay	Presidents of Paraguay
Raúl Cubas Grau	1943 births, Living people, Presidents of Paraguay, Engineers, People from Asunción
Luis Ángel González Macchi	1947 births, Living people, People from Asunción, Presidents of Paraguay, Lawyers
Nicanor Duarte	1956 births, Living people, Lawyers, Presidents of Paraguay
Fernando Lugo	1951 births, Living people, Bishops, Roman Catholics, Presidents of Paraguay, People with cancer
Federico Franco	1962 births, Living people, Vice presidents, Surgeons, People from Asunción, Presidents of Paraguay
President of Uruguay	Presidents of Uruguay
Luis Alberto Lacalle	1941 births, Living people, People from Montevideo, Presidents of Uruguay, Knights Grand Cross of the Order of St Michael and St George
Aquatic locomotion	Anthropology
Independent Art Festival	1988 establishments in Asia, 1980s establishments in South Korea, 2002 disestablishments, 2000s disestablishments in Asia, Disestablishments in South Korea
Church of North India	Protestant denominations, Religion in India
Habib Bourguiba	1903 births, 2000 deaths, Presidents of Tunisia, Prime Ministers of Tunisia, Speakers of the Assembly of the Representatives of the People, Dictators, Honorary Knights Grand Cross of the Order of the Bath
Bad Education	2004 drama movies, Spanish movies, NC-17 rated movies, Movies directed by Pedro Almodóvar, Movies about pedophilia, Movies about child sexual abuse
Toronto International Film Festival	Movie festivals
Fred Hubbell	US Democratic Party politicians, Politicians from Des Moines, Iowa, Businesspeople from Iowa, 1951 births, Living people
Late-May 1998 tornado outbreak and derecho	1998 in the United States, Tornadoes in the United States, Derechos, Severe weather, 1998 in Canada, May events
Carmen Campagne	1959 births, 2018 deaths, Deaths from pancreatic cancer, Cancer deaths in Canada, Canadian singers, People from Saskatchewan
Ernst W. Hamburger	1933 births, 2018 deaths, Deaths from lymphoma, Cancer deaths in Brazil, Brazilian scientists, German physicists, Scientists from Berlin
Adamu Ciroma	1934 births, 2018 deaths, Bankers, Nigerian politicians
Neil McDermott	1980 births, English stage actors, English television actors, People from Merseyside, Living people
Charles B. Reed	1941 births, 2016 deaths, American educators, People from Harrisburg, Pennsylvania
New Glarus, Wisconsin	1840s establishments in Wisconsin Territory, 1845 establishments in the United States, Villages in Wisconsin, Green County, Wisconsin
Farrah Abraham	1991 births, Living people, American television personalities, American pornographic actors, American autobiographers, Writers from Omaha, Nebraska, Writers from Iowa, Writers from Austin, Texas, Actors from Omaha, Nebraska, Actors from Iowa, Actors from Austin, Texas
Caitlin McHugh	1984 births, Living people, American movie actors, American television actors, Models from California, Actors from California, Writers from California
Rudolf Kirchschläger	1915 births, 2000 deaths, Presidents of Austria, Ambassadors of Austria, Judges, Austrian Roman Catholics, People from Upper Austria, Politicians from Vienna
Bulle	Municipalities of Fribourg, Cities in Switzerland
Mehrsa Baradaran	1978 births, Living people, Iranian writers, American lawyers, American educators, Naturalized citizens of the United States, Writers from Georgia (U.S. state)
Novato, California	1960 establishments in California, Settlements in Marin County, California, Cities in California, Cities in the San Francisco Bay Area
Mill Valley, California	1900s establishments in California, 1900 establishments in the United States, Cities in California, Settlements in Marin County, California, Cities in the San Francisco Bay Area
EA Canada	1983 establishments in Canada, Technology companies of Canada, Video game companies, British Columbia
Shoko Asahara	1955 births, 2018 deaths, Japanese people, Murderers, Terrorists, People executed by hanging, Executed people
Tokyo subway sarin attack	1990s in Japan, 20th century in Tokyo, March events, Mass murder in Asia, Murder in 1995, Terrorist incidents in Asia, Terrorist incidents in the 1990s
List of political parties in Pakistan	Political parties in Pakistan, Lists of political parties
Jean-Louis Tauran	1943 births, 2018 deaths, Deaths from Parkinson's disease, Disease-related deaths in Connecticut, Cardinals of the Roman Catholic Church, French Roman Catholics
Signal recognition particle	Cell biology
General Secretary Xi Jinping important speech series	Chinese culture, Non-fiction books, Xi Jinping
Counterintelligence	Security, Espionage
Minicomputer	Computers
Office of Strategic Services	Espionage
Karl Schlechta	1922 births, 2016 deaths, Austrian footballers, Austrian football managers
Hilmar Thate	1931 births, 2016 deaths, German movie actors, German television actors, People from Saxony-Anhalt
Julius Malema	1981 births, Living people, South African politicians
Gunnar Sandgren	1929 births, 2016 deaths, Swedish playwrights, Swedish novelists
Larkspur, California	1887 establishments in California, Cities in the San Francisco Bay Area, Settlements in Marin County, California, Cities in California
Belvedere, California	1890s establishments in California, 1896 establishments in the United States, Cities in California, Settlements in Marin County, California, Cities in the San Francisco Bay Area
Sausalito, California	1890s establishments in California, 1893 establishments in the United States, Cities in California, Settlements in Marin County, California, Cities in the San Francisco Bay Area
Corte Madera, California	1878 establishments in California, Settlements in Marin County, California, Cities in California, Cities in the San Francisco Bay Area
Fairfax, California	1930s establishments in California, 1931 establishments in the United States, Cities in California, Settlements in Marin County, California, Cities in the San Francisco Bay Area
San Anselmo, California	1900s establishments in California, 1907 establishments in the United States, Cities in California, Settlements in Marin County, California, Cities in the San Francisco Bay Area
Strawberry, California	Census-designated places in California, Settlements in Marin County, California
François Budet	1940 births, 2018 deaths, Deaths from stroke, French singers, French songwriters, French novelists, French poets
Amos Cardarelli	1930 births, 2018 deaths, Italian footballers
El Dorado, Kansas	Cities in Butler County, Kansas, County seats in Kansas
Gas turbine locomotive	Locomotives
Newton-le-Willows	Towns in Merseyside
Vulcan Foundry	Rail vehicles manufacturers, Companies of the United Kingdom, Engineering companies of the United Kingdom, Locomotive manufacturers
Reynolds Building	Winston-Salem, North Carolina, Art Deco buildings
KY Cygni	Red giants, Variable stars
Len Carlson	1937 births, 2017 deaths, Canadian voice actors, Actors from Toronto, People from Edmonton
Sanchi	World Heritage Sites in India
Roundabout	Roads
China Railway	Rail transport in China
List of FIFA World Cup finals	FIFA World Cup
Bengali script	Languages of Bangladesh
Alcubierre drive	Spacecraft, Propulsion
Ali Qanso	1948 births, 2018 deaths, Deaths from cancer, Lebanese politicians
Last Week Tonight with John Oliver	2014 American television series debuts, American comedy television series, HBO television series, American television talk shows, English-language television programs
Vlatko Ilievski	1985 births, 2018 deaths, Eurovision Song Contest entrants, Movie actors, Pop singers, Rock singers, People from Skopje
William Dunlop (motorcyclist)	1985 births, 2018 deaths, Deaths in sport, Irish sportspeople, People from Dublin
Tyler Honeycutt	1990 births, 2018 deaths, Suicides by firearm in the United States, Sacramento Kings players, Sportspeople from Los Angeles, California, Sportspeople who committed suicide
Rigoberta Menchú	1959 births, Living people, Guatemalan people, Human rights activists, Political activists, Feminists
Jim Morrison (ice hockey)	1931 births, Living people, Naturalized citizens of the United States, Canadian ice hockey defencemen, Canadian ice hockey coaches, Boston Bruins players, Toronto Maple Leafs players, Detroit Red Wings players, New York Rangers players, Pittsburgh Penguins players, American Hockey League players, Memorial Cup winners
Hacène Lalmas	1943 births, 2018 deaths, Deaths from aortic dissection, Algerian footballers, People from Algiers
Levko Lukyanenko	1928 births, 2018 deaths, Deaths from pneumonia, Ukrainian politicians, European diplomats
Henry Louis Gates Jr.	1950 births, Living people, African American writers, American literary critics, American educators, American historians, American agnostics, American movie directors, American television directors, American television producers, Writers from West Virginia
Keyser, West Virginia	Cities in West Virginia, County seats in West Virginia
Cottageville, South Carolina	Towns in South Carolina
2018–19 Russian Premier League	2018 in sports, 2018 in association football, Russian Premier League
FC Yenisey Krasnoyarsk	Russian football clubs, 1937 establishments
Pumpuang Duangjan	Thai singers, Thai actors, 1961 births, 1992 deaths, Buddhists
UEFA Euro 2024	UEFA Euro 2024, UEFA European Championship tournaments, 2023–24 in UEFA football, 2023–24 in German football, International association football competitions hosted by Germany, June 2024 sports events, July 2024 sports events, Scheduled association football competitions
2015 Canadian federal election	2015 in Canada, 2015 elections, October 2015 events, Elections in Canada
Thomas Mulcair	1954 births, Living people, Politicians from Ontario, People from Ottawa, Privy Councillors (Canada), Leaders of the Opposition (Canada), Members of the House of Commons of Canada from Quebec
2026 FIFA World Cup	2020s in sports, FIFA World Cup, Soccer in the United States, Football in Mexico, Soccer in Canada
Gilles Duceppe	1947 births, Living people, Politicians from Montreal, Leaders of the Opposition (Canada), Members of the House of Commons of Canada from Quebec
Elizabeth May	1954 births, Living people, Canadian activists, Politicians from British Columbia, Members of the House of Commons of Canada from British Columbia, Politicians from Hartford, Connecticut
2019 Canadian federal election	2019 in Canada, Elections in Canada, 2019 elections, October 2019 events
Andrew Scheer	1979 births, Living people, Politicians from Ontario, People from Ottawa, Privy Councillors (Canada), Leaders of the Opposition (Canada), Members of the House of Commons of Canada
Mario Beaulieu	1959 births, Living people, Politicians from Montreal, Members of the House of Commons of Canada from Quebec
Rhéal Fortin	Living people, Politicians from Quebec, Members of the House of Commons of Canada from Quebec
Wahbi Khazri	1991 births, Tunisian footballers, Living people
Québec debout	Political parties in Canada
2016 Austrian presidential election	2016 in Europe, Politics of Austria
Norbert Hofer	1971 births, Living people, Austrian politicians
Russian Women's Football Championship	1992 establishments in Russia, Sport in Russia
2016 Spanish general election	2010s in Spain, 2016 in Europe, 2016 elections
Pablo Iglesias Turrión	1978 births, Living people, Spanish politicians, People from Madrid
Albert Rivera	1979 births, Living people, Politicians from Barcelona
Gabriel Rufián	1982 births, Living people, Politicians from Barcelona
Francesc Homs Molist	Living people, 1969 births, Politicians from Barcelona
Tham Luang cave rescue	July 2018 events, Thailand
Smart casual	Clothing
2018 Russian Championship (women's football)	Football competitions
Zvezda-2005 Perm	2005 establishments, 2000s establishments in Russia
Nadezhda Smirnova	1996 births, Living people
Crewe Works	Rail transport in Great Britain, British Rail
Plane wave	Wave physics
EPROM	Computer memory
Charles Augustin White	1992 births, American composers, American educators, American pianists, American guitarists, American songwriters, American DJs, Russian composers, Russian pianists, Living people
Sainte-Croix-en-Plaine	Communes in Haut-Rhin
Coalville, Utah	Cities in Utah, County seats in Utah
Friendswood, Texas	Cities in Texas
Dickinson, Texas	Cities in Texas
Time in Vietnam	Time by country, Vietnam
Oroville, California	1900s establishments in California, 1906 establishments in the United States, Cities in California, County seats in California, Settlements in Butte County, California
Leavenworth, Washington	Cities in Washington (U.S. state)
Davis, West Virginia	Towns in West Virginia
Oroville, Washington	Cities in Washington (U.S. state)
La Marque, Texas	Cities in Texas
Bozeman, Montana	Cities in Montana, County seats in Montana
Butte, Montana	Cities in Montana, County seats in Montana
Kalispell, Montana	Cities in Montana, County seats in Montana
Plungė	Cities in Lithuania
Jonah Falcon	1970 births, Bisexual people, LGBT actors, LGBT writers, LGBT people from New York, Actors from Brooklyn, Writers from Brooklyn, American television presenters, Living people
Doncaster Works	Rail transport in Great Britain, British Rail
BR Standard Class 9F	British Rail, British Railways steam locomotives
Italian Mogadiscio	Somalia, History of Italy
BR Standard Class 7	British Rail, British Railways steam locomotives
November 2008 Carolinas tornado outbreak	Tornadoes in the United States, Tornado outbreaks, 2008 in the United States
I-94 derecho	Natural disasters in the United States, 1983 in the United States, July events, 20th century in Minnesota, 20th century in Wisconsin, 1980s in Illinois, 20th century in North Dakota
Carol Bellamy	1942 births, Living people, American lawyers, American philanthropists, Humanitarians, Politicians from New York City, Businesspeople from New York City, US Democratic Party politicians
Havre, Montana	Cities in Montana, County seats in Montana, 1893 establishments in Montana
Anaconda, Montana	Cities in Montana, County seats in Montana
Miles City, Montana	Cities in Montana, County seats in Montana
Eleanor Holmes Norton	1937 births, Living people, United States representatives, Politicians from Washington, D.C., US Democratic Party politicians
Antonio Toledo Corro	1919 births, 2018 deaths, Deaths from cerebral infarction, Deaths from pneumonia, Mayors, Mexican politicians
Drake University	Colleges and universities in Iowa, Des Moines, Iowa, 1881 establishments in the United States, 19th-century establishments in Iowa
Thomas Hardiman	1965 births, Living people, American lawyers, American judges, Politicians from Massachusetts, Politicians from Pittsburgh, Pennsylvania, US Republican Party politicians
Winchester, Massachusetts	Towns in Massachusetts
Amritlal Vegad	1928 births, 2018 deaths, Indian writers, Poets, Deaths from respiratory failure, Disease-related deaths in India
Alan Gilzean	1938 births, 2018 deaths, Deaths from brain cancer, Scottish footballers, Scottish football managers
M. M. Jacob	1927 births, 2018 deaths, Deaths from cardiopulmonary arrest, Governors of Arunachal Pradesh, Governors of Meghalaya
Frank Ramsey (basketball)	1931 births, 2018 deaths, Deaths from cardiac arrest, Deaths from surgical complications, Deaths from aneurysm, Boston Celtics players, Sportspeople from Kentucky, National Basketball Association players with retired numbers
Logan Paul	1995 births, Living people, American movie actors, American television actors, American voice actors, American rap musicians from Ohio, American boxers, American Internet celebrities, Actors from Ohio, Writers from Ohio, Musicians from Ohio, Sportspeople from Ohio, Actors from Los Angeles, California, Musicians from Los Angeles, California, Screenwriters from Los Angeles, California, Sportspeople from Los Angeles, California
Westlake, Ohio	Cities in Ohio
Taste of Chicago	Festivals in Chicago, July events
Gloria al Bravo Pueblo	National anthems, Spanish-language songs, Venezuela
Alpha Cephei	Northern pole stars
Yellow hypergiant	Hypergiants, Types of stars
Gnat	Flies
Rosie and Jim	English-language television programs, 1990 television series debuts, 2000 television series endings
Tugboat	Boats
CLS Group	Finance, Banks of the United States
Clearing House Association	Banks of the United States, Organizations in New York City, 1853 establishments in the United States
Rag doll	Dolls
Miles City, Florida	Unincorporated communities in Florida
Gianfranco Petris	1936 births, 2018 deaths, Italian footballers, Sportspeople from Friuli Venezia-Giulia
Firuz Mustafayev	Prime Ministers of Azerbaijan, 2018 deaths, 1933 births
Tab Hunter	1931 births, 2018 deaths, Deaths from thrombosis, Deaths from cardiac arrest, Cardiovascular disease deaths in California, American movie actors, American television actors, American stage actors, American voice actors, American pop singers, American musical theatre actors, American autobiographers, LGBT writers, LGBT singers, LGBT actors, Gay men, Actors from New York City, Writers from New York City, Singers from New York City, LGBT people from New York City, Movie producers from New York City
Oliver Knussen	1952 births, 2018 deaths, Composers, People from Glasgow
Hans Günter Winkler	1926 births, 2018 deaths, Deaths from cardiac arrest, German Olympic gold medalists, Equestrians, Sportspeople from North Rhine-Westphalia, Medalists at the 1956 Summer Olympics, Medalists at the 1960 Summer Olympics, Medalists at the 1964 Summer Olympics, Medalists at the 1968 Summer Olympics, Medalists at the 1972 Summer Olympics, Medalists at the 1976 Summer Olympics, Order of Merit of the Federal Republic of Germany
Ed Westwick	1987 births, Living people, Actors from Hertfordshire, Actors from London, English movie actors, English rock musicians, English rock singers, English television actors, English stage actors, English voice actors, Musicians from London, People from Stevenage, Singers from London, Writers from London
Raymond Kethledge	1965 births, Living people, American judges, American lawyers, People from Michigan, People from New Jersey
Willa Holland	1991 births, Living people, American movie actors, American television actors, American voice actors, American video game actors, American child actors, Actors from Los Angeles, California
Baar, Swabia	Aichach-Friedberg
Lena Headey	1973 births, Living people, English movie actors, English television actors, English voice actors, English stage actors, Actors from Yorkshire
Ian McElhinney	1948 births, Living people, Northern Ireland people, Movie actors, Television actors, Radio actors, Movie directors, People from Belfast
Liam Cunningham	1961 births, Irish movie actors, Irish television actors, Irish stage actors, Actors from Dublin, Living people
Linth	Rivers of Switzerland, Canton of Glarus, Canton of St. Gallen, Canton of Schwyz
Financial Stability Board	Finance
Bruce Hunter (swimmer)	1939 births, 2018 deaths, American swimmers, American Olympians, Sportspeople from Boston, Massachusetts
Erica Yohn	1928 births, 2019 deaths, American movie actors, American television actors, American voice actors, Actors from the Bronx
2017 New Zealand general election	2010s in New Zealand, September 2017 events, 2017 elections, Elections in New Zealand
Winston Peters	1945 births, Living people, Deputy Prime Ministers of New Zealand
James Shaw	1973 births, Living people, New Zealand politicians, Environmentalists, People from Wellington
David Seymour	1983 births, Living people, New Zealand politicians, Political commentators
Marama Fox	Living people, New Zealand politicians
2020 New Zealand general election	2020 elections, 21st century in Oceania, Elections in New Zealand, October 2020 events
Simon Bridges	1976 births, Living people, Leaders of the Opposition (New Zealand)
1994 Palm Sunday tornado outbreak	Tornadoes in the United States
Rab Butler	1902 births, 1982 deaths, Alumni of the University of Cambridge, British people of World War II, Chancellors of the Exchequer, Deaths from colorectal cancer, Deputy Prime Ministers of the United Kingdom, Former Conservative MPs (UK), Former members of the British House of Commons for English constituencies, Knights of the Garter, Members of the House of Lords, Privy Councillors (UK), Secretaries of State for the Home Department, Secretaries of State of the United Kingdom, UK MPs 1929–1931, UK MPs 1931–1935, UK MPs 1935–1945, UK MPs 1945–1950, UK MPs 1950–1951, UK MPs 1951–1955, UK MPs 1955–1959, UK MPs 1959–1964, UK MPs 1964–1966, University of Cambridge
2016 Australian federal election	July 2016 events, 2010s in Australia, 2016 elections
Richard Di Natale	1970 births, Living people, Politicians from Melbourne, Australian Greens politicians
Nick Xenophon	1959 births, Living people, Politicians from South Australia, People from Adelaide, Members of the Australian Senate
2019 Australian federal election	2019 elections, 2010s in Australia, May 2019 events
Abiy Ahmed	1976 births, Living people, Prime Ministers of Ethiopia, Current national leaders
Time in Estonia	Time by country, Estonia
President of Ethiopia	Presidents of Ethiopia
Rahim Huseynov	1936 births, Living people, Prime Ministers of Azerbaijan
List of cities and towns in Russia by population	Russia-related lists, Cities in Russia
Dan Burton	1938 births, Living people, United States representatives from Indiana, Politicians from Indianapolis, Indiana, US Republican Party politicians
BR standard class 5	British Rail, British Railways steam locomotives
Quantitative analysis (chemistry)	Analytical chemistry
Colorimetric analysis	Analytical chemistry
Optical filter	Physics, Optics, Color
Romford–Upminster line	London Overground, Rail transport in London
Secretary General of NATO	Secretaries General of NATO
Hastings Ismay, 1st Baron Ismay	1887 births, 1965 deaths, Secretaries General of NATO, British Barons, British military personnel of World War II, British generals, British politicians, Knights Grand Cross of the Order of the Bath, Knights of the Garter, Privy Councillors (UK), Knights of Justice of the Order of St John
Paul-Henri Spaak	1899 births, 1972 deaths, Belgian mayors, Belgian social democrats, Former MEPs, Government ministers of Belgium, MEPs for Belgium, People from Brussels-Capital Region, Presidents of the European Parliament, Presidents of the United Nations General Assembly, Prime Ministers of Belgium, Secretaries General of NATO
Dirk Stikker	1897 births, 1979 deaths, Ambassadors of the Netherlands, Dutch businesspeople, Government ministers of the Netherlands, People's Party for Freedom and Democracy politicians, Politicians from Groningen (province), Secretaries General of NATO
Manlio Brosio	1897 births, 1980 deaths, Italian lawyers, Italian politicians, Ambassadors, Secretaries General of NATO, People from Turin
Joseph Luns	1911 births, 2002 deaths, Dutch diplomats, Dutch Roman Catholics, Former members of the House of Representatives of the Netherlands, Government ministers of the Netherlands, Politicians from Rotterdam, Secretaries General of NATO
Manfred Wörner	1934 births, 1994 deaths, People from Stuttgart, Secretaries General of NATO, German politicians, Deaths from colorectal cancer
Willy Claes	1938 births, Living people, Belgian musicians, Conductors, Flemish politicians, Government ministers of Belgium, People from Limburg (Belgium), Secretaries General of NATO, Socialistische Partij (Belgium) politicians
George Robertson, Baron Robertson of Port Ellen	1946 births, Living people, Scottish politicians, Secretaries General of NATO
Alessandro Minuto-Rizzo	1940 births, Italian politicians, Secretaries General of NATO, Living people, Ambassadors
Jaap de Hoop Scheffer	1948 births, Living people, Christian Democratic Appeal politicians, Dutch diplomats, Dutch Roman Catholics, Former leaders of political parties in the Netherlands, Former members of the House of Representatives of the Netherlands, Government ministers of the Netherlands, Politicians from Amsterdam, Secretaries General of NATO
Gospel Oak to Barking line	London Overground, Rail transport in London
Anders Fogh Rasmussen	1953 births, Living people, Prime Ministers of Denmark, Secretaries General of NATO
Prime Minister of Denmark	Prime Ministers of Denmark
Poul Nyrup Rasmussen	1943 births, Living people, Prime Ministers of Denmark, European Union politicians
North London line	London Overground, Rail transport in London
Jan Henry T. Olsen	1956 births, 2018 deaths, Deaths from Alzheimer's disease, Norwegian politicians
José María Setién	1928 births, 2018 deaths, Spanish Roman Catholics, Bishops, Deaths from stroke
Dervish movement (Somali)	Darawiish, Somalia, 1899 establishments, 19th-century establishments in Africa, 1921 disestablishments, 20th-century disestablishments in Africa
West London line	London Overground, Rail transport in London
May 1989 tornado outbreak	1989 in the United States, Tornado outbreaks, Tornadoes in the United States
Watford DC line	London Overground, Rail transport in London, Watford
East London line	London Overground, Rail transport in London, 1869 establishments in the United Kingdom, 1860s establishments in England, 2007 disestablishments in the United Kingdom, 2000s disestablishments in England, 2010 establishments in England
South London line	London Overground, Rail transport in London
Giuseppe Franco Grillo	1842 births, 1903 deaths, Naturalists, Italian scientists
John Laird, Baron Laird	1944 births, 2018 deaths, Northern Ireland people, British politicians
President of the European Commission	European Commissioners
José Manuel Barroso	1956 births, Living people, Prime Ministers of Portugal, European Commissioners
Gaston Thorn	1928 births, 2007 deaths, Prime Ministers of Luxembourg, European Commissioners, Presidents of the United Nations General Assembly
Jean Rey (politician)	1902 births, 1983 deaths, Belgian liberals, European Commissioners, Freemasons, Government ministers of Belgium, People from Liège, Protestants
Franco Maria Malfatti	1927 births, 1991 deaths, European Commissioners, Italian politicians, People from Rome
Sicco Mansholt	1908 births, 1995 deaths, Dutch mayors, Dutch people of World War II, European Commissioners, Former members of the House of Representatives of the Netherlands, Government ministers of the Netherlands, Labour Party (Netherlands) politicians, Politicians from Groningen (province)
François-Xavier Ortoli	1925 births, 2007 deaths, European Commissioners, French Ministers of Finance
Roy Jenkins	1920 births, 2003 deaths, Abortion-rights activists, Alumni of the University of Oxford, Biographers, British Army officers, British autobiographers, British military personnel of World War II, Chancellors of the Exchequer, European Commissioners, Former Labour MPs (UK), Former members of the British House of Commons for English constituencies, Former members of the British House of Commons for Scottish constituencies, Leaders of the Social Democratic Party (UK), Members of the House of Lords, Order of Merit, Privy Councillors (UK), Secretaries of State for the Home Department, Social Democratic Party MPs (UK), UK MPs 1945–1950, UK MPs 1950–1951, UK MPs 1951–1955, UK MPs 1955–1959, UK MPs 1959–1964, UK MPs 1964–1966, UK MPs 1966–1970, UK MPs 1970–1974, UK MPs 1974, UK MPs 1974–1979, UK MPs 1979–1983, UK MPs 1983–1987, United Kingdom Life Peers, Welsh politicians, Welsh writers
Piet Dankert	1934 births, 2003 deaths, Deputy government ministers of the Netherlands, Former members of the House of Representatives of the Netherlands, Former MEPs, Labour Party (Netherlands) politicians, MEPs for the Netherlands, Politicians from Friesland, Presidents of the European Parliament
Pierre Pflimlin	1907 births, 2000 deaths, Presidents of the European Parliament, Prime Ministers of France, French Ministers of Finance
Enrique Barón Crespo	1944 births, Living people, Presidents of the European Parliament, Spanish politicians, People from Madrid
Egon Klepsch	1930 births, 2010 deaths, German politicians, Presidents of the European Parliament
Pat Cox	1952 births, Living people, Irish politicians, Irish television personalities, Presidents of the European Parliament
Josep Borrell	1947 births, Living people, Presidents of the European Parliament, Spanish politicians
Hans-Gert Pöttering	1945 births, Living people, Presidents of the European Parliament, German politicians
Prime Minister of Luxembourg	Prime Ministers of Luxembourg
Prime Minister of Croatia	Prime Ministers of Croatia
Ema Derossi-Bjelajac	1926 births, 2020 deaths, Presidents of Croatia
Stjepan Mesić	1934 births, Living people, Prime Ministers of Croatia, Presidents of Croatia, Presidents of Yugoslavia
Andrej Plenković	1970 births, Living people, Prime Ministers of Croatia, Current national leaders, European Union politicians
Kolinda Grabar-Kitarović	1968 births, Living people, Presidents of Croatia
President of Croatia	Presidents of Croatia
Franjo Tuđman	1922 births, 1999 deaths, Deaths from prostate cancer, Presidents of Croatia
Tom Osmond	1947 births, Living people, American activists, People from Ogden, Utah, Musicians from Utah
Lea Valley lines	London Overground, Rail transport in London
Save the children	1919 establishments, International organizations
Latrine	Waste
Liu Zhenhua	1921 births, 2018 deaths, Ambassadors of China, Chinese politicians, Chinese generals
James Dyson	1947 births, Living people, British engineers, British inventors, British businesspeople, People from Norfolk
Surrey Quays railway station	London Overground stations, 2007 disestablishments in the United Kingdom, 2000s disestablishments in England, 2010 establishments in England
Canada Water station	London Overground stations, London Underground stations
Oberblegisee	Lakes of Switzerland, Canton of Glarus
Towcester	Civil parishes in England, Towns in Northamptonshire
Sant'Antonino, Haute-Corse	Communes in Haute-Corse
Confederation of Government Employees Association Delhi (CGEAD)	Delhi, Unions, 1990s establishments in India
Sainte-Marie-aux-Mines	Communes in Haut-Rhin
Everipedia	Entertainment websites, Wikis
Kulsoom Nawaz	First Ladies, Pakistani politicians, 1950 births, 2018 deaths, Deaths from lymphoma, Cancer deaths in London
Terry Todd	1937 births, 2018 deaths, American historians, American journalists, American Olympians, Weightlifters, Writers from Austin, Texas, Sportspeople from Austin, Texas
Scorpio (astrology)	Astrological signs
Billy Knight (basketball, born 1979)	1979 births, 2018 deaths, African-American basketball players, Sportspeople from Los Angeles, California, American basketball players
Billy Knight	1952 births, Living people, Indiana Pacers players, Los Angeles Clippers players, Boston Celtics players, San Antonio Spurs players, Sacramento Kings players, Sportspeople from Pennsylvania
Darryl Rogers	1935 births, 2018 deaths, American football coaches, American football defensive ends, American football wide receivers, Detroit Lions, Sportspeople from Los Angeles, California, People from Fresno, California
Braddock, Pennsylvania	Boroughs in Pennsylvania
John Fetterman	1969 births, Living people, American mayors, Harvard University alumni, Lieutenant Governors of Pennsylvania, US Democratic Party politicians
Shridath Ramphal	1928 births, Living people, Diplomats, Guyanese politicians, Commonwealth Secretaries-General
Emeka Anyaoku	1933 births, Living people, Nigerian politicians, Commonwealth Secretaries-General
Commonwealth Secretary-General	Commonwealth Secretaries-General
Arnold Smith	1915 births, 1994 deaths, Canadian politicians, Canadian diplomats, Commonwealth Secretaries-General
Don McKinnon	1939 births, Living people, Deputy Prime Ministers of New Zealand, Commonwealth Secretaries-General
Kamalesh Sharma	1941 births, Living people, Indian politicians, Commonwealth Secretaries-General
Patricia Scotland	1955 births, Living people, Dominica people, English politicians, Commonwealth Secretaries-General
Commonwealth Chair-in-Office	Commonwealth Chairpersons-in-Office
Olusegun Obasanjo	1937 births, Living people, Presidents of Nigeria, Generals, African Union chairpersons, Commonwealth Chairpersons-in-Office
Lawrence Gonzi	1953 births, Living people, Lawyers, Prime Ministers of Malta, Commonwealth Chairpersons-in-Office
Maithripala Sirisena	1951 births, Living people, Presidents of Sri Lanka, Commonwealth Chairpersons-in-Office
Joseph Muscat	1974 births, Living people, Former MEPs, Prime Ministers of Malta, Commonwealth Chairpersons-in-Office
Karmenu Mifsud Bonnici	1933 births, Living people, Prime Ministers of Malta
Eddie Fenech Adami	1934 births, Living people, Prime Ministers of Malta, Presidents of Malta
Alfred Sant	1948 births, Living people, Prime Ministers of Malta, European Union politicians
Prime Minister of Malta	Prime Ministers of Malta
President of Malta	Presidents of Malta
Marie-Louise Coleiro Preca	1958 births, Living people, Presidents of Malta
Ugo Mifsud Bonnici	1932 births, Living people, Presidents of Malta
George Abela	1948 births, Living people, Presidents of Malta
Qormi	Cities in Malta
Birgu	Cities in Malta
Cospicua	Cities in Malta
Three Cities	Geography of Malta
Grand Harbour	Geography of Malta, Ports and harbours of Europe
Mdina	Cities in Malta
Victoria, Gozo	Cities in Malta
Gozo	Islands of Malta
Malta (island)	Islands of Malta
Comino	Islands of Malta
Cominotto	Islands of Malta, Uninhabited islands
Filfla	Islands of Malta
St Paul's Island	Islands of Malta, Uninhabited islands
Manoel Island	Islands of Malta
Marsamxett Harbour	Geography of Malta, Ports and harbours of Europe
Ħalfa Rock	Islands of Malta
Fungus Rock	Islands of Malta
San Lawrenz	Towns in Malta
Senglea	Cities in Malta
Siġġiewi	Cities in Malta
Mellieħa	Towns in Malta
Żabbar	Cities in Malta
Żebbuġ	Cities in Malta
Żejtun	Cities in Malta
President of Uganda	Presidents of Uganda
Prime Minister of Uganda	Prime Ministers of Uganda
Ruhakana Rugunda	1947 births, Living people, Prime Ministers of Uganda
List of prime ministers of Trinidad and Tobago	Prime Ministers of Trinidad and Tobago
Keith Rowley	1949 births, Living people, Prime Ministers of Trinidad and Tobago, Current national leaders
George Chambers	Prime Ministers of Trinidad and Tobago, 1928 births, 1997 deaths
Paula-Mae Weekes	1958 births, Living people, Presidents of Trinidad and Tobago, Current national leaders
President of Sri Lanka	Presidents of Sri Lanka
Prime Minister of Sri Lanka	Prime Ministers of Sri Lanka
Jusuf Gazibegović	2000 births, Living people, Bosnia and Herzegovina footballers
Ranil Wickremesinghe	1949 births, Prime Ministers of Sri Lanka, Living people
Abbas Amir-Entezam	1932 births, 2018 deaths, Iranian politicians, Spies
Prime Minister of Ethiopia	Prime Ministers of Ethiopia
Chairperson of the African Union	African Union chairpersons
Mohamed Ould Abdel Aziz	1956 births, Living people, Generals, Presidents of Mauritania, Current national leaders, African Union chairpersons
Bingu wa Mutharika	1934 births, 2012 deaths, Deaths from cardiac arrest, African Union chairpersons, Presidents of Malawi
Peter Mutharika	1939 births, Living people, Presidents of Malawi
Bakili Muluzi	1943 births, Living people, Presidents of Malawi
President of Malawi	Presidents of Malawi
Joyce Banda	1950 births, Living people, Presidents of Malawi, Vice presidents, Educators, Activists, BBC 100 Women
John Magufuli	1959 births, 2021 deaths, Deaths from heart failure, Presidents of Tanzania
President of Tanzania	Presidents of Tanzania
Benjamin Mkapa	1938 births, 2020 deaths, Presidents of Tanzania
Jakaya Kikwete	1951 births, Living people, Presidents of Tanzania, African Union chairpersons
Prime Minister of Tanzania	Prime Ministers of Tanzania
Salim Ahmed Salim	1942 births, Living people, Prime Ministers of Tanzania
Cleopa Msuya	1931 births, Living people, Prime Ministers of Tanzania
Kassim Majaliwa	1961 births, Living people, Prime Ministers of Tanzania, Current national leaders
Rotherhithe	Areas of London
Samora Machel	1933 births, 1986 deaths, Aviation deaths, Communists, Presidents of Mozambique
Joaquim Chissano	1939 births, Living people, Presidents of Mozambique, African Union chairpersons, Prime Ministers of Mozambique
Armando Guebuza	1943 births, Living people, Presidents of Mozambique
List of presidents of Mozambique	Presidents of Mozambique
Filipe Nyusi	1959 births, Living people, Presidents of Mozambique, Current national leaders
St Michael's Mount	Geography of Cornwall, Islands of England
Barbara Underwood	1944 births, Living people, American lawyers, United States Solicitors General, Politicians from Indiana, Politicians from New York City, Harvard University alumni, US Democratic Party politicians, People from Evansville, Indiana
Theodore Olson	1940 births, Living people, United States Solicitors General, American lawyers, Politicians from Chicago, US Republican Party politicians
Barbara Olson	1955 births, 2001 deaths, Victims of the September 11 attacks, American conservatives, American lawyers, American political commentators, Writers from Houston, Texas
Rick Rescorla	1939 births, 2001 deaths, Victims of the September 11 attacks, American military personnel of the Vietnam War, American crime victims, Naturalized citizens of the United States, People murdered in New York, People from Cornwall
Sekou Koita	1999 births, Living people, Malian footballers‎
Semi-aquatic	Ecology
London Docklands	Areas of London
Isle of Dogs	Areas of London
Alain Fauré	1962 births, 2018 deaths, Socialist Party (France) politicians, French mayors, People from Occitanie
Julius Maada Bio	1964 births, Presidents of Sierra Leone, Roman Catholics, African military people, Current national leaders, Living people
Magnavox Odyssey	Video game consoles
Poplar, London	Areas of London
2018 Japan floods	2018 in Asia, 2010s in Japan, Floods in Asia, June 2018 events, July 2018 events
D-Generation X	WWE teams and stables
Somerset County, Maine	19th-century establishments in Maine, 1809 establishments in the United States, Maine counties
St. Landry Parish, Louisiana	1807 establishments in the Territory of Orleans, Louisiana parishes, Acadiana
Vojtěch Mynář	1944 births, 2018 deaths, Czech politicians, Former MEPs
Pat Swindall	1950 births, 2018 deaths, American lawyers, United States representatives from Georgia, American criminals, Businesspeople from Georgia (U.S. state), US Republican Party politicians
Ro Khanna	1976 births, Living people, United States representatives from California, American lawyers, American progressives, Politicians from Philadelphia, Pennsylvania, US Democratic Party politicians
Walnut Grove, California	Census-designated places in California, Settlements in Sacramento County, California
Xerardo Fernández Albor	1917 births, 2018 deaths, Spanish politicians, Centenarians
Dada Vaswani	1918 births, 2018 deaths, Deaths from fractured hip, Indian writers, Animal rights activists
Joe E. Kernan	1946 births, 2020 deaths, Deaths from Alzheimer's disease, Governors of Indiana, American military personnel of the Vietnam War, American mayors, Lieutenant Governors of Indiana, People from South Bend, Indiana, Businesspeople from Indiana, Politicians from Chicago, Businesspeople from Chicago, US Democratic Party politicians
Governor of Indiana	Governors of Indiana
Frank O'Bannon	1930 births, 2003 deaths, Deaths from stroke, Cardiovascular disease deaths in Chicago, Governors of Indiana, Politicians from Louisville, Kentucky, Politicians from Chicago, US Democratic Party politicians, Lieutenant Governors of Indiana
California State University, Fresno	California State University, Fresno, California
Mountbatten-Windsor	House of Windsor
Whirligig beetle	Adephaga
Michelle Fischbach	1965 births, Living people, United States representatives from Minnesota, Lieutenant Governors of Minnesota, US Republican Party politicians
NatWest	Banks of the United Kingdom
Test data	Computer science
Battle of Jutland	Battles of World War I
Clearing bank	Finance, Banks
Big Four (banking)	Banks
Royal Bank of Scotland Group	Banks of the United Kingdom
Significant other	Personal life
Le Locle	Cities in Switzerland, Municipalities of Neuchâtel, World Heritage Sites in Switzerland
Bermondsey	Areas of London
Deptford	Areas of London
Limehouse	Areas of London
Stepney	Areas of London, London Borough of Tower Hamlets
High-rise building	Buildings and structures
Mile End	Areas of London
West India Docks	London Borough of Tower Hamlets, Water transport
Blackwall, London	Areas of London
East India Docks	London Borough of Tower Hamlets, Water transport
Peseux, Switzerland	Municipalities of Neuchâtel
Valangin	Municipalities of Neuchâtel, Cities in Switzerland
Milvignes	Municipalities of Neuchâtel, 2013 establishments in Switzerland
Val-de-Ruz	Municipalities of Neuchâtel, 2013 establishments in Switzerland
Val-de-Travers	2009 establishments in Switzerland, Municipalities of Neuchâtel
Sophie Lowe	1990 births, Living people, English movie actors, English television actors, English singer-songwriters, Australian movie actors, Australian television actors, Australian singer-songwriters, Writers from Yorkshire, Actors from Yorkshire, People from Sheffield
Industrial waste	Waste, Water pollution
Greenwich station	London Travelcard zone 2, Docklands Light Railway stations
TfL Rail	Rail transport in London, Train operating companies
Crossrail	Rail transport in London
Great Eastern Main Line	Rail transport in the United Kingdom
Shenfield	Towns in Essex
London and Blackwall Railway	Rail transport in London, 1840 establishments in England, 1926 disestablishments, 1920s disestablishments in the United Kingdom, 1968 disestablishments, 1960s disestablishments in the United Kingdom
Minories	Areas of London
Beckton	Areas of London
Tower Gateway DLR station	Docklands Light Railway stations
Docklands Light Railway rolling stock	Docklands Light Railway
Stefan Demert	1939 births, 2018 deaths, Swedish singers, Swedish writers, Songwriters, Swedish musicians
Jonathan Bartley	1971 births, Leaders of political parties in the United Kingdom, Green political parties, English politicians, English activists, Columnists, English Christians, English writers, Theologians, Living people
Edvin Hodžić	1994 births, 2018 deaths, Austrian footballers
Kezia Dugdale	1981 births, Scottish Parliament Members, Lesbians, Scottish LGBT people, LGBT politicians, Bloggers, People from Aberdeen, Living people
Clive King	1924 births, 2018 deaths, English children's writers, English novelists, Writers from London
Richard Kuklinski	1935 births, 2006 deaths, Deaths from blood disease, Disease-related deaths in New Jersey, American serial killers, American people convicted of manslaughter, People from Jersey City, New Jersey
Hematology	Blood
West India Quay DLR station	Docklands Light Railway stations
Jules Rimet	1873 births, 1956 deaths, Presidents of FIFA
FIFA World Cup Trophy	FIFA, Sports trophies and awards
List of presidents of FIFA	Presidents of FIFA
Robert Guérin	1876 births, 1952 deaths, Presidents of FIFA
Daniel Burley Woolfall	Presidents of FIFA, English footballers, 1852 births, 1918 deaths
Cornelis August Wilhelm Hirschman	1877 births, 1951 deaths, Bankers, Dutch sportspeople, Presidents of FIFA
Rodolphe Seeldrayers	1876 births, 1955 deaths, Presidents of FIFA
Arthur Drewry	1891 births, 1961 deaths, British military personnel of World War I, British businesspeople, Presidents of FIFA
Stanley Rous	1895 births, 1986 deaths, Deaths from leukemia, Cancer deaths in London, Presidents of FIFA
John Roselli	1905 births, 1976 deaths, American crime victims, Murders by firearm in Florida, Chicago Outfit mobsters, Italian people
Russell Bufalino	1903 births, 1994 deaths, Deaths from myocardial infarction, People from Sicily, Mobsters, Criminals from Pennsylvania
Kingston, Pennsylvania	Boroughs in Pennsylvania
Prime Minister of Namibia	Prime Ministers of Namibia
River Dart	Rivers of England, Devon
Hage Geingob	1941 births, Living people, Prime Ministers of Namibia, Presidents of Namibia, Current national leaders
Theo-Ben Gurirab	1938 births, 2018 deaths, Prime Ministers of Namibia, Presidents of the United Nations General Assembly, Recipients of the Order of the Rising Sun
Nahas Angula	1943 births, Living people, Prime Ministers of Namibia
Saara Kuugongelwa	1967 births, Living people, Prime Ministers of Namibia, Current national leaders
President of Namibia	Presidents of Namibia
Hifikepunye Pohamba	1936 births, Living people, Presidents of Namibia
Pudding Mill Lane DLR station	Docklands Light Railway stations
John Mulaney	1982 births, Living people, American movie actors, American television actors, American voice actors, American television producers, American television writers, Actors from Chicago, Writers from Chicago
Chappaquiddick incident	1969 in the United States, Deaths by drowning, History of Massachusetts, July events, Kennedy family
Mary Jo Kopechne	1940 births, 1969 deaths, People from Wilkes-Barre, Pennsylvania, American Roman Catholics, American educators, Deaths by drowning
Peeping Tom (movie)	1960 movies, 1960s horror movies, 1960s thriller movies, British horror movies, British thriller movies, Movies directed by Michael Powell
Stephanie Beatriz	1981 births, Living people, Argentine movie actors, Argentine television actors, American movie actors, American television actors, American voice actors, Bisexual people, LGBT people from Los Angeles, California, Actors from Los Angeles, California, People from Buenos Aires, Naturalized citizens of the United States
Bow Church DLR station	Docklands Light Railway stations
Devons Road DLR station	Docklands Light Railway stations
Langdon Park DLR station	Docklands Light Railway stations
Parker Posey	1968 births, Actors from Baltimore, Maryland, Actors from Mississippi, Actors from Manhattan, American singers, American movie actors, American television actors, Living people
Scott Foley	1972 births, American movie actors, American television actors, Actors from Kansas, Kansas City, Kansas, Living people
Merry Madagascar	American movies, American television movies, Madagascar (franchise), Short movies, 2009 animated movies, Christmas movies
Software architecture	Computer science
TVARK	Websites, Archives, 1998 establishments in the United Kingdom
Yeh Rishta Kya Kehlata Hai	Indian television series
Kasautii Zindagii Kay	Indian television series
Green Party in Northern Ireland	Political parties in Northern Ireland
Traditional Unionist Voice	Political parties in Northern Ireland
Richard Leonard	1962 births, Scottish politicians, Politicians from Yorkshire, Scottish Parliament Members, Living people
Big Sean	1988 births, Living people, African American musicians, American rap musicians from California, American hip hop musicians, Musicians from California, American singer-songwriters, Writers from California, Singers from California, Musicians from Detroit, Michigan, Singers from Detroit, Michigan, Writers from Detroit, Michigan, People from Santa Monica, California
La Grande-Béroche	Municipalities of Neuchâtel, 2010s establishments in Switzerland, 2018 establishments in Europe
La Tène	Municipalities of Neuchâtel, 2009 establishments in Switzerland
Side to Side	2016 songs, Ariana Grande songs, Songs about sexuality
Charlie Puth	1991 births, Living people, American pop singers, American rock singers, American R&B singers, American record producers, American pianists, Singers from New Jersey, Musicians from New Jersey, Atlantic Records artists
Arlene Foster	1970 births, Northern Ireland politicians, Living people
Urvashi Dholakia	1979 births, Indian television actors, Child actors, Punjabi people, Gujarat, Living people
Shweta Tiwari	Indian television actors, Indian actors
Lewisham station	Docklands Light Railway stations
River Tavy	Rivers of England, Devon
Elverson Road DLR station	Docklands Light Railway stations
Deptford Bridge DLR station	Docklands Light Railway stations
Demographics of Russia	Demographics by country, Russia
People Before Profit Alliance	Political parties in Northern Ireland, Ireland
Royal Victoria DLR station	Docklands Light Railway stations
Henry Morgenthau III	1917 births, 2018 deaths, American centenarians, American television producers, American poets, American autobiographers, Writers from New York City
Custom House for ExCeL DLR station	Docklands Light Railway stations
Miley Cyrus and Her Dead Petz	2015 albums, Miley Cyrus albums, Pop albums, Rock albums
RW Cephei	Red giants, Hypergiants, Variable stars
KW Sagittarii	Red giants, Variable stars, Supergiants
Thornhill United F.C.	1877 establishments in England, 1905 disestablishments, 1900s disestablishments in the United Kingdom, 20th century disestablishments in England
Rotherham County F.C.	1905 establishments in England, 1925 disestablishments in Europe, 1920s disestablishments in England
J. Frederick Grassle	1939 births, 2018 deaths, American biologists, American educators, Oceanographers, Researchers, Scientists from Cleveland, Ohio, Scientists from New Jersey
BuzzFeed Unsolved	YouTube
Football Club Rankings for number of World Cup Winning Players	FIFA
Abdelkhader Houamel	1936 births, 2018 deaths, Painters, Algerian people
Mai Tai Sing	1923 births, 2018 deaths, Cardiovascular disease deaths in the United States, American movie actors, American television actors, American stage actors, American dancers, Actors from Oakland, California, Businesspeople from California
Roger Perry	1933 births, 2018 deaths, Deaths from prostate cancer, Cancer deaths in California, American movie actors, American television actors, Actors from Iowa, People from Davenport, Iowa
Robert Wolders	1936 births, 2018 deaths, Dutch television actors, Dutch movie actors, European philanthropists, People from Rotterdam
Ray Frenette	1935 births, 2018 deaths, Premiers of New Brunswick
President of Slovakia	Presidents of Slovakia
Michal Kováč	1929 births, 2016 deaths, Presidents of Slovakia
Rudolf Schuster	1934 births, Living people, Presidents of Slovakia, Mayors
Ivan Gašparovič	1941 births, Living people, Presidents of Slovakia
Peter Pellegrini	1975 births, Living people, Prime Ministers of Slovakia
Prime Minister of Slovakia	Prime Ministers of Slovakia
Vladimír Mečiar	1942 births, Living people, Prime Ministers of Slovakia
Frank Giroud	1956 births, 2018 deaths, French writers, People from Toulouse
Claudio Pieri	1940 births, 2018 deaths, Italian sportspeople
Claude Seignolle	1917 births, 2018 deaths, French centenarians, French novelists
Gordon Chong	1943 births, 2018 deaths, Cardiovascular disease deaths in Canada, Politicians from Toronto
Petr Weigl	1939 births, 2018 deaths, Czech movie directors, Playwrights, Television directors, Czech writers
Icosikaitetragon	Polygons
David Goldblatt	1930 births, 2018 deaths, Deaths from skin cancer, Photographers, Activists, People from Johannesburg
Ignatios Lappas	1946 births, 2018 deaths, Deaths from heart failure, Bishops, Greek people
Phil Rodgers	1938 births, 2018 deaths, Deaths from leukemia, Cancer deaths in California, American golfers, Sportspeople from San Diego, California
Bob Charles (golfer)	1936 births, Living people, New Zealand sportspeople, Golfers
Mario Casalinuovo	1922 births, 2018 deaths, Deaths from Parkinson's disease, Disease-related deaths in Italy, Italian politicians
Liliana Ross	1939 births, 2018 deaths, Deaths from Alzheimer's disease, Italian movie actors, Italian television actors, Italian stage actors, Italian writers, Chilean movie actors, Chilean television actors, Chilean stage actors, Chilean writers, Playwrights, People from Genoa
John Coates (general)	1932 births, 2018 deaths, Generals, Australian military people, People from Adelaide
Bertha Sanseverino	1946 births, 2018 deaths, Deaths from myocardial infarction, Uruguayan politicians, People from Montevideo
Sally Pierone	1921 births, 2018 deaths, Deaths from renal failure, Disease-related deaths in California, American artists, American psychiatrists, People from Spokane, Washington
Darryl N. Johnson	1938 births, 2018 deaths, Ambassadors of the United States, American educators, Politicians from Chicago, Politicians from Seattle, Washington
Harald von Boehmer	1942 births, 2018 deaths, German scientists, Swiss scientists
Christine Nöstlinger	1936 births, 2018 deaths, Writers from Vienna
Masa Saito	1942 births, 2018 deaths, Deaths from Parkinson's disease, Disease-related deaths in Japan, Japanese professional wrestlers, Sportspeople from Tokyo
Antonio Inoki	1943 births, Living people, Japanese professional wrestlers, Politicians from Kanagawa Prefecture
It Chapter Two	2019 movies, 2010s drama thriller movies, 2010s horror thriller movies, 2010s supernatural movies, American drama thriller movies, American horror thriller movies, American supernatural movies, English-language movies, Movies based on books, Movies set in Maine, Warner Bros. movies
Red Robin	American restaurants
River Taw	Rivers of England, Devon
Bristol Channel	Devon, Somerset, Geography of England, Geography of Wales, Seas of the Atlantic Ocean
Droughts in the United States	Droughts, Severe weather
River Torridge	Devon, Rivers of England
Prince Regent DLR station	Docklands Light Railway stations
List of Texas hurricanes (1900-49)	Hurricanes in the United States, History of Texas
Matagorda, Texas	Census-designated places in Texas
Royal Albert DLR station	Docklands Light Railway stations
Cyprus DLR station	Docklands Light Railway stations
1932 Freeport hurricane	Hurricanes in the United States, 20th century in Texas, 1932 in the United States, August events
Hobie Billingsley	1927 births, Living people, Divers, Sportspeople from Indiana, People from Bloomington, Indiana
Christopher Robin Milne	1920 births, 1996 deaths, Deaths from myasthenia gravis, People from London
A. A. Milne	1882 births, 1956 deaths, English novelists, English playwrights, English poets, Writers from London
Unbinilium	Chemical elements
Prime Minister of Malaysia	Prime Ministers of Malaysia
Gallions Reach DLR station	Docklands Light Railway stations
Tunku Abdul Rahman	Prime Ministers of Malaysia, 1903 births, 1990 deaths
Abdul Razak Hussein	1922 births, 1976 deaths, Prime Ministers of Malaysia, Deputy Prime Ministers of Malaysia
Hussein Onn	1922 births, 1990 deaths, Prime Ministers of Malaysia, Deputy Prime Ministers of Malaysia
Woodstock '99	1999 in music, Music festivals
Abdullah Ahmad Badawi	Prime Ministers of Malaysia, 1939 births, Living people, Deputy Prime Ministers of Malaysia
Stratford High Street DLR station	Docklands Light Railway stations
2018 Malaysian general election	2018 in Asia, Malaysia
Hadi Awang	1947 births, Living people, Malaysian politicians
Richard Hofstadter	Pulitzer Prize winners, 1916 births, 1970 deaths, Deaths from leukemia, Cancer deaths in New York City, American historians, American educators, Writers from New York City, Writers from Buffalo, New York
John A. Stormer	1928 births, 2018 deaths, American political writers, Anti-Communists, American conservatives, Republicans (United States), Writers from Pennsylvania
Troy, Missouri	Cities in Missouri, County seats in Missouri
Dover, New Hampshire	Cities in New Hampshire, County seats in New Hampshire
Bristol, Rhode Island	County seats in Rhode Island, Towns in Rhode Island
List of Texas hurricanes (1950-79)	Hurricanes in the United States, History of Texas
Wailuku, Hawaii	Census-designated places in Hawaii, County seats in Hawaii
Lihue, Hawaii	Census-designated places in Hawaii, County seats in Hawaii
Doug Ford	1964 births, Living people, Politicians from Toronto, Premiers of Ontario
Philippe Couillard	1957 births, Living people, Politicians from Montreal, Premiers of Quebec, Privy Councillors (Canada)
Premier of Quebec	Premiers of Quebec
Stephen McNeil	1964 births, Living people, Premiers of Nova Scotia
Premier of Nova Scotia	Premiers of Nova Scotia
Frank McKenna	1948 births, Living people, Premiers of New Brunswick, Ambassadors of Canada, Privy Councillors (Canada), Canadian Queen's Counsel
Premier of New Brunswick	Premiers of New Brunswick
Brian Gallant	1982 births, Living people, Premiers of New Brunswick
Brian Pallister	1954 births, Living people, Premiers of Manitoba, People from Winnipeg, Members of the House of Commons of Canada
Edward Schreyer	1935 births, Living people, Governors General of Canada, Premiers of Manitoba, Privy Councillors (Canada)
John Horgan	Living people, Premiers of British Columbia, 1959 births
Premier of British Columbia	Premiers of British Columbia
Wade MacLauchlan	1954 births, Living people, Canadian LGBT people, Gay men, LGBT academics, LGBT politicians, Premiers of Prince Edward Island
Premier of Prince Edward Island	Premiers of Prince Edward Island
Alex Campbell (politician)	1933 births, Living people, Premiers of Prince Edward Island, Privy Councillors (Canada)
Scott Moe	Living people, 1973 births, Premiers of Saskatchewan
Premier of Saskatchewan	Premiers of Saskatchewan
Roy Romanow	1939 births, Living people, Premiers of Saskatchewan, Privy Councillors (Canada), Canadian Queen's Counsel
Rachel Notley	1964 births, Living people, Premiers of Alberta
Premier of Alberta	Premiers of Alberta
Dwight Ball	1957 births, Living people, Premiers of Newfoundland and Labrador
Premier of Newfoundland and Labrador	Premiers of Newfoundland and Labrador
Clyde Wells	1937 births, Living people, Premiers of Newfoundland and Labrador, Canadian Queen's Counsel
Bob McLeod (politician)	1952 births, Living people, Premiers of the Northwest Territories
Nick Sibbeston	Premiers of the Northwest Territories, 1943 births, Living people
Mastung, Pakistan	Towns in Pakistan
Premier of the Northwest Territories	Premiers of the Northwest Territories
Hay River, Northwest Territories	Towns in Canada
Sandy Silver	1969 births, Living people, Premiers of Yukon
Premier of Yukon	Premiers of Yukon
Willard Phelps	Premiers of Yukon, 1941 births, Living people, People from Vancouver
Joe Savikataaq	1960 births, Living people, Premiers of Nunavut
Premier of Nunavut	Premiers of Nunavut
Paul Okalik	1964 births, Living people, Premiers of Nunavut
Kathleen Wynne	1953 births, Living people, Premiers of Ontario, Lesbians, Canadian LGBT people, LGBT politicians, Politicians from Toronto
List of Texas hurricanes (1980–present)	Hurricanes in the United States, History of Texas
Woodstock '94	1994 in New York (state), August events, Music festivals in the United States
Unbihexium	Periodic table, Chemical elements
River Teign	Rivers of England, Devon
Crossharbour DLR station	Docklands Light Railway stations
Mudchute DLR station	Docklands Light Railway stations
Island Gardens DLR station	Docklands Light Railway stations
Cutty Sark for Maritime Greenwich DLR station	Docklands Light Railway stations
The Samaritan Museum	Museums in Israel, Abrahamic religions, Ethnic groups in Israel, Ethnic groups in the Middle East, Religion in Israel
Mien Schopman-Klaver	1911 births, 2018 deaths, Dutch centenarians, Dutch Olympians, Sportspeople from Amsterdam, Sprinters
Ye Lwin (musician)	1947 births, 2018 deaths, Deaths from liver cancer, Burmese people, Guitarists, Political activists
Gabriel Caruana	Maltese people, 1929 births, 2018 deaths, Artists
Rita Bhaduri	1955 births, 2018 deaths, Deaths from kidney disease, Disease-related deaths in India, Indian movie actors, Indian television actors, Actors from Uttar Pradesh
Yvonne Blake	Goya Award winners, Academy Award winners, 1941 births, 2018 deaths, Deaths from stroke, Costume designers, People from Madrid, People from Manchester
List of New York hurricanes	Hurricanes in the United States, History of New York (state)
BI Cygni	Red giants
Madeline Brewer	1992 births, Living people, American movie actors, American television actors, Actors from New Jersey
V382 Carinae	Hypergiants, Variable stars
Pitman, New Jersey	Boroughs in New Jersey
V838 Monocerotis	Red giants, Variable stars
Charles Nicoletti	1916 births, 1977 deaths, American crime victims, Murders by firearm, Chicago Outfit mobsters
Tom Aposporos	American mayors, Politicians from New York, People from Poughkeepsie, New York, Living people, Year of birth missing (living people)
List of New England hurricanes	Hurricanes in New England
Violence against women	Crime, Women
Vacation	Leisure
Indigenous marriage in South Africa	South African people
Buzzards Bay	Bays of the United States, Geography of Massachusetts
Narragansett Bay	Bays of the United States, Rhode Island, Geography of Massachusetts
Camberwell railway station (England)	Railway stations in London
Heron Quays DLR station	Docklands Light Railway stations
South Quay DLR station	Docklands Light Railway stations
Abbey Road DLR station	Docklands Light Railway stations, West Ham
Science to Youth Movement	1992 establishments in Europe, Education, Sarajevo
Star Lane DLR station	Docklands Light Railway stations
Canning Town	Areas of London
West Ham	West Ham
Silvertown	Areas of London
Royal Docks	Areas of London
In My Feelings	2018 songs, Hip hop songs, Drake songs
North Woolwich	Areas of London
Matthew Waterhouse	1961 births, English movie actors, English novelists, English stage actors, English television actors, Gay men, LGBT actors, LGBT writers, English LGBT people, Actors from Hertfordshire, Writers from Hertfordshire, People from West Sussex, Living people
Nirasenbei	Japanese food
Tsukemono	Japanese food
Oyaki	Japanese food
Goheimochi	Japanese food
Sekihan	Japanese food
Punch (drink)	Drinks
Chirashizushi	Japanese food
Gokabo	Japanese food
Pitsunda	Abkhazia, Ancient Greek cities
Narazuke	Japanese food
Sannzoku-yaki	Japanese food, Chicken as food
Kuriokowa	Japanese food
Masuzushi	Japanese food
Chikuzenni	Japanese food
Takikomi gohan	Japanese food
Yaki Manju	Japanese food
Yashouma	Japanese food
1977 Birmingham tornado	Tornadoes in the United States
Agni	Hindu gods and goddesses
Suryavanshi	Rajputs, Hinduism
Chandravanshi	Rajputs, Hinduism
She's All That	1999 romance movies, 1999 comedy movies, 1990s romantic comedy movies, 1990s teen romance movies, 1990s teen comedy movies, American romantic comedy movies, American teen romance movies, American teen comedy movies, Miramax movies, Movies set in California
Agnivanshi	Rajputs, Hinduism
Parmar	Rajputs, Hinduism
Canadian Tire Centre	Indoor arenas, Music venues, Sports buildings in Canada, 1996 establishments in Canada, Buildings and structures in Ottawa
Matthew Flinders	Royal Navy officers, English explorers, 1774 births, 1814 deaths
Induction coil	Electronic components
Frodsham	Towns in Cheshire, Market towns in England
Great Western main line	Railway lines of England
South Western Railway (train operating company)	First Group railway companies, Train operating companies
Marko Orlandić	1930 births, 2019 deaths, Presidents of Montenegro, Prime Ministers of Montenegro, Political activists
Prime Minister of Montenegro	Prime Ministers of Montenegro
Filip Vujanović	1954 births, Living people, Presidents of Montenegro, Prime Ministers of Montenegro
Igor Lukšić	1976 births, Living people, Prime Ministers of Montenegro
Duško Marković	1959 births, Living people, Prime Ministers of Montenegro, Current national leaders
President of Montenegro	Presidents of Montenegro
Momir Bulatović	1956 births, 2019 deaths, Deaths from myocardial infarction, People from Belgrade, Presidents of Montenegro
Veljko Bulajić	1928 births, Living people, Croatian people, Montenegrin people, Movie directors
Hans Kronberger	1951 births, 2018 deaths, Former MEPs, Austrian politicians, German politicians
Gary Beach	Tony Award winning actors, Drama Desk Award winners, 1947 births, 2018 deaths, American movie actors, American stage actors, LGBT actors, Gay men, LGBT singers, Singers from Virginia, Actors from Virginia, People from Alexandria, Virginia
João Semedo	1951 births, 2018 deaths, Portuguese politicians, Physicians, People from Lisbon
Adrian Cronauer	1938 births, 2018 deaths, Disease-related deaths in Virginia, American radio personalities, American autobiographers, American lawyers, Republicans (United States), American military personnel of the Vietnam War, Writers from Pennsylvania, People from Pittsburgh, Pennsylvania
Gopaldas Neeraj	1925 births, 2018 deaths, Deaths from respiratory tract infection, Disease-related deaths in India, Indian poets, People from Uttar Pradesh
Burton Richter	American physicists, 1931 births, 2018 deaths, Scientists from New York City
Geoffrey Wellum	1921 births, 2018 deaths, British military personnel of World War II, People from Essex
Rayo de Jalisco Sr.	1932 births, 2018 deaths, Deaths from congestive heart failure, Mexican professional wrestlers, Mexican movie actors, Actors from Mexico City, Sportspeople from Mexico City
Denis Ten	1993 births, 2018 deaths, Murders by blade weapons, Figure skaters, Kazakhstani sportspeople, Olympic bronze medalists
Luís Vaz de Torres	1560s births, 1600s deaths, Galician people, Spanish explorers
The President's Keeper	Non-fiction books, 2017 books, South Africa
Variscan orogeny	Orogenies, Palaeozoic
Pomarkku	Municipalities of Finland
Chotti Bahu 2	Soap operas, 2011 Indian television series debuts, 2012 television series endings
Head-end power	Rail technologies
Switcher	Locomotives
Jon Schnepp	American cinematographers, American editors, American cartoonists, American movie actors, American television actors, American voice actors, American television writers, American animators, American television directors, American television producers, American television presenters, Deaths from stroke, 1967 births, 2018 deaths
Jean-Loup Dabadie	1938 births, 2020 deaths, French screenwriters, French journalists, Songwriters, Writers from Paris
Loading gauge	Rail transport
L’Malouma Said	Living people, Mauritanian people, 1972 births, Women who received the International Women of Courage Award, African politicians, Slavery, Activists
Silvia Bel	Living people, Spanish people, Actors, 1970 births, People from Catalonia‎
Titot	Living people, 1967 births, Spanish musicians, Politicians from Catalonia
Mascarats	Musical groups, Catalonia
Roc Casagran	1980 births, Spanish poets, People from Catalonia, Living people
Anna Sahun	Living people, Spanish movie actors, Entertainers from Barcelona, 1975 births
Telling You	1998 romance movies, 1998 comedy movies, 1998 drama movies, 1990s romantic comedy movies, 1990s romantic drama movies, American romantic comedy movies, American romantic drama movies, English-language movies
V509 Cassiopeiae	Hypergiants
Alpha Herculis	Red giants
NGK (film)	2019 movies, Indian movies, Tamil-language movies
1000 Forms of Fear	2014 albums
Prestel	Telecommunications
Trichodesmium	Bacteria

