Cal Swenson	1948 births, 2014 deaths, Brandon Wheat Kings players, Canadian ice hockey forwards, Flin Flon Bombers players, Ice hockey people from Saskatchewan, World Hockey Association players
Karel Gut	1927 births, 2014 deaths, Czech ice hockey players, Czechoslovak ice hockey players, Sportspeople from Prague
Leslie Hope	Canadian television actors, Canadian movie actors, 1965 births, Living people
Joe Junkin	1946 births, 2014 deaths, Boston Bruins players, Canadian ice hockey goaltenders, Ice hockey people from Ontario, American Hockey League players, World Hockey Association players, Central Professional Hockey League players
Yevgeny Krylatov	1934 births, 2019 deaths, Deaths from pneumonia, Disease-related deaths in Moscow, Russian composers
Eric Paterson	1929 births, 2014 deaths, Canadian ice hockey goaltenders, Canadian Olympic gold medalists, Ice hockey people from Alberta, People from Edmonton
David Montgomery (baseball)	1946 births, 2019 deaths, Baseball executives, Businesspeople from Philadelphia, Pennsylvania, Deaths from cancer
Milan Kajkl	1950 births, 2014 deaths, Czechoslovak ice hockey players, Olympic silver medalists, Ice hockey defencemen
Krzysztof Birula-Białynicki	1944 births, 2014 deaths, Polish ice hockey players, Polish Olympians
Georg Katzer	1935 births, 2019 deaths, German educators, German composers
Celil Oker	1952 births, 2019 deaths, Turkish educators, Novelists, Turkish writers
Andrés Junquera	1946 births, 2019 deaths, Cardiovascular disease deaths in Spain, Deaths from myocardial infarction, Spanish association football goalkeepers
Vasile Huțanu	1954 births, 2014 deaths, Olympians, Romanian ice hockey players, Ice hockey centres
Vicente Emano	1943 births, 2019 deaths, Deaths from pneumonia, Filipino politicians, Governors, Mayors
Joel Virador	1967 births, 2019 deaths, Deaths from thyroid cancer, Filipino politicians, Human rights activists
Georginio Wijnaldum	1990 births, Living people, Dutch footballers, Liverpool F.C. players, Sportspeople from Rotterdam
Divock Origi	1995 births, Living people, 2014 FIFA World Cup players, Belgian footballers, Liverpool F.C. players, People from West Flanders
Jacques Taminiaux	1928 births, 2019 deaths, 20th century philosophers, 21st century philosophers, Belgian academics, Belgian philosophers, People from Hainaut (province)
Andy Gilpin	1920 births, 2014 deaths, Canadian ice hockey forwards, Canadian Olympic gold medalists, Ice hockey people from Quebec, Sportspeople from Montreal
Deaths in November 2016	2016 deaths, November 2016 events
Archie Mountbatten-Windsor	2019 births, Living people, People from London
Forensic anthropology	Anthropology, Forensics, Physical anthropology
Green Party (Sweden)	1981 establishments in Europe, Green political parties, Political parties in Sweden, 1980s establishments in Sweden
Bob Zeman	1937 births, 2019 deaths, American football coaches, American football safeties, San Diego Chargers players, Sportspeople from Illinois
Pekka Airaksinen	1945 births, 2019 deaths, Electronic musicians, Finnish composers, Jazz musicians, People from Helsinki
Web shell	Computing, Computer security
Mediterranean race	Race
Doru Tureanu	1954 births, 2014 deaths, Olympians, Romanian ice hockey players, Ice hockey centres
Jim Mikol	1938 births, 2014 deaths, Ice hockey people from Ontario, New York Rangers players, Toronto Maple Leafs players, Eastern Hockey League players, Ice hockey defencemen
Robert Meyers (ice hockey)	1924 births, 2014 deaths, Canadian ice hockey defencemen, Canadian Olympic gold medalists, Ice hockey people from Alberta, People from Edmonton
Shelburne, Nova Scotia	Towns in Nova Scotia
1949–50 Minneapolis Lakers season	National Basketball Association seasons
Lyudmila Putina	1958 births, Living people, First Ladies
New Safe Confinement	Buildings and structures in Ukraine, November 2016 events
Coad's riffle minnow	Freshwater fish
Alburnoides devolli	Freshwater fish
Alburnoides eichwaldii	Freshwater fish
Clive Palmer	1954 births, Living people, Australian businesspeople, Billionaires, Members of the Australian House of Representatives, Politicians from Melbourne, Politicians from Queensland
Beyazsu chub	Freshwater fish
Alburnoides fangfangae	Freshwater fish
Alburnoides gmelini	Freshwater fish
Alburnoides holciki	Freshwater fish
Transcaucasian spirlin	Freshwater fish, Animals of Turkey
Alburnoides kubanicus	Freshwater fish
Alburnoides maculatus	Freshwater fish
Jens Beutel	1946 births, 2019 deaths, German chess players, German mayors, Politicians from North Rhine-Westphalia, Politicians of the Social Democratic Party of Germany
Manyas spirlin	Freshwater fish
Tashkent riffle bleak	Freshwater fish
Saltoro Kangri	Karakoram, Jammu and Kashmir, Mountains of India
2019 FIFA Women's World Cup knockout stage	2019 FIFA Women's World Cup
Hahm Eun-jung	1988 births, Living people, K-pop singers, South Korean actors, South Korean singers, T-ara members
Alnitak	Stars
Freddie Starr	1943 births, 2019 deaths, Actors from Liverpool, Cardiovascular disease deaths in Spain, English comedians, English rock singers, Operation Yewtree, Singers from Liverpool
Batta, Libya	Cities in Libya
Sergey Dorenko	1959 births, 2019 deaths, Deaths from myocardial infarction, Russian journalists, Russian writers
Eric Cornell	Nobel Prize in Physics winners
Jim Hawkes	1934 births, 2019 deaths, Politicians from Alberta, Deaths from dementia, Disease-related deaths in Alberta, People from Calgary, Members of the House of Commons of Canada
Abul Khayr Alonto	1945 births, 2019 deaths, Filipino businesspeople, Deaths from pneumonia, Filipino politicians, Filipino lawyers
Daredevil (Marvel Comics character)	Characters created by Stan Lee, Fictional characters introduced in the 1960s, Marvel Comics adapted into movies, Marvel Comics characters, Marvel Comics mutates
Allison Anders	American television directors, American movie directors, People from Kentucky, 1954 births, Living people
Alburnoides ohridanus	Freshwater fish
Parham's riffle minnow	Freshwater fish
Alfredo Pérez Rubalcaba	1951 births, 2019 deaths, Cardiovascular disease deaths in Spain, Chemists, Deaths from stroke, Spanish educators, People from Cantabria, Socialist politicians, Deputy Prime Ministers of Spain, Spanish socialists
Alburnoides petrubanarescui	Freshwater fish
Alburnoides prespensis	Freshwater fish
Alburnoides qanati	Freshwater fish
Recep's chub	Freshwater fish
Alburnoides rossicus	Freshwater fish
Park Ji-yeon	1993 births, Living people, K-pop singers, South Korean actors, South Korean singers, South Korean models, People from Seoul, T-ara members
Samii's riffle minnow	Freshwater fish
Tabarestan riffle minnow	Freshwater fish
Kimberly Peirce	People from Harrisburg, Pennsylvania, Movie directors from Pennsylvania, 1967 births, Living people
Striped bystranka	Freshwater fish
Alburnoides varentsovi	Freshwater fish
Hyomin	1989 births, Living people, K-pop singers, South Korean actors, South Korean singers, People from Busan, T-ara members
Velioglu's chub	Freshwater fish
Qri	1986 births, Living people, K-pop singers, South Korean actors, South Korean singers, T-ara members
T-ara albums	Discographies, K-pop, T-ara
Abel Ferrara	Movie directors from New York City, 1951 births, Living people, People from the Bronx
Eric Stoltz	1961 births, American television actors, American movie actors, Actors from Los Angeles County, California, People from Whittier, California, Living people
The Funeral (movie)	1996 crime movies, 1996 drama movies, 1990s crime drama movies, American crime drama movies, Movies directed by Abel Ferrara
Pua Magasiva	1980 births, 2019 deaths, Actors from Wellington, New Zealand movie actors, New Zealand television actors, Samoan people
Differential privacy	Computer security
Dauphin, Manitoba	Cities in Manitoba
The Markup	Non-profit organizations of the United States, Websites
Grey partridge	Phasianidae, Birds of Europe, Birds of North America
I Don't Care (Ed Sheeran and Justin Bieber song)	2019 songs, Pop songs
Luisa Eugenia Navas	1918 births, Botanists, Chilean scientists, Living people, 2020 deaths
Bert Cooper	1966 births, 2019 deaths, African-American boxers, Deaths from pancreatic cancer, Sportspeople from Pennsylvania
Gianni De Michelis	1940 births, 2019 deaths, MEPs for Italy, People from Venice, Socialist politicians
Hector Busby	1932 births, 2019 deaths, Engineers, Knights, Members of the Order of the British Empire, New Zealand Māori people, Sailors
Gordon Neate	1941 births, 2019 deaths, English footballers, People from Reading, Berkshire
Jon Gittens	1964 births, 2019 deaths, Black British sportspeople, English footballers, English football managers, Sportspeople from Birmingham, Premier League players
Designated School Official	Immigration, Education in the United States
Pavlova (cake)	Cakes
List of women composers	Lists of women, Women composers, Lists of people by occupation
List of women lawyers	Lists of women, Women lawyers, Lists of people by occupation
Silver King (wrestler)	1968 births, 2019 deaths, Cardiovascular disease deaths in London, Coahuila, Deaths from myocardial infarction, Mexican professional wrestlers
N. R. Madhava Menon	1935 births, 2019 deaths, Cancer deaths in India, Deaths from liver cancer, Indian educators, Indian lawyers, People from Kerala
Rezo Cheishvili	1963 births, 2015 deaths, People from Tbilisi, Soviet writers, Civil servants, Writers from Georgia (country)
David Gordon Wilson	1928 births, 2019 deaths, American educators, American engineers, American inventors, British educators, British engineers, English inventors, Naturalized citizens of the United States, People from Warwickshire
Kyler Murray	1997 births, African American players of American football, Arizona Cardinals players, Heisman Trophy winners, American football quarterbacks, Sportspeople from Texas, Living people
Baker Mayfield	1995 births, Living people, Cleveland Browns players, Heisman Trophy winners
East Moriches, New York	Towns in New York
Old Sugar Mill of Koloa	Buildings and structures in Hawaii, 1835 establishments, Plantations in the United States
Frederick Brownell	1940 births, 2019 deaths, Deaths from cancer, Disease-related deaths in South Africa, Genealogy, South African people
Herobust	Year of birth missing, Living people, American DJs, American record producers, Electronic musicians, Musicians from Atlanta, Georgia
Héctor Enrique Olivares	1958 births, 2019 deaths, Argentine politicians, Assassinated people, Argentine engineers, Murders by firearm
Religion in North Macedonia	Religion by country, North Macedonia
Marble run	Toys
Shishapangma	Mountains of China, Tibet, Himalayas
Gyachung Kang	Mountains of China, Mountains of Nepal, Himalayas
Annapurna II	Mountains of Nepal, Himalayas
Ngadi Chuli	Mountains of Nepal, Himalayas
List of women politicians	Lists of women, Women politicians, Lists of politicians, Lists of people by occupation
Paul-Werner Scheele	1928 births, 2019 deaths, German Roman Catholics, German theologians, People from North Rhine-Westphalia, Roman Catholic bishops
Cyprinidae	Freshwater fish
George Avis Fulcher	Bishops, 1922 births, 1984 deaths
Harold Lederman	1940 births, 2019 deaths, Boxing broadcasters, Columbia University alumni, Deaths from cancer, HBO, People from the Bronx
1949–50 Rochester Royals season	National Basketball Association seasons
1949–50 Fort Wayne Pistons season	National Basketball Association seasons
1996–97 Utah Jazz season	National Basketball Association seasons
Everytime We Touch (album)	Pop albums, 2006 albums
Arif Malikov	1933 births, 2019 deaths, Composers, Azerbaijani people, Burials at Alley of Honor, People from Baku
Hayat Saif	1942 births, 2019 deaths, Bangladeshi poets, Critics, People from Dhaka
Allene Roberts	1928 births, 2019 deaths, American movie actors, American television actors, People from Fairfield, Alabama, Actors from Alabama
T-ara	South Korean girl groups, K-pop music groups, 2009 establishments in Asia, 2000s establishments in South Korea, T-ara
Saskhori	Settlements in Georgia (country)
Yuan Baohua	1916 births, 2019 deaths, Chinese politicians, Chinese educators, Centenarians
Jackson Wang	Living people, 1994 births, South Korean musicians, Singers from Hong Kong, Actors from Hong Kong, K-pop singers
Hiralal Yadav	1920s births, 2019 deaths, Indian singers, Indian musicians, People from Uttar Pradesh
Milos	Islands of Greece
Unita Blackwell	1933 births, 2019 deaths, African American politicians, American autobiographers, American civil rights activists, American mayors, Deaths from dementia, Disease-related deaths in Mississippi, US Democratic Party politicians, Writers from Mississippi
Ejnar Hertzsprung	1873 births, 1967 deaths, Astronomers, People from Copenhagen
Henry Norris Russell	1877 births, 1957 deaths, People from New York, American astronomers, Astrophysicists, Princeton University alumni, People from Princeton, New Jersey, Foreign Members of the Royal Society
Mayersville, Mississippi	County seats in Mississippi, Towns in Mississippi
Lula, Mississippi	Towns in Mississippi
Terry Melcher	1942 births, 2004 deaths, Deaths from melanoma, Singer-songwriters from New York City
Seymour Nurse	1933 births, 2019 deaths, Barbadian sportspeople, West Indies cricketers
David Harney	1947 births, 2019 deaths, English footballers, Sportspeople from County Durham
Alan Skirton	1939 births, 2019 deaths, Arsenal F.C. players, English footballers, People from Bath, Somerset
Thomas Silverstein	1952 births, 2019 deaths, Deaths from heart failure, Deaths from surgical complications, People who died in prison custody in the United States, American murderers, American people convicted of manslaughter, People from Long Beach, California, Criminals from California
Sven Lindqvist	1932 births, 2019 deaths, Disease-related deaths in Sweden, Writers from Stockholm
Jörg Kastendiek	1964 births, 2019 deaths, Deaths from lymphoma, Politicians of the Christian Democratic Union of Germany, Politicians from Bremen (state)
Chomo Lonzo	Himalayas, Tibet
Leopoldo Brizuela	1963 births, 2019 deaths, Deaths from leukemia, Argentine poets, Argentine journalists, Translators, Gay men, LGBT poets, LGBT journalists, LGBT novelists
Remig Stumpf	1966 births, 2019 deaths, German cyclists, German Olympians, Murder-suicides in Europe, Sportspeople from Bavaria, Sportspeople who committed suicide, Suicides in Germany
Shanghai Cooperation Organisation	Military alliances
List of University of Cambridge people	University of Cambridge
List of women scientists	Lists of women, Female scientists, Lists of scientists, Lists of people by occupation
Pelican eel	Fish
Stanton T. Friedman	1934 births, 2019 deaths, American historians, American physicists, Canadian writers, Canadian physicists, Scientists from New Jersey, Writers from New Jersey, People from New Brunswick
Hani Shukrallah	1950 births, 2019 deaths, Columnists, Egyptian writers, People from Cairo, Egyptian journalists
Salvatore Corallo	1928 births, 2019 deaths, Communist politicians, Italian communists, Italian politicians, People from Sicily
Lajos Faragó	1932 births, 2019 deaths, Association football goalkeepers, Hungarian footballers, Medalists at the 1960 Summer Olympics, Olympic bronze medalists, Sportspeople from Budapest
Michael Zampelas	1937 births, 2019 deaths, Business people, Cypriot people, Mayors, Philanthropists, Politicians
Nuptse	Himalayas, Mountains of Nepal
Escalon, California	Cities in California, Settlements in San Joaquin County, California
Siamaggiore	Communes of Sardinia
Siamanna	Communes of Sardinia
Siapiccia	Communes of Sardinia
Siddi, Sardinia	Communes of Sardinia
Silanus, Sardinia	Communes of Sardinia
Siliqua, Sardinia	Communes of Sardinia
Silius	Communes of Sardinia
Simala	Communes of Sardinia
Simaxis	Communes of Sardinia
Sindia, Sardinia	Communes of Sardinia
Siniscola	Communes of Sardinia
Siris, Sardinia	Communes of Sardinia
Siurgus Donigala	Communes of Sardinia
Soddì	Communes of Sardinia
Solarussa	Communes of Sardinia
Soleminis	Communes of Sardinia
Sorgono	Communes of Sardinia
Sorradile	Communes of Sardinia
Sorso	Communes of Sardinia
Stintino	Communes of Sardinia
Suelli	Communes of Sardinia
Suni, Sardinia	Communes of Sardinia
Tadasuni	Communes of Sardinia
Talana	Communes of Sardinia
Telti	Communes of Sardinia
Tempio Pausania	Communes of Sardinia
Tergu	Communes of Sardinia
Terralba	Communes of Sardinia
Tertenia	Communes of Sardinia
Teti, Sardinia	Communes of Sardinia
Teulada, Sardinia	Communes of Sardinia
Thiesi	Communes of Sardinia
Tiana, Sardinia	Communes of Sardinia
Tinnura	Communes of Sardinia
Tissi	Communes of Sardinia
Tonara	Communes of Sardinia
Torpè	Communes of Sardinia
Torralba, Sardinia	Communes of Sardinia
Tortolì	Communes of Sardinia
Tramatza	Communes of Sardinia
Tratalias	Communes of Sardinia
Tresnuraghes	Communes of Sardinia
Triei	Communes of Sardinia
Trinità d'Agultu e Vignola	Communes of Sardinia
Tuili	Communes of Sardinia
Tula, Sardinia	Communes of Sardinia
Turri	Communes of Sardinia
Ula Tirso	Communes of Sardinia
Ulassai	Communes of Sardinia
Uras	Communes of Sardinia
Uri, Sardinia	Communes of Sardinia
Urzulei	Communes of Sardinia
Usellus	Communes of Sardinia
Usini	Communes of Sardinia
Ussana	Communes of Sardinia
Ussaramanna	Communes of Sardinia
Ussassai	Communes of Sardinia
Valledoria	Communes of Sardinia
Vallermosa	Communes of Sardinia
Viddalba	Communes of Sardinia
Villa Sant'Antonio	Communes of Sardinia
Villa Verde	Communes of Sardinia
Villacidro	Communes of Sardinia
Villagrande Strisaili	Communes of Sardinia
Villamar	Communes of Sardinia
Villaperuccio	Communes of Sardinia
Villaputzu	Communes of Sardinia
Villasalto	Communes of Sardinia
Villamassargia	Communes of Sardinia
Villanova Monteleone	Communes of Sardinia
Villanova Truschedu	Communes of Sardinia
Villanova Tulo	Communes of Sardinia
Villanovaforru	Communes of Sardinia
Villanovafranca	Communes of Sardinia
Villasimius	Communes of Sardinia
Villasor	Communes of Sardinia
Villaspeciosa	Communes of Sardinia
Villaurbana	Communes of Sardinia
Zeddiani	Communes of Sardinia
Zerfaliu	Communes of Sardinia
Unix time	Unix
Namcha Barwa	Himalayas, Tibet, Mountains of China
Bill de Blasio 2020 presidential campaign	2020 United States presidential campaigns
Nobuo Sekine	1942 births, 2019 deaths, Japanese artists, Sculptors
Bill Workman	1940 births, 2019 deaths, American mayors, Businesspeople from South Carolina, People from Charleston, South Carolina, People from Greenville, South Carolina, Politicians from South Carolina, US Republican Party politicians
Bluffton, South Carolina	Cities in South Carolina
Vasili Blagov	1954 births, 2019 deaths, 1972 Winter Olympics, Russian figure skaters, Soviet figure skaters, Sportspeople from Moscow
Beatrix Philipp	1945 births, 2019 deaths, Former members of the German Bundestag, German politicians, German Roman Catholics, People from Mönchengladbach, Politicians from North Rhine-Westphalia, Politicians of the Christian Democratic Union of Germany
Haskell Indian Nations University	1884 establishments in Kansas, Colleges and universities in Kansas, Lawrence, Kansas, Native American, Buildings and structures in Lawrence, Kansas, National Register of Historic Places in Douglas County, Kansas
Junko Tabei	1939 births, 2016 deaths, Deaths from peritoneal cancer, Disease-related deaths in Japan, Japanese sportspeople, Mountain climbers, People from Fukushima Prefecture
List of territorial entities where English is an official language	English language, Geography-related lists, Language-related lists, Lists of countries
Bill Blair (politician)	1954 births, Living people, Politicians from Toronto, Members of the House of Commons of Canada from Ontario, Privy Councillors (Canada)
List of awards and nominations received by T-ara	Lists of awards and nominations, T-ara
T-ara videography	K-pop, Music videos and DVDs, T-ara
Cocos plate	Tectonic plates, Central America
Sol Yaged	1922 births, 2019 deaths, American jazz musicians, American clarinetists, Musicians from New York City
The Young Turks	YouTube, 2002 television series debuts
David Cervinski	1970 births, 2019 deaths, Australian footballers, Deaths from melanoma, People from Geelong, Sportspeople from Victoria (Australia)
Kadavoor Sivadasan	2019 deaths, 1932 births, Disease-related deaths in India, Indian politicians, Trade unionists
Kamet	Himalayas, Mountains of India, Uttarakhand
Cutworm	Agricultural pests, Moths, Gardening
Jannu	Himalayas, Mountains of Nepal
Molamenqing	Himalayas, Tibet, Mountains of China
Eduardo A. Roca	1921 births, 2019 deaths, Academics, Diplomats, Argentine lawyers, People from Buenos Aires
Rallapalli (actor)	1945 births, 2019 deaths, Deaths from lung disease, Disease-related deaths in India, Indian movie actors, Indian stage actors
Janet Kitz	1930 births, 2019 deaths, British educators, British historians, Canadian educators, Canadian historians, Canadian writers, People from Nova Scotia, Scottish writers
Juan Antonio Menéndez Fernández	1957 births, 2019 deaths, Cardiovascular disease deaths in Spain, Deaths from myocardial infarction, Roman Catholic bishops, Spanish Roman Catholics
Quentin Pongia	1970 births, 2019 deaths, Deaths from colorectal cancer, New Zealand rugby league players, People from South Island
Andrew Andraos	1997 births, Living people, Brit Award winners, Lebanese singers, Opera singers, Tenors, Lebanese people, Grammy Award winners, Lebanese Christians
Kozo Iizuka	Japanese engineers, Living people, 1931 births
Wanda Metropolitano	Buildings and structures in Madrid, Football stadiums in Spain, 1994 establishments in Europe
Ismoil Somoni Peak	Mountains of Asia, Tajikistan
Samuel Eugenio	1958 births, 2019 deaths, Deaths from surgical complications, Football managers, Peruvian footballers
CiNii	Databases, Libraries in Asia, Japan
British Columbia New Democratic Party	Political parties in Canada, 1933 establishments, Social democratic parties, 1930s establishments in Canada, British Columbia
Domain hack	Internet
Adrian Dix	1964 births, Politicians from British Columbia, People from Vancouver, Health, Living people
Jürgen Kissner	1942 births, 2019 deaths, German cyclists, German Olympic silver medalists, Sportspeople from Brandenburg
Four Ways to Forgiveness	Hainish Cycle, 1995 books
Analía Gadé	1931 births, 2019 deaths, Argentine movie actors, Argentine television actors, Cancer deaths in Spain, Córdoba, Argentina, Argentine stage actors
Mark Warawa	1950 births, 2019 deaths, Politicians from British Columbia, Members of the House of Commons of Canada from British Columbia, Cancer deaths in British Columbia, Deaths from pancreatic cancer
Adansonia gregorii	Malvaceae
Mandalay Bay	Hotels, Buildings and structures in Nevada
Nickey Iyambo	1936 births, 2019 deaths, Namibian politicians, Physicians, Vice presidents
Nilda Fernández	1957 births, 2019 deaths, Deaths from heart failure, French singers, Musicians from Barcelona, People from Lyon
Frank F. Ledford Jr.	1934 births, 2019 deaths, American generals, American physicians, Disease-related deaths in Texas, Military people from Florida, Scientists from Jacksonville, Florida
Rainwater tank	Water, Containers
Quinn H. Becker	1930 births, Living people, American generals, American physicians, People from Missouri
Bernhard T. Mittemeyer	1930 births, Living people, American generals, American physicians
Tanya Plibersek	1969 births, Living people, Politicians from Sydney
Anthony Albanese	1963 births, Living people, Deputy Prime Ministers of Australia, Politicians from Sydney
Fuck tha Police	Obscenity controversies, 1988 songs
Dental hygienist	Healthcare occupations
Fraser river gold rush	British Columbia, Gold rushes, 19th century in Canada
Anglo-Indian	Ethnic groups in India
Ruskin Bond	Indian writers, 1934 births, Living people
List of rivers of Canada	Rivers of Canada, Lists of rivers by country, Canada-related lists
Air Force School Jodhpur	Rajasthan, Education in India
Signe Marie Stray Ryssdal	1924 births, 2019 deaths, Lawyers, Norwegian politicians
Austin Eubanks	1981 births, 2019 deaths, American activists, Columbine High School massacre, Drug-related accidental deaths in the United States, Public speaking
Secular state	Politics, States
Lifeline Theatre	Chicago, Illinois, Theater
Amédée Grab	1930 births, 2019 deaths, People from Zürich, Roman Catholic bishops
2018–19 Fußball-Bundesliga	Fußball-Bundesliga, Bundesliga seasons
List of colleges and universities in Japan	Lists of colleges and universities, Japan-related lists
Cedar Fair	Companies
Miguel Montes Busto	1940 births, 2019 deaths, People from Oviedo, Spanish footballers, Spanish football managers
Dude Perfect	Internet celebrities
Gurla Mandhata	Tibet, Mountains of China
Chris Bowen	1973 births, Living people, Government ministers of Australia, Politicians from Sydney
Peter Slipper	1950 births, Living people, Speakers of the Australian House of Representatives, Politicians from Queensland
Saturn I	Apollo program, Rockets
Aarti	Religious behavior and experience, Music, Hinduism, Indian culture
List of WWE United States Champions	World Wrestling Entertainment championships
Saser Kangri	Karakoram, Mountains of India, Jammu and Kashmir
Sandy D'Alemberte	1933 births, 2019 deaths, American educators, American lawyers, People from Tallahassee, Florida, Politicians from Florida
Yuriy Bohutsky	1952 births, 2019 deaths, Deaths from surgical complications, Ukrainian politicians
John Moore, Baron Moore of Lower Marsh	1937 births, 2019 deaths, Former Conservative MPs (UK), Margaret Thatcher, Politicians from London, Stockbrokers
Ronnie Virgets	1942 births, 2019 deaths, American columnists, American journalists, Emmy Award winners, Writers from New Orleans, Louisiana
Kochavi Shemesh	1944 births, 2019 deaths, Communists, Iraqi Jews, Israeli activists, Israeli Jews, Israeli lawyers, Jewish activists, Jewish lawyers, Naturalized citizens of Israel, People from Baghdad, Political activists
Julio César Trujillo	1931 births, 2019 deaths, Deaths from cerebral hemorrhage, Ecuadorian politicians, Ecuadorian lawyers
Geneviève Waïte	1948 births, 2019 deaths, South African actors, Singers, South African models, People from Cape Town
Charles Kittel	1916 births, 2019 deaths, American physicists, American centenarians, Scientists from New York City, Writers from New York City
Geneviève Raugel	1951 births, 2019 deaths, French mathematicians
Ma'ruf Amin	1943 births, Living people, Vice-Presidents of Indonesia
Queensland lungfish	Fish of Australia, Freshwater fish, Lobe-finned fish, Queensland
Dumont d'Urville Station	1956 establishments, Establishments in Antarctica, Antarctica, Buildings and structures in France
Leland Stanford	1824 births, 1893 deaths, Governors of California, People from Palo Alto, California
Aker (deity)	Egyptian gods and goddesses
Kennedy Space Center Launch Complex 39	NASA, Buildings and structures in Florida
James Fitz-Allen Mitchell	1931 births, Living people, Prime Ministers of Saint Vincent and the Grenadines, Diplomats, Knights Commander of the Order of St Michael and St George
Tang Fei	1932 births, Living people, Generals, Premiers of the Republic of China on Taiwan
Jeffrey A. Rosen	1958 births, Living people, American lawyers, Politicians from Boston, Massachusetts, Writers from Boston, Massachusetts, US Republican Party politicians, United States Deputy Attorneys General
List of dialling codes in Italy	Area codes
List of countries and dependencies by population density	Lists of countries, Demography
Eduard Punset	1936 births, 2019 deaths, Deaths from lung cancer, Cancer deaths in Spain, Spanish economists, Spanish lawyers, Politicians from Barcelona, Writers from Barcelona
Ali Mohammad Mahar	2019 deaths, 1967 births, Deaths from heart failure, Pakistani politicians
Referential transparency	Computer programming
Walter Harris (author)	1925 births, 2019 deaths, BBC newsreaders and journalists‎, British journalists, British novelists, British poets
Nan Winton	1925 births, 2019 deaths, Accidental deaths from falls, Accidental deaths in the United Kingdom, Deaths from congestive heart failure, Deaths from hypertension, BBC newsreaders and journalists, English journalists, English television presenters, People from Portsmouth
Jean Beaudin	1939 births, 2019 deaths, Canadian movie directors, Canadian movie producers, Canadian screenwriters, Writers from Montreal
Jonathan Miller	1934 births, 2019 deaths, Deaths from Alzheimer's disease, Disease-related deaths in London, Actors from London, Alumni of University College London, BBC television presenters, British Jews, Commanders of the Order of the British Empire, British atheists, British television presenters, Jewish atheists, Knights Bachelor, British theatre directors, Tony Award winners, Writers from London
Side effect (computer science)	Computer science
Mars Climate Orbiter	NASA spacecraft
Glauco Sansovini	1938 births, 2019 deaths, European politicians, Heads of state, Sammarinese people
Neville Lederle	1938 births, 2019 deaths, Formula One drivers, South African sportspeople
Scala (Programming language)	Programming languages
William Wyatt Bibb	1781 births, 1820 deaths, Governors of Alabama, United States senators from Georgia, United States representatives from Georgia, Democratic Republican party (US) politicians, Politicians from Virginia, Accidental deaths in the United States
Shispare	Mountains of Pakistan, Gilgit-Baltistan, Karakoram
Piet Blauw	1937 births, 2019 deaths, Former members of the House of Representatives of the Netherlands, People from Alkmaar, People's Party for Freedom and Democracy politicians, Politicians from North Holland
TEC-9	Pistols
Artemis program	Artemis program, 2010s in the United States
Khwe language	Languages of South Africa, Namibia, Angola, Botswana, Zambia
Information commissioner	Government occupations
Value (computer science)	Computer science
Manual labour	Employment
Artemis 1	Artemis program, Orion program
New Mexico Territory	1850 establishments in the United States, 19th-century establishments in New Mexico Territory, 1910s disestablishments in the United States, 1912 disestablishments, Former territories of the United States, History of Arizona, History of Colorado, History of Nevada, History of New Mexico
Kongur Tagh	Xinjiang, Mountains of China
Muztagh Ata	Xinjiang, Mountains of China
Kongur Tiube	Xinjiang, Mountains of China
Carlton, Nottinghamshire	Settlements in Nottinghamshire, Nottingham
Clifton, Nottinghamshire	Settlements in Nottinghamshire, Nottingham
Doug Wilson (rugby union)	1931 births, 2019 deaths, New Zealand rugby union players, Sportspeople from North Island
Judith Kerr	1923 births, 2019 deaths, German novelists, German children's writers, British novelists, British illustrators, British children's writers, Writers from London, Writers from Berlin
Dumiso Dabengwa	1939 births, 2019 deaths, Deaths from liver disease, Generals, Zimbabwe politicians
Mette Frederiksen	1977 births, Living people, Current national leaders, Prime Ministers of Denmark
Rolf Huisgen	1920 births, 2020 deaths, German chemists, People from Rhineland-Palatinate
Beaton Tulk	1944 births, 2019 deaths, Deaths from prostate cancer, Premiers of Newfoundland and Labrador
Nanni Balestrini	1935 births, 2019 deaths, Disease-related deaths in Rome, Italian artists, Italian poets, People from Milan
AMC Theatres	Movie industry
Bobby Joe Long	1953 births, 2019 deaths, American kidnappers, American people convicted of assault, American people convicted of murder, American prisoners sentenced to death, American rapists, American robbers, American serial killers, Drug-related deaths in the United States, Executed American serial killers, People executed by lethal injection, People from West Virginia
Hosei Norota	1929 births, 2019 deaths, Deaths from bladder cancer, Disease-related deaths in Japan, Japanese politicians
Lionel Heinrich	1934 births, 2014 deaths, American Hockey League players, Boston Bruins players, Canadian ice hockey left wingers, Ice hockey people from Saskatchewan
Ralph Nattrass	1925 births, 2014 deaths, American Hockey League players, Canadian ice hockey defencemen, Chicago Blackhawks players, Ice hockey people from Saskatchewan
Ross Lonsberry	1947 births, 2014 deaths, American Hockey League players, Boston Bruins players, Canadian ice hockey left wingers, Estevan Bruins players, Ice hockey people from Saskatchewan, Los Angeles Kings players, Philadelphia Flyers players, Pittsburgh Penguins players, Stanley Cup champions, Memorial Cup winners, Central Professional Hockey League players
Brian Marchinko	1948 births, 2014 deaths, Canadian ice hockey centres, Ice hockey people from Saskatchewan, New York Islanders players, Toronto Maple Leafs players
Fred Dunsmore	1929 births, 2014 deaths, Canadian ice hockey centres, Ice hockey people from Manitoba, Sportspeople from Winnipeg
Neebing, Ontario	Settlements in Ontario
Parastratiosphecomyia stratiosphecomyioides	Flies, Long words
Phil Proctor	1940 births, Living people, American movie actors, American stage actors, American television actors, American voice actors, American video game actors, American screenwriters, Yale University alumni, Writers from Indiana, Actors from Indiana
Anna Udvardy	1949 births, 2019 deaths, Academy Award winners, Hungarian movie producers, People from Budapest
Wayne Thiebaud	1920 births, Living people, American painters, People from Mesa, Arizona, People from Long Beach, California
Estelle Parsons	1927 births, Living people, Actors from Massachusetts, American movie actors, American stage actors, American television actors, Best Supporting Actress Academy Award winners, Drama Desk Award winners, People from Lynn, Massachusetts, Singers from Massachusetts
Vijaya Mulay	1921 births, 2019 deaths, Indian educators, Indian historians, Indian movie directors, People from Bombay, Indian screenwriters
Icona Pop	Swedish pop music groups, 2009 establishments
World calendar	Calendars
2020 Belizean general election	2020 elections, Politics of Belize
Jaroslav Erik Frič	1949 births, 2019 deaths, Czech musicians, Czech poets, Deaths from cancer, Disease-related deaths in the Czech Republic
Kingdom of Koya	Former monarchies of Africa
Peter Gammond	1925 births, 2019 deaths, British military personnel of World War II, British poets, British composers, British journalists, British artists, Critics, Writers from Cheshire
George Zweig	1937 births, Living people, Russian physicists, American physicists, Naturalized citizens of the United States, People from Moscow
Flaminia Jandolo	1930 births, 2019 deaths, Italian movie actors, Italian voice actors, Italian television actors, Actors from Rome
Marisol Nichols	1973 births, Living people, American movie actors, American television actors, American voice actors, Actors from Chicago
Camila Mendes	1994 births, Living people, American movie actors, American television actors, American voice actors, Actors from Virginia, People from Charlottesville, Virginia
Colchagua (historical province)	Regions of Chile
Joseph Nye	1937 births, Living people, American political scientists, American political writers, Writers from New Jersey, Politicians from New Jersey, US Democratic Party politicians
Wonder Stories	Science fiction, American magazines
Yemeni Civil War (2014–present)	2015 in Asia, 2016 in Asia, 2017 in Asia, 2018 in Asia, 2019 in Asia, 21st century in Yemen, Al-Qaeda, Civil wars, Human rights abuses, Wars involving the United States, Yemen
Scott Bailey (bishop)	1916 births, 2005 deaths, Bishops, People from Houston, Texas
Scott Bailey (actor)	1978 births, American movie actors, Actors from Missouri, Living people
Rocketdyne F-1	Apollo program, Rockets
Stephen Thorne	1946 births, 2019 deaths, Actors from London, Alumni of the Royal Academy of Dramatic Art, English movie actors, English stage actors, English television actors
Jean Burns	1919 births, 2019 deaths, Aviators, People from Melbourne
Vittorio Zucconi	1944 births, 2019 deaths, American journalists, Italian journalists, Naturalized citizens of the United States, People from Emilia-Romagna
Charles C. Pattillo	1924 births, 2019 deaths, American generals, People from Atlanta, Georgia, United States Air Force, Twin people from the United States
Abdel Latif El Zein	1932 births, 2019 deaths, Lebanese politicians
Golden (Kylie Minogue album)	2018 albums, Kylie Minogue albums
KylieFever2002	Concerts, Concert tours
Anand Panyarachun	1932 births, Living people, Prime Ministers of Thailand, Thai businesspeople, Ambassadors
Suchinda Kraprayoon	1933 births, Living people, Prime Ministers of Thailand
Chavalit Yongchaiyudh	1932 births, Living people, Prime Ministers of Thailand, Generals
Umar Ghalib	1930 births, 2020 deaths, Prime Ministers of Somalia
Anthony Graziano	1940 births, 2019 deaths, Deaths from bladder cancer, Deaths from diabetes, American people convicted of attempted murder, American people convicted of drug offenses, Criminals from New York City
Dmytro Kremin	1953 births, 2019 deaths, Ukrainian writers, Poets, Ukrainian journalists, European translators, Ukrainian educators
Mira Zakai	1942 births, 2019 deaths, Deaths from stroke, Israeli academics, Grammy Award winners, Israeli singers, Asian opera singers, People from Jerusalem
Ibrahim Lame	1953 births, 2019 deaths, Educators, Nigerian politicians
Hampton, Victoria	Settlements in Australia, Melbourne
Andrew Peacock	1939 births, 2021 deaths, Ambassadors of Australia, Politicians from Melbourne
Siamodon	Dinosaurs of Asia, Cretaceous dinosaurs, Iguanodonts
Detached house	Buildings and structures
Bill Blair (racing driver)	1911 births, 1995 deaths, NASCAR drivers
Trivor	Mountains of Pakistan, Gilgit-Baltistan, Karakoram
The Water Hole	1928 movies, 1920s western movies, American western movies
Chumbawamba	1982 establishments in the United Kingdom, 2010s disestablishments in the United Kingdom, 2012 disestablishments in Europe, Musical groups established in 1982, Musical groups disestablished in 2012, British rock bands, Alternative rock bands, 1980s British music groups, 1990s British music groups, 2000s British music groups, 2010s British music groups
Veeru Devgan	1930s births, 2019 deaths, Cardiovascular disease deaths in India, Choreographers, Deaths from cardiac arrest, Indian movie actors, Indian movie directors, Punjabi people
Margaret-Ann Armour	1939 births, 2019 deaths, British chemists, British educators, Canadian educators, Canadian scientists, Order of Canada, People from Glasgow, Scottish scientists
Tsilkani	Settlements in Georgia (country), Villages in Asia
Alan Murray (golfer)	1940 births, 2019 deaths, Cancer deaths in Australia, Deaths from skin cancer, Golfers, Sportspeople from Sydney
Gianfranco Bozzao	1936 births, 2019 deaths, Italian footballers, People from Venice
Harry Hood (footballer)	1944 births, 2019 deaths, Scottish footballers, Scottish football managers, Sportspeople from Glasgow
Thembinkosi Mbamba	1995 births, 2019 deaths, Road accident deaths, South African footballers
American Bar Association	1870s establishments in Illinois, 1878 establishments in the United States, Organizations based in the United States, Schools in Illinois, United States law, Chicago, Illinois
Bill Buckner	1949 births, 2019 deaths, Baseball players from California, Boston Red Sox players, California Angels players, Chicago Cubs players, Deaths from dementia with Lewy bodies, Disease-related deaths in Idaho, Kansas City Royals players, Los Angeles Dodgers players, National League All-Stars
Gangkhar Puensum	Bhutan, Mountains of China, Himalayas, Tibet
Gabriel Diniz	1990 births, 2019 deaths, Aviation deaths, Brazilian singers, Composers, Guitarists
Contour integral	Mathematical analysis
Eric Harris and Dylan Klebold	1981 births, 1999 deaths, American children, American murderers, Columbine High School massacre, Duos, People from Colorado, People from Wichita, Kansas, Murder-suicides in the United States, Murderers who committed suicide, Suicides by firearm in the United States
Aharon Razin	Wolf Prize winners, 1935 births, 2019 deaths, Israeli scientists, Chemists, Biologists, People from Tel Aviv
John Pinto	1924 births, 2019 deaths, American military personnel of World War II, Native American people, Politicians from Arizona, Politicians from New Mexico, State legislators of the United States, US Democratic Party politicians
Lupton, Arizona	Census-designated places in Arizona, Unincorporated communities in Arizona
Edmund Morris (writer)	Pulitzer Prize winners, 1940 births, 2019 deaths, Deaths from stroke, Naturalized citizens of the United States, Kenyan people, British journalists, American journalists, American political writers, People from Nairobi
Khoo Kay Kim	1937 births, 2019 deaths, Academics, Deaths from respiratory failure, Historians, Malaysian people, Writers
Aurèle Joliat	1901 births, 1986 deaths, Canadian ice hockey left wingers, Hart Memorial Trophy winners, Hockey Hall of Fame inductees, Ice hockey people from Ontario, Montreal Canadiens players, Stanley Cup champions
Nana Sahib	1824 births, 1859 deaths, Indian people
Apolo Nsibambi	1940 births, 2019 deaths, Deaths from cancer, Academics, Educators, Prime Ministers of Uganda
Tony Horwitz	1958 births, 2019 deaths, American journalists, Jewish American writers, Pulitzer Prize winners, Writers from Washington, D.C.
Nicolae Pescaru	1943 births, 2019 deaths, 1970 FIFA World Cup players, Romanian footballers, Romanian football managers
Manuel Pazos	1930 births, 2019 deaths, Galician people, Spanish association football goalkeepers
Zlatko Škorić	1941 births, 2019 deaths, Croatian footballers, Association football goalkeepers, Olympians, Sportspeople from Zagreb, Yugoslavian sportspeople
Housing in the United States	United States, Real estate
Bad guy (song)	2019 songs, Pop songs, Billie Eilish songs
Timms Hill	Hills, Wisconsin
Michael Scott (The Office)	The Office (U.S. TV series) characters
Pam Beesly	The Office (U.S. TV series) characters
Stanley Hudson	The Office (U.S. TV series) characters
Leslie David Baker	1958 births, Living people, American movie actors, American television actors, American stage actors, American voice actors, Actors from Chicago
Kevin Malone	The Office (U.S. TV series) characters
Brian Baumgartner	1972 births, Living people, American movie actors, American television actors, American golfers, Actors from Atlanta, Georgia
Angela Martin	The Office (U.S. TV series) characters
Angela Kinsey	1971 births, Living people, American movie actors, American television actors, American voice actors, Actors from Louisiana
Oscar Nunez	1958 births, Living people, American movie actors, American voice actors, American television actors
B. J. Novak	1979 births, Living people, American movie actors, American television actors, American voice actors, American television directors, American television producers, American television writers, Actors from Massachusetts, Screenwriters from Massachusetts, Comedians from Massachusetts, Movie directors from Massachusetts
Ryan Howard (The Office)	The Office (U.S. TV series) characters
Creed Bratton	1943 births, Living people, American television actors, American movie actors, American stage actors, American voice actors, Actors from Los Angeles, California, Musicians from Los Angeles, California
Kelly Kapoor	The Office (U.S. TV series) characters
Jean Juventin	1928 births, 2019 deaths, French mayors, French Polynesia
Phyllis Vance	The Office (U.S. TV series) characters
Dunder Mifflin	Fiction, Scranton, Pennsylvania
Babergh	Babergh
Judith Scott (artist)	1943 births, 2005 deaths, Textile artists, People from Cincinnati, Ohio
Holbrook, Massachusetts	Towns in Massachusetts
Parkline, Idaho	Census-designated places in Idaho
Peter Hitchcock (environmentalist)	1944 births, 2019 deaths, Australian people, Environmentalists, Order of Australia
Deaths in June 2019	2019 deaths, June 2019 events
2019 Conservative Party leadership election	2019 in Europe, 2010s in the United Kingdom, July 2019 events, June 2019 events, 2019 elections
Rafael Safarov	1947 births, 2019 deaths, Russian footballers, Russian football managers, Disease-related deaths in Moscow, People from Tbilisi
Lightspeed POS Inc	2005 establishments in Canada, Technology companies of Canada, Companies listed on the Toronto Stock Exchange, Montreal
Walter Wolfgang	1923 births, 2019 deaths, British activists, British anti–Iraq War activists, British Jews, German Jews, Jewish activists, Labour Party (UK) people, Naturalised citizens of the United Kingdom, People from Frankfurt, Refugees from Nazism
James Cleverly	1969 births, Living people, Conservative MPs (UK), Politicians from London
Carmine Caridi	1934 births, 2019 deaths, Accidental deaths from falls in the United States, Actors from New York City, American movie actors, American television actors, Deaths from pneumonia, Infectious disease deaths in Los Angeles
Matt Hancock	1978 births, Living people, Alumni of the University of Cambridge, Alumni of the University of Oxford, Conservative MPs (UK), Members of the British House of Commons for English constituencies, People from Chester, Privy Councillors (UK), Secretaries of State of the United Kingdom, UK MPs 2010–2015, UK MPs 2015–2017, UK MPs 2017–2019, UK MPs 2019–
Lakewood Township, New Jersey	Townships in New Jersey, Ocean County, New Jersey
Andrea Leadsom	1963 births, Living people, Conservative MPs (UK), UK MPs 2010–2015, UK MPs 2015–2017, UK MPs 2017–2019, Bankers, People from Buckinghamshire, English Christians
Kit Malthouse	1966 births, Living people, Conservative MPs (UK), People from Liverpool
Esther McVey	1967 births, Living people, Conservative MPs (UK), People from Liverpool
Dominic Raab	1974 births, Living people, Alumni of the University of Cambridge, Alumni of the University of Oxford, British lawyers, Conservative MPs (UK), Jewish British politicians, Jewish lawyers, Members of the British House of Commons for English constituencies, Politicians from Buckinghamshire, Privy Councillors (UK), Secretaries of State of the United Kingdom, UK MPs 2010–2015, UK MPs 2015–2017, UK MPs 2017–2019, UK MPs 2019–
Rory Stewart	1973 births, Living people, Former Conservative MPs (UK), UK MPs 2010–2015, UK MPs 2015–2017, UK MPs 2017–2019, Politicians from London
Steve Baker (politician)	1971 births, Living people, Conservative MPs (UK)
Jacob Rees-Mogg	1969 births, Living people, Alumni of the University of Oxford, Conservative MPs (UK), Members of the British House of Commons for English constituencies, People from Hammersmith, Politicians from London, Privy Councillors (UK), UK MPs 2010–2015, UK MPs 2015–2017, UK MPs 2017–2019, UK MPs 2019–
Graham Brady	1967 births, Living people, Conservative MPs (UK), Politicians from Lancashire
Jesse Norman	1962 births, Living people, Conservative MPs (UK), Politicians from London
Priti Patel	1972 births, Living people, Conservative MPs (UK), Members of the British House of Commons for English constituencies, Politicians from London, Privy Councillors (UK), Secretaries of State for the Home Department, UK MPs 2010–2015, UK MPs 2015–2017, UK MPs 2017–2019, UK MPs 2019–, Women politicians
David Icke	1952 births, Living people, English footballers, English sports commentators, BBC people, English writers, People from Leicester
Michael Spicer	1943 births, 2019 deaths, Former Conservative MPs (UK), Deaths from leukemia, Deaths from Parkinson's disease, Politicians from Somerset
Dennis Etchison	1943 births, 2019 deaths, American editors, American novelists, Writers from California, Screenwriters from California, People from Stockton, California
Andrew Hall (actor)	1954 births, 2019 deaths, Deaths from cancer, English movie actors, English television actors, Actors from Manchester
McKinley County, New Mexico	New Mexico counties
EEPROM	Computer memory
Gustav Schwarzenegger	1907 births, 1972 deaths, Austrian people of World War II, Military personnel of World War II, SS officers, Police officers, Sturmabteilung people, Deaths from stroke, Pages with unreviewed translations
Jackie Winters	1937 births, 2019 deaths, African American politicians, Deaths from lung cancer, People from Topeka, Kansas, Politicians from Kansas, Politicians from Oregon, US Republican Party politicians
Papeete	1818 establishments, Capital cities in Oceania, Communes in France, French Polynesia
Bayram Şit	1930 births, 2019 deaths, Medalists at the 1952 Summer Olympics, Olympic gold medalists, Turkish sportspeople, Wrestlers
The Godfather Part II	1970s crime drama movies, American crime drama movies, Best Picture Oscar, Movies featuring a Best Supporting Actor Academy Award-winning performance, English-language movies, Gangster movies, Italian-language movies, Mafia, Movies based on books, Movies set in Italy, Movies set in New York City, Movies set in the 1950s, Prequel movies, Sequel movies, United States National Film Registry movies, Movies directed by Francis Ford Coppola
Wim Woudsma	1957 births, 2019 deaths, Disease-related deaths in the Netherlands, Dutch footballers, Dutch football managers, Sportspeople from Overijssel
Kimbolton Castle	Buildings and structures in England, Castles in England, Houses, Museums in England, Cambridgeshire
Dollhouse	Toys
Port Hawkesbury	Towns in Nova Scotia
List of towns in Nova Scotia	Settlements in Nova Scotia, Towns in Nova Scotia, Lists of settlements in Canada
List of villages in Nova Scotia	Settlements in Nova Scotia, Villages in Nova Scotia
Matthew P. Kennedy	1908 births, 1957 deaths, Sportspeople from New Jersey, People from Hoboken, New Jersey, Basketball, Referees
List of municipalities in Nova Scotia	Settlements in Nova Scotia, Lists of settlements in Canada
Khatuna Tskhadadze	1973 births, Translators, Writers from Georgia (country), People from Tbilisi, Living people
Morris County, New Jersey	18th-century establishments in New Jersey, 1730s establishments in the Thirteen Colonies, 1739 establishments, New Jersey counties
Fortnight	Units of time
Jiří Stránský	Poets, Novelists, Playwrights, Human rights activists, Anti-Communists, 1931 births, 2019 deaths, Czech screenwriters, Translators, Writers from Prague
Oxford, Mississippi	Cities in Mississippi, County seats in Mississippi
Włodzimierz Ptak	1928 births, 2019 deaths, Polish scientists, Microbiologists, Immunologists, People from Kraków
Claus von Bülow	1926 births, 2019 deaths, British lawyers, Critics, Socialites, People acquitted of murder, People from Copenhagen
Hartwig Löger	1965 births, Living people, Chancellors of Austria, Government ministers of Austria, Austrian businesspeople
Brigitte Bierlein	1949 births, Living people, Chancellors of Austria, Austrian lawyers, Politicians from Vienna, Women lawyers
James Marape	1971 births, Living people, Current national leaders, Prime Ministers of Papua New Guinea
Prime Minister of Papua New Guinea	Prime Ministers of Papua New Guinea
Stellarton	Towns in Nova Scotia
Michael Somare	1936 births, 2021 deaths, Deaths from pancreatic cancer, Prime Ministers of Papua New Guinea
Paulias Matane	1931 births, Living people, Governors-General of Papua New Guinea
Pictou	Towns in Nova Scotia
Governor-General of Papua New Guinea	Governors-General of Papua New Guinea
Bob Dadae	1961 births, Living people, Governors-General of Papua New Guinea
Freddy Buache	1924 births, 2019 deaths, Swiss writers, Swiss journalists, Movie critics, Swiss historians, People from Lausanne
Tornado outbreak of May 2019	Tornadoes in the United States, Tornado outbreaks, May 2019 events, 2019 in the United States, 2019 in weather
Kawasaki stabbings	2019 murders in Asia, 2010s crimes in Asia, 2010s in Japan, Mass stabbings, May 2019 events, Murder in 2019, Murder-suicides in Asia, Suicide in 2019
N-Dubz discography	Discographies
Judith Ortiz Cofer	American writers, 1952 births, 2016 deaths, Puerto Rican people
SNC-Lavalin	1910s establishments in Canada, 1911 establishments, Technology companies of Canada, Companies listed on the Toronto Stock Exchange, Montreal
Fritz Schösser	1947 births, 2019 deaths, Former members of the German Bundestag, Politicians from Bavaria, Politicians of the Social Democratic Party of Germany
Kritika Sharma	Living people, Indian actors
New Hope, Pennsylvania	Boroughs in Pennsylvania
Mark Harper	1970 births, Living people, Conservative MPs (UK), People from Wiltshire
Skyang Kangri	Karakoram, Xinjiang, Mountains of China, Gilgit-Baltistan, Mountains of Pakistan
Mulgrave, Nova Scotia	Towns in Nova Scotia
Mahone Bay, Nova Scotia	Towns in Nova Scotia
Richard Cordley	Lawrence, Kansas, 1829 births, 1904 deaths, Bleeding Kansas
2018–19 UEFA Europa League knockout phase	2018–19 UEFA Europa League, 2018–19 in UEFA football
Changtse	Himalayas, Mountains of China, Tibet
Bhumika Gurung	Indian television actors, Indian models, People from New Delhi, Living people, Year of birth missing (living people)
Laurie Hendren	1958 births, 2019 deaths, Canadian scientists, Cancer deaths in Quebec, Computer scientists, Cornell University alumni, Canadian educators, People from Ontario
Ingemar Skogö	1949 births, 2019 deaths, Civil servants, Governors, Swedish politicians
Roman temple	Ancient Rome, Temples
Tuulikki Ukkola	1943 births, 2019 deaths, Finnish politicians, Journalists
Kula Kangri	Tibet, Mountains of China, Himalayas
Chogolisa	Karakoram, Gilgit-Baltistan, Mountains of Pakistan
Frank Lucas	1930 births, 2019 deaths, American people convicted of drug offenses, People from Greensboro, North Carolina, People from Teaneck, New Jersey, Drug traffickers
Sinking of Hableány	21st century in Hungary, 2019 in Europe, 2019 disasters, May 2019 events, Budapest
Alan Smith (footballer, born 1921)	1921 births, 2019 deaths, Arsenal F.C. players, People from Newcastle upon Tyne
Edgeley Park	Football stadiums in England, Sport in Greater Manchester, Stockport, Greater Manchester
Never Really Over	Katy Perry songs, Dance-pop songs, 2019 songs
Charles L. Robinson	Lawrence, Kansas, 1818 births, 1894 deaths, Governors of Kansas, 19th-century American politicians, Kansas Republicans, People from Lawrence, Kansas
Broadgate Tower	Skyscrapers in the United Kingdom, Buildings and structures in London
Citypoint	Skyscrapers in the United Kingdom, Buildings and structures in London
Ani Yudhoyono	1952 births, 2019 deaths, Deaths from leukemia, First Ladies and Gentlemen of Indonesia
Virginia Beach shooting	2019 mass shootings, 2019 murders in the United States, 2010s in Virginia, Crime in Virginia, Mass murder in 2019, Mass murder in the United States, Mass shootings in the United States, May 2019 events, Murder in the 21st century in the United States, Virginia Beach, Virginia
Roky Erickson	1947 births, 2019 deaths, American rock guitarists, American rock singers, Singer-songwriters from Texas, Writers from Austin, Texas, Singers from Austin, Texas, Musicians from Austin, Texas
Oscar Martinez (The Office)	The Office (U.S. TV series) characters, Fictional gay males
Creed Bratton (character)	The Office (U.S. TV series) characters
Penny Mordaunt	1973 births, Living people, Privy Councillors (UK), Conservative MPs (UK), UK MPs 2010–2015, UK MPs 2015–2017, UK MPs 2017–2019, Royal Navy officers, People from Portsmouth, People from Devon
Paolo Babbini	1935 births, 2019 deaths, Italian politicians, People from Bologna, Socialist politicians
Tony DeLap	1927 births, 2019 deaths, American artists, People from Oakland, California
Bengt Rösiö	1927 births, 2019 deaths, Swedish writers, Swedish politicians, Political writers, Ambassadors of Sweden
Artois	History of France, Geography of France, Hauts-de-France
Joseph Cottet	1923 births, 2019 deaths, Canton of Fribourg, Swiss politicians
Simbach am Inn	Towns in Bavaria, Rottal-Inn
1/f noise	Equations, Sound
Upstream spying	National security, Espionage
List of airports in Canada	Airports in Canada, Canada-related lists, Lists of airports
Mario Baudoin	1942 births, 2019 deaths, Bolivian people, Biologists
Jan Levinson	The Office (U.S. TV series) characters
Melora Hardin	1967 births, Living people, American movie actors, American television actors, American voice actors, Actors from Houston, Texas, Actors from San Francisco
Sam Gyimah	1976 births, Living people, Conservative MPs (UK), Politicians from Buckinghamshire
Single-elimination tournament	Competitions, Football (soccer) terminology, Sports competitions, Sports words
John Myers (radio executive)	1959 births, 2019 deaths, British radio personalities, People from Cumbria
Momtazuddin Ahmed (dramatist)	1935 births, 2019 deaths, Bangladeshi playwrights, Bangladeshi educators
Alexey Kazannik	1943 births, 2019 deaths, Disease-related deaths in Russia, Russian educators, Russian lawyers, Russian politicians, Ukrainian people
Dhoti	Religious clothing, Indian culture, National symbols of India, Pakistani culture, Hinduism
Agent Cody Banks	Movies about bullying
Wilson Shannon	1802 births, 1877 deaths, Governors of Ohio, Governors of Kansas Territory, Ohio University alumni, Kansas Democrats, 19th-century American politicians
John W. Geary	1819 births, 1873 deaths, Governors of Kansas Territory, Kansas Democrats, Pennsylvania Republicans, 19th-century American politicians
Mart Nutt	1962 births, 2019 deaths, Estonian politicians, Estonian historians
Andrew Horatio Reeder	Governors of Kansas Territory, Kansas Democrats, Pennsylvania Republicans, 1807 births, 1864 deaths, 19th-century American politicians
Aphrophoridae	Agricultural pests, Hemiptera
Christian radio	Radio, Christianity
Charles Branscomb	1822 births, 1891 deaths, Lawrence, Kansas, 19th-century American politicians
Waterloo Wind Farm	Wind farms, Buildings and structures in Australia, South Australia
Barry Hughes	1937 births, 2019 deaths, Welsh footballers, Welsh football managers
János Horváth	1921 births, 2019 deaths, Hungarian economists, Hungarian politicians, Politicians from Indiana, US Republican Party politicians
Bertram Bowyer, 2nd Baron Denham	1927 births, Living people, British politicians
Susan Cunliffe-Lister, Baroness Masham of Ilton	1935 births, Living people, British politicians
Claes Andersson	1937 births, 2019 deaths, Finnish politicians, Finnish poets, Finnish musicians, Swedish politicians, Swedish poets, Swedish musicians, Psychiatrists, Jazz musicians, People from Helsinki
Jacob Söderman	1938 births, Living people, Finnish politicians, People from Helsinki
Jörn Donner	1933 births, 2020 deaths, Deaths from lung disease, Cancer survivors, Finnish politicians, Novelists, Finnish screenwriters, Finnish movie directors, Finnish movie producers, Critics, Former MEPs, People from Helsinki
Erkki Tuomioja	1946 births, Living people, Finnish politicians, People from Helsinki
Otto Schily	1932 births, Living people, German politicians
Heinz Riesenhuber	1935 births, Living people, German politicians, People from Frankfurt
David Wilson, Baron Wilson of Tillyorn	1935 births, Living people, Governors of Hong Kong, Scottish politicians
Béla Turi-Kovács	1935 births, Living people, Hungarian politicians
Tengku Razaleigh Hamzah	1937 births, Living people, Malaysian politicians, Malaysian businesspeople
Jonathan Hunt (New Zealand politician)	1938 births, Living people, New Zealand politicians
Robin Gray (New Zealand politician)	1931 births, Living people, New Zealand politicians
Russell Marshall	1936 births, Living people, New Zealand politicians
Vladimir Dolgikh	1924 births, 2020 deaths, Russian politicians
Dragoljub Mićunović	1930 births, Living people, Serbian politicians
Manolis Glezos	1922 births, 2020 deaths, Deaths from heart failure, Former MEPs, Greek politicians, Political activists
Leyland Motors	1896 establishments in England, 1960s disestablishments in England, 1968 disestablishments, British transport companies, Lancashire
Leyland, Lancashire	Towns in Lancashire, Coordinates on Wikidata, Pages with unreviewed translations
Alistair Browning	1954 births, 2019 deaths, Deaths from cancer, New Zealand movie actors, New Zealand stage actors, New Zealand television actors, New Zealand voice actors, People from Dunedin
Ang Mo Kio MRT station	Mass Rapid Transit (Singapore) stations, 1987 establishments in Asia, 20th century establishments in Singapore
First Spouses of Indonesia	First Ladies and Gentlemen of Indonesia, Lists of people
Arne Lyngstad	1962 births, 2019 deaths, Deaths from cancer, Norwegian politicians
Paul Darrow	1941 births, 2019 deaths, Deaths from aortic aneurysm, English movie actors, English television actors, English voice actors, English stage actors, English radio actors, Actors from Surrey
Ken Matthews	1934 births, 2019 deaths, British male athletes, British Olympic gold medalists, Medalists at the 1964 Summer Olympics, Members of the Order of the British Empire, Sportspeople from Birmingham
Grant Hammond	1940s births, 2019 deaths, New Zealand judges, New Zealand academics, People from North Island
Atsushi Aoki	1977 births, 2019 deaths, Japanese professional wrestlers, Road accident deaths, Sportspeople from Tokyo
Richard Hammond	1969 births, Living people, BBC television presenters, English autobiographers, English children's writers, English journalists, English radio personalities, English science writers, English television presenters, People from Solihull
James May	1963 births, Living people, BBC television presenters, English journalists, English television presenters, People from Bristol
Patricia Bath	1942 births, 2019 deaths, Cancer deaths in San Francisco, American inventors, American philanthropists, American educators, American physicians, Businesspeople from New York City, Scientists from New York City
Stanley Tigerman	1930 births, 2019 deaths, Architects from Chicago, Businesspeople from Chicago, American educators, American Jews, Deaths from COPD, Disease-related deaths in Chicago, Illinois
Maciej Parowski	1946 births, 2019 deaths, Polish journalists, Polish essayists, Editors, European translators, Writers from Warsaw
Geevarghese Mar Timotheos	1928 births, 2019 deaths, People from Kerala, Roman Catholic bishops
Nechama Rivlin	1945 births, 2019 deaths, Deaths from surgical complications, Hebrew University of Jerusalem alumni, Israeli Jews, Deaths from pulmonary fibrosis
Nick Yakich	1940 births, 2019 deaths, Australian rugby league players, Sportspeople from New South Wales, Sportspeople from Queensland
Knut Fredriksson	1930 births, 2019 deaths, 1960 Summer Olympics, Swedish Olympians
Mike Möllensiep	1975 births, 2019 deaths, Cancer deaths in Germany, German footballers, German football managers, People from Gelsenkirchen, Sportspeople from North Rhine-Westphalia
Werner Weist	1949 births, 2019 deaths, German footballers, Sportspeople from North Rhine-Westphalia
Geoff Toseland	1931 births, 2019 deaths, English footballers, People from Northamptonshire
Valentyn Sapronov	1932 births, 2019 deaths, Ukrainian football managers, Ukrainian footballers
Brexit Party	Brexit, Eurosceptic parties, Political parties in the United Kingdom, 2010s establishments in the United Kingdom, 2019 establishments in Europe
Manfred Burgsmüller	1949 births, 2019 deaths, German footballers, Sportspeople from Essen
2019 Darwin shooting	2019 mass shootings, 2010s in Australia, Crime in Australia, June 2019 events, Northern Territory
Jason Marcano	1983 births, 2019 deaths, Road accident deaths, Trinidad and Tobago footballers
Jurica Jerković	1950 births, 2019 deaths, 1974 FIFA World Cup players, 1982 FIFA World Cup players, Croatian footballers
Benidorm	Cities in Valencia (autonomous community), Municipalities in Valencia (autonomous community)
Josep Mussons	1925 births, 2021 deaths, Sports commentators, Spanish businesspeople, People from Barcelona, Deaths from the COVID-19 pandemic in Spain
Ben Weese	1929 births, Living people, American philanthropists, People from Evanston, Illinois, Businesspeople from Chicago, Architects from Chicago
Javier Barreda Jara	1966 births, 2019 deaths, Deaths from myocardial infarction, People from Lima, Peruvian politicians
Sunila Karambelkar	Indian movie actors, Living people, Year of birth missing (living people), Indian television actors
Sandy Koufax	1935 births, Living people, American baseball players, Jewish American sportspeople, Los Angeles Dodgers players, National League All-Stars, Sportspeople from Brooklyn
Al Kaline	1934 births, 2020 deaths, American baseball players, American League All-Stars, Detroit Tigers players, Sportspeople from Baltimore, Maryland
Knox Martin	1923 births, Living people, American painters, American sculptors, People from Barranquilla
Saifia	Sufism, Religion in Pakistan
Area code 785	Area codes in the United States
Area code 202	Area codes in the United States
Area code 316	Area codes in the United States
Area code 313	Area codes in the United States
Area code 989	Area codes in the United States
David Eby	1977 births, Living people, Attorneys general, Canadian activists, Civil rights activists, Canadian lawyers, Canadian businesspeople, Politicians from Ontario, People from Vancouver, Canadian Queen's Counsel
South Bronx	The Bronx, Neighborhoods of New York City
Billy Gabor	1922 births, 2019 deaths, American basketball players, Deaths from pneumonia, Infectious disease deaths in Florida, Sportspeople from New York, People from Binghamton, New York
George Darwin (footballer)	1932 births, 2019 deaths, English footballers, Sportspeople from  County Durham
Pogo TV	Indian television
Alcide M. Lanoue	1934 births, 2021 deaths, American generals, American physicians, Harvard University alumni, Scientists from New York, Yale University alumni
Ronald R. Blanck	1941 births, Living people, American generals, American physicians, People from Pennsylvania
Patrick Faber	1978 births, Living people, Belizean politicians
Tornike Kvitiya	1992 births, Living people, Russian footballers
Infanticide	Death, Population
Mark A. Hershkovitz	Living people
Hays, Kansas	Cities in Kansas, County seats in Kansas
Elio Sgreccia	1928 births, 2019 deaths, Biologists, Cardinals of the Roman Catholic Church, Italian Roman Catholics
Ellis County, Kansas	1867 establishments in Kansas, Kansas counties
Lawrie Leslie	1935 births, 2019 deaths, British association football goalkeepers, Scottish footballers, Sportspeople from Edinburgh, West Ham United F.C. players
Daniel Mora	1945 births, Peruvian politicians, South American military people, Living people
Carolyn Wilkins	Living people, Canadian politicians, Women politicians
Carrot and Stick	Psychology
Servant of the People	Sluga narodu, Workplace comedy television series, Interlanguage link template link number, 2010s comedy-drama television series, Ukrainian culture, Satirical television series
Kansas House of Representatives	Government of Kansas, State lower houses in the United States
Kansas Senate	Government of Kansas, State upper houses in the United States
Compaq	1980s establishments in Texas, 1982 establishments in the United States, 21st-century disestablishments in Texas, 2002 disestablishments in the United States, American technology companies, Companies based in Houston
Thomas J. Watson	1874 births, 1956 deaths, American chief executives, American Methodists, Democrats (United States), Businesspeople from New York City, People from Manhattan
Ben Bocquelet	Television directors, Animators, Emmy Award winners
Doudelainville	Communes in Somme
Beauval, Somme	Communes in Somme
Becquigny, Somme	Communes in Somme
Berneuil, Somme	Communes in Somme
Famechon, Somme	Communes in Somme
Andrew Sinclair	1935 births, 2019 deaths, Biographers, British critics, English historians, English movie directors, English novelists, English screenwriters, People from Oxford, Writers from Oxfordshire
Keith Birdsong	1959 births, 2019 deaths, Road accident deaths, American illustrators, People from Oklahoma
Peter Toogood	1930 births, 2019 deaths, Golfers, Sportspeople from South Australia
Bob Pettit	1932 births, Living people, American basketball players, Atlanta Hawks players, People from Baton Rouge, Louisiana, Sportspeople from Louisiana, National Basketball Association players with retired numbers
Bob Cousy	1928 births, Living people, American basketball players, Boston Celtics players, People from Manhattan, Sacramento Kings players, Sportspeople from New York City, National Basketball Association players with retired numbers
Robert A. Whitney	1935 births, Living people, American physicians, Scientists from Oklahoma City, Surgeon Generals of the United States, Veterinarians
Audrey F. Manley	1934 births, Living people, African-American people, American educators, Scientists from Mississippi, American physicians, People from Jackson, Mississippi, Surgeon Generals of the United States
Mark Camacho	1961 births, British actors, British screenwriters, British television writers, British television directors, Living people, People from Manchester
Redwood National and State Parks	Biosphere reserves, National parks in the United States, World Heritage Sites in the United States, Western United States, California, 1968 establishments in the United States
Egyptian Military Academy	1811 establishments
Pamela Rendi-Wagner	1971 births, Living people, Sportspeople from Vienna
Fiddler on the Roof	Musicals
Imposter syndrome	Personality disorders, Psychology, Syndromes
List of Google products	Computer-related lists
Johnny Robinson (footballer)	1936 births, 2019 deaths, English footballers, Sportspeople from Lancashire
Jan Karwecki	1949 births, 2019 deaths, Association football goalkeepers, Polish footballers
What's Up?	1993 songs, Pop rock songs
Gualterio Looser	Chilean scientists, Botanists
Karl Friedrich Reiche	German botanists
Rathlin Island	Settlements in County Antrim, Islands of the United Kingdom, Parishes
Causes of World War I	World War I
Ocyroe	Asteraceae
Whistle Down the Wind (1996 musical)	Musicals
Robin Herd	1939 births, 2019 deaths, Alumni of the University of Oxford, Commanders of the Order of the British Empire, English businesspeople, Formula One people, People from Lancashire
Coins and postage stamps of Sealand	Currency of Europe
City commission government	Local government in the United States
Lunenburg, Nova Scotia	Towns in Nova Scotia
Lockeport	Towns in Nova Scotia
Kentville	Towns in Nova Scotia
Baddeck	Villages in Nova Scotia
List of former capitals of Japan	Japan-related lists, Lists of cities
Froma Harrop	Writers from New York City, American political commentators, 1950 births, Living people
List of people from Lawrence, Kansas	Lists of American people, People from Kansas, Kansas-related lists
Battle royale game	Video game genres
List of African-American basketball players	African-American basketball players, Lists of sportspeople
It Takes Two	1995 comedy movies, American comedy movies, Movies set in New York City, Movies directed by Andy Tennant
Pascal Siakam	Toronto Raptors players, 1994 births, Living people, Cameroonian people
Narciso Ibáñez Serrador	1935 births, 2019 deaths, Deaths from urinary tract infection, Infectious disease deaths in Spain, People from Montevideo, Spanish movie actors, Spanish movie directors, Spanish movie producers, Spanish screenwriters, Spanish television actors
Alexander Kuznetsov (actor)	1959 births, 2019 deaths, American movie actors, American stage actors, American television actors, Russian movie actors, Russian television actors
Nonnie Griffin	1933 births, 2019 deaths, Actors from Toronto, Canadian movie actors, Canadian stage actors, Canadian television actors, Canadian voice actors, Deaths from aortic aneurysm
Charles Tupper	1821 births, 1915 deaths, Premiers of Nova Scotia, Prime Ministers of Canada, Privy Councillors (Canada), Leaders of the Opposition (Canada)
Welsh orthography	Welsh culture, Alphabets
Decimal degrees	Coordinate systems, Geography
Justin Edinburgh	1969 births, 2019 deaths, Deaths from cardiac arrest, English footballers, English football managers, Sportspeople from Essex, Tottenham Hotspur F.C. players, Premier League players
Ryszard Bugajski	1943 births, 2019 deaths, Disease-related deaths in Poland, Polish movie directors, Polish screenwriters, Writers from Warsaw
Allegheny, Pennsylvania	Cities in Pennsylvania, History of Pennsylvania, Pittsburgh, Pennsylvania
Andre Matos	1971 births, 2019 deaths, Deaths from myocardial infarction, Brazilian musicians, Brazilian singers, Composers, Heavy metal singers, People from São Paulo, Pianists
Frankincense	Natural materials
Capsize	Boats, Science, Maritime disasters
Blanca Suárez	1988 births, Living people, Spanish movie actors, Spanish television actors, Spanish models, Actors from Madrid
Clarence Avant	1931 births, Living people, Record producers, American movie producers, Businesspeople from North Carolina
Tony Rodham	1954 births, 2019 deaths, American political commentators, Businesspeople from Chicago, Hillary Rodham Clinton
Lucho Avilés	1938 births, 2019 deaths, Argentine writers, Deaths from myocardial infarction, Argentine journalists, People from Montevideo, Television presenters
Meddle	Pink Floyd albums, 1971 albums, Rock albums
Pulse (album)	1995 albums, Pink Floyd albums
Shine On You Crazy Diamond	1975 songs, Pink Floyd songs
Wish You Were Here (song)	1975 songs, Pink Floyd songs
Delicate Sound of Thunder	Pink Floyd albums, 1988 establishments
Jorge Brovetto	1933 births, 2019 deaths, Academics, Uruguayan educators, People from Montevideo, Uruguayan politicians, Engineers
Norman Dewis	1920 births, 2019 deaths, British engineers, English racecar drivers, Officers of the Order of the British Empire, People from Coventry, Sportspeople from Warwickshire
Alejandro Jadresic	1956 births, 2019 deaths, Academics, Chilean politicians, Deaths from brain cancer, Chilean economists, Chilean engineers, Harvard University alumni
Evangelina García Prince	1934 births, 2019 deaths, Academics, Activists, Feminists, Venezuelan politicians
Jess Wade	Living people, Science, British activists, British physicists
Devon Rex	Cats
Tabebuia	Bignoniaceae
Cree	First Nations
Girish Karnad	1938 births, 2019 deaths, Deaths from multiple organ failure, Disease-related deaths in India, Indian movie actors, Indian television actors, Indian stage actors, Indian movie directors, Indian playwrights, Indian screenwriters
Sonam Kapoor	1985 births, Living people, Indian movie actors, Indian television actors, Indian models, Indian philanthropists
Anil Kapoor	1956 births, Living people, Indian movie actors, Indian television actors, Indian stage actors, Indian movie producers
Katrina Kaif	1983 births, Living people, English movie actors, English television actors, English models
Dalyan	Settlements in Turkey, Towns in Asia, Towns in Europe
Robert Cohan	1925 births, 2021 deaths, American dancers, American choreographers, British dancers, Entertainers from New York City
Frank Lucchesi	1927 births, 2019 deaths, American baseball players, Sportspeople from San Francisco, Sportspeople from Dallas, Texas
Colleyville, Texas	Cities in Texas, Settlements in Tarrant County, Texas
Noémi Ban	1922 births, 2019 deaths, Naturalized citizens of the United States, Holocaust survivors, American educators, Hungarian people, American Jews
Bellingham, Washington	County seats in Washington, Cities in Washington (U.S. state)
Albert Rohan	1936 births, 2019 deaths, Austrian politicians
S. L. Bhyrappa	1934 births, Living people, Indian novelists
Rajeev Taranath	1932 births, Living people, Composers, Indian musicians
Paul Lieberstein	1967 births, Living people, American movie actors, American television actors, American television directors, American television producers, American television writers, Actors from Connecticut, Screenwriters from Connecticut
Yevgeny Dzhugashvili	Russian politicians, 1936 births, 2016 deaths
Crazy Mohan	1952 births, 2019 deaths, Cardiovascular disease deaths in India, Deaths from myocardial infarction, Indian comedians, Indian movie actors, Indian playwrights, Indian screenwriters, People from Tamil Nadu
Government of Ghana	Ghana
Duma (genus)	Caryophyllales
List of neuroscientists	Neuroscientists, Lists of scientists
Duma florulenta	Asterales
Master (musician)	1988 births, People from Tbilisi, Rap musicians
Kansas Department of Transportation	State agencies of Kansas, State departments of transportation in the United States
Kansas Department of Corrections	State agencies of Kansas
Lee Hee-ho	1922 births, 2019 deaths, Activists, Deaths from liver cancer, First Ladies, People from Seoul
Erich Iltgen	1940 births, 2019 deaths, People from Cologne, Politicians from North Rhine-Westphalia, Politicians from Saxony, Politicians of the Christian Democratic Union of Germany
Kansas Department of Health and Environment	State agencies of Kansas
Juhani Wahlsten	1938 births, 2019 deaths, 1960 Winter Olympics, 1964 Winter Olympics, 1968 Winter Olympics, Finnish Olympians, Finnish ice hockey players, Sportspeople from Helsinki
William D. Wittliff	1940 births, 2019 deaths, American novelists, American photographers, American screenwriters, Cardiovascular disease deaths in Texas, Deaths from myocardial infarction, Writers from Texas
Gabriele Grunewald	1986 births, 2019 deaths, American track and field athletes, Cancer deaths in Minnesota, Deaths from salivary gland cancer, Deaths from liver cancer, Sportspeople from Minnesota
Sinistrophobia	Phobias
2019 NBA Finals	2010s in Toronto, 2019 in sports, 2019 in the United States, Golden State Warriors, Toronto Raptors, 2010s in California, 2019 in California
Julia Kristeva	1941 births, Living people, French feminists, French literary critics, Feminist writers, Continental philosophers, Columbia University faculty, Bulgarian writers
Linda Collins-Smith	1961 births, 2019 deaths, Deaths by firearm in the United States, State legislators of the United States, Businesspeople from Arkansas, Politicians from Arkansas, US Republican Party politicians
Jonathan Nichols (politician)	1965 births, 2019 deaths, Deaths by firearm in the United States, State legislators of the United States, American lawyers, US Republican Party politicians, People from Norman, Oklahoma, Politicians from Oklahoma
Paul "Lil' Buck" Sinegal	1944 births, 2019 deaths, American blues singers, American blues musicians, American singer-songwriters, American guitarists, American songwriters, Musicians from Louisiana, Singers from Louisiana, Writers from Louisiana, People from Lafayette, Louisiana
Wang Jun (businessman)	1941 births, 2019 deaths, Chinese politicians, Chinese businesspeople
Son Myung-soon	1929 births, Living people, South Korean people, First Ladies
Megathrust earthquake	Earthquakes
Valeria Valeri	1921 births, 2019 deaths, Actors from Rome, Italian movie actors, Italian stage actors, Italian television actors, Italian voice actors
Gavin Robertson	1966 births, Living people, Australian cricketers, People with cancer, Sportspeople from Sydney
Ellicott City, Maryland	Unincorporated communities in Maryland, Census-designated places in Maryland, County seats in Maryland
Pontyberem	Villages in Wales
Joël Matip	1991 births, Living people, 2010 FIFA World Cup players, 2014 FIFA World Cup players, Cameroonian footballers, German footballers, Liverpool F.C. players, Sportspeople from North Rhine-Westphalia
Maidenhead (UK Parliament constituency)	Constituencies in the United Kingdom
Ryan Phillippe	1974 births, Living people, Actors from Delaware, American movie actors, American television actors
Whitey Herzog	1931 births, Living people, American baseball players, Baltimore Orioles players, Detroit Tigers players, Kansas City Athletics players, Sportspeople from Illinois, Washington Nationals players
WonderCon	1987 establishments in California, Festivals in the United States
Mark Giordano	1983 births, American Hockey League players, Calgary Flames players, Canadian ice hockey defencemen, Ice hockey people from Ontario, James Norris Memorial Trophy winners, Living people, Ontario Hockey League players, Sportspeople from Toronto
Lone Star, Kansas	Unincorporated communities in Douglas County, Kansas
Stull, Kansas	Unincorporated communities in Douglas County, Kansas
List of Pixar shorts	Pixar
Clinton, Kansas	Unincorporated communities in Douglas County, Kansas
Lone Star Lake	Lakes of Kansas, Bodies of water of Douglas County, Kansas
Tompall & the Glaser Brothers	Musicians from Nebraska
Tompall Glaser	1933 births, 2013 deaths, American country singers, Singers from Nebraska
Spalding, Nebraska	Villages in Nebraska
Karl Hurm	1930 births, 2019 deaths, German painters
Domenico De Simone	1926 births, 2019 deaths, Communist politicians, Italian politicians, Mayors, People from Apulia
Noel Lloyd	1946 births, 2019 deaths, Academics of the University of Cambridge, British academics, British mathematicians, Commanders of the Order of the British Empire, Welsh people
Kamalamai	Municipalities of Nepal
Podar Schools	Education in India
Damian Lewis	1971 births, Living people, Actors from London, English movie actors, English movie producers, English radio actors, English stage actors, English television actors, English voice actors, Officers of the Order of the British Empire, People educated at Eton College
Velvel Pasternak	1933 births, 2019 deaths, American composers, American conductors, American record producers, Jewish American musicians, Musicians from New York City, Musicians from Toronto, Musicologists
Philomena Lynott	1930 births, 2019 deaths, Deaths from lung cancer, Irish writers, Irish businesspeople, People from Dublin
Billy McKee	1921 births, 2019 deaths, Anti-Communists, Political activists, Criminals, People from Belfast
Bob Harrison (basketball)	1927 births, Living people, American basketball players, Atlanta Hawks players, Los Angeles Lakers players, People from Toledo, Ohio, Philadelphia 76ers players, Sportspeople from Ohio
1982 Stanley Cup Finals	Stanley Cup Finals
I Marine Expeditionary Force	United States Marine Corps, 1969 establishments in the United States
Steve Watkins	1976 births, Living people, 21st-century American politicians, Kansas Republicans
Jordi Sierra i Fabra	Spanish writers, Children's writers, 1947 births, People from Barcelona
Massachusetts Street	Lawrence, Kansas, National Register of Historic Places in Douglas County, Kansas, Historic districts in the United States
Kansas River	Rivers of Kansas, Bodies of water of Douglas County, Kansas
Wakarusa River	Rivers of Kansas, Bodies of water of Douglas County, Kansas
Pervis Ellison	1967 births, Sacramento Kings players, Washington Bullets players, Boston Celtics players, Seattle SuperSonics players, African-American basketball players, Sportspeople from Georgia (U.S. state), People from Savannah, Georgia, Living people, American basketball players
Herb White	1948 births, Atlanta Hawks players, American basketball players, Valdosta, Georgia, Living people
Sylvia Miles	1924 births, 2019 deaths, Deaths from respiratory failure, Deaths from anemia, Disease-related deaths in New York City, American movie actors, American television actors, American stage actors, Actors from New York City
Wim Betz	1943 births, 2019 deaths, Belgian physicians, Belgian educators
Sarah Nicole Jones	American screenwriters, DC Comics
Armand De Decker	1948 births, 2019 deaths, Belgian mayors, Brussels-Capital Region politicians, Mouvement réformateur (Belgium) politicians, People from Brussels
Léon Kalenga Badikebele	1956 births, 2019 deaths, Roman Catholics, People from the Democratic Republic of the Congo
2019–20 Hong Kong protests	2019 in Asia, 2020 protests in Asia, March 2019 events, April 2019 events, May 2019 events, June 2019 events, July 2019 events, August 2019 events, September 2019 events, October 2019 events, November 2019 events, December 2019 events, January 2020 events, History of Hong Kong
2019 Danish general election	June 2019 events, 2010s in Denmark
Dermatophyllum	Faboideae
Suskityrannus	Tyrannosaurids
Ashleigh Barty	1996 births, Living people, Australian cricketers, Australian tennis players, Female tennis players, French Open champions, Indigenous Australian sportspeople, Sportspeople from Queensland, US Open (tennis) champions
Deaths in December 2016	2016 deaths, December 2016 events
Diane Baker	1938 births, Living people, Actors from Los Angeles, California, American educators, American movie actors, American movie producers, American television actors
Bernie Taupin	1950 births, Living people, English poets, English rock musicians, English singer-songwriters, Golden Globe Award winners, Writers from Lincolnshire
Illumination (company)	2007 establishments in California, Movie studios
New Jersey Department of Transportation	State departments of transportation in the United States, 1966 establishments in the United States
JDSU	1981 establishments in Canada, Technology companies of Canada, Ottawa
Daemonologie	Magic (paranormal), Witchcraft
Shade-loving plants	Plants, Gardening
List of Korean family names	Korean-language surnames, Korean culture, Surnames
Edith González	1964 births, 2019 deaths, Cancer deaths in Mexico, Child actors, Dancers, Deaths from ovarian cancer, Mexican movie actors, Mexican stage actors, Mexican television actors, People from Monterrey
Australians for Constitutional Monarchy	1992 establishments in Australia
Wilhelm Wieben	1935 births, 2019 deaths, Gay men, German journalists, German LGBT people, German television actors, LGBT writers, People from Schleswig-Holstein
Istanbul University	15th century establishments in Europe, 15th century establishments in Asia, 1450s establishments, Colleges and universities in Turkey, Istanbul, Establishments in Turkey
Gar	Ray-finned fish
Igor Solopov	1961 births, 2019 deaths, 1992 Summer Olympics, Estonian sportspeople, Soviet sportspeople, Table tennis players
Exodusters	African-American people, 19th century in Kansas
Lover (Taylor Swift album)	Taylor Swift, 2010s albums
History of Kansas	History of Kansas
Jerome Lane	1966 births, African-American basketball players, Cleveland Cavaliers players, Denver Nuggets players, Indiana Pacers players, Living people, Milwaukee Bucks players, American basketball players
Run Like Hell	1980 songs, Pink Floyd songs
In the Flesh?	1979 songs, Pink Floyd songs
The Thin Ice	1979 songs, Pink Floyd songs
Pat Bowlen	1944 births, 2019 deaths, Businesspeople from Denver, Colorado, Businesspeople from Wisconsin, Deaths from Alzheimer's disease, Denver Broncos, Disease-related deaths in Colorado, Sportspeople from Denver, Colorado, Sportspeople from Wisconsin
Şeref Has	1936 births, 2019 deaths, People from Istanbul, Turkish footballers
Geoff Lees (footballer)	1933 births, 2019 deaths, English footballers, Sportspeople from Yorkshire
Carl Bertelsen	1937 births, 2019 deaths, Danish footballers, Deaths from Alzheimer's disease
Kyle Lowry	1986 births, African-American basketball players, Houston Rockets players, Living people, Medalists at the 2016 Summer Olympics, Memphis Grizzlies players, Toronto Raptors players, American basketball players
Northumbrian smallpipes	Woodwind instruments
Musical.ly	2014 establishments in California, Social networking
Missouri Territory	History of Missouri
Osage River	Rivers of Missouri
Great American Desert	Landforms of the United States, Deserts, 19th century in the United States
Elfriede Ott	1925 births, 2019 deaths, Austrian movie actors, Austrian television actors, Austrian stage actors, Austrian singers, Austrian educators, Actors from Vienna
Shawnee, Kansas	Cities in Johnson County, Kansas
Area code 913	Area codes in the United States
Liverpool John Lennon Airport	1930s establishments in England, 1935 establishments in Europe, Airports in England, Liverpool, Merseyside
You Need to Calm Down	Taylor Swift songs, 2019 songs, Synth-pop
Nick Nurse	1967 births, Living people, National Basketball Association coaches
Leonid Kuchma	1938 births, Living people, Presidents of Ukraine, Prime Ministers of Ukraine
Leonid Kravchuk	1934 births, Living people, Presidents of Ukraine, Legislative speakers, Communists
Vitold Fokin	1932 births, Living people, Prime Ministers of Ukraine
Lucile Randon	1904 births, Living people, French people, Supercentenarians
Fiscal conservatism	Economics
Tasmanian Devil (Looney Tunes)	Looney Tunes, Fictional characters introduced in the 1950s, Fictional animals
Johnny English Strikes Again	2018 comedy movies, 2010s spy movies, British comedy movies, British spy movies
Max Headroom broadcast signal intrusion	1987 in the United States, 1980s in Chicago
Ricardo Migliorisi	1948 births, 2019 deaths, Painters, Architects, Paraguayan people
Wilhelm Holzbauer	1930 births, 2019 deaths, Austrian architects, People from Vienna
John Dean	1938 births, Living people, American lawyers, American criminals, American political writers, American critics, Writers from Akron, Ohio, Politicians from Akron, Ohio
Stubbs, Kansas	Unincorporated communities in Barber County, Kansas
Deerhead, Kansas	Unincorporated communities in Barber County, Kansas
Pixley, Kansas	Unincorporated communities in Barber County, Kansas
Classic car	Automobiles
Ides of March	Ancient Rome
Hyde amendment	Abortion, United States federal legislation
Kevin Killian	1952 births, 2019 deaths, American editors, American LGBT people, American novelists, American playwrights, American poets, Gay men, LGBT novelists, LGBT playwrights, LGBT poets, Writers from New York
Marta Harnecker	1937 births, 2019 deaths, Chilean journalists, Communists, Political scientists, South American sociologists
2015 Cricket World Cup	Cricket World Cup, 2015 in sports, 21st century in Australia, 2010s in New Zealand, Sport in Australia, Sport in New Zealand
Bernard M. Judge	1940 births, 2019 deaths, Deaths from pancreatic cancer, Cancer deaths in Chicago, Journalists from Chicago, People from Oak Park, Illinois
Erzsébet Gulyás-Köteles	1924 births, 2019 deaths, 1948 Summer Olympics, 1952 Summer Olympics, 1956 Summer Olympics, Hungarian gymnasts, Olympic bronze medalists, Olympic gold medalists, Olympic silver medalists, Sportspeople from Budapest
Eagle Eye	2008 action movies, 2000s action thriller movies, American action thriller movies, Drone movies
Iceni	Celtic peoples
Round-robin tournament	Sports competitions
Bob Gibson	1935 births, 2020 deaths, Deaths from pancreatic cancer, African-American baseball players, Major League Baseball broadcasters, National League All-Stars, Sportspeople from Omaha, Nebraska, St. Louis Cardinals players
Simona Mafai De Pasquale	1928 births, 2019 deaths, Cardiovascular disease deaths in Italy, Communist politicians, Deaths from stroke, Italian communists, Politicians from Rome
Break up with your girlfriend, i'm bored	Ariana Grande songs, 2019 songs
List of JoJo's Bizarre Adventure characters	Lists of fictional characters, Anime characters
Hirohiko Araki	People from Sendai, 1960 births, Living people
Omnitrans	Bus transport, Transport in California
Dilraba Dilmurat	Chinese movie actors, Chinese television actors, Living people, 1992 births, Chinese singers
Dunkirk, Kansas	Unincorporated communities in Kansas, Crawford County, Kansas
Yaggy, Kansas	Unincorporated communities in Kansas
Duluth, Kansas	Unincorporated communities in Kansas
Swan River Colony	Settlements in Australia, Western Australia
Philipp Bobkov	1925 births, 2019 deaths, Russian people, Ukrainian people
2019 Memorial Cup	2019 in Canada, Memorial Cup
Shōjo manga	Anime, Comics, Japanese culture, Manga
Taft, Texas	Cities in Texas
New Athens, Illinois	Villages in Illinois
Steamboat Springs, Colorado	Cities in Colorado, County seats in Colorado
Destrehan, Louisiana	Census-designated places in Louisiana
Kirksville, Missouri	Cities in Missouri, County seats in Missouri
Kenova, West Virginia	Cities in West Virginia
Raiford, Florida	Towns in Florida
La Grange, North Carolina	Towns in North Carolina
Perham, Minnesota	Cities in Minnesota
Darwin Hindman	1933 births, 2019 deaths, American lawyers, American mayors, Deaths from lung disease, Disease-related deaths in Missouri, Military people from Ohio, Politicians from Missouri, Politicians from Columbus, Ohio, United States Air Force
Kingdom of Talossa	Antarctic territorial claims, Geography of Antarctica, Micronations, Milwaukee, Wisconsin, Republics
Greenwich, Kansas	Unincorporated communities in Sedgwick County, Kansas
Clonmel, Kansas	Unincorporated communities in Sedgwick County, Kansas
Schulte, Kansas	Unincorporated communities in Sedgwick County, Kansas
Sedgwick County, Kansas	1867 establishments in Kansas, Sedgwick County, Kansas
Mashina Vremeni	Russian musical groups
Frank LaMere	1950 births, 2019 deaths, Deaths from cholangiocarcinoma, American political activists, Politicians from Nebraska, US Democratic Party politicians
South Sioux City, Nebraska	Cities in Nebraska
Bishop Bullwinkle	1948 births, 2019 deaths, Deaths from myocardial infarction, Cardiovascular disease deaths in Florida, Comedians from Florida, Singers from Tampa, Florida
Lindsey Way	Living people, American bass guitarists, 1976 births
Haggis	Meat dishes
Salvatore Senese	1935 births, 2019 deaths, Italian politicians, Jurists, People from Calabria
Chang Liyi	1929 births, 2019 deaths, Spies, Aviators, Deaths from myocardial infarction
Daniel Colin	1933 births, 2019 deaths, French mayors, Politicians from Paris
Charles A. Reich	1928 births, 2019 deaths, American educators, American environmentalists, American political writers, Writers from New York City
June 2019 Gulf of Oman incident	2019 in Asia, 2010s in Iran, June 2019 events, Oman
A. B. Yehoshua	1936 births, Living people, Israeli Jews, Israeli writers, Israeli journalists, Essayists, People from Jerusalem
Makibishi	Japanese weapons
Dover, Nova Scotia	Villages in Nova Scotia
Amos Adams Lawrence	Bleeding Kansas, 1814 births, 1886 deaths, American activists, American philanthropists, People from Massachusetts
Area code 620	Area codes in the United States
Stephen Blaire	1941 births, 2019 deaths, American Roman Catholics, People from Los Angeles, California, Roman Catholic bishops
Area code 808	Area codes in the United States
Area code 802	Area codes in the United States
Music and Lyrics	2007 movies, American musical movies, American romantic comedy movies, 2000s musical movies, 2000s romantic comedy movies
Area code 307	Area codes in the United States
Friederike de Haas	1944 births, 2019 deaths, Politicians from Saxony, Politicians of the Christian Democratic Union of Germany
Area code 701	Area codes in the United States
Area code 401	Area codes in the United States
Hideki Matsui	1974 births, Japanese baseball players, American League All-Stars, Los Angeles Angels of Anaheim players, New York Yankees players, Oakland Athletics players, Tampa Bay Rays players, People from Ishikawa Prefecture, Living people
Shohei Ohtani	1994 births, Japanese baseball players, Los Angeles Angels of Anaheim players, Los Angeles Angels players, People from Iwate Prefecture, Living people
Ebert Van Buren	1924 births, 2019 deaths, American football running backs, Honduran people, Philadelphia Eagles players, Sportspeople from Louisiana
Hatsuko Morioka	1915 births, Possibly living people, 1936 Summer Olympics, Japanese swimmers, People from Wakayama Prefecture
Jiao Ruoyu	1915 births, Living people, Ambassadors of China, Centenarians, Chinese communist politicians, Mayors
Mary Ward (actress)	1915 births, 2021 deaths, Actors from Western Australia, Australian movie actors, Australian radio personalities, Australian stage actors, Australian television actors, Centenarians
Water supply system	Engineering, Microbiology, Water, Plague
Hermann Baumann (wrestler)	1921 births, Possibly living people, 1948 Summer Olympics, Olympic bronze medalists, Swiss Olympic medalists, Wrestlers
Carl-Göran Ekerwald	1923 births, Living people, Literary critics, Essayists, Swedish critics, Swedish educators, Swedish novelists, Teachers
Milena Djukic	Yugoslavian sportspeople, Basketball players, 1960 births, Living people
Jon Ola Norbom	1923 births, 2020 deaths, Economists, Norwegian politicians
Tom Hughes (Australian politician)	1923 births, Living people, Attorneys General of Australia, Australian lawyers, Australian military people, Legion of Honour, Liberal Party of Australia politicians, Military personnel of World War II, Order of Australia, Politicians from Sydney
Andry Rajoelina	1974 births, Living people, Presidents of Madagascar, Current national leaders, African businesspeople, Mayors
Désiré Rakotoarijaona	1934 births, Living people, Prime Ministers of Madagascar
Peng Xiaolian	1953 births, 2019 deaths, Chinese movie directors, Chinese screenwriters, People from Shanghai
Marko Feingold	1913 births, 2019 deaths, Austrian Jews, Centenarians, Holocaust survivors, People from Salzburg, People from Vienna
Dale, Texas	Unincorporated communities in Texas
Jimmy Weldon	1923 births, Living people, Actors from Texas, American voice actors, American television actors, American television personalities
2019 Pacific typhoon season	2019 Pacific typhoon season, January 2019 events, February 2019 events, March 2019 events, April 2019 events, May 2019 events, June 2019 events, July 2019 events, August 2019 events, September 2019 events, December 2018 events
Grover, Kansas	Unincorporated communities in Douglas County, Kansas
List of women judges	Lists of women, Women judges, Lists of people by occupation
Clearfield, Kansas	Unincorporated communities in Douglas County, Kansas
Kanwaka, Kansas	Unincorporated communities in Douglas County, Kansas, 1854 establishments in Kansas Territory
Weaver, Kansas	Unincorporated communities in Douglas County, Kansas
Lake View, Kansas	Unincorporated communities in Douglas County, Kansas, Lakes of Kansas, Bodies of water of Douglas County, Kansas
Hesper, Kansas	Unincorporated communities in Douglas County, Kansas, 1858 establishments in Kansas Territory
Midland, Kansas	Unincorporated communities in Douglas County, Kansas
Sibleyville, Kansas	Unincorporated communities in Douglas County, Kansas
Lapeer, Kansas	Ghost towns in Kansas
Belvoir, Kansas	Ghost towns in Kansas
Media, Kansas	Ghost towns in Kansas
Historical society	Historical societies
Kansas Historical Society	Historical societies, 1875 establishments in Kansas
St. Mary's Food Bank	Pages created with the Article Wizard from 2019, Non-profit organizations of the United States, Phoenix, Arizona, 1967 establishments in the United States
Julie Payne (actress, born 1940)	1940 births, 2019 deaths, Actors from Los Angeles, California, American movie actors, American television actors, Deaths from COPD
Bisbee, Arizona	Cities in Arizona, County seats in Arizona, Industrial Workers of the World
Jim Forbes (Australian politician)	1923 births, 2019 deaths, Alumni of the University of Oxford, Australian military people, Government ministers of Australia, Liberal Party of Australia politicians, Military personnel of World War II, People from Hobart, Politicians from Tasmania, University of Adelaide alumni
User (computing)	Computers
New-York Historical Society	Historical societies
Louisiana, Kansas	Ghost towns in Kansas, 1855 establishments in Kansas Territory
University nuhelotʼįne thaiyotsʼį nistameyimâkanak Blue Quills	1971 establishments in Canada, Colleges and universities in Canada, Alberta
Cross of Valour (Poland)	Military honors
Jerome Ch'en	1919 births, 2019 deaths, Canadian academics, Canadian historians, Canadian writers, Chinese academics, Chinese educators, Chinese writers
Congressional district	Legislatures, Democracy
Rafael de la Sierra	1948 births, 2019 deaths, Disease-related deaths in Spain, People from Cantabria, Spanish politicians
Dmytro Tymchuk	1972 births, 2019 deaths, Deaths by firearm, Ukrainian journalists, Ukrainian politicians, Ukrainian writers
Kansas's 2nd congressional district	Congressional districts of Kansas
Michel Sitjar	1942 births, 2019 deaths, People from Occitanie, Rugby league players, French rugby union players, Suicides in France, Sportspeople who committed suicide
Kansas's 4th congressional district	Congressional districts of Kansas, Sedgwick County, Kansas
Kansas's 3rd congressional district	Congressional districts of Kansas
Kansas's 1st congressional district	Congressional districts of Kansas
Kansas's 5th congressional district	Congressional districts of Kansas
Kansas's congressional districts	Congressional districts of Kansas
Charles Dolan	1926 births, Living people, American billionaires, Businesspeople from Cleveland, Ohio
List of United States representatives from Kansas	Lists of politicians from the United States, United States representatives from Kansas
United States congressional delegations from Kansas	United States representatives from Kansas, United States senators from Kansas
Special administrative region	Politics of China
Elnhausen	Elnhausen, Villages in Hesse, Marburg-Biedenkopf
Cyriaxweimar	Villages in Hesse, Marburg-Biedenkopf
Michelbach (Marburg)	Villages in Hesse, Marburg-Biedenkopf
Schröck	Schröck (Marburg), Villages in Hesse, Marburg-Biedenkopf
Stadtallendorf	Marburg-Biedenkopf
Uncle Ben	Fictional characters introduced in 1962, Marvel Comics superheroes
Virgina Kidd	1921 births, 2003 deaths, American science fiction writers, Editors, Novelists
Jean-Marie Hullot	1954 births, 2019 deaths, Apple Inc., Computer scientists, Scientists from Paris
Capital region	Regions
Pteroxygonum	Caryophyllales
Antigone	Classical Greek literature
Hepburn romanization	Japanese language, Romanization
Lynn Jenkins	21st-century American politicians, Living people, 1963 births, Kansas Republicans
Can't Buy Me Love (movie)	1987 romance movies, 1987 comedy movies, 1980s teen romance movies, 1980s teen comedy movies, 1980s romantic comedy movies, American teen romance movies, American teen comedy movies, American romantic comedy movies, Movies directed by Steve Rash
Fagopyrum tibeticum	Caryophyllales
The Bourne Supremacy	2004 movies, 2000s action movies, 2000s spy movies, 2000s thriller movies, American action movies, American spy movies, American thriller movies, English-language movies, Movies based on books, Universal Pictures movies
Greta Thunberg	Time People of the Year, 2003 births, Living people, Activists, Environmentalists, Writers from Stockholm
Macedonian denar	Currency of Europe, North Macedonia
RKO Pictures	Movie studios, 1928 establishments in the United States
Solar sail	Spaceflight, Alternative propulsion, Solar energy
Peter Ouwens	1849 births, 1922 deaths, Dutch military people, Dutch scientists, People from Amsterdam, Zoologists
Fulbright Program	1946 establishments in the United States, United States Department of State, Awards
Things Fall Apart	1958 books, English-language novels
Oiniades	Towns in Greece
Eutin	Towns in Schleswig-Holstein
World Bicycle Day	United Nations, Days
Peter Matić	1937 births, 2019 deaths, Actors from Vienna, Austrian movie actors, Austrian television actors, Austrian voice actors
Okayama Castle	Castles in Japan, History of Japan, Okayama Prefecture
Roger Béteille	1921 births, 2019 deaths, French engineers, French businesspeople
Lionel Tertis	1876 births, 1975 deaths, Violinists, Educators, Musicians from London
The Bourne Ultimatum	2007 movies, 2000s spy movies, 2000s action thriller movies, American action thriller movies, American spy movies, English-language movies, Movies based on books, Universal Pictures movies
The Heartbreak Kid (2007 movie)	2007 comedy movies, 2000s black comedy movies, American black comedy movies
Tadahito Iguchi	1974 births, Japanese baseball players, Japanese Olympic silver medalists, Medalists at the 1996 Summer Olympics, Chicago White Sox players, Philadelphia Phillies players, San Diego Padres players, Sportspeople from Tokyo, Living people
So Taguchi	1969 births, Chicago Cubs players, Japanese baseball players, Living people, Major League Baseball broadcasters, People from Hyōgo Prefecture, Philadelphia Phillies players, Radio personalities, St. Louis Cardinals players
What to Expect When You're Expecting (movie)	2012 comedy movies, 2012 romance movies, 2010s romantic comedy movies, American romantic comedy movies, Movies directed by Kirk Jones, Lionsgate movies
Nusret Gökçe	Turkish people, Chefs, 1983 births, Living people, Restaurateurs
Ioannis Veryvakis	1930 births, 2019 deaths, Generals, Greek people, Legion of Honour
Rubén Suñé	1947 births, 2019 deaths, Argentine footballers, Association football midfielders, Sportspeople from Buenos Aires
Russian ruble	Russia, Currency
Blaine, Washington	Cities in Washington (U.S. state), 1884 establishments in the United States
Miguel Ángel Falasca	1973 births, 2019 deaths, 2000 Summer Olympics, Argentine sportspeople, Cardiovascular disease deaths in Italy, Coaches, Deaths from myocardial infarction, Spanish Olympians, Volleyball players
Chernobyl (miniseries)	Miniseries, British television series, American television series, English-language television programs
Josl Rieder	1932 births, 2019 deaths, Austrian sportspeople, Skiers
Roary the Racing Car	2007 British television series debuts, 2010 British television series endings, 2000s British television series, 2000s animated television series, 2000s television series, 2007 American television series debuts, 2007 television series debuts, 2010 television series endings, 2010s television series, Animated television series, British television series, Channel 5 (UK) television programmes, Children's television series, Nickelodeon television series, English-language television programs
Bubba Green	1957 births, 2019 deaths, American football players, Cancer deaths in Maryland, Indianapolis Colts players, Sportspeople from New Jersey
Multiple system atrophy	Diseases
Reol	1993 births, Living people, Japanese singers, Rap musicians
Leevi Lehto	1951 births, 2019 deaths, Deaths from multiple system atrophy, Finnish people, Poets, Translators
Mickey Spillane	1918 births, 2006 deaths, Deaths from pancreatic cancer, American novelists, American television actors, Actors from New York City, Writers from New York City
Murrells Inlet, South Carolina	Unincorporated communities in the United States, Census-designated places in South Carolina
Charles Bernstein	1950 births, Living people, American poets, American essayists, American educators, Writers from New York City, Writers from Pennsylvania
Climate of Uttar Pradesh	Uttar Pradesh, Climate
Toy Story (franchise)	Disney, Toy Story
Prague Spring	Czechoslovakia
TV tuner card	Computer hardware, Television technology
Milan Asadurov	1949 births, 2019 deaths, Bulgarian writers, Science fiction writers, Translators
Bombay Hindi	Hindi
Bengali–Assamese script	Writing systems
Kei Igawa	1979 births, Japanese baseball players, New York Yankees players, People from Ibaraki Prefecture, Living people
Zealandia	New Zealand, Continents
General Government	Nazi Germany, History of Poland
Turkmen Soviet Socialist Republic	Soviet Union
SGR 1806-20	Variable stars
Andrey Kharitonov	1959 births, 2019 deaths, Deaths from stomach cancer, Disease-related deaths in Moscow, People from Kiev, Russian movie actors, Russian movie directors, Russian television actors, Russian voice actors, Soviet movie actors, Soviet television actors, Russian stage actors
Zdeněk Remsa	1928 births, 2019 deaths, Czech sportspeople, Olympians, Skiers
Se'are Mekonnen	Year of birth missing, 2019 deaths, African military people, Assassinated people, Ethiopian people, Generals, Murders by firearm
Abdul Sattar (diplomat)	1931 births, 2019 deaths, Asian diplomats, Pakistani politicians, Pakistani scientists, Pakistani writers, Political scientists
Estevan Bruins	Ice hockey teams in Saskatchewan, 1950s establishments in Canada
Frederick Andermann	1930 births, 2019 deaths, Canadian educators, Canadian physicians, Medical researchers, Neurologists, Order of Canada, People from Montreal
Roger Marshall	1960 births, 21st-century American politicians, Kansas Republicans, Living people, United States representatives from Kansas, United States senators from Kansas
Gunther Kress	1940 births, 2019 deaths, Australian scientists, British scientists, Cardiovascular disease deaths in Rome, Deaths from heart failure, Linguists, Members of the Order of the British Empire, Semioticians, Australian people, British people
Primary election	Types of elections
State legislature (United States)	Legislatures
Pavel Chihaia	2019 deaths, 1922 births, Anti-Communists, Novelists, Romanian writers
Kansas Legislature	Government of Kansas, State legislatures of the United States
Max Kay	1936 births, 2019 deaths, Australian businesspeople, Cancer deaths in Australia, Deaths from pneumonia, Entertainers from Perth, Western Australia, Infectious disease deaths in Australia, Order of Australia, Scottish entertainers
Amado Carrillo Fuentes	1956 births, 1997 deaths, Mobsters
Green Lantern (movie)	DC Comics movies, 2011 movies, 2010s superhero movies, American superhero movies
Abdul Rahman of Negeri Sembilan	1895 births, 1960 deaths, Knights Grand Cross of the Order of St Michael and St George, Malaysian politicians, Sultans
Hisamuddin of Selangor	1898 births, 1960 deaths, Knights Commander of the Order of St Michael and St George, Sultans
Putra of Perlis	1920 births, 2000 deaths, Knights Commander of the Order of St Michael and St George, Malaysian people
Ismail Nasiruddin of Terengganu	1907 births, 1979 deaths, 20th century births, Knights Commander of the Order of St Michael and St George, Malaysian people, Sultans
Ja’afar of Negeri Sembilan	1922 births, 2008 deaths, Alumni of the London School of Economics, Honorary Knights Grand Cross of the Order of the Bath, Malaysian politicians, Order of Merit of the Federal Republic of Germany, Order of the Bath
Salahuddin of Selangor	1926 births, 2001 deaths, Malaysian politicians
Sirajuddin of Perlis	1943 births, Kings and queens, Living people, Malaysian politicians
Mizan Zainal Abidin of Terengganu	1962 births, Living people, Malaysian politicians, Sultans
Muhammad V of Kelantan	1969 births, Alumni of the University of Oxford, Legion of Honour, Living people, Malaysian politicians, Sultans
Abdullah of Pahang	1959 births, Current national leaders, Heads of state, Living people, Malaysian politicians, Sultans
Jericho (2006 TV series)	English-language television programs
The Immortal (1970 TV series)	English-language television programs
Wan Azizah Wan Ismail	1952 births, Civil rights activists, Living people, Deputy Prime Ministers of Malaysia
2019 FIFA Women's World Cup Group A	Interlanguage link template link number, 2019 FIFA Women's World Cup
Siti Nurhaliza	Singers, Malaysian actors
2019 FIFA Women's World Cup Group B	2019 FIFA Women's World Cup
2019 FIFA Women's World Cup Group C	Interlanguage link template link number, 2019 FIFA Women's World Cup
Geng Tan	1963 births, Living people, Politicians from Ontario, Members of the House of Commons of Canada from Ontario
2019 FIFA Women's World Cup Group F	Interlanguage link template link number, 2019 FIFA Women's World Cup
2019 FIFA Women's World Cup Group E	Interlanguage link template link number, 2019 FIFA Women's World Cup
2019 FIFA Women's World Cup Group D	Interlanguage link template link number, 2019 FIFA Women's World Cup
David Lidington	1956 births, Living people, Alumni of the University of Cambridge, Commanders of the Order of the British Empire, English Anglicans, Former Conservative MPs (UK), Former members of the British House of Commons for English constituencies, Lord Chancellors, Politicians from London, Privy Councillors (UK), Secretaries of State of the United Kingdom, UK MPs 1992–1997, UK MPs 1997–2001, UK MPs 2001–2005, UK MPs 2005–2010, UK MPs 2010–2015, UK MPs 2015–2017, UK MPs 2017–2019
Sophora koreensis	Faboideae
Waiting for Love (Avicii song)	2015 songs, CS1 Swedish-language sources (sv), CS1 Polish-language sources (pl), CS1 Japanese-language sources (ja), CS1 Italian-language sources (it), CS1 German-language sources (de), Certification Table Entry usages for United States, Certification Table Entry usages for United Kingdom, Certification Table Entry usages for Sweden, Certification Table Entry usages for Spain, Certification Table Entry usages for Poland, Certification Table Entry usages for New Zealand, Certification Table Entry usages for Japan, Certification Table Entry usages for Italy, Certification Table Entry usages for Germany, Certification Table Entry usages for Denmark, Certification Table Entry usages for Canada, Certification Table Entry usages for Belgium, Certification Table Entry usages for Austria, Certification Table Entry usages for Australia
Steve Dunleavy	1938 births, 2019 deaths, American television news anchors, Australian journalists, Naturalized citizens of the United States, Writers from Sydney, Journalists from New York City
Peter Ball (bishop)	1932 births, 2019 deaths, Bishops, British sex offenders
Stepan Shakaryan	1935 births, 2019 deaths, Armenian people, Composers, Pianists
Wibke Bruhns	1938 births, 2019 deaths, German journalists, Television news anchors
Joe Sestak	1951 births, Living people, 2020 United States presidential candidates, United States representatives from Pennsylvania, American military people, US Democratic Party politicians
Joe Sestak 2020 presidential campaign	2020 United States presidential campaigns
Molara Ogundipe	1940 births, 2019 deaths, Nigerian people, Poets, Critics, Activists, Feminist writers
Frances Farenthold	2021 deaths, 1926 births, State legislators of the United States, American political activists, Politicians from Texas, People from Corpus Christi, Texas, US Democratic Party politicians, Deaths from Parkinson's disease
Lila Cockrell	1922 births, 2019 deaths, Mayors of San Antonio, American military personnel of World War II, Politicians from Fort Worth, Texas
Charles Wyrsch	1920 births, 2019 deaths, Swiss painters
David Esterly	1944 births, 2019 deaths, Deaths from motor neurone disease, American artists, Writers from Akron, Ohio, Writers from New York
Heinrich Reichert	1949 births, 2019 deaths, Swiss scientists
Graham Barnett	1936 births, 2019 deaths, English footballers, English football managers, Sportspeople from Staffordshire, People from Stoke-on-Trent
Liz Truss	1975 births, Living people, Alumni of the University of Oxford, Conservative MPs (UK), Lord Chancellors, Members of the British House of Commons for English constituencies, People from Leeds, People from Oxford, Privy Councillors (UK), Secretaries of State of the United Kingdom, UK MPs 2010–2015, UK MPs 2015–2017, UK MPs 2017–2019, UK MPs 2019–, Women politicians
Jörg Stübner	1965 births, 2019 deaths, German footballers
Ekrem İmamoğlu	1970 births, Living people, Mayors, Turkish politicians, People from Istanbul
2019 Amhara Region coup d'état attempt	2019 in Africa, 2010s crimes in Africa, Coups d'état, History of Ethiopia, June 2019 events, Murder in Africa, Murder in the 2010s
Hugh Norman-Walker	1916 births, 1985 deaths, Chief Secretaries of Hong Kong, People from London, Knights Commander of the Order of St Michael and St George, Officers of the Order of the British Empire
List of heads of state of the Comoros	Comoros, Lists of heads of state
List of colonial governors of Bechuanaland	Botswana
List of colonial governors of British Somali Coast Protectorate	Somaliland
Martine Ouellet	1969 births, Canadian engineers, Living people, Politicians from Quebec, Women politicians
Fernando Roldán	1921 births, 2019 deaths, 1950 FIFA World Cup players, Chilean footballers
Lieutenant Governor of Kansas	Government of Kansas, Lieutenant Governors of Kansas
Isabel Sarli	1929 births, 2019 deaths, Argentine models, Argentine movie actors
List of heads of government of the Comoros	Comoros
José Huerta	1948 births, 2019 deaths, Deaths from myocardial infarction, Generals, Peruvian politicians
Harold Olsen	1895 births, 1953 deaths
Sacking of Lawrence	Bleeding Kansas, Lawrence, Kansas
Liverpool Cruise Terminal	Liverpool, Merseyside, Ports and harbours of the United Kingdom
LZ 130 Graf Zeppelin	Airships, Individual aircraft
List of people from Kansas	Lists of people by state in the United States, People from Kansas
List of presidents of Djibouti	Presidents by country, Djibouti
Heads of state of the Gambia	Lists of heads of state, Presidents of the Gambia
List of cities in Eswatini	Cities in Eswatini, Lists of cities by country, Lists of cities in Africa, Geography-related lists
Tshaneni	Settlements in Eswatini
Locative adverb	Parts of speech
List of colonial governors of the Comoros	Comoros
Lists of office-holders	Politics
Gem Archer	British musicians, Living people, Year of birth missing (living people)
Bya (unit)	Units of time
Flash Thompson	Marvel Comics superheroes
Mary-Jane Watson	Comics characters, Fictional American people, Characters created by Stan Lee, Fictional characters introduced in the 1960s, Marvel Comics characters, Marvel Comics superheroes, Movie characters, Spider-Man
Cedar Crest (mansion)	Governors' mansions in the United States, Houses in the United States, National Register of Historic Places
Hindenburg Line	Battles of the Western Front (World War I), Fortification, World War I
Mary Walsh (actress)	1952 births, Canadian comedians, Living people
U.S. Route 59	U.S. Highways
Winterlude	Ottawa, Festivals in Canada, 1979 establishments in Canada
Superhero movie	Superhero movies
Dragon Tales	1999 American television series debuts, English-language television programs
Rishabh Pant	1997 births, Indian cricketers, Living people
WNET	Peabody Award winners, Television channels
Merriam, Kansas	Cities in Johnson County, Kansas
Hermosa Beach, California	Cities in California, Settlements in Los Angeles County, California
Duane Chapman	1953 births, Living people, American television personalities, Businesspeople from Denver, Colorado
Édith Scob	1937 births, 2019 deaths, French movie actors, French television actors, French stage actors, Actors from Paris
Rolf Maurer	1938 births, 2019 deaths, Cyclists, Swiss sportspeople
List of rulers of Iceland	Iceland
President of Iceland	Presidents of Iceland
Sveinn Björnsson	1881 births, 1952 deaths, Icelandic politicians, Presidents of Iceland
List of presidents of Iraq	Presidents of Iraq, Lists of heads of state
Salina, Kansas	Cities in Saline County, Kansas, 1858 establishments in Kansas Territory, County seats in Kansas
Saline County, Kansas	Saline County, Kansas, 1860 establishments in Kansas Territory
Alma Adams	1946 births, 20th-century American politicians, 21st-century American politicians, Living people
Colin Allred	1983 births, American football linebackers, Living people, Tennessee Titans players, 21st-century American politicians, American lawyers
Nanette Barragán	1976 births, 21st-century American politicians, Living people
Karen Bass	1953 births, 21st-century American politicians, African American politicians, United States representatives from California, Politicians from Los Angeles, California, Living people
Hutchinson, Kansas	Cities in Reno County, Kansas, County seats in Kansas
Republican River	Rivers of Kansas
Smoky Hill River	Rivers of Kansas
Lawrence Public Library	Lawrence, Kansas, Libraries in the United States, Buildings and structures in Lawrence, Kansas, 1854 establishments in Kansas Territory, 1854 establishments in the United States
The University Daily Kansan	University of Kansas
Matt Stairs	1968 births, Living people, Canadian baseball players
Aaron Rowand	1977 births, American baseball players, Baseball players from California, Chicago White Sox players, Living people, Major League Baseball broadcasters, Sportspeople from Portland, Oregon, Philadelphia Phillies players, San Francisco Giants players, Sportspeople from Los Angeles County, California
Cole Hamels	1983 births, American baseball players, American League All-Stars, Baseball players from California, Chicago Cubs players, Living people, National League All-Stars, Philadelphia Phillies players, Texas Rangers players
Ryan Howard	1979 births, African-American baseball players, Major League Baseball broadcasters, National League All-Stars, Philadelphia Phillies players, Sportspeople from St. Louis, Missouri, Living people
Ugyen Wangchuck	1862 births, 1926 deaths, Knights Grand Commander of the Order of the Indian Empire, Bhutanese people, Order of the Indian Empire, Order of the Star of India
Kevin McKenna (Irish republican)	1945 births, 2019 deaths, Irish politicians, Military people, Political activists
Jeff Austin	1974 births, 2019 deaths, American folk singers, American bluegrass musicians, Mandolinists, Musicians from Illinois, Singers from Illinois, People from Arlington Heights, Illinois
Jonás Gómez Gallo	1923 births, 2019 deaths, Chilean businesspeople, Chilean politicians
Dumitru Focșeneanu	1935 births, 2019 deaths, 1972 Winter Olympics, Deaths from stroke, Olympians, Romanian sportspeople
Georges Brossard	1940 births, 2019 deaths, Canadian scientists, Cancer deaths in Quebec, Deaths from lung cancer, Order of Canada, People from Montreal
Yekaterina Mikhailova-Demina	1925 births, 2019 deaths, People from Saint Petersburg, Russian military people, Russian physicians, Soviet military personnel of World War II
Nature Ganganbaigal	1990 births, 2019 deaths, Chinese singers, Mongolian people, New York University alumni, People from Beijing, Singer-songwriters
Stephanie Grisham	1977 births, Living people, White House Press Secretaries, Politicians from Arizona, US Republican Party politicians, White House Communications Directors
Gualberto Castro	1934 births, 2019 deaths, Deaths from respiratory tract infection, Deaths from bladder cancer, Mexican television presenters, Mexican movie actors, Mexican television actors, Mexican stage actors, Singers from Mexico City, Actors from Mexico City
2020 OFC Nations Cup	Football competitions, Sport in Oceania
Curtis Armstrong	1953 births, American actors, Converts to Judaism, Living people
Nebulizer	Health, Medical equipment
Reginald's Tower	Waterford, Buildings and structures in the Republic of Ireland
Ásgeir Ásgeirsson	1894 births, 1972 deaths, Presidents of Iceland, Prime Ministers of Iceland
Randy Romero	1957 births, 2019 deaths, Deaths from stomach cancer, Sportspeople from Louisiana, People from Lafayette, Louisiana
Erath, Louisiana	Towns in Louisiana
President of Tunisia	Presidents of Tunisia
Rachid Sfar	1933 births, Living people, Prime Ministers of Tunisia, Speakers of the Assembly of the Representatives of the People
Mark Moseley	1963 births, Living people, American voice actors, American radio personalities, American stand-up comedians, American rap musicians from Mississippi, Entertainers from Mississippi
Civil Works Administration	New Deal, Great Depression, Franklin D. Roosevelt, 20th century in the United States, 1933 establishments in the United States
Balanced budget	Government
Solomon River	Rivers of Kansas
Persicaria	Caryophyllales
Filandia	Cities in Colombia
Armenia, Colombia	Cities in Colombia
Deaths in July 2019	2019 deaths, July 2019 events
Jeon Mi-seon	1970 births, 2019 deaths, Actors who committed suicide, People from Seoul, South Korean movie actors, South Korean television actors, Suicides by hanging
David Golomb	1933 births, 2019 deaths, Former Members of Knesset, Jewish Israeli politicians, People from Tel Aviv
DWDB-TV	Filipino television stations, Quezon City
48 Hrs.	1982 comedy movies, 1982 action movies, 1980s buddy movies, American action comedy movies, Buddy cop movies, English-language movies, Movies directed by Walter Hill
Beverly Hills Cop	1984 comedy movies, 1984 action movies, American action comedy movies, English-language movies
Jamie Moyer	1962 births, American League All-Stars, American Roman Catholics, American baseball players, Baltimore Orioles players, Boston Red Sox players, Chicago Cubs players, Colorado Rockies players, Living people, Major League Baseball broadcasters, Philadelphia Phillies players, Seattle Mariners players, Sportspeople from Pennsylvania, St. Louis Cardinals players, Texas Rangers players
Lebanon, South Dakota	Towns in South Dakota
Cliff Morrison	Nurses, American activists, Living people, HIV/AIDS
Krishan Kant	1927 births, 2002 deaths, Punjabi people, Vice Presidents of India, Governors of Andhra Pradesh, Governors of Tamil Nadu
Bhairon Singh Shekhawat	1923 births, 2010 deaths, Deaths from respiratory tract infection, Deaths from cardiopulmonary arrest, Vice Presidents of India, Disease-related deaths in India
Gopal Swarup Pathak	1896 births, 1982 deaths, Governors of Karnataka, Vice Presidents of India
Prime Minister of Tunisia	Prime Ministers of Tunisia
Muhammad VIII al-Amin	1881 births, 1962 deaths, Tunisian politicians, History of Tunisia
George E. Felton	1921 births, 2019 deaths, English computer scientists, Scientists from Paris
Gunilla Pontén	1929 births, 2019 deaths, Designers, People from Stockholm
Willie Frazer	1960 births, 2019 deaths, Political activists, Deaths from multiple organ failure
Jintara Poonlarp	Thai singers, Thai actors, 1961 births, Living people, Buddhists
Waterford Viking Triangle	Waterford
2020 United Democratic Party (Belize) leadership election and convention	2020
Beloit College	1840s establishments in Wisconsin Territory, 1846 establishments in the United States, Colleges and universities in Wisconsin
Wangen bei Olten	Municipalities of the canton of Solothurn
Zuchwil	Municipalities of the canton of Solothurn
Zedd	1989 births, German musicians, Russian musicians, DJs, Record producers, Dance music, Grammy Award winners, Living people
Indian Space Research Organisation	1969 establishments, India, Space agencies
Kesgrave	Towns in Suffolk, Civil parishes in Suffolk, Ipswich, Suffolk Coastal
D. Watkins	Writers from Baltimore, Maryland, Biography articles of living people, African American writers, Living people, Year of birth missing (living people)
Point Roberts, Washington	Census-designated places in Washington (state), Exclaves
Bentonite	Ceramics, Materials, Sedimentary rocks, Sodium compounds, Calcium compounds, Potassium compounds
Bob Collymore	1958 births, 2019 deaths, British businesspeople, Chief executives, Deaths from acute myeloid leukemia, Guyanese people
Lisa Martinek	1972 births, 2019 deaths, Accidental deaths in Italy, German movie actors, German television actors, People from Stuttgart
Sebastián Alarcón	1949 births, 2019 deaths, Chilean writers, Deaths from cancer, Chilean movie directors, People from Valparaíso, Screenwriters
Etika	1990 births, 2019 deaths, Entertainers from New York City, Models from New York City, Suicides by drowning, Suicides in the United States
Guillermo Mordillo	1932 births, Cartoonists, 2019 deaths, Animators, People from Buenos Aires
Borka Pavićević	1947 births, 2019 deaths, Serbian people, Columnists, Activists
Amy Pietz	1969 births, Living people, American movie actors, American television actors, American stage actors, American voice actors, DePaul University alumni, Actors from Milwaukee, Wisconsin, Actors from Chicago
Susan Bernard	1948 births, 2019 deaths, Deaths from myocardial infarction, Cardiovascular disease deaths in Los Angeles, American movie actors, American television actors, Businesspeople from Los Angeles, California, Models from Los Angeles, California, Actors from Los Angeles, California, Writers from Los Angeles, California
Whitney North Seymour Jr.	1923 births, 2019 deaths, American lawyers, State legislators of the United States, Politicians from West Virginia, People from Huntington, West Virginia, Politicians from New York, Politicians from Connecticut, US Republican Party politicians
Yevheniya Dembska	1920 births, 2019 deaths, Ukrainian actors, People from Kiev
Andrey Nikolayevich Sakharov	1930 births, 2019 deaths, Soviet writers, Russian historians
Sascha Pohflepp	1978 births, 2019 deaths, Unexplained deaths, German artists, Designers, German writers, People from Cologne
Edgardo Mesa	1937 births, 2019 deaths, Deaths from emphysema, Argentine journalists, Radio personalities, Argentine writers, Argentine movie actors, Actors from Buenos Aires
Aldo Pignanelli	1950 births, 2019 deaths, Deaths from prostate cancer, Argentine politicians
Zakaria Ben Mustapha	1925 births, 2019 deaths, People from Tunis, Mayors
Florijana Ismaili	1995 births, 2019 deaths, Deaths by drowning, Female footballers, Swiss footballers
Alla Pokrovskaya	1937 births, 2019 deaths, Deaths from liver disease, Deaths from sepsis, Russian educators, Russian movie actors, Russian television actors, Soviet movie actors, Soviet television actors, Russian stage actors, Actors from Moscow
Oleg Yefremov	1927 births, 2000 deaths, Deaths from lung disease, Russian movie actors, Russian television actors, Russian stage actors, Russian educators, Actors from Moscow
Respiratory disease	Diseases, Respiratory system
Billy Drago	1945 births, 2019 deaths, Deaths from stroke, American movie actors, American television actors, American stage actors, American voice actors, Actors from Kansas
Hugoton, Kansas	Cities in Kansas, County seats in Kansas
Stevens County, Kansas	1886 establishments in Kansas, Kansas counties
Ken Behring	1928 births, 2019 deaths, Real estate developers, American philanthropists, Sportspeople from Illinois, Businesspeople from Illinois
Martinez, California	Cities in California, Cities in the San Francisco Bay Area, County seats in California, Settlements in Contra Costa County, California
Douglas Fielding	1946 births, 2019 deaths, British movie actors, British television actors, British stage actors, British voice actors, Actors from London
HarperCollins	1989 establishments in the United States
Homomorphism	Mathematics
David Koloane	1938 births, 2019 deaths, Deaths from natural causes, South African political writers, Painters
Radoje Kontić	1937 births, Living people, Prime ministers, Yugoslavian people
František Čuba	1936 births, 2019 deaths, Czech politicians
Abby Martin	1984 births, Living people, American political commentators, Journalists from California, Writers from Oakland, California
Roger Penske	1937 births, Living people, American racecar drivers, American conservatives, Businesspeople from Ohio, Businesspeople from Michigan, Sportspeople from Ohio, Sportspeople from Detroit, Michigan, People from Shaker Heights, Ohio, Businesspeople from Detroit, Michigan
Hartmut Nickel	1944 births, 2019 deaths, 1968 Winter Olympics, German ice hockey players, German Olympians, Sportspeople from Saxony
Jay Briscoe	1984 births, American professional wrestlers, Living people, Sportspeople from Delaware
Earth phase	Earth, Terrestrial planets
Jim McMullan	1936 births, 2019 deaths, Actors from New York, American movie actors, American television actors, Deaths from motor neurone disease, Disease-related deaths in California
Long Beach, New York	Cities in New York
Wofford Heights, California	Census-designated places in California, Settlements in Kern County, California
Ismail Al-Jazari	1206 deaths, Arab people, Artisans, Artists, Astronomers, Writers, Engineers, Giftedness, Inventors, Iraq, Islamic religious leaders, Mathematicians, Medieval literature, Scientists, 1136 births
AV Joseph	1906 births, People from Kerala, Indian politicians, Year of death missing
Noel White	1929 births, 2019 deaths, English businesspeople, The Football Association, People from Cheshire, Premier League, UEFA
List of Japanese scientists	Japanese scientists, Lists of scientists by nationality, Lists of Japanese people
Clinton Lake (Kansas)	Bodies of water of Douglas County, Kansas, Lakes of Kansas
Bogusław Schaeffer	1929 births, 2019 deaths, Musicologists, Polish composers
Djibouti at the 2000 Summer Olympics	Djibouti, 2000 Summer Olympics
Judicial activism	Law
Kansas Supreme Court	Government of Kansas, Courts (law)
Abilene, Kansas	Cities in Dickinson County, Kansas, County seats in Kansas, 1857 establishments in Kansas Territory
Buchegg	2014 establishments in Switzerland, Municipalities of the canton of Solothurn
Sándor Popovics (footballer)	1939 births, 2019 deaths, Deaths from Alzheimer's disease, Dutch football managers, Dutch footballers, Hungarian footballers, Naturalised citizens of the Netherlands
Ralph Brill	1935 births, 2019 deaths, American educators, Writers from Chicago
Theotokos	Ancient Christianity, Anglicanism, Christian art, Christian holidays, Christian terminology, Christian theology, Christianity, Christology, Eastern Catholicism, Eastern Orthodox Church, Jesus Christ, Lutheranism, Mary (mother of Jesus), Oriental Orthodoxy, Religion, Roman Catholicism, Saints, Theology
Djibouti at the 1984 Summer Olympics	Djibouti, 1984 Summer Olympics
Northern Light	Newspapers in the United States
Djibouti at the 1988 Summer Olympics	Djibouti, 1988 Summer Olympics
George Rogers Clark	1752 births, 1818 deaths, American military people, Deaths from stroke, People from Louisville, Kentucky
San Diego–Coronado Bridge	Bridges in the United States, Buildings and structures in San Diego, California, San Diego, California
Yu Darvish	1986 births, American League All-Stars, Chicago Cubs players, Japanese baseball players, Japanese sportspeople, Living people, Los Angeles Dodgers players, People from Osaka, Texas Rangers players
Nori Aoki	1982 births, Japanese baseball players, Houston Astros players, Kansas City Royals players, Milwaukee Brewers players, New York Mets players, San Francisco Giants players, Seattle Mariners players, Toronto Blue Jays players, Miyazaki Prefecture, Living people
Masahiro Tanaka	1988 births, Japanese baseball players, American League All-Stars, New York Yankees players, People from Hyōgo Prefecture, Living people
Koji Uehara	1975 births, American League All-Stars, Baltimore Orioles players, Boston Red Sox players, Chicago Cubs players, Japanese Olympic bronze medalists, Japanese baseball players, Living people, Medalists at the 2004 Summer Olympics, People from Osaka Prefecture, Texas Rangers players
Kenta Maeda	1988 births, Japanese baseball players, Living people, Los Angeles Dodgers players, People from Osaka Prefecture
Toshiya Sugiuchi	1980 births, Japanese baseball players, Olympians, People from Fukuoka Prefecture, Living people
Champa Chakma	1992 births, Bangladeshi cricketers, Living people
Jahanara Alam	1993 births, Living people, Bangladeshi cricketers, Bangladeshi Muslims
Lata Mondal	1993 births
Rolland Golden	1931 births, 2019 deaths, American artists, People from New Orleans, Louisiana
Folsom, Louisiana	Villages in Louisiana
Tyler Skaggs	1991 births, 2019 deaths, Arizona Diamondbacks players, Los Angeles Angels players, Sportspeople from Los Angeles, California, People from Santa Monica, California
Southlake, Texas	Cities in Texas, Settlements in Tarrant County, Texas
Lee Edwards	1932 births, Living people, American conservatives, American historians, American political writers, Writers from Chicago
Bob Ellicott	1927 births, Living people, Australian lawyers, Australian judges, Politicians from New South Wales
Marcin Wodziński	Living people, Year of birth missing (living people), Polish historians
John Cain (41st Premier of Victoria)	1931 births, 2019 deaths, Deaths from stroke, Premiers of Victoria, Politicians from Melbourne
Barrie Unsworth	1934 births, Living people, Premiers of New South Wales
Steele Hall	1928 births, Living people, Premiers of South Australia
Inkheart	2003 books, Children's books, Fantasy books

