Great Attractor	Galaxy clusters
Cubs Win Flag	Chicago Cubs, 1937 establishments in the United States, 1930s establishments in Illinois
Wrigley Field	Major League Baseball venues, Sports buildings in Chicago, Illinois, Chicago Cubs, 1914 establishments in the United States, 1910s establishments in Illinois, Landmarks in Chicago
Zone of Avoidance	Galaxies
Norma Cluster	Galaxy clusters
Lewis acid	Chemistry
Shamrock Rovers F.C.	Irish football clubs, Sport in Dublin
Galactic plane	Celestial mechanics
CfA2 Great Wall	Galaxy clusters
Local Group	Galaxy clusters, Local galaxies
Hydron	Chemistry
Hexactinellid	Sponges
Demosponge	Sponges
University Finis Terrae	Private Chilean universities, Colleges and universities in Chile, 1988 establishments in South America, 1980s establishments in Chile
Universidad Mayor, Chile	Private Chilean universities, Colleges and universities in Chile, 1988 establishments in South America, 1980s establishments in Chile
University of the Pacific	Private Chilean universities, Colleges and universities in Chile, 1990 establishments in Chile
Tentaculata	Ctenophores
Shōchū	Alcoholic drink, Japanese food
Awamori	Fermented drinks, Okinawa Prefecture
Greyson Chance	1997 births, Living people, American pianists, musicians from Texas, singers from Texas
Eephus pitch	Baseball
University of Antofagasta	Colleges and universities in Chile, 1981 establishments in Chile, Antofagasta
Siméon Denis Poisson	French mathematicians, 1781 births, 1840 deaths, Alumni of the École Polytechnique
Rotavirus	Diseases caused by viruses, Viruses
Croatian National Resistance	Nationalist organizations in Europe, Yugoslavia, Establishments in Croatia, 1955 establishments in Europe
Karel Plíhal	1958 births, Living people, Czech musicians, Czech poets, Singer-songwriters
D.C. United Academy	Soccer in the United States
Bat-and-ball games	Team sports
Virus classification	Viruses
Enterovirus	Viruses
Explode (song)	2011 songs
Kingdom of Italy (1861–1946)	19th century in Italy, 20th century in Italy, Former monarchies in Italy
New Jersey Turnpike	Roads in the United States, Transport in New Jersey
Jordan at the Olympics	Sport in Jordan, Nations at the Olympics
Kazakhstan at the Olympics	Nations at the Olympics, Sport in Kazakhstan
North Korea at the Olympics	Sport in North Korea, Nations at the Olympics
South Korea at the Olympics	Sport in South Korea, Nations at the Olympics
Kuwait at the Olympics	Sport in Kuwait, Nations at the Olympics
Kyrgyzstan at the Olympics	Sport in Kyrgyzstan, Nations at the Olympics
Laos at the Olympics	Laos, Nations at the Olympics
Lebanon at the Olympics	Nations at the Olympics, Sport in Lebanon
Marie Stopes	1880 births, 1958 deaths, Alumni of University College London, British botanists, British feminists, British writers, Cancer deaths in England, Deaths from breast cancer, Female scientists, People from Edinburgh
École normale supérieure	Colleges and universities in France
Malaysia at the Olympics	Sport in Malaysia, Nations at the Olympics
Maldives at the Olympics	Maldives, Nations at the Olympics
Mongolia at the Olympics	Nations at the Olympics, Sport in Mongolia
Myanmar at the Olympics	Sport in Myanmar, Nations at the Olympics
Nepal at the Olympics	Nations at the Olympics, Sport in Nepal
Oman at the Olympics	Sport in Oman, Nations at the Olympics
Pakistan at the Olympics	Sport in Pakistan, Nations at the Olympics
University of Tarapacá	Colleges and universities in Chile, 1982 establishments, 1980s establishments in Chile
Ostracoderm	Extinct fish, Agnatha
Nancy Wake	1911 births, 2011 deaths, World War II people, Order of Australia, Spies, People from Wellington
Erymanthian Boar	Greek legendary creatures, Pigs
Mount Tamalpais	Mountains of California, Marin County, California
Barnard's star	Red dwarfs
Punjabi language movement	Punjabi language
Platanus orientalis	Trees, Proteales, Plants and animals of Kashmir
Koi	Domesticated animals, Ray-finned fish
Heathen Chemistry	Oasis (band) albums, 2002 albums
Classical Chinese	Chinese language
Marc Janko	1983 births, Living people, Austrian footballers, Players of the Austrian national football team, FC Red Bull Salzburg players
2010–11 Manchester United F.C. season	Football seasons, 2011 in association football, 2010 in association football, 2010 in the United Kingdom, 2011 in the United Kingdom, 2010s in Manchester
Exergaming	Video games, Fitness
Standing on the Shoulder of Giants	Oasis (band) albums, 2000 albums
Communications satellite	Communication, Satellites
Bill & Melinda Gates Foundation	Non-profit organizations of the United States, Bill Gates
Mario Party (video game)	Mario Party games, Nintendo 64 games, 1998 video games
La Paz	Settlements in Bolivia, National capitals in South America, 1548 establishments, 1540s establishments in South America
Delaware Route 82	Roads in Delaware, 1952 establishments in the United States, 20th-century establishments in Delaware
Delaware Route 52	Roads in Delaware
Pennsylvania Route 82	Roads in Pennsylvania
Delaware Route 100	Roads in Delaware
Greenville, Delaware	Cities in Delaware
Yorklyn, Delaware	Cities in Delaware
Kennett Square, Pennsylvania	Cities in Pennsylvania
Red Clay Creek	Rivers of Delaware, Rivers of Pennsylvania
Wilmington and Western Railroad	Rail transport in the United States
John Stossel	1947 births, Living people, American journalists, American television presenters, Writers from Illinois
List of numbered routes in Delaware	Roads in Delaware, Delaware-related lists, Lists of roads
Delaware Department of Transportation	Roads in Delaware, State departments of transportation in the United States
Nasi kucing	Rice dishes, Indonesian culture
Hyponatremia	Blood, Health problems
Marlin	Teleosts
Pufferfish	Teleosts
Fort Kent, Maine	Towns in Maine
Oxytocin	Hormones
Phil Jones (footballer)	1992 births, Living people, 2014 FIFA World Cup players, English footballers, Manchester United F.C. players, People from Preston, Lancashire, Sportspeople from Lancashire
Bob Burnquist	1976 births, Living people, Brazilian sportspeople, Skateboarders
Aermacchi M.B.339	Military aircraft, Italian military aircraft
Ocean sunfish	Ray-finned fish
Remora	Perciformes
Rick Snyder	1958 births, Living people, Governors of Michigan, Businesspeople from Michigan, US Republican Party politicians
Bibliomania	Symptoms
Jersey Shore	Geography of New Jersey
Jefferson Cardoso dos Santos	1986 births, Living people, Brazilian footballers, FC Red Bull Salzburg players
2010 Russian Premier League	Russian Premier League
List of FIFA World Cup goalscorers	FIFA World Cup players, Lists of footballers
Chillán Viejo	Cities in Chile
Pyramid scheme	Commercial crime, Marketing
The Stinky Cheese Man and Other Fairly Stupid Tales	1992 books, Children's books, Fairy tales, Collections of fairy tales
Palestine at the Olympics	Palestinian culture, Nations at the Olympics
São Paulo Museum of Art	Art museums, São Paulo, 1968 establishments, 1960s establishments in Brazil
Philippines at the Olympics	Sport in the Philippines, Nations at the Olympics
Robert Louis Stevenson	Scottish writers, Deaths from cerebral hemorrhage, 1850 births, 1894 deaths
Qatar at the Olympics	Sport in Qatar, Nations at the Olympics
The Westing Game	1978 books, Children's books, Crime fiction books, Young adult novels, Newbery Medal winning books
Selous' zebra	Equids, Mammals of Africa, Zebras
Saudi Arabia at the Olympics	Sport in Saudi Arabia, Nations at the Olympics
BMW in Formula One	Formula One constructors, Formula One engine manufacturers
List of Interstate Highways	Interstate Highways, Lists of roads, United States-related lists
Andrew Gaze	1965 births, Living people, Basketball players, Autobiographers, Sportspeople from Melbourne
Honus Wagner	1874 births, 1955 deaths, American baseball players, Sportspeople from Pittsburgh, Pennsylvania, Major League Baseball players, Pittsburgh Pirates managers, Pittsburgh Pirates players, National Baseball Hall of Fame members, 19th century baseball players
Klaipėda	Cities in Lithuania
JIT	Computer programming
Hınıs	Settlements in Turkey
Avro 683 Lancaster	Royal Air Force aircraft
Indre (department)	Departments in Centre-Val de Loire, 1790 establishments
Blackburn B-103	Military aircraft
Southern (Govia Thameslink Railway)	Train operating companies, Railway companies of the United Kingdom
Annie Lennox	1954 births, Living people, Best Original Song Academy Award-winning songwriters, British feminists, People from Aberdeen, Scottish pop singers, Scottish rock singers
Michael Sheard	Scottish movie actors, Scottish television actors, People from Aberdeen, 1940 births
John Steell	1804 births, 1891 deaths, British artists, People from Aberdeen, Knights Bachelor
Alexander Auldjo	1758 births, 1821 deaths, People from Aberdeen
Neuromancer	1984 books, Science fiction books, Hugo Award winning books, American novels, English-language novels, Fantasy books, Nebula Awards
The Giver	1993 books, Children's books, Science fiction books, Newbery Medal winning books
Alex Rafael da Silva Antônio	Brazilian footballers, 1988 births, Living people, FC Red Bull Salzburg players
Northern corroboree frog	Frogs
Galaxy Science Fiction	American magazines, Science fiction
George Medal	Orders, decorations, and medals of the United Kingdom
George Cross	Orders, decorations, and medals of the United Kingdom
Land Rover	British automobile companies
Croix de Guerre	Orders, decorations, and medals of France
Scallop	Bivalves
QWOP	Online games
Aga Khan IV	1936 births, Living people, British businesspeople, British Muslims, Harvard University alumni, Quran reciters, Imams
Jesse Jackson	1941 births, Living people, African American politicians, American adoptees, American Baptists, American civil rights activists, Christian ministers, People with Parkinson's disease, People from Greenville, South Carolina, Politicians from Chicago, Politicians from South Carolina, HuffPost writers and columnists, 1984 United States presidential candidates, 1988 United States presidential candidates, United States Shadow senators from District of Columbia, US Democratic Party politicians
Structured program theorem	Computer programming, Theoretical computer science, Mathematics
Lower Triassic	Triassic
Middle Triassic	Triassic
Shahab al-Din Suhrawardi	1155 births, 1191 deaths, Asian Sufis, Muslims, Religious leaders, Philosophers
Adduction	Anatomy
List of Kurdish poets and authors	Kurds, Lists of writers
2011–12 FC Barcelona season	Football seasons, 2011 in association football, 2012 in association football, 2011 in Europe, 2012 in Europe, 2010s in Barcelona
Strength Through Joy	Nazi Germany
Hospital ship	Ship types
Volkswagen Beetle	Volkswagen automobiles
Ferdinand Porsche	German people, 1875 births, 1951 deaths
George Balanchine	1904 births, 1983 deaths, Deaths from Creutzfeldt–Jakob disease, Russian people, Ballet dancers, American choreographers
Tamara Karsavina	1885 births, 1978 deaths, Autobiographers, Ballets Russes, Russian ballerinas
Jeddah Tower	Skyscrapers, Jeddah, Buildings and structures in Saudi Arabia
Harmonium	Keyboard instruments
KrioRus	Companies of Russia, 2005 establishments, 2000s establishments in Russia
Butler, Alabama	Cities in Alabama, County seats in Alabama
Aerial warfare	Military tactics, Military aviation
United States Military Academy	Military schools, Patriot League, Atlantic Hockey, 1802 establishments in the United States, 1800s establishments in New York (state)
Barebacking	Human sexuality
Conscription	Military
Lalian	Capital cities in Pakistan, Punjab (Pakistan), 2009 establishments in Asia
List of common misconceptions	Society, Lists, Knowledge
Limerick F.C.	Football League of Ireland, Irish football clubs, Limerick
Dawn (spacecraft)	NASA spacecraft, Asteroids
2001–02 Asian Club Championship	Football competitions
2009–10 UEFA Champions League	UEFA Champions League seasons, 2009 in association football, 2010 in association football, 2009 in Europe, 2010 in Europe
Phillips Exeter Academy	Schools in New Hampshire, 1780s establishments in the United States, 1781 establishments in North America, 18th-century establishments in New Hampshire
Emblem	Symbols
List of U.S. state shells	Lists of United States state symbols
Tasman Bay	Bays, Bodies of water of New Zealand
Royal Forest and Bird Protection Society of New Zealand	Environmental organizations, Wellington, Conservation, Forestry, 1923 establishments in Oceania, 20th-century establishments in New Zealand
Fishing dredge	Fishing
Way of St. James	World Heritage Sites in Spain, Santiago de Compostela
Oyster Burns	1864 births, 1928 deaths, American baseball players, Sportspeople from Philadelphia, Pennsylvania, Los Angeles Dodgers players, San Francisco Giants players
Thomas Wolsey	1470s births, 1530 deaths, Alumni of the University of Oxford, Cardinals of the Roman Catholic Church, English Roman Catholics, Lord Chancellors, People from Ipswich, Roman Catholic archbishops
Pacifier	Childhood, Medical equipment
Wilmington Quicksteps	Baseball teams, Wilmington, Delaware
Games played	Statistics
Triple (baseball)	Statistics
Muhammad Ali (writer)	Indian writers, Indian journalists, Poets, Activists, Muslims, 1878 births, 1931 deaths
Golden, Colorado	Cities in Colorado, County seats in Colorado, 1859 establishments in the United States, 19th-century establishments in Colorado
Sprawl trilogy	Series of books, Science fiction books
Panzerschreck	Weapons, Nazi Germany
Markus Persson	1979 births, Living people, Swedish people, Minecraft
Pyeongchang	Cities in South Korea
Cape Conran Coastal Park	Protected areas of Victoria (Australia)
Seoul National University	Education in South Korea, Buildings and structures in Seoul, Colleges and universities in Asia
Margot Fonteyn	Ballerinas, British autobiographers, Deaths from cancer of unknown primary origin, English dancers, Knights and Dames Commander of the Order of the British Empire, People from Surrey, 1919 births, 1991 deaths
Hampstead	Areas of London
Cosmic dust	Space, Solar System, Physics
Sautéing	Cooking methods
Li Zehou	Chinese scholars, 1930 births, Living people
Cynthia DeFelice	Living people, Writers from Philadelphia, Pennsylvania, 1951 births, American science fiction writers
Alexander and the Terrible, Horrible, No Good, Very Bad Day	1972 books, English-language picture books
Pippi Longstocking (book)	1945 books, Children's books
Ringstraße	Vienna
Otto Wagner	1841 births, 1918 deaths, Austrian architects, People from Vienna, Urban planners
Ninette de Valois	1898 births, 2001 deaths, Ballerinas, British centenarians, Choreographers, British dancers
A Wrinkle in Time	1962 books, Fantasy books, Young adult novels, Newbery Medal winning books
Calibre	Ammunition
Sandro Rosell	1964 births, Living people, Spanish sportspeople
Bitterness	Sensory system
Comet Shoemaker–Levy 9	Comets, Impact events
International League	Baseball leagues
Cigerxwîn	1903 births, 1984 deaths, Kurdish people
Division by two	Arithmetics
List of ice hockey leagues	Ice hockey leagues, Ice hockey related lists
Mahmud Bayazidi	1797 births, 1859 deaths, Kurdish people
John Goodman	1952 births, Living people, Actors from St. Louis, Missouri, American movie actors, American television actors, American voice actors, People from Springfield, Missouri, People's Choice Award winners
Imprinting (ethology)	Learning, Ethology
De Dion-Bouton	Automobile companies of France, 1882 establishments in France
Vienna Secession	Arts, Art movements, Vienna, 1897, 19th century in Austria, 1890s in Europe
Ken Olsen	1926 births, 2011 deaths, Businesspeople from Connecticut, American engineers, Massachusetts Institute of Technology alumni, People from Bridgeport, Connecticut
Debbie Wasserman Schultz	1966 births, Living people, Jewish American politicians, Jewish women politicians, People from Queens, Politicians from New York City, United States representatives from Florida, University of Florida alumni, US Democratic Party politicians
Curtin University	Colleges and universities in Australia, 1966 establishments in Oceania, 1960s establishments in Australia
Midnight	Parts of a day
Rottnest Island	Islands of Australia, Geography of Western Australia
Southern Professional Hockey League	Ice hockey leagues in the United States, 2004 establishments in North Carolina
Ligue Nord-Américaine de Hockey	Ice hockey leagues in Canada
Federal Hockey League	Ice hockey leagues in the United States
International Ice Hockey Federation	Ice hockey, 1908 establishments in Europe, International organizations, Zürich, Sports organizations
Canadian Junior Hockey League	Ice hockey leagues in Canada
Alberta Junior Hockey League	Ice hockey leagues in Canada, Sport in Alberta
British Columbia Hockey League	Ice hockey leagues in Canada
Central Canada Hockey League	Ice hockey leagues in Canada
Quebec Junior AAA Hockey League	Ice hockey leagues in Canada
Czech Extraliga	Ice hockey in the Czech Republic, Ice hockey leagues
Deutsche Eishockey Liga	Ice hockey leagues
Kontinental Hockey League	Ice hockey leagues, 2008 establishments
Apple strudel	Desserts, Austrian food
Ostreoida	Bivalves
Pectinina	Bivalves
Constantine Samuel Rafinesque	French botanists, French zoologists, French writers, 1783 births, 1840 deaths, Linguists
Ostreidae	Bivalves
Lens (anatomy)	Eye anatomy
Pecten (bivalve)	Bivalves
Byssus	Bivalves
Lake Ülemiste	Lakes of Europe, Geography of Estonia
Sachertorte	Cakes, Dishes named after people, Austrian food
Salzburger Nockerl	Austrian food, Desserts, Egg dishes
Thermochemistry	Physical chemistry
Kurt Schuschnigg	1897 births, 1977 deaths, American academics, American political scientists, Austrian people of World War II, Chancellors of Austria, Government ministers of Austria, Holocaust survivors, Naturalized citizens of the United States
Valeria Kozlova	1988 births, Living people, Russian singers, Russian composers, Russian actors
Diario Frontera	1978 establishments, Newspapers in South America, Mérida (state)
Charles Doolittle Walcott	1850 births, 1927 deaths, American paleontologists, American geologists, Scientists from New York
Mérida (state)	1864 establishments, Mérida (state), Establishments in Venezuela, 19th-century establishments in South America, States of Venezuela
Microsoft Agent	Microsoft
Gideon Welles	United States Secretaries of the Navy, 1802 births, 1878 deaths, Politicians from Connecticut, American abolitionists, American journalists, American lawyers, American literature, Members of the Cabinet of the United States
Keble College, Oxford	Colleges of the University of Oxford, 1870 establishments in Europe, 1870s establishments in England
New York Clipper	Newspapers in New York City, 1853 establishments in the United States, 1924 disestablishments in the United States, 1850s establishments in New York (state), 1920s disestablishments in New York (state)
Baltimore Orioles (19th century)	Major League Baseball teams, Sports in Baltimore, Maryland, 1882 establishments in the United States, 19th-century establishments in Maryland, 1899 disestablishments, 1890s disestablishments in the United States
Sayabec	Settlements in Quebec, 1894 establishments, 1890s establishments in Canada
Arrows	Formula One
Bella Thorne	1997 births, Actors from Florida, American artists, American child actors, American child singers, American Christians, American dancers, American LGBT rights activists, American movie actors, American pop singers, American television actors, Pansexual people, Disney people, LGBT actors, LGBT Christians, LGBT models, LGBT musicians, LGBT people from Florida, LGBT singers, Living people, Models from Florida, Musicians from Florida, Singers from Florida, American voice actors
François Mitterrand	1916 births, 1996 deaths, Cancer deaths in France, Deaths from prostate cancer, French lawyers, French mayors, Presidents of France, Princes of Andorra, Socialist Party (France) politicians
Afonso IV of Portugal	Kings and Queens of Portugal, 1291 births, 1357 deaths
Burgenland	Burgenland
Organometallic chemistry	Organometallic chemistry
Coniston Water	Lakes of the United Kingdom, Cumbria, Geography of England
Delirium tremens	Symptoms, Addiction
Brian Cox (physicist)	1968 births, Living people, English pop musicians, English physicists, Musicians from Lancashire, Officers of the Order of the British Empire
How to Win Friends and Influence People	1936 books, Non-fiction books
Jemma Palmer	1986 births, Living people, Big Brother contestants, English professional wrestlers, Sportspeople from Birmingham
Damien Sandow	1981 births, Living people, American professional wrestlers, People from Worcester, Massachusetts, Sportspeople from Massachusetts, WWE wrestlers
Ulf von Euler	1905 births, 1983 deaths, Nobel Prize in Physiology or Medicine winners, Swedish scientists, Biologists
The Fighting Temptations	2000s musical movies, 2003 drama movies, English-language movies, American musical movies, American drama movies, Movies directed by Jonathan Lynn
Titus O'Neil	American professional wrestlers, 1977 births, American football players, Sportspeople from Florida, Living people
Paul Bearer	1954 births, 2013 deaths, American professional wrestlers, Deaths from myocardial infarction, Deaths from blood clot, People from Mobile, Alabama, Sportspeople from Alabama, WWE Hall of Fame
Maury Povich	Living people, 1939 births, American television talk show hosts, American game show hosts
Darwinopterus	Pterosaurs
Rubén Sierra	1965 births, American League All-Stars, Detroit Tigers players, Chicago White Sox players, Cincinnati Reds players, Living people, Minnesota Twins players, New York Yankees players, Oakland Athletics players, Seattle Mariners players, Sportspeople from Puerto Rico, Texas Rangers players, Toronto Blue Jays players
Matt Clement	1974 births, Living people, San Diego Padres players, Florida Marlins players, Chicago Cubs players, Boston Red Sox players, Sportspeople from Pennsylvania
Tarkovsky	Russian-language surnames
Marin County, California	Marin County, California, 1850 establishments in California
Dolce & Gabbana	1985 establishments in Europe, Italian fashion houses, Milan, 1980s establishments in Italy
Transitional fossil	Evolutionary biology, Fossils
Jan Vyčítal	1942 births, 2020 deaths, Czech musicians
Period 3 element	Periodic table
Period 2 element	Periodic table
Mariner 1	Mariner program
Cornish cookery	Cornwall, Cooking
Pedro Rodríguez Ledesma	1987 births, Living people, Spanish footballers, Santa Cruz de Tenerife
Sergio Busquets	1988 births, Living people, Spanish footballers
Edifício Itália	Skyscrapers in Brazil, São Paulo, 1965 establishments, 1960s establishments in Brazil
Start	Basic English 850 words
Ito Hirobumi	1841 births, 1909 deaths, Anti-Communists, Japanese educators, Japanese politicians, Murder victims, People from Yamaguchi Prefecture
Complexity class	Mathematics
Saif al-Islam al-Gaddafi	1972 births, Living people, People from Tripoli
Kim Jong-suk	1917 births, 1949 deaths, North Korean politicians
Pope Pius VI	1717 births, 1799 deaths, Italian popes
Mariner 2	Mariner program
Period 1 element	Periodic table
Peugeot 5008	Peugeot automobiles, Front wheel drive vehicles, 2000s automobiles, 2010s automobiles
Fiat Multipla	Fiat automobiles, Front wheel drive vehicles, 1990s automobiles, 2000s automobiles, 2010s automobiles
2011 Virginia earthquake	2011 earthquakes, 2011 in the United States, 2010s in Virginia, August 2011 events, Earthquakes in the United States
TSV Hartberg	Austrian football clubs, Football clubs of Styria
Candidatus	Bacteria, Taxonomy
Carsonella ruddii	Gram-negative bacteria
French Civil Aviation University	Heads of the French Civil Aviation University, Alumni of the École nationale de l'aviation civile, 1949 establishments in Europe, 1940s establishments in France, French Civil Aviation University
Institut Polytechnique des Sciences Avancées	Alumni of the Institut polytechnique des sciences avancées, Engineering schools, Aerospace engineering, Aviation in France, Technical colleges and universities in France, 1961 establishments in Europe, Institut polytechnique des sciences avancées, Toulouse, 1960s establishments in France, Lyon, Marseille
Büsingen am Hochrhein	Towns in Baden-Württemberg, Konstanz (district)
CAE Global Academy Phoenix	Aviation, Mesa, Arizona, 1995 establishments in the United States
Mastère Spécialisé	Qualifications, 1986 establishments in Europe, 1980s establishments in France
Beaumaris Castle	Castles in Wales, 1330 establishments, 14th century establishments in Europe, Establishments in Wales
Université de Versailles Saint-Quentin-en-Yvelines	Versailles Saint-Quentin-en-Yvelines University faculty, Université de Versailles Saint-Quentin-en-Yvelines, 1991 establishments in France, Île-de-France
Cuthbert	Monks, Christian saints
Durham Cathedral	1090s establishments, Anglican Cathedrals, Durham, World Heritage Sites in the United Kingdom
Lofoten	Islands of Norway
Black hole information paradox	Quantum mechanics, Black holes
Sabena Flight Academy	Aviation, Colleges and universities in Europe, 1953 establishments in Europe, 20th century establishments in Belgium
1988 Pacific hurricane season	Pacific hurricane seasons, 1988
Period 5 element	Periodic table
Period 6 element	Periodic table
Period 7 element	Periodic table
Caroline Wozniacki	1990 births, Living people, Danish sportspeople, Female tennis players, Odense, World No. 1 tennis players
Algeciras	Cities in Andalusia, Municipalities in Andalusia
Luke Mitchell	1985 births, Living people
Chris Smalling	1989 births, Living people, Black British sportspeople, English footballers, Manchester United F.C. players, Premier League players, Sportspeople from London
Jonny Evans	1988 births, Living people, Northern Irish footballers, Sportspeople from Belfast
Danny Welbeck	1990 births, Living people, English footballers, Arsenal F.C. players, Manchester United F.C. players, Premier League players
Rafael Pereira da Silva	1990 births, Living people, Brazilian footballers, People from Rio de Janeiro
Fábio Pereira da Silva	1990 births, Living people, Brazilian footballers, People from Rio de Janeiro
Area of Outstanding Natural Beauty	Areas of Outstanding Natural Beauty
Chaturanga	Chess variants
Shatranj	Chess variants
Ice cap	Landforms
Carbon–hydrogen bond activation	Organometallic chemistry
Egyptian literature	Egypt, Literature by nationality
Phormium tenax	Medicinal plants, New Zealand
Extensive reading	Learning
30 Minutes or Less	2011 comedy movies, American action movies, American adventure movies, American criminal comedy movies, Multilingual movies
Chemical education	Education by subject, Chemistry
SC Rheindorf Altach	Austrian football clubs, Football clubs of Vorarlberg
Hurricane Irene	2011 in weather, Hurricanes in the United States, 2011 in the United States, 21st century in Puerto Rico, 2010s in the Bahamas
Jean-François de Galaup, comte de Lapérouse	1741 births, 1788 deaths, French people
Anna Hazare	1937 births, Living people, Hindus, Indian activists, Nonviolence advocates
Simone Weil	1909 births, 1943 deaths, 20th century philosophers, French philosophers, Jewish activists, Jewish philosophers, Jews who converted to Christianity, Nonviolence advocates, Scientists from Paris
BBC Knowledge Magazine	Magazines of the United Kingdom, BBC
Norman Manley International Airport	Airports in North America, Jamaica
Song Jin-woo	1889 births, 1945 deaths, Anti-Communists, South Korean politicians, South Korean journalists
Karl Decker	1921 births, 2005 deaths, Austrian footballers, Players of the Austrian national football team, Austrian football managers, Austria national football team managers
Mohammed bin Hammam	Qatari people
Bisphenol A	Hormones
Joe Clark	1939 births, Living people, Canadian diplomats, Roman Catholics, Canadian writers, Politicians from Alberta, Privy Councillors (Canada), Leaders of the Opposition (Canada), Members of the House of Commons of Canada
Norfolk Broads	Norfolk, Suffolk, Waterways
Boko Haram	2002 establishments, 21st century in Nigeria, Crime in Nigeria, Islamic State, Rebel militia groups in Africa, Sunni organizations
Movement for the Emancipation of the Niger Delta	History of Nigeria, Nationalist organizations in Africa, National liberation movements, Rebel militia groups in Africa
Urbanization	Geography
Moliniana	Journals, Botany, Santiago de Chile
You Suffer	1987 songs
Frankie Fredericks	1967 births, Living people, Male athletes, Medalists at the 1992 Summer Olympics, Medalists at the 1996 Summer Olympics, Olympic silver medalists, Sport in Namibia, Sprinters, People from Windhoek
Jagged Little Pill	1995 albums, Alanis Morissette albums
Jack Layton	1950 births, 2011 deaths, Deaths from cancer of unknown primary origin, Cancer deaths in Ontario, Politicians from Montreal, Politicians from Toronto, Leaders of the Opposition (Canada), Members of the House of Commons of Canada from Ontario, Privy Councillors (Canada)
Green politics	Green politics
QRpedia	Free software, Encodings
Gun Hägglund	1932 births, 2011 deaths, Swedish television presenters, Translators
Conrotatory and disrotatory	Chemical reactions
Catherine Deneuve	1943 births, Living people, Actors from Paris, French movie actors
Samir Bargachi	1987 births, Living people, Atheists, LGBT people, LGBT rights activists, Moroccan people
Odontoceti	Cetaceans
Allen Telescope Array	Astronomical observatories in California, Telescopes, SETI, 2007 establishments in California, 2011 disestablishments in the United States, 2010s disestablishments in California, 2011 establishments in California, 2012 disestablishments in the United States
Herring gull	Charadriiformes
Lesser black-backed gull	Charadriiformes
Arab Indonesians	Ethnic groups in Asia, Indonesian people
Christina Aguilera (album)	Christina Aguilera albums, Debut albums, 1999 albums, Grammy Award-winning albums, Pop albums
Alien hand syndrome	Syndromes
Christina Aguilera discography	Discographies, Christina Aguilera
My Kind of Christmas	Christina Aguilera albums, 2000 albums
Stripped	2002 albums, Christina Aguilera albums
Back to Basics	2006 albums, Christina Aguilera albums
Bionic	2010 albums, Christina Aguilera albums
Burlesque (soundtrack)	2010 albums
Dorothea Sophie of Neuburg	1670 births, 1748 deaths, Dukes and Duchesses of Parma, House of Farnese
F.C. Blau-Weiß Linz	Austrian football clubs, Football clubs of Upper Austria, Linz
Yinghuo-1	Spacecraft, People's Republic of China, Mars
Aldershot	Towns in Hampshire
Cuckoo (Mineral, Virginia)	National Register of Historic Places, Buildings and structures in Virginia, 1819 establishments in the United States, 1810s establishments in Virginia
Centers for Disease Control and Prevention	United States government agencies, United States Department of Health and Human Services
Maria Anna of Austria	Archdukes and Archduchesses of Austria, Habsburg Dynasty, 1683 births, 1754 deaths, House of Braganza, Regents, Kings and Queens consort of Portugal
In the Zone	2003 albums, Britney Spears albums
Brooklyn Botanic Garden	Botanical gardens in the United States, Brooklyn, 1910 establishments in the United States, 1910s establishments in New York (state)
SKN St. Pölten	Austrian football clubs, Football clubs of Lower Austria
House of Bourbon-Parma	Bourbons of Parma, Dukes and Duchesses of Parma
English poetry	Poetry, English literature
Rearrangement reaction	Rearrangement reactions
Computational chemistry	Computational chemistry, Theoretical chemistry
Polymer chemistry	Polymer chemistry
Chemical synthesis	Chemical synthesis
Organic synthesis	Chemical synthesis, Organic chemistry
Alexander Morozevich	1977 births, Living people, Russian chess players, Chess grandmasters
Peter Leko	1979 births, Living people, Hungarian chess players, Chess grandmasters
Abilene Ruff Riders	American football, Abilene, Texas, Sports in Texas
Kifkif	LGBT, Morocco, Non-profit organizations, 2005 establishments, Establishments in Morocco, 2000s establishments in Africa
Jerry Koosman	1942 births, Living people, New York Mets players, Minnesota Twins players, Chicago White Sox players, Philadelphia Phillies players, National League All-Stars
Tom Cleverley	1989 births, Living people, English footballers, People from Basingstoke, People from Bradford, Sportspeople from Hampshire, Sportspeople from Yorkshire, Premier League players
Johnny Bench	1947 births, Cincinnati Reds players, Living people, Major League Baseball broadcasters, National League All-Stars, Sportspeople from Oklahoma City
Gali Akish	Tatars
Yield (chemistry)	Chemistry
Impulse	Basic English 850 words
Alexis Sánchez	1988 births, Living people, Chilean footballers, People from Antofagasta Region, 2010 FIFA World Cup players, 2014 FIFA World Cup players, Arsenal F.C. players, Manchester United F.C. players
Dry cleaning	Physical chemistry, Hygiene, Knowledge, Skills, Clothing
Evolution of cetaceans	Evolutionary biology, Cetaceans
Coal ball	Fossils, Geology
Napster	File sharing
Paul Flory	1910 births, 1985 deaths, American chemists, Scientists from Illinois, People from Elgin, Illinois, Autobiographers, American Nobel Prize winners
Alpine butterfly knot	Knots
List of knots	Knots, Lists
Reef knot	Binding knots, Joining knots
Sheet bend	Joining knots
Extinction (astronomy)	Astronomy
Astronomical object	Astronomical objects
Masala (movie genre)	Cinema of India, Cinema of Pakistan, Bangladeshi culture
Sharaf Khan Bidlisi	Kurdish people, 1543 births, 1603 deaths, Princes and princesses, Historians
Informal economy	Labor, Economic markets, Feminism
Two half-hitches	Hitches
Clove hitch	Hitches
The Hunchback of Notre Dame (1996 movie)	1996 movies, American family movies, American musical movies, Disney animated movies, Disney Renaissance, English-language movies, Fiction set in the past, Movies based on books, Movies composed by Alan Menken, Movies composed by David Newman, Movies set in Paris, The Hunchback of Notre Dame (Disney)
Biological engineering	Biology, Engineering
Audi A8	Audi automobiles, Front wheel drive vehicles, 1990s automobiles, 2000s automobiles, 2010s automobiles
Mariner 3	Mariner program
Selenography	Moon
Sorption	Physics
Dreaming of You (song)	Selena songs, 1995 songs
Selenology	Moon
Fobos-Grunt	Spacecraft, Mars, 2011 in Russia, 2012 in Russia
Wade Belak	1976 births, 2011 deaths, American Hockey League players, Calgary Flames players, Canadian ice hockey defencemen, Colorado Avalanche players, Florida Panthers players, Ice hockey people from Saskatchewan, Nashville Predators players, People from Saskatoon, Saskatoon Blades players, Sportspeople who committed suicide, Suicides in Canada, Toronto Maple Leafs players
Skate (video game)	Sports video games, 2007 video games, PlayStation 3 games, Xbox 360 games
Skate 2	Sports video games, 2009 video games, PlayStation 3 games, Xbox 360 games
Skate 3	Sports video games, 2010 video games, PlayStation 3 games, Xbox 360 games
Materials science	Materials science
Catwalk	Architectural elements, Fashion
About a Girl (song)	Nirvana songs, 1989 songs
The Rescuers	1977 comedy movies, 1977 drama movies, American animated movies, American buddy movies, American comedy-drama movies, American family movies, American musical movies, Disney animated movies, Movies based on books, Movies about animals
Logan Medal of the Arts	Art awards
Thames Barrier	River Thames, Civil engineering, Buildings and structures in England, Flood control
Environmental chemistry	Biochemistry, Chemistry, Environmental chemistry, Water pollution
Foster the People	American pop music groups, Musical groups from Los Angeles, California
Joseph-Louis Lagrange	1736 births, 1813 deaths, Alumni of the École Polytechnique, French mathematicians, Italian mathematicians, People from Turin, Theoretical physicists
Homeless World Cup	Homelessness, Football competitions, Football in Austria, Graz, 2003 establishments
I Know What You Did Last Summer	1997 horror movies, 1997 thriller movies, 1990s horror thriller movies, 1990s mystery movies, 1990s serial killer movies, 1990s teen horror movies, American horror thriller movies, American mystery movies, American serial killer movies, American teen horror movies, Columbia Pictures movies, English-language movies, Movies about revenge, Movies based on books, Movies set in North Carolina, Slasher movies
Amu Darya	Rivers of Afghanistan
Founding Fathers of the United States	Founding Fathers of the United States
CNDO/2	Semiempirical quantum chemistry methods
Argentine Chamber of Phonograms and Videograms Producers	Argentina, Music industry
AMPROFON	Mexican music, Music industry
Signature song	Songs
Selena (movie)	1990s biographical movies, 1997 drama movies, American biographical movies, American drama movies, English-language movies, Jennifer Lopez, Movies set in Texas, Movies based on real life events, Selena, Spanish-language movies
Selena ¡VIVE!	Selena
You and I	2011 songs, Lady Gaga songs
Kalam	Philosophy, Islamic theology
Ohio Senate	Government of Ohio, State upper houses in the United States
Snare drum	Drums
Economic boom	Economics
Tremors (movie)	1990 comedy movies, 1990 horror movies, 1990 science fiction movies, 1990s science fiction horror movies, American comedy movies, American science fiction horror movies, Comedy horror movies, English-language movies, Monster movies, Movies set in Nevada, Universal Pictures movies, Movies directed by Ron Underwood
Tremor	Medical signs, Muscular system
Grignard reaction	Organometallic chemistry, Chemical reactions
Giant Magellan Telescope	Telescopes, Chile
Stinging nettle	Urticaceae
Ferrari F50	Ferrari
Mass spectrum	Spectroscopy, Mass spectrometry
Stuntman (video game)	Racing video games, 2002 video games, Game Boy Advance games, PlayStation 2 games
God's Invitation	Christian theology
Eh, Eh (Nothing Else I Can Say)	2008 songs, Lady Gaga songs, Pop songs
SC Austria Lustenau	Austrian football clubs, Football clubs of Vorarlberg
Kazunori Yamauchi	1967 births, Living people, Japanese video game designers, Japanese racecar drivers, People from Chiba Prefecture
Cradle of Humankind	Geography of South Africa, Evolution, World Heritage Sites in Africa, Archaeological sites in Africa, History of South Africa, Prehistoric Africa
Lokomotiv Yaroslavl plane crash	2011 disasters, 2011 in Russia, Aviation disasters in the 2010s
Lokomotiv Yaroslavl	Sport in Russia, Ice hockey teams in Russia
Overhand knot	Knots
Knot theory	Knots
Fabergé egg	History of Russia, House of Holstein-Gottorp-Romanov, Jewelry
Primary care doctor	Health care
Anthology (Selena album)	1998 albums, Selena albums, Greatest hits albums
All My Hits/Todos Mis Exitos	Selena albums, 1999 albums
All My Hits Vol. 2	Selena albums, 2000 albums
Ones (album)	Selena albums, 2002 albums
Jammu Kashmir Liberation Front	Kashmir, Nationalist organizations in Asia, National liberation movements
Mirador de la Flor	Selena, Statues, Texas
Marie Joséphine of Savoy	1753 births, 1810 deaths, House of Bourbon, House of Savoy, Princes and Princesses of Savoy
Islam in Palestine	Palestinian culture, Islam by country
Specific impulse	Spaceflight, Mechanics
Aromatic hydrocarbon	Hydrocarbons
Erich Probst	1927 births, 1988 deaths, Austrian footballers, Austrian football managers, Players of the Austrian national football team, FC Red Bull Salzburg players
Mac Miller	1992 births, 2018 deaths, American hip hop musicians, American jazz singers, American rap musicians from Pennsylvania, American record producers, American television personalities, Businesspeople from Pittsburgh, Pennsylvania, Drug-related deaths, Jewish American musicians, Jewish businesspeople, Singers from Pittsburgh, Pennsylvania, Warner Bros. Records artists
Crossfade (band)	1990s American music groups, 2000s American music groups, 2010s American music groups, American hard rock bands, American heavy metal bands, Post-grunge bands, Columbia, South Carolina, Musical groups established in 1999, 1999 establishments in the United States, 20th-century establishments in South Carolina
Yabasic	Computer programming, Programming languages
Shaun Marsh	Australian cricketers, Sportspeople from Western Australia, 1983 births, Living people
Isolobal principle	Organometallic chemistry
Alcibiades	450s BC births, 404 BC deaths, Ancient Greek military people, Ancient Greek politicians, Generals, People from Athens
Enamorada de Ti	1990 songs, Selena songs, Songs written by A.B. Quintanilla, Spanish-language songs
Cold cathode	Electronics
Freestyle music	Electronic dance music
Furia Musical	Music magazines
TVyNovelas	Music magazines
Fugues (magazine)	Magazines of Canada, LGBT
Maginot Line	Fortifications of World War II
Alpha cleavage	Organic reactions, Mass spectrometry
Diabetic ketoacidosis	Diabetes mellitus, Diseases
Thornicroft's giraffe	Mammals of Africa
Simple aromatic rings	Organic compounds
Antiknock agent	Chemical substances, Fuel
Fat Lip	Sum 41 songs, 2001 songs
In Too Deep (Sum 41 song)	Sum 41 songs, 2001 songs
Liberal Animation	1988 albums, NOFX albums, Punk albums
Moshchena	Villages in Ukraine, 1543 establishments, Establishments in Ukraine, 1540s establishments in Europe
Adaptive Combat Rifle	Assault rifles, 5.56 mm firearms
Río Alseseca	Rivers of Mexico, Tlaxcala
North Arlington, New Jersey	Boroughs in New Jersey
Holy Cross Cemetery, North Arlington	New Jersey, 1915 establishments in the United States, Cemeteries in the United States, 20th-century establishments in New Jersey
EMI Latin	Latin music, Record labels
Harry Von der Horst	1850s births, 1905 deaths, Sportspeople from Baltimore, Maryland, Baseball executives
Center field	Baseball positions
Tom Daly (infielder)	Cincinnati Reds players, Chicago White Sox players, 1866 births, 1938 deaths, Sportspeople from Philadelphia, Pennsylvania
LP record	Audio disc
Cumbia music	Latin music
Canadian Hot 100	Record charts
Texas Monthly	American magazines, Texas, Weekly magazines, 1973 establishments in the United States, 1970s establishments in Texas
Dulce Amor (song)	Selena songs, 1988 songs
Juan Gabriel	1950 births, 2016 deaths, Cardiovascular disease deaths in Los Angeles County, California, Deaths from myocardial infarction, Latin singers, Mexican singer-songwriters, People from Michoacán, Latin Grammy Award winners
Costumbres	1996 songs, Selena songs, Spanish-language songs
Sony Music Latin	Latin music, Sony, Miami, Florida, 1980 establishments in the United States
Ranchera music	Latin music
Mariachi	Latin music
Joseph Serchuk	1919 births, 1993 deaths, Holocaust survivors, Israeli Jews, Naturalized citizens of Israel, Polish Jews, World War II people
Angry Birds	Mobile games
Fishmonger	Food-related occupations
Deep frying	Cooking methods
Nauru national football team	National football teams, Nauru
Corruption Perceptions Index	Crime by country, Lists of countries
Newhall, California	Settlements in Los Angeles County, California
George Andrew Olah	1927 births, 2017 deaths, People from Budapest, Hungarian people, American chemists, Foreign Members of the Royal Society, Naturalized citizens of the United States, Hungarian Nobel Prize winners, American Nobel Prize winners
Serie D	Football in Italy, Football leagues
Eigenvalues and eigenvectors	Basic physics ideas, Linear algebra
Superacid	Acids
Sick building syndrome	Syndromes, Environment, Air pollution, Buildings and structures
Andrea Libman	1984 births, Living people, Singers from Toronto, Canadian voice actors, Actors from Toronto
17 Again (movie)	2009 comedy-drama movies, 2000s fantasy-comedy movies, 2000s teen comedy movies, 2000s teen drama movies, American comedy-drama movies, American fantasy-comedy movies, American teen comedy movies, American teen drama movies, English-language movies
Four Christmases	2008 comedy-drama movies, 2000s romantic comedy movies, 2000s romantic drama movies, English-language movies, American comedy-drama movies, American romantic comedy movies, American romantic drama movies, German drama movies, Christmas movies, Movies about dysfunctional families, Movies set in San Francisco
Automatic firearm	Firearms
Input device	Computer hardware, Data input
Output device	Computer hardware, Computer science
Hitting for the cycle	Baseball statistics
Doubleheader (baseball)	Baseball
Louisville Colonels	Major League Baseball teams, Sportspeople from Louisville, Kentucky, 1882 establishments in the United States, 1880s establishments in Kentucky, 1899 disestablishments, 1890s disestablishments in the United States
Player-coach	Sports words
Batting average	Baseball statistics, Cricket
New World rats and mice	Rodents
Susana González	1973 births, Mexican television actors, Mexican movie actors, Living people, People from Zacatecas
Fabián Robles	Mexican television actors, 1974 births, Living people, Guanajuato (state)
Marlene Favela	Mexican television actors, Mexican movie actors, Mexican stage actors, 1976 births, Living people
Ninón Sevilla	Cuban actors, Mexican movie actors, Mexican television actors, Deaths from myocardial infarction, 1921 births, 2015 deaths
LG Optimus 2X	LG mobile phones
INDO	Semiempirical quantum chemistry methods
Wiswesser Line Notation	Chemical nomenclature, Cheminformatics
Hemerophile	Animals, Plants
The Winter's Tale	Plays by William Shakespeare
William Griffiths (politician)	1912 births, 1973 deaths, British politicians, Labour MPs (UK)
Gran Turismo (PlayStation Portable)	PlayStation Portable-only games, 2009 video games, Gran Turismo series
Remipedia	Crustaceans
Hokkien	Chinese language, Languages of China
Kumaranalloor	Kerala
Ichinoseki, Iwate	Cities in Japan, Settlements in Iwate Prefecture
Maxillopoda	Crustaceans
Line notation	Notation, Chemical nomenclature, Musical notation
Cephalocarida	Crustaceans
Dulce Amor Tour	Concert tours, 1988 in the United States, 1989 in Texas, 20th century in San Antonio, Texas, 20th century in Dallas, Texas, 20th century in Houston, Texas, History of Austin, Texas
Church's Chicken	1952 establishments in the United States, 1950s establishments in Texas, American fast food restaurants, San Antonio, Texas
PPSh-41	Submachine guns
Geto Boys	1980s American music groups, 1990s American music groups, 2000s American music groups, 2010s American music groups, American rap music groups, Hip hop bands, Musical groups from Texas, Musicians from Houston, Texas, Warner Bros. Records artists
IONIS Education Group	Colleges and universities in France, 1980 establishments in France
Scarface (rapper)	1970 births, Living people, Muslims, American rap musicians from Texas, Singers from Houston, Texas
Die Deutschen Inschriften	History of Germany
Buenos Amigos	Selena songs, 1991 songs, Spanish-language songs
¿Qué Creias?	Selena songs, 1992 songs, Songs written by A.B. Quintanilla, Spanish-language songs
Amame	Selena songs, 1992 songs, Songs written by A.B. Quintanilla, Spanish-language songs
No Debes Jugar	Selena songs, 1993 songs, Songs written by A.B. Quintanilla, Spanish-language songs
La Llamada	Selena songs, 1993 songs, Songs written by A.B. Quintanilla, Spanish-language songs
Tú Robaste Mi Corazón	Selena songs, 1993 songs, Songs written by A.B. Quintanilla, Spanish-language songs
Donde Quiera Que Estés	1994 songs, Selena songs, Spanish-language songs
Bushwick Bill	1966 births, 2019 deaths, Deaths from pancreatic cancer, American rap musicians from Texas, Singers from Houston, Texas, People with dwarfism
Bidi Bidi Bom Bom	Selena songs, 1994 songs, Songs written by A.B. Quintanilla, Spanish-language songs, Selena Gomez songs
Fotos y Recuerdos	Selena songs, 1994 songs, Spanish-language songs
Gullfoss	Waterfalls, Bodies of water of Europe, Geography of Iceland
Si Una Vez	1994 songs, Selena songs, Songs written by A.B. Quintanilla, Spanish-language songs
I Could Fall in Love	1995 songs, 1990s ballads, Pop ballads, Rhythm and blues ballads, Selena songs, Soul ballads
Willie D	1966 births, Living people, American rap musicians from Texas, Singers from Houston, Texas
CiCi's Pizza	1985 establishments in the United States, American fast food restaurants, Companies based in Texas
I'm Getting Used to You	Selena songs, 1995 songs
El Toro Relajo	Selena songs, 1995 songs, Spanish-language songs
Techno Cumbia	Selena songs, 1994 songs, Songs written by A.B. Quintanilla, Spanish-language songs
Tú Sólo Tú	Selena songs, 1995 songs, Spanish-language songs
Captive Heart	Selena songs, 1995 songs
Siempre Hace Frío	Selena songs, 1996 songs, Spanish-language songs
Funeral home	Death, Business
Isotope electrochemistry	Physical chemistry, Isotopes
Where Did the Feeling Go?	Selena songs, 1997 songs
Is It the Beat?	Selena songs, 1997 songs, Songs written by A.B. Quintanilla
Last Dance/The Hustle/On the Radio	Selena songs, 1997 songs
A Boy Like That	1950s songs, Selena songs
Sukiyaki (song)	Pop songs, Selena songs, 1961 songs, Japanese music
Biophysical chemistry	Chemistry, Biology
Bioinorganic chemistry	Biochemistry
Kōji	Japanese food
Madea	Fictional characters
Royal ghost frog	South Africa, Frogs
Joey Tribbiani	Fictional American people, Fictional characters introduced in 1994, Friends characters
Doburoku	Fermented drinks, Japanese food
Pons	Anatomy of the brain
Dibutyl sebacate	Organic compounds
Tombolo	Landforms
Habituation	Learning, Physiology
Nasal consonant	Pronunciation
Term (mathematics)	Algebra
Francisco Hernández de Córdoba (founder of Nicaragua)	1470s births, 1526 deaths, Nicaraguan people
Francisco Hernández de Córdoba (Yucatán conquistador)	1517 deaths, History of Mesoamerica, Spanish explorers, Year of birth unknown
International Direct Dialing	Telecommunications
Direct-broadcast satellite	Television technology
Rage	Emotions
Wii U	Nintendo video game consoles
FG 42	Battle rifles, Light machine guns, 8 mm firearms
Bioorganic chemistry	Biochemistry
Carbocation	Chemistry
Isodesmic reaction	Computational chemistry
Spit	Landforms
Sawfish	Rays
Eagle ray	Rays
Glasgow Prestwick Airport	Airports in Scotland
Shamarpa	Tibetan Buddhism
Naropa	Buddhism
Iodine deficiency	Nutrition, Health problems
John Haymes Newton	1965 births, Living people, American movie actors, American television actors, Actors from North Carolina
William Griffiths (VC)	1841 births, 1879 deaths, Victoria Cross winners, Irish people
Trachea	Animal anatomy
Pete Smith (baseball, born 1966)	1966 births, American baseball players, Atlanta Braves players, Baltimore Orioles players, Cincinnati Reds players, Living people, New York Mets players, San Diego Padres players, Sportspeople from Massachusetts
Pete L. Smith	American baseball players, Boston Red Sox players, Sportspeople from Massachusetts, 1940 births, Living people
Urban Dictionary	1999 establishments in California, American websites
Electric ray	Rays, Cartilaginous fish
Krispy Kreme	1937 establishments in the United States, American food companies, Winston-Salem, North Carolina, 1930s establishments in North Carolina
Infinite (Eminem album)	1996 albums, Debut albums, Eminem albums, Hip hop albums, Hip hop soul albums, R&B albums
The Slim Shady LP	1999 albums, Eminem albums, Hip hop albums, Comedy hip hop albums
Gampopa	Tibetan Buddhist lamas, 1079 births, 1153 deaths
The Marshall Mathers LP	2000 albums, Eminem albums, Hip hop albums, Comedy hip hop albums
Trill consonant	Pronunciation
The Eminem Show	2002 albums, Eminem albums, Hip hop albums, Comedy hip hop albums, Alternative hip hop albums
Encore (album)	2004 albums, Eminem albums
Relapse (album)	2009 albums, Eminem albums
Demersal	Fish, Ecology
S&M Airlines	1989 albums, NOFX albums, Punk albums
Ribbed	1991 albums, NOFX albums, Punk albums
Selena Etc.	1993 establishments in the United States, 2009 disestablishments in the United States, Companies listed on the New York Stock Exchange, Selena
Through the Years/A Traves de los Años	Selena albums, 2007 albums, Spanish-language albums
Wet 'n Wild	Theme parks in the United States
Alice Paul	1885 births, 1977 deaths, Quakers, Civil disobedience
White Trash, Two Heebs and a Bean	1992 albums, NOFX albums, Punk albums
Punk in Drublic	1994 albums, NOFX albums, Punk albums
Canton of Lucerne	Canton of Lucerne
Basel-Landschaft	Basel-Landschaft
Basel-Stadt	Basel-Stadt
Canton of Neuchâtel	Canton of Neuchâtel
PlayStation Vita	Sony, PlayStation, Sony consoles
La Salle University	Atlantic 10 Conference, Colleges and universities in Pennsylvania, Philadelphia, Pennsylvania, 1863 establishments in the United States, 1860s establishments in Pennsylvania
George Washington University	Atlantic 10 Conference, Colleges and universities in the District of Columbia, 1821 establishments in the United States
Feathered dinosaur	Coelurosaurs, Feathered dinosaurs
Monoculture	Agriculture
Rahonavis	Cretaceous dinosaurs, Feathered dinosaurs
Gran Turismo 2	1999 video games, Gran Turismo series
Wii Party	Wii games, 2010 video games, Party video games
UEFA Women's Championship	Football competitions, UEFA
Separatist movements of Pakistan	Politics of Pakistan, National liberation movements
Buddhism in Bangladesh	Bangladeshi culture, Buddhism
Soweto	Johannesburg
Synagogue of Besançon	Synagogues, Buildings and structures in France, Judaism in France, Besançon
Eurovision Song Contest 2012	2012 in music, Eurovision Song Contest, Baku, 21st century in Azerbaijan
Helle Thorning-Schmidt	Prime Ministers of Denmark, 1966 births, Living people
Samantha Stosur	1984 births, Living people, Australian tennis players, Sportspeople from Queensland, Female tennis players, People from Brisbane
Pallas	Titans
Childhood obesity	Obesity
Fricative consonant	Pronunciation
FIFA World Rankings	FIFA
Central limit theorem	Statistics
MG 42	General-purpose machine guns, 8 mm firearms
Chocolate gravy	Sauces
Waziristan	Regions of Pakistan
Chemical biology	Chemistry, Cells
Solid-state chemistry	Chemistry
Abdominal obesity	Obesity
Alveolar consonant	Pronunciation
List of programming languages	Programming languages, Computer-related lists
John George Kemeny	Computer scientists, 1926 births, 1992 deaths
List of bus models	Buses, Transport lists
Odontochelys	Turtles, Marine reptiles
Band gap	Quantum mechanics
Deal or No Deal (UK game show)	2005 British television series debuts, 2000s British television series, 2010s British television series, British television game shows, English-language television programs
Moves Like Jagger	Maroon 5 songs, Christina Aguilera songs, 2011 songs
David Walliams	1971 births, Living people, Actors from London, Actors from Surrey, British children's writers, British television producers, British television writers, Comedians from London, English movie actors, English television actors, English voice actors, Officers of the Order of the British Empire, People with bipolar disorder, British swimmers, Writers from London, Writers from Surrey
Luton	Luton
Superbase	Chemistry
Argyria	Health problems
Windows Task Manager	Software
Chemical species	Chemistry
Task manager	Software
Blind spot (vision)	Experiments, Vision
Lo Barnechea	Cities in Chile
Incubus (1966 movie)	1966 movies, American horror movies, Esperanto
Supramolecular chemistry	Chemistry
Chondroitin sulfate	Organic compounds
Red Bull X2010	Gran Turismo series
Banbasa	Settlements in Uttarakhand, Towns in India
Velar consonant	Pronunciation
George Church	1954 births, American geneticists, Scientists from Boston, Massachusetts, Scientists from Florida, Living people
Revolutions per minute	Units of measurement
Walter Gilbert	1932 births, American physicists, Foreign Members of the Royal Society, Harvard University alumni, Nobel Prize in Chemistry winners, American Nobel Prize winners, Scientists from Boston, Massachusetts, Living people, American molecular biologists
Optic chiasma	Anatomy of the brain, Vision
Chimaera (fish)	Cartilaginous fish
Mainframe computer	Computers
Heavy Petting Zoo	1996 albums, NOFX albums, Punk albums
So Long and Thanks for All the Shoes	1997 albums, NOFX albums, Punk albums
Pump Up the Valuum	2000 albums, NOFX albums, Punk albums
Youth	Life
Simplified molecular input line entry specification	Chemical nomenclature, Cheminformatics
Insulin resistance	Endocrine system, Health problems
Cheminformatics	Computational chemistry, Cheminformatics
The War on Errorism	2003 albums, NOFX albums, Punk albums
Wolves in Wolves' Clothing	2006 albums, NOFX albums, Punk albums
Coaster (album)	2009 albums, NOFX albums, Punk albums
2Pacalypse Now	1991 albums, Debut albums, Tupac Shakur albums, Hip hop albums
Strictly 4 My N.I.G.G.A.Z.	1993 albums, Tupac Shakur albums
Alexander Oparin	Russian scientists, 1894 births, 1980 deaths, Biochemists
Sy Oliver	1910 births, 1988 deaths, American jazz musicians, American composers, Jazz composers, Trumpeters, Musicians from Michigan, People from Battle Creek, Michigan
Aristolochiaceae	Piperales
Not Myself Tonight	2010 songs, Christina Aguilera songs
Context (language)	Human communication, Linguistics
2011 Sindh floods	2011 disasters in Asia, 2010s floods, 2010s in Pakistan, August 2011 events, Floods in Pakistan, History of Sindh, September events
Being (album)	2010 albums
Take a Shine To...	2011 albums
Rohypnol	Drugs, Drugs used in psychiatry
Sponge cake	Cakes
Metabolic syndrome	Syndromes
Me Against the World	1995 albums, Tupac Shakur albums
Palatal consonant	Pronunciation
Approximant consonant	Pronunciation
All Eyez on Me	1996 albums, Tupac Shakur albums
Windows 8	Microsoft operating systems
Windows To Go	Microsoft Windows software
Dardistan	Regions of Pakistan, Geography of Afghanistan, Kashmir
Lahore Stock Exchange	Stock exchanges, Economy of Pakistan, Lahore
M25 motorway	Motorways in England
Harold Urey	1893 births, 1981 deaths, Nobel Prize in Chemistry winners, Foreign Members of the Royal Society, American chemists, American Nobel Prize winners, Scientists from Indiana, Columbia University faculty
German Reich	German Reich
Trịnh Công Sơn	1939 births, 2001 deaths
Constituent Assembly of Pakistan	Government of Pakistan, Parliaments, Pakistan Movement
Piranha 3D	2010 movies, 2010 3D movies, Movies about animals, English-language movies
You Lost Me	2010 songs, Christina Aguilera songs, Pop ballads, Songs about infidelity
Metric system	Measurement, Systems
Piranha 3DD	2011 movies, Movies about animals, English-language movies
Matisyahu	American rap musicians from Pennsylvania, American rock musicians, Reggae musicians, Singers from Pennsylvania, 1979 births, Living people
Tom Waits	1949 births, Living people, Actors from Los Angeles County, California, American movie actors, Musicians from Los Angeles County, California, People from Pomona, California, Singers from Los Angeles County, California
Allama Iqbal International Airport	Airports in Pakistan
Woolly rhinoceros	Rhinoceroses
Woolly mammoth	Extinct elephants, Mammals of North America
Renewable energy in Pakistan	Pakistan, Renewable energy
Welfare	Human rights, Welfare economics
Independent politician	Politics
RNE	Radio
Cleveland Barons (NHL)	Defunct National Hockey League teams, Sports in Cleveland, Ohio, 1976 establishments in the United States, 1978 disestablishments in the United States, 1970s establishments in Ohio
Colorado Rockies (NHL)	Defunct National Hockey League teams, Sports in Denver, Colorado, 1976 establishments in the United States, 1970s establishments in Colorado, 1982 disestablishments in the United States
Hamilton Tigers	Defunct National Hockey League teams, Sport in Hamilton, 1920 establishments, 1925 disestablishments, 1920s establishments in Canada, 20th century disestablishments in Canada
Montreal Maroons	Defunct National Hockey League teams, 1924 establishments in North America, 1920s establishments in Canada, 1938 disestablishments, 20th century disestablishments in Canada
Ottawa Senators (original)	Defunct National Hockey League teams, 1883 establishments, 1880s establishments in Canada, 1954 disestablishments, 20th century disestablishments in Canada
Pittsburgh Pirates (NHL)	Defunct National Hockey League teams, 1925 establishments in the United States, 20th-century establishments in Pennsylvania
St. Louis Eagles	Defunct National Hockey League teams, 1934 establishments in the United States, 1935 disestablishments, 20th-century establishments in Missouri, 1930s disestablishments in the United States, 20th-century disestablishments in Missouri
Reconciliation	Christian theology
Safi Airways	Airlines of Asia, Kabul
Slovak Extraliga	Ice hockey leagues
Swedish Hockey League	1975 establishments in Europe, Ice hockey in Sweden, Ice hockey leagues, 1970s establishments in Sweden
Victorious	2010 American television series debuts, 2013 American television series endings, 2010s American sitcoms, American teen comedy television series, High school television series, Nickelodeon television series, Television series about friendship, Television series about sisters, Television series set in Los Angeles, California, English-language television programs
Samanid dynasty	History of Afghanistan, History of Pakistan, Royal dynasties
Prime Minister of Singapore	Prime Ministers of Singapore, Political office-holders in Singapore, Lists of prime ministers
Rhipidistia	Lobe-finned fish
Elisheva	Old Testament people, Ancient Israeli people
Amminadab	Old Testament people, Ancient Israeli people
Moose Jaw Warriors	1980 establishments, Canadian Hockey League teams, Ice hockey teams in Saskatchewan, Western Hockey League
Ice hockey at the Olympic Games	Ice hockey competitions, Winter Olympic sports
Ice Hockey World Championships	Ice hockey competitions
Tangier	1945 establishments, Phoenician colonies, Cities in Morocco
Tunisair	20th-century establishments in  Tunisia, 1948 establishments, Airlines of Africa, Tunis
Senior Minister	Political office-holders in Singapore
Edifício Altino Arantes	São Paulo, Skyscrapers in Brazil, 1947 establishments in South America, 1940s establishments in Brazil
1918–1920 unrest in Split	20th century in Italy, History of Croatia
Decagon	Polygons
To a Mouse	18th-century British poems, 1785, 1780s works
Tom Petty and the Heartbreakers	Tom Petty, American rock bands, Blues bands, Musical groups from Florida, Warner Bros. Records artists
Echiura	Annelids
Acoelomorpha	Invertebrates, Minor phyla
Atlantic 10 Conference	Atlantic 10 Conference, NCAA Division I athletics conferences, 1976 establishments in the United States
Chess rating system	Chess
Great white pelican	Pelecaniformes
Lipase	Enzymes
Nikolai Volkoff	1947 births, Croatian sportspeople, Former WWE wrestlers, 2018 deaths, Professional wrestlers, WWE Hall of Fame, Yugoslavian sportspeople
Palate	Bones
Mariner 4	Mariner program
Mario Lemieux	1965 births, Art Ross Trophy winners, Bill Masterton Memorial Trophy winners, Calder Trophy winners, Canadian ice hockey centres, Canadian Olympic gold medalists, Cancer survivors, Conn Smythe Trophy winners, People from Wilkes-Barre, Pennsylvania, Hart Memorial Trophy winners, Ice hockey people from Quebec, Laval Voisins players, Living people, Order of Canada, People from Montreal, Pittsburgh Penguins players, Stanley Cup champions
Gordie Howe	1928 births, 2016 deaths, Deaths from stroke, Art Ross Trophy winners, Canadian ice hockey right wingers, Detroit Red Wings players, Hart Memorial Trophy winners, Hartford Whalers players, Hockey Hall of Fame inductees, Ice hockey people from Saskatchewan, Stanley Cup champions, World Hockey Association players, International Hockey League (1945–2001) players
Soviet Championship League	Ice hockey leagues
Russian Superleague	Ice hockey leagues
Czechoslovak First Ice Hockey League	Ice hockey leagues
Myxozoa	Cnidarians, Parasites
Pederpes	Stem tetrapods, Fossils
Yolanda Saldívar	1960 births, Living people, American people convicted of murder, American prisoners sentenced to life imprisonment, Criminals from Texas, Selena
Candlelight vigil	Death customs
Univision	Companies based in California
Lake Jackson, Texas	Cities in Texas
Quinceañera	Birthdays
High school diploma	Education in Canada, Education in the United States
The American School of Correspondence	Schools in the United States, 1897 establishments in the United States, 1890s establishments in Illinois
Rick Trevi	Mexican singers, Singers from Houston, Texas, 1971 births, Living people
SBK Records	Record labels
Spokesperson	Occupations
Elopement (marriage)	Marriage
La Carcacha	Selena songs, 1992 songs, Songs written by A.B. Quintanilla, Spanish-language songs
Music venue	Music venues
Duet	Music
Álvaro Torres	1954 births, Living people, Latin singers, Salvadoran writers, Singer-songwriters
Hot Latin Tracks	Record charts
Dos Mujeres, Un Camino	1993 television series debuts, 1993 establishments in North America, 1990s establishments in Mexico
Premio Lo Nuestro	Music awards
Broadcast Music, Inc.	Music industry
Barrio Boyzz	1990s American music groups, 1991 establishments in New York (state), 2000s American music groups, 2001 disestablishments in the United States, American boy bands, American pop music groups, American R&B bands, Latin music, Musical groups disestablished in 2001, Musical groups established in 1991, Musical groups from New York City
Don Juan DeMarco	1995 comedy movies, 1995 drama movies, 1995 romance movies, English-language movies
Joggins	World Heritage Sites in Canada, Nova Scotia, Lagerstätten
Josh Duhamel	1972 births, Living people, American models, American movie actors, American television actors, American voice actors, American Roman Catholics, Actors from North Dakota, Musicians from North Dakota, People from Minot, North Dakota
Volkswagen Scirocco	Volkswagen automobiles, Front wheel drive vehicles, 1970s automobiles, 1980s automobiles, 1990s automobiles, 2000s automobiles, 2010s automobiles
Tetrapodomorph	Lobe-finned fish, Tetrapods
National League A	Ice hockey leagues
Shoulder	Joints
1941–42 NHL season	1941 in North America, 1942 in North America
1942–43 NHL season	1942 in North America
Wilfred Owen	1893 births, 1918 deaths, British Army people, British military personnel of World War I, English LGBT people, English poets, LGBT military people, LGBT poets, Military people killed in World War I, People from Oswestry
World Cup of Hockey	Ice hockey competitions
Pop icon	Culture
Canada Cup	Ice hockey competitions
Donna Summer	1948 births, 2012 deaths, African American musicians, American Christians, American R&B singers, American singer-songwriters, Cancer deaths in Florida, Deaths from lung cancer, Disco, Grammy Award winners, Writers from Boston, Massachusetts, Singers from Boston, Massachusetts
D.A.R.E.	Education in the United States
Fundraising	Finance
Life imprisonment	Punishments, Imprisonment and detention
Gregory Nava	American movie directors, People from San Diego, California, 1949 births, Living people
People En Espanol	Magazines
Golden Eagle Award	2000s establishments in Russia, 2002 establishments, Movie awards, Television, Russian culture
American Bank Center	Entertainment venues, Sports buildings in Texas, Corpus Christi, Texas, Convention and exhibition centers in the United States
Selena Forever	Selena, 2000s musicals, Musicals based on movies
Murder of Selena	1995 in the United States, 1990s in Texas, 1990s murders in the United States, Corpus Christi, Texas, March events, Murder in 1995, Murders by firearm in Texas, Selena
MG 34	General-purpose machine guns, 8 mm firearms
Ramy Ayach	1980 births, Living people, Druze, Lebanese singers
Islamic Emirate of Afghanistan	History of Afghanistan
Palestinian Jews	Palestinian culture, Judaism
Christianity in Palestine	Palestinian culture, Christianity by country
Dalmatian pelican	Pelecaniformes
Platyzoa	Groups of phyla
Lophotrochozoa	Groups of phyla
French food	French food, Masterpieces of the Oral and Intangible Heritage of Humanity
Rock pool	Biomes, Habitats
Doom engine	Video game technology
Sociolinguistics	Linguistics
J. G. Ballard	1930 births, 2009 deaths, Alumni of King's College, Cambridge, British autobiographers, Cancer deaths in London, Deaths from prostate cancer, English novelists
Indian cormorant	Cormorants
Oriental Darter	Pelecaniformes, Birds of Asia, IUCN Red List near threatened species
Charades	Games
Aestivation	Physiology
Dormancy	Metabolism
Wedding officiant	Law, Marriage
Masked booby	Seabirds
Great cormorant	Cormorants
Little cormorant	Cormorants
Pygmy cormorant	Cormorants, Pelecaniformes
Biographical movie	Biographical movies
List of Selena songs	Selena songs, Lists of songs
Joplin, Missouri	Cities in Missouri, Jasper County, Missouri
Bonsai Kitten	Websites, Shock sites, Hoaxes
Grey heron	Pelecaniformes
Goliath heron	Pelecaniformes
Purple Heron	Pelecaniformes
Striated Heron	Pelecaniformes
Nauplius	Crustaceans, Developmental biology
Arnold Skaaland	1925 births, 2007 deaths, American professional wrestlers, Former WWE wrestlers, Sportspeople from New York, WWE Hall of Fame
Fiat Duna	Fiat automobiles, Front wheel drive vehicles, 1980s automobiles, 1990s automobiles, 2000s automobiles
Night of Champions (2011)	2011 in professional wrestling, WWE Night of Champions, Sports in Buffalo, New York, 2011 in New York (state), 21st century in Buffalo, New York, September events
2010–11 NHL season	National Hockey League seasons, 2010 in North America, 2011 in North America
Dorothée Pousséo	French voice actors, Child actors, 1979 births, Actors from Paris, Living people
Teen Wolf (2011 TV series)	2011 American television series debuts, 2010s American television series, American comedy-drama television series, American fantasy television series, American horror television series, American teen television series, MTV programmes, Television series set in California, English-language television programs
Odessa, Texas	Cities in Texas, County seats in Texas
Mission, Texas	Cities in Texas
McAllen, Texas	Cities in Texas
Municipal corporation	Urban planning
Hunico	1977 births, Living people, WWE wrestlers, American professional wrestlers, Sportspeople from El Paso, Texas, Total Nonstop Action Wrestling alumni
Lucky Cannon	American professional wrestlers, Former WWE wrestlers, Living people, Sportspeople from Florida, Year of birth missing (living people)
Orlando Cole	American cellists, 1908 births, 2010 deaths, American teachers
Edwin G. Krebs	1918 births, 2009 deaths, Nobel Prize in Physiology or Medicine winners, American biochemists, American Nobel Prize winners, Scientists from Iowa
Joseph L. Goldstein	1940 births, Living people, American biochemists, American geneticists, American Nobel Prize winners, Jewish American academics, Jewish American scientists, Jewish Nobel Prize winners, Scientists from South Carolina
International human rights law	Human rights, International law
Genocide Convention	Genocide, Human rights, International law, 1948, History of the United Nations
Michael Madsen	Actors from Chicago, American movie actors, American movie producers, American photographers, American television actors, American voice actors, Celebrity Big Brother contestants, 1957 births, Living people
Chris Penn	Cardiovascular disease deaths in the United States, American movie actors, American television actors, Actors from Los Angeles, California, 1965 births, 2006 deaths
St. John's IceCaps	American Hockey League teams, Ice hockey teams in Canada, St. John's, Newfoundland and Labrador
Grand Theft Auto III	2001 video games, Grand Theft Auto, Cancelled Nintendo GameCube games, Impact of the September 11 attacks, PlayStation 2 games, Windows games, Xbox games
Lawrence Bender	1957 births, Living people, HuffPost writers and columnists, American bloggers
The Cider House Rules (movie)	1999 movies, 1990s romantic drama movies, American romantic drama movies, Movies based on books, Movies set in Maine, Movies set in the 1920s, Movies set in the 1940s, Movies directed by Lasse Hallström
The Bad Girls Club (season 6)	2011 in American television, 2011 television seasons, Bad Girls Club seasons
Convention against Torture	Torture, Human rights, International law
The Bad Girls Club (season 5)	2010 in American television, 2010 television seasons, Bad Girls Club seasons
Flow (psychology)	Psychology
The Bad Girls Club (season 4)	2009 in American television, 2009 television seasons, 2010 in American television, 2010 television seasons, Bad Girls Club seasons
The Bad Girls Club (season 3)	2008 in American television, 2008 television seasons, 2009 television seasons, Bad Girls Club seasons
The Bad Girls Club (season 2)	2007 in American television, 2007 television seasons, 2008 in American television, 2008 television seasons, Bad Girls Club seasons
The Bad Girls Club (season 1)	2006 in American television, 2007 in American television, 2007 television seasons, Bad Girls Club seasons
Halifax Mooseheads	Canadian Hockey League teams, Halifax, Nova Scotia, Ice hockey teams in Canada, Quebec Major Junior Hockey League, 1994 establishments in Canada
Johnathan Aitken	1978 births, American Hockey League players, Boston Bruins players, Brandon Wheat Kings players, Canadian ice hockey defencemen, Chicago Blackhawks players, Ice hockey people from Alberta, Living people, Medicine Hat Tigers players, Sportspeople from Edmonton, ECHL players
Ray Allison	1959 births, American Hockey League players, Brandon Wheat Kings players, Canadian ice hockey centres, Hartford Whalers players, Ice hockey people from British Columbia, Living people, Philadelphia Flyers players
Edifício Copan	São Paulo, Skyscrapers in Brazil, 1966 establishments in South America, 1960s establishments in Brazil
UEFA Euro 2012 qualifying Group A	UEFA Euro 2012 qualifying
UEFA Euro 2012	UEFA Euro 2012
Private property	Property
Radiata	Groups of phyla, Taxonomy
Wangari Maathai	1940 births, 2011 deaths, Deaths from ovarian cancer, Environmentalists, Nobel Peace Prize winners
Trochophore	Invertebrates, Developmental biology
Orthonectida	Minor phyla, Parasites
Lophophore	Invertebrates, Developmental biology
Rhombozoa	Invertebrates, Parasites
Besitos	Selena songs, 1988 songs, Songs written by A.B. Quintanilla, Spanish-language songs
Baila Esta Cumbia	Selena songs, 1990 songs, Songs written by A.B. Quintanilla, Spanish-language songs
No Quiero Saber	Selena songs, 1990 songs, Songs written by A.B. Quintanilla, Spanish-language songs
Ya Ves	Selena songs, 1990 songs, Songs written by A.B. Quintanilla, Spanish-language songs
La Tracalera	Selena songs, 1984 songs, Spanish-language songs
El Chico Del Apartamento 512	Selena songs, 1994 songs, Songs written by A.B. Quintanilla, Spanish-language songs
Greatest Hits (Selena album)	Selena albums, 2003 albums, Greatest hits albums
Momentos Intimos	Selena albums, 2004 albums, Compilation albums
Dos Historias	Selena albums, 2006 albums, Compilation albums
2011 Atlantic hurricane season	Atlantic hurricane seasons, 2011 in weather
Oxygen (TV channel)	American television networks
Kerry Harvick	Living people, 1974 births, Country musicians, singers from Texas
Ireland's Call	Sport in Ireland, Songs
Chinese musical system	Music, China
The Enemy (Higson novel)	2009 books, Young adult novels, Horror novels
David Norris	Living people, 1944 births, Irish politicians
Spinneret	Spiders
Endocardium	Heart, Anatomy of the cardiovascular system
Selena singles discography	Discographies, Selena songs
Beelzebufo	Frogs, Fossils
Fezouata Formation	Lagerstätten, Morocco
1961–62 AHL season	1961 in ice hockey, 1962 in ice hockey, American Hockey League, 1961 in North America, 1962 in North America
1961 World Ice Hockey Championships	1961 in ice hockey, 20th century in Geneva, Sport in Switzerland, 1960s in Europe
1961 Stanley Cup Finals	1961 in ice hockey, Chicago Blackhawks, Detroit Red Wings, 1961 in the United States, 1960s in Chicago, 20th century in Detroit, Michigan
Wolf spider	Lycosidae
Andrea Cano	1976 births, Living people, Italian association football goalkeepers, Italian football managers, Sportspeople from Rome
Web feed	Computers
Barcelona-Sagrera	Spain, Barcelona Metro
Cross-conjugation	Organic chemistry
Eric Serra	French composers, 1959 births, Living people
Education in the United States	Education in the United States
1961 Memorial Cup	1960s in Canada, 1961 in ice hockey, Memorial Cup
Ergonomic keyboard	Computers
1962 Memorial Cup	1962 in ice hockey, Memorial Cup, 1960s in Canada
1961 in sports	1961 in sports
2011 in sports	2011 in sports
Rafael Correa	1963 births, Living people, People from Guayaquil, Presidents of Ecuador
Elissa	1972 births, Living people, Lebanese Christians, Lebanese singers
Bastanak	2006 albums
Order of the Solar Temple	Secret societies, Geneva
Epistemic community	Community
Biosemiotics	Systems theory, Semiotics
University of Tartu	Colleges and universities in Europe, Estonia, 1632 establishments, 1630s establishments in Europe
Marcel Dionne	1951 births, Art Ross Trophy winners, Canadian ice hockey centres, Detroit Red Wings players, Ice hockey people from Quebec, Lady Byng Memorial Trophy winners, Living people, Los Angeles Kings players, New York Rangers players, International Hockey League (1945–2001) players, Quebec Major Junior Hockey League players
Infant mortality	Death, Statistics
What a Girl Wants	1999 songs, Christina Aguilera songs, Billboard Rhythmic Songs number-one singles
Bryan Trottier	1956 births, Art Ross Trophy winners, Canadian ice hockey centres, Canadian ice hockey right wingers, Calder Trophy winners, Conn Smythe Trophy winners, Hart Memorial Trophy winners, Hockey Hall of Fame inductees, Ice hockey people from Saskatchewan, Lethbridge Broncos players, Living people, New York Islanders players, Pittsburgh Penguins players, Stanley Cup champions, Swift Current Broncos players
Woohoo	2010 songs, Christina Aguilera songs, Nicki Minaj, Songs about sexuality
Australian gold rush	19th century in Australia, Gold rushes, 1850s
Romney Marsh	Geography of England, Kent, Sussex
Padua Airport	Airports in Europe, Buildings and structures in Italy, Padua, Transport in Italy
Toxaphene	Organic compounds
Eduard Strauss	1835 births, 1916 deaths, Austrian composers
Jug (container)	Containers
Paul Goldschmidt	1987 births, Living people, American baseball players, Arizona Diamondbacks players, Sportspeople from Wilmington, Delaware
Dendritic cell	Blood cells, Immunology
Ralph Steinman	1943 births, 2011 deaths, Canadian academics, Canadian Jews, Canadian Nobel Prize winners, Canadian physicians, Canadian scientists, Cell biology, Deaths from pancreatic cancer, Harvard University alumni, Immunologists, Jewish academics, Jewish Nobel Prize winners, Jewish scientists, People from Montreal, Scientists from New York City
Residual-current device	Electrical wiring, Safety, Hardware (mechanical)
Calico cat	Cats, Chromosomes
Bruce Beutler	1957 births, Living people, American geneticists, American Nobel Prize winners, American physicians, Immunologists, Jewish American academics, Jewish American scientists, Jewish Nobel Prize winners, Scientists from Chicago, University of Chicago alumni
Jules Hoffmann	1941 births, Living people, French academics, French biologists, French Nobel Prize winners, Immunologists
Autoimmune disease	Autoimmune diseases
Factoid	Philosophy
Allotropes of carbon	Carbon
SpySheriff	Malware, Spyware
Lunokhod 1	Soviet spacecraft, Moon, Planetary rovers
Salmonella enterica	Gram-negative bacteria, Microbiology
Irene Castle	American animal rights activists, 1893 births, 1969 deaths, American dancers, American movie actors
Medusa (biology)	Cnidarians
Expenditure	Economics
UN Women	2010 establishments, United Nations, Organizations in New York City, Human rights organizations, Women
Ruslan Salei	1974 births, 2011 deaths, Aviation deaths, American Hockey League players, Belarusian ice hockey players, Colorado Avalanche players, Detroit Red Wings players, Florida Panthers players, International Hockey League (1945–2001) players, Mighty Ducks of Anaheim players, People from Minsk, Ice hockey defencemen
Mr. Know It All	2011 songs, Kelly Clarkson songs
Andrei Kostitsyn	1985 births, Belarusian ice hockey players, Living people, Montreal Canadiens players, Nashville Predators players
Zygomycota	Fungi
Sébastien Bordeleau	1975 births, American Hockey League players, French ice hockey players, Hull Olympiques players, Ice hockey centres, Ice hockey people from British Columbia, Living people, Minnesota Wild players, Montreal Canadiens players, Nashville Predators players, Phoenix Coyotes players, Sportspeople from Vancouver
Philippe Bozon	1966 births, American Hockey League players, French ice hockey players, International Hockey League (1945–2001) players, Living people, Saint-Jean Castors players, St. Louis Blues players
Nizari	Islamic denominations
Invisible College	History of science, Royal Society, 17th century establishments in England
List of WWE Divas Champions	World Wrestling Entertainment championships, Lists of professional wrestlers
Steve Wozniak	1950 births, Living people, People from San Jose, California
Krzysztof Oliwa	1973 births, American Hockey League players, Boston Bruins players, Calgary Flames players, Columbus Blue Jackets players, Living people, New Jersey Devils players, New York Rangers players, Pittsburgh Penguins players, Polish ice hockey players, ECHL players, International Hockey League (1945–2001) players
Edward Leier	1927 births, Living people, Polish ice hockey players, Chicago Blackhawks players, Ice hockey centres
Knut Andresen	1959 births, Living people, Norwegian ice hockey players
Nik Antropov	1980 births, American Hockey League players, Atlanta Thrashers players, Canadian ice hockey centres, Kazakhstani ice hockey players, Living people, Naturalized citizens of Canada, New York Rangers players, Toronto Maple Leafs players, Winnipeg Jets players
Kevin Dallman	1981 births, American Hockey League players, Boston Bruins players, Canadian ice hockey defencemen, Ice hockey people from Ontario, Kazakhstani ice hockey players, Living people, Los Angeles Kings players, St. Louis Blues players, Ontario Hockey League players
Alliance, Nebraska	Cities in Nebraska, County seats in Nebraska
Yelena Chernykh	1979 births, 2011 deaths, Russian stage actors
Brian Schmidt	Living people, Harvard University alumni, Australian scientists, Astrophysicists, 1967 births, Australian Nobel Prize winners, American Nobel Prize winners, Australian academics, Scientists from Montana, Australian educators, People from Missoula, Montana
Crab Nebula	Nebulae, Supernovae
Trackball	Computer hardware
Binary pulsar	Binary stars, Relativity, Variable stars
Zacarias Moussaoui	1968 births, Living people, Al-Qaeda people, French criminals, French prisoners, Prisoners sentenced to life imprisonment, September 11 attacks
Massari	1981 births, Living people, Massari, Canadian singers, Lebanese Muslims, Naturalized citizens of Canada
Kid Nation	2007 television series debuts, CBS network shows, American reality television series, English-language television programs
Big Brother 14 (U.S.)	2012 in American television, 2012 television seasons, Big Brother seasons, American television seasons
Austrian Hockey League	Ice hockey leagues
Tamura, Fukushima	Cities in Fukushima Prefecture
Mount Stromlo Observatory	Observatories in Australia, Buildings and structures in Canberra, 1924 establishments, 1920s establishments in Australia
Pietro Baracchi	1851 births, 1926 deaths, Italian astronomers
Melbourne Observatory	Observatories in Australia, Buildings and structures in Melbourne, 1861 establishments in Australia
Matt Cooke	1978 births, American Hockey League players, Canadian ice hockey left wingers, Ice hockey people from Ontario, Living people, Minnesota Wild players, Ontario Hockey League players, Pittsburgh Penguins players, Stanley Cup champions, Vancouver Canucks players, Washington Capitals players
Mencius	Chinese philosophers, Humanism, 4th century BC births, 3rd century BC deaths
Radio frequency	Electromagnetic radiation, Radio technology
White-flippered penguin	Penguins
Chris Nilan	1958 births, American ice hockey players, Sportspeople from Boston, Massachusetts, Boston Bruins players, Living people, Montreal Canadiens players, New York Rangers players, Stanley Cup champions
Solar telescope	Telescopes
Dave Semenko	1957 births, 2017 deaths, Brandon Wheat Kings players, Canadian ice hockey left wingers, Deaths from liver cancer, Deaths from pancreatic cancer, Edmonton Oilers players, Hartford Whalers players, Ice hockey people from Manitoba, Sportspeople from Winnipeg, Stanley Cup champions, Toronto Maple Leafs players, World Hockey Association players, Central Professional Hockey League players
Seraikistan	Pakistan
Hexachlorobenzene	Carbon compounds, Chlorine compounds
Chlordane	Chemical compounds, Carcinogens
Aldrin	Chemical compounds
Mirex	Hydrocarbons
Dieldrin	Chemical compounds
Endrin	Chemical compounds, Organic compounds, Pollution
Mount Stromlo	Mountains of Australia, Australian Capital Territory
National Museum of Australia	National museums, Museums in Australia, Government agencies of Australia, Buildings and structures in Canberra, 2001 establishments in Australia
Terminal Velocity (video game)	1995 video games, DOS games
Star Fox 64	1997 video games, Nintendo 64 games, Virtual Console games, Nintendo Entertainment Analysis and Development games, Star Fox
Page layout	Typography, Graphics
Eric Carle	1929 births, 2021 deaths, Deaths from renal failure, American children's writers, Writers from New York, People from Syracuse, New York, American illustrators, Disease-related deaths in Massachusetts, American military personnel of the Korean War
The Very Hungry Caterpillar	1969 books, English-language picture books, Children's books, Children's picture books
1920 Duluth lynchings	1920 in the United States, Deaths by hanging, Duluth, Minnesota, Murder in the United States, 20th century in Minnesota, Lynching
Lynching	Civil rights, Murders, Lynching
MERLIN	Telescopes
Grouped data	Statistics
Kim Hyun-Soo	Names
Epitech	Schools in France, 1999 establishments in France, Réunion
École spéciale de mécanique et électricité	Schools in France, 1905 establishments in France
Conférence des Grandes Écoles	Education in France
Winnipeg Jets (1972–96)	1972 establishments in Canada, 1996 disestablishments in North America, 1990s disestablishments in Canada, Defunct National Hockey League teams, Ice hockey teams in Canada, Sport in Manitoba, World Hockey Association teams
F♯ (musical note)	Musical notes
A (musical note)	Musical notes
American Old West	American Old West
Desktop publishing	Typography, Graphics, History of printing
Gene silencing	Cell biology, Molecular biology
Neurospora	Fungi, Model organisms
Rosemont, Illinois	Villages in Illinois, Settlements in Cook County, Illinois, Suburbs of Chicago, Illinois
Satellite television	Television technology
Granada television	Defunct companies of the United Kingdom, Entertainment companies
Heptachlor	Chemical compounds
Magellan Telescopes	Telescopes, Astronomical observatories in Chile
Las Campanas Observatory	Astronomical observatories in Chile
Tyler Perry	1969 births, Living people, Actors from Louisiana, African American actors, African American movie directors, African American movie producers, African American writers, American Christians, Screenwriters from Louisiana, Writers from New Orleans, Louisiana
Be Easy	Massari, 2005 songs
Smile for Me	Massari, 2005 songs
Massari (album)	2005 albums, Debut albums, Massari, R&B albums, Pop albums, Hip hop albums
Spectrograph	Astronomy, Physics
Ken Mogi	1962 births, Living people, Scientists from Tokyo, University of Tokyo alumni
Occupy Wall Street	2011 in New York (state), 2010s in New York City, Protests in the 2010s
Thelma	Given names
First light (astronomy)	Telescopes
Esther Vergeer	1981 births, Living people, Dutch Paralympic gold medalists, Dutch Paralympic silver medalists, Dutch wheelchair basketball players, Dutch wheelchair tennis players, 2000 Summer Paralympics, 2004 Summer Paralympics, 2008 Summer Paralympics, 2012 Summer Paralympics, Sportspeople from Utrecht (province)
Liz Kendall	Labour MPs (UK), 1971 births, Living people
Keith Vaz	1956 births, Living people, Labour MPs (UK), Members of the British House of Commons for English constituencies, Politicians from London
Korie Homan	1986 births, Living people, Dutch Paralympic gold medalists, Dutch Paralympic silver medalists, Dutch wheelchair tennis players, Sportspeople from Drenthe
Party realignment in the United States	History of the United States, Politics
Krishna	Krishna, Hindu gods and goddesses
Rotating furnace	Telescopes, Optics
Dependent and independent variables	Experiments, Mathematics
Hamnet Shakespeare	1585 births, 1596 deaths, People from Warwickshire, Twin people from England
Large Zenith Telescope	Canada, Telescopes
Stéphane Hessel	1917 births, 2013 deaths, Deaths from natural causes, Political activists, French diplomats, People from Berlin
First Battle of Maryang San	1951, Korean War, 1950s in Australia
Ferdinand I of Bulgaria	Knights of the Golden Fleece, Bisexual people, 1861 births, 1948 deaths, Bulgarian people, Kings and queens, Botanists, Philatelists
Fugacity	Thermodynamics
Laava	1983 births, Living people, Brazilian singers
Jay Brannan	1982 births, Living people, Actors from Austin, Texas, American movie actors, LGBT actors, LGBT people from Texas, LGBT singers, LGBT songwriters, Singer-songwriters from Texas
Marojejy National Park	Madagascar, National parks in Africa
Philo T. Farnsworth	1906 births, 1971 deaths, American inventors, Deaths from pneumonia, American Latter Day Saints, Businesspeople from Idaho, Businesspeople from Utah, Television people, Scientists from Idaho, Scientists from Utah
Luigi Bruins	1987 births, Living people, Dutch footballers, FC Red Bull Salzburg players, Sportspeople from Rotterdam
Gerund	Parts of speech
Institution of Electrical Engineers	Organisations based in the United Kingdom
Participle	Parts of speech
Diary of a Mad Black Woman	2005 movies, American comedy movies, Movies set in Atlanta, Georgia, English-language movies, Movies about divorce, Lionsgate movies
Crash Bandicoot (video game)	PlayStation games, 1996 video games, Crash Bandicoot games, Naughty Dog games
Messerschmitt	Aviation
J Balvin	Colombian singers, Songwriters, 1985 births, Living people, Reggaeton, Latin Grammy Award winners
Killers (1997)	1997 movies, English-language movies
List of frogs and toads in New Jersey	Amphibians, Lists of animals
Northern Cricket Frog	Frogs
Ted Williams	1918 births, 2002 deaths, Deaths from cardiac arrest, Cryonically preserved people, American baseball players, Boston Red Sox players, Sportspeople from San Diego, California
Empress Suiko	554 births, 628 deaths, Emperors of Japan
Berkshire Hathaway	American financial companies, Insurance companies
Battle of Valcour Island	1776 in New York (state), Battles of the American Revolutionary War, October events
Valcour Bay	American Revolutionary War, Straits
Valcour Island	Islands of New York
Guy Carleton, 1st Baron Dorchester	1724 births, 1808 deaths, British Army generals
Bleeding Love	2007 songs, Leona Lewis
TBS	American television networks, Time Warner, Companies based in Atlanta, Georgia, 1976 establishments in the United States, 20th-century establishments in Georgia (U.S. state)
Good Luck Charlie	2010s American television series, 2011 American television series debuts, 2014 American television series endings, American sitcoms, Disney Channel shows, Television series by Disney, English-language television programs
Shake It Up (TV series)	American sitcoms, 2010s American television series, 2010 American television series debuts, 2013 American television series endings, Disney Channel shows, Television series by Disney, English-language television programs
Indian Camp	1924, 20th-century American short stories
Help Wanted (SpongeBob SquarePants)	SpongeBob SquarePants episodes, 1999 television episodes
Magellanic Clouds	Local galaxies, Dwarf galaxies
Christmas Who?	SpongeBob SquarePants episodes, 2000 in American television, 2000 television episodes, Christmas television episodes
Graveyard Shift	SpongeBob SquarePants episodes, 2002 in American television, 2002 television episodes
Sailor Mouth	SpongeBob SquarePants episodes, 2001 in American television, 2001 television episodes, Television episodes about profanity
Trinomial nomenclature	Taxonomy
Siberian crane	Critically endangered species, Cranes
The Climb (song)	2009 songs, Miley Cyrus songs
Nyarlathotep	Characters in written fiction
Suiko Seamount	Seamounts, Pacific Ocean, Volcanoes of Oceania
DeVry University	1930s establishments in Illinois, 1931 establishments in the United States, Colleges and universities in Illinois
Nintoku Seamount	Seamounts, Pacific Ocean, Volcanoes of Oceania
Light machine gun	Light machine guns
Meiji Seamount	Seamounts, Pacific Ocean, Volcanoes of Oceania
E. E. Cummings	1894 births, 1962 deaths, American poets, American Christians, Harvard University alumni, Writers from Massachusetts
Yūryaku Seamount	Seamounts, Pacific Ocean, Volcanoes of Oceania
Kimmei Seamount	Seamounts, Pacific Ocean, Volcanoes of Oceania
Minister Mentor	Members of the Cabinet of Singapore, Political office-holders in Singapore
Double helix	Geometry, Molecular biology
Cuatro Torres Business Area	Madrid, 2000s establishments in Spain
Trillion	Integers
Frank Abagnale	1948 births, Living people, American fraudsters, Businesspeople from New York City
Someone like You (Adele song)	2010s ballads, 2011 songs, Adele songs, Pop ballads, Soul songs, R&B songs, Torch songs
Kegon Falls	Waterfalls, Bodies of water of Japan, Geography of Japan
Razor shell	Bivalves
Cockle	Bivalves
Vernon Castle	1887 births, 1918 deaths, English dancers
Wildfire	Ecology, Fire
Bipod	Photography, Firearms
Emperor Jomei	593 births, 641 deaths, Emperors of Japan
Lawson Inada	1938 births, Living people, American jazz musicians, American poets, Musicians from California, Writers from California, People from Fresno, California
Nobushige Hozumi	1856 births, 1926 deaths, Japanese politicians, People from Ehime Prefecture
Sport Relief	BBC, Sports
Pope Gregory I	540 births, 604 deaths, Christian theologians, Christian writers, Italian popes, People from Rome
Casino Marina del Sol	Buildings and structures in Chile, 21st-century establishments in Chile, 2005 establishments in South America
Functional magnetic resonance imaging	Medical tests, Medical imaging
My Prerogative	1988 songs, Britney Spears songs
Cultural icon	Symbols, Cultural history
Sciadopitys	Conifers, Living fossils, Fossil plants
General-purpose machine gun	Medium machine guns, General-purpose machine guns
Yamashiro Province	Former provinces of Japan, Kyoto Prefecture
Symphyla	Myriapods
Pauropod	Myriapods
Defence against herbivory	Botany, Coevolution, Ecology
Wheeling Tunnel	Tunnels
Postgenderism	Gender
Kawachi Province	Former provinces of Japan, Osaka Prefecture
Karl Friedrich Schinkel	1781 births, 1841 deaths, German architects, German painters, People from Brandenburg, People from Prussia, Urban planners
Hey, Soul Sister	2009 songs
Hardwood	Wood
HM Prison Pentridge	Prisons, Buildings and structures in Melbourne, Law enforcement in Australia, 1851 establishments, 1997 disestablishments, 1850s establishments in Australia, 20th century disestablishments in Australia
Michael Chabon	Writers from Washington, D.C., Living people, 1963 births, Pulitzer Prize winners
Amit	Given names
Izumi Province	Former provinces of Japan, Osaka Prefecture
Settsu Province	Former provinces of Japan, Osaka Prefecture
Chloris	Greek mythology
Portable Network Graphics	Computer file formats
Curaçao	Dependent territories, Curaçao, Caribbean Community
Ox Mountain	Folklore, Literature
Human zoo	Cultural anthropology
Rye Beach, New Hampshire	Settlements in New Hampshire, Unincorporated communities in the United States, 1884 establishments in the United States, 1880s establishments in New Hampshire
Dan Wheldon	1978 births, 2011 deaths, Accidental deaths in the United States, Deaths in sport, English racecar drivers, Sportspeople from Buckinghamshire, IndyCar Series drivers
Ise Province	Former provinces of Japan, Mie Prefecture
Iga Province	Former provinces of Japan, Mie Prefecture
Curing salt	Food ingredients
Ferdinand VI of Spain	1713 births, 1759 deaths, People from Madrid, Kings and Queens of Spain, Princes and Princesses of Asturias, Spanish House of Bourbon
Neue Wache	Buildings and structures in Berlin
Transitivity (grammar)	Grammar
Audio description	Audio technology
Teak	Lamiaceae, Trees
Reel-to-reel tape recorders	Magnetic tape
Gym Class Heroes	1997 establishments in the United States, 1990s American music groups, 1990s establishments in New York (state), 2000s American music groups, 2010s American music groups, American rap music groups, Hip hop bands, Musical groups established in 1997, Musical groups from New York
Artificial cranial deformation	Traditions, Body art
Convention on the Elimination of All Forms of Racial Discrimination	History of the United Nations, Human rights, 1965, Politics of South Africa, 20th century in South Africa
International Covenant on Civil and Political Rights	United Nations, Human rights
International Covenant on Economic, Social and Cultural Rights	United Nations, Human rights
Economic, social and cultural rights	Human rights
Vickers machine gun	Medium machine guns
Albania at the Olympics	Nations at the Olympics, Sport in Albania
American Samoa at the Olympics	Nations at the Olympics, American Samoa
Andorra at the Olympics	Nations at the Olympics, Sport in Andorra
Tori Spelling	Actors from Los Angeles, California, American movie actors, American movie producers, American television actors, American television producers, American television writers, American voice actors, writers from Los Angeles, California, 1973 births, Living people
Royal Standard of Scotland	Flags of the United Kingdom, Scotland, Royalty and nobility, British monarchy, 1222 establishments, Establishments in Scotland, 1220s establishments in Europe
Flower of Scotland	National anthems, Scotland
Thistle	Asteraceae, Scotland
Football in Scotland	Football in Scotland
Micrograph	Photography, Microscopes
Felix Adjei	Ghanaian footballers, 1990 births, Living people, FC Red Bull Salzburg players
Wolfgang Köhler	German psychologists, 1887 births, 1967 deaths
Gluten-free diet	Nutrition
Little Havana	Miami, Florida
Howard Stern	1954 births, Living people, American autobiographers, American radio personalities, American television producers, American television talk show hosts, American television writers, Comedians from New York City, People from Queens, Television personalities from New York City, Writers from New York City
Myra (singer)	1986 births, American child singers, Pop singers, American dancers, Living people, Singers from California
3LW	1999 establishments in the United States, 1990s American music groups, 2000s American music groups, 2007 disestablishments in the United States, American girl groups, American R&B bands, Hip hop bands, Musical groups established in 1999, Musical groups disestablished in 2007, Musical groups from New Jersey, Newark, New Jersey, 1990s establishments in New Jersey
Nadia López	1983 births, Living people, Mexican singers, People from Oaxaca
Diana Reyes	Mexican singers, Latin singers, 1979 births, Living people, Baja California Sur
Ivy Queen	1972 births, Living people, Puerto Rican singers, Rap musicians
Fanny Lu	Colombian singers, 1973 births, Living people, Latin singers
Don Omar	1978 births, Living people, Puerto Rican singers, Latin singers, Reggaeton, Latin Grammy Award winners
Kat DeLuna	1987 births, Living people, singers from New York City
Aventura	1994 establishments in the United States, 1990s American music groups, 1990s establishments in New York (state), 2000s American music groups, 2010s American music groups, 2011 disestablishments in the United States, American R&B bands, Latin music, Musical groups disestablished in 2011, Musical groups established in 1994, Musical groups from New York City
Jennifer Peña	singers from Texas, 1983 births, Living people, Latin singers, People from Corpus Christi, Texas, Tejano musicians
The Cheetah Girls (group)	American girl groups
Tito Nieves	1958 births, Living people, Puerto Rican singers
Manny Manuel	1972 births, Living people, Puerto Rican singers, American choreographers
Girl in a Coma	American rock bands, American punk bands, Musicians from San Antonio, Texas, Musical groups from Texas
Angel y Khriz	Reggaeton, American musical groups, Puerto Rican entertainers, Musical groups established in 2002, 2002 establishments in the United States, Establishments in Puerto Rico
Karen Rodriguez	singers from New York City, 1989 births, Living people
Prince Royce	Living people, 1989 births, singers from New York City, Latin singers
Frankie J	1980 births, American singer-songwriters, Latin singers, Living people
Q'orianka Kilcher	1990 births, Living people, American movie actors, Actors from Hawaii
Sara Tavares	1978 births, Living people, Portuguese singers, Cape Verdean people
Conservative Judaism	Jewish denominations
Stringybark Creek	Ned Kelly
First Minister	Prime ministers, Government occupations
North Borneo at the Olympics	Former nations at the Olympics, Sport in Malaysia, 1956 Summer Olympics, History of Malaysia
Forbes list of billionaires	Billionaires, Lists of people
Gestalt psychology	Branches of psychology, Illusions
Max Wertheimer	1880 births, 1943 deaths, American psychologists, Czech Jews, Jewish American academics, Jewish American scientists, Jewish German academics, Jewish German scientists, Naturalized citizens of the United States, People from Prague, Refugees from Nazism, Psychologists
Optical illusion	Psychology, Illusions
Cassette single	Music technology
Guitar solo	Guitars
Music of Colombia	Music by nationality, Colombian culture
The Band Perry	Musical groups established in 2005, Country bands, Musical groups from Alabama, Musical groups from Mississippi, Musical groups from Tennessee, 2005 establishments in the United States
Criminal (song)	2011 songs, Britney Spears songs
Sound check	Concerts, Music
Ricky Martin (1991 album)	1991 albums, Spanish-language albums, Debut albums, Latin music albums, Latin pop albums, Ricky Martin
Latin Pop Albums	Latin music, Selena, Ricky Martin, Christina Aguilera, Shakira
Peter Carey (novelist)	1943 births, Living people, Writers from Victoria (Australia), Booker Prize winners
Emperor Kanmu	Emperors of Japan, 737 births, 806 deaths
National Cleavage Day	Human sexuality, South Africa, Breasts
Chauchilla Cemetery	Peru, Cemeteries
Heian period	Periods in Japanese history
Garnishment	Law
Gigantoraptor	Oviraptorosauria
University of Tübingen	1477 establishments, Baden-Württemberg, Colleges and universities in Germany, Establishments in Germany, 1470s establishments in Europe
Pylorus	Anatomy of the digestive system
Huxley family	Huxley family
Starfleet	Star Trek, San Francisco in fiction
Betty Garrett	American movie actors, American stage actors, American television actors, American dancers, Actors from Missouri, Singers from Missouri, People from St. Joseph, Missouri, Deaths from aortic aneurysm, 1919 births, 2011 deaths
Simon van der Meer	1925 births, 2011 deaths, Dutch Nobel Prize winners, Dutch physicists, People from The Hague
Gerry Rafferty	1947 births, 2011 deaths, Deaths from liver failure, Disease-related deaths in England, Scottish rock singers, Scottish singer-songwriters
Saeed Shehabi	1954 births, Living people, Bahraini people, Journalists, Political activists
Steve Prestwich	1954 births, 2011 deaths, Deaths from brain cancer, People from Liverpool, English drummers, Australian singers, People from Adelaide, Musicians from South Australia, English rock musicians, Australian drummers, Australian rock musicians
Culture hero	Mythology
Emperor Heizei	Emperors of Japan, 773 births, 824 deaths
IPhone 4S	Messaging, IPhone, Mobile phones released in 2011
Sakyo Komatsu	1931 births, 2011 deaths, Futurists, Japanese novelists, Science fiction writers, People from Osaka
Norio Ohga	1930 births, 2011 deaths, Japanese businesspeople, Sony, People from Shizuoka Prefecture
Farley Granger	1925 births, 2011 deaths, Actors from Santa Clara County, California, American autobiographers, LGBT people from California, American movie actors, American stage actors, American television actors, LGBT actors, Deaths from natural causes, People from San Jose, California
Burhanuddin Rabbani	Presidents of Afghanistan, Assassinated people, 1940 births, 2011 deaths
Norman Corwin	1910 births, 2011 deaths, Writers from Boston, Massachusetts, American journalists
Bert Jansch	1943 births, 2011 deaths, British folk musicians, British guitarists, Cancer deaths in England, Deaths from lung cancer, Entertainers from Edinburgh, Musicians from Glasgow, Scottish musicians, Scottish singer-songwriters
Desmond Mason	Milwaukee Brewers players, Living people, 1977 births, People from Waxahachie, Texas, Seattle SuperSonics players, New Orleans Hornets players, Sacramento Kings players, Oklahoma City Thunder players, Sportspeople from Texas
Ernesto Sabato	1911 births, 2011 deaths, Argentine painters, Argentine scientists, Argentine writers, Deaths from bronchitis, Disease-related deaths in Argentina, People from Buenos Aires Province, Physicists
Dick King-Smith	1922 births, 2011 deaths, British children's writers, English novelists, Officers of the Order of the British Empire, Writers from Gloucestershire
Poly Styrene	1957 births, 2011 deaths, Black British musicians, British punk musicians, Cancer deaths in England, Deaths from breast cancer, Disease-related deaths in Sussex, English rock musicians, English singer-songwriters, Musicians from Kent, People from Bromley, People with bipolar disorder, Singers from London
Phoebe Snow	singers from New York City, 1950 births, 2011 deaths
Vann Nath	Artists, 1946 births, 2011 deaths, Writers, Cambodian people
Stefan Maierhofer	1982 births, Living people, Austrian footballers, Players of the Austrian national football team, FC Red Bull Salzburg players
Vittorio Arrigoni	1975 births, 2011 deaths, Deaths by strangulation, Gaza Strip, Italian writers, Italian journalists, Murder victims, People from Lombardy
Thor Vilhjalmsson	1925 births, 2011 deaths, Icelandic writers, People from Edinburgh
Party Rock Anthem	2011 songs, Billboard Rhythmic Songs number-one singles
Cy Twombly	American painters, 1928 births, 2011 deaths
Owsley Stanley	2011 deaths, 1935 births, Accidental deaths in Australia, American chemists, Australian scientists, Road accident deaths, Scientists from Kentucky
Miss Independent	2003 songs, Kelly Clarkson songs
Bruce Cowan	1926 births, 2011 deaths, Order of Australia, Politicians from New South Wales, National Party of Australia politicians
Anne Francis	1930 births, 2011 deaths, Actors from New York, American movie actors, American stage actors, American television actors, Cancer deaths in the United States, Deaths from pancreatic cancer
Dorothea Puente	1929 births, 2011 deaths, Deaths from natural causes, American prisoners, American serial killers, People from Sacramento, California
Paul Baran	1926 births, 2011 deaths, American computer scientists, Engineers from California
Tom Gehrels	1925 births, 2011 deaths, American astronomers, Asteroid discoverers
City of Preston	District and borough councils in Lancashire
Diane Cilento	1933 births, 2011 deaths, Actors from Queensland, Australian movie actors, Australian television actors, Cancer deaths in Queensland, People from the Sunshine Coast, Queensland, Writers from Queensland
Charles Napier	1936 births, 2011 deaths, Deaths from thrombosis, American movie actors, American television actors, American voice actors, actors from Kentucky
Elisabeth Sladen	1946 births, 2011 deaths, Actors from Liverpool, Cancer deaths in England, English movie actors, English stage actors, English television actors
Jordan Lake	Lakes of the United States, Geography of North Carolina
U + Ur Hand	2006 songs, Pink songs
Melody Thornton	American singer-songwriters, American dancers, Models from Phoenix, Arizona, Writers from Phoenix, Arizona, 1984 births, Living people, Participants in American reality television series, Singers from Phoenix, Arizona
Jessica Sutta	1982 births, Living people, American dancers, Models from Florida, American movie actors, American television actors, Pussycat Dolls, Actors from Miami, Florida, Singers from Miami, Florida
Ashley Roberts	American dancers, Models from Phoenix, Arizona, American movie actors, 1981 births, Living people, Pussycat Dolls, American television personalities, Actors from Phoenix, Arizona
Kimberly Wyatt	American singer-songwriters, American dancers, American models, American television actors, Actors from Missouri, 1982 births, Living people, Pussycat Dolls
Edward Hardwicke	1932 births, 2011 deaths, Actors from London, Cancer deaths in England, English movie actors, English stage actors, English television actors, English voice actors, Royal Air Force
Ludmilla Radchenko	Russian actors, Reality television participants, Russian artists, Russian models, Living people, 1978 births
Gil Scott-Heron	African American musicians, African American writers, American blues musicians, American jazz musicians, American poets, American soul musicians, Musicians from Chicago, People with HIV/AIDS, Singers from Chicago, Writers from Chicago, 1949 births, 2011 deaths
Basse-Terre	Communes in Guadeloupe, Departmental capitals in France, Regional capitals in France
Separatist movements of India	Separatist movements of India
Manfred Gerlach	1928 births, 2011 deaths, German mayors, Members of the Volkskammer, People from Leipzig, Politicians from Saxony, Presidents of East Germany
Jeff Conaway	1950 births, 2011 deaths, Actors from New York City, American movie actors, American television actors, Deaths from pneumonia
Don Kirshner	1934 births, 2011 deaths, American songwriters, Record producers
Dan Peek	1950 births, 2011 deaths, American rock guitarists, Musicians from Florida, American folk musicians, Country musicians
John Dye	1963 births, 2011 deaths, American television actors, Actors from Mississippi
Park Gyu-ri	1988 births, Living people, K-pop singers, South Korean singers, People from Seoul
Kang Jiyoung	1994 births, Living people, K-pop singers, South Korean singers
Cliff Robertson	1923 births, 2011 deaths, American stage actors, American television actors, Emmy Award winners, Actors from San Diego, California, Best Actor Academy Award winners
Jagjit Singh	1941 births, 2011 deaths, Cardiovascular disease deaths in India, Indian singers
Grete Waitz	1953 births, 2011 deaths, Cancer deaths in Norway, Competitors in athletics, Female athletes, Medalists at the 1984 Summer Olympics, Norwegian Olympians, Olympic silver medalists, Sportspeople from Oslo
Ryan Dunn	1977 births, 2011 deaths, Accidental deaths in Pennsylvania, American television personalities, Entertainers from Ohio, Road accident deaths in the United States
Knut Steen	1924 births, 2011 deaths, Norwegian people, Sculptors
Pokémon Mystery Dungeon	Pokémon RPGs, Video game spin-offs
Alberto Granado	1922 births, 2011 deaths, Argentine scientists, Biochemists, Cuban people
Tony Tan	People's Action Party (Singapore) politicians, Political office-holders in Singapore, 1940 births, Living people
Nguyen Cao Ky	1930 births, 2011 deaths, Vietnamese people, Prime ministers
Thriller (song)	Pop songs, 1984 songs, Michael Jackson songs
Equivalence relation	Mathematics
Solid-state drive	Storage devices
Martial Célestin	1913 births, 2011 deaths, Prime Ministers of Haiti
Norwegian Crusade	History of Norway, Crusades
Jumping spider	Spiders
William Lipscomb	1919 births, 2011 deaths, American chemists, American Nobel Prize winners, Deaths from pneumonia, Infectious disease deaths in the United States, People from Cambridge, Massachusetts, Scientists from Cleveland, Ohio, Harvard University faculty
I Am Weasel	Cartoon Network series, Animated television series, 1990s television series, 1997 American television series debuts, 2000 American television series endings, English-language television programs
Hella Haasse	1918 births, 2011 deaths, Dutch novelists, People from Batavia
Derived demand	Economics
Pete Postlethwaite	Actors from Lancashire, Cancer deaths in England, Deaths from pancreatic cancer, English movie actors, English stage actors, English television actors, English voice actors, Members of the Order of the British Empire, People from Warrington, 1946 births, 2011 deaths
IHOP	1958 establishments in the United States, Companies based in California, Glendale, California, American restaurants
Otmar Gutmann	1937 births, 1993 deaths, Animators, German entertainers, People from Baden-Württemberg, Television directors, Television producers
Zwijndrecht, Netherlands	Settlements in South Holland, Municipalities of South Holland
Kan'ichi Asakawa	1873 births, 1948 deaths, Asian historians, Japanese scientists, Japanologists, People from Fukushima Prefecture, Waseda University alumni, Yale University alumni
OPERA experiment	Physics, Experiments
Ian Nish	Living people, British historians, Japanologists, Commanders of the Order of the British Empire, 1926 births, University of Sydney faculty
Reggaeton	Reggaeton, Reggae music
First Kashmir War	Wars involving Pakistan, 1947 in Asia, Wars involving India, Jammu and Kashmir, 1940s in India
Indo-Pakistani War of 1965	1965, 1960s in Asia, Jammu and Kashmir, Wars involving India, Wars involving Pakistan
Nusrat Bhutto	Pakistani people, 1929 births, 2011 deaths
Japan studies	Japan
Blind Fool Love	2000s music groups, 2010s music groups, Italian musical groups, Post-hardcore bands
Codelco	Metals, Chile, Santiago de Chile
Planet Dinosaur	2011 British television series debuts, 2010s British television series, BBC Television programmes, Dinosaurs, Documentaries, English-language television programs
Protecting Children from Internet Pornographers Act	Internet, Pornography, United States law, Children
Aishwarya Rai Bachchan	1973 births, Indian movie actors, Indian models, Miss World winners, Indian beauty pageant winners
Mariner 9	Mariner program, Mars
Flemming Jørgensen	1947 births, 2011 deaths, Danish actors, Danish singers, Danish movie actors
William George Aston	Japanologists, British historians, 1841 births, 1911 deaths, British diplomats
Emperor Junna	Emperors of Japan, 786 births, 840 deaths
Stye	Diseases and disorders of the eye
Isaac Titsingh	1745 births, 1812 deaths, Ambassadors of the Netherlands, Dutch esotericists, Dutch historians, Dutch scientists, Fellows of the Royal Society, Freemasons, Japanologists, Writers from Amsterdam
Morrison Formation	Jurassic dinosaurs, Geography of Montana, Geography of Utah, Geography of Colorado, Geography of Nebraska, Geography of Kansas, Geography of Arizona, Geography of New Mexico, Geography of Wyoming, Lagerstätten, Dinosaurs of North America, Geological formations, Sedimentary rocks

