Appomattox Court House	American Civil War
Base isolation	Earthquake engineering
Shōō (Kamakura period)	Japanese eras, 1288 establishments, 13th-century establishments in Japan, 1293 disestablishments, 13th century disestablishments in Japan
Vibration control	Earthquake engineering, Mechanical vibrations
Telephone card	Telephone
Vera Menchik	1906 births, 1944 deaths, British chess players, Czech people, Sportspeople from Moscow
Alexandra Kosteniuk	Russian chess players, 1984 births, Living people, Chess grandmasters
King's Sutton railway station	Trains, Northamptonshire, Railway stations in England
Akbash Dog	Dog breeds
Clapping	Sound
Strung Out	American punk bands, Musical groups from California, Simi Valley, California
Reading and Leeds Festivals	Music festivals in England
Circa Survive	American rock bands, musical groups from Philadelphia, Pennsylvania, 2004 establishments in the United States, 2000s establishments in Pennsylvania
The Blind Side (movie)	2009 drama movies, 2000s biographical movies, 2000s sports drama movies, Academy Award winning movies, American biographical movies, American sports drama movies, English-language movies, Memphis, Tennessee, Movies based on books, Warner Bros. movies
Lahaul and Spiti district	Local government in India, Himachal Pradesh
Presidency division	Divisions of West Bengal
Burdwan division	Divisions of West Bengal
List of presidents of the United States	Presidents of the United States, Lists of legislative speakers
Jalpaiguri division	Divisions of West Bengal
History of chess	Chess
Shani	Hindu mythology
Wolfgang Wagner	1919 births, 2010 deaths, German musical entertainers, Opera
American Foxhound	Dog breeds
Mu isamaa, mu õnn ja rõõm	Estonia, National anthems
V sign	Peace, Symbols, Non-verbal communication
Emperor Ankō	Emperors of Japan
Building code	Buildings and structures, Earthquake engineering
Supply-side economics	Economic policy, Presidency of Ronald Reagan
Vaan	Video game characters, Final Fantasy
Royal Canadian Mounted Police	Government agencies of Canada, Law enforcement agencies
Vielle	String instruments
Metropolitan Museum of Art	Museums in New York City, Art museums in the United States, Buildings and structures in Manhattan, 1870 establishments in New York (state)
Stéphane Grappelli	Jazz musicians, Musicians from Paris, Violinists, 1908 births, 1997 deaths
30 Minut	2003 songs
Einin	Japanese eras
ICarly	Children's television series, Nickelodeon television series, 2010s American sitcoms, English-language television programs
Scouting for Girls	2005 establishments in England, 2000s British music groups, 2010s British music groups, British pop rock bands, English pop music groups, English rock bands, Musical groups established in 2005, Musical groups from London, Musical trios
Božidar Bandović	Football managers, Serbian people, 1969 births, Living people
Enthronement	Ceremonies
Détente	International relations
Castoreum	Chemical compounds, Organic compounds
Fitzwilliam Virginal Book	Music media
Blue Ridge Mountains	Mountains of the United States, Appalachian Mountains
Mount Mitchell	Mountains of the United States, Geography of North Carolina, Appalachian Mountains
Sweet Home Alabama	1970s songs
Face to Face (band)	American punk bands, Musical groups from California, Musical groups established in 1991, 1991 establishments in California, Musical groups disestablished in 2004, 2004 disestablishments in the United States, 2000s disestablishments in California, Musical groups established in 2008, 2008 establishments in California
Geffen Records	1980 establishments in the United States, 1980s establishments in New York (state), American record labels, Companies based in New York City
Fast Forward Weekly	Newspapers published in Canada
Seismic performance	Earthquake engineering
Philidor	1726 births, 1795 deaths, Chess players, French composers, French writers
Silent majority	Politics
1960 United States presidential election	1960 in the United States, United States presidential elections
Emperor Ingyō	Emperors of Japan
Alien and Sedition Acts	1790s in the United States, United States federal legislation, John Adams, 1798
Pak Hon-yong	1900 births, 1956 deaths, Executed people, Korean activists, Korean feminists, North Korean politicians, People executed by firearm, South Korean politicians
Shogi	Chess variants, Japanese culture
1964 United States presidential election	1964 in the United States, United States presidential elections
1980 United States presidential election	1980 in the United States, 1980 elections, Jimmy Carter, Ronald Reagan, United States presidential elections
1984 United States presidential election	1984 in the United States, 1984 elections, Ronald Reagan, United States presidential elections
Kofun period	Periods in Japanese history, 250s establishments, 3rd century establishments in Asia, 538 disestablishments, Establishments in Japan, Disestablishments in Japan
Alexis Jordan	1992 births, Living people, Singers from South Carolina, American television actors, actors from South Carolina, Alexis Jordan, People from Columbia, South Carolina
Pico de gallo	Mexican sauces
Lighter	Light
Bridgit Mendler	1992 births, Living people, Actors from Marin County, California, Actors from Washington, D.C., American child actors, American child singers, American movie actors, American pop singers, American television actors, Singers from California, Singers from Washington, D.C.
Shake-table	Earthquake engineering, Modeling, Research
Chiniot District	Districts of Punjab (Pakistan), Faisalabad Division
Como La Flor (song)	1992 songs, Selena songs, Songs written by A.B. Quintanilla, Spanish-language songs
Spyware removal software	Spyware
Thul Taluka	Talukas of Sindh, Jacobabad District
Kamakura, Kanagawa	Cities in Kanagawa Prefecture, 1192 establishments, 1190s establishments in Japan
Concepción	1550 establishments, Concepción, 1550s establishments in South America, 16th-century establishments in Chile
Mass versus weight	Matter, Physics
Microsoft Security Essentials	Microsoft software, Antivirus software
Down by Law (band)	1990s American music groups, 2000s American music groups, 2010s American music groups, American punk bands, Musical groups from Los Angeles, California
Bhagat Singh	1907 births, 1931 deaths
Wisdom teeth	Teeth
Sebastián Piñera	1949 births, Living people, Chilean politicians, Current national leaders, Presidents of Chile, Chilean businesspeople, Billionaires, People from Santiago
Kamakura period	Periods in Japanese history, Samurai, 12th-century establishments in Japan, 1330s disestablishments in Japan, 1333 disestablishments, 1185 establishments
American Football Conference	National Football League
Tuned mass damper	Earthquake engineering
Nelsinho Baptista	1950 births, Living people, Brazilian footballers
Cesare Prandelli	1957 births, Living people, Italian footballers, Italian football managers
Gerhard Domagk	1895 births, 1964 deaths, German doctors, German Nobel Prize winners
Tomoyoshi Ikeya	1962 births, Living people, Footballers from Shizuoka Prefecture
Henrik Dam	1895 births, 1976 deaths, Danish scientists, Biochemists, Danish Nobel Prize winners
Josip Kuže	1952 births, 2013 deaths, Croatian footballers
Cairo International Book Fair	Cairo, 1969 establishments, 20th-century establishments in Egypt
Park Kyung-Hwan	1976 births, Living people, South Korean footballers
Alexander Alekhine	Russian chess players, 1946 deaths, 1892 births
Smoke grenade	Toys, Weapons, Law enforcement equipment
Kōan (Kamakura period)	Japanese eras, 1278 establishments, 13th-century establishments in Japan, 1288 disestablishments, 13th century disestablishments in Japan
Elevated building foundation	Earthquake engineering
Kenji (era)	Japanese eras, 1270s in Japan
Seismic load	Earthquake engineering
Henry Wadsworth Longfellow	1807 births, 1882 deaths, 19th-century American poets, Writers from Massachusetts, Writers from Maine, People from Portland, Maine, People from Cambridge, Massachusetts
Bun'ei	Japanese eras, 1260s in Japan, 1270s in Japan
Boston Police Strike	1919 in the United States, 20th century in Boston, Massachusetts, Law enforcement in the United States, Protests in the 1910s
Panama City	National capitals in North America, Cities in Central America, Settlements in Panama
Nobuyuki Uenoyama	1957 births, Living people, Footballers from Osaka Prefecture, People from Osaka
Josep María Comadevall	1983 births, Living people, Spanish footballers
Henk ten Cate	1954 births, Living people, Dutch footballers, Dutch football managers, Sportspeople from Amsterdam, Eredivisie managers
Edson Aparecido de Souza	1962 births, Living people, Brazilian footballers
Edson Rodrigues	1967 births, Living people, Brazilian footballers
Dan Ito	1975 births, Living people, Footballers from Hokkaidō Prefecture
Noriyuki Kawamata	1967 births, Living people, Footballers from Saitama Prefecture
Takeshi Satouchi	1957 births, Living people, Footballers from Shiga Prefecture
Billy Budd (opera)	Compositions by Benjamin Britten, 1950s operas, 1951
Toru Yoshida	1965 births, Living people, Footballers from Iwate Prefecture
Matsuichi Yamada	1961 births, Living people, Footballers from Shizuoka Prefecture
Motoaki Inukai	1942 births, Living people, Footballers from Saitama Prefecture
Kōan (Muromachi period)	Japanese eras, 1361 establishments, 1360s establishments in Japan, 1362 disestablishments, 1360s disestablishments in Japan
Samarkand	World Heritage Sites in Asia, Cities in Uzbekistan
Kōchō	Japanese eras, 1261, 1262, 1263, 1264, 1260s in Japan
Arovell Verlag	Book publishing companies, 1991 establishments in Europe, 1990s establishments in Austria
Powder monkey	Childhood, War, Occupations, Sailing
Seismic analysis	Earthquake engineering, Modeling, Research
Wiener Werkstattpreis	Literary awards
Petting, Germany	Villages in Bavaria
Japanese American internment	1940s in the United States, Crimes against humanity, Franklin D. Roosevelt, Imprisonment and detention, World War II, Concentration camps
Feldkircher Lyrikpreis	Literary awards, Austrian culture, Vorarlberg
Inferno Metal Festival	Oslo, Music festivals, Festivals in Europe
Sailing ship	Ships
Weather radar	Meteorology
Hominid (novel)	2008 books, Novels
Impressment	Navy
Naïve	Human behavior
Bun'ō	Japanese eras, 1260, 1261, 1260s in Japan
Miodrag Božović	1968 births, Living people, Montenegrin footballers
Kenichi Sugano	1971 births, Living people, Footballers from Kanagawa Prefecture
Lawar	Thai food
Strength training	Fitness
Naohiko Minobe	1965 births, Living people, Footballers from Shiga Prefecture
Hitoshi Nakata	1962 births, Living people, Footballers from Osaka Prefecture, People from Osaka
Karin Gayer	Austrian writers, 1969 births, Living people
Franzobel	1967 births, Austrian writers, Austrian poets, Living people
German National Library	Buildings and structures in Frankfurt, Buildings and structures in Saxony, Leipzig, Libraries in Germany, National libraries in Europe
Intonation (linguistics)	Linguistics
Heinz Gerstinger	1919 births, 2016 deaths, Austrian historians, Austrian playwrights, Writers from Vienna
Ingrid Reichel	1961 births, Living people, Austrian painters, Austrian writers, Essayists, People from Lower Austria
Absurdism	Philosophical movements and positions
Elpídio Silva	1975 births, Living people, Brazilian footballers
Takahiro Shimada	1965 births, Living people, Footballers from Osaka Prefecture, People from Osaka
Ryuji Ishizue	1964 births, Living people, Footballers from Hyōgo Prefecture
Shuichi Mase	1973 births, Living people, Footballers from Mie Prefecture
Tropical Storm Grace (2009)	2009 Atlantic hurricane season, Atlantic tropical storms, October 2009 events
Amar Osim	1967 births, Living people, Bosnia and Herzegovina footballers, Bosnia and Herzegovina football managers, People from Sarajevo
Be Good to Me	2006 songs
Emperor Kameyama	Emperors of Japan, 1249 births, 1305 deaths
National Diet Library	National libraries in Asia, Buildings and structures in Japan, 1948 establishments in Asia, 1940s establishments in Japan
Weight training	Fitness
Gang	Gangs
Folk metal	Heavy metal subgenres
Ensiferum	Finnish heavy metal bands, Folk metal bands, Musical groups from Helsinki, Musical groups established in 1995, 1995 establishments in Europe, 20th century establishments in Finland
Shōgen	Japanese eras, 1259, 1260, 1250s in Japan, 1260s in Japan
Kenichiro Tokura	1971 births, Living people, Footballers from Kanagawa Prefecture
Gahkuch	Cities in Pakistan
Sicilian defence	Chess openings
King's Gambit	Chess openings
Celtic Sea	Seas of the Atlantic Ocean, Bodies of water of Europe
Réti opening	Chess openings
Barbed wire	Security, Ranching, War
Balanced budget amendment	United States Constitution
Howard Staunton	1810 births, 1874 deaths, British chess players, English writers
Syncope	Symptoms
English opening	Chess openings
Sebastián Pardo	1982 births, Living people, Chilean footballers, People from Quillota
Goran Rubil	1981 births, Living people, Croatian footballers
Carlos Alberto Dias	1967 births, Living people, Brazilian footballers, People from Brasília
Claiton Fontoura dos Santos	1978 births, Living people, Brazilian footballers, People from Porto Alegre
Reinaldo Vicente Simão	1968 births, Living people, Brazilian footballers
Ovidiu Burcă	1980 births, Living people, Romanian footballers
Jussiê Ferreira Vieira	1983 births, Living people, Brazilian footballers
Oh Jang-Eun	1985 births, Living people, South Korean footballers
Caíco	1974 births, Living people, Brazilian footballers, People from Porto Alegre
Argélico Fuchs	1974 births, Living people, Brazilian footballers, Brazilian football managers
Henrique Arlindo Etges	1966 births, Living people, Brazilian footballers
Moacir Rodrigues Santos	1970 births, Living people, Brazilian footballers
Emerson Orlando de Melo	1973 births, Living people, Brazilian footballers
Claudio Ubeda	1969 births, Living people, Argentine footballers
Christoffer Andersson	1978 births, Living people, Swedish footballers
Shōan	Japanese eras, 1299, 1300s in Japan
Kengen	Japanese eras, 1302, 1303, 1300s in Japan
Jimmy Connors	1952 births, American male tennis players, Australian Open champions, Living people, People from East St. Louis, Illinois, Sportspeople from Illinois, US Open (tennis) champions, Wimbledon champions, World No. 1 tennis players
Kagen	Japanese eras, 1303, 1304, 1305, 1306, 1300s in Japan
Westport, Connecticut	Towns in Connecticut
Wofford College	Colleges and universities in South Carolina
Tokuji	Japanese eras, 1306, 1307, 1308, 1300s in Japan
Enkyō (Kamakura period)	Japanese eras, 1308 establishments, 14th century establishments in Japan, 1311 disestablishments, 14th century disestablishments in Japan
Preparatory school	Schools, Types of educational institutions
OR gate	Logic gates
Ōchō	Japanese eras, 1311 establishments, 1310s establishments in Japan, 1312 disestablishments, 1310s disestablishments in Japan
NOR gate	Logic gates
XOR gate	Logic gates
Hollywood Undead	Hip hop bands, Musical groups from Los Angeles, California
Erik Edman	1978 births, Living people, Swedish footballers
Magnus Hedman	1973 births, Living people, Swedish footballers, Association football goalkeepers
Ludovic Magnin	1979 births, Living people, Swiss footballers, Swiss football managers, People from Lausanne
Takashi Umeda	1976 births, Living people, Footballers from Gifu Prefecture
Yohei Fukumoto	1987 births, Living people, Footballers from Oita Prefecture
Marcelo Chamusca	1966 births, Living people, Brazilian footballers, Brazilian football managers, People from Salvador, Bahia
Manabu Komatsubara	1981 births, Living people, Footballers from Gunma Prefecture
Shinichi Terada	1985 births, Living people, Footballers from Osaka Prefecture, People from Osaka
Naruyuki Naito	1967 births, Living people, Footballers from Nara Prefecture
Július Bielik	1962 births, Living people, Slovak footballers
Tigran Petrosian	1929 births, 1984 deaths, Chess grandmasters, People from Tbilisi, Armenian people
Mikkel Kessler	Boxers, Danish sportspeople, People from Copenhagen, 1979 births, Living people
Line-item veto	Legal terms
Milton Friedman	1912 births, 2006 deaths, American agnostics, American economists, American Nobel Prize winners, Deaths from heart failure, Jewish American academics, Jewish American scientists, Jewish Nobel Prize winners, Libertarians, Republicans (United States), Scientists from San Francisco, Scientists from Chicago, Scientists from New Jersey, Scientists from New York City, Writers from San Francisco, Writers from Chicago, Writers from New Jersey, Writers from New York City
Electron configuration	Chemistry
Asuka period	Periods in Japanese history, 538 establishments, Establishments in Japan, 710s disestablishments in Japan, 6th century establishments in Asia
Marie Byrd Land	Geography of Antarctica
American Ornithologists' Union	Birds
Freedom, New Hampshire	Cities in New Hampshire
Constantinople Conference	1870s in Europe, 1876, 1877, History of Turkey
Demetri Martin	1973 births, Living people, Actors from New Jersey, Actors from New York City, Comedians from New Jersey, American movie actors, American stand-up comedians, American television actors, American television personalities, American television producers, American television writers, Comedy Central personalities, Writers from New Jersey, Writers from New York City, Comedians from New York City
Indian Removal Act	1830 in the United States, Andrew Jackson, United States federal legislation, Native American
John Wall	1990 births, American basketball players, Washington Wizards players, Sportspeople from North Carolina, Living people
Don Goodman	1966 births, Living people, English footballers, People from Leeds
Ricardo Cabanas	1979 births, Living people, Swiss footballers, Sportspeople from Zürich
Yuki Maki	1984 births, Living people, Footballers from Kumamoto Prefecture
Casting Crowns	Grammy Award winners, Christian rock bands, Musical groups from Florida, 1999 establishments in the United States, Musical groups established in 1999, 1990s establishments in Florida
Shigeyoshi Suzuki	1902 births, 1971 deaths, Footballers from Fukushima Prefecture, Japan international footballers, Japanese football managers, Japan national football team managers
Danny Blind	1961 births, Living people, Dutch football managers, Dutch footballers, Eredivisie managers, People from Vlissingen, Sportspeople from Zeeland
The Zephyr Song	2002 songs, Red Hot Chili Peppers songs
Amtrak	Amtrak
Dirk Lehmann	1971 births, Living people, German footballers, People from Aachen, Sportspeople from North Rhine-Westphalia
José Roberto de Oliveira	1980 births, Living people, Brazilian footballers
Robert Pereira da Silva	1985 births, Living people, Brazilian footballers
Atlético Clube Goianiense	Brazilian football clubs, Goiás
José Ricardo dos Santos Oliveira	1984 births, Living people, Brazilian footballers, Paraíba
Paulo Jamelli	1972 births, Living people, Brazilian footballers
Eugène Terre'Blanche	1941 births, 2010 deaths, Afrikaner people, Murder victims, People convicted of assault, People convicted of attempted murder, South African politicians
Emperor Kōshō	Emperors of Japan
Emperor Kōan	Emperors of Japan
Emperor Kōrei	Emperors of Japan
Roanoke Island	Islands of the United States, Geography of North Carolina
Transcontinental Railroad	Rail transport in the United States
Emperor Kōgen	Emperors of Japan
Gukanshō	History of Japan, 13th century books
Emperor Kaika	Emperors of Japan
Emperor Sujin	Emperors of Japan
Soda bread	Breads, Irish food
Anne of Denmark	1574 births, 1619 deaths, Kings and Queens consort of England
Henry Frederick, Prince of Wales	House of Stuart, 1594 births, 1612 deaths, Deaths from typhoid fever
Maurício Rodrigues Alves Domingues	1978 births, Living people, Brazilian footballers
Donald-Olivier Sié	1970 births, Living people, Ivorian footballers
Adriano Pimenta	Brazilian footballers, 1982 births, Living people, Goiânia
Marc Wilmots	1969 births, Living people, Belgian footballers, Belgian football managers, People from Walloon Brabant
Taro Ichiki	1976 births, Living people, Footballers from Tokyo Prefecture
Oséas	1971 births, Living people, Brazilian footballers, People from Salvador, Bahia
Hidetoki Takahashi	1916 births, 2000 deaths, Footballers from Fukushima Prefecture, Japanese football managers, Kashiwa Reysol players, Japan national football team managers
Flavio Elias Cordeiro	1975 births, Living people, Brazilian footballers
Kim Geun-Chol	1983 births, Living people, South Korean footballers
Censorship by Google	Google, Censorship
Myoglobin	Proteins, Iron compounds
Proxy marriage	Marriage
Hyperkalemia	Health problems
Sophie of Mecklenburg-Güstrow	1557 births, 1631 deaths, Kings and Queens of Denmark, Kings and Queens consort
Frederick II of Denmark	1534 births, 1588 deaths, Kings and Queens of Denmark, Kings and Queens of Norway
Emperor Suinin	Emperors of Japan
Lisa Della Casa	1919 births, 2012 deaths, European opera singers, Sopranos, Swiss singers
Samoyed (dog)	Dog breeds
Emperor Hanzei	Emperors of Japan
Title role	Performing arts
Character actor	Actors
Giulio Caccini	1551 births, 1618 deaths, Italian composers, Baroque composers, Renaissance composers
Free Soil Party	Political parties in the United States
The Jungle	English-language novels, History of Chicago, 1906 books
Emperor Keikō	Emperors of Japan
James Francis Edward Stuart	1688 births, 1766 deaths, British Roman Catholics, House of Stuart, Jacobite pretenders
Prince of Orange	House of Bourbon, House of Hohenzollern, House of Orange-Nassau, Princes and princesses, States of the Holy Roman Empire
Danny Jacobs (actor)	1968 births, Living people, American voice actors, American comedians, American movie actors, American television actors, Comedians from Michigan, Actors from Detroit, Michigan
Invitation to William	17th century in England, 1688, 1680s in Europe
Válber Costa	1977 births, Living people, Brazilian footballers
Royal house	Royalty and nobility
Andre Luis Neitzke	1986 births, Living people, Brazilian footballers
Yu Hasegawa	1987 births, Living people, Footballers from Yamanashi Prefecture
Alex Oliveira	1978 births, Living people, Brazilian footballers
Leandro Cesar de Souza	1979 births, Living people, Brazilian footballers
Hiroshi Hirakawa	1965 births, Living people, Footballers from Kanagawa Prefecture, Japan international footballers, J1 League players, Japan Soccer League players, Yokohama F. Marinos players, Yokohama Flügels players, Hokkaido Consadole Sapporo players
Satoshi Tezuka	1958 births, Living people, Footballers from Tochigi Prefecture, Japan international footballers, Japanese football managers, Japan Soccer League players, Shonan Bellmare players
Hiromitsu Horiike	1971 births, Living people, Footballers from Shizuoka Prefecture
Toshihiro Uchida	1972 births, Living people, Footballers from Nagasaki Prefecture
Kim Yong-sik	1910 births, 1985 deaths, Japanese footballers, South Korean footballers, South Korean football managers, Japan international footballers, Footballers at the 1936 Summer Olympics
Understudy	Theater, Opera
Lady Anne Hyde	1638 births, 1671 deaths, British royalty
Bill of Rights 1689	17th century in England, British monarchy, Acts of the Parliament of the United Kingdom, 1689, 1680s in Europe
Wilhelm Steinitz	1836 births, 1900 deaths, American chess players, Austrian Jews, Austrian sportspeople, Czech Jews, Jewish American sportspeople, Naturalized citizens of the United States, Sportspeople from Prague
Emperor Seimu	Emperors of Japan
List of chess terms	Chess lists, Glossaries
Emperor Chūai	Emperors of Japan
Empress Jingū	Emperors of Japan
Hypermodern	Chess
Confidence interval	Statistics
Emperor Richū	Emperors of Japan
Jacobitism	Jacobitism
Tadao Horie	1913 births, 2003 deaths, Footballers from Shizuoka Prefecture, Japan international footballers, Footballers at the 1936 Summer Olympics
Maksim Shatskikh	1978 births, Living people, Uzbekistani people, Asian footballers
John Churchill, 1st Duke of Marlborough	1650 births, 1722 deaths, British Army generals, English Barons, English Earls, English Dukes, Scottish nobility
Pierre Njanka	1975 births, Living people, Cameroonian footballers
Rigobert Song	1976 births, Living people, Cameroonian footballers
Wolfgang Feiersinger	1965 births, Living people, Austrian footballers, Players of the Austrian national football team, FC Red Bull Salzburg players
Ernst Happel	1925 births, 1992 deaths, Austria national football team managers, Austrian football managers, Austrian footballers, Sportspeople from Vienna, Players of the Austrian national football team, Eredivisie managers
Baboon	Old World monkeys
Friedrich Koncilia	1948 births, Living people, Austrian footballers, Association football goalkeepers, People from Klagenfurt, Players of the Austrian national football team
Toni Polster	1964 births, Living people, Austrian footballers, Players of the Austrian national football team
Daisuke Saito (born in 1980)	1980 births, Living people, Footballers from Osaka Prefecture, People from Osaka
Naohito Hirai	1978 births, Living people, Footballers from Kyoto
Emperor Nintoku	Emperors of Japan
Irukandji jellyfish	Animals of Australia, Jellyfish
Emperor Yūryaku	Emperors of Japan
Kia Carens	Kia automobiles
Renault FR1	Renault automobiles, Buses
Kia Soul	Kia automobiles, 2000s automobiles, 2010s automobiles
Kia Rio	Kia automobiles
Kia Magentis	Kia automobiles
Kia Carnival	Kia automobiles
Kia cee'd	Kia automobiles
Volkswagen Touran	Volkswagen automobiles
Rade Bogdanović	1970 births, Living people, Serbian footballers, People from Sarajevo
Atsushi Katagiri	1983 births, Living people, Footballers from Gifu Prefecture
Carlos Gamarra	1971 births, Living people, Paraguayan footballers
Flávio Conceição	1974 births, Living people, Brazilian footballers
Kei Kinoshita	1971 births, Living people, Footballers from Tottori Prefecture
Nariyasu Yasuhara	1968 births, Living people, Footballers from Aichi Prefecture
Masafumi Nakaguchi	1972 births, Living people, Footballers from Osaka Prefecture, People from Osaka
Emperor Ankan	Emperors of Japan
Emperor Senka	Emperors of Japan
Afrikaner Weerstandsbeweging	Political parties in South Africa, Nationalist organizations in South Africa, Rebel militia groups in Africa, 1973 establishments in Africa, Fascism, 20th-century establishments in South Africa
XNOR gate	Logic gates
Efim Bogolyubov	1889 births, 1952 deaths, German chess players, Ukrainian chess players, Chess grandmasters
Imperial Household Agency	History of Japan, Japanese imperial family
Operating environment	Operating systems
Adelong, New South Wales	Towns in New South Wales
Cole Porter	1891 births, 1964 deaths, 20th century composers, American composers, American songwriters, Deaths from renal failure, Disease-related deaths in California, Gay men, LGBT composers, LGBT people from Indiana, LGBT songwriters, Musicians from Indiana, Writers from Indiana, Yale University alumni
Jan van Riebeeck	1619 births, 1677 deaths, Cape Town, Governors, Politicians from Gelderland
Measles	Diseases caused by viruses
Emperor Seinei	Emperors of Japan
Xiphactinus	Extinct fish, Fossils
Emperor Kenzō	Emperors of Japan
Kofun	History of Japan, Burial monuments and structures
Chess and computers	Chess, Computers
Julio César Romero	1960 births, Living people, Paraguayan footballers
Lee Jong-Min	1987 births, Living people, South Korean footballers
Sin Byung-Ho	1977 births, Living people, South Korean footballers
Fernando Almeida de Oliveira	1978 births, Living people, Brazilian footballers
Derlis Florentín	1984 births, 2010 deaths, Paraguayan footballers
An Sun-Jin	1975 births, Living people, South Korean footballers
Joseph-Désiré Job	1977 births, Living people, Cameroonian footballers
Terry Venables	1943 births, Living people, English footballers, English football managers, England national football team managers, Sportspeople from London, Crystal Palace F.C. players, Tottenham Hotspur F.C. players
Shingo Hyodo	1985 births, Living people, Footballers from Nagasaki Prefecture
Takayuki Nishigaya	1973 births, Living people, Footballers from Shizuoka Prefecture
Chess notation	Chess, Notation
Akiba Rubinstein	1882 births, 1961 deaths, Jewish sportspeople, Polish chess players, Polish Jews, Chess grandmasters
Martín Chambi	1891 births, 1973 deaths, Peruvian people, Photographers
Kia Venga	Kia automobiles, 2000s automobiles, 2010s automobiles
Reception history of Jane Austen	Jane Austen
List of chess openings	Chess openings, Chess lists
Emperor Ninken	Emperors of Japan
Emperor Buretsu	Emperors of Japan
Prefectures of Japan	Prefectures of Japan
List of Provinces of Japan	Former provinces of Japan, Japan-related lists
Gilberto Kassab	Brazilian politicians, Mayors, 1960 births, Living people
Terra nullius	Legal terms, Property
Free State (province)	Provinces of South Africa, 1994 establishments in South Africa
Orange Free State	1852 establishments, 19th-century establishments in South Africa, 1900s disestablishments in Africa, 1850s establishments in Africa, 1902 disestablishments
Bir Tawil	Territorial disputes, Geography of Egypt, Sudan
Hebe Camargo	1929 births, 2012 deaths, Deaths from cardiac arrest, Brazilian actors, São Paulo (state)
Sam Bradford	1987 births, American football quarterbacks, Arizona Cardinals players, Heisman Trophy winners, Living people, Minnesota Vikings players, Philadelphia Eagles players, Sportspeople from Oklahoma City, St. Louis Rams players
Olmedilla Photovoltaic Park	Solar power plants, Buildings and structures in Spain, 2008 establishments in Europe, 2000s establishments in Spain
Strasskirchen Solar Park	Buildings and structures in Bavaria, Power stations in Germany, Solar power plants
Hiroshi Noguchi	1972 births, Living people, Footballers from Ibaraki Prefecture
Siegbert Tarrasch	1862 births, 1934 deaths, German chess players, German doctors, Jewish German writers, Jewish sportspeople, People from former German territories, People from Wrocław
Tetsuya Takada	1969 births, Living people, Footballers from Hiroshima Prefecture, People from Hiroshima
Tadamichi Machida	1981 births, Living people, Footballers from Saitama Prefecture
Branko Hucika	1977 births, Living people, Croatian footballers, Sportspeople from Zagreb
Goran Vasilijević	1965 births, Living people, Serbian footballers
Owusu Benson	1977 births, Living people, Ghanaian footballers, People from Accra
Massimo Taibi	1970 births, Living people, Italian footballers, People from Palermo
Noureddine Naybet	1970 births, Living people, Moroccan footballers, People from Casablanca
Kim Hyun-Seok	1967 births, Living people, South Korean footballers
Kwanzaa	Holidays, 1966 establishments in the United States, African-American history, American culture, Pan-Africanism
Interventional Radiology	Medicine
Chess Olympiad	Chess competitions
Cassandra Austen	English artists, Jane Austen, People from Hampshire, 1773 births, 1845 deaths
Lord Mayor	Titles, Local government in the United Kingdom
Henry Dyck	1912 births, 1993 deaths, American Hockey Association (1926–42) players, Canadian ice hockey left wingers, Ice hockey people from Saskatchewan, New York Rangers players, People from Saskatoon, Eastern Hockey League players
Steve Wochy	1922 births, Canadian ice hockey right wingers, Detroit Red Wings players, Ice hockey people from Ontario, Living people, People from Thunder Bay
Fort William, Ontario	Former cities in Canada, Thunder Bay
Port Arthur Bearcats	Ice hockey teams in Ontario, Thunder Bay
Allan Cup	1909 establishments in Canada, Ice hockey trophies and awards
Pokémon Black and White	Nintendo DS games, Nintendo DS-only games, Pokémon RPGs
Adolf Anderssen	1818 births, 1879 deaths, German chess players, German mathematicians, People from former German territories, People from Wrocław
Bayesian network	Mathematics, Artificial intelligence
M1 Abrams	Tanks
Sexual intercourse	Biological reproduction, Human sexuality
Gerontology	Gerontology
George Lowe	Adult Swim
Andy Merrill	Adult Swim
Dana Snyder	1973 births, Living people, Adult Swim, American movie actors, American television actors, American voice actors, Actors from Pennsylvania, Actors from Las Vegas, Nevada, Comedians from Pennsylvania, People from Allentown, Pennsylvania
Todd Hanson	Year of birth missing (living people), Adult Swim, Living people, American writers
Unknown Hinson	Living people, Year of birth missing (living people), Adult Swim
Emperor Kinmei	509 births, 571 deaths, Emperors of Japan
Don Kennedy	1930 births, Living people, American voice actors, American television actors, Actors from Pennsylvania
Complex sentence	Sentences
Emperor Keitai	Emperors of Japan
Koshi Province	Former provinces of Japan, Niigata Prefecture, Fukui Prefecture, Toyama Prefecture
Dario Dabac	1978 births, Living people, Croatian footballers
Dragiša Binić	1964 births, Living people, Serbian footballers
Capone	1972 births, Living people, Brazilian footballers
Hamad Al-Montashari	1982 births, Living people, Saudi Arabian footballers, People from Jeddah
Kim Hwang-Jung	1975 births, Living people, South Korean footballers, People from Osaka
Dario Hübner	1967 births, Living people, Italian footballers
Masaki Ogawa	1975 births, Living people, Footballers from Shizuoka Prefecture
Osamu Maeda	1965 births, Living people, Footballers from Fukuoka Prefecture, Japan international footballers, J1 League players, Japan Soccer League players, Yokohama Flügels players, 1988 AFC Asian Cup players
Masato Fue	1973 births, Living people, Footballers from Kagoshima Prefecture
Takayuki Fujikawa	1962 births, Living people, Footballers from Kanagawa Prefecture
Arthur Friedenreich	1892 births, 1969 deaths, Brazilian footballers
Pericles de Oliveira Ramos	1975 births, Living people, Brazilian footballers
Ivan Radeljić	1980 births, Living people, Bosnia and Herzegovina footballers
Marco Marchionni	1980 births, Living people, Italian footballers
Fernando Henrique Mariano	1967 births, Living people, Brazilian footballers
Lucas Chiaretti Cossenzo	1987 births, Living people, Brazilian footballers
Shinsuke Shiotani	1970 births, Living people, Footballers from Osaka Prefecture, People from Osaka
Hiroto Mogi	1984 births, Living people, Footballers from Fukushima Prefecture, Fukushima United FC players
Bruno Sarpa Costa	1984 births, Living people, Footballers from Rio de Janeiro
Marquem Gonçalves Ferreira	1983 births, Living people, Brazilian footballers
Katsuyuki Saito	1973 births, Living people, Footballers from Fukushima Prefecture
Ryota Aoki	1984 births, Living people, Footballers from Osaka Prefecture
Masahiro Wada	1965 births, Living people, Footballers from Hyōgo Prefecture
Abdeljalil Hadda	1972 births, Living people, Moroccan footballers
Lucas Neill	1978 births, Living people, Australian footballers, Sportspeople from Sydney
Michael Dawson	1983 births, Living people, English footballers, People from North Yorkshire, Tottenham Hotspur F.C. players
Gunnar Nordahl	1921 births, 1995 deaths, Swedish footballers
Yoshiki Okamura	1977 births, Living people, Footballers from Yamaguchi Prefecture
Kazuhiro Suzuki	1976 births, Living people, Footballers from Tokyo Prefecture
Paul Morphy	1837 births, 1884 deaths, American chess players, Sportspeople from New Orleans, Louisiana
Kim Carnes	American folk musicians, Singers from Los Angeles, California, American pop musicians, Singer-songwriters from California, Grammy Award winners, 1945 births, Living people, Country musicians
Emperor Bidatsu	538 births, 585 deaths, Emperors of Japan
Café de la Régence	Chess, Buildings and structures in Paris
Longevity	Life, Demography, Population, Gerontology, Healthy lifestyle
Andy Reid	1982 births, Living people, Irish footballers, Sportspeople from Dublin
Judit Polgár	1976 births, Living people, Hungarian chess players, Hungarian Jews, Sportspeople from Budapest, Chess grandmasters
Paul Stalteri	1977 births, Living people, Canadian footballers, Sportspeople from Ontario
Fábio de Jesus	1976 births, Living people, Brazilian footballers
Ricardo Souza Silva	1975 births, Living people, Brazilian footballers
Viktor Onopko	1969 births, Living people, Russian footballers
Henri Michel	1947 births, 2018 deaths, French footballers, French football managers, Aix-en-Provence
Kiatisuk Senamuang	1973 births, Living people, Thai football managers, Thai footballers
Michael Yano	1979 births, Living people, Japanese footballers, People from Accra
Taikai Uemoto	1982 births, Living people, Footballers from Kagoshima Prefecture
Yoshiaki Fujita	1983 births, Living people, Footballers from Tochigi Prefecture
Satoshi Taira	1970 births, Living people, Footballers from Iwate Prefecture
Alessandro Cambalhota	1973 births, Living people, Brazilian footballers
Masahiro Sukigara	1966 births, Living people, Footballers from Tokyo Prefecture, J1 League players, Japan Soccer League players, Tokyo Verdy players, Urawa Red Diamonds players, 1988 AFC Asian Cup players
Jun Takada	1977 births, Living people, Footballers from Hiroshima Prefecture, People from Hiroshima
Takahiro Kawamura	1979 births, Living people, Footballers from Shizuoka Prefecture
Takuma Koga	1969 births, Living people, Footballers from Shizuoka Prefecture
Eiji Hanayama	1977 births, Living people, Footballers from Tochigi Prefecture
Yasumasa Nishino	1982 births, Living people, Footballers from Toyama Prefecture
Hiromasa Yamamoto	1979 births, Living people, Footballers from Aichi Prefecture
Jorginho Putinatti	1959 births, Living people, Brazilian footballers
Ogyū Sorai	1666 births, 1729 deaths, Philosophers, Japanese people, Confucianism, People from Tokyo
Mercantilism	Economic history
Maimonides	1135 births, 1204 deaths, Egyptian Jews, European Jews, Jewish philosophers, People from Córdoba, Andalusia, Physicians, Rabbis
Communes of Chile	Cities in Chile
The Decemberists	American rock bands, Indie rock bands, Folk music groups, Musical groups from Oregon, Musicians from Portland, Oregon, 2000 establishments in the United States, 21st-century establishments in Oregon
Emperor Yōmei	518 births, 587 deaths, Emperors of Japan
Arica Province	Provinces of Chile
Francis Crick	1916 births, 2004 deaths, Biophysicists, English biologists, British Nobel Prize winners, British physicists, Cancer deaths in the United States, Deaths from colorectal cancer, Molecular biologists, Neuroscientists, Order of Merit, People from Northamptonshire
Arica	Cities in Chile, Communes of Chile
Camarones, Chile	Cities in Chile, 1927 establishments in Chile, Communes of Chile
Putre	Cities in Chile, Communes of Chile
General Lagos	Cities in Chile
Alto Hospicio	Cities in Chile, 2004 establishments, 21st-century establishments in Chile
Pozo Almonte	Cities in Chile
Camiña	Cities in Chile
Colchane	Cities in Chile
Huara	Cities in Chile
Pica, Chile	Cities in Chile
Motion blindness	Vision
Battles of Lexington and Concord	Battles of the American Revolutionary War, 1775 in the Thirteen Colonies, 1770s in Massachusetts, April events
Emperor Sushun	520s births, 592 deaths, Emperors of Japan
No. 3 Fighter Sector RAAF	Queensland
Jimmy Carr	1972 births, Living people, Actors from London, Alumni of the University of Cambridge, British stand-up comedians, Channel 4 presenters, Comedians from London, English atheists, English movie actors, English television presenters, English television writers, Irish comedians, Irish movie actors, Irish television personalities, Irish writers, People from Hounslow (London borough), Writers from London
Kingdom Records (UK)	British_record_labels
Whirlpool	Bodies of water
Clipper	Ships, Trade routes
Kim Yoo-Jin	1983 births, Living people, South Korean footballers, People from Busan
Carlos Sánchez García	1978 births, Living people, Spanish association football goalkeepers, Sportspeople from Madrid
Edmilson dos Santos Silva	1982 births, Living people, Brazilian footballers, People from Salvador, Bahia
Mariinsky Theatre	Opera houses, Buildings and structures in Saint Petersburg, Ballet
Dragan Džajić	1946 births, Living people, Serbian footballers
Masaki Yamamoto	1987 births, Living people, Footballers from Shizuoka Prefecture
Hisao Kuramata	1958 births, Living people, Footballers from Saitama Prefecture
Shinichiro Takahashi	1957 births, Living people, Footballers from Hiroshima Prefecture
Nobuhiro Takeda (footballer, born 1965)	1965 births, Living people, Footballers from Osaka Prefecture, People from Osaka
Nobuhiro Ueno	1965 births, Living people, Footballers from Shiga Prefecture, Japanese football managers, J1 League players, Japan Soccer League players, Yokohama Flügels players, Sanfrecce Hiroshima players, 1988 AFC Asian Cup players
Koji Gyotoku	1965 births, Living people, Footballers from Shizuoka Prefecture, Japanese football managers, Sport in Bhutan
Marvell Wynne	1986 births, Living people, American footballers
Faas Wilkes	1923 births, 2006 deaths, Dutch footballers, Sportspeople from Rotterdam
Kazuhito Mochizuki	1957 births, Living people, Footballers from Shizuoka Prefecture
Hidenori Kato	1981 births, Living people, Footballers from Mie Prefecture
Shota Koide	1981 births, Living people, Footballers from Fukuoka Prefecture
Hirotsugu Nakabayashi	1986 births, Living people, Footballers from Kanagawa Prefecture
Hiroshi Narazaki	1981 births, Living people, Footballers from Fukuoka Prefecture
Ante Šimundža	1971 births, Living people, Slovenian footballers
Toyoki Hasegawa	1986 births, Living people, Footballers from Kumamoto Prefecture
Takaaki Suzuki	1981 births, Living people, Footballers from Shizuoka Prefecture
Kentaro Yoshida	1980 births, Living people, Footballers from Fukuoka Prefecture
Peter Binkovski	1972 births, Living people, Slovenian footballers
Takuma Hidaka	1983 births, Living people, Footballers from Hiroshima Prefecture
Port of Hull	East Riding of Yorkshire, Ports and harbours of the United Kingdom
Yoshihito Fujita	1983 births, Living people, Footballers from Hyōgo Prefecture
Yu Eto	1983 births, Living people, Footballers from Fukuoka Prefecture
Koji Hirose	1984 births, Living people, Footballers from Kyoto
Tatsuya Kamohara	1983 births, Living people, Footballers from Saga Prefecture
Hirotsugu Kakoi	1987 births, Living people, Footballers from Kagoshima Prefecture
Masatoshi Mihara	1988 births, Living people, Footballers from Kumamoto Prefecture
Saint Petersburg Conservatory	Music schools, Buildings and structures in Saint Petersburg
Mikhail Tal	1936 births, 1992 deaths, Chess grandmasters, Jewish sportspeople, Latvian chess players, Latvian Jews, People from Riga, Soviet Jews, Soviet sportspeople
Game port	Video game consoles, Computer hardware, Electrical connectors
Clinical trial	Medicine
Yuki Kuriyama	1988 births, Living people, Footballers from Kumamoto Prefecture
Keiji Takachi	1980 births, Living people, Footballers from Saitama Prefecture
Takeshi Hamada	1982 births, Living people, Footballers from Osaka Prefecture, People from Osaka
Junya Yamashiro	1985 births, Living people, Footballers from Kyoto
Yoshiya Takemura	1973 births, Living people, Footballers from Hiroshima Prefecture
Asuka Tateishi	1983 births, Living people, Footballers from Kagoshima Prefecture
Yasuhiro Tominaga	1980 births, Living people, Footballers from Fukuoka Prefecture
Kenji Tanaka	1983 births, Living people, Footballers from Saga Prefecture, Vanraure Hachinohe players
Takashi Azuma	1979 births, Living people, Footballers from Shiga Prefecture
Yoshimi Sasahara	1974 births, Living people, Footballers from Kagoshima Prefecture
Paul Keres	1916 births, 1975 deaths, Chess grandmasters, Estonian sportspeople
Anne of Austria	1601 births, People from Valladolid, 1666 deaths, Habsburg Dynasty, House of Bourbon, Kings and Queens consort of France
Eric S. Raymond	1957 births, Living people, Writers from Boston, Massachusetts, American bloggers
Bourne End, Buckinghamshire	Villages in Buckinghamshire
2009–10 NHL season	National Hockey League seasons
Joe Mauer	1983 births, Living people, American baseball players, Minnesota Twins players, Sportspeople from Saint Paul, Minnesota
Death of a Salesman	Plays, Suicide in fiction
Continuum hypothesis	Set theory
Flexibility training	Fitness
Washington Luiz Mascarenhas Silva	1978 births, Living people, Brazilian footballers
Kazuhiro Murata	1969 births, Living people, Footballers from Nagasaki Prefecture
Junichi Watanabe	1973 births, Living people, Footballers from Tokyo Prefecture
Taku Watanabe	1971 births, Living people, Footballers from Ibaraki Prefecture
Satoru Mochizuki	1964 births, Living people, Footballers from Shiga Prefecture, Japan international footballers, J1 League players, Japan Soccer League players, NKK SC players, Urawa Red Diamonds players, Kyoto Sanga FC players
Koji Kataoka	1977 births, Living people, Footballers from Fukuoka Prefecture
Jun Ideguchi	1979 births, Living people, Footballers from Tokyo Prefecture
Sugao Kambe	1961 births, Living people, Footballers from Shizuoka Prefecture
Salif Keïta	1946 births, Living people, Malian footballers, People from Bamako
Sagan Tosu	Japanese football clubs, Saga Prefecture, 1987 establishments in Japan
The Fountainhead	20th century American novels, 1943 books, English-language novels
A Raisin In The Sun	Chicago, Illinois in fiction, Plays
Arctic fox	Foxes, Mammals of North America, Mammals of Asia, Mammals of Europe
DFB-Pokal	Football competitions
Rabah Madjer	1958 births, Living people, Algerian footballers, Algerian football managers
Yulian Sokhotski	1842 births, 1927 deaths, Academics, People from Warsaw, Polish mathematicians, Russian mathematicians
Wilson's storm petrel	Procellariiformes, Seabirds
Red-billed Tropicbird	Birds of Pakistan
Red-tailed tropicbird	Seabirds
Aida	Compositions by Giuseppe Verdi, Operas
Atropine	Drugs
Vladimir Uzoykin	1980 births, Living people, Russian footballers
Townsville	Cities in Queensland
Tsai Ing-wen	1956 births, Living people, Alumni of the London School of Economics, Cornell University alumni, Government ministers, Presidents of the Republic of China
Pheromone	Zoology, Physiology, Hormones, Endocrinology
Kronborg	Buildings and structures in Denmark, World Heritage Sites in Europe
Christian IV of Denmark	Kings and Queens of Denmark, 1577 births, 1648 deaths
Sex determination	Classical genetics, Developmental biology, Cell biology, Biological reproduction
Sketches by Boz	Books by Charles Dickens, Fiction books
Hiroshi Tetsuto	1982 births, Living people, Footballers from Kumamoto Prefecture
Victor Piţurcă	1956 births, Living people, Romanian footballers, Romanian football managers
Anghel Iordănescu	1950 births, Living people, Romanian footballers, Romanian football managers
Édison Méndez	1979 births, Living people, Ecuadorian footballers, People from Quito
Seiji Honda	1976 births, Living people, Footballers from Tokushima Prefecture
Teruaki Kobayashi	1979 births, Living people, Footballers from Ibaraki Prefecture
Hiroyuki Komoto	1985 births, Living people, Footballers from Hyōgo Prefecture
Oleg Romantsev	1954 births, Living people, Russian footballers, Russian football managers
Daisuke Tada	1982 births, Living people, Footballers from Okayama Prefecture
Masahito Suzuki	1977 births, Living people, Footballers from Chiba Prefecture
Equirectangular projection	Map projections
Zack Greinke	1980 births, Living people, Arizona Diamondbacks players, Kansas City Royals players, Los Angeles Angels of Anaheim players, Los Angeles Dodgers players, Milwaukee Brewers players, Sportspeople from Orlando, Florida
Scheherazade	Fictional characters
Stretching	Fitness
Debit card	Money
Sunbelt	Regions of the United States
Takuya Mikami	1980 births, Living people, Footballers from Saitama Prefecture
Kentoku Noborio	1983 births, Living people, Footballers from Kagoshima Prefecture
Hideaki Ueno	1981 births, Living people, Footballers from Hokkaidō Prefecture
Yuki Okubo	1984 births, Living people, Footballers from Chiba Prefecture
Keizo Imai	1950 births, Living people, Footballers from Kyoto Prefecture, Japan international footballers, Japan Soccer League players, Shonan Bellmare players
Haruhisa Hasegawa	1957 births, Living people, Footballers from Hyōgo Prefecture, Japan international footballers, Japan Soccer League players, Cerezo Osaka players
Hiroyuki Usui	1953 births, Living people, Footballers from Shizuoka Prefecture, Japan international footballers, Japan Soccer League players, Kashiwa Reysol players
Takeo Wakabayashi	1907 births, 1937 deaths, Footballers from Hyōgo Prefecture, Japan international footballers
Bruno N'Gotty	1971 births, Living people, French footballers, Sportspeople from Lyon
Mito HollyHock	Japanese football clubs, Ibaraki Prefecture
Serpopard	Egyptian mythology, Archaeology
Plott Hound	Dog breeds
Mary Cassatt	American painters, People from Pittsburgh, Pennsylvania, 1844 births, 1926 deaths
Crazy Eights	Card games
Ada Lovelace	1815 births, 1852 deaths, English computer scientists, Scientists from London, Female scientists
Shreveport, Louisiana	Ark-La-Tex, Former United States state capitals, Parish seats in Louisiana, Shreveport, Louisiana
Pinochle	Card games
Atom (feed)	Internet
Pop Chronicles	Radio programs, Documentaries, American music history
Digital Enhanced Cordless Telecommunications	Telecommunications, Mobile phones
Epcot	1982 establishments in the United States, 1980s establishments in Florida, Disney - Orlando, Theme parks in Florida
Aleph null	Mathematics
Cranston, Rhode Island	Cities in Rhode Island
Eyjafjallajökull	Volcanoes of Iceland
Anonymous function	Computer programming, Functions and mappings, Mathematical notation
The History of Rock and Roll	Radio programs, Documentaries, Rock music, American music history
Ward Burton	1961 births, Living people, Daytona 500 winners, American racecar drivers, Sportspeople from Virginia
Italian conquest of British Somali Coast Protectorate	World War II
List of cities in Australia by population	Cities in Australia, Lists of cities by country, Australia-related lists
Tiago Jorge Honório	1977 births, Living people, Brazilian footballers
Ferenc Bene	1944 births, 2006 deaths, Hungarian footballers, Hungarian football managers
Dwight Lodeweges	1957 births, Living people, Dutch football managers, Dutch footballers, Eredivisie managers, Sportspeople from Alberta
Toyoharu Takata	1948 births, Living people, Footballers from Hiroshima Prefecture
Yota Akimoto	1987 births, Living people, Footballers from Tokyo Prefecture
Takumi Shima	1967 births, Living people, Footballers from Tokushima Prefecture
Akinobu Yokouchi	1967 births, Living people, Footballers from Fukuoka Prefecture
Jun Marques Davidson	1983 births, Living people, Footballers from Tokyo Prefecture
Jan Jönsson	1960 births, Living people, Swedish footballers
MC Chris	1975 births, Living people, Writers from Illinois, Adult Swim, American voice actors, American rap musicians from Illinois, Musicians from Illinois, Actors from Illinois, People from Libertyville, Illinois, American bloggers
H. Jon Benjamin	1966 births, Living people, American stand-up comedians, American voice actors, Comedians from Massachusetts, American movie actors, American television actors, Actors from Massachusetts
David Cross	1964 births, Living people, American movie actors, American voice actors, American television actors, Actors from Atlanta, Georgia
Holy water	Christian religious objects
Shigemitsu Egawa	1966 births, Living people, Footballers from Mie Prefecture
Hiroki Nakayama	1985 births, Living people, Footballers from Kagoshima Prefecture
Osamu Kawamoto	1952 births, Living people, Footballers from Hokkaidō Prefecture
Raffaele Palladino	1984 births, Living people, Italian footballers
Lucien Laurent	1907 births, 2005 deaths, French footballers
Roberto Júlio de Figueiredo	1979 births, Living people, Brazilian footballers
Shota Matsuhashi	1982 births, Living people, Footballers from Nagasaki Prefecture
Carlos Esteves	1947 births, Living people, Brazilian footballers
Jan Polák	1981 births, Living people, Czech footballers, People from Brno
Shen Bao	Newspapers in Asia, China
Merchant Navy	Transport in the United Kingdom
Kazumasa Kawano	1970 births, Living people, Footballers from Oita Prefecture
Takashi Rakuyama	1980 births, Living people, Footballers from Toyama Prefecture
Yoshiya Nishizawa	1987 births, Living people, Footballers from Saitama Prefecture
Masahiro Okamoto	1983 births, Living people, Footballers from Chiba Prefecture
Lee Baxter	1976 births, Living people, Swedish footballers, People from Helsingborg
Casiano Delvalle	1970 births, Living people, Paraguayan footballers
Josip Barišić	1981 births, Living people, Croatian footballers
Yuji Kishioku	1954 births, Living people, Footballers from Hokkaidō Prefecture, Japan international footballers, Japan Soccer League players, Nippon Steel Yawata SC players
Linking verb	Parts of speech
Evacuation	Safety
French defence	Chess openings
Nimzo-Indian defence	Chess openings
Tsukasa Umesaki	1987 births, Living people, Footballers from Nagasaki Prefecture, Japan international footballers, J1 League players, Oita Trinita players, Urawa Red Diamonds players, Shonan Bellmare players
Steed Malbranque	1980 births, Living people, French footballers
Daisuke Takahashi (footballer)	1983 births, Living people, Footballers from Fukuoka Prefecture
Kim Jong-Song	1964 births, Living people, North Korean footballers
Giourkas Seitaridis	1981 births, Living people, Greek footballers
Pieter Huistra	1967 births, Living people, Dutch football managers, Dutch footballers, Sportspeople from Friesland
Salomon Kalou	1985 births, Living people, Ivorian footballers
Masao Uchino	1934 births, Year of death missing, Footballers from Kanagawa Prefecture, Japan international footballers, Japan Soccer League players, JEF United Chiba players, Footballers at the 1956 Summer Olympics
Fernando Cavenaghi	1983 births, Living people, Argentine footballers
Jong Tae-Se	1984 births, Living people, North Korean footballers
Thespakusatsu Gunma	Japanese football clubs, Gunma Prefecture, 1995 establishments in Japan
Joey Logano	1990 births, Living people, NASCAR drivers, American racecar drivers
Pound-force	Imperial units
Long ton	Units of mass
Seismogram	Earthquakes, Earthquake engineering
Nothosaur	Fossils, Sauropterygia, Marine reptiles
Hod Stuart	1879 births, 1907 deaths, Canadian ice hockey defencemen, Hockey Hall of Fame inductees, Ice hockey people from Ontario, Montreal Wanderers players, People from Ottawa, Stanley Cup champions
List of ZIP Code prefixes	Postal codes, United States Postal Service, United States-related lists
Mohamed Zidan	1981 births, Living people, Egyptian footballers, Egypt international footballers
Koichi Ae	1976 births, Living people, Footballers from Hiroshima Prefecture
Opium Wars	19th century in Asia, Wars involving China, Wars involving France, Wars involving the United Kingdom, Wars involving the United States, 1850s in France, 1830s in the United Kingdom, 1840s in the United Kingdom
Shunichi Ikenoue	1967 births, Living people, Footballers from Gunma Prefecture, J1 League players, Japan　Soccer　League players, Gamba Osaka players, Yokohama Flügels players, Sagan Tosu players, 1988 AFC Asian Cup players
Seismometer	Earthquakes, Measuring tools
Denny Landzaat	1976 births, Living people, Dutch footballers, Sportspeople from Amsterdam
David Connolly	1977 births, Living people, Irish footballers, Sportspeople from London
Antonio Valencia	1985 births, Living people, Ecuadorian footballers, Manchester United F.C. players
Graham Kavanagh	1973 births, Living people, Irish footballers, Sportspeople from Dublin
Lee McCulloch	1978 births, Living people, Scottish footballers
Cool Silly	Pop music groups, Taiwanese musical groups
David Wright	1980 births, Living people, English footballers, Sportspeople from Cheshire
Arjan de Zeeuw	1970 births, Living people, Dutch footballers, Sportspeople from North Holland
Andreas Johansson	1978 births, Living people, Swedish footballers
Yohei Toyoda	1985 births, Living people, Footballers from Ishikawa Prefecture, Japan international footballers, J1 League players, J2 League players, Nagoya Grampus players, Montedio Yamagata players, Kyoto Sanga FC players, Sagan Tosu players, Footballers at the 2008 Summer Olympics
Paul Jewell	1964 births, Living people, English footballers, English football managers, Sportspeople from Liverpool
Nathan Ellington	1981 births, Living people, English footballers, People from Bradford, Premier League players
Jason Roberts	1978 births, Living people, Grenadian people, British footballers
Kim Jung-Hoon	1986 births, Living people, South Korean footballers, People from Osaka
Ryuji Shimoshi	1985 births, Living people, Footballers from Ehime Prefecture
Dew	Precipitation
666 (number)	Integers, Superstitions, New Testament, Christian eschatology
Jazz piano	Jazz music
Apito	Musical instruments
Jedward	2009 establishments in Europe, 2000s Irish music groups, 2010s Irish music groups, Living people, Celebrity Big Brother contestants, Irish pop music groups, Musicians from Dublin, Sibling musical duos, The X Factor contestants, Twin people
Marcionism	Gnosticism
Chorley	Towns in Lancashire
Clayton-le-Woods	Villages in Lancashire
Divididos	Argentine rock bands, 1988 establishments in South America, Musical groups established in 1988, 20th-century establishments in Argentina
Gao Shun	Han Dynasty generals, 198 deaths, Year of birth unknown
Hitachi A-train	Trains
2 Maccabees	Books of the Bible, Hanukkah
3 Maccabees	Books of the Bible
List of counties in Florida	Florida counties, Lists of counties of the United States, Florida-related lists
Persecution	Sociology, Violence
Lincoln Park Zoo	1868 establishments in the United States, Zoos in Illinois, Buildings and structures in Chicago, Illinois, 1860s establishments in Illinois
List of zoos	Science-related lists, Zoos, Geography-related lists
Modern defence	Chess openings
Bodybuilding	Bodybuilding
Kohei Yamamichi	1980 births, Living people, Footballers from Aichi Prefecture
Tatsuomi Koishi	1977 births, Living people, Footballers from Saga Prefecture
Gary Teale	1978 births, Living people, Scottish footballers
Josip Skoko	1975 births, Living people, Australian footballers, Sportspeople from South Australia
Takuji Miyoshi	1978 births, Living people, Footballers from Fukuoka Prefecture
Haruhiko Sato	1978 births, Living people, Footballers from Tokyo Prefecture
Rikiya Kawamae	1971 births, Living people, Footballers from Kagawa Prefecture
Bunichiro Abe	1985 births, Living people, Footballers from Shizuoka Prefecture
Gabriel Paletta	1986 births, Living people, Argentine footballers, Sportspeople from Buenos Aires
Omi Sato	1975 births, Living people, Footballers from Iwate Prefecture
Daisuke Yano	1984 births, Living people, Footballers from Kumamoto Prefecture
Jermaine Pennant	1983 births, Living people, Black British sportspeople, English footballers, People from Nottingham, Sportspeople from Nottinghamshire, Premier League players
Yuki Takabayashi	1980 births, Living people, Footballers from Shizuoka Prefecture
Takumi Motohashi	1982 births, Living people, Footballers from Tokyo Prefecture
Titus Bramble	Black British sportspeople, English footballers, People from Ipswich, Sportspeople from Suffolk, 1981 births, Living people, Premier League players
Mark González	1984 births, Living people, Chilean footballers, People from Durban
Takashi Furukawa	1981 births, Living people, Footballers from Saga Prefecture
Kenta Shimaoka	1973 births, Living people, Footballers from Mie Prefecture
Jiro Yabe	1978 births, Living people, Footballers from Nara Prefecture
Kenji Takagi	1976 births, Living people, Footballers from Kyoto Prefecture
Ice-nine	Science fiction technology
Firlus	Villages in Poland
Papowo Biskupie	Villages in Poland
Folgowo	Villages in Poland
Dubielno	Villages in Poland
Falęcin, Kuyavian-Pomeranian Voivodeship	Villages in Poland
Jeleniec	Villages in Poland
Kucborek	Villages in Poland
Niemczyk	Villages in Poland
Staw	Villages in Poland
Storlus	Villages in Poland
Wrocławki	Wrocławki, Villages in Poland
Zegartowice	Villages in Poland
Żygląd	Villages in Poland
1 Esdras	Religious texts
Potential National Hockey League expansion	National Hockey League
4 Maccabees	Books of the Bible
Esdras	Religious texts
NHL Conference Finals	National Hockey League
Jewish Publication Society of America Version	Bible versions, Judaism in the United States, 1917, 1910s books
Prayer of Manasseh	Religious texts
Patricio Rey y sus Redonditos de Ricota	Argentine rock bands, Musical groups established in 1976, 1976 establishments in South America, 20th-century establishments in Argentina
Development of the New Testament canon	New Testament
Peshitta	Bible versions
Rockumentary	Rock music, Documentary movies
The Band	1960s music groups, 1970s music groups, 1980s music groups, 1990s music groups, Canadian rock bands, Grammy Award winners, Warner Bros. Records artists, Musical groups established in 1964, 1964 establishments in Canada, Musical groups disestablished in the 1970s, 1976 disestablishments in North America, Musical groups established in 1983, 1983 establishments in North America, Musical groups disestablished in 1999, 1999 disestablishments, 1990s disestablishments in Canada
One Foot in Heaven	1941 movies, Biographical movies, Movies based on books, Movies directed by Irving Rapper
Adam Lambert	1982 births, Living people, Adam Lambert, American Idol contestants, Gay Jews, Jewish American LGBT people, Jewish American musicians, LGBT people from California, LGBT people from Indiana, LGBT singers, LGBT songwriters, Writers from Indianapolis, Indiana, Writers from San Diego, California, Singers from San Diego, California, Singers from Indianapolis, Indiana, Singer-songwriters from California
Cristobal Huet	1975 births, American Hockey League players, Chicago Blackhawks players, French ice hockey players, Living people, Los Angeles Kings players, Montreal Canadiens players, Washington Capitals players, Stanley Cup champions, Ice hockey goaltenders
The Hockey News	Magazines of Canada, Ice hockey
Majed Moqed	1977 births, 2001 deaths, Al-Qaeda people, Saudi Arabian people, September 11 attacks
Bill Masterton Memorial Trophy	National Hockey League trophies and awards
Yoshinori Matsuda	1974 births, Living people, Footballers from Saitama Prefecture
Daisuke Watanabe	1978 births, Living people, Footballers from Hokkaidō Prefecture
Hiroshi Moriyasu	1972 births, Living people, Footballers from Shizuoka Prefecture
Koji Fujikawa	1978 births, Living people, Footballers from Tokushima Prefecture
Shinsuke Shimabukuro	1983 births, Living people, Footballers from Nagasaki Prefecture
Masaharu Kawahara	1984 births, Living people, Footballers from Osaka Prefecture, Japanese association football goalkeepers, People from Osaka
The Advocate (Australia)	Tasmania, Newspapers published in Australia
Taro Sugahara	1981 births, Living people, Footballers from Shiga Prefecture
Koki Habata	1983 births, Living people, Footballers from Wakayama Prefecture
Ryohei Nishiwaki	1979 births, Living people, Footballers from Gifu Prefecture
Choi Chung-min	1930 births, 1983 deaths, South Korean footballers, South Korean football managers, People from Pyongyang
Gary Stevens	1963 births, Living people, 1986 FIFA World Cup players, 1990 FIFA World Cup players, English footballers, Sportspeople from Cumbria, Sportspeople from Lancashire
Finidi George	1971 births, Living people, Nigerian footballers
Moabe Platini Dias Ramos	1987 births, Living people, Brazilian footballers
Mitsutoshi Watada	1976 births, Living people, Footballers from Hyōgo Prefecture
Motoki Kawasaki	1979 births, Living people, Footballers from Oita Prefecture
Naohiro Tamura	1978 births, Living people, Footballers from Tokushima Prefecture
Jefferson Vieira da Cruz	1981 births, Living people, Brazilian footballers
Paul Anderson	1988 births, Living people, English footballers, Sportspeople from Leicestershire
Fábio Aurélio	1979 births, Living people, Brazilian footballers
Masanao Sasaki	1962 births, Living people, Footballers from Chiba Prefecture, Japan international footballers, J1 League players, Japan Soccer League players, Honda FC players, Yokohama Flügels players, JEF United Chiba players, Kashiwa Reysol players
Leyden jar	Electricity
Seo Jung-won	1970 births, Living people, South Korean footballers, South Korean football managers
Hakan Şükür	1971 births, Living people, Turkish footballers
Maciej Żurawski	1976 births, Living people, People from Poznań, Polish footballers
Agustín Ross Park	Pichilemu, Buildings and structures in Chile
Therapy dog	Working dogs, Service animals
VMU	Technology, Sega
Suffer (album)	1988 albums, Bad Religion albums, Punk albums
No Control	1989 albums, Bad Religion albums, Punk albums
Greg Graffin	1964 births, Living people, musicians from Wisconsin, People from Racine, Wisconsin, Bad Religion, Cornell University alumni, American paleontologists, American zoologists, Scientists from Wisconsin
Jay Bentley	1964 births, Living people, American guitarists, Punk musicians, Bassists, Bad Religion, Musicians from Wichita, Kansas
Stranger Than Fiction	1994 albums, Bad Religion albums, Punk albums
Woodstock (movie)	American documentary movies, English-language movies, 1970 movies, United States National Film Registry movies
Battle of the Alamo	1836, 1830s in Texas, Battles, History of San Antonio, Texas, 19th century in Mexico, March events
Adrian Edmondson	1957 births, Living people, Actors from Bradford, British stand-up comedians, Comedians from Yorkshire, English movie actors, English movie directors, English screenwriters, English television actors, English television directors, English television writers, Writers from Yorkshire
Eugen Sandow	1867 births, 1925 deaths, German sportspeople, People from former German territories, People from Kaliningrad, People from Prussia
Naoki Naruo	1974 births, Living people, Footballers from Iwate Prefecture
Koichiro Katafuchi	1975 births, Living people, Footballers from Saga Prefecture
Takashi Uemura	1973 births, Living people, Footballers from Osaka Prefecture, People from Osaka
Satoshi Miyagawa	1977 births, Living people, Footballers from Kanagawa Prefecture
Takashi Okuhara	1972 births, Living people, Footballers from Tokyo Prefecture
Kotaro Nakao	1969 births, Living people, Footballers from Nagasaki Prefecture
Yoshiro Nakamura	1979 births, Living people, Footballers from Nara Prefecture
Kenta Kano	1986 births, Living people, Footballers from Shizuoka Prefecture
Miguel Monteiro	1980 births, Living people, Portuguese footballers, Sportspeople from Lisbon
Geremi Njitap	1978 births, Living people, Cameroonian footballers
Tetsuharu Yamaguchi	1977 births, Living people, Footballers from Nagasaki Prefecture
Marcelo Rosada Silva	1976 births, Living people, Brazilian footballers, People from Porto Alegre
Yasuhide Ihara	1973 births, Living people, Footballers from Saga Prefecture
Kosei Kitauchi	1974 births, Living people, Footballers from Kōchi Prefecture
Washington Luiz Pereira dos Santos	1975 births, Living people, Brazilian footballers
Scatman John	1982 births, 1999 deaths, Cancer deaths in the United States, Deaths from lung cancer, Singers from Los Angeles, California
Kiyohiro Hirabayashi	1984 births, Living people, Footballers from Aichi Prefecture
Akira Komatsu	1962 births, Living people, Footballers from Akita Prefecture
FC Gifu	Japanese football clubs, Gifu Prefecture
Kataller Toyama	Japanese football clubs, Toyama Prefecture
Roasso Kumamoto	Japanese football clubs, Kumamoto Prefecture
Tochigi SC	Japanese football clubs, Tochigi Prefecture
Fagiano Okayama	Japanese football clubs, Okayama Prefecture
Giravanz Kitakyushu	Japanese football clubs, Fukuoka Prefecture
Irvine, California	Irvine, California, 1971 establishments in California
Fault (geology)	Plate tectonics
Bible translations	Bible
Darts	Darts
Aerobics	Fitness, Healthy lifestyle
California Polytechnic State University	1901 establishments in the United States, 1900s establishments in California, Big Sky Conference, Big West Conference, California State University
Pennywise	American punk bands, Musical groups from Los Angeles, California, 1990s American music groups, 2000s American music groups, 2010s American music groups
About Time	1995 albums
Come Out and Play	The Offspring songs, 1994 songs
Compiled language	Programming languages
Self Esteem	The Offspring songs, 1994 songs
Gotta Get Away	The Offspring songs, 1994 songs
Memory address	Computer memory
Ignition (album)	1992 albums, The Offspring albums, Punk albums
Ixnay on the Hombre	1997 albums, The Offspring albums, Punk albums
Americana (The Offspring album)	1998 albums, The Offspring albums
Conspiracy of One	2000 albums, The Offspring albums, Pop punk albums
Splinter	2003 albums, The Offspring albums, Punk albums
Rise and Fall, Rage and Grace	2008 albums, The Offspring albums, Pop punk albums
Jumping	Human skills, Fitness, Athletics
Maia Chiburdanidze	1961 births, Living people, Chess grandmasters, People from Tbilisi
Taiping Rebellion	Civil wars, History of China
David Pizarro	1979 births, Living people, Chilean footballers, People from Valparaíso
Nilmar Honorato da Silva	1984 births, Living people, Brazilian footballers
Danilo Gomes	1981 births, Living people, Brazilian footballers
Nobuhiro Maeda	1973 births, Living people, Footballers from Kagawa Prefecture, Japanese association football goalkeepers
Minoru Kushibiki	1967 births, Living people, Footballers from Osaka Prefecture, People from Osaka
Kota Ueda	1986 births, Living people, Footballers from Tokyo Prefecture
Keisuke Funatani	1986 births, Living people, Footballers from Mie Prefecture
Shun Morishita	1986 births, Living people, Footballers from Mie Prefecture
Steven Reid	1981 births, Living people, Irish footballers, Sportspeople from London
Li Tie	1977 births, Living people, Chinese footballers
Kota Mizunuma	1990 births, Living people, Footballers from Kanagawa Prefecture
Vujadin Boškov	1931 births, 2014 deaths, Serbian footballers, Serbian football managers, Eredivisie managers
Genki Nakayama	1981 births, Living people, Footballers from Yamaguchi Prefecture
Hiroshi Nakano	1983 births, Living people, Footballers from Saga Prefecture, Albirex Niigata players
Edmar Bernardes dos Santos	1960 births, Living people, Brazilian footballers
Kazumasa Kume	1955 births, Living people, Footballers from Shizuoka Prefecture
Takahiro Yodogawa	1951 births, Living people, Japanese association football goalkeepers
Susan Polgar	1969 births, Living people, American chess players, Hungarian chess players, Hungarian Jews, Jewish American sportspeople, Sportspeople from Budapest, Chess grandmasters
Christian Pander	1983 births, Living people, German footballers, Sportspeople from North Rhine-Westphalia
Dado Pršo	1974 births, Living people, Croatian footballers
Mart Poom	1972 births, Living people, Estonian sportspeople, Association football goalkeepers, European footballers, People from Tallinn
Antonios Nikopolidis	1971 births, Living people, Greek footballers, Association football goalkeepers
Sean Waltman	1972 births, Living people, American professional wrestlers, Former WWE wrestlers, Sportspeople from Minneapolis, Minnesota, Total Nonstop Action Wrestling alumni
Raven (wrestler)	Living people, 1964 births, American professional wrestlers
Mommy's Little Monster	1983 albums, Punk albums
Beachwood, Ohio	Cities in Ohio
Against the Grain	1990 albums, Bad Religion albums, Punk albums
Recipe for Hate	1993 albums, Bad Religion albums, Punk albums
Greg Hetson	1961 births, American folk musicians, American guitarists, American punk musicians, Bad Religion, Living people, Musicians from Los Angeles, California, Musicians from New York City
Flower Street	Curitiba, Roads
You're My Heart, You're My Soul	Modern Talking, 1984 songs
Francisco Yeste	1979 births, Living people, Spanish footballers
Philip Ifil	1986 births, Living people, English footballers, Sportspeople from London, Premier League players
Manuel Almunia	1977 births, Living people, Spanish association football goalkeepers, People from Pamplona
Pierre Womé	1979 births, Living people, Cameroonian footballers
Raúl Albiol	1985 births, Living people, Spanish footballers
Ivan Klasnić	1980 births, Living people, Croatian footballers
Willesden	Areas of London
Antonín Panenka	1948 births, Living people, Czech footballers, Sportspeople from Prague
David Healy	1979 births, Living people, Northern Irish footballers
Hiroyuki Nishijima	1982 births, Living people, Footballers from Nara Prefecture
Public nudity	Nudity
Vincent Candela	1973 births, Living people, French footballers
Emiliano Moretti	1981 births, Living people, Italian footballers, Sportspeople from Rome
Paolo Cannavaro	1981 births, Living people, Italian footballers
Ranko Popović	1967 births, Living people, Serbian footballers, Serbian football managers
Diego Ribas da Cunha	1985 births, Living people, Brazilian footballers
Kazumi Tsubota	1956 births, Living people, Footballers from Nagasaki Prefecture, Japan international footballers, Japan Soccer League players, Cerezo Osaka players
Thomas Sørensen	1976 births, Living people, Danish footballers, Association football goalkeepers
Zanesville, Ohio	Cities in Ohio, Former United States state capitals, County seats in Ohio, 1790s establishments in the Northwest Territory, 1797 establishments in the United States
Entomophagy	Insects, Food and drink
Kazumasa Takagi	1984 births, Living people, Footballers from Kagawa Prefecture
Yasuhito Morishima	1987 births, Living people, Footballers from Hyōgo Prefecture
Takuya Miyamoto	1983 births, Living people, Footballers from Hiroshima Prefecture, People from Hiroshima
Kohei Miyazaki	1981 births, Living people, Footballers from Kumamoto Prefecture
Circle Jerks	1979 establishments in California, 1970s American music groups, 1980s American music groups, 1990s American music groups, 2000s American music groups, 2010s American music groups, American punk bands, Musical groups established in 1979, Musical groups from California
Naoki Ishikawa	1985 births, Living people, Footballers from Chiba Prefecture
Ryota Miki	1985 births, Living people, Footballers from Osaka Prefecture, People from Osaka
Saeed Al-Owairan	1967 births, Living people, Saudi Arabian footballers, People from Riyadh
Shinya Kawashima	1978 births, Living people, Footballers from Shizuoka Prefecture
Shunsuke Oyama	1986 births, Living people, Footballers from Saitama Prefecture
Boeing X-37	Spaceflight, Boeing aircraft
Puerto Natales	Cities in Chile
Aftershock	Earthquakes
Barcode	Data input, Barcodes
Nathalia Dill	1986 births, Living people, Brazilian actors, People from Rio de Janeiro
Optical mark recognition	Computer hardware, Data input
Optical character recognition	Data input
Nhundiaquara River	Paraná State
Istrian Italians	Italian-speaking countries, Italian people, History of Italy, Croatia, Slovenia
Valentina Tolkunova	1946 births, 2010 deaths
Toshikazu Kato (born in 1969)	1969 births, Living people, Footballers from Shizuoka Prefecture
Luke Moore	1986 births, Living people, Black British sportspeople, English footballers, Sportspeople from Birmingham, Premier League players
Atsuyoshi Furuta	1952 births, Living people, Footballers from Hiroshima Prefecture, Japan international footballers, Japan Soccer League players, Sanfrecce Hiroshima players
Anthony Le Tallec	1984 births, Living people, French footballers
Lee Bowyer	1977 births, Living people, English footballers, Sportspeople from London, Premier League players
Justin Hoyte	1984 births, Living people, English footballers, Sportspeople from London, Premier League players
Armand Traoré	1989 births, Living people, French footballers, Sportspeople from Paris
Steven Taylor	1986 births, Living people, English footballers, Sportspeople from London
Makoto Okubo	1975 births, Living people, Footballers from Nagasaki Prefecture
Mitsuaki Kojima	1968 births, Living people, Footballers from Nagasaki Prefecture
Katsuhiro Minamoto	1972 births, Living people, Footballers from Hiroshima Prefecture, People from Hiroshima
Yasuyuki Sato	1966 births, Living people, Footballers from Hiroshima Prefecture, People from Hiroshima
Francisco Javier García	1987 births, Living people, Spanish footballers
Design management	Management, Innovation
Middlegame	Chess
Truro Cathedral	Cathedrals in England, Cornwall
VHS	Entertainment, Electronics
Telemetry	Measurement, Technology
Agustín Ross	1844 births, 1926 deaths, Chilean politicians, People from Pichilemu, Diplomats
Blueprint	Engineering
José Arraño	1921 births, 2009 deaths, Chilean writers, People from Pichilemu, Historians
Boeing 367-80	Boeing 707
Harvey Birdman, Attorney at Law	Adult Swim, English-language television programs
Bosque Capão da Imbuia	Curitiba, Forests, Geography of Brazil
Ben Folds Five	American rock bands, Musical groups from North Carolina
Woolmer Green	Villages in Hertfordshire, Civil parishes in Hertfordshire
Rubén de la Red	1985 births, Living people, Spanish footballers
Ryuji Kato	1969 births, Living people, Footballers from Tokyo Prefecture, Japanese association football goalkeepers
Hideaki Mori	1972 births, Living people, Footballers from Nagasaki Prefecture
Sho Ito	1988 births, Living people, Footballers from Aichi Prefecture
Maxwell Cabelino Andrade	1981 births, Living people, Brazilian footballers
Mary of Modena	1658 births, 1718 deaths, Deaths from breast cancer, House of Este, Kings and Queens of Ireland, Kings and Queens consort of Scotland, People from Modena
Juan Pablo Ángel	1975 births, Living people, Colombian footballers
Ciprian Marica	1985 births, Living people, Romanian footballers, Sportspeople from Bucharest
Hideki Nishimura	1983 births, Living people, Footballers from Osaka Prefecture, People from Osaka
Morten Gamst Pedersen	1981 births, Living people, Norwegian footballers
Manabu Kubota	1981 births, Living people, Footballers from Shimane Prefecture
Naoyuki Okimoto	1984 births, Living people, Footballers from Hiroshima Prefecture, People from Hiroshima
Ryota Terauchi	1982 births, Living people, Footballers from Ishikawa Prefecture
Dani Alves	1983 births, Association football defenders, Association football full-backs, Living people, Brazilian footballers
Daniel Carvalho	1983 births, Living people, Brazilian footballers
Keita Kanemoto	1977 births, Living people, Footballers from Hiroshima Prefecture
Yutaka Azuma	1967 births, Living people, Footballers from Tokushima Prefecture, Japanese football managers
Yasutaka Yoshida	1966 births, Living people, Footballers from Hiroshima Prefecture
Hossam Ghaly	1981 births, Living people, Egyptian footballers, Egypt international footballers
Eric Gerets	1954 births, Living people, Belgian footballers, Belgian football managers, Eredivisie managers
Darius Vassell	1980 births, Living people, Black British sportspeople, English footballers, Sportspeople from Birmingham, Premier League players
Hisashi Jogo	1986 births, Living people, Footballers from Fukuoka Prefecture, Avispa Fukuoka players
Masato Morishige	1987 births, Living people, Footballers from Hiroshima Prefecture, Japan international footballers, J1 League players, J2 League players, Oita Trinita players, FC Tokyo players, 2014 FIFA World Cup players, Footballers at the 2008 Summer Olympics
Wuyi Mountains	Mountains of China, Biosphere reserves
Norwegian Labour Party	1887 establishments in Europe, Socialist International, Social democratic parties, Political parties in Norway, 19th century establishments in Norway
Socialist Left Party	Political parties in Norway, Socialism, Green politics
Red Party (Norway)	Political parties in Norway
Mektig og avmektig	2003 books, Non-fiction books
Dofus	Online games, Massively multiplayer online role-playing games
Sinn Féin	Politics of Ireland, Political parties in Northern Ireland, Nationalist organizations in Europe, 1905 establishments in Europe, 20th century establishments in the Republic of Ireland, 1905 establishments in the United Kingdom
Diana Wynne Jones	1934 births, 2011 deaths, Deaths from lung cancer, English writers, Writers from London
Sherman, Texas	Cities in Texas, County seats in Texas, 1846 establishments in the United States, 1840s establishments in Texas
Kıbrıs Türk Hava Yolları	Airlines of the Middle East, Nicosia
Iberia (airline)	Airlines of Spain
Orthodontist	Orthodontics, Healthcare occupations
Chicoutimi	Cities and towns in Quebec, Former cities in Canada
Vágner Love	1984 births, Living people, Brazilian footballers
Lucas Leiva	1987 births, Living people, Brazilian footballers, Mato Grosso do Sul
Takaya Oishi	1972 births, Living people, Footballers from Shizuoka Prefecture, Japanese association football goalkeepers
Yasuhiro Yoshida	1969 births, Living people, Footballers from Hiroshima Prefecture
Naoki Naito	1968 births, Living people, Footballers from Shizuoka Prefecture
Francisco Pavón	1980 births, Living people, Spanish footballers, Sportspeople from Madrid
Kenji Wakai	1974 births, Living people, Footballers from Hiroshima Prefecture
Elano	1981 births, Living people, Brazilian footballers
Collins John	1985 births, Living people, Dutch footballers, Liberian people, Naturalised citizens of the Netherlands
Jelle Van Damme	1983 births, Living people, Belgian footballers, People from East Flanders
Satoshi Koga	1970 births, Living people, Footballers from Kanagawa Prefecture
Takashi Kageyama	1977 births, Living people, Footballers from Osaka Prefecture, People from Osaka
Motoki Ueda	1979 births, Living people, Footballers from Kanagawa Prefecture
Nobuyasu Ikeda	1970 births, Living people, Footballers from Saitama Prefecture
Koichi Kawazoe	1961 births, Living people, Footballers from Kagoshima Prefecture
Tsubasa Oya	1986 births, Living people, Footballers from Shimane Prefecture
Tenerife South Airport	Airports in Spain, Canary Islands
Daisuke Nakamaki	1986 births, Living people, Footballers from Tokyo Prefecture, Japanese association football goalkeepers
John Aldridge	1958 births, Living people, 1990 FIFA World Cup players, 1994 FIFA World Cup players, Irish football managers, Irish footballers, Sportspeople from Liverpool
Gary Breen	1973 births, Living people, Irish footballers, Sportspeople from London
Faisal Al-Dakhil	1957 births, Living people, Kuwaiti people, Asian footballers
Junki Koike	1987 births, Living people, Footballers from Saitama Prefecture
Kenji Haneda	1981 births, Living people, Footballers from Chiba Prefecture
Hunza-Nagar District	Districts of Gilgit-Baltistan
Speech recognition	Data input
Smile (band)	Queen (band)
Vinyl cutter	Computer hardware, Output devices
Oddanchatram	Cities in Tamil Nadu
Total Drama Action	Total Drama
Total Drama World Tour	Animated television series
Santa Felicidade neighborhood	Curitiba, Neighborhoods, 1878 establishments, 1870s establishments in Brazil
Joakim Soria	Kansas City Royals players, Mexican sportspeople, 1984 births, Living people
Slate	Metamorphic rocks
Sachio Yoshida	1980 births, Living people, Footballers from Yamaguchi Prefecture
Daishi Kato	1983 births, Living people, Footballers from Saitama Prefecture
Manuel Fernandes	1986 births, Living people, Portuguese footballers, Sportspeople from Lisbon
Andrea Bocelli	1958 births, Living people, Blind people, Brit Award winners, Italian singers, Multi-instrumentalists, Musicians from Tuscany, Italian opera singers, Songwriters, Tenors
Kikuo Konagaya	1950 births, Living people, Footballers from Shizuoka Prefecture
Toshiya Tanaka	1984 births, Living people, Footballers from Ishikawa Prefecture
Eiji Hirata	1966 births, Living people, Footballers from Yamaguchi Prefecture
Takashi Onishi	1971 births, Living people, Footballers from Ehime Prefecture
Shola Ameobi	1981 births, Living people, English footballers, People from Newcastle upon Tyne, Nigerian footballers, Sportspeople from Tyne and Wear, Premier League players
Aiden McGeady	1986 births, Living people, Irish footballers, Sportspeople from Glasgow
Pavel Černý	1962 births, Living people, Czech footballers
Yushi Ozaki	1969 births, Living people, Footballers from Mie Prefecture
Hiroshi Sato	1972 births, Living people, Footballers from Kanagawa Prefecture
Takenori Ikeda	1981 births, Living people, Footballers from Shimane Prefecture
Quinton Fortune	1977 births, Living people, South African footballers, People from Cape Town
Bantu languages	Niger-Congo languages
Terukazu Tanaka	1985 births, Living people, Footballers from Osaka Prefecture, People from Osaka
Niger–Congo languages	Niger-Congo languages
Ivar Hippe	1953 births, Living people, Norwegian journalists, Writers from Oslo
Ken Tokura	1986 births, Living people, Footballers from Tokyo Prefecture
Kenya Matsui	1985 births, Living people, Footballers from Shizuoka Prefecture
Ryoji Yukutomo	1979 births, Living people, Footballers from Hiroshima Prefecture
Mirko Vučinić	1983 births, Living people, Montenegrin footballers
Mista	1978 births, Living people, Spanish footballers
Pascal Cygan	1974 births, Living people, French footballers
Carlo Cudicini	1973 births, Living people, Chelsea F.C. players, Italian association football goalkeepers, Tottenham Hotspur F.C. players, Sportspeople from Milan
Andrey Gustavo dos Santos	Brazilian footballers, 1974 births, Living people
Neško Milovanović	1974 births, Living people, Bulgarian footballers
Jonathan Spector	1986 births, Living people, American footballers
Masahiro Akimoto	1979 births, Living people, Footballers from Oita Prefecture
Junya Ohata	1979 births, Living people, Footballers from Tokyo Prefecture
Yuya Matsuoka	1978 births, Living people, Footballers from Ehime Prefecture
Hisashi Hiroike	1978 births, Living people, Footballers from Miyazaki Prefecture
Masato Tamada	1976 births, Living people, Footballers from Saitama Prefecture, Japanese association football goalkeepers
American Samoa national football team	National football teams, American Samoa
Ian Crook	1963 births, Living people, English footballers, English football managers, Sportspeople from London, Premier League players
Antônio Carlos Santos	1964 births, Living people, Footballers from Rio de Janeiro
Ryuichi Hirashige	1988 births, Living people, Footballers from Hiroshima Prefecture, Kataller Toyama players
Tomokazu Nagira	1985 births, Living people, Footballers from Shimane Prefecture, Avispa Fukuoka players
Wawel Dragon	Folklore, Kraków
Renal cell carcinoma	Renal cancer
Self-portrait	Art
3D printing	Technology stubs, Innovation, Printing
Air travel	Air travel
GABA	Amino acids
Stroke (engine)	Mechanics
Italian car number plates	Italy, Law, Road transport
Abraham (name)	Given names
Yuta Abe	1974 births, Living people, Footballers from Yamaguchi Prefecture, Renofa Yamaguchi FC players
Lomana LuaLua	1980 births, Living people, African footballers, People from Kinshasa
Toru Yasutake	1978 births, Living people, Footballers from Fukuoka Prefecture
Takeshi Ikoma	1971 births, Living people, Footballers from Hyōgo Prefecture
Tatsuya Makiuchi	1964 births, Living people, Footballers from Kagoshima Prefecture
Jean-Paul Vonderburg	1964 births, Living people, Swedish footballers
Katsuyuki Kawachi	1955 births, Living people, Footballers from Hiroshima Prefecture, Japan international footballers, Japan Soccer League players, Sanfrecce Hiroshima players
Chris Kirkland	1981 births, Living people, English association football goalkeepers, Sportspeople from Leicestershire, Premier League players
Wes Brown	1979 births, Living people, Black British sportspeople, English footballers, Sportspeople from Manchester, Premier League players
Kunihiko Akabane	1972 births, Living people, Footballers from Nagano Prefecture
Kenji Wakamatsu	1972 births, Living people, Footballers from Kagoshima Prefecture
Tetsuya Tanaka	1971 births, Living people, Footballers from Nagasaki Prefecture
Mark Bresciano	1980 births, Living people, Australian footballers, Sportspeople from Melbourne
Samir Nasri	1987 births, Living people, Arsenal F.C. players, French footballers, Manchester City F.C. players, West Ham United F.C. players, Sportspeople from Marseille
Yasumasa Makino	1973 births, Living people, Footballers from Shizuoka Prefecture
Koji Yoshikawa	1973 births, Living people, Footballers from Shimane Prefecture
Tsukimitsu Mizuta	1976 births, Living people, Footballers from Nagasaki Prefecture
Tomasz Kuszczak	1982 births, Living people, Polish footballers
Pyrite	Minerals, Iron compounds
John Lewis (pianist)	1920 births, 2001 deaths, American pianists, American composers
Kazuhiko Chiba	1985 births, Living people, Footballers from Hokkaidō Prefecture, Japan international footballers, J1 League players, J2 League players, Albirex Niigata players, Sanfrecce Hiroshima players, Nagoya Grampus players
Kazuhisa Kawahara	1987 births, Living people, Footballers from Saitama Prefecture, Albirex Niigata players
Masaki Chugo	1982 births, Living people, Footballers from Chiba Prefecture
Naoki Hatta	1986 births, Living people, Footballers from Mie Prefecture
Mario J. Molina	1943 births, 2020 deaths, Deaths from myocardial infarction, Chemists, Mexican Nobel Prize winners, Mexican scientists
Andriy Voronin	1979 births, Living people, Ukrainian footballers
Kazuki Ganaha	1980 births, Living people, Footballers from Okinawa Prefecture, Japan international footballers, J1 League players, J2 League players, J3 League players, Kawasaki Frontale players, Vissel Kobe players, FC Ryukyu players, Kamatamare Sanuki players
Jorge Vargas	1967 births, Living people, Chilean politicians, People from Pichilemu
Dye-sublimation printer	Printers
Rockhopper penguin	Penguins
Kidney cancer	Renal cancer
Crunchy Black	Singers from Memphis, Tennessee, American rap musicians, American dancers, Singers from Indiana, 1974 births, Living people
Hellhound	Mythology, Demons
Wilms tumor	Renal cancer
Pancreatic cancer	Cancer, Diseases and disorders of the digestive system
Abdominal pain	Pain, Digestive system
Renal medullary carcinoma	Renal cancer
Clear cell sarcoma of the kidney	Renal cancer
Glioblastoma multiforme	Brain tumors
Jordan Schroeder	1990 births, American Hockey League players, American ice hockey players, Living people, Sportspeople from Minnesota, Minnesota Wild players, Vancouver Canucks players, Ice hockey centres
Sania Mirza	Living people, Female tennis players, Indian sportspeople, 1986 births, BBC 100 Women
Akira Kawaguchi	1967 births, Living people, Footballers from Chiba Prefecture
Shiro Hashimitsu	1972 births, Living people, Footballers from Kyoto
Ken Michiki	1972 births, Living people, Footballers from Nagasaki Prefecture
Kenji Tomita	1967 births, Living people, Footballers from Kagoshima Prefecture
Hirobumi Zaima	1964 births, Living people, Footballers from Kumamoto Prefecture
Ryoji Araki	1978 births, Living people, Footballers from Nagasaki Prefecture
Takahisa Iwamura	1978 births, Living people, Japanese footballers
Taro Goto	1969 births, Living people, Footballers from Hiroshima Prefecture
Hideaki Hagino	1973 births, Living people, Footballers from Hokkaidō Prefecture
Kazuo Sumata	1973 births, Living people, Footballers from Oita Prefecture
Nitroglycerin	Explosives, Nitrogen compounds
Marcus Bent	1978 births, Living people, English footballers, Sportspeople from London, Premier League players, Crystal Palace F.C. players
Patrice Evra	1981 births, Living people, French footballers, Manchester United F.C. players, Senegalese footballers, People from Dakar
Kazuyoshi Hamaguchi	1960 births, Living people, Footballers from Mie Prefecture
Shabani Nonda	1977 births, Living people, African footballers, People from the Democratic Republic of the Congo
Kosuke Harada	1977 births, Living people, Footballers from Hiroshima Prefecture
Ryuji Nagata	1972 births, Living people, Footballers from Nagasaki Prefecture
Norihiro Kawakami	1987 births, Living people, Footballers from Shimane Prefecture
Seol Ki-hyeon	1979 births, Living people, South Korean footballers
Agustín Delgado	1974 births, Living people, Ecuadorian footballers
Shuichi Gonda	1989 births, Living people, Footballers from Tokyo Prefecture, Japan international footballers, J1 League players, J2 League players, FC Tokyo players, Sagan Tosu players, Shimizu S-Pulse players, 2014 FIFA World Cup players, 2013 FIFA Confederations Cup players, Footballers at the 2012 Summer Olympics
Bronisław Komorowski	1952 births, Living people, Presidents of Poland, Marshals of the Sejm
Toru Miyamoto	1982 births, Living people, Footballers from Yamaguchi Prefecture
Yūsuke Tanaka (born in February 1986)	1986 births, Living people, Footballers from Fukuoka Prefecture
Temozolomide	Drugs, Cancer treatment
Kazuki Hara	1985 births, Living people, Footballers from Chiba Prefecture
Keisuke Iwashita	1986 births, Living people, Footballers from Kagoshima Prefecture
Astrocytoma	Brain tumors
2009–10 Chicago Blackhawks season	2009 in ice hockey, 2010 in ice hockey, National Hockey League team seasons
2009–10 Montreal Canadiens season	2009 in ice hockey, 2010 in ice hockey, National Hockey League team seasons, 2009 in Canada, 2010 in Canada
2009–10 Boston Bruins season	2009 in ice hockey, 2010 in ice hockey, National Hockey League team seasons, 2009 in the United States, 2010 in the United States, 21st century in Boston, Massachusetts
2009–10 Nashville Predators season	2009 in ice hockey, 2010 in ice hockey, National Hockey League team seasons, Nashville Predators, 2009 in the United States, 2010 in the United States, 2000s in Nashville, Tennessee, 2010s in Nashville, Tennessee
Philmont Scout Ranch	New Mexico
2010 Stanley Cup playoffs	2010 in Canada, 2010 in ice hockey, 2010 in the United States, Stanley Cup playoffs
Flash flood	Floods
Finger Lakes	Geography of New York, Lakes of the United States
Cape Fear (headland)	Geography of North Carolina, Capes of the United States
Craven County, North Carolina	North Carolina counties, 18th-century establishments in North Carolina, 1712 establishments in the Thirteen Colonies
Absecon, New Jersey	Cities in New Jersey
Fanconi anemia	Genetic disorders
Stack machine	Computer science
Captain Hook	Fictional characters
O'Hare International Airport	Airports in Chicago, 1944 establishments in the United States, 1940s establishments in Illinois
Stiliyan Petrov	1979 births, Living people, Bulgarian footballers
Tom Sermanni	1954 births, Living people, Scottish footballers
Toshiaki Tsukioka	1971 births, Living people, Footballers from Miyazaki Prefecture
Daisuke Matsuyama	1972 births, Living people, Footballers from Osaka Prefecture, People from Osaka
Nolberto Solano	1974 births, Living people, Peruvian footballers
Yuichi Yoshimoto	1972 births, Living people, Footballers from Ehime Prefecture
Kimio Hata	1965 births, Living people, Footballers from Hiroshima Prefecture, Japanese football managers
Álvaro Mejía Pérez	1982 births, Living people, Spanish footballers, Sportspeople from Madrid
Evair	1965 births, Living people, Brazilian footballers
Katsuhiro Suzuki	1977 births, Living people, Footballers from Kanagawa Prefecture
Benni McCarthy	1977 births, Living people, South African footballers, People from Cape Town
André Ooijer	1974 births, Living people, Dutch footballers, Sportspeople from Amsterdam
John Heitinga	1983 births, Living people, Dutch footballers, Sportspeople from South Holland
Luis Fernández	1959 births, Living people, French footballers, French football managers
Khalid Boulahrouz	1981 births, Living people, Dutch footballers, Sportspeople from South Holland
Jumpei Takaki	1982 births, Living people, Footballers from Kumamoto Prefecture
Kota Sugiyama	1985 births, Living people, Footballers from Shizuoka Prefecture
Rikihiro Sugiyama	1987 births, Living people, Footballers from Shizuoka Prefecture
Ryuta Sasaki	1988 births, Living people, Footballers from Ibaraki Prefecture
Satoshi Kukino	1987 births, Living people, Footballers from Miyazaki Prefecture
Shingo Akamine	1983 births, Living people, Footballers from Okinawa Prefecture
Shinji Okazaki	1986 births, Living people, Footballers from Hyōgo Prefecture, Japan international footballers, J1 League players, Shimizu S-Pulse players, 2010 FIFA World Cup players, 2014 FIFA World Cup players, 2018 FIFA World Cup players, 2013 FIFA Confederations Cup players, Footballers at the 2008 Summer Olympics
Shinzo Koroki	1986 births, Living people, Footballers from Miyazaki Prefecture, Japan international footballers, J1 League players, Kashima Antlers players, Urawa Red Diamonds players, Footballers at the 2016 Summer Olympics
Shunsuke Tsutsumi	1987 births, Living people, Footballers from Saitama Prefecture
Tadashi Takeda	1986 births, Living people, Japanese footballers
Samanda	1988 births, 2007 establishments in the United Kingdom, 2000s British music groups, 2010s British music groups, Living people, Big Brother contestants, British girl groups, British pop music groups, British television personalities, English models, English pop music groups, Musical duos, Musical groups disestablished in 2010, Musical groups established in 2007, People from Staffordshire, Twin people from England
Young Concert Artists Trust	Music competitions, 1984 establishments
Belcea Quartet	String quartets
Satyagraha	India, Philosophy, Peace, Violence
Spanair	Airlines of Spain
Vueling	2004 establishments in Europe, 2000s establishments in Spain, Low-cost airlines, Airlines of Spain, Barcelona
Binter Canarias	Airlines of Spain, Canary Islands
Air Europa	Airlines of Spain
Air Nostrum	Airlines of Spain
Cycad	Gymnosperms
Melodic hardcore	Hardcore punk
Daisuke Yoneyama	1982 births, Living people, Footballers from Mie Prefecture
Manuel Pasqual	1982 births, Living people, Italian footballers
Teruyuki Tahara	1968 births, Living people, Footballers from Kagoshima Prefecture
Enzo Maresca	1980 births, Living people, Italian footballers
Lee Cheong-Gyeong	1958 births, Living people, North Korean footballers
Calum Davenport	1983 births, Living people, British crime victims, English footballers, Sportspeople from Bedfordshire, Premier League players
Seiichi Ogawa	1970 births, Living people, Footballers from Chiba Prefecture
Gary O'Neil	1983 births, Living people, English footballers, People from Bromley (London borough), Sportspeople from London, Premier League players
Fuat Usta	1972 births, Living people, Turkish football managers, Turkish footballers
Ryu Saito	1979 births, Living people, Footballers from Hokkaidō Prefecture
Yuki Fukaya	1982 births, Living people, Footballers from Aichi Prefecture
Kaito Yamamoto	1985 births, Living people, Footballers from Shizuoka Prefecture, J1 League players, J2 League players, J3 League players, Shimizu S-Pulse players, Vissel Kobe players, JEF United Chiba players, Yokohama FC players, Roasso Kumamoto players, Fukushima United FC players, Footballers at the 2008 Summer Olympics
Keiji Watanabe	1985 births, Living people, Footballers from Shizuoka Prefecture
Takahiro Shibasaki	1982 births, Living people, Footballers from Kanagawa Prefecture
Takashi Amano	1986 births, Living people, Footballers from Kanagawa Prefecture
Pluto	Pluto
Yuya Yoshizawa	1986 births, Living people, Footballers from Tochigi Prefecture
Shota Arai	1985 births, Living people, Footballers from Saitama Prefecture
Yuya Nakamura	1986 births, Living people, Footballers from Saitama Prefecture
Alessandro Scarlatti	1660 births, 1725 deaths, Baroque composers, Italian composers, People from Palermo
Atsushi Yoshimoto	1982 births, Living people, Footballers from Shizuoka Prefecture
Takeshi Terada	1980 births, Living people, Footballers from Ibaraki Prefecture
Fernando Navarro	1982 births, Living people, Spanish footballers, Sportspeople from Barcelona
Akira Ishigame	1985 births, Living people, Footballers from Saitama Prefecture
Haruki Nishimura	1987 births, Living people, Footballers from Saitama Prefecture
Alison Barros Moraes	1982 births, Living people, Brazilian footballers
Nobuhisa Kobayashi	1983 births, Living people, Footballers from Tochigi Prefecture
Junya Tanaka (footballer, born 1983)	1983 births, Living people, Footballers from Osaka Prefecture, People from Osaka
Gábor Csupó	1952 births, Living people, Hungarian people, Animators
Katherine Paterson	1932 births, Living people
Bridge to Terabithia (novel)	Children's books, 1977 books, Fantasy books, Newbery Medal winning books
Akira Takeuchi	1983 births, Living people, Footballers from Kanagawa Prefecture
Kosuke Yamamoto	1989 births, Living people, Footballers from Shizuoka Prefecture
Satoshi Hashida	1981 births, Living people, Footballers from Kyoto
Shohei Abe	1983 births, Living people, Footballers from Kanagawa Prefecture
Takuya Muguruma	1984 births, Living people, Footballers from Kyoto
Takumi Wada	1981 births, Living people, Footballers from Shizuoka Prefecture
Shinji Kagawa	1989 births, Living people, Footballers from Hyōgo Prefecture, Japan international footballers, J1 League players, J2 League players, Cerezo Osaka players, Manchester United F.C. players, 2014 FIFA World Cup players, 2018 FIFA World Cup players, 2013 FIFA Confederations Cup players, Footballers at the 2008 Summer Olympics
Tomohiro Tsuda	1986 births, Living people, Footballers from Gifu Prefecture
Hurricane Elena	1985 in the United States, Category 3 Atlantic hurricanes, Hurricanes in the United States, 20th century in Cuba, 1980s in Florida, 20th century in Alabama, 20th century in Mississippi, 1980s in Louisiana
Wu-Tang Clan	Hip hop bands, 1990s American music groups, 1992 establishments in New York (state)
MICR	Data input
Computer law	Law, Computers
Dale Earnhardt Jr.	1974 births, Living people, Daytona 500 winners, People from Kannapolis, North Carolina, American racecar drivers, Sportspeople from North Carolina
Aigle Azur	Airlines of France
TAAG Air Angola	Airlines of Africa
Sarcoidosis	Diseases
Neurosarcoidosis	Diseases
Prednisone	Drugs
Europe Airpost	Airlines of France
Corsairfly	Airlines of France, 1981 establishments in Europe, 1980s establishments in France
Italian irredentism in Istria	History of Italy
Perestroika	1980s in the Soviet Union, Mikhail Gorbachev, 1986 establishments, 1980s establishments in the Soviet Union
Henri Verneuil	1920 births, 2002 deaths, French movie directors, Armenian movie directors
Armen Dzhigarkhanyan	1935 births, 2020 deaths, Deaths from renal failure, Deaths from cardiac arrest, Russian movie actors, Russian stage actors, Russian television actors, Armenian actors
Gettysburg, Pennsylvania	County seats in Pennsylvania, Gettysburg, Pennsylvania, Boroughs in Pennsylvania
Gettysburg National Cemetery	Cemeteries in the United States, National cemeteries, Military monuments and memorials in the United States, Gettysburg, Pennsylvania, 1863 establishments in the United States, 1860s establishments in Pennsylvania
Atsushi Ito	1983 births, Living people, Footballers from Yamaguchi Prefecture
Hibiki Kato	1987 births, Living people, Footballers from Gifu Prefecture
Tomoya Kumagai	1988 births, Living people, Footballers from Akita Prefecture
M&Ms	Candy
Kyohei Horikawa	1986 births, Living people, Footballers from Ehime Prefecture
Mitsuki Ichihara	1986 births, Living people, Footballers from Chiba Prefecture
Yusuke Kawabuchi	1986 births, Living people, Footballers from Osaka Prefecture, People from Osaka
Kosuke Nakahara	1987 births, Living people, Footballers from Osaka Prefecture, People from Osaka
Taisuke Matsugae	1982 births, Living people, Footballers from Kagawa Prefecture
Ken Matsumoto	1987 births, Living people, Footballers from Kanagawa Prefecture
Reiichi Ikegami	1983 births, Living people, Footballers from Chiba Prefecture
Taishi Endo	1980 births, Living people, Footballers from Chiba Prefecture
Rychely	1987 births, Living people, Brazilian footballers
Yuki Uekusa	1982 births, Living people, Footballers from Chiba Prefecture
Tatsuya Suzuki (born in 1988)	1988 births, Living people, Footballers from Kanagawa Prefecture
Koji Nishimura	1984 births, Living people, Footballers from Mie Prefecture
Takuya Honda	1985 births, Living people, Footballers from Kanagawa Prefecture, Japan international footballers, J1 League players, J2 League players, J3 League players, Shimizu S-Pulse players, Kashima Antlers players, Montedio Yamagata players, FC Gifu players, Footballers at the 2008 Summer Olympics
Wataru Inoue	1986 births, Living people, Footballers from Shizuoka Prefecture
Art game	Types of video games, Video game genres
Yasuhiro Hiraoka	1986 births, Living people, Footballers from Shizuoka Prefecture
Yohei Takeda	1987 births, Living people, Footballers from Osaka Prefecture, People from Osaka
Josimar Rodrigues Souza Roberto	1987 births, Living people, Brazilian footballers
Yuji Kimura	1987 births, Living people, Footballers from Tokyo Prefecture
Yuji Yabu	1984 births, Living people, Footballers from Kanagawa Prefecture
Drift mining	Mining
Yuki Fuji	1981 births, Living people, Footballers from Saitama Prefecture
2009–10 New Jersey Devils season	2009 in ice hockey, 2010 in ice hockey, National Hockey League team seasons, 2009 in the United States, 2010 in the United States, 21st century in New Jersey
2009–10 Calgary Flames season	2009 in ice hockey, 2010 in ice hockey, National Hockey League team seasons, 2009 in Canada, 2010 in Canada
Cosmic ray	Astrophysics, Nuclear physics
Cyclophosphamide	Drugs, Cancer treatment
Eilat	Spa towns, Ports and harbours of Israel, Eilat
Edwin H. Land	1909 births, 1991 deaths, American physicists, Scientists from Connecticut
San Francisco de Mostazal, Chile	Cities in Chile, Settlements in the Region of O'Higgins
Retarder	Trains
Janeite	Jane Austen
Sleep (operating system)	Computing
2008–09 Calgary Flames season	2008 in ice hockey, 2009 in ice hockey, National Hockey League team seasons, 2008 in Canada, 2009 in Canada
2007–08 Calgary Flames season	2007 in ice hockey, 2008 in ice hockey, National Hockey League team seasons, 2007 in Canada, 2008 in Canada
Histone	Molecular biology, Cell biology
Satoshi Hida	1984 births, Living people, Footballers from Mie Prefecture
Masato Okubo	1986 births, Living people, Footballers from Tokyo Prefecture
Mitsumasa Yoda	1977 births, Living people, Footballers from Tokyo Prefecture
Óscar López Hernández	1980 births, Living people, Spanish footballers
Heurelho Gomes	1981 births, Living people, Brazilian footballers
Alex Rodrigo Dias da Costa	1982 births, Living people, Brazilian footballers
Helton da Silva Arruda	1978 births, Living people, Brazilian association football goalkeepers
Carlo Mazzone	1937 births, Living people, Italian footballers, Sportspeople from Rome
Yuji Goto	1985 births, Living people, Footballers from Gifu Prefecture
Yūsuke Tanaka (born in April 1986)	1986 births, Living people, Footballers from Tokyo Prefecture
Jonathan de Guzmán	1987 births, Living people, Dutch footballers, Naturalised citizens of the Netherlands, Sportspeople from Toronto
Jiro Kamata	1985 births, Living people, Footballers from Tokyo Prefecture
Kengo Ishii	1986 births, Living people, Footballers from Hokkaidō Prefecture
Taku Akahoshi	1984 births, Living people, Footballers from Fukuoka Prefecture
Substrate (biochemistry)	Biochemistry
Maciej Rataj	Presidents of Poland, 1884 births, 1940 deaths, Activists, Legislative speakers, Murder victims
Fatty acid	Chemical compounds, Biochemistry
Repetitive strain injury	Disability
Debt consolidation	Economics
Prognosis	Medicine
Nephrectomy	Surgery
Prostatectomy	Surgery, Cancer treatment
Interleukin-2	Cancer treatment
Lymphoma	Cancer, Immunology, Lymphatic system
Primary central nervous system lymphoma	Brain tumors, Nervous system
Kya Dark Lineage	PlayStation 2 games, PlayStation 2-only games, 2003 video games
2008–09 Nashville Predators season	2008 in ice hockey, 2009 in ice hockey, Nashville Predators, National Hockey League team seasons, 2008 in the United States, 2009 in the United States, 2000s in Nashville, Tennessee
2007–08 Nashville Predators season	2007 in ice hockey, 2008 in ice hockey, Nashville Predators, National Hockey League team seasons, 2007 in the United States, 2008 in the United States, 2000s in Nashville, Tennessee
Darci Sprotte Neto	1987 births, Living people, Brazilian footballers
Daisuke Aono	1979 births, Living people, Footballers from Ehime Prefecture
Kosei Nakamura	1981 births, Living people, Footballers from Kumamoto Prefecture
Akihiro Kurihara	1985 births, Living people, Footballers from Gunma Prefecture
Yudai Suwa	1986 births, Living people, Footballers from Chiba Prefecture
Yuki Sakai (footballer, born 1985)	1985 births, Living people, Footballers from Shiga Prefecture
Shunichiro Zaitsu	1987 births, Living people, Footballers from Fukuoka Prefecture
Olivier Dacourt	1974 births, Living people, French footballers
Andranik Eskandarian	1951 births, Living people, Iranian footballers, Sportspeople from Tehran
Hironobu Haga	1982 births, Living people, Footballers from Miyagi Prefecture
Shinji Tsujio	1985 births, Living people, Footballers from Osaka Prefecture, People from Osaka
Yuya Hikichi	1983 births, Living people, Footballers from Kagoshima Prefecture
Yusuke Inuzuka	1983 births, Living people, Footballers from Shizuoka Prefecture
Kazunori Yoshimoto	1988 births, Living people, Footballers from Tokyo Prefecture
Farnborough, Hampshire	Towns in Hampshire
List of chemistry topics	Chemistry lists
Late Heavy Bombardment	Moon, Earth, Impact craters, Hadean, Impact events
2008–09 Boston Bruins season	National Hockey League team seasons, 2008 in ice hockey, 2009 in ice hockey, 2008 in Massachusetts, 2009 in the United States, 2000s in Boston, Massachusetts
2007–08 Boston Bruins season	2007 in ice hockey, 2008 in ice hockey, National Hockey League team seasons, 2007 in Massachusetts, 2008 in Massachusetts, 2000s in Boston, Massachusetts
Rover 75	Rover automobiles, 1990s automobiles, 2000s automobiles
Brain tumor	Brain tumors, Cancer
The Black Cat	19th-century American short stories, Short stories by Edgar Allan Poe
Benzodiazepine	Drugs, Drugs used in psychiatry
Bacterial meningitis	Diseases caused by bacteria
Viral meningitis	Diseases caused by viruses, Diseases and disorders of the brain
Multiple myeloma	Cancer, Blood
Edward Everett	1794 births, 1865 deaths, Whig party (US) politicians, Governors of Massachusetts, United States senators from Massachusetts, United States representatives from Massachusetts, Harvard University faculty
NBA draft	National Basketball Association
Radiometric dating	Radiometric dating
Gerard López	1979 births, Living people, Spanish footballers
Tatsuya Okamoto	1986 births, Living people, Footballers from Shizuoka Prefecture
Takashi Fujii	1986 births, Living people, Footballers from Aichi Prefecture, Blaublitz Akita players
Go Nakamura	1986 births, Living people, Footballers from Gifu Prefecture
Toru Morino	1987 births, Living people, Footballers from Chiba Prefecture
Noboru Kohara	1983 births, Living people, Footballers from Osaka Prefecture, People from Osaka
Sho Kamogawa	1983 births, Living people, Footballers from Oita Prefecture
Yusuke Sudo	1986 births, Living people, Footballers from Tokyo Prefecture
Shingo Wada	1987 births, Living people, Footballers from Shizuoka Prefecture
Tomoyasu Naito	1986 births, Living people, Footballers from Kanagawa Prefecture
Ryota Takahashi	1986 births, Living people, Footballers from Tokushima Prefecture
K–Ar dating	Archaeology, Radiometric dating
Ivan Leko	1978 births, Living people, Croatian footballers, Croatian football managers, People from Split
Jerko Leko	1980 births, Living people, Croatian footballers, Sportspeople from Zagreb
Uranium-lead dating	Radiometric dating
Daigo Watanabe	1984 births, Living people, Footballers from Nagasaki Prefecture
Genki Nagasato	1985 births, Living people, Footballers from Kanagawa Prefecture, Avispa Fukuoka players
Pedro Cea	1900 births, 1970 deaths, Uruguayan footballers, Uruguayan football managers, Sportspeople from Montevideo
Masato Yamazaki	1981 births, Living people, Footballers from Kyoto
Mälaren	Lakes of Sweden
Cadbury Creme Egg	Candy
Bevacizumab	Cancer treatment
Metastatic breast cancer	Cancer, Torso
Bone metastasis	Cancer, Diseases and disorders of bones
Hypercalcemia	Medical signs
Eoghan Quigg	British pop musicians, 1992 births, Living people
Imhotep	Ancient Egypt
Ablai Khan	1711 births, 1781 deaths, Asian military people, European military people, Kazakhstani people, Kings and queens
Turkmen Alabai	Dog breeds
Liver disease	Liver disease
Hepatocellular carcinoma	Cancer, Liver disease
NHL All-Star Game SuperSkills Competition	National Hockey League, 1990 establishments in North America
Henrik Sedin	1980 births, Art Ross Trophy winners, Hart Memorial Trophy winners, Living people, Swedish ice hockey players, Vancouver Canucks players, Twin people, Swedish Hockey League players, Ice hockey centres
Hepatoblastoma	Cancer, Liver disease
Smythe Division	National Hockey League divisions
Kansas City Scouts	Defunct National Hockey League teams, Sports in Kansas City, Missouri, 1974 establishments in the United States, 20th-century establishments in Missouri, 1976 disestablishments in the United States, 20th-century disestablishments in Missouri
Monikangana Dutta	1982 births, Living people, Indian actors, Indian models
Hideaki Ikematsu	1986 births, Living people, Footballers from Osaka Prefecture, People from Osaka
Masataka Tamura	1988 births, Living people, Footballers from Okayama Prefecture
Diego Bastos Riberiro	1988 births, Living people, Brazilian footballers
Gary Caldwell	1982 births, Living people, Scottish footballers
Eduardo da Silva	1983 births, Living people, Croatian footballers
Hidetaka Ubagai	1951 births, Living people, Footballers from Hyōgo Prefecture
Christian Riganò	1974 births, Living people, Italian footballers
Ryuta Hara	1981 births, Living people, Footballers from Tokyo Prefecture
Yoshiki Maeda	1975 births, Living people, Footballers from Saga Prefecture
David Di Michele	1976 births, Living people, Italian footballers
Leandro Simioni	1974 births, Living people, Brazilian footballers
Goran Jurić	1963 births, Living people, Croatian footballers
Diamondback rattlesnake	Vipers, Reptiles of North America
David Trezeguet	1977 births, Living people, French footballers, People from Rouen
Hiroshi Jofuku	1961 births, Living people, Footballers from Tokushima Prefecture
Jun Ando	1984 births, Living people, Footballers from Shiga Prefecture
Junya Hosokawa	1984 births, Living people, Footballers from Saitama Prefecture
Koki Otani	1989 births, Living people, Footballers from Kumamoto Prefecture
Carambola	Tropical fruit
Kota Ogi	1983 births, Living people, Footballers from Gifu Prefecture
Skardu District	Districts of Gilgit-Baltistan
Astore District	Districts of Gilgit-Baltistan
Katra Tehsil	Tehsils of Jammu and Kashmir
Nowshera Tehsil	Tehsils of Jammu and Kashmir
Super Mario	Mario video games
Hawthorne, California	Hawthorne, California
Choa Rajgan	Villages in Pakistan
Langston University	Colleges and universities in Oklahoma, Historically black colleges and universities, 1897 establishments in the United States, 1890s establishments in Oklahoma Territory
Marques Haynes	1926 births, 2015 deaths, Sportspeople from Oklahoma, African-American basketball players, American basketball players
Southwestern Athletic Conference	NCAA Division I athletics conferences, 1920 establishments in the United States
Major League Baseball Most Valuable Player Award	Major League Baseball awards, Baseball lists, Lists of sportspeople, Most valuable player awards
Silver medal	Awards, Olympic Games
Cáhuil	Settlements in the Region of O'Higgins
Liceo Agustín Ross Edwards	Pichilemu, Schools in Chile
Derivative (mathematics)	Mathematical analysis
Ruminant	Mammals
Renault Tracer	Buses, Renault automobiles
Mercedes-Benz Sprinter	Rear wheel drive vehicles, Buses, Vans, Mercedes-Benz automobiles
Naoya Otaki	1984 births, Living people, Footballers from Yamagata Prefecture
Kenichi Yagara	1981 births, Living people, Footballers from Osaka Prefecture, People from Osaka
Ryosuke Amo	1983 births, Living people, Footballers from Tokushima Prefecture
Yosuke Nozaki	1985 births, Living people, Footballers from Mie Prefecture
Josue Souza Santos	1987 births, Living people, Brazilian footballers
Joan Capdevila	1978 births, Living people, Spanish footballers
Shogo Sakurai	1984 births, Living people, Footballers from Kyoto
Mitsutada Ikeda	1984 births, Living people, Footballers from Saitama Prefecture
Kinoto Saito	1976 births, Living people, Footballers from Iwate Prefecture
Takafumi Kanazawa	1981 births, Living people, Footballers from Ibaraki Prefecture
Stelios Giannakopoulos	1974 births, Living people, Greek footballers
Daisuke Horiuchi	1985 births, Living people, Footballers from Yamagata Prefecture
Yuji Oe	1986 births, Living people, Footballers from Kyoto
Hayato Sasaki	1982 births, Living people, Footballers from Miyagi Prefecture
Kenjiro Ezoe	1982 births, Living people, Footballers from Okayama Prefecture
Bible version debate	Bible versions
1955 World Series	Major League Baseball World Series, 1955 in sports, Los Angeles Dodgers, New York Yankees, 1955 in the United States, 1950s in New York (state)
Second baseman	Baseball positions
Naoki Matsuda	1977 births, 2011 deaths, Footballers from Gunma Prefecture, Japan international footballers, J1 League players, Yokohama F. Marinos players, Matsumoto Yamaga FC players, 2002 FIFA World Cup players, 2001 FIFA Confederations Cup players, Footballers at the 1996 Summer Olympics, Footballers at the 2000 Summer Olympics, 2000 AFC Asian Cup players, AFC Asian Cup-winning players, Disease-related deaths in Japan, Deaths from heart failure
Splenomegaly	Diseases and disorders of the cardiovascular system
Nick Griffin	1959 births, Living people, Alumni of the University of Cambridge, Former MEPs, MEPs for the United Kingdom, Politicians from Hertfordshire, Politicians from Suffolk
Geoffrey Burbidge	1925 births, 2010 deaths, English astronomers, Astrophysicists, English physicists, English science writers, Alumni of University College London
Michael Scholz	1949 births, Living people, German composers, German musicians, Modern Talking
2008–09 Montreal Canadiens season	2008 in ice hockey, 2009 in ice hockey, National Hockey League team seasons, 2008 in Canada, 2009 in Canada
2007–08 Montreal Canadiens season	2007 in ice hockey, 2008 in ice hockey, National Hockey League team seasons, 2007 in Canada, 2008 in Canada
Radiation therapy	Cancer treatment
Dacarbazine	Cancer treatment
Ross Hotel	Pichilemu, Hotels
Liceo Santa Cruz	Schools in Chile
Chronic myeloid leukemia	Cancer, Blood disorders
Zoom (1972 TV series)	English-language television programs, Public Broadcasting Service, 1972 television series debuts, 1978 television series endings
Haboob	Winds, Severe weather
Food waste	Waste, Food and drink
Antonio Barragán	1987 births, Living people, Spanish footballers
Borja Oubiña	1982 births, Living people, Spanish footballers
Bojan Krkić	1990 births, Living people, Spanish footballers
Raúl Tamudo	1977 births, Living people, Spanish footballers
David Suazo	1979 births, Living people, Honduran footballers
Mauro Esposito	1979 births, Living people, Italian footballers
Genki Ota	1988 births, Living people, Footballers from Osaka Prefecture, People from Osaka
Kazuyuki Otsuka	1982 births, Living people, Footballers from Kumamoto Prefecture
Christian Poulsen	1980 births, Living people, Danish footballers
Adalto Batista da Silva	1978 births, Living people, Brazilian footballers
Maxsandro Barbosa de Oliveira	1972 births, Living people, Footballers from Rio de Janeiro
Srđan Baljak	1978 births, Living people, Serbian footballers, People from Belgrade
Tatsuro Noda	1986 births, Living people, Footballers from Hokkaidō Prefecture
Fran Mérida	1990 births, Living people, Spanish footballers, Sportspeople from Barcelona
Hugo Ibarra	1974 births, Living people, Argentine footballers
Takashi Soejima	1988 births, Living people, Footballers from Kumamoto Prefecture
Ismaël Bangoura	1985 births, Living people, Guinean people, African footballers
Masato Koga	1970 births, Living people, Footballers from Shizuoka Prefecture
Hidetoshi Wakui	1983 births, Living people, Footballers from Tochigi Prefecture
Ewerthon	1981 births, Living people, Brazilian footballers
Juan Arango	1980 births, Living people, Venezuelan sportspeople, South American footballers
Marcelo Vieira	1988 births, Living people, Association football defenders, Association football full-backs, Footballers from Rio de Janeiro
Artem Milevskiy	1985 births, Living people, Ukrainian footballers
Tugay Kerimoğlu	1970 births, Living people, Turkish footballers
Hiroaki Namba	1982 births, Living people, Footballers from Okayama Prefecture
Kohei Usui	1979 births, Living people, Footballers from Kanagawa Prefecture
Masaki Iida	1985 births, Living people, Footballers from Ibaraki Prefecture
Lakhdar Belloumi	1958 births, Living people, Algerian footballers, Algerian football managers
Shenandoah Valley Academy	Schools in Virginia, 1908 establishments in the United States, 20th-century establishments in Virginia
Computer Misuse Act 1990	Computers, Acts of the Parliament of the United Kingdom
Acrobatics	Fitness, Gymnastics
David Aardsma	1981 births, Living people, American baseball players, Sportspeople from Colorado, San Francisco Giants players, Chicago Cubs players, Chicago White Sox players, Boston Red Sox players, Seattle Mariners players, Sportspeople from Denver, Colorado
Parliament Hill	Buildings and structures in Ottawa
Pine Gap	Northern Territory
Colleges and universities in Kansas	Colleges and universities in Kansas, Lists of colleges and universities
House of Romanov	House of Romanov
João Moutinho	1986 births, Living people, Portuguese footballers
Takuya Shiihara	1980 births, Living people, Footballers from Kagoshima Prefecture
Tomoya Hirayama	1985 births, Living people, Footballers from Fukuoka Prefecture
Daniele Bonera	1981 births, Living people, Italian footballers, Sportspeople from Lombardy, People from Brescia
Ricardo Quaresma	1983 births, Living people, Portuguese footballers, Sportspeople from Lisbon
Daisuke Akashi	1982 births, Living people, Footballers from Saga Prefecture
Koichi Sekimoto	1978 births, Living people, Footballers from Osaka Prefecture, People from Osaka
Ryuki Kozawa	1988 births, Living people, Footballers from Aichi Prefecture
Paulino Alcántara	1896 births, 1964 deaths, Spanish footballers, Spanish football managers, Association football forwards
Masanori Tokita	1925 births, 2004 deaths, Footballers from Hyōgo Prefecture, Japan international footballers, Tanabe Mitsubishi Pharma SC players, Footballers at the 1956 Summer Olympics
Nuri Şahin	1988 births, Living people, Turkish footballers, Borussia Dortmund squad
Halil Altıntop	1982 births, Living people, People from Gelsenkirchen, Sportspeople from North Rhine-Westphalia, Turkish footballers
Hamit Altıntop	1982 births, Living people, People from Gelsenkirchen, Sportspeople from North Rhine-Westphalia, Turkish footballers
David Silva	1986 births, Living people, Spanish footballers, Manchester City F.C. players
Ángel Javier Arizmendi	1984 births, Living people, Spanish footballers, Sportspeople from Madrid
Khodadad Azizi	1971 births, Living people, Iranian footballers, Iranian football managers, 1998 FIFA World Cup players
Atsuga Shimizu	1972 births, Living people, Footballers from Yamanashi Prefecture
Yukio Tsuda	1917 births, 1979 deaths, Footballers from Hyōgo Prefecture, Japan international footballers, Urawa Red Diamonds players
Ko Arima	1917 births, Year of death missing, Japanese footballers, Japan international footballers
Nobuyuki Kato	1920 births, Year of death missing, Japanese footballers, Japan international footballers, Tanabe Mitsubishi Pharma SC players
Ken Noritake	1922 births, 1994 deaths, Japanese footballers, Japan international footballers
Hiroto Muraoka	1931 births, 2017 deaths, Footballers from Tokyo Prefecture, Japan international footballers
Osamu Yamaji	1929 births, Living people, Footballers from Hyōgo Prefecture, Japan international footballers, Kashima Antlers players
Nobuo Fujishima	1950 births, Living people, Footballers from Akita Prefecture, Japan international footballers, Japan Soccer League players, NKK SC players
Masaru Akiba	1984 births, Living people, Footballers from Yamagata Prefecture
Takashi Hirajima	1982 births, Living people, Footballers from Osaka Prefecture, People from Osaka
Tetsuya Ōkubo	1980 births, Living people, Footballers from Kanagawa Prefecture
Tomoya Kanamori	1982 births, Living people, Footballers from Mie Prefecture
Tomoyoshi Ono	1979 births, Living people, Footballers from Kanagawa Prefecture
Toshihiko Uchiyama	1978 births, Living people, Footballers from Kagoshima Prefecture
Yasuaki Oshima	1981 births, Living people, Footballers from Hyōgo Prefecture
Yoshizumi Ogawa	1984 births, Living people, Footballers from Tokyo Prefecture
Yuichi Shibakoya	1983 births, Living people, Footballers from Miyagi Prefecture
Yuji Rokutan	1987 births, Living people, Footballers from Kagoshima Prefecture, Avispa Fukuoka players
Coelenterata	Invertebrates
Ben & Jerry's	1978 establishments in the United States, American food companies, Burlington, Vermont, 20th-century establishments in Vermont
Choanoflagellate	Protista, Invertebrates, Minor phyla
Yoshitada Yamaguchi	1944 births, Living people, Footballers from Shizuoka Prefecture, Japan international footballers, Japan Soccer League players, Kashiwa Reysol players, Footballers at the 1964 Summer Olympics, Footballers at the 1968 Summer Olympics, Olympic medalists in football, Japanese Olympic bronze medalists, Medalists at the 1968 Summer Olympics
Kozo Arai	1950 births, Living people, Footballers from Hiroshima Prefecture, Japan international footballers, Japan Soccer League players, JEF United Chiba players
Mitsuo Kamata	1937 births, Living people, Footballers from Ibaraki Prefecture, Japan international footballers, Japan Soccer League players, JEF United Chiba players, Footballers at the 1964 Summer Olympics, Footballers at the 1968 Summer Olympics, Olympic medalists in football, Japanese Olympic bronze medalists, Medalists at the 1968 Summer Olympics
Nobuo Kawakami	1947 births, Living people, Footballers from Saitama Prefecture, Japan international footballers, Japan Soccer League players, Kashiwa Reysol players
Hiroshi Katayama	1940 births, Living people, Footballers from Tokyo Prefecture, Japan international footballers, Japan Soccer League players, Urawa Red Diamonds players, Footballers at the 1964 Summer Olympics, Footballers at the 1968 Summer Olympics, Olympic medalists in football, Japanese Olympic bronze medalists, Medalists at the 1968 Summer Olympics
Masafumi Yokoyama	1956 births, Living people, Footballers from Nagasaki Prefecture, Japan international footballers, Japan Soccer League players, Nippon Steel Yawata SC players
Michihiro Ozawa	1932 births, Living people, Footballers from Tochigi Prefecture, Japan international footballers, Japan Soccer League players, Sanfrecce Hiroshima players, Footballers at the 1956 Summer Olympics
Mitsuo Watanabe	1953 births, Living people, Footballers from Tochigi Prefecture, Japan international footballers, Japan Soccer League players, Shonan Bellmare players
Tetsuo Sugamata	1957 births, Living people, Footballers from Tochigi Prefecture, Japan international footballers, Japan Soccer League players, Kashiwa Reysol players
Yasuo Takamori	1934 births, Year of death missing, Footballers from Okayama Prefecture, Japan international footballers, Japan Soccer League players, NKK SC players, Footballers at the 1956 Summer Olympics
Placozoa	Minor phyla
Sipuncula	Minor phyla, Annelids
Ebbe Sand	1972 births, Living people, Danish footballers
Mattias Jonson	1974 births, Living people, Swedish footballers
So Far Gone	2009 albums, Drake albums
Danny Mills	1977 births, 2002 FIFA World Cup players, English footballers, Living people, Manchester City F.C. players, Sportspeople from Norfolk, Premier League players
2008–09 Chicago Blackhawks season	2008 in ice hockey, 2009 in ice hockey, National Hockey League team seasons, 2000s in Chicago, 2008 in Illinois, 2009 in Illinois
2007–08 Chicago Blackhawks season	2007 in ice hockey, 2008 in ice hockey, National Hockey League team seasons, 2000s in Chicago, 2007 in Illinois, 2008 in Illinois
Table (information)	Typography, Statistics, Graphics, Genres
Siphon (mollusc)	Molluscs
2008–09 New Jersey Devils season	2008 in ice hockey, 2009 in ice hockey, National Hockey League team seasons, 2000s in New Jersey, 2008 in the United States, 2009 in the United States
2007–08 New Jersey Devils season	2007 in ice hockey, 2008 in ice hockey, National Hockey League team seasons, 2007 in New Jersey, 2008 in the United States
2008–09 Washington Capitals season	2008 in ice hockey, 2009 in ice hockey, National Hockey League team seasons, 2000s in Washington, D.C.
2007–08 Washington Capitals season	2007 in ice hockey, 2008 in ice hockey, National Hockey League team seasons, 2000s in Washington, D.C.
2008–09 Tampa Bay Lightning season	2008 in ice hockey, 2009 in ice hockey, National Hockey League team seasons, 2008 in Florida, 2009 in Florida, 2000s in Tampa, Florida, Tampa Bay Lightning
2007–08 Tampa Bay Lightning season	2007 in ice hockey, 2008 in ice hockey, National Hockey League team seasons, 2007 in Florida, 2008 in Florida, 2000s in Tampa, Florida, Tampa Bay Lightning
Streaking	Nudity
Vanishing point	Art
Catherine Spence	1825 births, 1910 deaths, Australian novelists, British activists, British journalists, British novelists, Scottish writers, Australian activists, Australian journalists
2002 Commonwealth Games	Commonwealth Games, 2002 in Europe, 2000s in Manchester
Desso GrassMaster	Sports
Table (furniture)	Basic English 850 words, Furniture
Saitama Prefecture	Saitama Prefecture, Prefectures of Japan
Manatee Palms Youth Services	Hospitals in the United States, Buildings and structures in Florida, 2007 disestablishments in the United States, 2000s disestablishments in Florida, 2007 establishments in the United States, 2000s establishments in Florida, 2010 disestablishments in the United States, 2010s disestablishments in Florida
Tatsuhiko Seta	1952 births, Living people, Footballers from Iwate Prefecture, Japan international footballers, Japan Soccer League players, Kashiwa Reysol players
Tadahiko Ueda	1947 births, 2015 deaths, Footballers from Kyoto Prefecture, Japan international footballers, Japan Soccer League players, Nippon Steel Yawata SC players
Toshio Matsuura	1955 births, Living people, Footballers from Kanagawa Prefecture, Japan international footballers, Japan Soccer League players, NKK SC players
Yasuyuki Kuwahara	1942 births, 2017 deaths, Footballers from Hiroshima Prefecture, Japan international footballers, Japan Soccer League players, Sanfrecce Hiroshima players, Footballers at the 1968 Summer Olympics, Olympic medalists in football, Japanese Olympic bronze medalists, Medalists at the 1968 Summer Olympics
Lisandro López	1983 births, Living people, Argentine footballers, Sportspeople from Buenos Aires
Carlos Jorge Neto Martins	1982 births, Living people, Portuguese footballers
Gonzalo Higuaín	1987 births, Living people, Argentine footballers, People from Brest, France
Raul Meireles	1983 births, Living people, Portuguese footballers, People from Porto
Fabio Cudicini	1935 births, Living people, Italian association football goalkeepers, People from Trieste
Cristian Hidalgo	1983 births, Living people, Spanish footballers, Sportspeople from Barcelona
Joan Verdú	1983 births, Living people, Spanish footballers, Sportspeople from Barcelona
Guillermo Franco	1976 births, Living people, Mexican footballers
Thomas Vermaelen	1985 births, Living people, Belgian footballers
Mauro Rosales	1981 births, Living people, Argentine footballers
Steven Pienaar	1982 births, Living people, South African footballers, People from Johannesburg
Japanese food	Japanese food
Pointe du Hoc	World War II, Normandy
Welsh Premier League	Football leagues in the United Kingdom, Football in Wales, English Football League, 1992 establishments in the United Kingdom, 1990s establishments in Wales
The New Saints F.C.	Welsh football clubs, 1959 establishments in the United Kingdom, 20th century establishments in Wales
French toast	Breakfast foods, Breads, Egg dishes
John Smith (explorer)	1580 births, 1631 deaths, British military people, English explorers, Governors of Virginia, Writers from Lincolnshire
Entoprocta	Minor phyla
5000 metres	Running
Sportcity (sports ground)	Sports buildings in the United Kingdom, Manchester
Oakwell	Football stadiums in England, 1888 establishments in England
Cortisol	Steroid hormones
Ryszard Kaczorowski	1919 births, 2010 deaths, Aviation deaths, Knights Grand Cross of the Order of St Michael and St George, Presidents of Poland
Periodic function	Mathematics
List of series	Mathematics lists
Manchester City Council	Manchester
Lord Don't Slow Me Down	Oasis (band), 2007 movies, Documentary movies
Kea	Birds of New Zealand, Parrots
Billabong (lake)	Bodies of water of Australia
Antonio Di Natale	1977 births, Living people, Italian footballers
Yuya Chiba	1986 births, Living people, Footballers from Iwate Prefecture
Ryo Okawara	1987 births, Living people, Footballers from Gunma Prefecture
Matteo Paro	1983 births, Living people, Italian footballers
Atsushi Yamaguchi	1980 births, Living people, Footballers from Kanagawa Prefecture
Noriaki Tsutsui	1976 births, Living people, Footballers from Kanagawa Prefecture
Ryunosuke Okamoto	1984 births, Living people, Footballers from Okayama Prefecture
Atsushi Matsuura	1981 births, Living people, Footballers from Aichi Prefecture
Takuto Koyama	1982 births, Living people, Footballers from Hyōgo Prefecture
Pablo Zabaleta	1985 births, Living people, Argentine footballers, Manchester City F.C. players, Sportspeople from Buenos Aires
Daniel Bilos	1980 births, Living people, Argentine footballers
Yohei Taniike	1977 births, Living people, Footballers from Hyōgo Prefecture
Mohamed Abdelwahab	1983 births, 2006 deaths, Egyptian footballers
Jérémy Toulalan	1983 births, Living people, French footballers, People from Nantes
Chris Eagles	1985 births, Living people, English footballers, Sportspeople from Hertfordshire, Premier League players
Velvet	Cloth
Carlos Tenorio	1979 births, Living people, Ecuadorian footballers
Niko Kovač	1971 births, Living people, Croatian footballers, Croatian football managers
Eric Djemba-Djemba	1981 births, Living people, Cameroonian footballers
Nemertea	Minor phyla
WebKit	Web browsers, Free software
Choi Jin-sil	1968 births, 2008 deaths, South Korean movie actors, South Korean television actors, People who committed suicide
Cristal Racecourse	Horse racing, Porto Alegre
Speed reading	Literature
Abu Dhabi United Group	Companies of Asia, United Arab Emirates
Maine Road	1923 establishments in England, 2003 disestablishments in England, Football stadiums in England, Sport in Manchester
List of English football stadiums by capacity	Football stadiums in England, Lists about England, Sports lists
John D. Rockefeller	American billionaires, Businesspeople from New York, Rockefeller family, Cardiovascular disease deaths in Florida, 1839 births, 1937 deaths, Deaths from arteriosclerosis
2008 UEFA Cup Final	2008 in association football, 2008 in England, Sport in Manchester, UEFA, 2000s in Manchester
UEFA stadium categories	UEFA, Football stadiums in Europe
Biricodar	Drugs, Cancer treatment
The Futureheads	English punk bands
Dicynodont	Therapsids
Lassana Diarra	1985 births, Living people, French footballers, Sportspeople from Paris
Jiří Jarošík	1977 births, Living people, Czech footballers
Besian Idrizaj	Austrian footballers, 1987 births, 2010 deaths, Crystal Palace F.C. players
Kim Wi-Man	1979 births, Living people, North Korean footballers
Ryota Arimitsu	1981 births, Living people, Footballers from Fukuoka Prefecture
Zak Whitbread	1984 births, Living people, American footballers, Sportspeople from Houston, Texas
Giuseppe Favalli	1972 births, Living people, Italian footballers
Paul McShane	1986 births, Living people, Irish footballers, People from County Wicklow
Rio Mavuba	1984 births, Living people, French footballers
Didier Agathe	1975 births, Living people, French footballers, French football managers, People from Réunion
Yuki Hamano	1978 births, Living people, Footballers from Kagoshima Prefecture
Oscar Ruggeri	1962 births, Living people, Argentine footballers, Argentine football managers
South Park Mexican	1971 births, Living people, American Christians, American prisoners, American rap musicians from Texas, American sex offenders, Child sexual abusers, Criminals from Texas, Drug dealers, Singers from Houston, Texas
2004 Rugby League Tri-Nations	Rugby
Delray, Detroit	Cities in Michigan
Gneiss	Metamorphic rocks
Hiroki Kishida	1981 births, Living people, Footballers from Hyōgo Prefecture
Yoshiyuki Shinoda	1971 births, Living people, Footballers from Yamanashi Prefecture
David Sommeil	1974 births, Living people, French footballers, Guadeloupe
Yakubu Aiyegbeni	1982 births, Living people, Nigerian footballers
Colin Bell	1946 births, 2021 deaths, People with cancer, English footballers, Sportspeople from County Durham
Malir District	Districts of Sindh, Karachi
Carl Levin	Politicians from Detroit, Michigan, US Democratic Party politicians, United States senators from Michigan, 1934 births, 2021 deaths, Deaths from lung cancer, 20th-century American politicians, 21st-century American politicians
Lights Out	Rick Astley songs, 2010 songs
John Engler	Living people, Governors of Michigan, 1948 births
Mount Pleasant, Michigan	Cities in Michigan
Román Fresnedo Siri	Architects, 1975 deaths, 1903 births, Uruguayan people
Photomask	Technology, Electronic components
Gastrotrich	Minor phyla
Liam Ridgewell	1984 births, Living people, English footballers, Actors from London, Premier League players
Fábio Rochemback	1981 births, Living people, Brazilian footballers
Yasuomi Kugisaki	1982 births, Living people, Footballers from Miyazaki Prefecture
Shingo Honda	1987 births, Living people, Footballers from Kumamoto Prefecture
Kengo Takushima	1987 births, Living people, Footballers from Fukuoka Prefecture, Avispa Fukuoka players
Tadaomi Yasuda	1987 births, Living people, Footballers from Fukuoka Prefecture, Avispa Fukuoka players
Mitsunori Izutani	1983 births, Living people, Footballers from Osaka Prefecture, People from Osaka
Shingo Hoshino	1978 births, Living people, Footballers from Fukuoka Prefecture
Koichi Kawai	1979 births, Living people, Footballers from Ehime Prefecture
Kazuhisa Hamaoka	1981 births, Living people, Footballers from Nagasaki Prefecture
Kenta Kawai	1981 births, Living people, Footballers from Ehime Prefecture, Japanese football managers
François Clerc	1983 births, Living people, French footballers
Shigeru Sakurai	1979 births, Living people, Footballers from Ibaraki Prefecture
Masayuki Ota	1973 births, Living people, Footballers from Tokyo Prefecture
Ralf Edström	1952 births, Living people, Swedish footballers
Yuta Suzuki	1987 births, Living people, Footballers from Kanagawa Prefecture
Hand axe	Anthropology, Cutting tools, Stone Age
Key 103	Radio stations in the United Kingdom, 1988 establishments in England
Brian McBride	1972 births, Living people, American footballers, People from Arlington Heights, Illinois, Sportspeople from Illinois
Ognjen Koroman	1978 births, Living people, Serbian footballers
2002–03 UEFA Cup	UEFA, 2002 in association football, 2002 in Europe, 2003 in association football, 2003 in Europe
Yaya Touré	1983 births, Living people, Ivorian footballers, Manchester City F.C. players
Roger Lemerre	1941 births, Living people, French footballers, French football managers
Rochdale	Rochdale
C2 Green Tea	Tea, Filipino culture, Asian foods
Ashton-under-Lyne	Towns in Greater Manchester
Universal Robina	Companies of the Philippines, Food companies
Tameside	Towns in Greater Manchester
Sun Cellular	Mobile phone companies, Companies of the Philippines, Quezon City
Joey Scarbury	1955 births, Living people, Singers from Los Angeles, California
Kenny Rankin	1940 births, 2009 deaths, American jazz musicians, Singer-songwriters from New York, Deaths from lung cancer, Singers from New York City
Sarah Geronimo	1988 births, Living people, Filipino movie actors, Filipino actors, Filipino singers, People from Manila
Bolton	Towns in Greater Manchester
Jonathan Edwards (athlete)	1966 births, Living people, BBC television presenters, British male athletes, British Olympic gold medalists, British Olympic silver medalists, Triple jumpers, Commanders of the Order of the British Empire, Commonwealth Games medallists, English atheists, English television presenters, Former Christians, Sportspeople from London, Television personalities from London, World record holders
Explosion protection	Explosives, Buildings and structures, Terrorism
2007–08 UEFA Cup	UEFA, 2007 in association football, 2008 in association football, 2007 in Europe, 2008 in Europe
Žydrūnas Ilgauskas	1975 births, Living people, Lithuanian basketball players, Cleveland Cavaliers players, Miami Heat players, People from Kaunas
David L. Paterson	1966 births, Living people, American screenwriters, writers from Washington, D.C.
Horst Köppel	1948 births, Living people, German footballers, Sportspeople from Stuttgart
Henrique Hilário	1975 births, Living people, Portuguese footballers, Association football goalkeepers, People from Porto
Gavin McCann	1978 births, Living people, English footballers, People from Lancashire, Premier League players
Evander Sno	1987 births, Living people, Dutch footballers, People from Dordrecht, Sportspeople from South Holland
Andreas Ivanschitz	1983 births, Living people, Austrian footballers, Players of the Austrian national football team, FC Red Bull Salzburg players, UEFA Euro 2008 players
Andrew Johnson (footballer)	1981 births, Living people, English footballers, People from Bedford, Sportspeople from Bedfordshire, Crystal Palace F.C. players
Alessandro Pistone	1975 births, Living people, Italian footballers
Dedê	1978 births, Living people, Brazilian footballers, People from Belo Horizonte
Élber Giovane	1972 births, Living people, Brazilian footballers
Tsukasa Hosaka	1937 births, 2018 deaths, Footballers from Yamanashi Prefecture, Japan international footballers, Japan Soccer League players, JEF United Chiba players, Footballers at the 1964 Summer Olympics, Deaths from pneumonia
Chung Yong-dae	1978 births, Living people, South Korean footballers
Kerlon	1988 births, Living people, Brazilian footballers
Reto Ziegler	1986 births, Living people, Swiss footballers, People from Geneva
Yukinori Shigeta	1976 births, Living people, Footballers from Kanagawa Prefecture
Josh Hutcherson	1992 births, Living people, Actors from Kentucky, American child actors, American movie actors, American television actors, American voice actors
Walden Media	Companies based in Los Angeles, Publishing companies of the United States, Movie studios
Buxaceae	Plant families
The Washington Post	Newspapers in the United States, 1877 establishments in the United States, Washington, D.C.
Chicago Sun-Times	Newspapers in Chicago, Illinois, 1948 establishments in the United States
B of the Bang	Sculptures, Manchester, 2005 establishments in England, 2009 disestablishments in England
Ron Brand	Montreal Expos players, Houston Astros players, Pittsburgh Pirates players
Ewing's sarcoma	Cancer, Diseases and disorders of bones
Bone tumor	Cancer, Diseases and disorders of bones
Sticky keys	Computing
Unincorporated area	Local government, Local government in the United States
Chapters and verses of the Bible	Bible
Glioma	Brain tumors
Subset sum problem	Computer science
Istanbul Technical University	Colleges and universities in Turkey, 1773 establishments, Establishments in Turkey, 1770s establishments in Asia, 1770s establishments in Europe, Istanbul
Saxifragaceae	Saxifragales
Lolol	Cities in Chile, Settlements in the Region of O'Higgins
Yun Chi-ho	1865 births, 1945 deaths, Korean educators, South Korean politicians, Anti-Communists, Korean politicians, Murder victims, Autobiographers, Korean activists
Squat	Fitness
John Lubbock, 1st Baron Avebury	1834 births, 1913 deaths, English biologists, English politicians, English Barons, Baronets, English archaeologists, Privy Councillors (UK)
Georges Seurat	1859 births, 1891 deaths, French painters
Eugène Boudin	1824 births, 1898 deaths, French painters
Boolean satisfiability problem	Theoretical computer science, Boolean algebra
Denny Lemaster	1939 births, Atlanta Braves players, Baseball players from California, Houston Astros players, Living people, Milwaukee Braves players, Montreal Expos players, People from Riverside County, California
NP-complete	Theoretical computer science
Cook–Levin theorem	Theoretical computer science
Bill France, Sr.	American racecar drivers, NASCAR, Sportspeople from Washington, D.C., 1909 births, 1992 deaths
Denis Menke	1940 births, 2020 deaths, Milwaukee Braves players, National League All-Stars, Houston Astros players, Cincinnati Reds players, Sportspeople from Iowa
Huaso	Chilean culture
Purchase	Trade
Stargate (movie)	1994 movies, 1990s science fiction movies, Stargate, Movies set in Egypt, Movies set in Colorado, Movies set on fictional planets, Movies directed by Roland Emmerich
Super Junior	South Korean boy bands, K-pop music groups, Hip hop bands, R&B bands, 2005 establishments in Asia, 2000s establishments in South Korea
Pandanaceae	Malpighiales
Gilmar Silva Santos	1984 births, Living people, Brazilian footballers
José Luís Santos da Visitação	1979 births, Living people, Brazilian footballers, People from Salvador, Bahia
Juan Pedro Benali	1969 births, Living people, Spanish football managers
Manuel dos Santos Fernandes	1974 births, Living people, French footballers
Alberto Aquilani	1984 births, Living people, Italian footballers, Sportspeople from Rome
Flavio Roma	1974 births, Living people, Italian footballers, Sportspeople from Rome
Bernard Allou	1975 births, Living people, French footballers
Éric Carrière	1973 births, Living people, French footballers
Eliézio Santos Santana	1987 births, Living people, Brazilian footballers, People from Salvador, Bahia
Ben Thatcher	1975 births, Living people, Welsh footballers
Gnathostomulida	Minor phyla
Alexandre Lopes	1974 births, Living people, Footballers from Rio de Janeiro
Leandro Montera da Silva	1985 births, Living people, Brazilian footballers
Junya Nitta	1978 births, Living people, Footballers from Shizuoka Prefecture
Yosuke Kobayashi	1983 births, Living people, Footballers from Tokyo Prefecture
Anoxia	Biology
Epidermis	Integumentary system
Eddie Pope	1973 births, Living people, American footballers, Sportspeople from North Carolina, People from Greensboro, North Carolina
Double check	Chess
Sindh Institute of Urology and Transplantation	Hospitals, Buildings and structures in Karachi
Tuck Everlasting (2002 movie)	2002 movies, Disney movies, Movies based on books, English-language movies
2010 Pacific hurricane season	2010 in weather, Pacific hurricane seasons, 2010 in North America
William Jennings Bryan	1860 births, 1925 deaths, American lawyers, American Presbyterians, Burials at Arlington National Cemetery, Creationists, United States representatives from Nebraska, United States Secretaries of State, US Democratic Party politicians
Regeneration	Developmental biology
Lowell, Massachusetts	Cities in Massachusetts, County seats in Massachusetts
Haifa	Haifa, Ports and harbours of Israel
National University of San Marcos	Colleges and universities in South America, 1551 establishments, Lima, 16th-century establishments in the Viceroyalty of Peru, 1550s establishments in South America
Princes Street	Edinburgh, Roads in the United Kingdom
Social anxiety disorder	Anxiety disorders, Phobias
ASP.NET	Programming languages, Microsoft Visual Studio
Digital Economy Act 2010	Acts of the Parliament of the United Kingdom, Software, 2010 in the United Kingdom
Android (operating system)	Android (operating system)
Carlos Boozer	1981 births, Living people, African-American basketball players, Chicago Bulls players, Cleveland Cavaliers players, Los Angeles Lakers players, Utah Jazz players, Sportspeople from Alaska, 2008 Summer Olympics, American basketball players
Mark Schwarzer	1972 births, Living people, Australian footballers, Sportspeople from Sydney
Rocky Colavito	1933 births, Living people, American baseball players, Cleveland Indians players, Sportspeople from New York City
Escitalopram	Drugs used in psychiatry
Leeds Cathedral	Leeds, Roman Catholic Cathedrals, Grade II* listed buildings
Leeds Town Hall	Leeds, Concert halls in England, Administrative buildings, 1858 establishments in the United Kingdom, 1850s establishments in England
LittleBigPlanet	2008 video games, LittleBigPlanet, PlayStation 3 games, Sony Interactive Entertainment games
Nexus One	Nexus mobile phones, Android smartphones, Mobile phones released in 2010
Nellie McKay	American pop musicians, American jazz musicians, Singers from New York City, American movie actors, American stage actors, Actors from New York City, Comedians from New York City, 1982 births, Living people
Mo Williams	1982 births, American basketball players, Living people, Cleveland Cavaliers players, Los Angeles Clippers players, Milwaukee Bucks players, Utah Jazz players, Sportspeople from Mississippi
Hummus	Middle Eastern foods
Sean Combs	African American actors, African American musicians, American movie actors, American television actors, Actors from New York City, Grammy Award winners, Singers from New York City, American rap musicians from New York, 1969 births, Living people
Context (computing)	Computer science
Ryohei Suzuki (footballer, born 1983)	1983 births, Living people, Footballers from Fukui Prefecture
Shogo Sakai	1988 births, Living people, Footballers from Mie Prefecture
Kenta Kifuji	1981 births, Living people, Footballers from Nagasaki Prefecture
Douglas Pires de Souza	1987 births, Living people, Brazilian footballers
Osama Elsamni	1988 births, Living people, Footballers from Okinawa Prefecture, YSCC Yokohama players
Nedum Onuoha	1986 births, Living people, English footballers, Manchester City F.C. players, Nigerian footballers, Sportspeople from Manchester, Premier League players
Jean Makoun	1983 births, Living people, Cameroonian footballers
Zé Castro	1983 births, Living people, Portuguese footballers
Iván Cuéllar	1984 births, Living people, Spanish association football goalkeepers
Ismael Falcón	1984 births, Living people, Spanish association football goalkeepers, People from Cádiz
Junya Kimura	1987 births, Living people, Footballers from Ibaraki Prefecture
Marcos Aurélio Galeano	1972 births, Living people, Brazilian footballers
Axel Cédric Konan	1983 births, Living people, Ivorian footballers
Hideo Yoshizawa	1972 births, Living people, Footballers from Gunma Prefecture
Sho Gokyu	1983 births, Living people, Footballers from Mie Prefecture
Oswaldo López Arellano	1921 births, 2010 deaths, North American politicians, Presidents of Honduras
Bosnian language	Slavic languages, Bosnia and Herzegovina, Languages of Europe
Kotka	Towns in Finland, Municipalities of Kymenlaakso, 1879 establishments in Europe, 1870s establishments in Finland
Volkswagen Touareg	Volkswagen automobiles, 2000s automobiles, 2010s automobiles, Sport utility vehicles
Volkswagen Golf Cabriolet	Volkswagen Golf, 1970s automobiles, 1980s automobiles, 1990s automobiles, 2000s automobiles
Google I/O	Internet
Ecchi	Anime, Anime and manga terms
National Polytechnic Institute	Colleges and universities in Mexico, 1936 establishments in North America, Mexico City, 1930s establishments in Mexico
Oxalidaceae	Oxalidales
Ganglion	Anatomy of the nervous system
Obsessive-compulsive personality disorder	Personality disorders
Craig Moore	1975 births, Living people, Australian footballers, Sportspeople from Sydney, Crystal Palace F.C. players
Tsuyoshi Kawaguchi	1978 births, Living people, Footballers from Shizuoka Prefecture
Masayuki Ishii	1978 births, Living people, Footballers from Kanagawa Prefecture
Ryosuke Horikiri	1983 births, Living people, Footballers from Chiba Prefecture
Mitsuru Mukojima	1976 births, Living people, Footballers from Shizuoka Prefecture
Masahiko Kumagai	1975 births, Living people, Footballers from Kanagawa Prefecture
Taiki Maekawa	Footballers from Shizuoka Prefecture, 1979 births, Living people
Shuhei Hanabuchi	1978 births, Living people, Footballers from Miyagi Prefecture
Hirokazu Otsubo	1979 births, Living people, Footballers from Fukuoka Prefecture
Takeshi Ushibana	1977 births, Living people, Footballers from Kagoshima Prefecture
Datsakorn Thonglao	1983 births, Living people, Thai footballers
Juande Ramos	1954 births, Living people, Spanish footballers, Spanish football managers
Tatsuhiro Nishimoto	1980 births, Living people, Footballers from Yamaguchi Prefecture
Marc Crosas	1988 births, Living people, Spanish footballers
Jeffrén Suárez	1988 births, Living people, Spanish footballers
Takuya Tomiyama	1980 births, Living people, Footballers from Kanagawa Prefecture
Shōgo Shimada	1979 births, Living people, Footballers from Hyōgo Prefecture
Raimundo Orsi	1901 births, 1986 deaths, Argentine footballers, Italian footballers
Hao Haidong	1970 births, Living people, Chinese footballers
Emanuel Pogatetz	1983 births, Living people, Austrian footballers, Players of the Austrian national football team, People from Graz
Carlos Bocanegra	1979 births, Living people, American footballers
Park Chu-young	1985 births, Living people, South Korean footballers
Mario Regueiro	1978 births, Living people, Uruguayan footballers, Sportspeople from Montevideo
Daniel Andersson	1977 births, Living people, Swedish footballers
Niclas Jensen	1974 births, Living people, Danish footballers
Red Dead Redemption	2010 video games, PlayStation 3 games, Xbox 360 games
Hypertrophy	Health, Fitness
Spiritual successor	Writing
William Gibson	1948 births, Living people, American science fiction writers, Writers from South Carolina, Nebula Award winning writers, Hugo Award winning writers
Dadyal	Tehsils of Azad Kashmir
Thymelaeaceae	Malvales
Samahni	Tehsils of Azad Kashmir
Dhirkot	Tehsils of Azad Kashmir
Palandri Tehsil	Tehsils of Azad Kashmir
2010 Formula One World Championship	Formula One seasons, 2010 in sports
Heart urchin	Echinoderms
Nobumitsu Yamane	1979 births, Living people, Footballers from Chiba Prefecture
Shohei Kamada	1980 births, Living people, Footballers from Hyōgo Prefecture
Takayuki Odajima	1977 births, Living people, Footballers from Kanagawa Prefecture
Tomoyuki Kajino	1960 births, Living people, Footballers from Aichi Prefecture, Japan international footballers, J1 League players, Japan Soccer League players, Cerezo Osaka players, Gamba Osaka players, Kashiwa Reysol players
Lee Cattermole	1988 births, Living people, English footballers, Sportspeople from County Durham, Premier League players
Takeshi Takama	1956 births, Living people, Footballers from Kyoto
Toshiaki Hotta	1975 births, Living people, Footballers from Tochigi Prefecture
Kim Yong-Jun	1983 births, Living people, North Korean footballers
Francesco Tavano	1979 births, Living people, Italian footballers
Kodai Suzuki	1981 births, Living people, Footballers from Tokyo Prefecture
Shinji Honda	1978 births, Living people, Footballers from Aomori Prefecture
Kohei Masumoto	1982 births, Living people, Footballers from Kanagawa Prefecture
Yoshihide Ogushi	1975 births, Living people, Footballers from Miyazaki Prefecture
Shoma Mizunaga	1985 births, Living people, Footballers from Miyazaki Prefecture
Masahiro Hamazaki	1940 births, 2011 deaths, Footballers from Osaka Prefecture, Japan international footballers, Japan Soccer League players, Nippon Steel Yawata SC players, Footballers at the 1968 Summer Olympics, Olympic medalists in football, Japanese Olympic bronze medalists, Medalists at the 1968 Summer Olympics
Ryozo Suzuki	1939 births, Living people, Footballers from Saitama Prefecture, Japan international footballers, Japan Soccer League players, Kashiwa Reysol players, Footballers at the 1964 Summer Olympics, Footballers at the 1968 Summer Olympics, Olympic medalists in football, Japanese Olympic bronze medalists, Medalists at the 1968 Summer Olympics
Kiyoshi Tomizawa	1943 births, Living people, Footballers from Shizuoka Prefecture, Japan international footballers, Japan Soccer League players, Nippon Steel Yawata SC players, Footballers at the 1964 Summer Olympics, Footballers at the 1968 Summer Olympics, Olympic medalists in football, Japanese Olympic bronze medalists, Medalists at the 1968 Summer Olympics
Eizo Yuguchi	1945 births, 2003 deaths, Footballers from Osaka Prefecture, Japan international footballers, Japan Soccer League players, Cerezo Osaka players, Footballers at the 1968 Summer Olympics, Olympic medalists in football, Japanese Olympic bronze medalists, Medalists at the 1968 Summer Olympics
Hisao Kami	1941 births, Living people, Footballers from Hiroshima Prefecture, Japan international footballers, Japan Soccer League players, Nippon Steel Yawata SC players, Footballers at the 1964 Summer Olympics
Shozo Tsugitani	1940 births, 1978 deaths, Footballers from Hyōgo Prefecture, Japan international footballers, Japan Soccer League players, Urawa Red Diamonds players, Footballers at the 1964 Summer Olympics
Yoshio Furukawa	1934 births, Living people, Footballers from Osaka Prefecture, Japan international footballers, Footballers at the 1956 Summer Olympics
Takashi Takabayashi	1931 births, 2009 deaths, Footballers from Saitama Prefecture, Japan international footballers, Tanabe Mitsubishi Pharma SC players, Footballers at the 1956 Summer Olympics
Waichiro Omura	1933 births, Year of death missing, Footballers from Shizuoka Prefecture, Japan international footballers, Tanabe Mitsubishi Pharma SC players, Footballers at the 1956 Summer Olympics
Tadao Kobayashi	1930 births, Living people, Footballers from Kanagawa Prefecture, Japan international footballers, Footballers at the 1956 Summer Olympics
Akira Kitaguchi	1935 births, Living people, Footballers from Osaka Prefecture, Japan international footballers, Japan Soccer League players, Urawa Red Diamonds players, Footballers at the 1956 Summer Olympics
Sault Ste. Marie, Ontario	Cities in Ontario
Easter Island	World Heritage Sites in South America, Islands of Chile, Easter Island, Provinces of Chile
Appin, New South Wales	Towns in New South Wales
Rihei Sano	1912 births, 1992 deaths, Footballers from Shizuoka Prefecture, Japan international footballers, Footballers at the 1936 Summer Olympics
Sei Fuwa	Year of birth missing, Year of death missing, Footballers from Tokyo Prefecture, Footballers at the 1936 Summer Olympics
Teizo Takeuchi	1908 births, 1946 deaths, Footballers from Tokyo Prefecture, Japan international footballers, Footballers at the 1936 Summer Olympics
Constable	Law enforcement occupations
Ever Palacios	1969 births, Living people, Colombian footballers
Monaro (New South Wales)	Regions of New South Wales
Kei Omoto	1984 births, Living people, Footballers from Chiba Prefecture
Kazuma Kita	1981 births, Living people, Footballers from Ishikawa Prefecture
Tomonobu Hiroi	1985 births, Living people, Footballers from Tokyo Prefecture
Peter Løvenkrands	1980 births, Living people, Danish footballers
Hiroki Iikura	1986 births, Living people, Footballers from Aomori Prefecture
Halifax (bank)	Banks of the United Kingdom, 1853 establishments, 1850s establishments in the United Kingdom
Peavy Wagner	1964 births, Living people, Bassists
Leeds Kirkgate Market	Leeds, Retail markets, Buildings and structures in England, 1822 establishments, 1820s establishments in England
Kosei Shibasaki	1984 births, Living people, Footballers from Nagasaki Prefecture
Landlord	Occupations
Debbie Stabenow	1950 births, Living people, United States senators from Michigan, United States representatives from Michigan, US Democratic Party politicians, 20th-century American politicians, 21st-century American politicians
Grand Valley State University	Colleges and universities in Michigan, 1960 establishments in the United States, 1960s establishments in Michigan
Neith	Egyptian gods and goddesses
Force India	Formula One constructors, Formula One current
Yasuo Suzuki	1913 births, Year of death missing, Footballers from Kanagawa Prefecture, Japan international footballers, Footballers at the 1936 Summer Olympics
Motoo Tatsuhara	1913 births, Year of death missing, Footballers from Tokyo Prefecture, Japan international footballers, Footballers at the 1936 Summer Olympics
Shoichi Nishimura	1912 births, 1998 deaths, Footballers from Hyōgo Prefecture, Japan international footballers, Footballers at the 1936 Summer Olympics
Tokutaro Ukon	1913 births, 1944 deaths, Footballers from Hyōgo Prefecture, Japan international footballers, Footballers at the 1936 Summer Olympics
Akira Matsunaga (footballer, born 1914)	1914 births, 1943 deaths, Footballers from Shizuoka Prefecture, Japan international footballers, Footballers at the 1936 Summer Olympics
Takeshi Kamo	1915 births, 2004 deaths, Footballers from Shizuoka Prefecture, Japan international footballers, Footballers at the 1936 Summer Olympics
Toyoji Takahashi	1915 births, 1940 deaths, Footballers from Tokyo Prefecture, Footballers at the 1936 Summer Olympics
Shogo Kamo	1915 births, 1977 deaths, Footballers from Shizuoka Prefecture, Japan international footballers, Footballers at the 1936 Summer Olympics
Narita Takaki	1977 births, Living people, Footballers from Nagasaki Prefecture
Yoshiki Nakai	1983 births, Living people, Footballers from Osaka Prefecture, People from Osaka
Jaime Gavilán	1985 births, Living people, Spanish footballers, People from Valencia
Dario Dainelli	1979 births, Living people, Italian footballers
José Manuel Jurado	1986 births, Living people, Spanish footballers
Ali Al-Habsi	1981 births, Living people, Omani people, Association football goalkeepers
Air India Express Flight 812	2010 aviation disasters, 2010 in India, 2010s disasters in Asia, Disasters in India, Karnataka, May events, Transport in India
Otto Hahn	1879 births, 1968 deaths, German academics, German chemists, German Nobel Prize winners, People from Frankfurt
Air India	1932 establishments in India, Star Alliance, Airlines of Asia, Companies of India, Transport in India, National symbols of India, IATA members
Gonzalo Sorondo	1979 births, Living people, Uruguayan footballers, Sportspeople from Montevideo, Crystal Palace F.C. players
Powerwolf	German heavy metal bands, Musical groups established in 2003, 2000s German music groups, 2010s German music groups, Power metal
Matt Holland	1974 births, Living people, English footballers, Irish footballers, People from Bury, Sportspeople from Greater Manchester, Premier League players
Captain (association football)	Association football
Maarten Stekelenburg	1982 births, Living people, 2006 FIFA World Cup players, 2010 FIFA World Cup players, Dutch footballers, Association football goalkeepers, People from Haarlem, Sportspeople from North Holland
Rik van den Boog	1959 births, Living people, Dutch football managers, Sportspeople from Amsterdam
Taira Inoue	1983 births, Living people, Footballers from Tokyo Prefecture
Kensuke Fukuda	1984 births, Living people, Footballers from Shizuoka Prefecture
Kenzo Taniguchi	1988 births, Living people, Footballers from Kagoshima Prefecture
Kenichi Kaga	1983 births, Living people, Footballers from Akita Prefecture
Yasuhiro Nomoto	1983 births, Living people, Footballers from Niigata Prefecture
Yuki Okada	1983 births, Living people, Footballers from Shizuoka Prefecture
Machida Station	Railway stations in Tokyo
Demigod	Gods and goddesses
Maicon Douglas Sisenando	1981 births, Living people, Brazilian footballers, Manchester City F.C. players
Masaharu Nishi	1977 births, Living people, Footballers from Fukuoka Prefecture
Michiyasu Osada	1978 births, Living people, Footballers from Saitama Prefecture
Toru Sano	1963 births, Living people, Footballers from Shizuoka Prefecture, Japan international footballers, Japanese football managers, J1 League players, Japan Soccer League players, Yokohama F. Marinos players
Atsushi Natori	1961 births, Living people, Footballers from Saitama Prefecture, Japan international footballers, J1 League players, Japan Soccer League players, Urawa Red Diamonds players
Masaaki Mori	1961 births, Living people, Footballers from Nagasaki Prefecture, Japan international footballers, Japan Soccer League players, Shonan Bellmare players
Alexandre Pato	1989 births, Living people, Brazilian footballers
Shunta Takahashi	1989 births, Living people, Footballers from Toyama Prefecture
Kazuyuki Kyoya	1971 births, Living people, Footballers from Hokkaidō Prefecture
Roman Weidenfeller	1980 births, Living people, German association football goalkeepers, Sportspeople from Rhineland-Palatinate
Max Tonetto	1974 births, Living people, Italian footballers, People from Trieste
Jean-Marc Bosman	1964 births, Living people, Belgian footballers
Rodrigo Taddei	1980 births, Living people, Brazilian footballers
Takeshi Kuwahara	1985 births, Living people, Footballers from Fukuoka Prefecture
Jorge Burruchaga	1962 births, Living people, Argentine footballers, Argentine football managers
Artur Boruc	1980 births, Living people, Polish footballers, Association football goalkeepers
Liberal Party (Philippines)	Politics of the Philippines, Liberal parties
Aleksandr Mostovoi	1968 births, Living people, Russian footballers
Gregory van der Wiel	1988 births, Living people, Dutch footballers, Sportspeople from Amsterdam
Luis Suárez	1987 births, Living people, 2010 FIFA World Cup players, 2014 FIFA World Cup players, 2018 FIFA World Cup players, Uruguayan footballers
Arup	1946 establishments in Europe, Engineering companies of the United Kingdom, 1940s establishments in the United Kingdom
Brownfield land	Urban planning
Manchester Regional Arena	Stadiums in the United Kingdom
Royston Drenthe	1987 births, Living people, Dutch footballers, Sportspeople from Rotterdam
Michael Lindeman	1964 births, Living people, Dutch football managers
Uri Coronel	1946 births, 2016 deaths, Dutch football managers, Dutch Jews, Jewish sportspeople, Sportspeople from Amsterdam
Paul Phoenix (Tekken)	Tekken characters
Lei Wulong	Tekken characters
Manchester Velodrome	Manchester, Cycling, 1994 establishments in England
2012 United States presidential election	2012 in the United States, 2012 elections, Barack Obama, United States presidential elections
The Kippax	Sports buildings in the United Kingdom
UEFA Women's Euro 2005	2005 in association football, 2005 in England, Lancashire, Football in England, UEFA, June 2005 events
Laurent Robert	1975 births, Living people, French footballers, People from Réunion
Nicolae Mitea	1985 births, Living people, Romanian footballers, Sportspeople from Bucharest
Yasumichi Uchima	1984 births, Living people, Footballers from Okinawa Prefecture
Rodrigo Fabri	1976 births, Living people, Brazilian footballers
Public health	Public health, Medicine
Tsubasa Watabe	1986 births, Living people, Footballers from Kanagawa Prefecture
Marcos Assunção	1976 births, Living people, Brazilian footballers
James McFadden	1983 births, Living people, Scottish footballers
Richard Wright	1977 births, Living people, English association football goalkeepers, Manchester City F.C. players, People from Ipswich
Lawrence Akandu	1974 births, Living people, Chinese footballers
Marco Cassetti	1977 births, Living people, Italian footballers, Sportspeople from Lombardy, People from Brescia
Piyapong Pue-on	1959 births, Living people, Thai football managers, Thai footballers
Aaron Hughes	1979 births, Living people, Northern Irish footballers
Wilfred Bouma	1978 births, Living people, Dutch footballers, People from Helmond, Sportspeople from North Brabant
Sho Miyasaka	1988 births, Living people, Footballers from Kumamoto Prefecture
Seiji Sonoda	1988 births, Living people, Footballers from Kumamoto Prefecture
Thomas Myhre	1973 births, Living people, Norwegian footballers, Association football goalkeepers, Crystal Palace F.C. players
Tom Finney	1922 births, 2014 deaths, English footballers, Sportspeople from Lancashire
Nat Lofthouse	English footballers, People from Bolton, Sportspeople from Lancashire, 1925 births, 2011 deaths
Antonio Carbajal	1929 births, Living people, Mexican footballers, Mexican football managers, Sportspeople from Mexico City, Association football goalkeepers, 1950 FIFA World Cup players, 1954 FIFA World Cup players, 1958 FIFA World Cup players, 1962 FIFA World Cup players, 1966 FIFA World Cup players
Daniel Van Buyten	1978 births, Living people, Belgian footballers
Epidemiology	Public health, Epidemiology
Masakatsu Sawa	1983 births, Living people, Footballers from Chiba Prefecture
Intercontinental Broadcasting Corporation	Intercontinental Broadcasting Corporation, Quezon City
Paul-Henri Mathieu	1982 births, Living people, French tennis players, Male tennis players, People from Strasbourg
Kentaro Kawasaki	1982 births, Living people, Footballers from Osaka Prefecture, People from Osaka
Pooper-scooper	Pets
Seiya Fujita	1987 births, Living people, Footballers from Hokkaidō Prefecture, People from Sapporo
Daigo Nishi	1987 births, Living people, Footballers from Hokkaidō Prefecture, Japan international footballers, J1 League players, J2 League players, Hokkaido Consadole Sapporo players, Albirex Niigata players, Kashima Antlers players, Vissel Kobe players, Urawa Red Diamonds players
Heterokont	Algae, Protista
Metastability	Chemicals, Physics
Cryptomonad	Algae, Protista
England women's national football team	Women's national football teams, Football in England, 1970s establishments in England, 1972 establishments in the United Kingdom
Planck constant	Numbers, Physics
Sebastian Coe	1956 births, Living people, British male athletes, British Olympic gold medalists, British Olympic silver medalists, Former Conservative MPs (UK), Former members of the British House of Commons for English constituencies, Medalists at the 1980 Summer Olympics, Medalists at the 1984 Summer Olympics, Politicians from London, Politicians from Yorkshire, Sportspeople from London, Sportspeople from Sheffield, Sportspeople from Warwickshire, United Kingdom Life Peers
Theme restaurant	Restaurants
John Laing plc	Companies of the United Kingdom, 1848 establishments in Europe, 1840s establishments in the United Kingdom
Christian Eriksen	1992 births, Danish footballers, Living people, Tottenham Hotspur F.C. players
Norman Foster (architect)	1935 births, Living people, English architects, United Kingdom Life Peers, People from Stockport, Greater Manchester, Order of Merit, Knights Bachelor, Order of Merit of the Federal Republic of Germany, People from Cheshire, People from Manchester, Pritzker Prize winners, Members of the House of Lords
Cessna 152	Aircraft, Cessna aircraft
Thomas Heatherwick	1970 births, Artists from London, British fashion designers, Living people
Louver	Architectural elements
Lost (season 6)	2010 in American television, 2010 television seasons, American television seasons
Weather map	Meteorology
Junpei Shinmura	1988 births, Living people, Footballers from Osaka Prefecture, People from Osaka
Sandro Hiroshi	1979 births, Living people, Brazilian footballers
Takumi Oguri	1987 births, Living people, Footballers from Shizuoka Prefecture
Kimitoshi Nōgawa	1984 births, Living people, Footballers from Wakayama Prefecture
Yoshiaki Shimojo	1954 births, Living people, Footballers from Nagano Prefecture
Matteo Ferrari	1979 births, Living people, Italian footballers
Hiroaki Kumon	1966 births, Living people, Footballers from Kanagawa Prefecture
Tsuneyuki Ueda	1985 births, Living people, Footballers from Miyazaki Prefecture
Shunsuke Iwanuma	1988 births, Living people, Footballers from Gunma Prefecture
Yasuaki Okamoto	1988 births, Living people, Footballers from Kumamoto Prefecture
Tomotaka Kitamura	1982 births, Living people, Footballers from Mie Prefecture
Hatem Trabelsi	1977 births, Living people, Tunisian footballers
Takuya Matsuura	1988 births, Living people, Footballers from Shizuoka Prefecture
Ryu Okada	1984 births, Living people, Footballers from Shizuoka Prefecture
Ryohei Yamazaki	1989 births, Living people, Footballers from Niigata Prefecture
Yohei Kurakawa	1977 births, Living people, Footballers from Yamaguchi Prefecture
Koki Yonekura	1988 births, Living people, Footballers from Chiba Prefecture, Japan international footballers, J1 League players, J2 League players, J3 League players, JEF United Chiba players, Gamba Osaka players, Gamba Osaka U-23 players
Kazushige Kirihata	1987 births, Living people, Footballers from Yamanashi Prefecture, Japanese association football goalkeepers
Takahiro Takagi	1982 births, Living people, Footballers from Ishikawa Prefecture, Albirex Niigata players
Kazuya Kawabata	1981 births, Living people, Footballers from Hokkaidō Prefecture
Ryota Takasugi	1984 births, Living people, Footballers from Yamaguchi Prefecture
Shinsaku Mochidome	1988 births, Living people, Footballers from Osaka Prefecture
Kenichi Ego	1979 births, Living people, Footballers from Hyōgo Prefecture
Chaetognatha	Minor phyla
Pepper spray	Capsicum, Safety, Law enforcement equipment
Roy Lichtenstein	1923 births, 1997 deaths, American artists, Deaths from pneumonia, People from New York City, Pop artists, Andy Warhol
Sodor (fictional island)	Fictional locations
Tomoki Suzuki	1985 births, Living people, Footballers from Hokkaidō Prefecture
Yuki Kaneko	1982 births, Living people, Footballers from Tokyo Prefecture
Jorge Sebastian Nunez	1986 births, Living people, Argentine footballers
Hiroshi Kichise	1983 births, Living people, Footballers from Fukuoka Prefecture
Zheng Zhi	1980 births, Living people, Chinese footballers
Shinya Tokuni	1981 births, Living people, Footballers from Hokkaidō Prefecture
Shogo Ebisawa	1985 births, Living people, Footballers from Hokkaidō Prefecture, People from Sapporo
Michihisa Date	1966 births, Living people, Footballers from Shizuoka Prefecture
Dejan Petković	1972 births, Living people, Serbian footballers
Alexei Shirov	1972 births, Living people, Latvian chess players, People from Riga, Soviet sportspeople, Chess grandmasters
Tweenies	Children's television series, Nickelodeon television series, BBC Television programmes, English-language television programs, 1999 television series debuts, 2002 television series endings
Pavel Eljanov	Ukrainian chess players, 1983 births, Living people, Chess grandmasters
Lactase	Genetics, Enzymes, Evolutionary biology
Tanduay	1854 establishments, Alcoholic spirits, Companies of the Philippines, 1850s establishments in Asia, Establishments in the Philippines
Asia Brewery	Companies of the Philippines, 1982 establishments in Asia, 1980s establishments in the Philippines
Ginebra San Miguel	Companies of the Philippines, 1902 establishments in Asia, 20th century establishments in the Philippines
Fox (Asia)	Fox Broadcasting Company, 1998 establishments in Asia
WarnerTV	Time Warner subsidiaries, Miami, Florida
All Sports Network	Sport in Hong Kong, Television channels, Sports media, Asian culture
RHTV	Companies of the Philippines, Television stations, 2008 establishments in Asia
NBA TV	1999 establishments in Georgia (U.S. state), American television networks, Sports in Atlanta, Georgia, Companies based in Atlanta, Georgia
HBO Asia	HBO, Time Warner subsidiaries, Television channels, 1992 establishments in Asia
Discovery Channel (South East Asian TV channel)	Asia, Television channels
National Geographic Channel (Asia)	Television channels, News Corporation, 1994 establishments in Asia, Disney companies
Gifted education	Giftedness
Sport England	Sport in England
Manic Street Preachers	1986 establishments in the United Kingdom, 1980s British music groups, 1990s British music groups, 2000s British music groups, 2010s British music groups, Musical groups established in 1986, Welsh rock bands, 20th century establishments in Wales
Turnstile	Gates
Toroid (geometry)	Shapes
Ashburys railway station	Railway stations in England, 1855 establishments in Europe, 1850s establishments in England
Regional casino	Gambling
Royal Institute of British Architects	Organisations based in the United Kingdom

