Caldecott medal	Awards
Sanders County, Montana	1900s establishments in Montana, 1905 establishments in the United States, Montana counties
Sheridan County, Montana	1913 establishments in Montana, Montana counties
List of presidents of Seychelles	Presidents of Seychelles, Lists of heads of state
France-Albert René	1934 births, 2019 deaths, Deaths from respiratory failure, Presidents of Seychelles, Prime Ministers of Seychelles
Prime Minister of Seychelles	Prime Ministers of Seychelles
James Michel	1944 births, Living people, Presidents of Seychelles, Vice presidents
Danny Faure	1962 births, Living people, Presidents of Seychelles, Vice presidents
Richard Willstätter	1872 births, 1942 deaths, German chemists
Stillwater County, Montana	1913 establishments in Montana, Montana counties
Sweet Grass County, Montana	1890s establishments in Montana, 1895 establishments in the United States, Montana counties
Teton County, Montana	1893 establishments in Montana, Montana counties
Toole County, Montana	1914 establishments in Montana, Montana counties
Valley County, Montana	1893 establishments in Montana, Montana counties
Wheatland County, Montana	1910s establishments in Montana, 1917 establishments in the United States, Montana counties
Wibaux County, Montana	1914 establishments in Montana, Montana counties
Yellowstone County, Montana	1893 establishments in Montana, Montana counties
Hechsher	Symbols, Hebrew language, Food and drink
The Karate Kid Part II	1986 movies, 1980s sequel movies, American sequel movies, English-language movies, Martial arts movies, Karate, Movies directed by John G. Avildsen, Movies set in California
Jay Inslee 2020 presidential campaign	2020 United States presidential campaigns
Beto O'Rourke 2020 presidential campaign	2020 United States presidential campaigns
Joe Biden 2020 presidential campaign	2020 United States presidential campaigns, Joe Biden
Wurtz reaction	Organic reactions
Humayun's Tomb	16th century establishments in India, 1572 establishments, Buildings and structures in India, World Heritage Sites in India, Delhi
Alex Nibourette	1983 births, Living people, Seychellois people, African footballers
Abbeville County, South Carolina	1785 establishments in South Carolina, South Carolina counties
Bamberg County, South Carolina	1897 establishments in South Carolina, South Carolina counties
Richland County, South Carolina	1785 establishments in South Carolina, South Carolina counties
Union County, South Carolina	South Carolina counties, 1785 establishments in South Carolina
Darlington County, South Carolina	1785 establishments in South Carolina, South Carolina counties
Charleston County, South Carolina	20th-century establishments in South Carolina, 1901 establishments in the United States, South Carolina counties
Hollywood, South Carolina	Towns in South Carolina
Centerville, Texas	Cities in Texas, County seats in Texas
Throckmorton, Texas	Towns in Texas, County seats in Texas
Hatfield, Arkansas	Towns in Arkansas
Jerome, Arkansas	Towns in Arkansas
Haynes, Arkansas	Towns in Arkansas
Hector, Arkansas	Towns in Arkansas
Higden, Arkansas	Towns in Arkansas
Highfill, Arkansas	Towns in Arkansas
Mount Pleasant, Arkansas	Towns in Arkansas
Rabindra Prasad Adhikari	1969 births, 2019 deaths, Nepalese politicians, Aviation deaths
Paul Hausser	1880 births, 1972 deaths, SS officers, German military personnel of World War I, German military personnel of World War II, German writers, German generals
Hindsville, Arkansas	Towns in Arkansas
Magness, Arkansas	Towns in Arkansas
Pontiac, Michigan	Cities in Michigan, County seats in Michigan
Oakland County, Michigan	1820 establishments in the United States, 1820s establishments in Michigan Territory, Michigan counties
Horseshoe Lake, Arkansas	Towns in Arkansas
Hunter, Arkansas	Towns in Arkansas
Puplinge	Municipalities of Geneva, Villages in Switzerland
Bill Weld 2020 presidential campaign	2020 United States presidential campaigns
Dosa	Indian food
Najib Tareque	Living people, 1970 births, Printmakers, Bangladeshi writers, People from Dhaka
Rajasthan University Students Union (RUSU)	Colleges and universities in India, 1960s establishments in India, 1967 establishments in Asia, Rajasthan
Sancho VI of Navarre	Kings and queens, 1132 births, 1194 deaths
West Darfur	States of Sudan
John C. Gaunt	1833 births, 1886 deaths, United States Army Medal of Honor recipients, People from Ohio
Allendale County, South Carolina	20th-century establishments in South Carolina, 1919 establishments in the United States, South Carolina counties
Allendale, South Carolina	Towns in South Carolina, County seats in South Carolina
Jericho, Arkansas	Towns in Arkansas
Lafe, Arkansas	Towns in Arkansas
Louann, Arkansas	Towns in Arkansas
Zinc, Arkansas	Towns in Arkansas
Sunset, Arkansas	Cities in Arkansas
Lynn, Arkansas	Towns in Arkansas
Maynard, Arkansas	Towns in Arkansas
O'Kean, Arkansas	Towns in Arkansas
McNab, Arkansas	Towns in Arkansas
Menifee, Arkansas	Towns in Arkansas
Midway, Arkansas	Towns in Arkansas
Winchester, Arkansas	Towns in Arkansas
Moorefield, Arkansas	Towns in Arkansas
Sulphur Rock, Arkansas	Towns in Arkansas
Moro, Arkansas	Towns in Arkansas
Mount Vernon, Arkansas	Towns in Arkansas
Twin Groves, Arkansas	Towns in Arkansas
Perla, Arkansas	Towns in Arkansas
Nimmons, Arkansas	Towns in Arkansas
McDougal, Arkansas	Cities in Arkansas
Georgetown, Texas	Cities in Texas, County seats in Texas
Milton Morris	1924 births, 2019 deaths, Australian businesspeople, Military personnel of World War II, Politicians from New South Wales, Liberal Party of Australia politicians, Order of Australia, Deaths from stroke, Cardiovascular disease deaths in New South Wales
Uffholtz	Communes in Haut-Rhin
Catholic University of Petrópolis	Colleges and universities in Brazil, Rio de Janeiro (state), 1953 establishments in South America, 1950s establishments in Brazil
Petrópolis	Cities in Rio de Janeiro (state)
We Didn't Start the Fire	1989 songs, Pop rock songs
Deaths in March 2019	2019 deaths, March 2019 events
Kumar Bhattacharyya, Baron Bhattacharyya	1940 births, 2019 deaths, Indian politicians, Indian scientists, Indian engineers, British politicians, British scientists, British engineers
Zhores Alferov	1930 births, 2019 deaths, Deaths from stroke, Russian physicists, Soviet politicians, Russian politicians, Jewish Nobel Prize winners
Sue Casey	1926 births, 2019 deaths, American movie actors, American television actors, Actors from Los Angeles, California
T. Jack Lee	1935 births, 2019 deaths, Deaths from pancreatic cancer, Engineers from Alabama, Scientists from Huntsville, Alabama
Helen Baxendale	1970 births, Living people, English movie actors, English television actors, English stage actors, English voice actors, Actors from Yorkshire
John Herron	1932 births, 2019 deaths, Australian Roman Catholics, Ambassadors of Australia, Politicians from Queensland
Christian Bach	1959 births, 2019 deaths, Deaths from respiratory failure, Argentine movie actors, Argentine television actors, Mexican movie actors, Mexican television actors, Actors from Buenos Aires, Actors from Mexico City
Justyna Steczkowska	1972 births, Living people, Polish singers, Singer-songwriters
Dogana	Towns in Europe, San Marino
North Nicosia	National capitals in Europe, Capital cities in Asia, Northern Cyprus, Nicosia
Social Democrats (Slovenia)	1990s establishments in Slovenia, 1993 establishments in Europe, Social democratic parties, Political parties in Europe, Ljubljana
Nova Gorica	Towns in Slovenia
University of Nova Gorica	1990s establishments in Slovenia, 1995 establishments in Europe, Colleges and universities in Europe, Buildings and structures in Slovenia
Western Grove, Arkansas	Towns in Arkansas
Norman, Arkansas	Towns in Arkansas
Oak Grove Heights, Arkansas	Towns in Arkansas
Oak Grove, Carroll County, Arkansas	Towns in Arkansas
Oakhaven, Arkansas	Towns in Arkansas
Oden, Arkansas	Towns in Arkansas
Ogden, Arkansas	Towns in Arkansas
Ozan, Arkansas	Towns in Arkansas
Blevins, Arkansas	Cities in Arkansas
Pineville, Arkansas	Towns in Arkansas
Reed, Arkansas	Towns in Arkansas
Roe, Arkansas	Towns in Arkansas
Rose Bud, Arkansas	Towns in Arkansas
Higginson, Arkansas	Cities in Arkansas
Russell, Arkansas	Cities in Arkansas
West Point, Arkansas	Towns in Arkansas
Tupelo, Arkansas	Towns in Arkansas
Tucuruí Dam	Dams, Buildings and structures in Brazil, Pará
Weldon, Arkansas	Towns in Arkansas
Campbell Station, Arkansas	Cities in Arkansas
Rosston, Arkansas	Towns in Arkansas
Willisville, Arkansas	Towns in Arkansas
Jasper County, South Carolina	20th-century establishments in South Carolina, 1912 establishments in the United States, South Carolina counties
Alfred Freddy Krupa	1971 births, Living people, Croatian people, Painters
Kevin Roche	Pulitzer Prize winners, 1922 births, 2019 deaths, Naturalized citizens of the United States, American architects, People from Dublin, Businesspeople from New Haven, Connecticut
Guilford, Connecticut	Towns in Connecticut
Arnulf Baring	1932 births, 2019 deaths, German historians, People from Dresden
Fred Hill (coach)	1934 births, 2019 deaths, American football coaches, Sportspeople from New Jersey
Ivar Nilsson	1933 births, 2019 deaths, Swedish Olympians
Channel catfish	IUCN Red List least concern species, Freshwater fish, Catfish, Articles with 'species' microformats
Xabier Arzalluz	1932 births, 2019 deaths, Spanish politicians, Spanish Roman Catholics
Roger Carel	1927 births, 2020 deaths, French movie actors, French television actors, French voice actors, Actors from Paris
Francisco Macri	1930 births, 2019 deaths, Real estate developers, Italian businesspeople, Argentine politicians, Argentine businesspeople, Politicians from Rome, People from Buenos Aires
María Ignacia Benítez	1958 births, 2019 deaths, Deaths from pancreatic cancer, Chilean politicians, Environmentalists
Norma Paulus	1933 births, 2019 deaths, Deaths from vascular dementia, American lawyers, American political activists, Politicians from Nebraska, Politicians from Portland, Oregon, US Republican Party politicians
Bombus lapidarius	Bees
Wolff–Kishner reduction	Organic reactions
Ambroise-Paré Hospital	1920s establishments in France, 1923 establishments in Europe, Hospitals in France, Île-de-France
Vice President of Turkey	Vice presidents, Turkish politicians
Rudy, Arkansas	Towns in Arkansas
St. Paul, Arkansas	Towns in Arkansas
Sherrill, Arkansas	Towns in Arkansas
South Lead Hill, Arkansas	Towns in Arkansas
Springtown, Arkansas	Towns in Arkansas
Success, Arkansas	Towns in Arkansas
Widener, Arkansas	Cities in Arkansas
Tillar, Arkansas	Towns in Arkansas
Tull, Arkansas	Towns in Arkansas
Valley Springs, Arkansas	Towns in Arkansas
Vandervoort, Arkansas	Towns in Arkansas
Wheatley, Arkansas	Towns in Arkansas
Williford, Arkansas	Towns in Arkansas
Altus, Arkansas	Cities in Arkansas
Austin, Arkansas	Cities in Arkansas
Bay, Arkansas	Cities in Arkansas
Belleville, Arkansas	Cities in Arkansas
Hundwil	Municipalities of Appenzell Ausserrhoden
Dungan people	Ethnic groups in China, Xinjiang
Cyclopropane	Cycloalkanes
Cyclohexane	Cycloalkanes
Dungan language	Languages of China, Languages of Russia, Languages of Tajikistan, Kyrgyzstan, Kazakhstan, Turkmenistan, Uzbekistan
Analytic language	Linguistics
Keith Flint	1969 births, 2019 deaths, Suicides by hanging in the United Kingdom, Singers from Essex, Singers from London
Dehradun	Capital cities in India, Settlements in Uttarakhand
Sprachbund	Linguistics
East Asian cultural sphere	East Asia, Chinese culture, Japanese culture, Korean culture, Filipino culture, Vietnamese culture, Singapore, Cultural geography
Greater China	Geography of China
Waccabuc, New York	Hamlets in New York
Chinese loanwords	Chinese language, Words
John Hickenlooper 2020 presidential campaign	2020 United States presidential campaigns
Governor of Colorado	Governors of Colorado
Bradford, Arkansas	Cities in Arkansas
Briarcliff, Arkansas	Cities in Arkansas
List of governors of Montana	Governors of Montana
Caldwell, Arkansas	Cities in Arkansas
Calion, Arkansas	Cities in Arkansas
Caraway, Arkansas	Cities in Arkansas
Havana, Arkansas	Cities in Arkansas
Peter van Gestel	1937 births, 2019 deaths, Dutch children's writers, Writers from Amsterdam
Carthage, Arkansas	Cities in Arkansas
Cherry Valley, Arkansas	Cities in Arkansas
Keith Davis	1930 births, 2019 deaths, New Zealand rugby union players
Chidester, Arkansas	Cities in Arkansas
Colt, Arkansas	Cities in Arkansas
Clarkedale, Arkansas	Cities in Arkansas
Werner Schneyder	1937 births, 2019 deaths, Actors from Vienna, Singers from Vienna, Writers from Vienna
East Camden, Arkansas	Cities in Arkansas
Ed Bickert	1932 births, 2019 deaths, Deaths from lung cancer, Canadian guitarists, People from Manitoba
Juan Corona	1934 births, 2019 deaths, People who died in prison custody in the United States, American serial killers, American people convicted of murder, Naturalized citizens of the United States, Mexican people, Criminals from California
Corcoran, California	Cities in California, Settlements in Kings County, California
Rafael Torija de la Fuente	1927 births, 2019 deaths, Spanish Roman Catholics, Bishops
Urnäsch	Municipalities of Appenzell Ausserrhoden
Teufen, Appenzell Ausserrhoden	Municipalities of Appenzell Ausserrhoden
Anderson County, South Carolina	19th-century establishments in South Carolina, 1826 establishments in the United States, South Carolina counties
Anderson, South Carolina	Cities in South Carolina, County seats in South Carolina
Speicher	Municipalities of Appenzell Ausserrhoden
Schwellbrunn	Municipalities of Appenzell Ausserrhoden
Sam Mayo	1881 births, 1938 deaths, Singers from London
Johnny Romano	1934 births, 2019 deaths, Chicago White Sox players, Cleveland Indians players, St. Louis Cardinals players, Sportspeople from New Jersey, People from Hoboken, New Jersey
Oakland Charter Township, Michigan	Townships in Michigan
Peter Hurford	1930 births, 2019 deaths, Deaths from Alzheimer's disease, British composers, British musicians, People from Somerset
Rosaly Lopes	1957 births, Living people, NASA, Geologists
Raisen district	Districts of Madhya Pradesh
Barnwell County, South Carolina	1800 establishments in South Carolina, South Carolina counties
Laurens County, South Carolina	1785 establishments in South Carolina
Damascus, Arkansas	Cities in Arkansas, Van Buren County, Arkansas
Dyer, Arkansas	Cities in Arkansas
Channing, Texas	Cities in Texas, County seats in Texas
Gais	Municipalities of Appenzell Ausserrhoden, Villages in Switzerland
Grub, Appenzell Ausserrhoden	Municipalities of Appenzell Ausserrhoden
Heiden, Switzerland	Municipalities of Appenzell Ausserrhoden
Lutzenberg	Municipalities of Appenzell Ausserrhoden
Rehetobel	Municipalities of Appenzell Ausserrhoden
Walzenhausen	Municipalities of Appenzell Ausserrhoden
Greenland, Arkansas	Cities in Arkansas
Elkins, Arkansas	Cities in Arkansas
Elm Springs, Arkansas	Cities in Arkansas
Hughes, Arkansas	Cities in Arkansas
Commerce Township, Michigan	Townships in Michigan
Jim Whittaker	1929 births, Living people, American environmentalists, American autobiographers, Twin people from the United States, Writers from Seattle, Washington
Tim Green	1963 births, Living people, Atlanta Falcons players, American football defensive ends, American football linebackers, American lawyers, American sports commentators, American children's writers, American radio personalities, Sportspeople from New York, Writers from New York, Television personalities from New York
Oblique type	Typography
Soyuz 11	Soviet spacecraft, 1971 in Europe, Soviet Union
House of Oldenburg	Royal dynasties
Absolute space and time	Time, Physics
János Koós	1937 births, 2019 deaths, Pop singers, People from Budapest
José Pedro Pérez-Llorca	1940 births, 2019 deaths, Spanish politicians, Spanish lawyers
Robert DeProspero	1938 births, 2019 deaths, Deaths from amyloidosis, People from West Virginia
Jean Starobinski	1920 births, 2019 deaths, Swiss writers, Critics, People from Geneva
Chu Shijian	1928 births, 2019 deaths, Deaths from diabetes, Chinese businesspeople
Jacques Loussier	1934 births, 2019 deaths, French pianists, French composers
Carmen Yulín Cruz	1963 births, Living people, Mayors, People from San Juan, Puerto Rico
Foreman, Arkansas	Cities in Arkansas
Gillett, Arkansas	Cities in Arkansas
Gilmore, Arkansas	Cities in Arkansas
Gould, Arkansas	Cities in Arkansas
Grady, Arkansas	Cities in Arkansas
Erica Jong	1942 births, Living people, American feminist writers, American novelists, American poets, Writers from New York City
Grannis, Arkansas	Cities in Arkansas
Greenbrier, Arkansas	Cities in Arkansas
Greenway, Arkansas	Cities in Arkansas
Greers Ferry, Arkansas	Cities in Arkansas
Grubbs, Arkansas	Cities in Arkansas
Richard B. Spencer	1978 births, Living people, American political activists, American political writers, American atheists, Writers from Boston, Massachusetts, Writers from Montana, Writers from Virginia, Writers from Dallas, Texas, People from Whitefish, Montana
Ambrose Mandvulo Dlamini	2020 deaths, 1968 births, African businesspeople, Prime Ministers of Eswatini, Deaths from the COVID-19 pandemic in South Africa
Mswati III	1968 births, Living people, Swazi people, Current national leaders, Kings and queens
Benny Gantz	1959 births, Living people, Government ministers of Israel, Haifa University alumni, Israeli generals, Israeli opposition leaders, Israeli political leaders, Jewish Israeli politicians, Jewish military people, Knesset speakers, Members of Knesset, Tel Aviv University alumni
Leaving Neverland	2019 movies, British movies, American documentary movies, English-language movies, Michael Jackson
Reute, Switzerland	Municipalities of Appenzell Ausserrhoden
Schönengrund	Municipalities of Appenzell Ausserrhoden
Stein, Appenzell Ausserrhoden	Municipalities of Appenzell Ausserrhoden
Wald, Appenzell Ausserrhoden	Municipalities of Appenzell Ausserrhoden
Waldstatt	Municipalities of Appenzell Ausserrhoden
Wolfhalden	Municipalities of Appenzell Ausserrhoden
Beaufort County, South Carolina	18th-century establishments in South Carolina, 1769 establishments in the Thirteen Colonies, South Carolina counties
Goethe-Institut	1950s establishments in Germany, 1951 establishments in Europe, Cultural organizations, Munich
Johnson, Arkansas	Cities in Arkansas
Lake View, Arkansas	Cities in Arkansas
Glendora, New Jersey	Unincorporated communities in New Jersey, Census-designated places in New Jersey
The Campaign (movie)	2012 movies, American comedy movies, Warner Bros. movies
Red (2010 movie)	2010 comedy movies, 2010s action comedy movies, American action comedy movies, Movies directed by Robert Schwentke
Karl Urban	1972 births, Living people, New Zealand actors, People from Wellington
Red 2	2013 action movies, 2013 comedy movies, 2010s action comedy movies, American action comedy movies, French action movies, French comedy movies, Canadian comedy movies, Sequel movies, Warner Bros. movies, Movies directed by Dean Parisot
Ryo Narita	Living people, 1993 births, Japanese movie actors, Japanese models, People from Saitama Prefecture
Azucena Berrutti	1929 births, Living people, Uruguayan lawyers, Uruguayan politicians, People from Montevideo
NationStates	Websites, Websites established in 2002, Simulator video games
Repository (data)	Computing, Computer science
Black sapote	Ebenaceae, Tropical fruit
Another One Bites the Dust	1980 songs, Queen songs
Haskell, Arkansas	Cities in Arkansas
Hermitage, Arkansas	Cities in Arkansas
Hickory Ridge, Arkansas	Cities in Arkansas
Holland, Arkansas	Cities in Arkansas
Holly Grove, Arkansas	Cities in Arkansas
Horseshoe Bend, Arkansas	Cities in Arkansas
Humnoke, Arkansas	Cities in Arkansas
Humphrey, Arkansas	Cities in Arkansas
Junction City, Arkansas	Cities in Arkansas
Knobel, Arkansas	Cities in Arkansas
Berkeley County, South Carolina	1880s establishments in South Carolina, 1882 establishments in the United States, South Carolina counties
Panamanian balboa	Currency of North America, Panama
Chester County, South Carolina	1785 establishments in South Carolina, South Carolina counties
Chesterfield County, South Carolina	1785 establishments in South Carolina, South Carolina counties
Chesterfield, South Carolina	Towns in South Carolina, County seats in South Carolina
Düdingen	Municipalities of Fribourg
Tentlingen	Municipalities of Fribourg
The Reverend	Religion
Gempenach	Municipalities of Fribourg
Lepanto, Arkansas	Cities in Arkansas
To the Shores of Iwo Jima	Movies set in islands
Discord (software)	Software, Websites
Triton (malware)	Malware
Sea snail	Gastropods
Fine Gael	Conservative parties, Republic of Ireland
Selma to Montgomery marches	History of Alabama, 1965 in the United States, March events, Selma, Alabama, Montgomery, Alabama, Protests in the 1960s, Conflicts, Martin Luther King Jr.
Kensett, Arkansas	Cities in Arkansas
Kibler, Arkansas	Cities in Arkansas
Knoxville, Arkansas	Cities in Arkansas
Luxora, Arkansas	Cities in Arkansas
Mitchellville, Arkansas	Cities in Arkansas
Mayflower, Arkansas	Cities in Arkansas
McCrory, Arkansas	Cities in Arkansas
McNeil, Arkansas	Cities in Arkansas
McRae, Arkansas	Cities in Arkansas
Monette, Arkansas	Cities in Arkansas
Great crested newt	Salamanders
Montrose, Arkansas	Cities in Arkansas
Parkdale, Arkansas	Cities in Arkansas
Portland, Arkansas	Cities in Arkansas
Wilmot, Arkansas	Cities in Arkansas
North Crossett, Arkansas	Census-designated places in Arkansas
West Crossett, Arkansas	Census-designated places in Arkansas
Cherokee City, Arkansas	Census-designated places in Arkansas
Wiederkehr Village, Arkansas	Cities in Arkansas
Newark, Arkansas	Cities in Arkansas
Norphlet, Arkansas	Cities in Arkansas
Oxford, Arkansas	Cities in Arkansas
Joseph H. Boardman	1948 births, 2019 deaths, American chief executives, United States Department of Transportation, Amtrak, Republicans (United States), American military personnel of the Vietnam War, Cornell University alumni, Businesspeople from New York, Deaths from stroke
Vienna, New York	Cities in New York
Chesalles-sur-Moudon	Former municipalities of Vaud
Gimel, Switzerland	Municipalities of Vaud
Dupont Plaza Hotel arson	1980s fires, 20th century in Puerto Rico, 1986
Metal Gear Solid	1998 video games, PlayStation games
Communist Party of Cuba	20th-century establishments in Cuba, 1965 establishments in North America, Communist parties, Havana, Marxism
José Ramón Machado Ventura	1930 births, Living people, Vice presidents, Cuban politicians, Marxism
Popular Socialist Party (Cuba)	Political parties, Havana, 20th-century establishments in Cuba, 1925 establishments in North America, 1961 disestablishments, Communist parties
Almendares River	Rivers of North America, Geography of Cuba
Oppelo, Arkansas	Cities in Arkansas
Pangburn, Arkansas	Cities in Arkansas
Parkin, Arkansas	Cities in Arkansas
Patterson, Arkansas	Cities in Arkansas
Plainview, Arkansas	Cities in Arkansas
Plumerville, Arkansas	Cities in Arkansas
Pollard, Arkansas	Cities in Arkansas
Prattsville, Arkansas	Cities in Arkansas
Quitman, Arkansas	Cities in Arkansas
Winthrop, Arkansas	Cities in Arkansas
Raimundo Ongaro	1924 births, 2016 deaths, Argentine people, Trade unionists
Mel Hurtig	1932 births, 2016 deaths, Canadian activists, Canadian writers, Politicians from Alberta, Order of Canada, Canadian Jews, People from Edmonton, Deaths from pneumonia
Panchu Arunachalam	1941 births, 2016 deaths, Tamil directors, Indian movie directors, Indian movie producers, Indian screenwriters, Lyricists, Deaths from cardiac arrest
Sasi Shanker	1957 births, 2016 deaths, Indian movie directors
Klaus Weber	1936 births, 2016 deaths, German biologists, People from Łódź
Aboud Jumbe	1920 births, 2016 deaths, Tanzanian people, Presidents (government), Vice presidents, Muslims, Heads of government
Center Ridge, Arkansas	Census-designated places in Arkansas
Rye, Arkansas	Census-designated places in Arkansas
Stamps, Arkansas	Cities in Arkansas
Tontitown, Arkansas	Cities in Arkansas
Wickes, Arkansas	Cities in Arkansas
Wilmar, Arkansas	Cities in Arkansas
Springdale, Pennsylvania	Boroughs in Pennsylvania
Heidelberg, Pennsylvania	Boroughs in Pennsylvania
Tamakeri	Pornography, BDSM, Pages with unreviewed translations
Fort Scott, Kansas	County seats in Kansas, Cities in Bourbon County, Kansas
McPherson, Kansas	Cities in Kansas, County seats in Kansas
Fate, Texas	Cities in Texas
Rockwall, Texas	Cities in Texas, County seats in Texas
Jan-Michael Vincent	1945 births, 2019 deaths, Deaths from cardiac arrest, American movie actors, American television actors, American voice actors, American aviators, Actors from Denver, Colorado
Mandya District	Districts of Karnataka
Redfield, Arkansas	Cities in Arkansas
Rockport, Arkansas	Cities in Arkansas
Waldo, Arkansas	Cities in Arkansas
Taylor, Arkansas	Cities in Arkansas
Salesville, Arkansas	Cities in Arkansas
Midway, Baxter County, Arkansas	Census-designated places in Arkansas
Shannon Hills, Arkansas	Cities in Arkansas
Traskwood, Arkansas	Cities in Arkansas
East End, Arkansas	Census-designated places in Arkansas
Hot Springs Village, Arkansas	Census-designated places in Arkansas
Clarendon County, South Carolina	1785 establishments in South Carolina, South Carolina counties
Siegbert Horn	1950 births, 2016 deaths, Cancer deaths in Germany, German Olympic gold medalists, Medalists at the 1972 Summer Olympics, Sportspeople from Brandenburg
Childress, Texas	Cities in Texas, County seats in Texas
Mikis Theodorakis	1925 births, 2021 deaths, Greek writers, Composers, Greek politicians, Political activists, Deaths from cardiac arrest
Flemings (supermarkets)	1930 establishments, 1930s establishments in Australia, Supermarkets of Australia, Sydney
Solihull	Towns in the West Midlands (county)
Plurinational Legislative Assembly	National legislatures, Politics of South America, Bolivia
Fountain pen	Writing tools
John Habgood	1927 births, 2019 deaths, British educators, Bishops
Carolee Schneemann	1939 births, 2019 deaths, Deaths from breast cancer, Cancer deaths in New York, American feminists, American artists, People from Philadelphia, Pennsylvania
New Paltz, New York	Towns in New York
Llanito	Spanish language, Gibraltar, United Kingdom
Robert Braithwaite (engineer)	1943 births, 2019 deaths, British businesspeople, People from Yorkshire
Pino Caruso	1934 births, 2019 deaths, Deaths from Parkinson's disease, Italian movie actors, Italian television actors, Italian stage actors, Italian writers, Italian television personalities
Guillaume Faye	1949 births, 2019 deaths, Deaths from lung cancer, French journalists, French novelists
Carmine Persico	1933 births, 2019 deaths, Deaths from diabetes, People who died in prison custody in the United States, American people convicted of murder, Criminals from New York City
William Powers Jr.	1946 births, 2019 deaths, Accidental deaths from falls in the United States, American Presbyterians, American educators, People from Los Angeles, California, People from Austin, Texas
Kelly Catlin	1995 births, 2019 deaths, American cyclists, American Olympic silver medalists, Sportspeople from Saint Paul, Minnesota, Sportspeople from California, Suicides in California
Michael Gielen	1927 births, 2019 deaths, Deaths from pneumonia, Austrian writers, Conductors, People from Dresden
Ian Lawrence	1937 births, 2019 deaths, Deaths from stomach cancer, New Zealand politicians, New Zealand lawyers, Mayors, People from Wellington, Politicians from Sydney
Alberto Bucci	1948 births, 2019 deaths, Deaths from pancreatic cancer, Italian sportspeople, People from Bologna
Bernard Binlin Dadié	1916 births, 2019 deaths, Centenarians, African writers, Poets, Novelists, African politicians, Ivorian people
Harry Howell	1932 births, 2019 deaths, Deaths from Alzheimer's disease, New York Rangers players, California Golden Seals players, Los Angeles Kings players, Sportspeople from Ontario, People from Hamilton
Beverly Byron	1932 births, Living people, United States representatives from Maryland, Politicians from Baltimore, Maryland, US Democratic Party politicians
World Trade Center (2001–present)	Buildings and structures in Manhattan, 2000s establishments in New York (state), 2001 establishments in the United States, Landmarks in Manhattan, Skyscrapers in New York City, World Trade Organization
Excessive Daytime Sleepiness	Sleep disorders
Swifton, Arkansas	Cities in Arkansas
Sparkman, Arkansas	Cities in Arkansas
Strong, Arkansas	Cities in Arkansas
Na.Muthukumar	1975 births, 2016 deaths, Indian poets, Lyricists, People from Tamil Nadu, Deaths from jaundice, Deaths from cardiac arrest
Marion County, South Carolina	1800 establishments in South Carolina, South Carolina counties
Clarendon, Texas	Cities in Texas, County seats in Texas
İrsen Küçük	1940 births, 2019 deaths, Deaths from heart failure, Prime ministers, Cypriot people
Hal Blaine	1929 births, 2019 deaths, American rock drummers, Musicians from Massachusetts, Musicians from Los Angeles, California, People from Holyoke, Massachusetts
Martín Chirino	1925 births, 2019 deaths, Deaths from prostate cancer, Spanish sculptors
Daniel Silva dos Santos	1982 births, 2019 deaths, Deaths from lung cancer, Brazilian footballers
Ivan Irwin	1927 births, 2019 deaths, Deaths from pneumonia, New York Rangers players, Montreal Canadiens players, Sportspeople from Chicago, Sportspeople from Toronto, Eastern Hockey League players, Ice hockey defencemen
Jeffrey Hart	1930 births, 2019 deaths, Deaths from dementia, American columnists, American critics, American political writers, American conservatives, American political commentators, Cultural critics, Journalists from New York City, Writers from Vermont, Writers from New Hampshire
Fairlee, Vermont	Towns in Vermont
Marie-Claire Bancquart	1932 births, 2019 deaths, Deaths from bone cancer, French poets, French literary critics, French essayists
Dick Boushka	1934 births, 2019 deaths, Deaths from Alzheimer's disease, Disease-related deaths in Florida, American basketball players, American Olympic gold medalists, Sportspeople from Illinois, People from Springfield, Illinois
Fred Gloden	1918 births, 2019 deaths, American centenarians, Philadelphia Eagles players, American military personnel of World War II, Sportspeople from Iowa, People from Dubuque, Iowa
Jack Smith (end)	1917 births, 2015 deaths, Philadelphia Eagles players, Sportspeople from Los Angeles, California, Washington Redskins players
Stanley Price (writer)	1931 births, 2019 deaths, British novelists, British playwrights, British screenwriters, British television writers, Writers from London
Summer Wars	2009 anime movies
Butanone	Ketones
Pentanone	Ketones
2-Pentanone	Ketones
3-Pentanone	Ketones
Ljubomir Popović	1934 births, 2016 deaths, Serbian people, French painters
W. Carter Merbreier	1926 births, 2016 deaths, American television personalities, American Lutherans, Religious leaders, People from Pennsylvania
Glenn Yarbrough	1930 births, 2016 deaths, American folk singers, American guitarists, Tenors, Singers from Milwaukee, Wisconsin, Musicians from Milwaukee, Wisconsin, Deaths from dementia
3-Methyl-2-butanone	Ketones
Charles Toubé	1958 births, 2016 deaths, Cameroonian footballers
Tyronza, Arkansas	Cities in Arkansas
Stephens, Arkansas	Cities in Arkansas
Century egg	Egg, Chinese food
Charlene, Princess of Monaco	Olympians, Commonwealth Games medallists, Princes and princesses of Monaco, 1978 births, Living people
Archimedes number	Fluid mechanics, Numbers, Archimedes
Lorna Doone	1869 books, British novels, Romance novels
Eurico Miranda	1944 births, 2019 deaths, Deaths from brain cancer, Brazilian politicians, Brazilian businesspeople, People from Rio de Janeiro
Ghazali Jaafar	1944 births, 2019 deaths, Deaths from renal failure, Filipino politicians, Generals
David Garman	1922 births, 2019 deaths, British businesspeople, British inventors, People from West Sussex
Sue Povey	1942 births, 2019 deaths, British geneticists, British educators
Tom Warner	1948 births, 2019 deaths, State legislators of the United States, Deaths from prostate cancer, Cancer deaths in Florida, Politicians from New York, Politicians from Florida, People from Rochester, New York, US Republican Party politicians
Dale Dodrill	1926 births, 2019 deaths, Deaths from Alzheimer's disease, American football defensive tackles, American military personnel of World War II, Pittsburgh Steelers players, Businesspeople from Denver, Colorado, Businesspeople from Kansas, Sportspeople from Colorado, Sportspeople from Kansas
Paul Barrett	1940 births, 2019 deaths, British movie actors, Record producers
Summit, Arkansas	Cities in Arkansas
St. Francis, Arkansas	Cities in Arkansas
Rosemarie Bowe	1932 births, 2019 deaths, American models, American dancers, American movie actors, American television actors, Actors from Montana, Actors from Washington, People from Butte, Montana, People from Tacoma, Washington
Turrell, Arkansas	Cities in Arkansas
Ward, Arkansas	Cities in Arkansas
Watson, Arkansas	Cities in Arkansas
Wilson, Arkansas	Cities in Arkansas
Richard Bodycombe	1922 births, 2019 deaths, American generals, People from Pittsburgh, Pennsylvania
Wooster, Arkansas	Cities in Arkansas
Hagarville, Arkansas	Census-designated places in Arkansas
John Jeffries	1929 births, 2019 deaths, New Zealand politicians, New Zealand judges, People from Wellington
Jan Wahl	1931 births, 2019 deaths, Deaths from prostate cancer, Cancer deaths in Ohio, American children's writers, Writers from Columbus, Ohio
Paul Talalay	1923 births, 2019 deaths, Deaths from congestive heart failure, American biologists, German scientists, Scientists from Baltimore, Maryland
Altstätten	Municipalities of St. Gallen, Cities in Switzerland
A. Ernest Fitzgerald	1926 births, 2019 deaths, Engineers from Alabama, American military people, American political writers, Politicians from Birmingham, Alabama, Writers from Birmingham, Alabama
Wayne Messam 2020 presidential campaign	2020 United States presidential campaigns
Luwian language	Indo-European languages
Küssnacht	Municipalities of Schwyz, Districts of Schwyz, Cities in Switzerland, Villages in Schwyz
Željko Kopanja	1954 births, 2016 deaths, Bosnia and Herzegovina writers, Journalists, Crime victims, Deaths from cardiac arrest, CPJ International Press Freedom Award winners
Ines Mandl	1917 births, 2016 deaths, American biochemists, Scientists from Vienna
Colleton County, South Carolina	1800 establishments in South Carolina, South Carolina counties
Dillon County, South Carolina	20th-century establishments in South Carolina, 1910 establishments in the United States, South Carolina counties
Dillon, South Carolina	Cities in South Carolina, County seats in South Carolina
Edgefield County, South Carolina	1785 establishments in South Carolina, South Carolina counties
Florence County, South Carolina	1880s establishments in South Carolina, 1888 establishments in the United States, South Carolina counties
East–West Schism	History of Christianity, 1054
Dennard, Arkansas	Census-designated places in Arkansas, Van Buren County, Arkansas
Hiwasse, Arkansas	Census-designated places in Arkansas
Holiday Island, Arkansas	Census-designated places in Arkansas
Lake Hamilton, Arkansas	Census-designated places in Arkansas
Lost Bridge Village, Arkansas	Census-designated places in Arkansas
Gravel Ridge, Arkansas	Census-designated places in Arkansas
Schwyz (district)	Districts of Schwyz
Höfe (district)	Districts of Schwyz
Einsiedeln	Municipalities of Schwyz, Districts of Schwyz, Cities in Switzerland
March (district)	Districts of Schwyz
Lachen, Switzerland	Municipalities of Schwyz, Cities in Switzerland
Lauerz	Municipalities of Schwyz, Villages in Schwyz
Fairfield County, South Carolina	1785 establishments in South Carolina, South Carolina counties
Georgetown County, South Carolina	18th-century establishments in South Carolina, 1769 establishments in the Thirteen Colonies, South Carolina counties
Wollerau	Municipalities of Schwyz
Feusisberg	Municipalities of Schwyz
Ingenbohl	Municipalities of Schwyz
Greenwood County, South Carolina	1897 establishments in South Carolina, South Carolina counties
Chemical purification	Laboratory techniques, Chemical processes
Movies banned in China	Censorship, Lists of movies
Ocean's Eleven	2001 crime movies, English-language movies, American heist movies, Movies set in Las Vegas, Warner Bros. movies, Movies directed by Steven Soderbergh
Christchurch mosque shootings	2019 mass shootings, 2010s in New Zealand, Attacks on mosques, Islamophobic attacks and incidents, March 2019 events, Massacres, Terrorist incidents in 2019, Jacinda Ardern
Ethiopian Airlines Flight 302	2019 in Africa, March 2019 events, 2019 aviation disasters, History of Ethiopia
Under the Bridge	Rock songs, 1991 songs
Magnet Cove, Arkansas	Census-designated places in Arkansas
Maysville, Arkansas	Census-designated places in Arkansas
Prairie Creek, Arkansas	Census-designated places in Arkansas
New Edinburg, Arkansas	Census-designated places in Arkansas
Piney, Arkansas	Census-designated places in Arkansas
Reader, Arkansas	Census-designated places in Arkansas
Rockwell, Arkansas	Census-designated places in Arkansas
Staves, Arkansas	Census-designated places in Arkansas
Sulphur Springs, Jefferson County, Arkansas	Census-designated places in Arkansas
Tumbling Shoals, Arkansas	Census-designated places in Arkansas
Woodlawn, Arkansas	Census-designated places in Arkansas
Yarborough Landing, Arkansas	Census-designated places in Arkansas
Morschach	Municipalities of Schwyz
Sattel, Switzerland	Municipalities of Schwyz, Villages in Schwyz
Alpthal	Municipalities of Schwyz, Villages in Schwyz
Illgau	Municipalities of Schwyz
Oberiberg	Municipalities of Schwyz, Villages in Schwyz
Steinen, Switzerland	Municipalities of Schwyz
Hampton County, South Carolina	1870s establishments in South Carolina, 1878 establishments in the United States, South Carolina counties
Steinerberg	Municipalities of Schwyz
Rothenthurm	Municipalities of Schwyz
V-Varen Nagasaki	2005 establishments in Japan, Japanese football clubs, Nagasaki Prefecture
John Bardo	1948 births, 2019 deaths, Deaths from lung disease, American educators, Writers from Cincinnati, Ohio, Writers from Wichita, Kansas
Ocean's Twelve	2004 movies, 2000s crime movies, American sequel movies, English-language movies, American heist movies, Movies set in Europe, Warner Bros. movies, Movies directed by Steven Soderbergh, Movies set in Rome
Frank Cali	1965 births, 2019 deaths, Murders by firearm in New York, American crime victims, Criminals from New York City
Beril Dedeoğlu	1961 births, 2019 deaths, Deaths from cerebral hemorrhage, Turkish writers, Turkish politicians, Turkish educators, Columnists, People from Ankara
Alberto Lois	1956 births, 2019 deaths, Deaths from stomach cancer, Pittsburgh Pirates players, Dominican Republic sportspeople
Andrea Pollack	1961 births, 2019 deaths, Deaths from pancreatic cancer, German Olympic gold medalists, German Olympic silver medalists, German swimmers
Leroy Stanton	1946 births, 2019 deaths, Road accident deaths in the United States, New York Mets players, California Angels players, Seattle Mariners players, Sportspeople from South Carolina
Latta, South Carolina	Towns in South Carolina
Easton, Maryland	Towns in Maryland, County seats in Maryland
Denton, Maryland	Towns in Maryland, County seats in Maryland
Walter Kasper	1933 births, Living people, Cardinals of the Roman Catholic Church, German Roman Catholics
Godfried Danneels	1933 births, 2019 deaths, Belgian priests, Belgian Roman Catholics, Cardinals of the Roman Catholic Church, People from West Flanders, Roman Catholic archbishops
Drink coaster	Drinks
House of Glucksburg	Royal dynasties
Thirumanam (TV series)	Tamil-language television series, 2018 television series debuts
Muotathal	Municipalities of Schwyz, Villages in Schwyz
Unteriberg	Municipalities of Schwyz, Villages in Schwyz
Biberbrugg	Villages in Schwyz
Galgenen	Municipalities of Schwyz
Schübelbach	Municipalities of Schwyz
Altendorf, Schwyz	Municipalities of Schwyz, Villages in Schwyz
Innerthal	Municipalities of Schwyz
Reichenburg	Municipalities of Schwyz
Tuggen	Municipalities of Schwyz, Villages in Schwyz
Vorderthal	Municipalities of Schwyz
Wangen, Schwyz	Municipalities of Schwyz
Turtleneck	Tops (clothing)
Horry County, South Carolina	1800s establishments in South Carolina, 1801 establishments in the United States, South Carolina counties
Conway, South Carolina	Cities in South Carolina, County seats in South Carolina
Clarksville, Texas	Cities in Texas, County seats in Texas
Coldspring, Texas	Cities in Texas, County seats in Texas
Katharine Ross	Golden Globe Award winning actors, BAFTA Award winning actors, Saturn Award winners, 1940 births, Living people, American movie actors, American television actors, American stage actors, American voice actors, Actors from Los Angeles, California
Colors Tamil	Tamil-language television, Television channels, 2018 establishments in India
List of programs broadcast by Colors Tamil	Lists of television series by network
Verenahof	Exclaves, Canton of Schaffhausen, Geography of Baden-Württemberg
Long and short scales	Numerals
Vandhal Sridevi	Tamil-language television series, 2018 television series debuts
Fox Kids	Fox Broadcasting Company
Feliks Zemdegs	1995 births, Sportspeople from Melbourne, World record holders, Living people
Gliese 581 c	Exoplanets
Oviya (TV series)	Tamil-language television series, 2018 television series debuts
Whitney M. Young Magnet High School	Buildings and structures in Chicago, Illinois, Schools in Illinois, 1970s establishments in Illinois, 1975 establishments in the United States
Utrecht tram shooting	2019 crimes in Europe, 2019 mass shootings, 2010s in the Netherlands, 2010s mass shootings in Europe, 2010s murders in Europe, March 2019 events, Mass murder in 2019, Mass murder in Europe, Utrecht (city)
Norwood Junction railway station	Railway stations in London, Rail transport stations in London fare zone 4‎, 1839 establishments in Europe, 1830s establishments in England, London Borough of Croydon, London Overground stations
Lev Kamenev	1883 births, 1936 deaths, People from Moscow, Russian Revolution, Deaths by firearm, Executed people, Heads of state, Jewish atheists, Jewish politicians, Jewish writers, People from Tbilisi, Presidents of Russia, Prisoners sentenced to death, Russian Jews, Russian communists, Russian diplomats, Russian politicians, Russian writers, Socialists, Soviet Jews, Soviet politicians
Kepler-186f	Exoplanets
Alan Krueger	1960 births, 2019 deaths, Suicides in the United States, American economists, American educators, United States Council of Economic Advisers, People from Livingston, New Jersey, People from Princeton, New Jersey, Writers from New Jersey
Errol Barrow	1920 births, 1987 deaths, Prime Ministers of Barbados, North American politicians, Alumni of the London School of Economics, Lawyers, Military personnel of World War II, Privy Councillors (UK)
Democratic Labour Party (Barbados)	20th-century establishments in Barbados, 1950s establishments in North America, 1955 establishments, Political parties, Social democratic parties, Politics of Barbados
West Croydon station	1830s establishments in England, 1839 establishments in Europe, Railway stations in London, London Overground stations, London Borough of Croydon
St Albans School	980s establishments, 10th century establishments in Europe, Establishments in England, Schools in Hertfordshire
Sebastian	Given names
Transbrasil Flight 303	Aviation disasters in the 1980s, 20th century in Brazil, 1980s in South America, 1980, Santa Catarina, São Paulo
Kadungalloor	Towns in India, Settlements in Kerala
2014 Mount Ontake eruption	2014 disasters in Asia, 2014 in Japan, Disasters in Japan, Gifu Prefecture, Nagano Prefecture, Natural disasters in Asia, September 2014 events
Kenneth To	1992 births, 2019 deaths, Australian swimmers, Cardiovascular disease deaths in Florida, Deaths from cardiac arrest, People from Hong Kong, Sportspeople from Sydney
Mike Gravel 2020 presidential campaign	2020 United States presidential campaigns
Donald Kalpokas	1943 births, 2019 deaths, Deaths from disease, Diplomats, Prime ministers, Vanuatuan people
Stephen E. Ambrose	1936 births, 2002 deaths, American educators, American historians, American novelists, Biographers, Cancer deaths in the United States, Deaths from lung cancer, Disease-related deaths in Mississippi, Writers from Illinois, Writers from Wisconsin
Naseem Hamed	1974 births, Living people, British boxers, British Muslims, Sportspeople from Sheffield
Pringles	Snack foods
Born Again (The Notorious B.I.G. album)	1999 albums
Thessaly	Geography of Greece
Louis Gossett Jr.	African American actors, Academy Award winning actors, American television actors, American stage actors, American movie actors, Actors from Brooklyn, 1936 births, Living people, American voice actors, Emmy Award winning actors, Golden Globe Award winning actors, American television producers
Kassym-Jomart Tokayev	1953 births, Living people, Presidents of Kazakhstan, Prime Ministers of Kazakhstan, Current national leaders, Asian politicians
Prime Minister of Kazakhstan	Prime Ministers of Kazakhstan
President of Kazakhstan	Presidents of Kazakhstan
Dinmukhamed Kunaev	1912 births, 1993 deaths, Communist politicians, Kazakhstani politicians, Soviet politicians
Tim Peake	1972 births, Living people, Astronauts, British Army people, People from West Sussex
Maria (given name)	Given names
Rest energy	Relativity
Prison Break	2005 American television series debuts, 2009 American television series endings, 2000s American drama television series, 2010s American drama television series, American crime drama television series, Fox television series, Television series about brothers, Television series set in Chicago, Illinois, Television series set in Los Angeles, California, English-language television programs
Sarwar Danish	Vice Presidents of Afghanistan, 1961 births, Living people, Hazara politicians
Dominic Purcell	1970 births, Living people, Actors from Cheshire, Actors from Sydney, Australian movie actors, Australian television actors
Oswaldo Segura	Pages with unreviewed translations
Hugo Avilés	1962 births, Pages with unreviewed translations
Wenche Kvamme	1950 births, 2019 deaths, Deaths from breast cancer, People from Bergen, Norwegian singers, Norwegian movie actors, Norwegian television actors, Norwegian stage actors
Ilona Novák	1925 births, 2019 deaths, Hungarian sportspeople, Hungarian swimmers, Olympic gold medalists, People from Budapest
Jason David Frank	1973 births, Living people, American martial artists, American movie actors, American television actors
Okwui Enwezor	1963 births, 2019 deaths, Deaths from colorectal cancer, Nigerian writers, Poets, Educators, Critics
Dave Hood Jr.	1954 births, 2019 deaths, Deaths from brain cancer, State legislators of the United States, American judges, Politicians from Florida, US Republican Party politicians
Wiesław Kilian	1952 births, 2019 deaths, Deaths from cardiac arrest, Polish politicians
Jorge Insunza Becker	1936 births, 2019 deaths, Deaths from stroke, Chilean politicians, Communists, Chilean engineers
Andre Williams	1936 births, 2019 deaths, Deaths from colorectal cancer, Cancer deaths in Chicago, American R&B musicians, People from Bessemer, Alabama, Musicians from Alabama, Musicians from Detroit, Michigan
Chuck Harmon	1924 births, 2019 deaths, Cincinnati Reds players, St. Louis Cardinals players, Philadelphia Phillies players, Sportspeople from Indiana, Sportspeople from Ohio
Golf Manor, Ohio	Villages in Ohio
Marlen Khutsiev	Russian movie directors, 1925 births, 2019 deaths, People from Tbilisi
Randy Jackson (baseball)	1926 births, 2019 deaths, Brooklyn Dodgers players, Chicago Cubs players, Cleveland Indians players, Los Angeles Dodgers players, People from Little Rock, Arkansas, Sportspeople from Arkansas
Terje Nilsen	1951 births, 2019 deaths, Deaths from lung cancer, Norwegian singers, Norwegian writers, Songwriters
Teuscher	Swiss chocolate companies, Zürich
Noto (font)	Fonts
Dentures	Dentistry
Francis Quinn	1921 births, 2019 deaths, American Roman Catholics, People from Los Angeles, California, Roman Catholic bishops
Noel Hush	1924 births, 2019 deaths, Australian scientists, Chemists, Fellows of the Royal Society, Order of Australia, People from Sydney, University of Sydney alumni, University of Sydney faculty
Deo, Bihar	Settlements in Bihar, Towns in India
Chris Eubank	1966 births, Living people, Black British sportspeople, British boxers, Sportspeople from London
Chris Eubank Jr.	1989 births, Living people, Black British sportspeople, British boxers, Sportspeople from Sussex
Canelo Álvarez	1990 births, Living people, Boxers, Mexican sportspeople, People from Guadalajara
The Ship of the Dead	2017 books, Fantasy books, Children's books
Empusa	Greek legendary creatures
Catwoman (movie)	2004 movies, Warner Bros. movies, DC Comics movies, African-American superhero movies
Night-watchman state	Libertarianism, Capitalism, Liberalism
The Way of Walking Alone	17th century books
Colin Thiele	1920 births, 2006 deaths, Australian educators, Australian military people, Australian novelists, Deaths from heart failure, Military personnel of World War II, Order of Australia, People from South Australia
Hyponymy and hypernymy	Hierarchy
Bunia	Cities in Africa, Settlements in the Democratic Republic of the Congo
Retroactive continuity	Fiction
Equivalent weight	Physical chemistry
Capoid	Anthropology, Race
Big Boss	Video game characters
Contradiction	Words, Philosophical concepts
Rebel Alliance	Star Wars
Galactic Empire	Star Wars
Code name	Names, Espionage
Snapple	1970s establishments in Texas, 1972 establishments in the United States, American food companies, Drink companies, Companies based in Texas, Plano, Texas
Judith Resnik	1949 births, 1986 deaths, Accidental deaths in Florida, American astronauts, Engineers from Ohio, American Jews, NASA, Scientists from Akron, Ohio
Ellison Onizuka	1946 births, 1986 deaths, Accidental deaths in Florida, American astronauts, American engineers, Military people from Hawaii, NASA, United States Air Force
Ronald McNair	1950 births, 1986 deaths, Accidental deaths in Florida, African-American people, American academics, American astronauts, American physicists, Massachusetts Institute of Technology alumni, NASA, Scientists from South Carolina
Please Me	2019 songs, R&B songs, Hip hop soul songs
Peter Brock	1945 births, 2006 deaths, Accidental deaths in Australia, Australian racecar drivers, Deaths in sport, Order of Australia, Sportspeople from Melbourne
Gregory Jarvis	1950 births, 1986 deaths, Accidental deaths in Florida, American astronauts, Engineers from Michigan, American military people, NASA, Scientists from Detroit, Michigan, United States Air Force
Qingjiang biota	Lagerstätten, China, Cambrian
Sam Worthington	1976 births, Living people, Actors from Perth, Western Australia, Actors from Surrey, Australian Christians, Australian movie actors, Australian screenwriters, Australian television actors, Australian voice actors, Naturalised citizens of Australia
Jai Courtney	1986 births, Living people, Actors from Sydney, Australian movie actors, Australian television actors
Karen Uhlenbeck	1942 births, Living people, American educators, American mathematicians, Scientists from Cleveland, Ohio
Spooky Scary Skeletons	1996 songs, Holidays, YouTube
Larry Cohen	1941 births, 2019 deaths, American television directors, Movie directors from New York City, Movie producers from New York City, Screenwriters from New York City, Writers from Manhattan
Jeff Horn	1988 births, Living people, Australian boxers, Australian educators, Australian Olympians, People from Brisbane, Sportspeople from Queensland
Dick Smith (businessman)	1944 births, Living people, Australian activists, Australian businesspeople, Aviators, Order of Australia, People from Sydney, Australian philanthropists, Political activists
Kirsten Vangsness	American television actors, American movie actors, Actors from Pasadena, California, 1972 births, Living people
Vanessa Marano	American television actors, American movie actors, Actors from Los Angeles, California, 1992 births, Living people
Laura Marano	American television actors, American movie actors, Actors from Los Angeles, California, 1995 births, Living people
Islam in Russia	Islam by country, Russian culture
Good Friday Agreement	1990s treaties, 1998 in the United Kingdom, 1990s in Northern Ireland, Politics of Northern Ireland, Politics of Ireland, Belfast
Jan Łukasiewicz	1878 births, 1956 deaths, 20th century philosophers, Polish mathematicians, Polish Roman Catholics
Stylianos Harkianakis	1935 births, 2019 deaths, Archbishops, Australian Christians, Australian educators, Australian poets, Disease-related deaths in Sydney, Eastern Orthodox Christians, Greek writers, Theologians, University of Sydney faculty
Jock Sturrock	1915 births, 1997 deaths, Australian Olympic bronze medalists, Sailors, Members of the Order of the British Empire, Sportspeople from Melbourne
John Eccles (neurophysiologist)	1903 births, 1997 deaths, 20th century philosophers, Australian educators, Australian medical researchers, Australian Nobel Prize winners, Fellows of the Royal Society, Knights Bachelor, Neuroscientists, Order of Australia, People from Melbourne, Physiologists
John Yu	1934 births, Living people, Australian educators, Australian medical doctors, Chief executives, People from Nanjing, People from Sydney, University of Sydney alumni, Companions of the Order of Australia
Singing Stars	Tamil-language television series, 2019 television series debuts
Kershaw County, South Carolina	18th-century establishments in South Carolina, 1791 establishments in the United States, South Carolina counties
Comanche, Texas	Cities in Texas, County seats in Texas
BTS	South Korean boy bands, 2013 establishments in Asia, 2010s establishments in South Korea, K-pop music groups
Bigelow Tea Company	1945 establishments in the United States, Fairfield, Connecticut, Tea, Drink companies
Pius Adesanmi	2019 deaths, 1972 births, Aviation deaths, Canadian critics, Literary critics, Columnists, Nigerian writers
Sebastiano Tusa	1952 births, 2019 deaths, Aviation deaths, Italian writers, Italian politicians, Archaeologists
William Stanley Peart	1922 births, 2019 deaths, British physicians, Medical researchers, Scientists from London
Dick Dale	1937 births, 2019 deaths, Deaths from heart failure, Cardiovascular disease deaths in California, American rock guitarists, Musicians from Boston, Massachusetts
Loma Linda, California	Cities in California, Settlements in San Bernardino County, California
Bengt Gustafsson (general)	1933 births, 2019 deaths, Swedish people, Generals
Barbara Hammer	1939 births, 2019 deaths, Deaths from ovarian cancer, Cancer deaths in New York City, American autobiographers, American educators, Lesbian feminists, Movie directors from Los Angeles, California, LGBT people from Los Angeles, California
Tom Hatten	1926 births, 2019 deaths, American television personalities, American radio personalities, American movie actors, American television actors, Actors from North Dakota
Yann-Fañch Kemener	1957 births, 2019 deaths, French singers, French writers, Songwriters
Mohamed Mahmoud Ould Louly	1943 births, 2019 deaths, Presidents of Mauritania, Generals
Bill Phelps	1934 births, 2019 deaths, American lawyers, Politicians from Missouri, US Republican Party politicians
Mary Warnock, Baroness Warnock	1924 births, 2019 deaths, English philosophers, Educators, Writers from Hampshire
Gonzalo Portocarrero Maisch	1949 births, 2019 deaths, Deaths from lung cancer, Essayists, Peruvian educators, People from Lima
Patrick McGorry	1952 births, Living people, Australian academics, Australian activists, Australian educators, Australian medical doctors, Australian medical researchers, Order of Australia, People from Dublin, Psychiatrists, University of Sydney alumni
Lina Cheryazova	1968 births, 2019 deaths, Deaths from motor neurone disease, Olympic gold medalists, Uzbekistani people
Denise DuBarry	1956 births, 2019 deaths, Infectious disease deaths in Los Angeles, American movie actors, American television actors, American movie producers, American philanthropists, Actors from Texas, Businesspeople from Texas
Rafi Eitan	1926 births, 2019 deaths, Deaths from stroke, Former Members of Knesset, Government ministers of Israel, Jewish Israeli politicians, People of the Mossad, Spies
Fiona Stanley	1946 births, Living people, Australian medical doctors, Australian medical researchers, Epidemiology, Order of Australia, People from Perth, Western Australia, People from Sydney
Joseph Pilato	1949 births, 2019 deaths, American movie actors, American television actors, American voice actors, Actors from Boston, Massachusetts
Robert W. Sweet	1922 births, 2019 deaths, Deaths from pneumonia, American judges, People from Yonkers, New York, Politicians from New York City
Egon Balas	1922 births, 2019 deaths, Romanian people, Mathematicians
György Baló	1947 births, 2019 deaths, Deaths from esophageal cancer, Hungarian writers, Television presenters, Political commentators, People from Budapest
Pioneerof the Nile	2006 births, 2019 deaths, Deaths from myocardial infarction, Thoroughbred racehorses
John Carl Buechler	1952 births, 2019 deaths, Deaths from prostate cancer, Cancer deaths in Los Angeles, Make-up artists, American movie actors, Movie directors from Illinois, Movie producers from Illinois, Screenwriters from Illinois, Actors from Illinois, People from Belleville, Illinois
Raigh Roe	1922 births, 2014 deaths, Australian activists, Knights and Dames Commander of the Order of the British Empire, People from Western Australia
Servilius Casca	1st century BC, 80s BC births, 42 BC deaths, Year of birth unknown, Ancient people, Politicians, People who committed suicide, Roman Republic, Assassins
Siebnen	Villages in Schwyz
Gorgier	Former municipalities of Neuchâtel
Adam Goodes	1980 births, Living people, Australian rules footballers, Indigenous Australian activists, Indigenous Australian sportspeople, Sportspeople from South Australia, Sportspeople from Victoria (Australia)
Thielle-Wavre	Former municipalities of Neuchâtel
Vaumarcus	Former municipalities of Neuchâtel
Les Planchettes	Municipalities of Neuchâtel
Auvernier	Former municipalities of Neuchâtel, Villages in Neuchâtel
F.C. Dinamo Tbilisi	1925 establishments in Asia, Football clubs, Tbilisi
Bevaix	Former municipalities of Neuchâtel
La Coudre, Neuchâtel	Villages in Neuchâtel, Former municipalities of Neuchâtel
Pancracio Celdrán	1942 births, 2019 deaths, Spanish educators, Spanish journalists, Spanish historians, Spanish writers
Ted Burgin	1927 births, 2019 deaths, English footballers, English football managers, Sportspeople from Yorkshire
Master Fatman	1965 births, 2019 deaths, Comedians, Danish movie actors, Danish singers, Danish movie directors
Kevin McCarthy (actor)	Golden Globe Award winning actors, 1914 births, 2010 deaths, Deaths from pneumonia, Disease-related deaths in Massachusetts, American movie actors, American television actors, American stage actors, American voice actors, Actors from Seattle, Washington, Actors from Minneapolis, Minnesota
Hyannis, Massachusetts	Villages in Massachusetts
Barnstable, Massachusetts	Cities in Massachusetts, County seats in Massachusetts
Ray Kelly (singer)	Living people, 1953 births, Irish singers, Roman Catholic priests
Discrimination against non-binary people	LGBT, Discrimination
Microsoft Store	Microsoft Windows software, Windows games
Ranking Roger	1963 births, 2019 deaths, Black British musicians, Deaths from brain cancer, Deaths from lung cancer, English rock singers, Musicians from Birmingham
William Ward, 2nd Earl of Dudley	1867 births, 1932 deaths, Australian Governors-General, British Army officers, British Earls, British military personnel of World War I, Cancer deaths in London, Knights Grand Cross of the Order of St Michael and St George, Knights Grand Cross of the Order of the Bath, Knights Grand Cross of the Royal Victorian Order, Politicians from London
Hayden Fry	Cancer deaths in Texas, Deaths from prostate cancer, College football coaches, American football quarterbacks, Sportspeople from Texas, 1929 births, 2019 deaths, College Football Hall of Fame
Jussie Smollett	1982 births, African American actors, African-American singers, American television actors, American movie actors, Singers from California, Actors from California, Living people
David Hurley	1953 births, Living people, Australian Governors-General, Australian military people, Generals, Governors of New South Wales, People from New South Wales, Companions of the Order of Australia
Angela Carter	1940 births, 1992 deaths, British feminists, British socialists, Cancer deaths in England, Deaths from lung cancer, English novelists, English science fiction writers, English short story writers, Feminist writers, People from Eastbourne, Translators, Women linguists, Writers from Sussex
Stefan Savić	Manchester City F.C. players, Montenegrin footballers, Living people, 1991 births
Bôle	Former municipalities of Neuchâtel, Villages in Neuchâtel
Brot-Dessous	Former municipalities of Neuchâtel
Colombier, Neuchâtel	Former municipalities of Neuchâtel, Villages in Neuchâtel
Fresens	Former municipalities of Neuchâtel
Witold Pilecki	1901 births, 1948 deaths, Executed people, Prisoners of war, Polish Roman Catholics, World War II people, Crime victims, Nazi Germany
Montalchez	Former municipalities of Neuchâtel
Saint-Aubin-Sauges	Former municipalities of Neuchâtel
Corcelles-Cormondrèche	Municipalities of Neuchâtel
Cortaillod	Municipalities of Neuchâtel, Villages in Neuchâtel
Rochefort, Switzerland	Municipalities of Neuchâtel
Buttes	Former municipalities of Neuchâtel
Boveresse	Former municipalities of Neuchâtel
Couvet	Former municipalities of Neuchâtel
Fleurier	Former municipalities of Neuchâtel
Les Bayards	Former municipalities of Neuchâtel
Saint-Aubin, Neuchâtel	Former municipalities of Neuchâtel, Villages in Neuchâtel
Sauges	Former municipalities of Neuchâtel, Villages in Neuchâtel
Areuse	Former municipalities of Neuchâtel, Villages in Neuchâtel
Môtiers	Former municipalities of Neuchâtel
Noiraigue	Former municipalities of Neuchâtel
Thari (TV series)	Tamil-language television series, 2019 television series debuts
Saint-Sulpice, Neuchâtel	Former municipalities of Neuchâtel
Travers, Switzerland	Former municipalities of Neuchâtel
Enges	Municipalities of Neuchâtel
Saint-Blaise, Switzerland	Municipalities of Neuchâtel
Cornaux	Municipalities of Neuchâtel
Kindertransport	The Holocaust
Friedrich Achleitner	1930 births, 2019 deaths, Academics, Austrian architects, Austrian artists, Austrian poets, Critics, Austrian educators, People from Upper Austria
Yoji Harada	1972 births, 2019 deaths, Japanese artists, Musicians from Tokyo, Punk musicians, Participants in American reality television series, Rock musicians
Andrew Marshall (foreign policy strategist)	1921 births, 2019 deaths, American diplomats, Politicians from Detroit, Michigan
Andrew Marshall (Asia journalist)	1967 births, Living people, British journalists, Pulitzer Prize winners, Scottish writers
Bruce Yardley	1947 births, 2019 deaths, Australian cricketers, Cancer deaths in Australia, Coaches, Sportspeople from Western Australia
Gordon S. Wood	1933 births, Living people, American educators, American historians, Pulitzer Prize winners, Writers from Massachusetts
Jim Moody	1935 births, 2019 deaths, American economists, United States representatives from Wisconsin, US Democratic Party politicians, Politicians from Virginia, Politicians from Milwaukee, Wisconsin
Virgilio Caballero Pedraza	1942 births, 2019 deaths, Deaths from myocardial infarction, Mexican politicians
Lyle Tuttle	1931 births, 2019 deaths, American artists, People from Iowa
Kay Cottee	1954 births, Living people, Australian explorers, Order of Australia, Sailors, Sportspeople from Sydney, Writers from Sydney
Ukiah, California	Cities in California, County seats in California, Settlements in Mendocino County, California
W. H. Pugmire	1951 births, 2019 deaths, Deaths from myocardial infarction, American novelists, American science fiction writers, Writers from Seattle, Washington
Lee Kernaghan	1964 births, Living people, Australian country musicians, Australian guitarists, Australian singer-songwriters, Order of Australia, Musicians from Victoria (Australia), Singers from New South Wales
Valery Bykovsky	1934 births, 2019 deaths, Cosmonauts
Sigmund Jähn	1937 births, 2019 deaths, German scientists, Astronauts
Leonard Fenton	1926 births, Living people, British movie actors, British television actors, British television directors, British painters, British stage actors, British radio actors, Actors from London
British Medical Association	1830s establishments in the United Kingdom, 1832 establishments, Medical and health organizations in the United Kingdom, Organisations based in London
The Herd (South African series)	2018 television series debuts, 2010s drama television series, South African culture
Arthur Liebehenschel	Waffen-SS people, SS officers, Executed German people, People from Poznań, 1948 deaths, 1901 births, Articles with hAudio microformats, Pages with unreviewed translations
Le Landeron	Municipalities of Neuchâtel, Cities in Switzerland
Hauterive, Neuchâtel	Municipalities of Neuchâtel
Brot-Plamboz	Municipalities of Neuchâtel
Ali Mema	1943 births, 2019 deaths, Albanian footballers, Football managers, People from Tirana
La Brévine	Municipalities of Neuchâtel
La Chaux-du-Milieu	Municipalities of Neuchâtel
Les Ponts-de-Martel	Municipalities of Neuchâtel
La Côte-aux-Fées	Municipalities of Neuchâtel
Les Verrières	Municipalities of Neuchâtel
Cernier	Former municipalities of Neuchâtel, Villages in Neuchâtel
Les Hauts-Geneveys	Former municipalities of Neuchâtel
Boudevilliers	Former municipalities of Neuchâtel
Coffrane	Former municipalities of Neuchâtel
Fontaines, Switzerland	Former municipalities of Neuchâtel
Montmollin	Former municipalities of Neuchâtel
Dombresson	Former municipalities of Neuchâtel
Les Geneveys-sur-Coffrane	Former municipalities of Neuchâtel
Lancaster County, South Carolina	1785 establishments in South Carolina, South Carolina counties
Fontainemelon	Former municipalities of Neuchâtel
Murray Tyrrell	1913 births, 1994 deaths, Civil servants, Commanders of the Order of the British Empire, Commanders of the Royal Victorian Order, People from Victoria (Australia)
Akihito Kondo	1938 births, 2019 deaths, Japanese baseball players
Wong Tien Fatt	1954 births, 2019 deaths, Deaths from myocardial infarction, Malaysian politicians
Jon Skolmen	1940 births, 2019 deaths, Actors from Oslo, Norwegian comedians, Norwegian movie actors, Norwegian television actors, Norwegian television presenters, Norwegian voice actors
Total Drama All Stars and Pahkitew Island	Total Drama
Milo (drink)	1930s establishments in Australia, Drinks, Nestlé
British thermal unit	Imperial units, Units of measurement
Ed Westcott	1922 births, 2019 deaths, American photographers, People from Chattanooga, Tennessee, People from Nashville, Tennessee
Pierre Bourguignon	1942 births, 2019 deaths, Cardiovascular disease deaths in France, Deaths from myocardial infarction, French mayors, People from Rouen, Socialist Party (France) politicians
Chézard-Saint-Martin	Former municipalities of Neuchâtel
Engollon	Former municipalities of Neuchâtel
Fenin-Vilars-Saules	Former municipalities of Neuchâtel
Savagnier	Former municipalities of Neuchâtel
Le Pâquier, Neuchâtel	Former municipalities of Neuchâtel
Villiers, Switzerland	Former municipalities of Neuchâtel
Epagnier	Former municipalities of Neuchâtel, Villages in Neuchâtel
Marin, Neuchâtel	Former municipalities of Neuchâtel, Villages in Neuchâtel
Frederic Forrest	1936 births, Living people, American movie actors, American television actors, American stage actors, Actors from Texas, People from Waxahachie, Texas
Henry Stern	1935 births, 2019 deaths, Deaths from Parkinson's disease, Disease-related deaths in New York City, Politicians from New York City
Voëns-Maley	Former municipalities of Neuchâtel, Villages in Neuchâtel
Brot-Dessus	Former municipalities of Neuchâtel, Villages in Neuchâtel
Plamboz	Former municipalities of Neuchâtel, Villages in Neuchâtel
Combes, Switzerland	Former municipalities of Neuchâtel, Villages in Neuchâtel
Arlen Ness	1939 births, 2019 deaths, American artists, Businesspeople from Minnesota
Ken Bald	1920 births, 2019 deaths, American illustrators, American comics artists, Artists from New York City
Mount Arlington, New Jersey	Boroughs in New Jersey
Elly Mayday	1988 births, 2019 deaths, Deaths from ovarian cancer, Canadian models, Canadian activists, People from Saskatchewan, People from Vancouver
Vilars, Switzerland	Former municipalities of Neuchâtel, Villages in Neuchâtel
Lee County, South Carolina	20th-century establishments in South Carolina, 1902 establishments in the United States, South Carolina counties
Lexington County, South Carolina	1785 establishments in South Carolina, South Carolina counties
Dumas, Texas	Cities in Texas, County seats in Texas
Fenin	Former municipalities of Neuchâtel, Villages in Neuchâtel
Saules, Neuchâtel	Former municipalities of Neuchâtel, Villages in Neuchâtel
1980 Quebec referendum	1980 elections, 1980s in Canada, Politics of Canada, Quebec, May events, Elections in Canada
2022 Asian Games	2022 in sports, 21st century in China, 2020s in Asia, Asian Games, Hangzhou, Sport in China
2019 Xiangshui chemical plant explosion	2019 in Asia, 2010s explosions in Asia, 21st century in China, Disasters in China, Explosions in 2019, March 2019 events
Vernéaz	Former municipalities of Neuchâtel, Villages in Neuchâtel
Wavre, Switzerland	Former municipalities of Neuchâtel, Villages in Neuchâtel
Thielle, Switzerland	Former municipalities of Neuchâtel, Villages in Neuchâtel
Les Eplatures	Former municipalities of Neuchâtel, Villages in Neuchâtel
Speculation tax	British Columbia, Taxation in Canada, Politics of Canada, Houses, Law, Legislation
Romont, Fribourg	Municipalities of Fribourg, Cities in Switzerland
Tafers	Municipalities of Fribourg
Estavayer	2017 establishments in Switzerland, Municipalities of Fribourg
List of cities in British Columbia	Cities in British Columbia, Lists of cities in Canada
Marlboro County, South Carolina	1785 establishments in South Carolina, South Carolina counties
McCormick County, South Carolina	20th-century establishments in South Carolina, 1916 establishments in the United States, South Carolina counties
Broye (district)	Districts of Fribourg
See (district)	Districts of Fribourg
Wil (Wahlkreis)	Districts of St. Gallen
St. Gallen (Wahlkreis)	Districts of St. Gallen
Biocenosis	Ecology
TRAPPIST-1	Red dwarfs
Bebe Rexha	Singers from New York City, Award winners, 1989 births, Living people
Lee Miglin	1924 births, 1997 deaths, Murders by blade weapons, Deaths by beating, American murder victims, Real estate developers, American philanthropists, Businesspeople from Chicago
Westville, Illinois	Villages in Illinois
Andrew Cunanan	1969 births, 1997 deaths, Murderers who committed suicide, American serial killers, People with antisocial personality disorder, Gay men, LGBT criminals, LGBT people from California, Criminals from California, People from San Diego, California
Rush City, Minnesota	Cities in Minnesota
Darren Criss	Golden Globe Award winning actors, Emmy Award winning actors, 1987 births, Living people, American LGBT rights activists, American movie actors, American television actors, American stage actors, American voice actors, American pop singers, American pop musicians, American pianists, American guitarists, American drummers, Musicians from San Francisco, Writers from San Francisco, Actors from San Francisco, Singer-songwriters from California, American Internet celebrities
Hugo, Minnesota	Towns in Minnesota
Jason Reese	1967 births, 2019 deaths, British engineers, British scientists
Dobrica Erić	1936 births, 2019 deaths, Deaths from lung cancer, Poets, Novelists, People from Belgrade
Édgar Ramírez	1977 births, Living people, Venezuelan entertainers, Movie actors, Television actors, Voice actors, Venezuelan journalists
Geoff Harvey	1935 births, 2019 deaths, Australian musicians, Australian entertainers, English pianists, Conductors, Musicians from London, Television personalities from London
Louise Bourgeois	American painters, 1911 births, 2010 deaths
Ruben Tovmasyan	1937 births, 2019 deaths, Deaths from thyroid cancer, Armenian politicians, Communists
Cobh	Establishments in the Republic of Ireland, 18th century establishments in Europe, Towns in Ireland, County Cork
Frances Farmer	American television actors, American stage actors, American movie actors, Actors from Seattle, Washington, 1913 births, 1970 deaths
Zuzana Čaputová	1973 births, Living people, Political activists, Women lawyers, Presidents of Slovakia, Current national leaders
Volodymyr Zelensky	1978 births, Living people, Ukrainian movie directors, Presidents of Ukraine, Ukrainian actors, Ukrainian Jews, Ukrainian screenwriters, Current national leaders
Eduardo Fajardo	1924 births, 2019 deaths, Spanish movie actors
José Terrón	1939 births, 2019 deaths, Actors from Madrid, Spanish movie actors
Héctor Alterio	1929 births, Living people, Argentine movie actors, People from Buenos Aires
Julieta Serrano	1933 births, Living people, Spanish movie actors, Spanish television actors, Spanish stage actors, People from Barcelona
Marisa Paredes	1946 births, Living people, Spanish movie actors, Spanish television actors, Spanish stage actors, Actors from Madrid
Deaths in April 2019	2019 deaths, April 2019 events
Tottenham Hotspur Stadium	National Football League venues, Football stadiums in London
Jenny Shipley	Prime Ministers of New Zealand, 1952 births, Living people, Leaders of the Opposition (New Zealand)
Chinatown	Chinese culture
Battle of Shiroyama	1877, 19th century in Asia, Battles involving Japan, September events
Corporal punishment	Psychology, Family
Domenico Giannace	1924 births, 2019 deaths, Basilicata, Communist politicians, Italian communists, Italian politicians, Mayors, Trade unionists
Glâne (district)	Districts of Fribourg
Susan Flannery	Golden Globe Award winning actors, Emmy Award winning actors, People from Jersey City, New Jersey, LGBT people from New Jersey, LGBT actors, Lesbians, American television directors, American television actors, Actors from New Jersey, 1939 births, Living people
Gruyère (district)	Districts of Fribourg
Saane (district)	Districts of Fribourg
Sense (district)	Districts of Fribourg
Veveyse (district)	Districts of Fribourg
Conroe, Texas	Cities in Texas, County seats in Texas
Nipsey Hussle	1985 births, 2019 deaths, Murders by firearm in California, American rap musicians from California, Musicians from Los Angeles, California
Tania Mallet	1941 births, 2019 deaths, Actors from Lancashire, Actresses who played Bond girls, English models, English movie actors, English television actors, People from Blackpool
Gauss's law for magnetism	Electromagnetism, Laws of physics
Fokker	Companies of the Netherlands, Aircraft companies, 1916 establishments in Europe, 1910s establishments in the Netherlands
Peter Coleman	1928 births, 2019 deaths, Alumni of the London School of Economics, Australian journalists, Biographers, Administrators of Norfolk Island, Australian essayists, Liberal Party of Australia politicians, Members of the Australian House of Representatives, Order of Australia, Politicians from Melbourne, University of Sydney alumni, Writers from Melbourne
Ron Elvidge	1923 births, 2019 deaths, New Zealand rugby union players, People from South Island, Physicians
Reiwa period	Japanese eras, 2010s establishments in Japan, 2019 establishments
Rafael Sánchez Ferlosio	1927 births, 2019 deaths, Spanish essayists, Spanish novelists, Writers from Rome
Len Fontaine	1948 births, 2019 deaths, Detroit Red Wings players, Ice hockey people from Quebec, People from Quebec City
Kurt Armbruster	1934 births, 2019 deaths, 1966 FIFA World Cup players, Sportspeople from Zürich, Swiss footballers
Stakeholder	Economics, Business
Köbi Kuhn	1943 births, 2019 deaths, 1966 FIFA World Cup players, Swiss football managers, Sportspeople from Zürich, Swiss footballers
Fritz Künzli	1946 births, 2019 deaths, 1966 FIFA World Cup players, Swiss footballers
Peter Cetera	1944 births, Living people, American bass guitarists, American pop singers, American rock guitarists, American rock singers, American singer-songwriters, Grammy Award winners, Rock and Roll Hall of Fame inductees, Singers from Chicago, Tenors
David Foster	1949 births, Living people, Canadian composers, Canadian pop musicians, Canadian songwriters, Emmy Award winners, Grammy Award winners, Keyboardists, Musicians from British Columbia, Order of Canada, People from Victoria, British Columbia, Canadian pianists, Record producers
Rheintal (Wahlkreis)	Districts of St. Gallen
Rorschach (Wahlkreis)	Districts of St. Gallen
Sarganserland	Districts of St. Gallen
See-Gaster	Districts of St. Gallen
Toggenburg (Wahlkreis)	Districts of St. Gallen
Werner Leimgruber	1934 births, Living people, 1966 FIFA World Cup players, People from Bern, Swiss footballers
Werdenberg (Wahlkreis)	Districts of St. Gallen
Barbara Jordan	US Democratic Party politicians, Politicians from Houston, Texas, African American politicians, 1936 births, 1996 deaths
Jean-Claude Schindelholz	1940 births, Living people, 1966 FIFA World Cup players, Swiss footballers
Curl	Calculus
Mohamad Chatah	1951 births, 2013 deaths, Ambassadors of Lebanon, Assassinated people, Economists, Lebanese politicians, Muslims, People murdered in Asia
Grabs	Municipalities of St. Gallen
Cooper, Texas	Cities in Texas, County seats in Texas
Newberry County, South Carolina	1785 establishments in South Carolina, South Carolina counties
Rheineck	Municipalities of St. Gallen, Cities in Switzerland
Mels	Municipalities of St. Gallen
Bad Ragaz	Municipalities of St. Gallen, Ski areas and resorts in Switzerland, Spa towns
Jane Smiley	Writers from Missouri, Writers from California, 1949 births, Living people
Sinéad Cusack	Irish actors, Actors from Dublin‎, 1948 births, Living people
Rubén Blades	Television actors, Movie actors, Latin singers, Grammy Award winners, People from Panama City, 1948 births, Living people
Abbey Theatre	Theatres, History of Dublin
Augusta, Lady Gregory	Irish novelists, 1852 births, 1932 deaths
Olavi Mannonen	1930 births, 2019 deaths, Disease-related deaths in Finland, Finnish Olympic silver medalists, Medalists at the 1956 Summer Olympics, Medalists at the 1952 Summer Olympics, Police officers
List of cities in Alberta	Cities in Alberta, Lists of cities in Canada
J. Mahendran	1939 births, 2019 deaths, Indian movie actors, Indian movie directors, Indian writers, People from Tamil Nadu, Tamil actors, Tamil directors
Francisco Massiani	1944 births, 2019 deaths, Novelists, Painters, People from Caracas, Poets, Short story writers
Sally Jessy Raphael	American television talk show hosts, People from Pennsylvania, Emmy Award winners, 1935 births, Living people
Vonda N. McIntyre	1948 births, 2019 deaths, American novelists, American science fiction writers, Cancer deaths in the United States, Deaths from pancreatic cancer, Disease-related deaths in Washington (state), Hugo Award winners, Writers from Louisville, Kentucky, Star Trek
Barrie Hole	1942 births, 2019 deaths, Aston Villa F.C. players, People from Swansea, Welsh footballers
Pete Rose	Sportspeople from Cincinnati, Ohio, Cincinnati Reds players, Philadelphia Phillies players, Montreal Expos players, 1941 births, Living people
Kit Napier	1943 births, 2019 deaths, Scottish footballers
Kate Miller-Heidke	1981 births, Living people, Actors from Queensland, Australian movie actors, Australian pop singers, Australian singer-songwriters, Australian television actors, Eurovision Song Contest entrants, Musicians from Brisbane, Sopranos
Norman Thomas Gilroy	1896 births, 1977 deaths, Australian Roman Catholics, Cardinals of the Roman Catholic Church, Knights and Dames Commander of the Order of the British Empire, People from Sydney, Roman Catholic archbishops
Dimitar Dobrev	1931 births, 2019 deaths, Bulgarian sportspeople, Olympic gold medalists, Olympic silver medalists, Medalists at the 1956 Summer Olympics, Medalists at the 1960 Summer Olympics, Wrestlers
Don Williamson	1934 births, 2019 deaths, American mayors, Businesspeople from Michigan, Deaths from respiratory failure, People from Flint, Michigan, Politicians from Michigan, US Democratic Party politicians
Antonio Permunian	1930 births, 2020 deaths, 1962 FIFA World Cup players, Association football goalkeepers, Swiss footballers
Willy Kernen	1929 births, 2009 deaths, 1950 FIFA World Cup players, 1954 FIFA World Cup players, 1962 FIFA World Cup players, Swiss footballers
Space flight simulation game	Simulator video games
Michael Stipe	1960 births, Living people, American LGBT people, American movie producers, American rock singers, American singer-songwriters, Grammy Award winners, LGBT singers, Musicians from Georgia (U.S. state), People from Decatur, Georgia, Queer people, Rock and Roll Hall of Fame inductees
Bill Berry	1958 births, Living people, American bass guitarists, American rock drummers, American rock guitarists, American songwriters, Grammy Award winners, Musicians from Minnesota, People from Duluth, Minnesota, Rock and Roll Hall of Fame inductees
Oconee County, South Carolina	19th-century establishments in South Carolina, 1868 establishments in the United States, South Carolina counties
Walhalla, South Carolina	Cities in South Carolina, County seats in South Carolina
Hedi Turki	1922 births, 2019 deaths, Tunisian artists, Tunisian academics, People from Tunis
Noureddine Bedoui	1959 births, Living people, Current national leaders, Prime Ministers of Algeria
Abdelkader Bensalah	1941 births, 2021 deaths, Presidents of Algeria, Deaths from the COVID-19 pandemic, Deaths from cancer
Jenna Fischer	1974 births, Living people, American movie actors, American television actors, American voice actors, Actors from Indiana, Actors from St. Louis, Missouri, People from Fort Wayne, Indiana
Bev Clarno	1936 births, Living people, Politicians from Oregon, US Republican Party politicians
Sudarat Keyuraphan	1961 births, Living people, Thai politicians
Longmont, Colorado	Cities in Colorado
2019–20 Premier League	Premier League, 2020 in association football, 2019 in association football
Bear Valley, Alpine County, California	Cities in California, Settlements in Alpine County, California
List of cities in Ontario	Cities in Ontario, Lists of cities in Canada
List of towns in Quebec	Cities and towns in Quebec, Lists of cities in Canada
Kim Dotcom	1974 births, Living people, Extradition, Finnish people, German businesspeople, German political activists, People from Kiel
Isaiah Firebrace	1999 births, Living people, Australian pop singers, Eurovision Song Contest entrants, Indigenous Australian musicians, Musicians from Victoria (Australia), Singers from New South Wales
Anton Allemann	1936 births, 2008 deaths, 1962 FIFA World Cup players, Cardiovascular disease deaths in Switzerland, Deaths from myocardial infarction, Swiss footballers
United Nations Secretariat Building	United Nations, Buildings_and_structures_in_Manhattan, Buildings and structures completed in the 20th century, Skyscrapers in New York City
Rauf Denktaş	1924 births, 2012 deaths, Deaths from multiple organ failure, Prime Ministers of Northern Cyprus, Presidents of Northern Cyprus, Speakers of the Assembly of Northern Cyprus
Felix Hoffmann	1868 births, 1946 deaths, German chemists, German inventors, People from Baden-Württemberg
Banh mi	Sandwiches, Vietnamese food
Northwestern China	Geography of China
Aqaba	Cities in Jordan, Ports and harbours
Aiken, South Carolina	Cities in South Carolina, County seats in South Carolina
Philippi, West Virginia	Cities in West Virginia, County seats in West Virginia
Barbour County, West Virginia	West Virginia counties
Lewisburg, West Virginia	Cities in West Virginia, County seats in West Virginia
Orangeburg County, South Carolina	18th-century establishments in South Carolina, 1769 establishments in the Thirteen Colonies, South Carolina counties
Pickens County, South Carolina	19th-century establishments in South Carolina, 1826 establishments in the United States, South Carolina counties
Saluda County, South Carolina	19th-century establishments in South Carolina, 1896 establishments in the United States, South Carolina counties
Bobby Cox	1941 births, Living people, New York Yankees players, Businesspeople from Tulsa, Oklahoma, Sportspeople from Tulsa, Oklahoma
Michael E. Busch	1947 births, 2019 deaths, Deaths from pneumonia, Deaths from surgical complications, Deaths from liver disease, Politicians from Baltimore, Maryland, US Democratic Party politicians
Leetsch C. Hsu	1920 births, 2019 deaths, Chinese educators, Chinese mathematicians
Spartanburg County, South Carolina	1785 establishments in South Carolina, South Carolina counties
Williamsburg County, South Carolina	1800s establishments in South Carolina, 1804 establishments, South Carolina counties
Briny Breezes, Florida	Towns in Florida, Palm Beach County, Florida
Aleksey Buldakov	1951 births, 2019 deaths, Deaths from blood clot, Soviet movie actors, Soviet television actors, Russian movie actors, Russian television actors
Harmony Korine	1973 births, Living people, Actors from Nashville, Tennessee, American screenwriters, Jewish American actors, Jewish American writers, Movie directors from California, Writers from Nashville, Tennessee, Screenwriters from California
Rachel Korine	1986 births, Living people, American movie actors, American television actors, Actors from Nashville, Tennessee
Philippe Pottier	1938 births, 1985 deaths, 1962 FIFA World Cup players, Swiss footballers
Charles Antenen	1929 births, 2000 deaths, 1950 FIFA World Cup players, 1954 FIFA World Cup players, 1962 FIFA World Cup players, Swiss footballers
David Pearce (boxer)	1959 births, 2000 deaths, British boxers, People from Newport, Welsh sportspeople
William Monahan	1960 births, Living people, Academy Award winning writers, American journalists, American novelists, Movie directors from Massachusetts, Screenwriters from Massachusetts, Writers from Boston, Massachusetts, People from Dorchester, Massachusetts
Angela's Ashes	Historical movies, 1990s drama movies, 1999 drama movies
John Farnham	1949 births, Living people, Actors from Melbourne, Australian pop singers, Australian rock singers, Australian stage actors, Musicians from Melbourne, Naturalised citizens of Australia, Order of Australia, Singers from Essex
Marcel Mauron	1929 births, Living people, 1954 FIFA World Cup players, Swiss football managers, Swiss footballers
Alcor	Non-profit organizations of the United States, Companies of the United States, Scottsdale, Arizona
Roger Vonlanthen	1930 births, Living people, 1954 FIFA World Cup players, 1962 FIFA World Cup players, Swiss football managers, Swiss footballers
Broad Front (Uruguay)	Uruguay, Political parties in South America
Turf Moor	Football stadiums in England
Tim Ryan 2020 presidential campaign	2020 United States presidential campaigns
Mpaka	Towns in Africa, Settlements in Eswatini
Arbitrary code execution	Computer security
Corsicana, Texas	Cities in Texas, County seats in Texas
Mason, Texas	Cities in Texas, County seats in Texas
Cotulla, Texas	Cities in Texas, County seats in Texas
Crockett, Texas	Cities in Texas, County seats in Texas
Crosbyton, Texas	Cities in Texas, County seats in Texas
Richmond, Texas	Cities in Texas, County seats in Texas
Crowell, Texas	Cities in Texas, County seats in Texas
Bobby Clarke	1949 births, Living people, Bill Masterton Memorial Trophy winners, Canadian ice hockey centres, Flin Flon Bombers players, Hart Memorial Trophy winners, Hockey Hall of Fame inductees, Ice hockey people from Manitoba, Philadelphia Flyers players, People from Manitoba, Stanley Cup champions
Cuero, Texas	Cities in Texas, County seats in Texas
Georges Stuber	1925 births, 2006 deaths, Swiss footballers, 1950 FIFA World Cup players, 1954 FIFA World Cup players
Dustin Slade	1986 births, Brandon Wheat Kings players, Canadian ice hockey goaltenders, Ice hockey people from British Columbia, Kamloops Blazers players, Living people, Regina Pats players, Vancouver Giants players
Georgiy Daneliya	1930 births, 2019 deaths, Deaths from heart failure, Deaths from respiratory failure, Disease-related deaths in Moscow, People from Tbilisi, Russian movie directors, Russian screenwriters, Soviet writers
Flums	Municipalities of St. Gallen
Jim Playfair	1964 births, Calgary Wranglers players, Chicago Blackhawks players, Edmonton Oilers players, Ice hockey people from British Columbia, Living people, Portland Winterhawks players, American Hockey League players, International Hockey League (1945–2001) players, Ice hockey defencemen
Ryan Walter	1958 births, Calgary Wranglers players, Canadian ice hockey centres, Ice hockey people from British Columbia, Kamloops Chiefs players, Living people, Montreal Canadiens players, National Hockey League broadcasters, Seattle Breakers players, Stanley Cup champions, Vancouver Canucks players, Washington Capitals players
Glenn Anderson	1960 births, Canadian ice hockey right wingers, Edmonton Oilers players, Hockey Hall of Fame inductees, Ice hockey people from British Columbia, Living people, New Westminster Bruins players, New York Rangers players, St. Louis Blues players, Seattle Breakers players, Sportspeople from Vancouver, Stanley Cup champions, Toronto Maple Leafs players
Joe Ward (ice hockey)	1961 births, Canadian ice hockey centres, Colorado Rockies (NHL) players, Ice hockey people from Ontario, Living people, Seattle Breakers players, International Hockey League (1945–2001) players, Central Professional Hockey League players
Rob Flockhart	1956 births, 2021 deaths, Canadian ice hockey left wingers, Ice hockey people from British Columbia, Kamloops Chiefs players, Minnesota North Stars players, Vancouver Canucks players
Barry Melrose	1956 births, Canadian ice hockey defencemen, Detroit Red Wings players, Ice hockey people from Saskatchewan, Kamloops Chiefs players, Living people, National Hockey League broadcasters, Toronto Maple Leafs players, Winnipeg Jets (1979–96) players, American Hockey League players, World Hockey Association players
Alberto Cortez	1940 births, 2019 deaths, Deaths from gastrointestinal hemorrhage, Argentine singers, Disease-related deaths in Madrid, Singer-songwriters
Cellophane	Polymers, Biochemistry, Materials
Maurice Pon	1921 births, 2019 deaths, French songwriters, Lyricists, People from Bordeaux
Pfäfers	Municipalities of St. Gallen
Fräschels	Municipalities of Fribourg
Gibloux	2016 establishments in Switzerland, Municipalities of Fribourg
Grolley	Municipalities of Fribourg
Cheyres-Châbles	2017 establishments in Switzerland, Municipalities of Fribourg
Belmont-Broye	2016 establishments in Switzerland, Municipalities of Fribourg
Jackie Robinson Day	Baseball
Sam Sullivan	1960 births, Living people, Liberals, Mayors of Vancouver, Order of Canada, People with disabilities, Real estate
Infiorata di Genzano	Festivals in Europe, Rome
Basque Country (autonomous community)	Basque Country
Einaras von Gravrock	Living people, American businesspeople, Year of birth missing (living people)
Daniel Kaluuya	1989 births, Living people, Actors from London, Golden Globe Award winning actors, BAFTA Award winning actors, Black British actors, English movie actors, English television actors, English television writers, Writers from London, Best Supporting Actor Academy Award winners
Letitia Wright	1993 births, Living people, Actors from London, BAFTA Award winning actors, Black British actors, English movie actors, English television actors, Guyanese people, People from Tottenham
National Students' Union of India	1970s establishments in India, 1972 establishments in Asia, Organizations based in Asia, New Delhi
Mill Creek Falls	Waterfalls, Oregon
Gustav Nossal	1931 births, Living people, Australian academics, Australian biologists, Australian educators, Australian Jews, Australian medical researchers, Australian Roman Catholics, Commanders of the Order of the British Empire, Immunologists, Jewish academics, Jewish scientists, Jewish writers, Knights Bachelor, Naturalised citizens of Australia, Order of Australia, Scientists from Vienna, Writers from Vienna, University of Sydney alumni, Writers from Sydney
Bookbinding	Book terminology, Occupations
John Quarmby	1929 births, 2019 deaths, Actors from Liverpool, Alumni of the Royal Academy of Dramatic Art, British military people, English movie actors, English stage actors, English television actors
Đồng Sĩ Nguyên	1923 births, 2019 deaths, Communist politicians, Military personnel of the Vietnam War, Vietnamese military people, Vietnamese politicians
Mont-Vully	2016 establishments in Switzerland, Municipalities of Fribourg
Val-de-Charmey	2014 establishments in Switzerland, Municipalities of Fribourg
Alterswil	Municipalities of Fribourg
Arconciel	Municipalities of Fribourg
Schmitten, Fribourg	Municipalities of Fribourg
Wünnewil-Flamatt	Municipalities of Fribourg
St. Antoni	Municipalities of Fribourg
Carmelita Pope	1924 births, 2019 deaths, Actors from Chicago, American movie actors, American stage actors, American television actors
Bösingen, Switzerland	Municipalities of Fribourg
Plaffeien	Municipalities of Fribourg
Brünisried	Municipalities of Fribourg
Pat Cleveland	1950 births, Living people, People with cancer, Models from New York City
Giffers	Municipalities of Fribourg
Jeremy Bowen	1960 births, Living people, BBC people, Political commentators, Welsh journalists, British television presenters, Television news anchors, People with cancer, People from Cardiff
Ueberstorf	Municipalities of Fribourg
Muntelier	Municipalities of Fribourg
Daingerfield, Texas	Cities in Texas, County seats in Texas
De Smet, Idaho	Census-designated places in Idaho
Maryville, Tennessee	Cities in Tennessee, County seats in Tennessee
Katrin Sjögren	1966 births, Living people, Åland Islands, Finnish politicians, Government ministers
René Fontès	1941 births, 2019 deaths, Cardiovascular disease deaths in France, Deaths from myocardial infarction, French mayors, Legion of Honour, Rugby union
Nikolay Kovalyov (politician)	1949 births, 2019 deaths, Disease-related deaths in Moscow, People from Moscow, Russian politicians
Gresham College	1590s establishments in England, 1597 establishments, Colleges and universities in London
Edmund Gunter	1581 births, 1626 deaths, People educated at Westminster School, London, British mathematicians
Melvin Van Peebles	Writers from Chicago, American stage actors, American movie actors, African American movie directors, Actors from Chicago, 1932 births, 2021 deaths, Movie directors from Chicago
Damon Wayans Jr.	American television actors, American movie actors, American comedians, Actors from Vermont, 1982 births, Living people
Michael Ironside	Canadian television actors, Canadian movie actors, Actors from Toronto, 1950 births, Living people
Phonograph cylinder	Audio technology, Music technology
Olli Mäki	1936 births, 2019 deaths, Boxers, Coaches, Deaths from Alzheimer's disease, Finnish sportspeople
Shawn Smith	1965 births, 2019 deaths, American keyboard players, American rock musicians, American singer-songwriters, Deaths from aortic dissection, Deaths from diabetes, Musicians from Washington, People from Spokane, Washington
Soviet satellite state	Political systems, Soviet Union, Colonialism
Barry Malkin	1938 births, 2019 deaths, American movie editors
Marilyn Mason	1925 births, 2019 deaths, American educators, American keyboard players, Musicians from Michigan, Musicians from Oklahoma, Organists, People from Ann Arbor, Michigan
Jon Østeng Hov	1936 births, 2019 deaths, Columnists, Conservation, Norwegian writers, Photographers
Ralph S. Greco	2019 deaths, 1942 births, American physicians, American sculptors, Cancer deaths in California, Deaths from prostate cancer, People from the Bronx, Surgeons, Yale University alumni
Marysville, California	Cities in California, County seats in California, Settlements in Yuba County, California
Franz Weber (activist)	1927 births, 2019 deaths, Animal rights activists, Environmentalists, Swiss journalists, People from Basel
Daniela Peštová	1970 births, Living people, Czech models
Alturas, California	Cities in California, County seats in California, Modoc County, California, 1901 establishments in the United States, 1900s establishments in California
Attalens	Municipalities of Fribourg
Oberschrot	Former municipalities of Fribourg
Zumholz	Former municipalities of Fribourg
Heitenried	Municipalities of Fribourg
Plasselb	Municipalities of Fribourg
Rechthalten	Municipalities of Fribourg
St. Silvester	Municipalities of Fribourg
St. Ursen	Municipalities of Fribourg
Ried bei Kerzers	Municipalities of Fribourg
Gurmels	Municipalities of Fribourg
Madisonville, Texas	Cities in Texas, County seats in Texas
Don Alden Adams	1925 births, Living people, American Christians, Christian religious leaders, Jehovah's Witnesses people, People from Oak Park, Illinois
Adele Addison	1925 births, Living people, African-American singers, American opera singers, People from Springfield, Massachusetts, Singers from Massachusetts, Singers from New York City, Sopranos
List of Ottawa neighborhoods	Ottawa, Canada-related lists
Billie Eilish	Grammy Award winners, American singer-songwriters, Alternative music, 2001 births, Living people, American pop singers, American pop musicians, Musicians from Los Angeles, California, Singers from Los Angeles, California, Writers from Los Angeles, California
Communist Party of Greece	20th century establishments in Greece, 1918 establishments in Europe, Communist parties, Political parties in Greece, Athens
Union Public Service Commission	1920s establishments in India, 1926 establishments in Asia, Public services, Government of India, New Delhi
Lao People's Revolutionary Party	1955 establishments in Asia, Communist parties, Laos
Communist Party of Chile	1920s establishments in Chile, 1922 establishments, Communist parties, Politics of Chile
Angelo Acerbi	1925 births, Living people, Italian Roman Catholics, Liguria, Roman Catholic archbishops
Isle of Palms, South Carolina	Cities in South Carolina
Redoute's Choice	1996 births, 2019 deaths, Deaths by euthanasia, Thoroughbred racehorses
Laminitis	Diseases
Paula Garcés	1974 births, Living people, Colombian entertainers, American movie actors, American television actors, American voice actors, Naturalized citizens of the United States
Vodka (horse)	2004 births, 2019 deaths, Thoroughbred racehorses
Philip Greaves	1931 births, Living people, Governors-General of Barbados
Tetiana Chornovol	1979 births, Living people, Activists, Polish journalists, People from Kiev, Ukrainian politicians, Ukrainian writers, Free Media Award winners
SmoshCast	Podcasting
Philip Nitschke	1947 births, Living people, Australian activists, Australian medical doctors, Australian writers, Euthanasia activists, Humanists, People from South Australia
Sacred fig	Moraceae
Fayez al-Sarraj	1960 births, Heads of state of Libya, Living people, People from Tripoli, Prime Ministers of Libya
Tornado outbreak of April 2–3, 1982	Tornado outbreaks, Tornadoes in the United States, 1980s in Texas, 20th century in Oklahoma, Disasters in the 1980s, 1982 in the United States, April events
Motorcycle trials	Motorcycling, Trials
The Pokémon Company	Video game companies
Abbasanta	Communes of Sardinia
Aggius	Communes of Sardinia
Aglientu	Communes of Sardinia
Cho Yang-ho	1949 births, 2019 deaths, Disease-related deaths in Los Angeles, People from Incheon, South Korean businesspeople
Jim Glaser	1936 births, 2019 deaths, American country guitarists, American country singers, American singer-songwriters, Deaths from myocardial infarction, Singers from Nebraska
Empty Homes Tax	Vancouver, Taxation in Canada, Politics of Canada, Houses, Law
La Cité collégiale	Colleges and universities in Canada, Ottawa
List of Kyoto universities	Lists of universities
Lloyd McDermott	1939 births, 2019 deaths, Australian lawyers, Australian rugby league players, Australian rugby union players, Indigenous Australian sportspeople, Sportspeople from Queensland
Joe Dolce	1947 births, Living people, American guitarists, American poets, American singer-songwriters, Australian guitarists, Australian poets, Australian singer-songwriters, American essayists, Singers from Ohio
Shaddap You Face	1980 songs, Debut singles, Pop songs
Sammy Hagar	1947 births, Living people, American autobiographers, American heavy metal singers, American rock guitarists, American rock singers, American singer-songwriters, Rock and Roll Hall of Fame inductees, Singers from California, Writers from California
Victorian Socialists	Socialism, Political parties in Australia, Victoria, Australia, 2018 establishments, 2010s establishments in Australia
Judy Parfitt	English television actors, English stage actors, English movie actors, People from Sheffield, 1935 births, Alumni of the Royal Academy of Dramatic Art, Living people
Ascending node	Orbits
O'Shea Jackson Jr.	Singers from Los Angeles, California, Actors from Los Angeles, California, African American musicians, American rap musicians from California, 1991 births, Living people
Pyrophone	Keyboard instruments
Lasse Hallström	People from Stockholm, Swedish movie directors, 1946 births, Living people
Thelma Houston	Singers from Mississippi, Actors from Mississippi, Grammy Award winners, 1946 births, Living people
Vasily Likhachyov	1952 births, 2019 deaths, Communist politicians, Russian communists, Russian politicians
Hugo Ballesteros Reyes	1930s births, 2019 deaths, Chilean politicians, Deaths from brain cancer, Diplomats, Disease-related deaths in Chile, People from Santiago
Eva Moser	1982 births, 2019 deaths, Austrian sportspeople, Cancer deaths in Austria, Chess players, Deaths from leukemia
Xerocole	Animals, Deserts
Montresta	Communes of Sardinia
Courgevaux	Municipalities of Fribourg
Nina Lagergren	1921 births, 2019 deaths, Swedish businesspeople, People from Stockholm, Swedish radio personalities
Courtepin	Municipalities of Fribourg
Cressier, Fribourg	Municipalities of Fribourg
Greng	Municipalities of Fribourg
Ulmiz	Municipalities of Fribourg
Meyriez	Municipalities of Fribourg
Misery-Courtion	Municipalities of Fribourg
Avenches	Municipalities of Vaud, Cities in Switzerland
Courlevon	Former municipalities of Fribourg
Lurtigen	Former municipalities of Fribourg
Jeuss	Former municipalities of Fribourg
Jaun	Municipalities of Fribourg
Salvenach	Former municipalities of Fribourg
Sachin Bansal	1981 births, Living people
Büchslen	Former municipalities of Fribourg
Utøya	Islands of Norway
Barberêche	Former municipalities of Fribourg
Villarepos	Former municipalities of Fribourg
Wallenried	Former municipalities of Fribourg
Bas-Vully	Former municipalities of Fribourg
Haut-Vully	Former municipalities of Fribourg
Dalhart, Texas	Cities in Texas, County seats in Texas
Princeton, Idaho	Census-designated places in Idaho
Dimmitt, Texas	Cities in Texas, County seats in Texas
Gruyères	Municipalities of Fribourg, Cities in Switzerland
Eric Swalwell 2020 presidential campaign	2020 United States presidential campaigns
Michael Bennet 2020 presidential campaign	2020 United States presidential campaigns
Angels Camp, California	Cities in California, Settlements in Calaveras County, California
Governor of Tennessee	Governors of Tennessee
Ruth-Margret Pütz	1930 births, 2019 deaths, German educators, Sopranos
Davey Williams (musician)	1952 births, 2019 deaths, Cancer deaths in the United States, American guitarists, American music critics, Writers from Birmingham, Alabama, Musicians from Birmingham, Alabama
Arie Irawan	1990 births, 2019 deaths, Malaysian sportspeople, Golfers
Nadja Regin	1931 births, 2019 deaths, Actresses who played Bond girls, Actors who played Bond villains, Models, Serbian actors
Sukharev Tower	Buildings and structures in Moscow, Towers in Europe
Harry Kesten	1931 births, 2019 deaths, American educators, American mathematicians, Cornell University alumni, People from Duisburg
Ruth Negga	1982 births, Living people, Ethiopian people, Irish movie actors, Irish stage actors, Irish television actors, People from Limerick
Wolof people	Ethnic groups in Africa, Gambian people, Mauritanian people, Senegalese people
Gabriel Piroird	1932 births, 2019 deaths, French Roman Catholics, People from Lyon, Roman Catholic bishops
Avi Gabbay	1967 births, Living people, Former Members of Knesset, Government ministers of Israel, HaAvoda politicians, Hebrew University of Jerusalem alumni, Israeli businesspeople, Israeli former political leaders, Jewish businesspeople, Jewish Israeli politicians, People from Jerusalem
Richard E. Cole	1915 births, 2019 deaths, American aviators, American centenarians, American military personnel of World War I, Military people from Ohio, People from Dayton, Ohio, United States Air Force
Copperopolis, California	Cities in California, Settlements in Calaveras County, California
San Andreas, California	Cities in California, County seats in California, Settlements in Calaveras County, California
Gummy candy	Candy
K. M. Mani	1933 births, 2019 deaths, Deaths from COPD, Disease-related deaths in India, Indian politicians, People from Kerala
Marilynn Smith	1929 births, 2019 deaths, American golfers, People from Topeka, Kansas, Sportspeople from Kansas
Auboranges	Municipalities of Fribourg
Billens-Hennens	Municipalities of Fribourg
Chapelle (Glâne)	Municipalities of Fribourg
Châtonnaye	Municipalities of Fribourg
Rue, Switzerland	Municipalities of Fribourg, Cities in Switzerland
Ursy	Municipalities of Fribourg
Montet (Glâne)	Municipalities of Fribourg
Littlefield, Texas	Cities in Texas, County seats in Texas
Saint-Julien-Innocence-Eulalie	2019 establishments in France, Communes in Dordogne
Waldighofen	Communes in Haut-Rhin
Felix, California	Unincorporated communities in California, Settlements in Calaveras County, California
Tamarack, California	Unincorporated communities in California, Settlements in Calaveras County, California
Telegraph City, California	Unincorporated communities in California, Settlements in Calaveras County, California
Alà dei Sardi	Communes of Sardinia
Anela	Communes of Sardinia
Ardara	Communes of Sardinia
Arzachena	Communes of Sardinia
Badesi	Communes of Sardinia
Aritzo	Communes of Sardinia
Arzana	Communes of Sardinia
Atzara	Communes of Sardinia
Austis	Communes of Sardinia
Banari	Communes of Sardinia
Benetutti	Communes of Sardinia
Bari Sardo	Communes of Sardinia
Baunei	Communes of Sardinia
Belvì	Communes of Sardinia
Birori	Communes of Sardinia
Berchidda	Communes of Sardinia
Bessude	Communes of Sardinia
Bitti	Communes of Sardinia
Bolotana	Communes of Sardinia
Bonnanaro	Communes of Sardinia
Borore	Communes of Sardinia
Bono (Italy)	Communes of Sardinia
Bonorva	Communes of Sardinia
Bortigiadas	Communes of Sardinia
Borutta	Communes of Sardinia
Bortigali	Communes of Sardinia
Bottidda	Communes of Sardinia
Buddusò	Communes of Sardinia
Budoni	Communes of Sardinia
Bultei	Communes of Sardinia
Bulzi	Communes of Sardinia
Burgos	Communes of Sardinia
Cardedu	Communes of Sardinia
Calangianus	Communes of Sardinia
Cargeghe	Communes of Sardinia
Castelsardo	Communes of Sardinia
Cheremule	Communes of Sardinia
Chiaramonti	Communes of Sardinia
Codrongianos	Communes of Sardinia
Cossoine	Communes of Sardinia
Erula	Communes of Sardinia
Esporlatu	Communes of Sardinia
Desulo	Communes of Sardinia
Dorgali	Communes of Sardinia
Dualchi	Communes of Sardinia
Elini	Communes of Sardinia
Fonni	Communes of Sardinia
Florinas	Communes of Sardinia
Yoke and arrows	Politics of Spain, Symbols, Spain
Cape Horn, Alpine County, California	Unincorporated communities in California, Settlements in Alpine County, California
The Lancet	Weekly magazines, Medicine, 1823 establishments, Journals
List of municipal districts in Alberta	Settlements in Alberta, Lists of settlements in Canada
Housing starts	economic theories, Houses, Economic indicators
Leif Haraldseth	1929 births, 2019 deaths, Norwegian politicians, Trade unionists
John Motson	1945 births, Living people, Association football broadcasters, BBC radio presenters, BBC television presenters, English radio personalities, English television presenters, Officers of the Order of the British Empire, People from Lancashire
Julio-Claudian dynasty	Ancient Rome, Roman Emperors, Royal dynasties
The Onion	Newspapers in the United States, American websites, Webby Award winners, Madison, Wisconsin
Laxmi Prasad Devkota	1909 births, 1959 deaths, People from Kathmandu, Nepalese poets, Asian writers
Flatback turtle	Turtles
Dialect continuum	Language
Chelidae	Turtles
Dave Bartholomew	1918 births, 2019 deaths, Deaths from heart failure, American centenarians, American composers, American bandleaders, American R&B musicians, American rock musicians, American songwriters, Trumpeters, Musicians from New Orleans, Louisiana, Writers from New Orleans, Louisiana
Edgard, Louisiana	Census-designated places in Louisiana, Parish seats in Louisiana
Timber Trails, California	Unincorporated communities in California, Settlements in Calaveras County, California
Ecublens, Fribourg	Municipalities of Fribourg
Grangettes	Municipalities of Fribourg
La Folliaz	2005 establishments in Switzerland, Former municipalities of Fribourg
Massonnens	Municipalities of Fribourg
Le Châtelard, Fribourg	Municipalities of Fribourg
Mézières, Fribourg	Municipalities of Fribourg
Siviriez	Municipalities of Fribourg
Torny	Municipalities of Fribourg
Villaz-Saint-Pierre	Former municipalities of Fribourg
Paul Wolfowitz	1943 births, Living people, American political scientists, American political writers, American educators, Presidents of the World Bank Group, Ambassadors of the United States, Businesspeople from New York City, Politicians from New York City, Writers from New York City
Vuarmarens	Former municipalities of Fribourg, Villages in Fribourg
Sandy Ratcliff	1948 births, 2019 deaths, English movie actors, English television actors, English stage actors, Actors from London
Nikolai Gorbachev	1948 births, 2019 deaths, Soviet Olympic gold medalists, Belarusian sportspeople
Villorsonnens	Municipalities of Fribourg
James D. Hudnall	1957 births, 2019 deaths, Deaths from diabetes, American comics writers, American comics artists, Writers from California
Charles Van Doren	1926 births, 2019 deaths, American editors, American educators, Writers from New York City
Canaan, Connecticut	Towns in Connecticut
Vuisternens-devant-Romont	Municipalities of Fribourg
Earl Thomas Conley	1941 births, 2019 deaths, Deaths from dementia, Disease-related deaths in Tennessee, American country singers, American country guitarists, Musicians from Dayton, Ohio, Singers from Ohio, Writers from Dayton, Ohio
Avry	Municipalities of Fribourg
Goshen, Connecticut	Towns in Connecticut
Neyruz	Municipalities of Fribourg
Weckolsheim	Communes in Haut-Rhin
Arundhati Ghose	1939 births, 2016 deaths, Indian politicians, Ambassadors of India, Ambassadors to the United Nations
Whitewash	Paints
Whitewashing	Disambiguation pages
Aidomaggiore	Communes of Sardinia
Albagiara	Communes of Sardinia
Ales	Communes of Sardinia
Allai	Communes of Sardinia
Arborea	Communes of Sardinia
Arbus	Communes of Sardinia
Ardauli	Communes of Sardinia
Armungia	Communes of Sardinia
Assolo	Communes of Sardinia
Asuni	Communes of Sardinia
Baradili	Communes of Sardinia
Ballao	Communes of Sardinia
Barrali	Communes of Sardinia
Barumini	Communes of Sardinia
Baratili San Pietro	Communes of Sardinia
Baressa	Communes of Sardinia
Bauladu	Communes of Sardinia
Bidonì	Communes of Sardinia
Bonarcado	Communes of Sardinia
Boroneddu	Communes of Sardinia
Bosa	Communes of Sardinia
Buggerru	Communes of Sardinia
Burcei	Communes of Sardinia
Busachi	Communes of Sardinia
Cabras	Communes of Sardinia
Calasetta	Communes of Sardinia
Carbonia	Communes of Sardinia, Capital cities in Italy
Carloforte	Communes of Sardinia
Castiadas	Communes of Sardinia
Collinas	Communes of Sardinia
Cuglieri	Communes of Sardinia
Curcuris	Communes of Sardinia
Decimoputzu	Communes of Sardinia
Dolianova	Communes of Sardinia
Domus de Maria	Communes of Sardinia
Domusnovas	Communes of Sardinia
Donori	Communes of Sardinia
Escalaplano	Communes of Sardinia
Escolca	Communes of Sardinia
Esterzili	Communes of Sardinia
Fluminimaggiore	Communes of Sardinia
Furtei	Communes of Sardinia
Flussio	Communes of Sardinia
Fordongianus	Communes of Sardinia
Genoni	Communes of Sardinia
Genuri	Communes of Sardinia
Gergei	Communes of Sardinia
Gesico	Communes of Sardinia
Gesturi	Communes of Sardinia
Giba	Communes of Sardinia
Ghilarza	Communes of Sardinia
Goni	Communes of Sardinia
Gonnesa	Communes of Sardinia
Gonnoscodina	Communes of Sardinia
Gonnosfanadiga	Communes of Sardinia
Gonnosnò	Communes of Sardinia
Gonnostramatza	Communes of Sardinia
Guamaggiore	Communes of Sardinia
Guasila	Communes of Sardinia
Guspini	Communes of Sardinia
Iglesias	Communes of Sardinia
Isili	Communes of Sardinia
Laconi	Communes of Sardinia
Las Plassas	Communes of Sardinia
Lunamatrona	Communes of Sardinia
Mandas	Communes of Sardinia
Magomadas	Communes of Sardinia
Marrubiu	Communes of Sardinia
Masullas	Communes of Sardinia
Milis	Communes of Sardinia
Modolo	Communes of Sardinia
Masainas	Communes of Sardinia
Monastir	Communes of Sardinia
Mogorella	Communes of Sardinia
Mogoro	Communes of Sardinia
Muravera	Communes of Sardinia
Morgongiori	Communes of Sardinia
Musei	Communes of Sardinia
Narcao	Communes of Sardinia
Narbolia	Communes of Sardinia
Neoneli	Communes of Sardinia
Norbello	Communes of Sardinia
Nughedu Santa Vittoria	Communes of Sardinia
Nurachi	Communes of Sardinia
Nuragus	Communes of Sardinia
Nurallao	Communes of Sardinia
Nuraminis	Communes of Sardinia
Nurri	Communes of Sardinia
Nuxis	Communes of Sardinia
Nureci	Communes of Sardinia
Ollastra	Communes of Sardinia
Orroli	Communes of Sardinia
Ortacesus	Communes of Sardinia
Pabillonis	Communes of Sardinia
Palmas Arborea	Communes of Sardinia
Pau	Communes of Sardinia
Pauli Arbarei	Communes of Sardinia
Paulilatino	Communes of Sardinia
Perdaxius	Communes of Sardinia
Pimentel	Communes of Sardinia
Pompu	Communes of Sardinia
Piscinas	Communes of Sardinia
Portoscuso	Communes of Sardinia
Bhanubhakta Acharya	1814 births, 1868 deaths, Nepalese poets, Asian translators
Magnetostatics	Magnetism
Language border	Language, Geography
Jay Garner	1938 births, Living people, American generals, American military personnel of the Vietnam War, Military people from Florida, Politicians from Florida, US Republican Party politicians
César Lévano	1926 births, 2019 deaths, People from Lima, Peruvian educators, Peruvian journalists, Poets, Activists
Roger Moore (computer scientist)	1939 births, 2019 deaths, American computer scientists, Scientists from California
Redlands, California	Cities in California, Settlements in San Bernardino County, California
Boris Dubrovin	1950 births, 2019 deaths, Deaths from motor neurone disease, Russian mathematicians
Yuya Uchida (singer)	1939 births, 2019 deaths, Deaths from pneumonia, Japanese singers, Record producers, Actors from Tokyo
Katherine Waterston	American stage actors, American movie actors, Actors from New York City, 1980 births, Living people
Red McCombs	1927 births, Living people, American billionaires, American philanthropists, Real estate developers, Businesspeople from Texas
Spur, Texas	Cities in Texas
Homo luzonensis	Hominins, Philippines
Zoë Kravitz	American television actors, American movie actors, Singers from California, Models from Los Angeles, California, Actors from Los Angeles, California, African American actors, Jewish American actors, 1988 births, Living people
French Republican Calendar	1790s establishments in France, 1792 establishments, Calendars, France
Cephalothorax	Arthropods, Body parts
Bossonnens	Municipalities of Fribourg
Châtel-Saint-Denis	Municipalities of Fribourg, Cities in Switzerland
Granges (Veveyse)	Municipalities of Fribourg
La Verrerie	Municipalities of Fribourg
Le Flon	Municipalities of Fribourg
Remaufens	Municipalities of Fribourg
Saint-Martin, Fribourg	Municipalities of Fribourg
Semsales	Municipalities of Fribourg
Income taxes in Canada	Taxation in Canada, Income
Dmitri Savitski	1944 births, 2019 deaths, French novelists, French poets, Russian novelists, Russian poets, Writers from Moscow
Trent Alexander-Arnold	1998 births, Living people, Association football defenders, Association football full-backs, Black British sportspeople, English footballers, Liverpool F.C. players, Sportspeople from Liverpool, Premier League players
Gadoni	Communes of Sardinia
Gairo	Communes of Sardinia
Galtellì	Communes of Sardinia
Gavoi	Communes of Sardinia
Giave	Communes of Sardinia
Girasole	Communes of Sardinia
Golfo Aranci	Communes of Sardinia
Ilbono	Communes of Sardinia
Illorai	Communes of Sardinia
Irgoli	Communes of Sardinia
Ittireddu	Communes of Sardinia
Ittiri	Communes of Sardinia
Jerzu	Communes of Sardinia
La Maddalena	Communes of Sardinia
Laerru	Communes of Sardinia
Loculi	Communes of Sardinia
Loceri	Communes of Sardinia
Lanusei	Communes of Sardinia
Lodè	Communes of Sardinia
Mara	Communes of Sardinia
Mamoiada	Communes of Sardinia
Macomer	Communes of Sardinia
Luras	Communes of Sardinia
Luogosanto	Communes of Sardinia
Lula	Communes of Sardinia
Lotzorai	Communes of Sardinia
Loiri Porto San Paolo	Communes of Sardinia
Lodine	Communes of Sardinia
Monteleone Rocca Doria	Communes of Sardinia
Monti	Communes of Sardinia
Martis	Communes of Sardinia
Muros	Communes of Sardinia
Noragugume	Communes of Sardinia
Nughedu San Nicolò	Communes of Sardinia
Nule	Communes of Sardinia
Nulvi	Communes of Sardinia
Nuoro	Communes of Sardinia, Capital cities in Italy
Oliena	Communes of Sardinia
Ollolai	Communes of Sardinia
Olmedo	Communes of Sardinia
Olzai	Communes of Sardinia
Onanì	Communes of Sardinia
Onifai	Communes of Sardinia
Oniferi	Communes of Sardinia
Orani	Communes of Sardinia
Orgosolo	Communes of Sardinia
Oristano	Communes of Sardinia, Capital cities in Italy
Orosei	Communes of Sardinia
Orotelli	Communes of Sardinia
Ortueri	Communes of Sardinia
Orune	Communes of Sardinia
Oschiri	Communes of Sardinia
Osidda	Communes of Sardinia
Osilo	Communes of Sardinia
Osini	Communes of Sardinia
Ossi	Communes of Sardinia
Ottana	Communes of Sardinia
Ovodda	Communes of Sardinia
Ozieri	Communes of Sardinia
Casey Wilson	American television actors, American movie actors, American comedians, Actors from Virginia, People from Alexandria, Virginia, 1980 births, Living people
Andrzej Suski	1941 births, Living people, Polish Roman Catholics, Roman Catholic bishops
Andrew Robertson	1994 births, Living people, Association football defenders, Association football full-backs, Liverpool F.C. players, Scottish footballers, Sportspeople from Glasgow
Tommy Smith (footballer, born 1945)	1945 births, 2019 deaths, Deaths from dementia, English footballers, English football managers, Liverpool F.C. players, Members of the Order of the British Empire, Sportspeople from Liverpool
Irwin L. Jacobs	1941 births, 2019 deaths, Suicides by firearm in the United States, Businesspeople from Minnesota
Orono, Minnesota	Cities in Minnesota
Estrella Zeledón Lizano	1929 births, 2019 deaths, First Ladies, Costa Rican people
Rodrigo Carazo Odio	1926 births, 2009 deaths, Presidents of Costa Rica
Ian Cognito	1958 births, 2019 deaths, Cardiovascular disease deaths in England, Comedians from London, Deaths from myocardial infarction
Dina (singer)	1956 births, 2019 deaths, Deaths from idiopathic pulmonary fibrosis, Portuguese singers, Eurovision Song Contest entrants
Forrest Gregg	1933 births, 2019 deaths, Deaths from Parkinson's disease, Green Bay Packers players, Dallas Cowboys players, Sportspeople from Texas
Bas-Intyamon	Municipalities of Fribourg
Botterens	Municipalities of Fribourg
Broc	Municipalities of Fribourg
Echarlens	Municipalities of Fribourg
Marsens	Municipalities of Fribourg
Cerniat	Former municipalities of Fribourg
Charmey	Former municipalities of Fribourg
Crésuz	Municipalities of Fribourg
Rental vacancy rate	Houses, Economic indicators
Châtel-sur-Montsalvens	Municipalities of Fribourg
Haut-Intyamon	Municipalities of Fribourg
Hauteville, Fribourg	Municipalities of Fribourg
Wendy Williams	Living people, 1964 births, American television personalities, American radio personalities, Entertainers from New Jersey
Ray Clemence	1948 births, 2020 deaths, Cancer deaths in England, Deaths from prostate cancer, English association football goalkeepers, English football managers, Liverpool F.C. players, Members of the Order of the British Empire, Sportspeople from Lincolnshire
Israel Folau	1989 births, Living people, Australian Christians, Australian rugby league players, Australian rugby union players, Australian rules footballers, Sportspeople from New South Wales, Sportspeople from Queensland
Rich Brian	1999 births, Living people, Indonesian singers, People from Jakarta, Rap musicians
Ron Livingston	1967 births, Living people, American movie actors, American television actors, American voice actors, American stage actors, Actors from Iowa, People from Cedar Rapids, Iowa
Marcia Clark	Writers from California, Television personalities from California, 1953 births, Living people
Goodyear, Arizona	Cities in Arizona
Shirley Spork	1927 births, Living people, American golfers, American educators, Sportspeople from Detroit, Michigan
Marlene Hagge	1934 births, Living people, American golfers, Sportspeople from South Dakota, Sportspeople from California
Eureka, South Dakota	Cities in South Dakota
Marlyn Mason	1940 births, Living people, American movie actors, American television actors, American stage actors, American voice actors, Actors from California, Screenwriters from California, Movie producers from California
Bhim Nidhi Tiwari	1911 births, 1973 deaths, People from Kathmandu, Poets, Asian writers
Peace of Augsburg	Treaties, 16th century, Holy Roman Empire, Lutheranism
Joe Hisaishi	1950 births, Living people, Japanese composers, People from Nagano Prefecture, 20th century composers, 21st century composers, Movie score composers, Video game composers
Shahdara District	Districts of Delhi
Bridgewater, Connecticut	Towns in Connecticut
Corbières, Fribourg	Municipalities of Fribourg
Grandvillard	Municipalities of Fribourg
La Roche, Fribourg	Municipalities of Fribourg
Le Pâquier, Fribourg	Municipalities of Fribourg
Morlon	Municipalities of Fribourg
Pont-en-Ogoz	Municipalities of Fribourg
Pont-la-Ville	Municipalities of Fribourg
Riaz	Municipalities of Fribourg
Sâles	Municipalities of Fribourg
Sorens	Municipalities of Fribourg
Vaulruz	Municipalities of Fribourg
Villarvolard	Former municipalities of Fribourg
Vuadens	Municipalities of Fribourg
List of botanical gardens	Botanical gardens by country, Geography-related lists, Science-related lists
Estavayer-le-Lac	Former municipalities of Fribourg, Cities in Switzerland
Eagle Pass, Texas	Cities in Texas, County seats in Texas
Cheiry	Municipalities of Fribourg
Mike Jakubo (ice hockey)	1947 births, 2019 deaths, Deaths from Alzheimer's disease, Ice hockey people from Ontario
Thompson Mann	1942 births, 2019 deaths, American Olympic gold medalists, American swimmers, People from Norfolk, Virginia, Sportspeople from Virginia
Ivan Mrázek	1926 births, 2019 deaths, Basketball players, Coaches, Czech sportspeople, Czechoslovak people, People from Brno
Arthur Polonsky	1925 births, 2019 deaths, American academics, American educators, American painters, Jewish American academics, People from Lynn, Massachusetts
Elwyn Berlekamp	1940 births, 2019 deaths, Deaths from pulmonary fibrosis, American computer scientists, American educators, American mathematicians, Scientists from Kentucky, Scientists from Ohio
Inex-Adria Aviopromet Flight 1308	Aviation disasters in the 1980s, Aviation disasters in Europe, 1981 in Europe, 20th century in France, Yugoslavia, History of Slovenia, December events
Werner Bardenhewer	1929 births, 2019 deaths, German Roman Catholics, Humanitarians, People from North Rhine-Westphalia, People from Wiesbaden‎, German philanthropists, Roman Catholic priests
Stanley Plumly	1939 births, 2019 deaths, American academics, American poets, Cancer deaths in Maryland, Deaths from multiple myeloma, Writers from Ohio, Writers from Virginia
Tony Buzan	1942 births, 2019 deaths, Deaths from myocardial infarction, British educators, People from Middlesex, British psychologists, Writers from London
῾Eta	Letters (alphabet)
Neus Català	1915 births, 2019 deaths, Centenarians, Communist politicians, People from Catalonia, Political activists, Spanish military people, Spanish politicians
Paul Raymond (musician)	1945 births, 2019 deaths, British keyboardists, Deaths from myocardial infarction, English rock guitarists, English songwriters
D. Babu Paul	1941 births, 2019 deaths, Civil servants, Deaths from multiple organ failure, Indian writers, People from Kerala
Yvette Williams	1929 births, 2019 deaths, Members of the Order of the British Empire, New Zealand sportspeople, Olympic gold medalists, People from Dunedin
Ivor Broadis	1922 births, 2019 deaths, 1954 FIFA World Cup players, English footballers, English football managers, Manchester City F.C. players, Sportspeople from London
Billy Mainwaring	1941 births, 2019 deaths, People from Port Talbot, Welsh rugby union players
Barnesville, Ohio	Villages in Ohio
Ski Mask the Slump God	1996 births, Living people, African American musicians, American rap musicians from Florida, American songwriters, People from Fort Lauderdale, Florida
2019 Sudanese coup d'état	2019 in Africa, April 2019 events, Sudan
Beresheet	April 2019 events
Adrian Smith	1957 births, Living people, British keyboardists, English rock guitarists, English rock singers, English singer-songwriters, Heavy metal guitarists, Iron Maiden, Musicians from London, People from Hackney
Adrian Smith (basketball)	1936 births, Living people, American basketball players, American Olympic gold medalists, Golden State Warriors players, Sacramento Kings players, Sportspeople from Kentucky
John Barth	1930 births, Living people, American novelists, American essayists, American poets, Writers from Maryland
Cambridge, Maryland	Cities in Maryland, County seats in Maryland
Elkton, Maryland	Towns in Maryland, County seats in Maryland
Kabulig Bikol	Language
Colin Collindridge	1920 births, 2019 deaths, English footballers, People from South Yorkshire, Sportspeople from Yorkshire
21 Savage	1992 births, Living people, British rap musicians, Singers from Atlanta, Georgia, English rap musicians, English singer-songwriters, Black British musicians, Black British people, People from London, English musicians, British musicians
Giuseppe Ciarrapico	1934 births, 2019 deaths, Italian businesspeople, Politicians from Rome
Gunnel Lindblom	1931 births, 2021 deaths, Swedish movie actors, Swedish television actors, Swedish stage actors, Swedish movie directors, People from Gothenburg
Bibi Andersson	1935 births, 2019 deaths, Deaths from stroke, Actors from Stockholm, Swedish movie actors, Swedish stage actors, Swedish television actors
Max van Weezel	1951 births, 2019 deaths, Deaths from pancreatic cancer, Dutch Jews, Dutch journalists, Jewish writers, Political commentators, Writers from Amsterdam
Albert Quixall	1933 births, 2020 deaths, 1954 FIFA World Cup players, English footballers, Manchester United F.C. players, Sportspeople from Sheffield
Harry Hooper (footballer, born 1933)	1933 births, Living people, 1954 FIFA World Cup players, English footballers, Sportspeople from County Durham
Harry Hooper	1887 births, 1974 deaths, Baseball players from California, Boston Red Sox players, Chicago White Sox players
Ambrogio Fogar	1941 births, 2005 deaths, Italian explorers, Italian writers, Italian television presenters, Sailors, Racecar drivers, Sportspeople from Milan
List of Danny Phantom episodes	Lists of Nickelodeon television series episodes
T.U.F.F. Puppy	American children's television series, Animated television series, Nickelodeon television series, 2010 American television series debuts, English-language television programs
Chelsea Physic Garden	17th century establishments in England, Chelsea, London
List of T.U.F.F. Puppy episodes	Lists of Nickelodeon television series episodes
Barrington, Illinois	Villages in Illinois, Suburbs of Chicago, Illinois, Settlements in Cook County, Illinois
S. K. Shivakumar	1953 births, 2019 deaths, Deaths from jaundice, Indian scientists
Alexander V. Acebo	1927 births, 2019 deaths, Politicians from Vermont, US Republican Party politicians
Barre (city), Vermont	Cities in Vermont
Mirjana Marković	1942 births, 2019 deaths, Deaths from surgical complications, Serbian politicians, Political activists, First Ladies, Civil servants, Fraudsters
Jacek Namieśnik	1949 births, 2019 deaths, Deaths from heart failure, Polish writers, Polish scientists, Chemists, Polish educators
Bussy, Fribourg	Former municipalities of Fribourg
Notre-Dame de Paris fire	2019 disasters, 2019 in Europe, 2010s disasters in Europe, 2010s fires, 2010s in Paris, April 2019 events, Building and structure fires in Europe
Morens	Former municipalities of Fribourg
Murist	Former municipalities of Fribourg
Vuissens	Former municipalities of Fribourg
Rueyres-les-Prés	Former municipalities of Fribourg
Florida School for Boys	1900s establishments in Florida, 1900 establishments in the United States, 2010s disestablishments in Florida, 2011 disestablishments in the United States, Schools in the United States, Buildings and structures in Florida
Vernay, Switzerland	2006 establishments in Switzerland, 2017 disestablishments in Switzerland, Former municipalities of Fribourg
Châbles	Former municipalities of Fribourg
Gletterens	Municipalities of Fribourg
Owen Garriott	1930 births, 2019 deaths, American engineers, American astronauts, Scientists from Oklahoma, People from Enid, Oklahoma
Joaquim Alberto Silva	1974 births, 2019 deaths, Deaths from myocardial infarction, Angolan people, Footballers
Ben Ray Luján	1972 births, Living people, United States senators from New Mexico, United States representatives from New Mexico, People from Santa Fe, New Mexico, US Democratic Party politicians
Don L. Lind	1930 births, Living people, American astronauts, American aviators, American military people, Scientists from Utah
Midvale, Utah	Cities in Utah
William E. Thornton	1929 births, 2021 deaths, American astronauts, Scientists from North Carolina
Faison, North Carolina	Towns in North Carolina
Vance D. Brand	1931 births, Living people, American astronauts, American aviators, Scientists from Colorado
Winston L. Shelton	1922 births, 2019 deaths, American engineers, American inventors, Businesspeople from West Virginia
Aleksandar Kostov	1938 births, 2019 deaths, 1962 FIFA World Cup players, 1966 FIFA World Cup players, Bulgarian footballers, Bulgarian football managers, People from Sofia
Ahmad Eghtedari	1925 births, 2019 deaths, Academics, Deaths from kidney disease, Deaths from lung disease, Iranian educators, Asian geographers, Iranian historians, Iranian writers, Lawyers
Francisca Aguirre	1930 births, 2019 deaths, People from Alicante, Spanish poets
Outwash plain	Landforms
Jan Wraży	1943 births, 2019 deaths, Polish footballers
Ancash Region	Regions of Peru
Les Reed (songwriter)	1935 births, 2019 deaths, English composers, English pianists, English songwriters, Members of the Order of the British Empire, Musicians from Surrey, People from Woking, Writers from Surrey
Hal Ketchum	1953 births, 2020 deaths, American country singers, American singer-songwriters, American country guitarists, Deaths from Alzheimer's disease, Singer-songwriters from New York, Musicians from New York, People with multiple sclerosis
Greenwich (town), New York	Towns in New York
Greenwich (village), New York	Villages in New York
Glens Falls, New York	Cities in New York
Les Reed (football manager)	1952 births, Living people, English footballers, English football managers, Sportspeople from London
Les Reed (footballer)	1932 births, Living people, Australian rules footballers, Sportspeople from Victoria (Australia)
David Brion Davis	1927 births, 2019 deaths, American educators, American historians, American political writers, Writers from Denver, Colorado
Bernard Arnault	1949 births, Living people, French philanthropists, French businesspeople, People from Paris
Larry Ellison	1944 births, Living people, American billionaires, American Jews, American philanthropists, Businesspeople from New York City, Jewish billionaires, Jewish businesspeople, Jewish philanthropists
Al Staley	1928 births, 2019 deaths, American Hockey League players, Canadian ice hockey centres, Ice hockey people from Saskatchewan, New York Rangers players, People from Regina, Saskatchewan, Eastern Hockey League players
Nardwuar	1968 births, Living people, Canadian journalists, Canadian radio personalities, Canadian rock singers, Keyboardists, Musicians from Vancouver
Kepler-62e	Exoplanets
Hieu Van Le	1954 births, Living people, Accountants, Economists, Order of Australia, Governors of South Australia, Vietnamese people
Norio Kaifu	1943 births, 2019 deaths, Astronomers, Deaths from pancreatic cancer, Japanese scientists
Guro Fjellanger	1964 births, 2019 deaths, Norwegian politicians, People from Bergen, People with disabilities
Cugy, Fribourg	Municipalities of Fribourg
Châtillon, Fribourg	Municipalities of Fribourg
Cheyres	Former municipalities of Fribourg
Delley-Portalban	2005 establishments in Switzerland, Municipalities of Fribourg
Domdidier	Former municipalities of Fribourg
Dompierre, Fribourg	Former municipalities of Fribourg
Surpierre	Municipalities of Fribourg
Fétigny, Switzerland	Municipalities of Fribourg
Vallon	Municipalities of Fribourg
Ménières	Municipalities of Fribourg
Telestial kingdom	Mormonism
Monkey Punch	1937 births, 2019 deaths, Deaths from pneumonia, Disease-related deaths in Japan, Japanese academics, Japanese manga artists, Japanese writers, People from Hokkaido
Super-Earth	Exoplanets
John McEnery	1943 births, 2019 deaths, Actors from Birmingham, English movie actors, English playwrights, English stage actors, English television actors, Writers from Birmingham
Warren Adler	1927 births, 2019 deaths, American novelists, American playwrights, American poets, Cancer deaths in New York City, Deaths from liver cancer, American essayists, Writers from Brooklyn
Can Bartu	1936 births, 2019 deaths, Turkish basketball players, Turkish footballers, Turkish journalists, People from Istanbul
Randall C. Berg Jr.	1949 births, 2019 deaths, American lawyers, Deaths from motor neurone disease, Disease-related deaths in Florida, Writers from Jacksonville, Florida
Ya'akov Nehoshtan	1925 births, 2019 deaths, Ambassadors of Israel, Bulgarian Jews, Former Members of Knesset, Israeli lawyers, Jewish Israeli politicians
Font, Switzerland	Former municipalities of Fribourg
Bollion	Former municipalities of Fribourg, Villages in Fribourg
Lully, Fribourg	Municipalities of Fribourg
Seiry	Former municipalities of Fribourg, Villages in Fribourg
Léchelles	Former municipalities of Fribourg
Montagny, Fribourg	2000s establishments in Switzerland, 2000 establishments in Europe, Municipalities of Fribourg
Nuvilly	Municipalities of Fribourg
Prévondavaux	Municipalities of Fribourg
Russy, Switzerland	Former municipalities of Fribourg
Saint-Aubin, Fribourg	Municipalities of Fribourg
Sévaz	Municipalities of Fribourg
Villeneuve, Fribourg	Former municipalities of Fribourg
Burg bei Murten	Former municipalities of Fribourg, Villages in Fribourg
Belfaux	Municipalities of Fribourg
Chénens	Municipalities of Fribourg
Pierrafortscha	Municipalities of Fribourg
Walterswil, Solothurn	Municipalities of the canton of Solothurn
Zaqatala (city)	Cities in Azerbaijan
Marly, Switzerland	Municipalities of Fribourg
Autafond	Former municipalities of Fribourg
Autigny, Switzerland	Municipalities of Fribourg
Corminboeuf	Municipalities of Fribourg
Elk City, Idaho	Census-designated places in Idaho
Eastland, Texas	Cities in Texas, County seats in Texas
Abdallah Lamrani	1946 births, 2019 deaths, 1970 FIFA World Cup players, Military people, Moroccan footballers
Mya-Lecia Naylor	2002 births, 2019 deaths, Accidental deaths in the United Kingdom, Cardiovascular disease deaths in London, Deaths by hanging, Deaths from cardiac arrest, English child actors, English models, English movie actors, English singers, English television actors, People from Warwickshire
2020 Taiwan presidential election	2020 elections in Asia, January 2020 events, Politics of Taiwan
Ko Wen-je	1959 births, Living people, Mayors, Surgeons, Political commentators, Taiwanese educators, Taiwanese politicians
Terry Gou	1950 births, Living people, Taiwanese businesspeople, Taiwanese politicians
Eric Chu	1961 births, Living people, Taiwanese politicians, Mayors
Hsu Shui-teh	1931 births, 2021 deaths, Deaths from pneumonia, Taiwanese politicians, Mayors
Ignace Murwanashyaka	1963 births, 2019 deaths, Disease-related deaths in Germany, Rwandan people, War criminals
Jörg Demus	1928 births, 2019 deaths, Austrian composers, Classical musicians, People from Lower Austria, Austrian pianists
Geoffrey Chew	1924 births, 2019 deaths, American educators, American physicists, Scientists from Washington, D.C., Theoretical physicists, University of Chicago alumni
Víctor Manzanilla Schaffer	1924 births, 2019 deaths, Ambassadors of Mexico, Politicians from Mexico City
José María Rico	1934 births, 2019 deaths, Canadian lawyers, Costa Rican people, Deaths from Alzheimer's disease, People from Granada
New International Encyclopedia	Encyclopedias, 1900s books, 1914 books, 1923 books, 1935 books
Kobi Marimi	Israeli singers
2018 Lombok earthquake	2018 disasters in Asia, 2018 earthquakes, 2010s earthquakes in Asia, August 2018 events, July 2018 events, Lombok
Kent Harris	1930 births, 2019 deaths, Cancer deaths in San Diego County, Record producers, American songwriters, Writers from Oklahoma City, Writers from San Diego, California
Siegmar Wätzlich	1947 births, 2019 deaths, German footballers, German Olympic bronze medalists, Sportspeople from Saxony
Rammenau	Cities in Saxony, Bautzen Rural District
Jameel Jalibi	1929 births, 2019 deaths, Pakistani writers, Critics, Pakistani educators
Chésopelloz	Former municipalities of Fribourg
Corpataux-Magnedens	Former municipalities of Fribourg
Corserey	Former municipalities of Fribourg
Cottens, Fribourg	Municipalities of Fribourg
Granges-Paccot	Municipalities of Fribourg
Givisiez	Municipalities of Fribourg
Villars-sur-Glâne	Municipalities of Fribourg, Cities in Switzerland
Ependes, Fribourg	Municipalities of Fribourg
15 Orionis	Southern pole stars
La Sonnaz	Municipalities of Fribourg
Farvagny	Former municipalities of Fribourg
Ferpicloz	Municipalities of Fribourg
Matran	Municipalities of Fribourg
Sweetwater, Idaho	Census-designated places in Idaho
Jerrie Cobb	1931 births, 2019 deaths, American aviators, People from Oklahoma
Myrtle Cagle	1925 births, 2019 deaths, American aviators, Writers from South Carolina, Writers from North Carolina
Wally Funk	1939 births, Living people, American aviators, People from New Mexico
Las Vegas, New Mexico	Cities in New Mexico, County seats in New Mexico
Sarah Gorelick	1931 births, Living people, American aviators, People from Kansas
Hauterive, Fribourg	Municipalities of Fribourg
Rhea Woltman	1927 births, 2021 deaths, American aviators, People from St. Cloud, Minnesota
La Brillaz	Municipalities of Fribourg
Suzanne Twelftree	1956 births, 2019 deaths, Australian tennis players, Paralympians, People with disabilities, Sportspeople from South Australia
Seth Moulton 2020 presidential campaign	2020 United States presidential campaigns
List of zoos in Canada	Canada-related lists
List of botanical gardens in Canada	Canada-related lists
Foreign-buyers tax	British Columbia, Legislation, Taxation in Canada, Houses
Madame X (album)	Madonna albums, 2019 albums, Pop albums
Sergio Valdés (footballer)	1933 births, 2019 deaths, 1962 FIFA World Cup players, Chilean footballers, Deaths from leukemia, Disease-related deaths in Chile, People from Santiago
David Lama	1990 births, 2019 deaths, Accidental deaths in Canada, Austrian sportspeople, Mountain climbers
Jess Roskelley	1982 births, 2019 deaths, Accidental deaths in Canada, Mountain climbers, People from Spokane, Washington, Sportspeople from Washington
Theodora Kroeber	1897 births, 1979 deaths, American anthropologists, Scientists from Denver, Colorado, Writers from Denver, Colorado, Writers from California, Scientists from Berkeley, California
Belsize Park tube station	1907 establishments in England, London Underground stations, Northern Line stations, Rail transport stations in London fare zone 2
Hansjörg Auer	1984 births, 2019 deaths, Accidental deaths in Canada, Austrian sportspeople, Mountain climbers
Kazuo Koike	1936 births, 2019 deaths, Deaths from pneumonia, Disease-related deaths in Japan, Japanese businesspeople, Japanese writers, Manga, Novelists
Joker Xue	1983 births, Living people, Chinese singers, People from Shanghai
Lyra McKee	1990 births, 2019 deaths, British journalists, British murder victims, Lesbians, LGBT journalists, Murders by firearm in the United Kingdom, Northern Ireland people, People from Belfast
Victor Crone	Living people, 1992 births, Swedish singers
John Lundvik	1983 births, Living people, Swedish singers
Sergey Lazarev	1983 births, Living people, Russian singers, Russian actors
Duncan Laurence	1994 births, Living people, Bisexual people, Dutch LGBT people, Dutch singers, Eurovision Song Contest winners, LGBT singers, People from South Holland
Bilal Hassani	1999 births, Living people, Eurovision Song Contest entrants, French pop singers, Musicians from Paris, French YouTubers
Mahmood (singer)	1992 births, Living people, Italian singers
Anne Plunkett	1952 births, Living people, Ambassadors of Australia, People from New South Wales
Darude	1975 births, Living people, Finnish musicians
Con de Lange	1981 births, 2019 deaths, Cricketers, Deaths from brain cancer, Scottish sportspeople, South African sportspeople, White South African people
2019 Madeira bus crash	2019 in Africa, 2010s in Portugal, April 2019 events, Madeira Islands, Road accident deaths
Patrick Sercu	1944 births, 2019 deaths, Belgian cyclists, Olympic gold medalists, People from West Flanders
Carrie Coon	American television actors, American stage actors, American movie actors, Actors from Ohio, 1981 births, Living people
Pieter Verhoeff	1938 births, 2019 deaths, Dutch movie directors, People from Friesland
Tommie Smith	1944 births, Living people, African-American track and field athletes, American autobiographers, American Olympic gold medalists, Sportspeople from Texas, Sprinters
John Carlos	1945 births, Living people, American track and field athletes, American Olympic bronze medalists, Sportspeople from New York City, Sprinters
Peter Norman	1942 births, 2006 deaths, Australian Olympic silver medalists, Cardiovascular disease deaths in Australia, Deaths from myocardial infarction, Sportspeople from Melbourne, Sprinters
Sean Dyche	Living people
Nikki Sixx	Living people, 1958 births, American musicians
Bell System	Telephone companies, 1877 establishments, 1984 disestablishments
CenturyLink	20th-century establishments in Louisiana, 1930 establishments in the United States, American technology companies, Telephone companies, Internet service providers, Louisiana
Fall River Mills, California	Census-designated places in California, Settlements in Shasta County, California
Coco Austin	American television actors, American movie actors, Actors from Los Angeles, California, 1979 births, Living people
Affordable housing	Houses
The Fox and the Hound	1980s buddy movies, 1981 drama movies, American animated movies, American buddy movies, American family movies, American movies, Disney animated movies, Movies about dogs, Movies based on books, English-language movies
Fat Joe	Actors from the Bronx, Singers from New York City, American television actors, American movie actors, American rap musicians from New York, 1970 births, Living people
Sunol, California	Census-designated places in California, Settlements in Alameda County, California
Descendants	2015 comedy-drama movies, 2010s fantasy movies, 2010s musical movies, 2010s teen drama movies, American comedy-drama movies, American family movies, American musical movies, American teen comedy movies, American teen drama movies, American television movies, Disney movies, English-language movies, Movies based on fairy tales, Movies directed by Kenny Ortega
Descendants 2	2017 comedy-drama movies, 2010s fantasy movies, 2010s musical movies, 2010s teen drama movies, American comedy-drama movies, American family movies, American musical movies, American teen comedy movies, American teen drama movies, American television movies, Disney movies, English-language movies, Movies based on fairy tales, Movies directed by Kenny Ortega
Neville Sillitoe	1925 births, Living people, Australian educators, Coaches, Order of Australia, Sportspeople from Victoria (Australia)
David Morrison	1956 births, Living people, Australian feminists, Australian military people, Order of Australia, People from Cairns, Queensland
Takashi Hiraoka	1927 births, Living people, Japanese politicians, Japanese journalists, Mayors, People from Hiroshima, People from Osaka
John Kander	1927 births, Living people, American composers, American songwriters, Columbia University alumni, Emmy Award winners, Gay men, Grammy Award winners, Jewish American LGBT people, Jewish American musicians, Kennedy Center honorees, LGBT composers, Musicians from Kansas City, Missouri, Writers from Kansas City, Missouri, Tony Award winners
Josine Ianco-Starrels	1926 births, 2019 deaths, American academics, American educators, Deaths from natural causes, People from Bucharest
Rogue River, Oregon	Cities in Oregon
List of LazyTown episodes	Lists of Nickelodeon television series episodes
Super High Me	2007 movies, Cannabis, American documentary movies, English-language movies, Movies about drugs
Rodolfo Severino Jr.	1936 births, 2019 deaths, Ambassadors, ASEAN, Deaths from Parkinson's disease, Asian diplomats, Filipino educators, Filipino politicians, People from Manila
Okiharu Yasuoka	1939 births, 2019 deaths, Deaths from pancreatic cancer, Disease-related deaths in Japan, Lawyers, People from Kagoshima Prefecture, Politicians from Tokyo
Massimo Marino (TV presenter)	1960 births, 2019 deaths, Actors from Rome, Italian movie actors, Italian television presenters
Rahul Gandhi	1970 births, Indian politicians, Living people, Indian National Congress politicians
Burns, Oregon	Cities in Oregon, County seats in Oregon, Harney County, Oregon
Le Glèbe	Former municipalities of Fribourg
Fish sauce	Condiments, Sauces, Fish
Le Mouret	Municipalities of Fribourg
Noréaz	Former municipalities of Fribourg
Ponthaux	Municipalities of Fribourg
Prez-vers-Noréaz	Former municipalities of Fribourg
Rossens, Fribourg	Former municipalities of Fribourg
Vuisternens-en-Ogoz	Former municipalities of Fribourg
Senèdes	Municipalities of Fribourg
Villarsel-sur-Marly	Municipalities of Fribourg
Treyvaux	Municipalities of Fribourg
Agriswil	Former municipalities of Fribourg, Villages in Fribourg
Esmonts	Former municipalities of Fribourg, Villages in Fribourg
List of Blue's Clues episodes	Lists of Nickelodeon television series episodes
Alfred L. Kroeber	1876 births, 1960 deaths, American anthropologists, American archaeologists, American folklore, American academics, Columbia University alumni, Scientists from New Jersey, Writers from New Jersey, People from Hoboken, New Jersey, University of California, Berkeley faculty
Ishi in Two Worlds	Anthropology, Non-fiction books
Emory University	1830s establishments in Georgia (U.S. state), 1836 establishments in the United States, Colleges and universities in Georgia (U.S. state), Buildings and structures in Atlanta, Georgia
Berkeley High School (California)	1880s establishments in California, 1880 establishments in the United States, Schools in California, Berkeley, California
2019 Belizean territorial dispute referendum	2010s in Belize, Politics of Belize, Guatemala, Politics of North America, May 2019 events
Simbakubwa	Creodonts, Mammals of Africa
Rijksmuseum	1800 establishments, 1800s establishments in Europe, Establishments in the Netherlands, Art museums, Museums in the Netherlands, National museums, Amsterdam
2019 Sri Lanka Easter bombings	2019 murders in Asia, 2010s explosions in Asia, 21st century in Sri Lanka, April 2019 events, Attacks on churches, Attacks on hotels, Attacks on buildings and structures in 2019, Attacks on religious buildings and structures in Asia, Islamic State, Islamic terrorist incidents in 2019, Islamic terrorist incidents in Asia, Mass murder in 2019, Massacres in Asia, Suicide bombings in 2019, Suicide bombings in Asia, Terrorist incidents in Asia in 2019
Processual archaeology	Archaeology
Riley, Oregon	Harney County, Oregon, Unincorporated communities in Oregon
Orion Pictures	Movie studios, Companies based in Los Angeles
Joe Armstrong (programmer)	1950 births, 2019 deaths, British computer scientists, People from Bournemouth
John Singleton	1968 births, 2019 deaths, Deaths from stroke, Cardiovascular disease deaths in Los Angeles, Movie directors from Los Angeles, California, Movie producers from Los Angeles, California, Screenwriters from Los Angeles, California
Walidah Imarisha	Living people, American science fiction writers, American feminist writers, American feminists, Year of birth missing (living people)
Jerry Clack	1926 births, 2019 deaths, American academics, American educators, American political activists, People from New York City, Princeton University alumni
Peter Colotka	1925 births, 2019 deaths, Academics, Ambassadors to France, Communist politicians, Czechoslovak politicians, Lawyers, Prime Ministers of Slovakia
Reggie Cobb	1968 births, 2019 deaths, American football running backs, Deaths from myocardial infarction, Green Bay Packers players, Jacksonville Jaguars players, New York Jets players, People from Knoxville, Tennessee, Sportspeople from Tennessee, Tampa Bay Buccaneers players
Aminul Haque	1940s births, 2019 deaths, Bangladeshi politicians, Bangladeshi Muslims, Deaths from liver cancer, Bangladeshi lawyers
Karl Grob	1946 births, 2019 deaths, Deaths from heart failure, Association football goalkeepers, Swiss footballers
Braulio Lara	1988 births, 2019 deaths, Baseball players, Dominican Republic sportspeople, Road accident deaths
Amelia Vargas	1928 births, 2019 deaths, Cuban actors, Dancers, Movie actors, People from Havana, Television actors
Martin Böttcher	1927 births, 2019 deaths, German conductors, German composers, Musicians from Berlin
Wally Carr	1954 births, 2019 deaths, Australian boxers, Cancer deaths in New South Wales, Deaths from stomach cancer, Indigenous Australian sportspeople
Shantha Mayadunne	2019 deaths, Chefs, 1955 births, Writers
Harper's Magazine	1850s establishments in New York (state), 1850 establishments in the United States, Monthly magazines, American magazines
Krasimir Bezinski	1961 births, 2019 deaths, Bulgarian footballers, Deaths from colorectal cancer, Disease-related deaths in Bulgaria
Julio César Toresani	1967 births, 2019 deaths, Argentine footballers, Argentine football managers, People from Santa Fe, Argentina, Sportspeople who committed suicide
Mark Connolly (public official)	1955 births, 2019 deaths, Businesspeople from Massachusetts, Deaths from cerebral hemorrhage, US Democratic Party politicians, Politicians from Massachusetts, Politicians from New Hampshire
New Castle, New Hampshire	Towns in New Hampshire
St. Louis Lambert International Airport	20th-century establishments in Missouri, 1923 establishments in the United States, Airports in the United States, Buildings and structures in Missouri, St. Louis, Missouri
Feminist Anthropology	Feminism, Anthropology
Garden Valley, Idaho	Census-designated places in Idaho
Lincoln, Idaho	Census-designated places in Idaho
Lowman, Idaho	Census-designated places in Idaho
Villarbeney	Former municipalities of Fribourg, Villages in Fribourg
Forel, Fribourg	Former municipalities of Fribourg, Villages in Fribourg
Montbrelloz	Former municipalities of Fribourg, Villages in Fribourg
Autavaux	Former municipalities of Fribourg, Villages in Fribourg
1965 Palm Sunday tornado outbreak	Tornado outbreaks, Tornadoes in the United States, 1965 in the United States
La Tour-de-Trême	Former municipalities of Fribourg, Villages in Fribourg, Cities in Switzerland
Beirut Nights	Middle Eastern foods
Epidermis (botany)	Plant anatomy, Plant tissues
Monir Shahroudy Farmanfarmaian	1922 births, 2019 deaths, Deaths from natural causes, Iranian people, Painters
Yuriy Pimenov	1958 births, 2019 deaths, Rowers, Soviet Olympic silver medalists, Sportspeople from Moscow, Twin people
Nikolay Pimenov	1958 births, Living people, Rowers, Soviet Olympic silver medalists, Sportspeople from Moscow, Twin people
David V. Picker	1931 births, 2019 deaths, American Jews, Businesspeople from New York City, Cancer deaths in New York City, Deaths from colorectal cancer, Movie producers from New York City, Writers from New York City
Steve Golin	1955 births, 2019 deaths, Academy Award winners, American Jews, American movie producers, American television producers, Cancer deaths in Los Angeles
Mueller Report	Controversies in the United States
Ventseslav Konstantinov	1940 births, 2019 deaths, Bulgarian writers, Critics, People from Sofia, European translators
List of cities in South Korea	Lists of cities by country, Lists of cities in Asia, Cities in South Korea
Jacqueline Saburido	1978 births, 2019 deaths, Activists, Deaths from cancer, People from Caracas, Venezuelan people
Peter Skipper	1958 births, 2019 deaths, Deaths from stroke, English footballers, People from Kingston upon Hull, Sportspeople from Yorkshire
Indianapolis Racers	Ice hockey teams in the United States, World Hockey Association teams
Valdiram	1982 births, 2019 deaths, Deaths by beating, Brazilian footballers, Murdered sportspeople, Pernambuco
November 1992 tornado outbreak	Tornadoes in the United States, 1992 in the United States, Tornado outbreaks
Hannelore Elsner	1942 births, 2019 deaths, Deaths from breast cancer, Actors from Bavaria, Cancer deaths in Germany, German movie actors, German television actors
Stanisław Jędryka	1933 births, 2019 deaths, Polish movie directors, Polish screenwriters
Xiao Yang (judge)	1938 births, 2019 deaths, Chinese politicians, Communist politicians, Deaths from disease, Judges
Lake Agassiz	Lakes of North America
Juan José Muñante	1948 births, 2019 deaths, 1978 FIFA World Cup players, Cancer deaths in Florida, Deaths from lung cancer, Peruvian footballers
Cindy Axne	US Democratic Party politicians, United States representatives from Iowa, 1965 births, Living people
Biodiversity Convention	Treaties
Matthew Buckland	1974 births, 2019 deaths, South African businesspeople, Deaths from cancer, People from Cape Town, White South African people
Terry Rawlings	1933 births, 2019 deaths, British movie editors, Deaths from heart failure, People from London
Oiva Toikka	1931 births, 2019 deaths, Finnish artists, Designers
Heather Harper	1930 births, 2019 deaths, British singers, Commanders of the Order of the British Empire, Grammy Award winners, Musicians from Northern Ireland, British opera singers, People from Belfast, Sopranos
Jarosław Biernat	1960 births, 2019 deaths, Deaths from disease, Polish footballers
Chittagong Veterinary and Animal Sciences University	Colleges and universities in India
Giraffoidea	Even-toed ungulates
Wolcottville, Indiana	Towns in Indiana
David Milch	Emmy Award winners, 1945 births, Living people, People with bipolar disorder, People with Alzheimer's disease, American television directors, American television writers, Writers from Buffalo, New York
Lenny Johnrose	1969 births, Living people, English footballers, Sportspeople from Lancashire
Dick Rivers	1945 births, 2019 deaths, Cancer deaths in France, French movie actors, French television actors, French voice actors, Actors from Paris, French singers
Mark Medoff	Tony Award winners, 1940 births, 2019 deaths, Accidental deaths from falls in the United States, Cancer deaths in the United States, American playwrights, American stage actors, American movie actors, American educators, Screenwriters from Illinois, Actors from Illinois, Movie directors from Illinois
John Quinn (wrestler)	1941 births, 2019 deaths, Canadian professional wrestlers, Sportspeople from Ontario
William Krehm	1913 births, 2019 deaths, Canadian centenarians, Canadian journalists, Canadian activists, Political activists, Political commentators, Canadian businesspeople, Real estate developers, Writers from Toronto
Ira Neimark	1921 births, 2019 deaths, American educators, Writers from New York City, Businesspeople from New York City
Harrison, New York	Towns in New York, Villages in New York
James V. Schall	1928 births, 2019 deaths, Deaths from bone cancer, Cancer deaths in California, American Roman Catholics, American philosophers, American educators, Writers from Iowa
Barbara Marx Hubbard	1929 births, 2019 deaths, Infectious disease deaths in the United States, American political writers, American philosophers, Writers from New York City, Politicians from New York City
Herman Braun-Vega	1933 births, 2019 deaths, Peruvian painters, People from Lima
Jean-Jacques Honorat	1931 births, Living people, Prime Ministers of Haiti
Cara Williams	1925 births, Living people, American movie actors, American television actors, American stage actors, Actors from New York City
Claude Jarman Jr.	1934 births, Living people, American child actors, American movie actors, American television actors, American stage actors, Actors from Nashville, Tennessee
Manx pound	Isle of Man, British currency
Neale Daniher	1961 births, Living people, Australian rules footballers, Coaches, Order of Australia, Sportspeople from New South Wales
David Winters (choreographer)	1939 births, 2019 deaths, Actors from London, American choreographers, American dancers, American movie actors, American movie directors, American movie producers, American stage actors, American television actors, English dancers, English movie actors, English movie directors, English movie producers, English stage actors, English television actors, Jewish American actors, Jewish British actors
The Chinese Convert	17th century paintings, British paintings
Ocean planet	Types of planet
Crop top	Tops (clothing)
Jean-Pierre Marielle	1932 births, 2019 deaths, Actors from Paris, Disease-related deaths in Paris, French movie actors, French television actors
Johnny Neumann	1951 births, 2019 deaths, American basketball players, Cancer deaths in the United States, Coaches, Disease-related deaths in Mississippi, Indiana Pacers players, Los Angeles Lakers players, Sportspeople from Memphis, Tennessee
Peter Cartwright (lawyer)	1940 births, 2019 deaths, New Zealand lawyers, People from Dunedin
Donald McEachin	1961 births, Living people, American lawyers, United States representatives from Virginia, US Democratic Party politicians
Victor Borge	Kennedy Center honorees, 1909 births, 2000 deaths, Naturalized citizens of the United States, Danish musicians, American conductors, American pianists, Musicians from Connecticut, Comedians from Connecticut, People from Greenwich, Connecticut, People from Copenhagen, Jewish American musicians, Refugees from Nazism, Victims of Nazism
Cecil Souders	1921 births, 2021 deaths, American centenarians, Detroit Lions players, American military personnel of World War II, Sportspeople from Ohio
Henry B. Sayler	1921 births, Living people, State legislators of the United States, American lawyers, Politicians from Georgia (U.S. state), Politicians from Florida, People from Savannah, Georgia, US Republican Party politicians
Mildred J. Hill	1859 births, 1916 deaths, American songwriters, Writers from Louisville, Kentucky
Dan Tolkowsky	1921 births, Living people, Israeli military people, Aviators, People from Tel Aviv
Jaswant Singh Marwah	1921 births, Living people, Indian writers, Indian journalists, Indian military people
Patsy Reddy	1954 births, Living people, Governors General of New Zealand, Current national leaders
Gandalf Award	Awards
Robert Cardenas	1920 births, Living people, Naturalized citizens of the United States, American generals, American military personnel of World War II, American military personnel of the Vietnam War, Mexican military people, People from San Diego, California
Edwin Hunt	1920 births, Living people, British military personnel of World War II, People from London
William Moncrief	1920 births, Living people, American billionaires, American centenarians, Businesspeople from Fort Worth, Texas
The Avengers (1998 movie)	1998 action movies, 1998 thriller movies, 1990s action thriller movies, 1990s spy movies, American action thriller movies, American spy movies
Eddie Griffin	Musicians from Missouri, American comedians, American voice actors, American television actors, American movie actors, Actors from Kansas City, Missouri, 1968 births, Living people
Ronald Isley	American R&B singers, Musicians from Cincinnati, Ohio, African American musicians, American singer-songwriters, Singers from Cincinnati, Ohio, 1941 births, Living people, Writers from Cincinnati, Ohio
Treaty of Amiens	Treaties, Amiens, History of France, History of England
Skewes's number	Number theory
Wet'n'Wild Hawaii	Hawaii
Microsoft Visual C++	Microsoft
Overhead projector	Display technology, Machines
Heavy equipment	Construction
External combustion engine	Engineering
Novelty song	Songs
Warcraft 3	2002 video games
Silky anteater	Mammals of South America, Xenarthrans
John Havlicek	1940 births, 2019 deaths, American basketball players, Boston Celtics players, Deaths from Parkinson's disease, Disease-related deaths in Florida, Sportspeople from Ohio, National Basketball Association players with retired numbers
List of countries by past and projected GDP (nominal)	GDP-related lists of countries
Juan Francisco Rodríguez	1950 births, 2019 deaths, Boxers, People from Andalusia, Spanish Olympians
Fallout (series)	Fallout series, Video game series
Greg Theakston	1953 births, 2019 deaths, American comics artists, American illustrators, People from Detroit, Michigan
Eurasian eagle-owl	Strigiformes
Sergey Pogorelov	1974 births, 2019 deaths, 2000 Summer Olympics, 2004 Summer Olympics, Handball, Olympic bronze medalists, Olympic gold medalists, Russian sportspeople, Volgograd
Zoran Marojević	1942 births, 2019 deaths, 1968 Summer Olympics, Basketball players, Olympic silver medalists, Yugoslavian sportspeople
Fish stock (food)	Seafood, Cooking methods
Faty Papy	1990 births, 2019 deaths, African footballers, Burundian people
Comet Borrelly	Comets
Avalon (mythology)	Fictional locations
Robbert de Greef	1991 births, 2019 deaths, Cardiovascular disease deaths in Belgium, Deaths from cerebral hemorrhage, Deaths from myocardial infarction, Dutch cyclists, Sportspeople from North Brabant
Nasser Farbod	1922 births, 2019 deaths, Iranian military people, People from Tehran, Political activists
Ellen Schwiers	1930 births, 2019 deaths, German movie actors, German stage actors, German television actors
Lorenzo Quinteros	1945 births, 2019 deaths, Argentine movie actors, Argentine television actors, Argentine stage actors
Feargal Quinn	1936 births, 2019 deaths, Irish businesspeople, Irish philanthropists, Disease-related deaths in the Republic of Ireland, Former members of Seanad Éireann, Irish television personalities, People from Dublin
Jimmy Banks	1964 births, 2019 deaths, 1990 FIFA World Cup players, American footballers, Cancer deaths in the United States, Deaths from pancreatic cancer, Disease-related deaths in Wisconsin, American football managers, Sportspeople from Milwaukee, Wisconsin
Me!	2019 songs, Taylor Swift songs, Pop songs
Fabolous	1977 births, Living people, Musicians from Brooklyn
Hachette Book Group	2006 establishments in New York (state), Publishing companies of the United States, Companies based in New York City
Authors Guild	1910s establishments in New York (state), 1912 establishments in the United States, Organizations based in the United States, New York City
Somniosidae	Sharks
Ken Rothman	1935 births, 2019 deaths, American lawyers, Jewish American politicians, Politicians from St. Louis, Missouri, US Democratic Party politicians
Meana Sardo	Communes of Sardinia
San Gavino Monreale	Communes of Sardinia
Padria	Communes of Sardinia
Padru	Communes of Sardinia
Pattada	Communes of Sardinia
Perdasdefogu	Communes of Sardinia
Perfugas	Communes of Sardinia
Ploaghe	Communes of Sardinia
Porto Torres	Communes of Sardinia
Posada	Communes of Sardinia
Pozzomaggiore	Communes of Sardinia
Putifigari	Communes of Sardinia
Riola Sardo	Communes of Sardinia
Ruinas	Communes of Sardinia
Sadali	Communes of Sardinia
Sagama	Communes of Sardinia
Samassi	Communes of Sardinia
Samatzai	Communes of Sardinia
Samugheo	Communes of Sardinia
San Basilio	Communes of Sardinia
San Giovanni Suergiu	Communes of Sardinia
San Nicolò d'Arcidano	Communes of Sardinia
San Nicolò Gerrei	Communes of Sardinia
San Sperate	Communes of Sardinia
San Teodoro	Communes of Sardinia
San Vero Milis	Communes of Sardinia
San Vito	Communes of Sardinia
Santa Giusta	Communes of Sardinia
Sanluri	Communes of Sardinia
Santa Maria Coghinas	Communes of Sardinia
Santa Teresa Gallura	Communes of Sardinia
Santadi	Communes of Sardinia
Sant'Andrea Frius	Communes of Sardinia
Sant'Anna Arresi	Communes of Sardinia
Sant'Antioco	Communes of Sardinia
Sant'Antonio di Gallura	Communes of Sardinia
Santu Lussurgiu	Communes of Sardinia
Sardara	Communes of Sardinia
Sarule	Communes of Sardinia
Scano di Montiferro	Communes of Sardinia
Sedilo	Communes of Sardinia
Sedini	Communes of Sardinia
Segariu	Communes of Sardinia
Selegas	Communes of Sardinia
Semestene	Communes of Sardinia
Seneghe	Communes of Sardinia
Senis	Communes of Sardinia
Sennariolo	Communes of Sardinia
Sennori	Communes of Sardinia
Senorbì	Communes of Sardinia
Martin Rees	1942 births, Living people, British astronomers, British physicists, People from York
Serdiana	Communes of Sardinia
Serramanna	Communes of Sardinia
Serrenti	Communes of Sardinia
Serri	Communes of Sardinia
Province of South Sardinia	Provinces of Sardinia, Communes of the Province of South Sardinia
Setzu	Communes of Sardinia
Mores	Communes of Sardinia
Seui	Communes of Sardinia
Seulo	Communes of Sardinia
Robert May, Baron May of Oxford	1936 births, 2020 deaths, Deaths from pneumonia, Deaths from Alzheimer's disease, Australian biologists, Mathematicians, Zoologists, Ecologists, People from Sydney
Carrion beetle	Polyphaga
Hugo Gunckel Lüer	1901 births, 1997 deaths, Chilean scientists, Botanists, Pharmacists
Crown gear	Mechanics, Engineering
Four-field approach	Anthropology, Academic disciplines
Kate Gale	American political writers, 1965 births, Living people, Librettists
Hand2Mouth Theatre	Portland, Oregon, Theater
Aleksey Lebed	1955 births, 2019 deaths, Deaths from hemorrhage, Russian military people, Russian politicians
Homosexuality and religion	Religions, LGBT
Simply connected space	Mathematics, Geometry
Reijo Taipale	1940 births, 2019 deaths, Deaths from dementia, Disease-related deaths in Finland, Finnish singers, Pop singers
Jovita Carranza	1949 births, Living people, Administrators of the Small Business Administration, Treasurers of the United States, Businesspeople from Chicago, Politicians from Chicago, US Republican Party politicians
Hubert Hahne	1935 births, 2019 deaths, Deaths from dementia, Disease-related deaths in Germany, Formula One drivers, German racecar drivers, Sportspeople from North Rhine-Westphalia
Denton Lotz	1939 births, 2019 deaths, American Baptists, Christian ministers, People from Queens
Negasso Gidada	1943 births, 2019 deaths, Disease-related deaths in Germany, Independent politicians, Presidents of Ethiopia
Elina Bystritskaya	1928 births, 2019 deaths, Jewish actors, People from Kiev, Russian Jews, Russian movie actors, Russian television actors, Soviet Jews, Soviet movie actors, Soviet television actors, Ukrainian actors, Ukrainian Jews
Bart Chilton	1960 births, 2019 deaths, Civil servants, Deaths from pancreatic cancer, Politicians from Indiana, Politicians from Wilmington, Delaware
Sylvia Bretschneider	1960 births, 2019 deaths, Cancer deaths in Germany, Politicians from Mecklenburg-Vorpommern, Politicians of the Social Democratic Party of Germany
Ogden Dunes, Indiana	Towns in Indiana
Forestdale, Massachusetts	Census-designated places in Massachusetts
Sandwich, Massachusetts	Towns in Massachusetts
José Rizo Castellón	1944 births, 2019 deaths, Disease-related deaths in Chile, Vice Presidents of Nicaragua
Mika McKinnon	Year of birth missing (living people), Living people, Female scientists
Gennadi Yakovlev	1938 births, Living people, Russian botanists
María de los Ángeles Moreno	1945 births, 2019 deaths, Presidents of the Senate of the Republic (Mexico), Presidents of the Chamber of Deputies (Mexico), Politicians from Mexico City
Larry "Flash" Jenkins	1955 births, 2019 deaths, Actors from New York City, African-American movie actors, African American movie directors, African American movie producers, African-American screenwriters, African-American television actors, Cardiovascular disease deaths in Los Angeles, Deaths from myocardial infarction, Movie directors from New York City, Movie producers from New York City, Screenwriters from New York City
Jessie Lawrence Ferguson	1942 births, 2019 deaths, Actors from the Bronx, African-American movie actors, African-American television actors
Chronic inflammatory demyelinating polyneuropathy	Diseases
Mayda Insula	Saturn's moons
Wayson Choy	1939 births, 2019 deaths, Autobiographers, Canadian LGBT people, Canadian novelists, Gay men, LGBT novelists, Order of Canada, People from Vancouver, Writers from British Columbia
Josef Šural	1990 births, 2019 deaths, Czech footballers, Road accident deaths, UEFA Euro 2016 players
Les Murray (poet)	1938 births, 2019 deaths, Australian poets, Australian Roman Catholics, Australian critics, Editors, Order of Australia, Writers from New South Wales
Deaths in May 2019	2019 deaths, May 2019 events
Karol Modzelewski	1937 births, 2019 deaths, Adoptees, Polish educators, Legion of Honour, People from Moscow, Polish academics, Polish historians, Polish politicians, Polish writers
Adenocalymma	Bignoniaceae
Saburtalo Pantheon	Cemeteries, Buildings and structures in Asia, Tbilisi
Python License	Programming languages, Licenses
Menachem Mendel Taub	1923 births, 2019 deaths, American rabbis, Holocaust survivors, Israeli rabbis, Jewish Israeli writers, Naturalized citizens of Israel, Naturalized citizens of the United States, Romanian Jews
Pecora	Even-toed ungulates
Karl Kroeber	1926 births, 2009 deaths, Deaths from cancer, American academics
TheOdd1sOut	1996 births, Living people, American animators, Internet celebrities, Writers from Arizona
Alaska's Flag	Alaska, 1930s songs, United States state songs
20 July Plot	World War II
Eric Kent	1919 births, 2019 deaths, Australian Labor Party politicians, Order of Australia, Politicians from Victoria (Australia)
Wolf's Lair	Military of Germany, World War II
Bruce Bickford (animator)	1947 births, 2019 deaths, American animators, American filmmakers, People from Seattle, Washington
Sinethemba Jantjie	1989 births, 2019 deaths, Road accident deaths, South African footballers
Joe Sanberg	1979 births, Living people, Democrats (United States), Businesspeople from Los Angeles, California
Daniel Horlaville	1945 births, 2019 deaths, French footballers
Zubair Torwali	Pakistani writers, Linguists, Living people, Year of birth missing (living people)
Mia Mottley	1965 births, Living people, Prime Ministers of Barbados, Lawyers, Current national leaders, Women lawyers, Women politicians, Caribbean people
Gersemi	Norse gods and goddesses
Ellen Tauscher	1951 births, 2019 deaths, American diplomats, Cancer survivors, Deaths from pneumonia, Politicians from Newark, New Jersey, United States representatives from California, Women diplomats, Women politicians
Anémone	1950 births, 2019 deaths, Actors from Paris, Cancer deaths in France, Deaths from lung cancer, French movie actors
Matoug Adam	1926 births, 2019 deaths, Civil servants, Libyan politicians, Poets
Andrew County, Missouri	1841 establishments in Missouri, Missouri counties
Converse County, Wyoming	1880s establishments in Wyoming Territory, 1888 establishments in the United States, Wyoming counties
Fred McLafferty	1923 births, Living people, American chemists, People from Evanston, Illinois
Daniele da Volterra	1509 births, 1566 deaths
Chariot racing	Ancient sports, Horse racing, Ancient Greece, Ancient Rome
Emma Haruka Iwao	World record holders, Living people, Year of birth missing (living people), LGBT scientists, Female scientists, Japanese scientists, Google people
List of women linguists	Lists of women, Women linguists, Lists of people by occupation
Diane Larsen-Freeman	1946 births, Living people, American academics, Women linguists
Thermomicrobia	Gram-negative bacteria
Sunny Garcia	1970 births, Living people, Sportspeople from Hawaii
B. Subhashan Reddy	1943 births, 2019 deaths, Disease-related deaths in India, Chief justices, Hyderabad, India, Indian politicians
S. P. Y. Reddy	1950 births, 2019 deaths, Andhra Pradesh, Deaths from respiratory tract infection, Indian politicians, Infectious disease deaths in India‎
Alejandro Planchart	1935 births, 2019 deaths, American composers, American conductors, Harvard University alumni, Musicologists, People from Caracas, Yale University alumni
Roy Hattersley	1932 births, Living people, British journalists, UK MPs 1964–1966, UK MPs 1966–1970, UK MPs 1970–1974, UK MPs 1974, UK MPs 1974–1979, UK MPs 1979–1983, UK MPs 1983–1987, UK MPs 1987–1992, UK MPs 1992–1997, Former Labour MPs (UK), People from Sheffield, Politicians from Yorkshire, Writers from Yorkshire
Yves-François Blanchet	1965 births, Living people, Members of the House of Commons of Canada from Quebec
Maxime Bernier	1963 births, Living people, Canadian businesspeople, Canadian lawyers, Writers from Quebec, Members of the House of Commons of Canada from Quebec, Privy Councillors (Canada)
People's Party of Canada	Political parties in Canada, 2018 establishments, 2010s establishments in Canada, Conservative parties
Blanca Rodríguez	1926 births, 2020 deaths, Deaths from respiratory failure, Deaths from pulmonary embolism, Venezuelan people, First Ladies
2019 UNCC shooting	2019 mass shootings, 2019 murders in the United States, 2010s mass shootings in the United States, 21st century in North Carolina, April 2019 events, Attacks on buildings and structures in 2019, Charlotte, North Carolina, School shootings in the United States
Louis Rosenblum	1923 births, 2019 deaths, Engineers from New York, American political activists, American political writers, Researchers, Scientists from New York City, Writers from New York City
Frederick Hemke	1935 births, 2019 deaths, American saxophonists, American educators, American composers, People from Evanston, Illinois, Musicians from Milwaukee, Wisconsin, Musicians from Illinois
Martin Kilson	1931 births, 2019 deaths, American political scientists, American educators, Writers from New Jersey
Nils John Nilsson	1933 births, 2019 deaths, American computer scientists, Engineers from Michigan, American educators, People from Saginaw, Michigan, Scientists from Michigan
Shakey the robot	Robots
Petar Omčikus	1926 births, 2019 deaths, Painters, People from Belgrade
Jo Sullivan Loesser	1927 births, 2019 deaths, Deaths from heart failure, Cardiovascular disease deaths in New York City, American stage actors, Actors from Illinois, Singers from Illinois
Beth Carvalho	1946 births, 2019 deaths, Deaths from staphylococcal infection, Brazilian singers, Brazilian musicians, Guitarists, People from Rio de Janeiro
Luis Maldonado Venegas	1956 births, 2019 deaths, Deaths from surgical complications, Mexican lawyers, Politicians from Mexico City
English Landing Park	Parks in the United States, Missouri
Eldon Bargewell	1947 births, 2019 deaths, Accidental deaths in the United States, American generals, American military personnel of the Vietnam War, People from Washington
Hoquiam, Washington	Cities in Washington (U.S. state)
Dinko Dermendzhiev	1941 births, 2019 deaths, 1962 FIFA World Cup players, 1966 FIFA World Cup players, 1970 FIFA World Cup players, Bulgarian footballers, Bulgarian football managers, Deaths from stroke
Watford City, North Dakota	Cities in North Dakota, County seats in North Dakota
Caroline Bittencourt	1981 births, 2019 deaths, Accidental deaths by drowning, Brazilian models, People from São Paulo, Brazilian television presenters
Luciano Comaschi	1931 births, 2019 deaths, Italian footballers, Italian football managers
Scotts Corner, California	Settlements in Alameda County, California, Unincorporated communities in California
Taylor Hawkins	1972 births, Grammy Award winners, Musicians from California, Living people, People from Laguna Beach, California, Musicians from Fort Worth, Texas, Writers from Fort Worth, Texas, Singers from Texas, Singers from California, Writers from California, American rock singers, American rock guitarists, American rock drummers, American pianists, American punk musicians
Cultural Materialism	Sociology
Dresser, California	Settlements in Alameda County, California, Unincorporated communities in California
Japanese Canadians	Ethnic groups in Canada
Sweet but Psycho	2018 songs, Dance-pop songs, Pop songs
Australian Canadians	Ethnic groups in Canada
Portuguese Canadians	Ethnic groups in Canada
Black Canadians	African people, Ethnic groups in Canada
Gliese 832c	Exoplanets
Jamaican Canadians	Ethnic groups in Canada
American Canadians	Ethnic groups in Canada
Howie Hawkins 2020 presidential campaign	2020 United States presidential campaigns
Dario Hunter 2020 presidential campaign	2020 United States presidential campaigns
Adam Kokesh 2020 presidential campaign	2020 United States presidential campaigns
John McAfee 2020 presidential campaign	2020 United States presidential campaigns, John McAfee
Arvi Parbo	1926 births, 2019 deaths, Australian businesspeople, People from Tallinn, Order of Australia
Steve Bullock 2020 presidential campaign	2020 United States presidential campaigns
Dunaden	2006 births, 2019 deaths, Thoroughbred racehorses
Alexis Ohanian	1983 births, Living people, Businesspeople from New York City, American Internet celebrities
Qaem Shahr	Cities in Iran
Micha Lindenstrauss	1937 births, 2019 deaths, German Jews, Israeli civil servants, Israeli judges, Jewish judges, Naturalized citizens of Israel, Politicians from Berlin, Refugees from Nazism
Filipino Americans	Ethnic groups in the United States
Master Hirannaiah	1934 births, 2019 deaths, Deaths from liver disease, Indian movie actors, Indian stage actors
Italian Canadians	Ethnic groups in Canada
Su Yu-chang	1940 births, 2019 deaths, Chinese educators
Alessandra Panaro	1939 births, 2019 deaths, Italian movie actors, Actors from Rome
German Canadians	Ethnic groups in Canada
Dino Risi	1916 births, 2008 deaths, Italian movie directors, Italian screenwriters, People from Milan
Marisa Allasio	1934 births, Living people, Italian movie actors, People from Turin
American Jews	Ethnic groups in the United States
Rafael Hernández Colón	1936 births, 2019 deaths, Deaths from acute myeloid leukemia, Governors of Puerto Rico, US Democratic Party politicians
Governor of Puerto Rico	Governors of Puerto Rico
Michel Crauste	1934 births, 2019 deaths, French rugby union players
Johan August Arfwedson	1792 births
Scandinavian Canadian	Ethnic groups in Canada
Swedish Canadians	Ethnic groups in Canada
Norwegian Canadians	Ethnic groups in Canada
Czech Canadians	Ethnic groups in Canada
Swiss Canadian	Ethnic groups in Canada
Campbell County, Wyoming	1911 establishments in Wyoming, Wyoming counties
God Save Our Solomon Islands	National anthems, Solomon Islands
Sebastopol, California	Settlements in Sonoma County, California, Towns in California
Mars Orbiter Mission	Mars, Spacecraft, India, 2013 in India
Zadie Smith	1975 births, Alumni of King's College, Cambridge, Living people, English writers
Red Kelly	1927 births, 2019 deaths, Canadian ice hockey centres, Canadian ice hockey defencemen, Detroit Red Wings players, Hockey Hall of Fame inductees, Ice hockey people from Ontario, James Norris Memorial Trophy winners, Lady Byng Memorial Trophy winners, Order of Canada, Politicians from Toronto, Sportspeople from Toronto, Stanley Cup champions, Toronto Maple Leafs players, Ontario Hockey League players, Members of the House of Commons of Canada from Ontario
Viggo Fossum	1949 births, 2019 deaths, Mayors, Norwegian politicians
Radha Krishn	Indian television series
Songbird (Oasis song)	Oasis (band) songs
Scott W. Sloan	1954 births, 2019 deaths, Australian academics, Australian educators, Engineers, Fellows of the Royal Society, Order of Australia, People from Victoria (Australia)
RadhaKrishn	Indian television series
Marble, Minnesota	Cities in Minnesota
Chris Reccardi	1964 births, 2019 deaths, American animators, American television directors, American television writers, Artists from New York City, Cardiovascular disease deaths in California, Deaths from myocardial infarction, Screenwriters from New York City
Roseville, California	Cities in California, Settlements in Placer County, California
Kenny Loggins	1948 births, Living people, American composers, American country guitarists, American country singers, American pop singers, American rock guitarists, American rock singers, American singer-songwriters, Grammy Award winners, Musicians from Washington
Boyd, Texas	Towns in Texas
Fatimih Dávila	1988 births, 2019 deaths, Beauty pageant winners, Models, Murder victims, Uruguayan people
Lord Toby Jug	1965 births, 2019 deaths, Politicians from London
Clarice Phelps	Year of birth missing (living people), Living people, African-American military personnel, Female scientists, American chemists, People of Tennessee State University
Endeavour Award	Science fiction awards, Literary awards
Grappes Bluff, Louisiana	Unincorporated communities in Natchitoches Parish, Louisiana
Arne Sorenson	1958 births, 2021 deaths, American LGBT rights activists, American lawyers, Deaths from pancreatic cancer, Democrats (United States), Businesspeople from Washington, D.C., Businesspeople from Tokyo
Jack Young (politician)	1954 births, Living people, Mayors of Baltimore, US Democratic Party politicians
Angela Sarafyan	1983 births, Living people, Naturalized citizens of the United States, Armenian actors, American movie actors, American television actors, American voice actors, People from Yerevan
Prospero Nograles	1947 births, 2019 deaths, Deaths from respiratory failure, Deaths from pneumonia, Speakers of the House of Representatives of the Philippines, Filipino lawyers, Majority leaders of the House of Representatives of the Philippines
Sylvain Sylvain	1951 births, 2021 deaths, Deaths from bladder cancer, American rock guitarists, American punk musicians, Jewish American musicians, Musicians from New York City, People from Cairo
Mills Lane	American television personalities, American boxers, 1930s births, Living people
The Power of Love (song)	Pop songs, Celine Dion songs, 1984 songs
Ali Mroudjaé	1939 births, 2019 deaths, African politicians, Comoros, Deaths from disease, Prime ministers
Issa J. Boullata	1929 births, 2019 deaths, Christians, Educators, People from Jerusalem, Translators
Terje Moe Gustavsen	1954 births, 2019 deaths, Civil servants, Deaths from respiratory tract infection, Norwegian politicians
Rachel Held Evans	1981 births, 2019 deaths, American Christians, American columnists, American journalists, Bloggers, Christian writers, Infectious disease deaths in the United States, Writers from Birmingham, Alabama, Writers from Tennessee, American bloggers
Dayton, Tennessee	Cities in Tennessee, County seats in Tennessee
Bodega, California	Settlements in Sonoma County, California, Census-designated places in California, Towns in California
Valley Ford, California	Settlements in Sonoma County, California, Census-designated places in California, Unincorporated communities in California
Goro Shimura	1930 births, 2019 deaths, Japanese mathematicians, Princeton University faculty, University of Tokyo alumni
Goshen County, Wyoming	1911 establishments in Wyoming, Wyoming counties
Torrington, Wyoming	Cities in Wyoming, County seats in Wyoming
Mirabeau B. Lamar	1798 births, 1859 deaths, Deaths from myocardial infarction, American lawyers, American poets, Ambassadors of the United States, Politicians from Texas, Politicians from Georgia (U.S. state)
Carbon County, Wyoming	1868 establishments in Wyoming Territory, Wyoming counties
Anson Jones	1798 births, 1858 deaths, Suicides by firearm in the United States, American physicians, Businesspeople from Texas, Politicians from Texas, Businesspeople from Massachusetts, Politicians from Massachusetts
Tonic water	Soft drinks
Tommy Raudonikis	1945 births, 2021 deaths, Australian rugby league players, Coaches, Order of Australia, Cancer deaths in Queensland, Sportspeople from New South Wales
Scott Dureau	1986 births, Living people, Australian rugby league players, People with cancer, Sportspeople from New South Wales
Loleta, California	Settlements in Humboldt County, California, Census-designated places in California, Towns in California
John Herriott	1844 births, 1918 deaths, Politicians from Pennsylvania, Lieutenant Governors of Iowa
Osmoderma eremita	Polyphaga, Animals of Europe
Cantharis fusca	Polyphaga, Animals of Europe
Cantharis rufa	Polyphaga, Animals of Europe
Frédéric Bartholdi	1834 births, 1904 deaths, French sculptors, French military people, Freemasons, Legion of Honour, People from Grand Est, Infectious disease deaths in France, Deaths from tuberculosis
St. Clair, Michigan	Cities in Michigan
Valentino (fashion designer)	1932 births, Living people, Italian fashion designers, Italian LGBT people, Legion of Honour, LGBT fashion designers, People from Lombardy
Shih Chi-yang	1935 births, 2019 deaths, Deaths from multiple organ failure, Taiwanese politicians
Marilù Tolo	1944 births, Living people, Actors from Rome, Italian models, Italian movie actors, Italian television actors
Chiu Chuang-huan	1925 births, 2020 deaths, Deaths from pneumonia, Vice presidents, Taiwanese politicians
Guido van den Berg	1975 births, 2019 deaths, Cancer deaths in Germany, German economists, Politicians from North Rhine-Westphalia, Politicians of the Social Democratic Party of Germany
Monica Vitti	1931 births, Living people, Actors from Rome, Italian movie actors, Italian movie directors, Italian stage actors, Italian television actors, People with Alzheimer's disease
Rawlins, Wyoming	Cities in Wyoming, County seats in Wyoming
Crook County, Wyoming	19th-century establishments in Wyoming, 1875 establishments in the United States, Wyoming counties
Panghuang	Chinese novels
Robert Brown	1773 births, 1858 deaths, Scottish scientists, Fellows of the Royal Society
Ravendale, California	Unincorporated communities in California, Settlements in Lassen County, California
Spaulding, California	Census-designated places in California, Settlements in Lassen County, California
Masherbrum	Mountains of Pakistan, Gilgit-Baltistan, Karakoram
Gasherbrum I	Mountains of Pakistan, Mountains of China, Karakoram
Batura Sar	Mountains of Pakistan, Gilgit-Baltistan, Karakoram
Jo Walton	1964 births, Canadian novelists, Living people, Hugo Award winning writers, Welsh writers, Canadian science fiction writers, British science fiction writers, Bloggers
Murray Thomson	1922 births, 2019 deaths, Canadian activists, Canadian Christians, Order of Canada, People from Ontario, Quakers
Aeroflot Flight 1492	2019 in Europe, Aviation disasters in Europe, 2019 aviation disasters, 21st century in Moscow
Carmel, New York	Towns in New York, County seats in New York
Scarsdale, New York	Towns in New York, Villages in New York
Brett Halsey	1933 births, Living people, American movie actors, American television actors, Actors from Santa Ana, California
Cytoplasmic streaming	Cell biology, Botany, Plant physiology
British Science Association	1830s establishments in the United Kingdom, Royal Borough of Kensington and Chelsea, Science in society
Dexter King	1961 births, African-American people, American civil rights activists, People from Atlanta, Georgia, Living people
Bernice King	People from Atlanta, Georgia, African-American people, 1963 births, Living people
Gasherbrum II	Karakoram, Mountains of Pakistan, Mountains of China, Gilgit-Baltistan, Xinjiang
Angel Witch	British musical groups
Colt Single Action Army	Revolvers
Bici Bici	Turkish food, Desserts
Line of Duty	BBC television dramas, 2010s British drama television series, Pages with unreviewed translations, Police television series, English-language television programs
Gasherbrum III	Karakoram, Mountains of Pakistan, Mountains of China, Gilgit-Baltistan, Xinjiang
Deaths in September 2016	2016 deaths, September 2016 events
Anne of Green Gables (1979 TV series)	1970s television series, 1979 television series debuts, 2010 anime movies, Anime series, Children's television series, Fictional orphans, Japanese movies, Studio Ghibli
Mamostong Kangri	Karakoram, Jammu and Kashmir, Mountains of India
Dala Airport	Airports in Sweden
Michael Mastro	Real estate developers, 1925 births, Living people, Businesspeople from Seattle, Washington, Extradition
Gasherbrum IV	Karakoram, Mountains of Pakistan, Mountains of China, Gilgit-Baltistan, Xinjiang
Distaghil Sar	Karakoram, Mountains of Pakistan, Gilgit-Baltistan
Hello, Dolly! (movie)	Movies based on plays, American romantic comedy movies, American musical comedy movies, Academy Awards, 1960s musical movies, 1969 comedy movies, Movies set in the 1890s
Barbara Perry	1921 births, 2019 deaths, American television actors, American movie actors, American stage actors, American dancers, Singers from Virginia, Actors from Virginia, People from Norfolk, Virginia
Kadir Mısıroğlu	1933 births, 2019 deaths, Turkish writers, Turkish poets, Turkish lawyers, Turkish journalists
Max Azria	1949 births, 2019 deaths, Deaths from lung cancer, Cancer deaths in Texas, Tunisian businesspeople, American fashion designers, Fashion designers, People from Tunis
Gjermund Eggen	1941 births, 2019 deaths, Norwegian sportspeople, Norwegian Olympians, Skiers
Paz de la Huerta	1984 births, Living people, American movie actors, American television actors, American voice actors, American models, Actors from New York City
Ron Darling	1960 births, Living people, People with cancer, New York Mets players, Montreal Expos players, Oakland Athletics players, Sportspeople from Hawaii, People from Honolulu
1G	Telecommunications, Mobile phones
2G	Telecommunications, Mobile phones
Dante Gullo	1947 births, 2019 deaths, Argentine politicians, People from Buenos Aires, Sociologists
Pratibhasthali	Schools
Wolfville	Towns in Nova Scotia
Windsor, Nova Scotia	Towns in Nova Scotia
Westville, Nova Scotia	Towns in Nova Scotia
Trenton, Nova Scotia	Towns in Nova Scotia
Jean Vanier	1928 births, 2019 deaths, Canadian academics, Canadian activists, Canadian Christians, Canadian writers, Cancer deaths in France, Deaths from thyroid cancer, Humanitarians, Legion of Honour, Order of Canada, People from Geneva, Philosophers, Roman Catholics, Theologians
Deaths in October 2016	2016 deaths, October 2016 events
Te Wharehuia Milroy	1937 births, 2019 deaths, New Zealand academics, New Zealand Māori people
Genrikh Novozhilov	1925 births, 2019 deaths, Russian engineers, People from Moscow
Alburnoides bipunctatus	Freshwater fish
Acanthopagrus latus	Freshwater fish
Adam Svoboda	1978 births, 2019 deaths, Czech ice hockey goaltenders, Ice hockey coaches, People from Brno, Sportspeople who committed suicide, Suicides by hanging, Swedish Hockey League players
Khunyang Chhish	Kunyang Chhish, Karakoram, Mountains of Pakistan, Gilgit-Baltistan
Cosimo de' Medici	1389 births, 1464 deaths, House of Medici
Kanjut Sar	Kanjut Sar, Mountains of Pakistan, Gilgit-Baltistan, Karakoram
Launch vehicle	Spaceflight
Sprent Dabwido	1972 births, 2019 deaths, Cancer deaths in New South Wales, Deaths from throat cancer, Nauru, Presidents (government), Weightlifters
Paris, France (movie)	NC-17 rated movies, 1994 comedy-drama movies, Canadian comedy movies, Canadian drama movies

