Constantine the Great	272 births, 337 deaths, Byzantine Emperors
Cleopatra VII	69 BC births, 30 BC deaths, Pharaohs, People from Alexandria
Kelly Clarkson	1982 births, Living people, American Idol winners, American pop singers, Extras, Grammy Award winners, Kelly Clarkson, Writers from Fort Worth, Texas, Musicians from Fort Worth, Texas, Actors from Fort Worth, Texas, Singer-songwriters from Texas
Maurice Ravel	1875 births, 1937 deaths, 20th century composers, French composers
Jean-Philippe Rameau	1683 births, 1764 deaths, French composers, Baroque composers, Music theorists
Bedřich Smetana	Czech composers, Romantic composers, 1824 births, 1884 deaths
Light-emitting diode	Electronic components
Antonín Dvořák	Czech composers, Romantic composers, 1841 births, 1904 deaths
Leoš Janáček	Czech composers, Romantic composers, 20th century composers, 1854 births, 1928 deaths
Arthur Sullivan	1842 births, 1900 deaths, English composers, Romantic composers, Gilbert and Sullivan
Psychosis	Psychosis
Ramen	Soups, Noodles, Japanese food
Peter Paul Rubens	1577 births, 1640 deaths, Flemish painters
Adolf Frederick of Sweden	1710 births, 1771 deaths, Kings and Queens of Sweden
Gothenburg	Port cities and towns of the North Sea, Gothenburg, 1621 establishments, 1620s establishments in Europe, 17th century establishments in Sweden
BBC One	1936 establishments in Europe, BBC television channels, 1930s establishments in the United Kingdom
Bad Aibling	Towns in Bavaria, Spa towns in Germany, Rosenheim (district)
Gaya	Cities in India, Settlements in Bihar
Patna	Capital cities in India, Settlements in Bihar
Samuel Johnson	1709 births, 1784 deaths, Deaths from surgical complications, English Anglicans, English writers, People buried in Westminster Abbey, People from Staffordshire
Nozomi (Shinkansen)	Rapid transit systems, Shinkansen
Moravia	Geography of the Czech Republic
Advanced Photo System	Photography
Coral reef	Biomes, Reefs
Laurel wreath	Ancient Greece, Awards, Headgear
Ranchi	Capital cities in India, Jharkhand
Ujjain	Settlements in Madhya Pradesh, Cities in India
Ayodhya	Cities and towns in Uttar Pradesh
Tulsidas	1543 births, 1623 deaths, Indian writers, People from Uttar Pradesh
Mathura	Cities and towns in Uttar Pradesh
Pulitzer Prize	Pulitzer Prizes
Titan (mythology)	Titans
Turkish language	Turkic languages
Phoebe (Titan)	Titans
Rhea (mythology)	Titans
Magnus II of Sweden	Kings and Queens of Sweden, 12th century births, 1161 deaths
Karl Sverkersson	1130s births, 1167 deaths, Kings and Queens of Sweden
Knut Eriksson	12th century births, 1190s deaths, Kings and Queens of Sweden
Sverker II of Sweden	Kings and Queens of Sweden, 1160s births, 1210 deaths
Eric X of Sweden	Kings and Queens of Sweden, 1180 births, 1216 deaths
Johan Sverkersson	1200s births, 1222 deaths, Kings and Queens of Sweden
Eric XI of Sweden	Kings and Queens of Sweden, 1216 births, 1250 deaths
Westboro Baptist Church	Baptist churches, 1955 establishments in the United States, LGBT in the United States, Churches in the United States, 20th-century establishments in Kansas, Buildings and structures in Kansas, Homophobia
University of Chicago	Association of American Universities, Colleges and universities in Chicago, 1890 establishments in the United States, 1890s establishments in Illinois
Shanghai Fugu Agreement	Hesse, Politics of Germany, 1985 in Europe, 1980s in Germany
Siren (noisemaker)	Tools, Electronics
Washington Capitals	Washington Capitals
Rhea Silvia	Roman mythology
Virginity	Sexuality
Tethys (mythology)	Titans
Sarajevo	Sarajevo, Olympic cities
Iapetos	Titans
Kronos	Titans
Okeanos	Titans
Okeanid	Nymphs
Kreios	Titans
Koios	Titans
Uranos	Greek gods and goddesses
Gaia (mythology)	Greek gods and goddesses
Erebos	Greek gods and goddesses
Kallisto	Nymphs
Semele	People in Greek mythology
Robbie Williams	1974 births, Living people, English pop singers, Musicians from Staffordshire, People from Stoke-on-Trent
Hyperion (Titan)	Titans
Durga	Hindu gods and goddesses
Theia	Titans
Themis	Titans
Adi Shankara	Indian educators, Hinduism, 788 births, 820 deaths
Lake Garda	Lakes of Italy, Trentino-Alto Adige/Südtirol, Lombardy, Veneto
Award	Awards
Thetis	Nymphs
Tirunelveli	Cities in Tamil Nadu, Tirunelveli District
Domestic worker	Basic English 850 words, Domestic work
Cassandra	People in Greek mythology
Leda	People in Greek mythology
Tyndareus	People in Greek mythology
Telemachus	People in Greek mythology
Antonio Vivaldi	1678 births, 1741 deaths, Italian composers, Baroque composers, People from Venice
Agamemnon	People in Greek mythology, Classical Greek literature
Menelaus	People in Greek mythology
Clytemnestra	People in Greek mythology
Percussion instrument	Percussion instruments
Hurrians	Ethnic groups in Asia, Mesopotamian people
Oneiroi	Greek gods and goddesses
Malcolm X	1925 births, 1965 deaths, American burglars, American civil rights activists, American Muslims, Murdered African-American people, Murders by firearm in New York, People from Omaha, Nebraska, People murdered in New York
Nereus	Greek gods and goddesses
James MacMillan	British composers, 20th century composers, 21st century composers, 1959 births, Living people, Scottish people
Polyphemos	Greek legendary creatures
Federated States of Micronesia	Federated States of Micronesia
Pär Lagerkvist	1891 births, 1974 deaths, Swedish writers
Thanatos	Greek gods and goddesses
Medication	Drugs
Ahimsa	Hinduism, Jainism, Buddhism
Kabir	Hindu saints, 1440 births, 1518 deaths, Asian Sufis, Mystics
Indus River	Rivers of Pakistan
Jagannath	Hinduism
Patanjali	Yoga, Hinduism, Indian people
Calypso	Nymphs
Dialects of English	Dialects of English
Music theory	Music theory
Ravana	Hindu mythology, History of Sri Lanka
Devaki	Hindu mythology
Ayurveda	Indian culture, Pseudoscience
Ganges	Rivers of India, National symbols of India, Rivers of Bangladesh
Sita	Hindu gods and goddesses
Halimah bint Abi Dhuayb	Muslims, 6th century births, Year of death unknown
Khadijah bint Khuwaylid	555 births, 619 deaths, Muslims, Family of Muhammad
555	555
619	619
Sarasvati River	Rivers of Pakistan, Tributaries of the Indus River, Rivers of India
Ming dynasty	Chinese dynasties, 1368 establishments, 14th century establishments in Asia, Establishments in China, 1644 disestablishments, Disestablishments in China, 1640s disestablishments in Asia
Saraswati	Hindu gods and goddesses
Holi	Hindu festivals, Indian culture, Maharashtra, Religious holidays, Sikhism, Suriname
Beaminster	Towns in Dorset
Electronic music	Electronic music
Reggae	Reggae music, Pop music
Bebop	African-American history, Jazz music
Magnetic resonance imaging	Medical procedures, Medical imaging
Refugee camp	Forced migration, War
Rubber	Natural materials, Polymers
Argument	Basic English 850 words, Mathematics, Human communication, Philosophy
2003 invasion of Iraq	2003 in Asia, Iraq War, 21st century in Iraq
Helmet	Protective clothing, Headgear
Coonskin cap	Headgear
Crazy Horse Memorial	Monuments and memorials in the United States, South Dakota
1727	1727
1720	1720
1725	1725
Dwarka	Hinduism
Ramayana	Hinduism, Hindu texts
Mahabharata	Mahabharata, Hinduism, Hindu texts, National symbols of India
Hajj	Islam, Mecca, Religion in Saudi Arabia, Worship
English Civil War	Wars involving England, Civil wars, Rebellions in Europe, 17th century rebellions, 17th century in England, History of Scotland, History of Ireland, 1640s in Europe, 1650s in Europe
Urdu	Languages of Pakistan, National symbols of Pakistan, Urdu language, Languages of India, Languages of Azad Jammu and Kashmir, Languages of Jammu and Kashmir
Zakat	Islam, Giving
Salat	Salah, Worship
Fasting in Islam	Islam
Franz Schubert	Austrian composers, Classical era composers, Writers from Vienna, Romantic composers, 1797 births, 1828 deaths
Cowpox	Diseases caused by viruses, Animal diseases
1535	1535
1689	1689
532	532
1658	1658
408	408
1696	1696
1647	1647
1698	1698
Margaret Atwood	1939 births, Living people, Canadian novelists, Agnostics, Award winning writers, Booker Prize winners, Canadian activists, Canadian feminists, Canadian poets, Children's writers, Feminist writers, Harvard University alumni, Canadian science fiction writers
Variola virus	Viruses
Rainbow Brite	Animated television series, English-language television programs
Chickenpox	Diseases caused by viruses
1742	1742
1624	1624
1279	1279
1046	1046
Tonality	Music theory
Toucan	Piciformes
Elbow	Joints
Wrist	Joints
Knee	Basic English 850 words, Joints
Atomic theory	Nuclear physics, Chemistry
Particle physics	Subatomic particles
X Japan	Japanese heavy metal bands, Speed metal bands, Power metal bands, Progressive metal bands, Glam metal bands, Visual kei bands, 1982 establishments in Japan
State Anthem of the Soviet Union	National anthems, Soviet Union, 1944 establishments in the Soviet Union
Minimalism	Musical movements, Art movements
Igor Stravinsky	1882 births, 1971 deaths, Russian composers, 20th century composers, Grammy Award winners, Ballets Russes
Emilio de Villota	1946 births, Living people, Spanish sportspeople, Formula One drivers
TAE connector	Electrical connectors
Technological singularity	Technology
Mew (Pokémon)	Fictional characters introduced in 1996, Pokémon monsters
Avignon	Avignon, Departmental capitals in France, World Heritage Sites in France
Marseille	Departmental capitals in France, Marseille, Regional capitals in France
Halo 2	2004 video games, Xbox games, Windows games, Halo
Actuary	Mathematicians, Business, Financial occupations
Thesaurus	Reference works, Language
Bass (fish)	Perciformes
Roxette	1980s Swedish music groups, 1990s Swedish music groups, 2000s Swedish music groups, 2010s Swedish music groups, Musical groups established in 1986, Pop rock bands, Swedish pop music groups, Swedish rock music groups
Hindu scripture	Hinduism, Hindu texts
Aum	Hinduism, Religious symbols
Norfolk Island	Pacific islands, Commonwealth dependent states, Islands of Australia, 1979 establishments in Australia, Norfolk Island
Atlas (mythology)	Titans
El Paso, Texas	El Paso, Texas, County seats in Texas
Ecosystem	Ecosystems
House of Stuart	House of Stuart, Kings and Queens of England, Kings and Queens of Scotland
Parasitism	Parasitism, Coevolution, Symbiosis
Moment of silence	Relationships, Religious behavior and experience, Education
Muhammad Ali Jinnah	1876 births, 1948 deaths, Deaths from tuberculosis, Governors General of Pakistan, Leaders of All India Muslim League, National symbols of Pakistan, Muslims, People from Karachi, Pakistani culture, Speakers of the National Assembly of Pakistan
Gregor Mendel	1822 births, 1884 deaths, Austrian biologists, Botanists, Geneticists, Austrian Roman Catholics, Religious people
Marschall der DDR	East Germany
Farscape	Science fiction television series, English-language television programs
Interplanetary internet	Internet
History of China	History of China
Briefs	Underwear
Kayastha	Indian people, Ethnic groups in Asia
Rainbow Brite and the Star Stealer	1985 movies, Animated movies, English-language movies, Warner Bros. movies
Arctic Monkeys	2002 establishments in England, 2000s British music groups, 2010s British music groups, Brit Award winners, English rock bands, Indie bands, Musical groups established in 2002, Musical groups from Sheffield
Swarm	Insects
Queen's University	Colleges and universities in Canada
String quartet	Musical forms, String quartets
Opus number	Musical terminology
Amino acid	Amino acids
Miscarriage	Abortion
Yuan dynasty	Chinese dynasties, 1271 establishments, 1368 disestablishments, 13th-century establishments in Asia, 14th century disestablishments in Asia
History of India	History of India
1250s	1250s
The Life and Times of Michael K	Novels, 1983 books, Booker Prize winners, English-language novels
Tort	Legal terms
Lawsuit	Law
Chamber music	Music genres
Stefano Mei	1963 births, Living people, 1984 Summer Olympics, 1988 Summer Olympics, Italian athletes, Italian Olympians, Liguria
Museum in Bielsko-Biała	Museums in Europe, Castles, Buildings and structures in Poland, Education in Poland, 14th century establishments in Europe
Circumcision	Health, Sexuality, Religious ethics, Islamic culture
Moirai	Greek gods and goddesses
Wikisource	Wikis, 2003 establishments
Whaling	Fishing
Opinion	Basic English 850 words, Human communication
School year	Education, Academia
Audience	Performing arts, Entertainment
Group	Basic English 850 words
Side-scrolling video game	Types of video games, Video game gameplay
Eating	Food and drink
Bathroom	Rooms
Shower	Hygiene
Gangtok	Capital cities in India, Settlements in Sikkim
Transposing instrument	Musical instruments
Transposition (music)	Music, Music theory
Erinyes	Greek gods and goddesses
Indian subcontinent	Geography of Asia, South Asia, Gondwana
Horae	Greek gods and goddesses
Alkmene	People in Greek mythology
Danaë	People in Greek mythology
Akrisios	People in Greek mythology
Andromeda (mythology)	People in Greek mythology
Centaur	Greek legendary creatures
Bruntál	Cities in the Czech Republic
Concerto	Musical forms, Concertos
Concerto grosso	Musical forms
Hyundai Grandeur	Hyundai automobiles, Front wheel drive vehicles, Sedans, 1980s automobiles, 1990s automobiles, 2000s automobiles, 2010s automobiles
Ape	Apes
Hattingen	Ennepe-Ruhr Rural District
Morning wood	Male reproductive system
Accompaniment	Musical terminology
Tagalog language	Austronesian languages, Filipino culture
Basso continuo	Music
Diwali	Hinduism, Religious holidays
Arthashastra	History of India
Hanuman	Hindu mythology
Indra	Hinduism, Hindu mythology
Badrinath	Hindu temples, Buildings and structures in India, 9th century establishments in Asia, Establishments in India
Kanchipuram	Cities in India, Kanchipuram district, Settlements in Tamil Nadu
History of Japan	History of Japan
History of Saudi Arabia	History of Saudi Arabia, History of the Middle East
Linga	Hinduism
United States National Guard	United States Army
Bishop's Stortford	Towns in Hertfordshire
Raven	Corvids
Malnutrition	Nutrition
Carolina parakeet	Arinae, Extinct species
Match Game	Television game shows, NBC network shows, CBS network shows, First run syndicated television programs
Melanesia	Melanesia, Australasia
Diaphragm	Anatomy of the respiratory system, Muscles
Germ theory of disease	Microbiology, Medicine
Labor Day	September events
Christian cross	Christian symbols
Martin Luther King, Jr. Day	January events
Washington's Birthday	Presidential birthdays in the United States, February events
Ralph Vaughan Williams	1872 births, 1958 deaths, 20th century composers, English composers, Musicians from Gloucestershire, Order of Merit, People buried in Westminster Abbey
Recycling	Recycling
Transnistria	Moldova, Unrecognized countries
Mercalli intensity scale	Geology
Dili	Capital cities in Asia, Cities in East Timor
Holly	Christmas, Asterids
Dysentery	Diseases caused by bacteria, Diseases and disorders of the digestive system
NHK	Japanese television networks, 1926 establishments in Asia, 1920s establishments in Japan
Fargo, North Dakota	County seats in North Dakota, Fargo, North Dakota, 1871 establishments in the United States, 1870s establishments in Dakota Territory
Blur (band)	1988 establishments in England, 1980s British music groups, 1990s British music groups, 2000s British music groups, 2010s British music groups, Alternative rock bands, English rock bands, Musical groups established in 1988, Musical groups from Essex, Warner Bros. Records artists
Daft Punk	1993 establishments in France, 1990s music groups, 2000s music groups, 2010s music groups, French musical groups, Entertainers from Paris
Paralympic Games	Paralympic Games, 1948 establishments, Multi-sport events
National Basketball Association	National Basketball Association, Basketball leagues
FIFA Women's World Cup	FIFA Women's World Cup, 1991 establishments
Nathula	Himalayas, Mountain passes, Mountain passes of India, Mountains of China, Territorial disputes of India, Sikkim, Tibet
Klondike Gold Rush	1890s in Canada, Gold rushes
Clone High	American animated television series, Canadian animated television series, English-language television programs, 2002 television series debuts, 2003 television series endings
Chinese Civil War	Wars involving China, Wars of independence, Rebellions in Asia, 20th century rebellions, Civil wars, 20th century in China
Nagorno-Karabakh	Nagorno-Karabakh
Newcastle upon Tyne	Newcastle upon Tyne
James Read	1953 births, Living people, American movie actors, American television actors, Actors from Buffalo, New York
Satyr play	Theatrical forms, Ancient Greece
Premier League	Premier League, 1992 establishments in the United Kingdom
Giro d'Italia	Giro d'Italia, UCI ProTour, 1909 establishments in Italy
Rosalynn Carter	1927 births, Living people, American Baptists, First Ladies of the United States, Jimmy Carter, People from Plains, Georgia
Hitopadesha	Fiction books, Sanskrit
Tiberius	42 BC births, 37 deaths, New Testament people, Roman Emperors
14	14
Ray Bradbury	1920 births, 2012 deaths, Actors from Illinois, American novelists, Screenwriters from Illinois, American television actors, American television writers, Writers from Illinois, Writers from Los Angeles, California, People from Waukegan, Illinois
Porpoise	Toothed whales
Cetology	Branches of zoology, Cetaceans
Primatology	Branches of zoology, Primates, Anthropology, Physical anthropology
Orangutan	Hominids
Greeting	Human communication
Sunlight	Light, Solar System, Natural resources, Solar energy, Electromagnetic radiation
Theism	Theology
Plesiosaur	Plesiosaurs
Midland, Texas	Cities in Texas, County seats in Texas
Sardinia	Autonomous areas, Islands of Italy, Sardinia
Nuclear reactor	Nuclear energy
Samobor	Samobor, Cities in Croatia
Frankfurt (Oder)	Urban districts of Brandenburg
Cook Islands	Cook Islands, Commonwealth dependent states
Punishment	Basic English 850 words, Punishments, Criminal justice
Blue whale	Baleen whales
Cetacea	Cetaceans
Scottish Gaelic language	Celtic languages, Languages of Europe
West Germanic languages	West Germanic languages, Languages of Europe
Germanic languages	Germanic languages, Languages of Europe
Killer whale	Oceanic dolphins
Pac-Man	1980 video games, Arcade games, Video game series, Namco video games, Game Gear games, Game Boy games, Game Boy Color games, Game Boy Advance games, PlayStation games, Xbox 360 games, Xbox One games, Wii U games, Nintendo Switch games, Commodore 64 games, Apple II games
Pot Noodle	Fast food
Superman (1978 movie)	1978 movies, American action movies, Superman movies, Movies composed by John Williams, Movies based on comic book characters, Movies set on fictional planets, English-language movies, American superhero movies, Warner Bros. movies
Domestic violence	Domestic violence, Women's rights
Emersons Green	Villages in Gloucestershire
Archaeopteryx	Birds, Coelurosaurs, Dinosaurs of Europe, Jurassic dinosaurs, Feathered dinosaurs
Mosel-Saar-Ruwer	German food, Geography of Rhineland-Palatinate, Geography of Saarland, Wine regions
Snail	Gastropods
Ruwer River	Geography of Rhineland-Palatinate, Rivers of Germany
Slug	Gastropods
Ruwer (municipality)	Geography of Rhineland-Palatinate
Gunpowder	Firearms
Mayor	Mayors, Government occupations
Churning of the Ocean	Hindu mythology
Martha Washington	1731 births, 1802 deaths, First Ladies of the United States, People from Virginia
Abigail Adams	1744 births, 1818 deaths, First Ladies of the United States, Second Ladies of the United States, John Adams
Martha Jefferson Randolph	People from Virginia, 1772 births, 1836 deaths, First Ladies of the United States, Children of Presidents of the United States, Thomas Jefferson
Aracaju	Cities in Sergipe, Capitals of Brazilian states, 1855 establishments, 19th-century establishments in Brazil, 1850s establishments in South America
A Midsummer Night's Dream	Plays by William Shakespeare
Vodka	Alcoholic spirits
Sexual reproduction	Methods of reproduction
Leprosy	Diseases caused by bacteria
Dolley Madison	1768 births, 1849 deaths, First Ladies of the United States, James Madison, American Christians, People from Greensboro, North Carolina, People from Virginia, Quakers
Elizabeth Monroe	1768 births, 1830 deaths, First Ladies of the United States, James Monroe
Celestia	Software, Astronomy
Bill Cullen	American radio personalities, American television presenters, Deaths from lung cancer, American game show hosts, Actors from Pittsburgh, Pennsylvania, 1920 births, 1990 deaths
Rudi Carrell	1934 births, 2006 deaths, Cancer deaths in Germany, Comedians, Deaths from lung cancer, Dutch singers, Dutch television presenters, People from Alkmaar
Lung cancer	Cancer
Whitchurch, Shropshire	Towns in Shropshire, Civil parishes in Shropshire
Panthera	Panthera
Superpower	Countries, Politics
Snow leopard	Felines, Mammals of Asia, National symbols of Pakistan
Yonkers, New York	Yonkers, New York, 1640s establishments in the Thirteen Colonies, 17th-century establishments in New York
Louisa Adams	1775 births, 1852 deaths, First Ladies of the United States, John Quincy Adams
Angelica Van Buren	First Ladies of the United States, 1818 births, 1877 deaths, Martin Van Buren
Jane Irwin Harrison	1804 births, 1846 deaths, First Ladies of the United States, People from Pennsylvania
Mary Todd Lincoln	First Ladies of the United States, Abraham Lincoln, 1818 births, 1882 deaths, People from Lexington, Kentucky
Jacqueline Kennedy Onassis	Burials at Arlington National Cemetery, Cancer deaths in New York City, Deaths from non-Hodgkin lymphoma, First Ladies of the United States, John F. Kennedy, Kennedy family, Writers from New York City, 1929 births, 1994 deaths, Writers from Rhode Island, People from Newport, Rhode Island, American socialites, American editors, American photographers, American photojournalists, American autobiographers, Writers from Virginia, Journalists from New York City, Democrats (United States), American Roman Catholics
Bornean orangutan	Hominids
Missile	Military, Ballistics, Rockets
Salford	Cities in North West England, Settlements in Greater Manchester
1290s	1290s
The Nightmare Before Christmas	1993 movies, 2000s 3D movies, American family movies, Disney animated movies, American musical movies, Christmas movies, Movies composed by Danny Elfman, The Nightmare Before Christmas, 3D re-releases
Crumple zone	Engineering
Harriet Lane	James Buchanan, First Ladies of the United States, 1830 births, 1903 deaths
Afelia	Greek food
President of Ireland	Politics of Ireland, Presidents of Ireland, Lists of heads of state, Government of the Republic of Ireland
Normandy	Normandy, 2016 establishments in France
Sarah Childress Polk	First Ladies of the United States, James K. Polk, 1803 births, 1891 deaths
Anna Harrison	1775 births, 1864 deaths, First Ladies of the United States, William Henry Harrison
Sarah Yorke Jackson	First Ladies of the United States, People from Philadelphia, Pennsylvania, 1805 births, 1877 deaths
Carnivora	Carnivora
Fowl	Birds, Basic English 850 words, Animals
Receipt	Basic English 850 words, Genres, Business
Error	Basic English 850 words
Union of European Football Associations	UEFA, 1954 establishments in Europe
Asian Football Confederation	Asian Football Confederation, 1954 establishments in Asia
Micronesia	Micronesia
2002 FIFA World Cup	FIFA World Cup, 2002 in association football, 2000s in Japan, 21st century in South Korea, Football in Japan, Football in South Korea
Confederación Sudamericana de Fútbol	CONMEBOL
Monotreme	Monotremes, Living fossils
FIFA Club World Cup	FIFA
Metatheria	Metatheria
Spermatic cord	Anatomy of the male reproductive system
Mixed martial arts	Mixed martial arts
Urarina	Peruvian people
Sergipe	Sergipe, States of Brazil
Soviet–Afghan War	1970s in Asia, 1980s in Asia, 20th century rebellions, History of Afghanistan, Rebellions in Asia, History of the Soviet Union, Wars
Emily Donelson	1807 births, 1836 deaths, First Ladies of the United States, Andrew Jackson
Letitia Christian Tyler	1790 births, 1842 deaths, First Ladies of the United States, Second Ladies of the United States, People from Hampton Roads, Virginia, John Tyler
Julia Gardiner Tyler	1820 births, 1889 deaths, First Ladies of the United States, John Tyler, Refugees
Newsround	Children's television series, English-language television programs
Lancelot	Arthurian legend, Fictional knights
Pitcairn Islands	Islands of Oceania, British overseas territories, Polynesia, Mutiny on the Bounty, Pitcairn Islands
Sun bear	Ursidaes
Priscilla Cooper Tyler	First Ladies of the United States, 1816 births, 1889 deaths, People from New York City
Eliza McCardle Johnson	1810 births, 1876 deaths, Andrew Johnson, Deaths from tuberculosis, First Ladies of the United States, Infectious disease deaths in Tennessee, Second Ladies of the United States
Rose Cleveland	First Ladies of the United States, Deaths from influenza, 1846 births, 1918 deaths
Project Gutenberg	Books, Non-profit organizations of the United States, 20th-century establishments in Mississippi, 1971 establishments in the United States
F. Scott Fitzgerald	Writers from Saint Paul, Minnesota, 1896 births, 1940 deaths
Cupertino, California	Cupertino, California, 1955 establishments in California
The A-Team	1983 television series debuts, 1987 television series endings, 1980s American television series, Action television series, Television series set in Los Angeles, California, 1983 establishments in the United States, 1987 disestablishments in the United States, English-language television programs
Philadelphia (movie)	1993 drama movies, 1990s LGBT movies, Academy Award winning movies, American drama movies, American LGBT movies, English-language movies, HIV/AIDS in movies, Legal movies, LGBT drama movies, Movies directed by Jonathan Demme, Movies set in Philadelphia, Pennsylvania, Movies that won the Best Original Song Academy Award
Forrest Gump	1994 romance movies, 1994 comedy-drama movies, 1990s coming-of-age movies, 1990s romantic comedy movies, 1990s romantic drama movies, American comedy-drama movies, American coming-of-age movies, American epic movies, American romantic comedy movies, American romantic drama movies, Best Picture Oscar, English-language movies, Golden Globe Award winning movies, Movies based on books, Movies set in Alabama, Movies set in the 1950s, Movies set in the 1960s, Movies set in the 1970s, Movies set in the 1980s, United States National Film Registry movies, Movies directed by Robert Zemeckis, Movies that won the Best Visual Effects Academy Award, Movies set in California, 1994 movies
Ted Kennedy	Burials at Arlington National Cemetery, Cancer deaths in Massachusetts, Deaths from glioblastoma, Kennedy family, 1980 United States presidential candidates, People from Brookline, Massachusetts, Recipients of the Order of the Aztec Eagle, United States senators from Massachusetts, US Democratic Party politicians, 1932 births, 2009 deaths, 21st-century American politicians, 20th-century American politicians
Flag of Singapore	National flags, Singapore
Bess Truman	1885 births, 1982 deaths, First Ladies of the United States, People from Independence, Missouri, Second Ladies of the United States, Harry S. Truman
Margaret Taylor	1788 births, 1852 deaths, Zachary Taylor, First Ladies of the United States, People from Maryland
Persian Gulf	Middle East, Gulfs
Khalistan movement	Punjab, India, Sikhism
World Trade Organization	1995 establishments, Geneva, World Trade Organization
Międzyrzec Podlaski	Cities in Poland
Qing dynasty	Chinese dynasties
Hypnosis	Psychology, Consciousness
Krusty Krab	SpongeBob SquarePants, Fictional buildings and structures
M6 motorway	Motorways in England
Sloth bear	Ursidaes
Inclined plane	Machines
Jamestown, New York	Cities in New York
Lego	Lego
Giant panda	Ursidaes, Gansu, Shaanxi, Sichuan
Game Boy Color	Game Boy, Nintendo video game consoles
Hula	Dances, Culture of Hawaii
Herakles	People in Greek mythology
Steam engine	Motors, Engineering
Computer programming	Computer programming
BASIC	Programming languages
Mayon Volcano	Volcanoes of Asia, Geography of the Philippines
Visual Basic .NET	Microsoft software, IDEs, Programming languages
Temperature record of the past 1000 years	Climate change
Camping	Camping, Tourism
New Guinea	Islands of Oceania, Islands of Indonesia, Geography of Papua New Guinea, Melanesia, Australasia, Gondwana
Honda	Automobile companies of Japan
Camelid	Camelids
Wallis and Futuna	Wallis and Futuna
Western New Guinea	Indonesia
Maluku Islands	Melanesia, Islands of Indonesia
Domestication	Domesticated animals, Agriculture
Night of the Living Dead	1968 movies, 1960s horror movies, American horror movies, English-language movies, Zombie movies, United States National Film Registry movies, American independent movies
Russian Civil War	Wars involving Russia, Civil wars, Russian Revolution, 20th century in Russia
Foster's Home for Imaginary Friends	Animated television series, Cartoon Network series, English-language television programs, 2004 television series debuts, 2009 television series endings
Interpol	International organizations, Law enforcement agencies
El Niño–Southern Oscillation	Weather events, Climate change
Pressure cooker	Cooking appliances
1710	1710
Pescozada	Hip hop bands, Salvadoran people, 1998 establishments in North America, Establishments in El Salvador
Rhyme	Rhymes
Lock	Basic English 850 words, Locks
Knob	Hardware (mechanical)
The Sims 2	The Sims, 2004 video games
RollerCoaster Tycoon	1999 video games, 2002 video games, 2004 video games, Simulator video games
Fuhua Secondary School	Schools in Singapore
Eintracht Frankfurt	1899 establishments in Germany, Frankfurt, German Bundesliga, German football clubs, Sport in Hesse
Commonwealth of Nations	1949 establishments, Commonwealth of Nations
Nuclear meltdown	Nuclear accidents
Zoroaster	Zoroastrianism
Russian Empire	Former empires, Former monarchies of Asia, Former monarchies of Europe, History of Russia, 1721 establishments, 1917 disestablishments, 1720s establishments in Europe, 1720s establishments in Asia, 1910s disestablishments in Europe, 20th century disestablishments in Asia
International Red Cross and Red Crescent Movement	International organizations, Red Cross, Geneva
Cello	String instruments
European colonization of the Americas	History of Europe, History of North America, History of South America, History of Central America
Doha	Capital cities in Asia, Qatar
Bandar Seri Begawan	Brunei, Capital cities in Asia
Thimphu	Capital cities in Asia, Settlements in Bhutan
Colombo	Capital cities in Asia, Settlements in Sri Lanka, Western Province, Sri Lanka
Malé	Capital cities in Asia, Geography of the Maldives
Islamabad	Islamabad, Capital cities in Asia, Capital of Pakistan
Wall of Voodoo	American rock bands, American punk bands, New wave bands, Musical groups from Los Angeles, California
Khyber Pass	Mountain passes of Pakistan
Ground zero	Physics
Anne Rice	1941 births, Living people, American novelists, Writers from New Orleans, Louisiana
Homemaker	Domestic work, Social sciences, Family
Necktie	Accessories
Joke	Humor
Brother-in-law	Family
Sister-in-law	family
Tuxedo	Clothing
Experience points	Games
Hide (musician)	1964 births, 1998 deaths, Singer-songwriters, Musicians who committed suicide, Suicides by hanging, Singers from Kanagawa Prefecture, Japanese guitarists
Measurement	Measurement
Alligator clip	Electrical connectors, tools
Gordon Brown	1951 births, Living people, British Protestants, Calvinists, Chancellors of the Exchequer, Former Labour MPs (UK), Former members of the British House of Commons for Scottish constituencies, Leaders of the Labour Party (UK), Politicians from Glasgow, Privy Councillors (UK), Scottish Christians, UK MPs 1983–1987, UK MPs 1987–1992, UK MPs 1992–1997, UK MPs 1997–2001, UK MPs 2001–2005, UK MPs 2005–2010, UK MPs 2010–2015
Chancellor of the Exchequer	Chancellors of the Exchequer, Politics of the United Kingdom, United Kingdom-related lists
Dallas Cowboys	Dallas Cowboys, 1960 establishments in the United States, 1960s establishments in Texas
Duncanville, Texas	Cities in Texas, Settlements in Dallas County, Texas
Koror	Capital cities in Oceania, Palau
Palikir	Capital cities in Oceania, Federated States of Micronesia
Atari XL	Computers, Atari hardware
Port Moresby	Capital cities in Oceania, Geography of Papua New Guinea
Nur-Sultan	Capital cities in Asia, Cities in Kazakhstan, Nur-Sultan
National emblem	National symbols
Cessna 172	Civil aircraft, Cessna aircraft
United States Marine Corps	United States Marine Corps, 1775 establishments in the Thirteen Colonies
San Antonio	San Antonio, Texas, 1718 establishments, 18th-century establishments in Mexico, County seats in Texas
The Alamo	Buildings and structures in Texas, San Antonio, Texas, 1724 establishments, 18th-century establishments in Mexico
Odessa	Cities in Ukraine
Queen Elizabeth The Queen Mother	Bailiffs Grand Cross of the Order of St John, Breast cancer survivors, British centenarians, Kings and Queens consort of the United Kingdom, Royalty from London, 1900 births, 2002 deaths, Elizabeth II
United States Department of Defense	United States Department of Defense, 1947 establishments in the United States
United States Department of the Navy	United States Navy, Former United States Executive Departments, 1798 establishments in the United States
Weather station	Meteorology
Atmospheric pressure	Meteorology, Atmosphere
1482	1482
Franz Berwald	Composers, Writers from Stockholm, Romantic composers, 1786 births, 1868 deaths
Chemnitz	Chemnitz
Karl-Marx-Stadt	Chemnitz
List of Brazilian football teams	Brazilian football clubs, Lists of football teams
Small intestine	Anatomy of the digestive system
Songwriter	Music industry, Songwriters, Entertainment occupations
Hezbollah	1985 establishments in Asia, Nationalist organizations in Asia, Political parties in Asia, Islamic terrorism, Shia organizations, Arab–Israeli conflict, 20th century establishments in Lebanon
Sociedade Esportiva Palmeiras	Football clubs in São Paulo (state), 1914 establishments in Brazil
Agastya	Hindu mythology, Tamil culture
International Criminal Court	International organizations, The Hague
Brahma	Hindu gods and goddesses
Asexual reproduction	Methods of reproduction
Brahman	Hinduism
International Monetary Fund	International organizations, Economics
São Paulo F.C.	Football clubs in São Paulo (state), 1930 establishments in South America, 1930s establishments in Brazil
World Bank Group	International organizations, Non-profit organizations
International Court of Justice	United Nations, The Hague, 1945 establishments
Indian independence movement	Indian independence movement
Declaration of the Establishment of the State of Israel	1940s in Israel, Declarations of independence, 1948 in Asia
Parvati	Hindu gods and goddesses
Estádio Palestra Itália	Football stadiums in Brazil, São Paulo
1963 Pan American Games	Pan American Games
Pan American Games	Pan American Games, Multi-sport events
Campinas	Cities in São Paulo (state)
Multilingualism	Linguistics
Fall/Liberation of Saigon	Vietnam War
Between Friends	Comic strips
Patrice Lumumba	1925 births, 1961 deaths, Assassinated people, History of the Democratic Republic of the Congo, Prime Ministers of the Democratic Republic of the Congo
Ho Chi Minh	1890 births, 1969 deaths, Deaths from heart failure, Presidents of Vietnam, History of Vietnam, General Secretaries of the Central Committee of the Communist Party of Vietnam
Vietnamese Declaration of Independence	1945 in Vietnam, Speeches
Khmer Rouge	1970s in Cambodia, Communist parties, Rebel militia groups in Asia, Crimes against humanity, Genocide, 1999 disestablishments, 1990s disestablishments in Asia
Juche	Politics, North Korea, Nationalism
Kigali	Capital cities in Africa, Rwanda
Louis XVI	Dauphins and Dauphines of France, Executed French people, Kings and Queens of France, People executed by decapitation, Princes of Andorra, 1754 births, 1793 deaths, People of the French Revolution
Paul Kagame	1957 births, Living people, African Union chairpersons, Rwandan people, Dictators, Presidents (government)
Juche Tower	Pyongyang, Monuments and memorials, Towers in Asia, Buildings and structures in Korea, 1982 establishments in Asia, Establishments in North Korea
Space exploration	Space
Vietnamese language	Vietnam, Austro-Asiatic languages, Tonal languages
Valmiki	Hindu saints, Hindu mythology, Poets, History of Pakistan
Kali	Hindu gods and goddesses
Petr Čech	Association football goalkeepers, 1982 births, Living people, Czech footballers, Chelsea F.C. players, Arsenal F.C. players, UEFA Euro 2004 players, UEFA Euro 2008 players, UEFA Euro 2012 players, UEFA Euro 2016 players, 2006 FIFA World Cup players
Mustafa Kemal Atatürk	1881 births, 1938 deaths, Deaths from cirrhosis, Disease-related deaths in Turkey, Presidents of Turkey, Thessaloniki, Speakers of the Parliament of Turkey
Morumbi Stadium	Football stadiums in Brazil, São Paulo (state)
Bail	Criminal justice, Money, Imprisonment and detention
Initialism	Vocabulary
Soufflé	Egg dishes, Desserts
Blossom	Flowers
Marmalade	Spreads
1697	1697
Thomas Hardy	English novelists, English poets, People buried in Westminster Abbey, Writers from Dorset, 1840 births, 1928 deaths
Manhole	Construction, Street furniture
Sewer	waste
Pajamas	Clothing
Barter	Commerce, Money
Carlisle United F.C.	English football clubs, 1904 establishments in England
Baroque pop	Music genres
290s	290s
Leica Camera	Cameras, Companies of Germany, Hesse
2011	2011
Tiến Quân Ca	Vietnamese music, National anthems
North American blizzard of 2003	2003 in weather, 2003 in the United States, 2003 in Canada, Historic blizzards in the United States, Natural disasters in Canada
Organization of American States	International organizations, Political organizations based in the United States, 1948 establishments, Politics of North America, Politics of South America
Gustav Holst	20th century composers, Cardiovascular disease deaths in England, Deaths from heart failure, English composers, Musicians from Gloucestershire, 1874 births, 1934 deaths
Nelson's Column	Monuments and memorials in England, Buildings and structures in London, 1840s establishments in England
Cousin	Family
900	900
996	996
1288	1288
1345	1345
1347	1347
1565	1565
Livestock	Domesticated animals, Agriculture
Breed	Animal husbandry, Genetics
Storm	Severe weather
Hemisphere	Hemispheres
Pressure	Measurement
Alligator	Crocodilia, Reptiles of North America, Reptiles
Curitiba	Capitals of Brazilian states, Curitiba, 1693 establishments, 17th-century establishments in Brazil
Crocodilia	Crocodilia
Biometrics	Anatomy, Authentication methods
Bandwidth (signal processing)	Internet, Mechanical vibrations, Radio technology, Electronics
Hertz	Units of measurement
Batman Returns	Movies based on comic book characters, 1992 movies, 1990s superhero movies, Batman (1989 movie series), Batman movies, Movies composed by Danny Elfman, English-language movies, Warner Bros. movies, American superhero movies
Ulster Scots dialects	Dialects of English, Ireland, Northern Ireland, Germanic languages
Sara Cox	1974 births, Living people, BBC radio presenters, English radio personalities, English television presenters, People from Bolton
Winx Club	Animated television series, Italian animated television series, 2004 television series debuts, Nicktoons, Nickelodeon television series
Jack o'lantern mushroom	fungi
Norfolk County, Ontario	Cities in Ontario
Simcoe, Ontario	Towns in Ontario
Simcoe Composite School	Schools in Canada, Buildings and structures in Ontario, 1898 establishments, 1890s establishments in Canada
Liberal Party (Australia)	Liberal parties, Liberal Party of Australia, 1945 establishments, 1940s establishments in Australia
Paul Keating	Politicians from Sydney, Prime Ministers of Australia, 1944 births, Living people, Republicans, Australian Labor Party politicians, Treasurers of Australia, Deputy Prime Ministers of Australia
Commonwealth of Independent States	1991 establishments, International organizations, Political organizations based in Europe, Soviet Union, Politics of Asia, Politics of Europe, Political organizations based in Asia
Association of Southeast Asian Nations	1967 establishments in Asia, ASEAN
Electric motor	Motors, Electricity
Explosive material	Explosives
UNICEF	United Nations, Charities
German reunification	1990 in Europe, 1990s in Germany, Democracy movements, Nationalism
Partitions of Poland	History of Poland
Polish–Lithuanian Commonwealth	1795 disestablishments, Former republics, Former state unions, History of Belarus, History of Lithuania, History of Poland, History of Ukraine, 1569 establishments, 1790s disestablishments in Europe
Unification of Germany	19th century in Germany, Nationalism
OPEC	International organizations
OECD	Think tanks, International organizations, Economics organizations, 1948 establishments
1973 oil crisis	1973, Arab–Israeli conflict, Economic history
Organization for Security and Co-operation in Europe	International organizations, Political organizations based in Europe, 1973 establishments in Europe, Politics of Europe
Franco-Prussian War	19th century in France, 1870s in Germany, Prussia, Wars involving France, Wars involving Germany, 1870, 1871
Kaohsiung City	Cities in Taiwan, Ports and harbours of Taiwan
Fernando Alonso	1981 births, Living people, Formula One drivers, Formula One current, People from Oviedo
Peter Crouch	1981 births, Living people, English footballers, Liverpool F.C. players, Sportspeople from Cheshire, Sportspeople from London, Tottenham Hotspur F.C. players, Premier League players
Delhi, Ontario	Towns in Ontario
Bishkek	Capital cities in Asia, Geography of Kyrgyzstan
Dushanbe	Capital cities in Asia, Tajikistan
Taiwan Strait	Geography of Taiwan, Straits
Tashkent	Capital cities in Asia, Cities in Uzbekistan
Aşgabat	Capital cities in Asia, Geography of Turkmenistan
Crew	Aviation, Water transport
Cargo	Transport
Ransom	Piracy, Kidnapping
Paraphilia	Mental illnesses, Sociology, Paraphilias
Belo Horizonte	Belo Horizonte, Capitals of Brazilian states
Bohemia	Bohemia
Rhododendron	Rhododendron
Jasmine	Oleaceae, Plants of Asia, Plants of Australia
Yaren	Cities in Oceania, Nauru
Nupedia	2000 establishments in the United States, 2003 disestablishments, 2000s disestablishments in the United States, Encyclopedias, Websites
Article (grammar)	Parts of speech, Basic English 850 words
Waterfront	Geography
East Asia	East Asia
List of counties of the Republic of China	Counties of Taiwan, Lists of counties, Asia-related lists
Tbilisi	Tbilisi, 5th century establishments in Europe
Robot	Robots, Technology
Habemus Papam	Popes
Xabi Alonso	1981 births, Living people, Spanish footballers, Spanish football managers
Porto Alegre	Capitals of Brazilian states, Porto Alegre
Salvador, Bahia	Capital of Brazil, Former national capitals, World Heritage Sites in South America, Capitals of Brazilian states, Salvador, Bahia, 1540s establishments in South America, 16th-century establishments in Brazil, 1549 establishments
Goiânia	Capitals of Brazilian states, Goiânia
1610	1610
1677	1677
1508	1508
Campo Grande	Cities in Mato Grosso do Sul, Capitals of Brazilian states
Cuiabá	Cities in Brazil, Mato Grosso, Capitals of Brazilian states
Vitória, Espírito Santo	Cities in Brazil, Espírito Santo, Capitals of Brazilian states
Fortaleza	Capitals of Brazilian states, Fortaleza
São Luís, Maranhão	Cities in Brazil, Maranhão, Capitals of Brazilian states
João Pessoa	Cities in Paraíba, Capitals of Brazilian states, 1585 establishments, 16th-century establishments in Brazil
Teresina	Cities in Brazil, Piauí, Capitals of Brazilian states
Natal, Rio Grande do Norte	Cities in Brazil, Municipalities in Rio Grande do Norte, Capitals of Brazilian states
Rio Branco	Cities in Brazil, Municipalities in Acre (state), Capitals of Brazilian states
Council of Europe	Council of Europe, 1949 establishments in Europe, Strasbourg
Palmas, Tocantins	Cities in Brazil, Tocantins (state), Capitals of Brazilian states
Macapá	Cities in Brazil, Amapá, Capitals of Brazilian states
Belém	Capitals of Brazilian states, Belém
Florianópolis	Cities in Santa Catarina, Capitals of Brazilian states
Porto Velho	Cities in Brazil, Rondônia, Capitals of Brazilian states
Boa Vista	Cities in Brazil, Municipalities in Roraima, Capitals of Brazilian states
Recife	Capitals of Brazilian states, Recife
Recognition	Psychology, Software, Politics
Cystic fibrosis	Genetic disorders, Respiratory system
IEEE 1394	Computer buses, Electrical connectors
De facto	Latin phrases, Legal terms
Househusband	Social sciences
Port Dover, Ontario	Cities in Ontario
Julius Nyerere	1922 births, 1999 deaths, African politicians, Deaths from leukemia, Presidents of Tanzania, Prime Ministers of Tanzania, Socialists
Interahamwe	1994 in Africa, Rebel militia groups in Africa, Rwandan genocide
Democratic Kampuchea	1970s in Cambodia, Former countries in Southeast Asia, Genocide, 1976 establishments in Asia, Establishments in Cambodia, 1979 disestablishments, 1970s disestablishments in Asia
Lindsborg, Kansas	Cities in Kansas
Pie	Pies, Baked foods
Customer service	Commerce
Busan	Busan, Cities in South Korea
Sarcasm	Human communication, Figures of speech
Lie	VOA Special English words, Terminology
Germ-X	Hygiene
Scratch and sniff	Consciousness
Rose	Roses
Apple pie	Apple products, Pies
Pumpkin pie	Pies, Desserts
Pumpkin	Fruits, Cucurbitaceae, Vegetables
Ribeirão Preto	Cities in São Paulo (state)
Guarulhos	Cities in São Paulo (state)
Santos, São Paulo	Cities in São Paulo (state)
São José dos Campos	Cities in São Paulo (state)
São Bernardo do Campo	Cities in São Paulo (state), 1550s establishments in South America, 16th-century establishments in Brazil, 1553 establishments
Santo André	Cities in São Paulo (state)
Osasco	Cities in São Paulo (state)
Sorocaba	Cities in São Paulo (state)
Google Earth	Google, Technology, Internet
Google Maps	Google
Google Videos	Google
Zane Lowe	1973 births, Living people, Entertainers from North Island, People from Auckland, New Zealand radio personalities, Television presenters
Islamic Revolution	History of Islam, 1970s in Iran, Revolutions, Rebellions in Asia, 20th century rebellions, 1979
Tentacle	Animal anatomy
Javelin	Sports equipment
Sea anemone	Cnidarians
Polyp	Cnidarians
Dravidian languages	Dravidian languages
East-West Schism	Christianity of the Middle Ages
William III of England	1650 births, 1702 deaths, Dutch royalty, House of Orange-Nassau, Kings and Queens of Scotland
Abigail Fillmore	1798 births, 1853 deaths, First Ladies of the United States, Second Ladies of the United States, Millard Fillmore
Myocardial infarction	Heart disease, Medical emergencies
Keith Richards	1943 births, Living people, English rock composers, English rock guitarists, English rock singers, Musicians from Kent, People from Dartford, The Rolling Stones members
Edward Elgar	1857 births, 1934 deaths, 20th century composers, Baronets, Cancer deaths in England, Deaths from colorectal cancer, English composers, Knights Grand Cross of the Royal Victorian Order, Order of Merit, Musicians from Worcestershire, Romantic composers
Printing press	Machines, Communication, Printing
Mezzo-soprano	Vocal ranges
Georges Bizet	1838 births, 1875 deaths, Disease-related deaths in France, French composers, Musicians from Paris, People with foods named after them, Romantic composers
Old age	Gerontology
The Crystal Maze	1990 British television series debuts, 1990s British television series, 2010s British television series, British television game shows, Channel 4 television programmes, English-language television programs
Counter-Reformation	Counter-Reformation
Decolonization	Politics
History of the Soviet Union (1985-1991)	1980s in the Soviet Union, 1990s in the Soviet Union
Meiji Restoration	History of Japan, 1866, 1867, 1868, 1869, 1860s in Asia
European Convention on Human Rights	Human rights, Council of Europe, Treaties and Conventions
European Court of Human Rights	Human rights, Council of Europe, Courts (law)
Ted Turner	1938 births, Living people, American billionaires, American philanthropists, Businesspeople from Atlanta, Georgia, Chief executives, Businesspeople from Cincinnati, Ohio, People from Savannah, Georgia, People with bipolar disorder, Time People of the Year
Taco Bell	1962 establishments in the United States, American fast food restaurants, Companies based in California, Irvine, California, 1960s establishments in California
Żagań	towns in Poland
Palatine Hill	Rome, Hills
Chupacabra	Cryptozoology
Hydra (animal)	Cnidarians
Clownfish	Perciformes
Bruce Lee	1940 births, 1978 deaths, Deaths from cerebral edema, Actors from San Francisco, American movie actors, American television actors, American movie producers, Bruce Lee
George Martin	1926 births, 2016 deaths, BBC people, Brit Award winners, British conductors, British military personnel of World War II, British record producers, English rock composers, Musicians from London, The Beatles
Brian Epstein	1935 births, 1967 deaths, British autobiographers, British Jews, Drug-related accidental deaths in the United Kingdom, English businesspeople, English LGBT people, Gay Jews, Jewish businesspeople, LGBT businesspeople, People from Liverpool, The Beatles
Jurong	Places in Singapore
Plastic Ono Band	English rock bands
Olsztyn	Cities in Poland
Lee Iacocca	1924 births, 2019 deaths, Deaths from Parkinson's disease, Disease-related deaths in Los Angeles, American inventors, American autobiographers, Businesspeople from Pennsylvania, Writers from Pennsylvania
Standard	Measurement
Ginkgo	Trees, Gymnosperms, Living fossils, Fossil plants
Mean	Statistics
Detergent	Home
1329	1329
Klaus Voormann	1942 births, Living people, German artists, German rock musicians, Musicians from Berlin
Alan White (Yes drummer)	1949 births, Living people, English drummers, English pop musicians
Stock market	Stock market
Allen Ginsberg	1926 births, 1997 deaths, American activists, American Buddhists, LGBT people from New Jersey, American poets, Beat Generation, Cancer deaths in the United States, Deaths from liver cancer, Gay men, Industrial Workers of the World, Jewish American writers, LGBT writers, Writers from Newark, New Jersey
Northwestern University	American Lacrosse Conference, Association of American Universities, Big Ten Conference, Colleges and universities in Chicago, 1851 establishments in the United States, 1850s establishments in Illinois
Door god	Art, Luck, Chinese gods and goddesses, Taoism
Jack Kerouac	1922 births, 1969 deaths, Deaths from hemorrhage, Deaths from cirrhosis, American poets, Beat Generation, Columbia University alumni, Disease-related deaths in the United States, People with personality disorders, Writers from Massachusetts, People from Lowell, Massachusetts
Himno Istmeño	National anthems, Panama
Jack Neo	1956 births, Living people, Movie directors, Singaporean people
Fyodor Dostoyevsky	1821 births, 1881 deaths, Christian writers, Deaths from emphysema, Disease-related deaths in Russia, Russian novelists, Russian Orthodox Christians, Writers from Moscow
Julia Grant	1826 births, 1902 deaths, First Ladies of the United States, Ulysses S. Grant
Jane Pierce	1806 births, 1863 deaths, First Ladies of the United States, Franklin Pierce, People from Concord, New Hampshire
Lucy Webb Hayes	1831 births, 1889 deaths, Deaths from stroke, First Ladies of the United States, Rutherford B. Hayes
Caroline Harrison	First Ladies of the United States, Benjamin Harrison, 1832 births, 1892 deaths
Helen Herron Taft	William Howard Taft, First Ladies of the United States, People from Cincinnati, Ohio, 1861 births, 1943 deaths
Mary McElroy	Chester A. Arthur, First Ladies of the United States, 1841 births, 1917 deaths
Frances Folsom Cleveland	First Ladies of the United States, People from Buffalo, New York, Grover Cleveland, 1864 births, 1947 deaths
Betty Ford	American autobiographers, First Ladies of the United States, Gerald Ford, People from Chicago, Second Ladies of the United States, Time People of the Year, 1918 births, 2011 deaths
Edith Roosevelt	1861 births, 1948 deaths, First Ladies of the United States, Second Ladies of the United States, People from Norwich, Connecticut, Theodore Roosevelt
Lucretia Garfield	First Ladies of the United States, 1832 births, 1918 deaths, James A. Garfield
Biotechnology	Interdisciplinary fields
Ida Saxton McKinley	1847 births, 1907 deaths, William McKinley, First Ladies of the United States, People from Canton, Ohio
Edith Bolling Wilson	1872 births, 1961 deaths, Woodrow Wilson, First Ladies of the United States, People from Virginia
Florence Harding	Warren G. Harding, First Ladies of the United States, 1860 births, 1924 deaths
Lou Henry Hoover	1874 births, 1944 deaths, Herbert Hoover, First Ladies of the United States, People from Waterloo, Iowa
Eleanor Roosevelt	1884 births, 1962 deaths, American activists, American autobiographers, Deaths from tuberculosis, First Ladies of the United States, Franklin D. Roosevelt, Infectious disease deaths in New York, People from New York City
Mamie Eisenhower	1896 births, 1979 deaths, Dwight D. Eisenhower, First Ladies of the United States, People from Pueblo, Colorado, People from Iowa
Lady Bird Johnson	1912 births, 2007 deaths, Deaths from natural causes, First Ladies of the United States, Second Ladies of the United States, Lyndon B. Johnson
Pat Nixon	1912 births, 1993 deaths, Cancer deaths in New Jersey, Deaths from emphysema, Deaths from lung cancer, Extras, First Ladies of the United States, Writers from Nevada, Writers from New Jersey, Writers from California, People from Park Ridge, New Jersey, Richard Nixon, Second Ladies of the United States
Nancy Reagan	1921 births, 2016 deaths, Actors from Chicago, Actors from New York City, American activists, American movie actors, American philanthropists, Breast cancer survivors, Congressional Gold Medal recipients, Deaths from congestive heart failure, First Ladies of the United States, Nancy Reagan, Reagan family
Furniture	Furniture
Rhythm	Basic English 850 words, Music theory
Necessary	Basic English 850 words
Inheritance	Death customs, Property
Consonant	Letters (alphabet)
Vowel	Letters (alphabet), Linguistics
F.C. United of Manchester	English football clubs, 2005 establishments in England
Metronome	Music
Lübeck	Former states in Germany, Port cities and towns of the Baltic Sea, Ports and harbours of Germany, Imperial free cities
Weimar	Cities in Thuringia, Urban Districts of Thuringia, Weimar, Weimar Republic
Augsburg	Augsburg
Münster	Münster
Nuremberg	Nuremberg, Imperial free cities
Military–industrial complex	Military-industrial complex
Organization	Basic English 850 words, Organizations
Heidelberg	Heidelberg
Göttingen	Hanseatic League
Trevor Hemmings	English businesspeople, People from London, Living people, 1935 births
Karlsruhe	Karlsruhe
Wuppertal	Wuppertal
Bielefeld	Bielefeld
Maastricht	Maastricht, Cities in the Netherlands, Settlements in Limburg (Netherlands), Provincial capitals of the Netherlands
Utrecht (city)	Utrecht (city), Cities in the Netherlands, Settlements in Utrecht (province), Provincial capitals of the Netherlands
Groningen (city)	Groningen (city), Cities in the Netherlands, Settlements in Groningen (province), Provincial capitals of the Netherlands
Eindhoven	Eindhoven, Cities in the Netherlands, Settlements in North Brabant
Nijmegen	Nijmegen, Cities in the Netherlands, Settlements in Gelderland
Leiden	Leiden, Cities in the Netherlands, Settlements in South Holland
Apeldoorn	Apeldoorn, Cities in the Netherlands, Settlements in Gelderland
Tilburg	Tilburg, Cities in the Netherlands, Settlements in North Brabant
Zwolle, Netherlands	Cities in the Netherlands, Settlements in Overijssel, Municipalities of Overijssel, Provincial capitals of the Netherlands
Haiphong	Cities in Vietnam
Oldenburg (city)	Lower Saxony
Kos	Islands of Greece
Crete	Crete, Peripheries of Greece
Rhodes	Islands of Greece
Tenerife	Islands of the Canary Islands
Mallorca	Mallorca
Huế	Cities in Vietnam
Nha Trang	Cities in Vietnam
Da Nang	Cities in Vietnam
Rostock	Port cities and towns of the Baltic Sea, Ports and harbours of Germany, Rostock, Urban districts of Mecklenburg-Vorpommern, 1218 establishments, 13th-century establishments in Germany, 1210s establishments in Europe
Jena	Jena, Urban Districts of Thuringia
Paderborn	Paderborn Rural District
Darmstadt	Darmstadt
His Holiness	Religious leaders
Cottbus	Urban districts of Brandenburg
Mönchengladbach	Urban districts in Regierungsbezirk Düsseldorf, Mönchengladbach
Regensburg	Regensburg
Mannheim	Mannheim
Kaiserslautern	Cities in Rhineland-Palatinate, Kaiserslautern
Dordrecht	Dordrecht, Cities in the Netherlands, Settlements in South Holland, 11th century establishments in Europe
's-Hertogenbosch	's-Hertogenbosch, Cities in the Netherlands, Settlements in North Brabant, Provincial capitals of the Netherlands
Razorlight	English rock bands, English punk bands, indie rock bands
Gran Canaria	Biosphere reserves, Islands of the Canary Islands
Bremerhaven	Port cities and towns of the North Sea
Jamie Oliver	1975 births, Living people, British chefs, English television presenters, Television personalities from Essex
Neuss	Rhein-Kreis Neuss Rural District
Oberhausen	Urban districts in Regierungsbezirk Düsseldorf, Oberhausen
Giessen	Giessen (district)
Ludwigshafen	Ludwigshafen
Krefeld	Urban districts in Regierungsbezirk Düsseldorf
Zwickau	Zwickau Rural District
Anton Praetorius	1560 births, 1613 deaths, Calvinists, Christian ministers, Christian theologians, Christian writers, German Protestants, German theologians, Writers from North Rhine-Westphalia
Hagen	Urban districts in Regierungsbezirk Arnsberg
Hamm	Urban districts in Regierungsbezirk Arnsberg
Herne, North Rhine-Westphalia	Urban districts in Regierungsbezirk Arnsberg
Mülheim	Urban districts in Regierungsbezirk Düsseldorf
Solingen	Solingen
Europa (moon)	Jupiter's moons
Keane	1995 establishments in England, 1990s British music groups, 2000s British music groups, 2010s British music groups, English rock bands, Keane, Musical groups established in 1995, Musical quartets, New wave bands, People from East Sussex
Tim Rice-Oxley	1976 births, Living people, english pianists, English guitarists, English rock musicians, Keane, Musicians from Oxfordshire, People from Oxford
Tom Chaplin	1979 births, Living people, English singers, Keane, Musicians from Sussex, People from East Sussex
Somewhere Only We Know	2004 songs, Keane songs
Under the Iron Sea	2006 albums, Keane, Island Records albums, Rock albums
List of songs by Keane	Keane songs, Lists of songs
Everybody's Changing	2003 songs, Keane songs
Dominic Scott	1979 births, Living people, Irish guitarists, Keane, Rock guitarists
Langeoog	Islands of Germany, Towns in Lower Saxony
Shirt	Tops (clothing)
T-shirt	Tops (clothing)
Sleeve	Clothing
Taxi	Automobiles, Public transport
Eastbourne	Eastbourne, 19th century establishments in England
Sunburn	Dermatology
Antwerp	Antwerp, Olympic cities
Trieste	Regional capitals in Italy, Trieste
Offenbach am Main	Cities in Hesse
Recklinghausen	Recklinghausen Rural District
Wolfsburg	Wolfsburg
Bergisch Gladbach	Rheinisch-Bergische Rural District
Gera	Urban Districts of Thuringia
Remscheid	Urban districts in Regierungsbezirk Düsseldorf
Undernet	Internet Relay Chat
Advanced Micro Devices	American technology companies
Illinois Institute of Technology	Colleges and universities in Chicago, 1940 establishments in Illinois
Hermann Minkowski	1864 births, 1909 deaths, German mathematicians, Jewish German academics, Jewish German scientists, Lithuanian Jews, People from Kaunas, Russian Jews
Certificate of deposit	Money
Cousins Subs	American fast food restaurants, 1970s establishments in the United States, 20th-century establishments in Wisconsin
Robert Walpole	1676 births, 1745 deaths, People from Norfolk, Whig party (UK) politicians, Prime Ministers of Great Britain
Leeuwarden	Leeuwarden, Cities in Friesland, Provincial capitals of the Netherlands
Middelburg, Netherlands	Cities in the Netherlands, Municipalities of Zeeland, Settlements in Zeeland, Provincial capitals of the Netherlands
Haarlem	Haarlem, Cities in the Netherlands, Settlements in North Holland, Provincial capitals of the Netherlands
Lelystad	Settlements in Flevoland, Municipalities of Flevoland, Provincial capitals of the Netherlands
Assen	Cities in the Netherlands, Settlements in Drenthe, Municipalities of Drenthe, Provincial capitals of the Netherlands
Breda	Breda, Cities in the Netherlands, Settlements in North Brabant
Enschede	Enschede, Cities in the Netherlands, Settlements in Overijssel
Amersfoort	Amersfoort, Cities in the Netherlands, Settlements in Utrecht (province)
Zoetermeer	Cities in the Netherlands, Municipalities of South Holland, Settlements in South Holland
Almere	Cities in the Netherlands, Settlements in Flevoland, Municipalities of Flevoland
Hilversum	Hilversum, Cities in the Netherlands, Settlements in North Holland
Roermond	Cities in the Netherlands, Settlements in Limburg (Netherlands), Municipalities of Limburg (Netherlands)
Venlo	Venlo, Cities in the Netherlands, Settlements in Limburg (Netherlands)
Delft	Delft, Cities in the Netherlands, Settlements in South Holland
Deventer	Cities in the Netherlands, Settlements in Overijssel, Municipalities of Overijssel
Ede	Cities in the Netherlands, Settlements in Gelderland, Municipalities of Gelderland
Freud Museum	Museums in London
Emu	Birds of Australia, Ratites, Struthioniformes
Kiwi	Birds of New Zealand, Ratites, Struthioniformes
Dodo	Columbiformes, Flightless birds, Extinct species, Mauritius
Tolkāppiyam	Tamil language
Great auk	Charadriiformes, Flightless birds, Extinct species
Abbey Road Studios	Music industry
Ujamaa	Tanzania, Nationalism
Prisoner	Prisoners
Fachhochschule Düsseldorf	Düsseldorf, Education in North Rhine-Westphalia, 1971 establishments in Germany
Psychoanalysis	Psychology, Philosophical movements and positions
Zaandam	Cities in the Netherlands, Settlements in North Holland, Former municipalities of North Holland, Zaanstad
Windows 3.x	Microsoft operating systems
Woodwind instrument	Woodwind instruments
Bewitched	1960s American television series, 1970s American television series, 1964 television series debuts, American sitcoms, English-language television programs
Dumbo	1941 movies, American family movies, American musical movies, Buddy movies, Disney animated movies, English-language movies, Movies based on books, Movies about animals, Movies composed by Oliver Wallace, Movies with circus settings
Bertolt Brecht	1898 births, 1956 deaths, Cardiovascular disease deaths in Germany, Deaths from myocardial infarction, Disease-related deaths in Bavaria, East German people, German poets, People from Augsburg, Writers from Bavaria
Beresford, South Dakota	Cities in South Dakota, 1884 establishments in the United States, 1880s establishments in Dakota Territory
Gotthold Ephraim Lessing	1729 births, 1781 deaths, 18th century philosophers, German philosophers, German poets, People from Saxony
Heinrich Böll	1917 births, 1985 deaths, German military personnel of World War II, German Roman Catholics, People from Cologne, German writers, German Nobel Prize winners
Anna Seghers	1900 births, 1983 deaths, East German people, German communists, Hungarian Jews, Jewish German writers, People from Mainz, Refugees from Nazism
Friedrich Schiller	German writers, 1759 births, 1805 deaths, German poets
Clement Attlee	1883 births, 1967 deaths, Alumni of the University of Oxford, British mayors, British military personnel of World War I, Companions of Honour, Deaths from pneumonia, Deputy Prime Ministers of the United Kingdom, Former Labour MPs (UK), Former members of the British House of Commons for English constituencies, Infectious disease deaths in London, Knights of the Garter, Order of Merit, Members of the House of Lords, People buried in Westminster Abbey, People from Putney, Politicians from London, Privy Councillors (UK), UK MPs 1929–1931, UK MPs 1931–1935, UK MPs 1935–1945, UK MPs 1945–1950, UK MPs 1950–1951, UK MPs 1951–1955, UK MPs 1955–1959, United Kingdom Earls
Bassoon	Double reed instruments
Octave	Music theory
Tinder	Fire
Stephen Harper	1959 births, Living people, Politicians from Toronto, Politicians from Alberta, Canadian economists, Privy Councillors (Canada), Leaders of the Opposition (Canada), Members of the House of Commons of Canada
Tadpole	Frogs
Zeulenroda-Triebes	Verwaltungsgemeinschaftfrei towns in Thuringia, Greiz Rural District
Harry Nilsson	Singer-songwriters from New York, Cardiovascular disease deaths in California, Deaths from heart failure, Singers from New York City, 1941 births, 1994 deaths
Acoustic guitar	Guitars
Flipper	Animal anatomy
Coral fungi	Ramariaceae, fungi
Stone fruit	Food ingredients, Food-related lists
Humpback whale	Baleen whales
Slovak language	Slavic languages, Languages of Europe
Electronic Arts	Video game companies, 1982 establishments in California
Tap (valve)	Hardware (mechanical)
Competition	Basic English 850 words, Everyday life
SimCity	1989 video games, SimCity
Doorstop	Tools
Digital rights management	Technology, Copyright
Cement	Materials
Brown algae	Algae
Bacillus	Gram-positive bacteria
Milk powder	Milk
Vaccinium vitis-idaea	Berries, Vaccinium
Dehydration	Health problems
Square Enix	Comic companies, Companies of Japan, Video game companies, 2003 establishments in Japan
Game designer	Video game designers, Games
Shigeru Miyamoto	1952 births, Living people, Japanese video game designers, People from Kyoto Prefecture, Nintendo people
Individual	Basic English 1500 Words
Truck	Trucks
Crown-of-thorns starfish	Echinoderms
Sea urchin	Echinoderms
Brittle star	Echinoderms
Bivalve	Bivalves
Card	Basic English 850 words
Bishop	Christian religious occupations
Tray	Basic English 850 words
Orkney Islands	Orkney, Counties of Scotland, Scottish Council Areas
Methodism	Methodism
Salivary gland	Mouth, Exocrine system, Glands
Vas deferens	Anatomy of the male reproductive system
Che Guevara	Argentine people, Communists, People executed by firearm, Physicians, 1928 births, 1967 deaths, Cuban scientists
Whisker	Facial hair, Animal anatomy
Magma	Volcanology
Glue	Chemical compounds
Angara River	Rivers of Russia, Siberia
Yenisei	Rivers of Russia, Mongolia, Siberia
Moonspell	Portuguese musicians, Black metal bands, Doom metal bands, Death metal bands, Gothic metal bands, Folk metal bands
Siberia	Siberia
Opel Corsa	Opel Corsa, 1980s automobiles, 1990s automobiles, 2000s automobiles, Opel automobiles
Iron Maiden	1975 establishments in the United Kingdom, 1970s British music groups, 1980s British music groups, 1990s British music groups, 2000s British music groups, 2010s British music groups, English heavy metal bands, Iron Maiden, Musical groups established in 1975, Musical groups from London
Ljubljana	Ljubljana, 15th century establishments in Europe, Establishments in Slovenia
Nukuʻalofa	Tonga, Capital cities in Oceania
General Motors	1908 establishments in the United States, 1900s establishments in Michigan, General Motors
Bartolomeu Dias	1450 births, 1500 deaths, Portuguese explorers
Cape Agulhas	Capes, Geography of South Africa
Holy Roman Emperor	Holy Roman Emperors
Fatu Hiva	Islands of French Polynesia
Tampere	Tampere, 1779 establishments in Europe, Cities in Finland, 18th century establishments in Finland
Asikkala	Municipalities of Päijänne Tavastia
Lordi	Finnish musical groups, Finnish heavy metal bands, Hard rock bands, Eurovision Song Contest winners
CD-R	Compact Disc
The Truman Show	1998 comedy-drama movies, 1990s satirical movies, American comedy-drama movies, American satirical movies, English-language movies, Movies directed by Peter Weir, Dystopian movies
Krill	Krill
Subaru	Subaru, 1954 establishments in Asia, 1950s establishments in Japan
Giraffe	Even-toed ungulates, Mammals of Africa
Giant isopod	Isopods
Elementary algebra	Algebra
Kesälahti	Municipalities of Finland, 1873 establishments in Europe, 1870s establishments in Finland
Eckerö	Municipalities of Finland, Åland Islands
Utsjoki	Municipalities of Lapland (Finland)
Savitaipale	Municipalities of South Karelia
Vantaa	Vantaa
Karstula	Municipalities of Central Finland, 1867 establishments in Finland
Dimmu Borgir	Black metal bands, Norwegian heavy metal bands, Oslo, 1993 establishments in Europe, Musical groups established in 1993, 1990s establishments in Norway
Sonata Arctica	Finnish musical groups, Power metal bands
Carpet	Cloth
Digon	Shapes, Polygons
Great circle	Shapes
John Dalton	1766 births, 1844 deaths, English chemists, English physicists, Nuclear physicists
Kauniainen	Cities in Finland, Municipalities of Uusimaa, 1920 establishments in Europe, 1920s establishments in Finland
Nummi-Pusula	Former municipalities of Finland, 1981 establishments in Europe, 20th century establishments in Finland
Medicine man	Native American, Religious people, Health care
Basement	Construction
Landfill	Waste
Human reproductive system	Reproductive system
Rectum	Anatomy of the digestive system
County seat	Local government, County seats in the United States
Pacific Islands	Pacific islands
Large intestine	Anatomy of the digestive system
Joensuu	Cities in Finland
Tuupovaara	Municipalities of Finland
Urine	Urinary system
Rudolf Vrba	1924 births, 2006 deaths, Canadian academics, Canadian Jews, Canadian scientists, Czechoslovak people, Holocaust survivors, Jewish academics, Jewish British scientists, Naturalized citizens of Canada, Naturalised citizens of the United Kingdom, Pharmacologists, Slovakian Jews
Joel Brand	1907 births, 1964 deaths, Hungarian Jews
Auschwitz concentration camp	1940 establishments in Europe, Nazi concentration camps in Poland, World Heritage Sites in Poland, 20th century establishments in Poland
Savukoski	Municipalities of Lapland (Finland)
Friedrich Dürrenmatt	1921 births, 1990 deaths, Swiss writers, 20th century philosophers
Kampala	Capital cities in Africa, Settlements in Uganda, 1890 establishments
Common wombat	Marsupials of Australia
Chimpanzee	Hominins
Bonobo	Hominins
Genoa	Genoa, Regional capitals in Italy
Liguria	Liguria
Royal Opera House	Opera houses, Buildings and structures in London
Kalahasti	Hindu mythology
Raidas	Buddhism, Indian people
Rishi	Hindu mythology
Tiruvannamalai	Hinduism, Hindu mythology, Tiruvannamalai District
Vishvamitra	Hindu mythology
Rabindranath Tagore	1861 births, 1941 deaths, Indian writers, Poets, Alumni of University College London, People from Kolkata, National symbols of India, Indian Nobel Prize winners
Tamil people	Tamil people
Down syndrome	Trisomies
Genetic disorder	Genetic disorders
Umberto Eco	1932 births, 2016 deaths, Deaths from pancreatic cancer, Italian philosophers, Novelists, Order of Merit of the Federal Republic of Germany, Semioticians, Writers from Piedmont, People from Alessandria, Former Roman Catholics
Balloon	Aircraft, Toys, 1823
Einsteinium	Actinides, Chemical elements
Vulva	Anatomy of the female reproductive system
Congruence	Geometry
Deism	Theology
Cleveland Indians	Cleveland Indians
Friuli-Venezia Giulia	Friuli Venezia-Giulia
Udine	Udine, Capital cities in Italy
Günter Grass	1927 births, 2015 deaths, Deaths from respiratory tract infection, German essayists, German Nobel Prize winners, German novelists, German writers, People from former German territories, People from Gdańsk, Playwrights, Waffen-SS people
Occitan language	Romance languages, Languages of Europe
Bass (singer)	Vocal ranges
Plankton	Biological oceanography, Ecology
Wake Forest University	Atlantic Coast Conference, Colleges and universities in North Carolina, Oak Ridge Associated Universities, 1834 establishments in the United States, 1830s establishments in North Carolina
Mirza Ghulam Ahmad	1835 births, 1908 deaths, Religious leaders, New religious movements
Pharmacology	Drugs, Pharmacology
Indo-European languages	Indo-European languages
Gulf of Mexico	Gulfs, Atlantic Ocean, Bodies of water of the United States, Geography of Cuba, Geography of Mexico
Zaire	1971 establishments in Africa, 1997 disestablishments, 1990s disestablishments in Africa, Former countries in Africa, History of the Democratic Republic of the Congo, States and territories established in the 20th century, States and territories disestablished in the 20th century
Pneumonia	Infectious diseases, Pulmonology
Encino, Los Angeles	Neighborhoods of Los Angeles
Winter Olympic Games	Winter Olympic Games, Sports lists
Woodside, California	Cities in California, Cities in the San Francisco Bay Area, Settlements in San Mateo County, California
Pesticide	Poisons, Gardening
Inhalation	Respiratory system
Severe acute respiratory syndrome	Diseases caused by viruses, Pulmonology, Coronaviruses, Zoonoses
Ballet	Ballet
Lazio	Lazio
Rudolf Diesel	1858 births, 1913 deaths, German inventors
Niklaus Otto	1832 births, 1891 deaths, German engineers, German inventors
Quito	World Heritage Sites in South America, 1534 establishments, Quito, 1530s establishments in South America
Uralic languages	Uralic languages
Indo-Aryan languages	Indo-Aryan languages
Indo-Iranian languages	Indo-Iranian languages
Slavic languages	Slavic languages, Languages of Europe, Language-related lists
Sienna	World Heritage Sites in Italy, Sienna, Capital cities in Italy
Padua	Padua, Capital cities in Italy
Mary McAleese	1951 births, Living people, Fianna Fáil politicians, Northern Ireland politicians, Politicians from Belfast
Divorce	Social sciences, Family, Relationships
Writing system	Writing systems
Cloudberry	Rubus
Migration	Ecology, Zoology, Ethology, Migration
Scent marks	Animals
Maputo	Capital cities in Africa, Provinces of Mozambique, Geography of Mozambique
Original sin	Christian theology
American Airlines	1934 establishments in the United States, Airlines of the United States
United Airlines	Airlines of the United States, History of Chicago, Star Alliance, 1926 establishments in the United States, 20th-century establishments in Idaho, IATA members
Romanization of Ukrainian	Romanization
Magical DoReMi	1999 anime television series, 2000 anime television series, 2000 manga, 2001 anime television series, 2001 manga, 2002 anime television series, Children's television series
Friedrich Nietzsche	1844 births, 1900 deaths, 19th century philosophers, Continental philosophers, German atheists, German philosophers, German writers, People from Saxony-Anhalt
Movie screen	Movie industry
Metallica	Metallica, American heavy metal bands, American hard rock bands, Thrash metal bands, Speed metal bands, Musical groups from Los Angeles, California, Musical groups established in 1981
Time bomb	Explosives
1655	1655
1400s	1400s
1412	1412
1634	1634
Zinedine Zidane	1972 births, Living people, 1998 FIFA World Cup players, 2002 FIFA World Cup players, 2006 FIFA World Cup players, French footballers, Sportspeople from Marseille
Babylon	Mesopotamia
1572	1572
1359	1359
1389	1389
Genetic engineering	Genetic engineering
Kim Il-Sung	1912 births, 1994 deaths, Atheists, Deaths from myocardial infarction, Former Christians, Former dictators, North Korean military people, North Korean politicians, Presidents (government), Prime ministers
Nucleophilic substitution	Chemical reactions
Brasschaat	Municipalities of Antwerp
Okapi	Even-toed ungulates, Mammals of Africa
Giraffidae	Even-toed ungulates
Amman	Capital cities in Asia, Cities in Jordan
Riyadh	Riyadh
Popular culture	Popular culture
Psychiatric hospital	Psychiatry, Hospitals
Military camp	Army
Private (rank)	Army, Marines
Spinster	Family, Pejoratives
Dick Clark	Emmy Award winning actors, American movie actors, American television actors, American stage actors, American voice actors, American radio actors, American radio personalities, American television personalities, American television presenters, Deaths from myocardial infarction, American game show hosts, Businesspeople from New York, Actors from New York, 1929 births, 2012 deaths, National Radio Hall of Fame inductees, People from Mount Vernon, New York
Perl	Programming languages
Johannes Kepler	1571 births, 1630 deaths, 16th century philosophers, 17th century philosophers, Astrologers, German astronomers, German esotericists, German Lutherans, German mathematicians, German philosophers, German theologians, People from Baden-Württemberg, Teachers
Pascal	Programming languages
Hymen	Anatomy of the female reproductive system
Maidenhead	Towns in Berkshire
G-spot	Anatomy of the female reproductive system
Skene's gland	Anatomy of the female reproductive system, Glands
Bartholin's gland	Anatomy of the female reproductive system, Glands, Sexuality
Gland	Glands
Sevastopol	Cities in Ukraine, Capital cities in Russia, Federal cities of Russia
Aegukka	National anthems, North Korea
Aegukga	National anthems, South Korean music
Sunni Islam	Islamic denominations, Muslims
Hunting	Sports involving animals, Animal rights, Hunting
Tycho Brahe	1546 births, 1601 deaths, Astrologers, Astronomers, Danish scientists
Ellipse	shapes, Conic sections
Babur	Mughal emperors, 1483 births, 1530 deaths
Mantra	Hinduism, Hindu mythology
Fruit tree	Trees, Fruits
Line of Control	Kashmir, Territorial disputes of India, Territorial disputes of Pakistan, Walls
Detmold	Lippe Rural District
Arnsberg	Hochsauerland Rural District
Siegen	Siegen-Wittgenstein Rural District
Graz	Cities and towns in Styria, Districts of Styria, Graz, World Heritage Sites in Austria
Linz	Linz, Districts of Upper Austria, Cities and towns in Upper Austria
Innsbruck	Cities and towns in Tyrol (state), Olympic cities, Districts of Tyrol (state), Innsbruck
Basel	Basel, Imperial free cities
Lausanne	Lausanne
Porto	Port cities and towns of the Atlantic Ocean, Porto, Ports and harbours of Europe
Witten	Ennepe-Ruhr Rural District
Moers	Wesel (district)
Castrop-Rauxel	Recklinghausen Rural District
Ratingen	Mettmann Rural District
Gland (city)	Cities in Switzerland, Municipalities of Vaud
All Quiet on the Western Front	1929 books
Cần Thơ	Cities in Vietnam
Vinh	Cities in Vietnam
Dalat	Cities in Vietnam
Pleiku	Cities in Vietnam
Quảng Ngãi	Cities in Vietnam
Bordeaux	Bordeaux, Capital of France, Departmental capitals in France, Former national capitals, Regional capitals in France, World Heritage Sites in France
Nantes	1st-century BC establishments, Departmental capitals in France, Nantes, Regional capitals in France
Toulouse	Departmental capitals in France, Regional capitals in France, Toulouse
Nice	Nice
Strasbourg	Departmental capitals in France, Imperial free cities, Regional capitals in France, Strasbourg, World Heritage Sites in France
Montpellier	Departmental capitals in France, Montpellier, Former regional capitals in France
Lille	Departmental capitals in France, Lille, Regional capitals in France
Rennes	Rennes, Departmental capitals in France, Regional capitals in France
Reims	Reims
Orléans	Capital of France, Former national capitals, Orléans, Departmental capitals in France, Regional capitals in France
Le Havre	Le Havre, Subprefectures in France, World Heritage Sites in France, 1517 establishments, 1510s establishments in Europe, 16th century establishments in France
Mountain range	Mountain ranges
Straight edge	Society, Lifestyles
Rouen	Departmental capitals in France, Regional capitals in France, Rouen
Microcode	Microprocessor design
Computational complexity theory	Theoretical computer science
Average	Mathematics
Fluminense FC	Football clubs in Rio de Janeiro, 1902 establishments, 1900s establishments in Brazil
Romanization	Romanization, Culture
Diaspora	Migration
Angers	Cities in France, Communes in Maine-et-Loire, Departmental capitals in France
Toulon	Toulon, Departmental capitals in France
Grenoble	Grenoble, Departmental capitals in France, Olympic cities
Sequence	Mathematics, Words
Aix-en-Provence	Aix-en-Provence, Subprefectures in France
Amiens	Amiens, Departmental capitals in France, Former regional capitals in France
Le Mans	Le Mans, Departmental capitals in France
Tours	Capital of France, Cities in France, Communes in Indre-et-Loire, Former national capitals, Departmental capitals in France
Nancy, France	Departmental capitals in France, Nancy
Limoges	Limoges, Departmental capitals in France, Former regional capitals in France
Clermont-Ferrand	Clermont-Ferrand, Departmental capitals in France, Former regional capitals in France
Villeurbanne	Cities in France, Communes in Rhône
Exile on Main St.	The Rolling Stones, 1972 albums, Rock and roll albums, R&B albums, Blues albums, Soul albums, Country albums, Blues rock albums
OpenGL	Free software, Graphics software
Māori language	Austronesian languages, Languages of Oceania, Māori language
Movie criticism	Movie critics, Movie occupations
McCarthyism	20th century in the United States, Political movements
Syphilis	Sexually transmitted diseases, Diseases caused by bacteria
Gonorrhea	Sexually transmitted diseases, Diseases caused by bacteria
Cichlid	Perciformes
Battle of Hastings	1066 in England, Battles involving England, October events, Battles of the Middle Ages
Pavo (genus)	Phasianidae, Birds of Asia, Galliformes
Reading, Berkshire	County towns in England, Towns in Berkshire, Unitary authorities
Dozen	Numbers
European sprat	Teleosts
The Little Mermaid	Fairy tales, Works by Hans Christian Andersen
Hans Christian Andersen	1805 births, 1875 deaths, Accidental deaths from falls, Bisexual people, Children's writers, Danish poets, Deaths from liver cancer, Disease-related deaths in Denmark, LGBT writers, Novelists, Odense
Şükrü Saracoğlu Stadium	Football stadiums in Turkey, Istanbul
List of airlines	Aviation lists, Airlines
Atlantic herring	Clupeiformes
Pelagie Islands	Archipelagos, Islands of Africa, Islands of Italy
Lampedusa	Islands of Italy, Islands of Africa
Muscat	Capital cities in Asia, Oman
Ukrainian language	Slavic languages, Languages of Europe
Native speaker	Language
Guilty Gear	Guilty Gear, Video game series
Florence Nightingale	1820 births, 1910 deaths, Nurses, Unitarians, Order of Merit, People from Florence, People from London
Apocalypse Now	1979 drama movies, 1970s war movies, American drama movies, American epic movies, American war movies, Cambodia, English-language movies, French-language movies, Jungle movies, Movies set in the 1960s, United States National Film Registry movies, Vietnam War movies, Movies directed by Francis Ford Coppola
1228	1228
1305	1305
1327	1327
312	312
1709	1709
1336	1336
1374	1374
1295	1295
1360	1360
Vojvodina	Serbia, Provinces
1649	1649
Pennsylvania Station	Railway stations in the United States
Dan Quayle	1947 births, Living people, American lawyers, American Presbyterians, Manx people, 2000 United States presidential candidates, United States representatives from Indiana, United States senators from Indiana, US Republican Party politicians, 20th-century American politicians
Cincinnati	Cincinnati, Ohio, County seats in Ohio, 1788 establishments in the United States, 18th-century establishments in the Northwest Territory
Cable car	Vehicles, Cableways
Tokusatsu	Japanese language, Movie terminology, Television
Snakes on a Plane	2006 horror movies, 2000s action movies, 2000s crime thriller movies, American action movies, American crime thriller movies, American horror movies, English-language movies, Movies about animals, Movies set in Hawaii, Movies set in Los Angeles, California
War in Afghanistan (2001–2021)	2000s in Asia, 2010s in Asia, 2020s in Asia, 21st century in Afghanistan, Wars involving Canada, Wars involving Germany, Wars involving Greece, Wars involving Italy, Wars involving New Zealand, Wars involving the Netherlands, Wars involving the United Kingdom, Wars involving the United States
Castrato	Vocal ranges
Falsetto	Vocal ranges
Countertenor	Vocal ranges
Breeches role	Cross-dressing, Opera terminology
Treble (singer)	Vocal ranges
Claque	Opera terminology
Leech	Annelids
Glycoprotein	Molecular biology, Hormones
Tissue culture	Cell biology, Laboratory techniques
Chemotherapy	Cancer treatment
Typhoid	Diseases caused by bacteria
Necklace	Jewelry
Cranbourne, Victoria	Cities in Victoria
Transylvania	Transylvania
Southwest Airlines	1967 establishments in the United States, Airlines of the United States, Dallas, Texas, Low-cost airlines
Cluj-Napoca	County capitals of Romania, Transylvania
Sibiu	County capitals of Romania, Cities in Romania, Transylvania
Graphic design	Written communication, Graphics, Typography, History of printing
Rwandan genocide	1994 in Africa, April events, Genocide, July events, June events, Mass murder in Africa, May events, Murder in the 1990s, Rwandan genocide, War crimes
Vaquita	Toothed whales
Zygote	Biological reproduction
Dave Jauss	Baseball coaches, 1957 births, Living people
Cardiac arrest	Heart
Huguenots	Calvinism, 16th century in France, 17th century in Europe, 18th century in France
La Rochelle	Communes in Charente-Maritime, Departmental capitals in France
Combustion	Chemical processes
Nanometre	Units of length
Caterpillar	Lepidoptera
Hummingbird	Hummingbirds
Bielsko-Biała	Cities in Poland
Idi Amin	1925 births, 2003 deaths, African military people, Boxers, Deaths from renal failure, Former dictators, Muslims, Presidents of Uganda
Phnom Penh	Capital cities in Asia, Settlements in Cambodia
Take Me Out to the Ball Game	Baseball, 20th century songs
Xia dynasty	Chinese dynasties
South Park	1997 American television series debuts, 1990s American sitcoms, 1990s animated television series, 1990s satirical television series, 2000s American sitcoms, 2000s animated television series, 2000s satirical television series, 2010s American sitcoms, 2010s animated television series, 2010s satirical television series, 2020s American sitcoms, 2020s animated television series, 2020s satirical television series, Adult animated television series, American animated television series, American satirical television series, Black comedy television series, English-language television programs, South Park, Television series set in Colorado
Colon	Anatomy of the digestive system
Battle of Ðiện Biên Phủ	1954, 20th century in Vietnam, Battles
August Revolution	1945 in Vietnam, 20th century rebellions, Rebellions in Asia, Revolutions
Dictator	Politics
Nigeria	Nigeria, English-speaking countries, Members of the Organisation of Islamic Cooperation, 1960 establishments in Africa
Laxoox	Breads, Somalia
Khmer language	Austro-Asiatic languages, Cambodia
Democratic Republic of the Congo	Democratic Republic of the Congo, French-speaking countries, Least developed countries, 1960 establishments in Africa
Spotted hyena	Mammals of Africa, Hyaenas
Aardwolf	Hyaenas
Waterbury, Connecticut	Cities in Connecticut
Blue cheese	Cheeses
Elektra	People in Greek mythology
Insulin	Biochemistry
Dragon Ball Z	Anime series based on manga
Nerve impulse	Physiology
Hare	Lagomorphs
ESSEC	1900s establishments in France, 1907 establishments in Europe, Schools in France, Business
National symbols	National symbols, Culture
Computer bus	Computer buses
Diego Ramírez Islands	Islands of Chile
Performing music from memory	Musical performance techniques
Grave	Death customs, Burial monuments and structures
Polyrhythm	Musical terminology
Theme Hospital	Simulator video games, 1997 video games, Electronic Arts video games
Pontin's	Companies of the United Kingdom, Shops, Holidays
Twin prime conjecture	Number theory, Conjectures
Mud	Soil, Sedimentary rocks
The Zutons	English rock bands, Indie rock bands, Musical groups from Liverpool
Dwarf planet	Dwarf planets, Solar System
Blue peafowl	Birds of India, Birds of Pakistan
Green peafowl	Birds of Asia
Nintendo Virtual Boy	Nintendo video game consoles, Handheld video games
Duke University	Association of American Universities, Atlantic Coast Conference, Colleges and universities in North Carolina, Oak Ridge Associated Universities, 1838 establishments in the United States, 1830s establishments in North Carolina
Existentialism	Philosophical movements and positions
King of the Hill	1997 American television series debuts, 2010 American television series endings, 1990s American television series, 2000s American television series, 2010s American television series, American animated television series, Fox television series, Television series set in Texas, English-language television programs
Hairdresser	Personal service occupations, Hair
Eppie Lederer	Jewish American writers, Twin people from the United States, Writers from Chicago, 1918 births, 2002 deaths, American columnists
Northern bluefin tuna	Bony fish
Automaton	Mathematics, Theoretical computer science
Vending machine	Commerce
Bar (business)	Restaurants, Places where alcohol is served
Cape Horn	Geography of Chile, Capes, Peninsulas
Iceberg	Water
Circumnavigation	Water transport
Thought experiment	Science, Philosophy of science, Thought
Breaking Benjamin	American rock bands, American heavy metal bands, Post-grunge bands, Musical groups from Pennsylvania
Headlands and bays	Landforms, Bays
Drake Passage	Waterways, Antarctic region
Glacier	Landforms
Sight-reading	Musical performance techniques
Child prodigy	Child prodigies, Intelligence
Puerto Rican	Puerto Rico
Toothbrush	Tools, Teeth, Hygiene
70s BC	70s BC
20s BC	20s BC
Homeostasis	Physiology, Systems theory
Pulmonary embolism	Pulmonology
Toilet	Home, Waste management
Stegosaurus	Stegosaurs, Jurassic dinosaurs
Psittacosis	Diseases caused by bacteria
Gregorian chant	Music genres
Barneveld	Settlements in Gelderland, Municipalities of Gelderland
Executable	Computer file formats
Windows NT	Microsoft operating systems
File extension	Software, Computer file formats
Lagomorpha	Lagomorphs
Lupus	Autoimmune diseases
Hiragana	Writing systems, Japanese language
Kuomintang	Political parties in Taiwan, Conservative parties, Nationalist organizations in Taiwan
Chiang Kai-shek	1887 births, 1975 deaths, Anti-Communists, Deaths from cardiovascular disease, Generals, Methodists, Presidents of the Republic of China, Prime ministers, Taiwanese military people, Time People of the Year, World War II political leaders, Zhejiang
Dark matter	Astrophysics, Galaxies
Katakana	Writing systems, Japanese language
Sanja Stijačić	Serbian musicians, Classical musicians, 1965 births, Living people
Comb	Basic English 850 words, Care
Perfume	Perfumery
Journey (band)	1973 establishments in the United States, 1970s American music groups, 1970s establishments in California, 1980s American music groups, 1990s American music groups, 2000s American music groups, 2010s American music groups, American heavy metal bands, American rock bands, Musical groups established in 1973, Musical groups from San Francisco
Bruno Brun	1910 births, 1978 deaths, Clarinetists, Yugoslavian people
Faculty of Arts (Priština)	Colleges and universities in Europe, Buildings and structures in Serbia, 1973 establishments in Europe
Jasmina Novokmet	Living people, 1969 births, Serbian musicians, Conductors
Magna Carta	Politics of the United Kingdom, Documents, 13th century in England, Law, 1215
Catapult	Weapons
1552	1552
1562	1562
1563	1563
Minuet	Ballroom dances, Musical forms
Scherzo	Musical forms
1592	1592
1595	1595
1599	1599
1612	1610s
Griffin	Legendary creatures
Chordate	Chordates
Sanlucar la Mayor	Towns in Spain, Municipalities in Andalusia
Pyrolysis	Organic reactions, Chemical processes
Uri (canton)	Canton of Uri
Michael Ende	1929 births, 1995 deaths, Cancer deaths in Germany, Deaths from stomach cancer, German children's writers, Writers from Bavaria
Applet	Software
Veneto	Veneto
Molise	Molise
Philippine Sea	Seas of the Pacific Ocean, Bodies of water of Asia, Bodies of water of Oceania, Geography of the Philippines
Visayas	Islands of the Philippines
Tuscany	Tuscany, Wine regions
1484	1484
Austronesian languages	Austronesian languages
Fundamentalist Church of Jesus Christ of Latter Day Saints	Mormonism
Biological classification	Taxonomy
Kingdom (biology)	Taxonomy
Class (biology)	Taxonomy
Order (biology)	Taxonomy
Family (biology)	Taxonomy
Digestion	Digestive system, Basic English 850 words
Sight	Psychology, Vision, Perception
Pharynx	Neck
Jejunum	Anatomy of the digestive system
Ileum	Anatomy of the digestive system
Cecum	Anatomy of the digestive system
Romano Prodi	1939 births, Living people, European Commissioners, Politicians from Emilia-Romagna, Prime Ministers of Italy
2013	2013
Basilicata	Basilicata
Campania	Campania
Emilia-Romagna	Emilia-Romagna
Vasil Levski	1837 births, 1873 deaths, Bulgarian people, Executed people
CP/M	Operating systems
Sana'a	Capital cities in Asia, Cities in Yemen
Astrid Lindgren	1907 births, 2002 deaths, Swedish children's writers
Cantabria	Cantabria
Civil Aviation Authority	1972 establishments in the United Kingdom, Aviation authorities, Organisations based in the United Kingdom, Transport in the United Kingdom
Apulia	Apulia
Belluno	Cities in Veneto, Capital cities in Italy
Vicenza	Cities in Veneto, Capital cities in Italy
Rovigo	Cities in Veneto, Capital cities in Italy
L'Aquila	Cities in Abruzzo, Regional capitals in Italy
Chieti	Cities in Abruzzo, Capital cities in Italy
Pescara	Cities in Abruzzo, Capital cities in Italy
Cryptozoology	Cryptozoology, Pseudoscience
Ankylosaurus	Ankylosauria, Cretaceous dinosaurs
Matera	Towns in Italy, World Heritage Sites in Italy, Settlements in Basilicata, Capital cities in Italy
Potenza	Regional capitals in Italy, Settlements in Basilicata
Kara Sea	Seas of the Arctic Ocean
Prototheria	Monotremes, Mammals
Edvard Munch	Norwegian painters, 1863 births, 1944 deaths
Sex education	Human sexuality
Bedroom	Rooms
Marche	Marche
Umbria	Umbria
Valle d'Aosta	Valle d'Aosta
Mont Blanc	Alps, Mountains of France, Mountains of Italy
Shiite Crescent	Middle East
Tibet	Tibet
Air gun	Firearms
Carcass	Death
Unit circle	Mathematics
El Al	Airlines of the Middle East, Transport in Israel, 1948 establishments in Israel
Middle East Airlines	Airlines of the Middle East, Lebanon, 1945 establishments in Asia, 20th century establishments in Lebanon
Blackmail	Types of crime
Bribery	Types of crime
Rubella	Diseases caused by viruses
Psychiatry	Psychiatry
Stephen Colbert	1964 births, Living people, Actors from South Carolina, Actors from Washington, D.C., American television actors, American television talk show hosts, Comedians from South Carolina, Comedians from Washington, D.C., Comedy Central personalities, Webby Award winners, People from Montclair, New Jersey, Emmy Award winners, Grammy Award winners
Hobsonville	Cities in New Zealand
Papatoetoe	Cities in New Zealand
Bognor Regis Town F.C.	English football clubs, 1883 establishments in the United Kingdom
Humour	Humor, Virtues
Anthony Kiedis	1962 births, Living people, American rock singers, Singers from Grand Rapids, Michigan, Red Hot Chili Peppers
Treviso	Cities in Veneto, Capital cities in Italy
Tony Hoare	1934 births, Living people, Alumni of the University of Oxford, British academics, English computer scientists, People from Colombo, Turing Award winners
John Frusciante	American rock guitarists, Musicians from New York City, Electronic musicians, 1970 births, Living people, Red Hot Chili Peppers
Flea (musician)	1962 births, Living people, American punk musicians, Red Hot Chili Peppers, Musicians from Los Angeles, California, Musicians from New York, Bassists, American rock guitarists, Australian guitarists, Musicians from Melbourne, Australian rock musicians, Warner Bros. Records artists
Andrey Kolmogorov	1903 births, 1987 deaths, Russian scientists, Computer scientists, Russian mathematicians
Chad Smith	American drummers, American rock musicians, Musicians from Saint Paul, Minnesota, Red Hot Chili Peppers, 1961 births, Living people
Hillel Slovak	1962 births, 1988 deaths, Drug-related deaths, Jewish Israeli musicians, People from Haifa, Red Hot Chili Peppers, Rock musicians
Jack Irons	1962 births, Living people, American drummers, Red Hot Chili Peppers, Musicians from Los Angeles, California, American rock musicians
Dave Navarro	American guitarists, Red Hot Chili Peppers, Musicians from California, 1967 births, Living people, People from Santa Monica, California, American bloggers
Charles Babbage	1791 births, 1871 deaths, English mathematicians, English computer scientists, Scientists from London
Ticket (admission)	Basic English 850 words, Everyday life
Bergamo	Cities in Lombardy, Capital cities in Italy
Brescia	Brescia, Capital cities in Italy
Como	Como, Capital cities in Italy
Cremona	Cremona, 3rd-century BC establishments, Capital cities in Italy
Lecco	Cities in Lombardy, Capital cities in Italy
Lodi	Lodi, Capital cities in Italy
Mantua	Mantua, Capital cities in Italy
Pavia	Pavia, Capital cities in Italy
Sondrio	Cities in Lombardy, Capital cities in Italy
Varese	Cities in Lombardy, Capital cities in Italy
Perugia	Regional capitals in Italy, Cities in Umbria
Terni	Capital cities in Italy, Cities in Umbria
Biological weapon	Biology, Terrorism, Weapons
Harper Lee	1926 births, 2016 deaths, Deaths from stroke, American novelists, Writers from Alabama, To Kill a Mockingbird
Truman Capote	1924 births, 1984 deaths, Actors from Louisiana, American movie actors, American novelists, American television writers, Cancer deaths in Los Angeles, Deaths from liver cancer, Gay men, LGBT actors, LGBT novelists, LGBT people from Alabama, LGBT people from Connecticut, LGBT people from Louisiana, LGBT people from New York City, Screenwriters from Louisiana, Writers from Alabama, Writers from Connecticut, Writers from New Orleans, Louisiana, Writers from New York City
Ubuntu	Linux distributions, Debian-based Linux distributions
The Second Coming (TV)	2003 British television series debuts, 2003 British television series endings, 2000s British television series, British drama television series, Fantasy television series, ITV television programmes, English-language television programs
Eid festival	Islam
Alessandria	Alessandria, Capital cities in Italy
Asti	Cities in Piedmont, Capital cities in Italy
Biella	Cities in Piedmont, Capital cities in Italy
Cuneo	Cities in Piedmont, Capital cities in Italy
Novara	Novara, Capital cities in Italy
Vercelli	Cities in Piedmont, Capital cities in Italy
Kate Moss	Models from London, 1974 births, Living people
Alesha Dixon	1978 births, Living people, Black British musicians, British R&B musicians, British rap musicians, English singers, Musicians from Hertfordshire, Strictly Come Dancing participants, Television personalities from Hertfordshire
Lake Tahoe	Lakes of the United States, Bodies of water of California, Geography of Nevada, Western United States, El Dorado County, California, Placer County, California
Dull, Perth and Kinross	Villages in Scotland
Dr Jekyll and Mr Hyde	1886 books, Books by Robert Louis Stevenson, British novels, Dissociative identity disorder in fiction, English-language novels, Horror novels, Bipolar disorder in fiction, Crime fiction books
Hafez al-Assad	1930 births, 2000 deaths, Deaths from myocardial infarction, Former dictators, Generals, Prime Ministers of Syria, Presidents of Syria, Syrian military people
Eroticism	Human sexuality
Tarantella	Dances
Flag of Germany	National flags, Germany
Ancona	Ancona, Regional capitals in Italy
Fermo	Cities in Marche, Capital cities in Italy
Macerata	Cities in Marche, Capital cities in Italy
Ban	Law, Internet
Neurology	Neurology
Steve Irwin	1962 births, 2006 deaths, Accidental deaths in Australia, Australian activists, Australian television presenters, People from Melbourne, People from the Sunshine Coast, Queensland, Officers of the Order of Australia
Karlstad	Karlstad
Search and seizure	Law enforcement techniques
Impulse (physics)	Basic English 850 words, Mechanics
Ruler	Measuring tools
Mutation	Classical genetics, Cell biology
Södermanland	Provinces of Sweden
Dalarna	Provinces of Sweden
Hälsingland	Provinces of Sweden
Stingray	Rays, Venomous animals
Sergei Rachmaninoff	20th century composers, Cancer deaths in the United States, Deaths from melanoma, Romantic composers, Russian composers, Russian pianists, 1873 births, 1943 deaths
Turbot	Flatfish, Edible fish
William Gallas	1977 births, Living people, French footballers
Ruud van Nistelrooy	1976 births, Living people, 2006 FIFA World Cup players, Dutch footballers, Manchester United F.C. players, People from Oss, Sportspeople from North Brabant, UEFA Euro 2004 players, UEFA Euro 2008 players
Rosa Parks	Congressional Gold Medal recipients, 1913 births, 2005 deaths, Deaths from natural causes, People with Alzheimer's disease, African-American people, American civil rights activists, Nonviolence advocates, People from Alabama
Euler's identity	Mathematics
Hideki Tōjō	1884 births, 1948 deaths, Generals, Japanese military people, Military personnel of World War II, People executed by hanging, Politicians from Tokyo, Prime Ministers of Japan, War criminals, World War II political leaders
Trentino	Provinces of Trentino-Alto Adige/Südtirol, Tyrol
SuSE Linux	Linux distributions
Laissez-faire	Politics, Political movements, Libertarianism
Walter Moers	1957 births, Living people, Comics artists, German artists, People from Mönchengladbach, Writers from North Rhine-Westphalia
Dorothy Metcalf-Lindenburger	1975 births, Living people, American astronauts, People from Colorado Springs, Colorado
Worker	Employment, Labor
Actinium	Actinides, Chemical elements
Alyson Michalka	1989 births, Living people, American movie actors, American television actors, Actors from Los Angeles County, California, Musicians from Los Angeles County, California, American rock guitarists, American pop musicians, People from Torrance, California
Phil of the Future	Television series by Disney, 2004 television series debuts, English-language television programs
Brenda Song	1988 births, Living people, American television actors, Models from California, Disney actors, Actors from Sacramento County, California, Singers from California
William E. Nelson	1941 births, Canadian inventors, Living people, People from Ontario
Guide dog	Working dogs, Service animals
Keelung City	Cities in Taiwan, Ports and harbours of Taiwan
Chocolate cake	Cakes
Ten Who Dared	Disney movies, 1960 movies, Historical movies
Imaginary unit	Mathematics, Numbers
Phycology	Algae
Snorkeling	Water sports
Kelly Tarlton's Antarctic Encounter and Underwater World	Aquariums, Auckland, 1985 establishments, 20th-century establishments in New Zealand, 1980s establishments in Oceania
List of cat breeds	Cat breeds, Lists of animals
Grave (mass)	Old units of measurement, Units of mass
The Smiths	1982 establishments in England, 1980s British music groups, 1980s disestablishments in England, English rock bands, Musical groups disestablished in 1987, Musical groups established in 1982, Musical groups from Greater Manchester, Warner Bros. Records artists
Countdown (game show)	1982 television series debuts, 1980s British television series, 1990s British television series, 2000s British television series, 2010s British television series, British television game shows, Channel 4 television programmes, English-language television programs
Allotheria	Mammals, Fossils
Multituberculate	Mammals, Fossils
Gondwanatheria	Mammals, Fossils, Gondwana
Taichung City	Cities in Taiwan
Majuro	Marshall Islands, Capital cities in Oceania
South Tarawa	Capital cities in Oceania, Settlements in Kiribati
Bairiki	Villages, Settlements in Kiribati
Audio engineer	Entertainment occupations, Music industry, Engineering
Phil Spector	1939 births, 2021 deaths, American murderers, American pianists, American pop musicians, American prisoners, American record producers, American rock guitarists, American songwriters, Criminals from New York City, Deaths from the COVID-19 pandemic in the United States, Grammy Award winners, Infectious disease deaths in California, Musicians from the Bronx
Fugue	Musical forms
Jermain Defoe	1982 births, Living people, Black British sportspeople, English footballers, Sportspeople from London, Tottenham Hotspur F.C. players, Premier League players
Province of Ascoli Piceno	Provinces of Marche
Ascoli Piceno	Towns in Italy, Settlements in Marche, Capital cities in Italy
Franz Beckenbauer	1945 births, Living people, 1966 FIFA World Cup players, 1970 FIFA World Cup players, 1974 FIFA World Cup players, German football managers, German footballers, Order of Merit of the Federal Republic of Germany, Sportspeople from Munich
Groundhog	Squirrels, Mammals of North America, Rodents
Squirrel	Squirrels
Gestation	Biological reproduction
Shrew	Eulipotyphla
Ground squirrel	Squirrels
Human Be-In	1967 in California, Popular culture, 20th century in San Francisco
Suva	Capital cities in Oceania, Fiji
Honiara	Capital cities in Oceania, Solomon Islands
Port Vila	Capital cities in Oceania, Vanuatu
Tainan	Cities in Taiwan
Chiayi City	Cities in Taiwan
Example	Basic English 850 words
Hsinchu	Cities in Taiwan
Kangaroo rat	Geomyoid rodents
Hibernation	Physiology
Pack rat	Rodents
Mohamed ElBaradei	1942 births, Living people, Diplomats, Egyptian Muslims, Vice-Presidents of Egypt, New York University alumni, People from Cairo, Egyptian Nobel Prize winners
Bandicoot	Marsupials of Australia
Lesser bandicoot rat	Old World rats and mice
Roquefort cheese	French cheeses
Serial ATA	Storage devices, Computer buses
Legnica	Cities in Poland
Cruzeiro Esporte Clube	Brazilian football clubs, Belo Horizonte, 1921 establishments in Brazil
Flag of Estonia	Estonia, National flags
Coat of arms of Estonia	Estonia, National coats of arms
Ichthyology	Branches of zoology, Fish
Indre, Loire-Atlantique	Cities in France, Communes in Loire-Atlantique
Apatosaurus	Diplodocids
Hanseatic League	Hanseatic League, 1358 establishments, 1350s establishments in Europe
Steve McClaren	1961 births, Living people, English footballers, English football managers, England national football team managers, People from York, Eredivisie managers
Condom, Gers	Subprefectures in France, Communes in Gers
Now You See It...	2005 movies, Disney movies
Trojan horse (computing)	Malware
Cognac	Alcoholic spirits
Den Helder	Port cities and towns of the North Sea, Cities in the Netherlands, Settlements in North Holland, Municipalities of North Holland
Art of Life	1993 albums
Barbecue	Cooking methods, American food
Cow Belles	Disney movies, 2006 movies, Television movies, English-language movies
Legacy	History, Law
Lulu (singer)	1948 births, Living people, Actors from Glasgow, Musicians from Glasgow, Scottish movie actors, Scottish pop singers, Scottish television actors, Strictly Come Dancing participants, Eurovision Song Contest winners
Catanzaro	Regional capitals in Italy, Cities in Calabria
Vibo Valentia	Cities in Calabria, Capital cities in Italy
Reggio Calabria	Cities in Calabria
Crotone	Cities in Calabria, Capital cities in Italy
Cosenza	Cities in Calabria, Capital cities in Italy
Common Era	Time
Sheet music	Music
Radian	Angles
Taoyuan City	Counties of Taiwan
Tainan County	Counties of Taiwan
Hsinchu County	Counties of Taiwan
Xindian City	Cities in Taiwan
Apia	Capital cities in Oceania, Samoa
Funafuti	Capital cities in Oceania, Tuvalu, Atolls
Cantonese language	Sino-Tibetan languages, Linguistics, Languages of China
Skirt	Basic English 850 words, Clothing
Kaohsiung County	Cities in Taiwan
Red blood cell	Blood cells, Physiology
Chișinău	National capitals in Europe, Cities in Moldova, 1436 establishments, 1430s establishments in Europe
Jöns Jakob Berzelius	1779 births, 1848 deaths, Swedish scientists, Chemists
Antibody	Cell biology, Immunology
Anura	Frogs
Noel Edmonds	1948 births, Living people, British game show hosts, British radio personalities, English television presenters, People from Ilford, Television personalities from Essex
Quizmania	2005 British television series debuts, 2000s British television series, ITV game shows
Davina McCall	Actors from London, Channel 4 presenters, English television actors, English television presenters, ITV presenters, Television personalities from London, 1967 births, Living people
Artiodactyl	Even-toed ungulates
Odd-toed ungulate	Odd-toed ungulates
Condor	Vultures, Ciconiiformes
Carrion	Animals, Death
Chongqing	Cities in China, 4th-century BC establishments
Bologna	6th-century BC establishments, Bologna, Regional capitals in Italy
Oviedo	Capital cities in Spain, Oviedo
1088	1088
Pieve Ligure	Towns in Italy, Settlements in Liguria
Gamal Abdel Nasser	1918 births, 1970 deaths, Colonels, Deaths from myocardial infarction, Disease-related deaths in Egypt, Egyptian military people, Egyptian Muslims, People from Alexandria, Presidents of Egypt
Stork	Ciconiiformes
Wharf	Water transport
Public house	Places where alcohol is served, Restaurants
Squaring the circle	Geometry
Tampa Bay Lightning	Tampa Bay Lightning, 1991 establishments in the United States, 1990s establishments in Florida
Syd Barrett	Cancer deaths in England, Deaths from pancreatic cancer, English guitarists, English rock musicians, English singer-songwriters, Musicians from Cambridge, Pink Floyd, 1946 births, 2006 deaths
Tapir	Odd-toed ungulates
Bovid	Bovids
Cromwell current	Oceanography
Subduction	Earthquakes, Plate tectonics
Icebreaker	Ship types
Tattoo	Dermatology, Body art
Constructed language	Constructed languages, Language-related lists
Joel Engel	1936 births, Living people, Scientists from New York, People from New York City
Engineered languages	Constructed languages
Pronghorn	Even-toed ungulates
Graphical user interfaces and consoles	Technology
Water deer	Deer
Orchestration	Music
Blockbusters	Television game shows, NBC network shows, English-language television programs
Theria	Mammals
Ameridelphia	Marsupials of South America
Luiz Inácio Lula da Silva	1945 births, Living people, Presidents of Brazil, Honorary Knights Grand Cross of the Order of the Bath
Paraná (state)	Paraná State, States of Brazil
Dual Alliance	History of Germany, Austria-Hungary
RCTV	Television networks, Caracas, 1953 establishments in South America, 20th-century establishments in Venezuela
AIDS	Syndromes, Sexually transmitted diseases, Diseases caused by viruses, HIV/AIDS
Gibibyte	Computing measurement
Return to Castle Wolfenstein	2001 video games, Activision video games, Shooter video games, PlayStation 2 games, Windows games, Xbox games, Online games
Ssirum	Wrestling, Sports in Korea
Queensland	Queensland, 1859 establishments in Australia
Babes in Toyland (1961 movie)	1961 movies, 1960s musical movies, 1960s fantasy movies, Disney movies, American family movies, American musical movies, American fantasy movies, English-language movies
Airship	Airships, Gases, Aerospace engineering
New Amsterdam	History of Manhattan
Universal suffrage	Voting, Democratic rights
Bruce Dickinson	1958 births, Living people, British aviators, English rock singers, Iron Maiden, Musicians from Nottinghamshire
Streaming Soundtracks	Radio stations, Entertainment websites
Étude	Musical forms
Nocturne	Musical terminology
Delta Air Lines	1924 establishments in the United States, Airlines of the United States, Companies based in Atlanta, Georgia, 1920s establishments in Georgia (U.S. state)
Vytorin	Drugs
Blade Runner	1982 science fiction movies, American science fiction movies, Hong Kong movies, English-language movies, Film noir, Movies based on books, Movies directed by Ridley Scott, Movies set in Los Angeles, California, Movies set in the future, United States National Film Registry movies, Warner Bros. movies, Dystopian movies
Ridley Scott	1937 births, Living people, BAFTA Award winners, Emmy Award winners, English movie directors, English movie producers, Golden Globe Award winners, People from Tyne and Wear
Motörhead	1975 establishments in the United Kingdom, 1970s establishments in England, 2015 disestablishments in the United Kingdom, 1970s British music groups, 1980s British music groups, 1990s British music groups, 2000s British music groups, 2010s British music groups, English hard rock bands, English heavy metal bands, Musical groups established in 1975, Musical groups disestablished in 2015, Speed metal bands, Thrash metal bands, 21st century disestablishments in England
Celebrity	Celebrities
Epinephrine	Hormones
February Revolution	Russian Revolution, 1917 in Russia
Flag of Russia	Russia, National flags
Neckar	Geography of Baden-Württemberg, Rivers of Germany
Anaphylaxis	Medical emergencies, Health problems
Radolfzell	Towns in Baden-Württemberg, Konstanz (district)
Nenzingen	Towns in Baden-Württemberg, Konstanz (district)
Hypertension	Diseases and disorders of the cardiovascular system
Live Aid	1985 in music, Charity events, 20th century in Philadelphia, 1985 in the United States, 1985 in the United Kingdom, 1980s in London
Flag of the Soviet Union	Soviet Union, National flags
Coat of arms of the Soviet Union	Soviet Union, National coats of arms, 1923 establishments in the Soviet Union, 1991 disestablishments in the Soviet Union
Giancarlo Fisichella	Formula One drivers
Karate	Karate
Kickboxing	Kickboxing
Robert Kubica	1984 births, Living people, People from Kraków, Polish sportspeople, Formula One drivers, Formula One current
Grady Sizemore	1982 births, Living people, American baseball players, Sportspeople from Seattle, Washington, Tempe, Arizona, Boston Red Sox players, Cleveland Indians players, Philadelphia Phillies players, Tampa Bay Rays players
Joachim Sauer	1949 births, Living people, East German people, German academics, German chemists, People from Brandenburg
Everett, Washington	County seats in Washington, Everett, Washington
Tempe, Arizona	Tempe, Arizona
Hoyerswerda	Bautzen Rural District, Cities in Saxony
Hamburger SV	German Bundesliga, German football clubs, Sport in Hamburg, 1887 establishments in Europe, 1880s establishments in Germany
Borussia Dortmund	German Bundesliga, German football clubs, Dortmund, Sport in North Rhine-Westphalia, 1909 establishments in Europe, 1900s establishments in Germany
Palace of Soviets	Soviet Union, Palaces in Russia
Battle of the Somme	1916 in France, Battles involving Australia, Battles involving Canada, Battles involving France, Battles involving Germany, Battles involving India, Battles involving New Zealand, Battles involving South Africa, Battles involving the United Kingdom, Battles of the Western Front (World War I), Hauts-de-France
Ravicherla	Villages in Andhra Pradesh
San Marino, California	San Marino, California
Ballade	Musical forms, Poetry forms
Ballade (musical form)	Musical forms
Signal Iduna Park	Buildings and structures in North Rhine-Westphalia, Dortmund, Football stadiums in Germany, Sport in North Rhine-Westphalia
Allianz Arena	Buildings and structures in Munich, Football stadiums in Germany, Sport in Bavaria
Imtech Arena	Buildings and structures in Hamburg, Football stadiums in Germany, Sport in Hamburg
Veltins Arena	Buildings and structures in North Rhine-Westphalia, Football stadiums in Germany, Gelsenkirchen, Sport in North Rhine-Westphalia
FC Schalke 04	Gelsenkirchen, German Bundesliga, German football clubs, Sport in North Rhine-Westphalia, 1904 establishments in Europe, 1900s establishments in Germany
Michael Ballack	1976 births, Living people, German footballers, Sportspeople from Saxony
Coat of arms of Germany	Coats of arms of Germany, National coats of arms
Plauen	Vogtlandkreis Rural District
Braunau am Inn	Cities and towns in Upper Austria
Berlin Hauptbahnhof	2006 establishments in Europe, 2000s establishments in Germany, Buildings and structures in Berlin, Railway stations in Germany
Mazurka	Ballroom dances, Musical forms
Weserstadion	Bremen (city), Football stadiums in Germany, Sport in Bremen (state)
Belt	Accessories
Zugspitze	Alps, Geography of Bavaria, Mountains of Austria, Mountains of Germany, Tyrol (state)
British Airways	1974 establishments in the United Kingdom, Airlines of the United Kingdom
Group of Eight	G8, 1975 establishments
Helmut Kohl	1930 births, 2017 deaths, Chancellors of Germany, Former members of the German Bundestag, Ministers-President of Germany, Order of Merit of the Federal Republic of Germany, People from Ludwigshafen, Politicians from Rhineland-Palatinate, Politicians of the Christian Democratic Union of Germany
Organ (anatomy)	Organs
Students for a Democratic Society	1960s in the United States, American culture, 1960 establishments in the United States, Youth organizations, Political movements, Political organizations based in the United States
Postulate	Science, Mathematics
Influence	Social sciences, VOA Special English words
Existence	Basic English 850 words, Philosophical concepts
Lidl	1930 establishments in Europe, 1930s establishments in Germany, Neckarsulm, Supermarkets of Germany
Asian Games	Asian Games, Multi-sport events
Newton Mearns	Towns in Scotland
NBA Finals	National Basketball Association
The Open Championship	Golf tournaments, Sport in the United Kingdom, 1860 establishments in the United Kingdom
Viennese waltz	Ballroom dances, Waltzes
Musk deer	Even-toed ungulates
Himalayan musk deer	Deer, Mammals of Asia
FIBA Basketball World Cup	Basketball
Cooking oil	Cooking oils
Hulk (Marvel Comics)	Characters created by Stan Lee, Dissociative identity disorder in fiction, Fictional characters introduced in the 1960s, Hulk (Marvel Comics), Marvel Comics adapted into movies, Marvel Comics mutates, Marvel Comics superheroes, Marvel vs. Capcom fighters, Fictional American people
Pelican	Pelecaniformes
Sharpie	Writing tools
Francis Ford Coppola	1939 births, Living people, Academy Award winning directors, American television directors, American television producers, American television writers, BAFTA Award winners, Movie directors from Michigan, Movie producers from Michigan, Movie directors from New York City, Movie producers from New York City, Screenwriters from Michigan, Screenwriters from New York City, Writers from Detroit, Michigan, Writers from Queens
Abdul Aziz Al Ghurair	Business people, 1954 births, Living people, Emirati people
Billericay	Towns in Essex
East of England	East of England, 1994 establishments in England
Regions of England	Regions of England, Lists about England
Prelude	Musical forms
Polonaise	Musical forms, Ballroom dances
Malcolm Arnold	1921 births, 2006 deaths, 20th century composers, English composers, People from Northampton, Trumpeters
Bowser (character)	Fictional characters introduced in 1985, Animated television characters, Mario series characters, Fictional dragons, Video game antagonists, Video game bosses
Lars Ulrich	1963 births, Living people, Danish musicians, Metallica, Rock drummers
Kim Possible	Animated television series, Television series by Disney, Television series by Buena Vista Television, English-language television programs, 2002 television series debuts, 2007 television series endings
Windows Live Messenger	Microsoft, Instant messaging software, 1999 establishments, 2013 disestablishments
Great Dane	Dog breeds
Linkin Park	1996 establishments in California, 1990s American music groups, 2000s American music groups, 2010s American music groups, American heavy metal bands, Linkin Park, Musical groups established in 1996, Musical groups from California, Nu metal bands, Warner Bros. Records artists
0s BC	0s BC
168 BC	168 BC
Bissau	Capital cities in Africa, Regions of Guinea-Bissau
1130s	1130s
1120s	1120s
1699	1699
Bamberg	Upper Franconia, Bamberg
Diving	Diving, Summer Olympic sports
Pulsar	Variable stars, Astrophysics
Julius Caesar (play)	Plays by William Shakespeare
Twisted Sister	1970s American music groups, 1980s American music groups, 1990s American music groups, 2000s American music groups, 2010s American music groups, American hard rock bands, American heavy metal bands, Musical groups from New York City
1630	1630
Paul Biya	1933 births, Living people, Presidents of Cameroon, Prime Ministers of Cameroon, Current national leaders, Alumni of the Institut d'études politiques de Paris
International Olympic Committee	Olympic Games, Lausanne, 1894 establishments
Confederation of African Football	Football organizations, 1957 establishments in Africa
Oceania Football Confederation	Football organizations, 1966 establishments in Oceania
Ludwigsburg Rural District	Districts of Baden-Württemberg
1260s	1260s
Dessau	Urban districts of Saxony-Anhalt
Weissenfels	Burgenlandkreis Rural District
Constitution of the United States	United States Constitution
Space-time	Relativity, Basic physics ideas
Scottish Socialist Party	Political parties in Scotland, 1998 establishments in the United Kingdom, 1990s establishments in Scotland
Esztergom	Cities in Hungary, 10th century establishments in Europe, Establishments in Hungary
Public transport	Public transport
Edmund Barton	1849 births, 1920 deaths, Australian judges, Australian lawyers, Australian ministers for Foreign Affairs, Cardiovascular disease deaths in Australia, Deaths from heart failure, Disease-related deaths in New South Wales, Legislative speakers, Members of the Australian House of Representatives, Politicians from Sydney, Prime Ministers of Australia, Protectionist Party politicians
Crofton, British Columbia	Towns in Canada, Settlements in British Columbia
Zabno	Towns in Poland
Western Australia	Western Australia, Geography of Australia by state or territory
South Australia	South Australia
Richard Roeper	1959 births, Living people, American journalists, American historians, Movie critics from Chicago, Writers from Chicago
Alfred Deakin	1856 births, 1919 deaths, Deaths from Alzheimer's disease, Prime Ministers of Australia, Politicians from Melbourne, Attorneys General of Australia, Leaders of the Opposition (Australia), Commonwealth Liberal Party politicians, Protectionist Party politicians, Australian ministers for Foreign Affairs, Members of the Australian House of Representatives
Chris Watson	Prime Ministers of Australia, 1867 births, 1941 deaths, Australian Labor Party politicians, Leaders of the Opposition (Australia), Politicians from Sydney, Members of the Australian House of Representatives, People from Valparaíso
Archie Comics	Comic companies, Comic books
Zak Starkey	1965 births, Living people, English drummers, English rock musicians, Musicians from London, Ringo Starr
Heroin	Illegal drugs
Pittsburgh	Pittsburgh, Pennsylvania, County seats in Pennsylvania, 1758 establishments, 1750s establishments in the Thirteen Colonies
Nasal bone	Bones of the skull
Kapellmeister	Musicians, Occupations
Kingdom of England	History of England, Wales
Romansh language	Romance languages, Swiss culture, Graubünden, Languages of Europe
Protractor	Protractors, Geometry, Measuring tools
Rabbi	Rabbis
Gentile	Judaism
Super Mario Galaxy	2007 video games, Mario platform games, 3D platform games, Wii games, Wii-only games
Five and dime	Companies
The Legend of Zelda (series)	The Legend of Zelda
3rd century	3rd century
2nd century	2nd century
Walmart	American department stores, Companies based in Arkansas, 1962 establishments in the United States, 20th-century establishments in Arkansas
Sam Walton	1918 births, 1992 deaths, American billionaires, Businesspeople from Arkansas, Cancer deaths in the United States, Deaths from multiple myeloma, Disease-related deaths in Arkansas, Businesspeople from Oklahoma
New York Stock Exchange	Stock exchanges, Companies listed on the New York Stock Exchange, Buildings and structures in Manhattan, New York City Designated Landmarks, Economy of the United States
Stock exchange	Stock exchanges
Bombay Stock Exchange	Stock exchanges, Economy of India, 1875 establishments in Asia, 1870s establishments in India
Stamford Raffles	1781 births, 1826 deaths, Singapore, British people
Euronext	Stock exchanges, 2000 establishments in Europe
Hippopotamidae	Even-toed ungulates
Hiroshi Yamauchi	Billionaires, Deaths from pneumonia, Japanese businesspeople, 1927 births, 2013 deaths, People from Kyoto Prefecture, Nintendo people
ExxonMobil	Companies of the United States, 1999 establishments in the United States
Paul Allen	1953 births, 2018 deaths, Deaths from sepsis, Deaths from non-Hodgkin lymphoma, Microsoft people, Businesspeople from Seattle, Washington, Writers from Seattle, Washington
Hero	Mythology
Sonic Rivals	2006 video games, PlayStation Portable-only games, Sonic the Hedgehog games
Sega Genesis	Sega video game consoles
Dreamcast	Sega video game consoles, Sixth generation consoles
Platte River	Rivers of Nebraska, Oregon Trail
Counting	Mathematics
Launch pad	Spaceflight, Transport buildings and structures
Space Shuttle	Space Shuttles
Thor	Norse gods and goddesses
Blood cell	Cell biology
Windsurfing	Surfing, Wind energy
Thoroughbred	Horse breeds
Sound card	Computer hardware
Charlie Chaplin	Academy Award winning actors, Academy Award winning directors, Actors from London, British silent movie actors, Cardiovascular disease deaths in Switzerland, Deaths from stroke, English movie actors, Movie directors from London, Knights Commander of the Order of the British Empire, Movie producers from London, Screenwriters from London, 1889 births, 1977 deaths
American Stock Exchange	Buildings and structures in Manhattan, New York City Designated Landmarks, Stock exchanges
Field hockey	Field hockey, National symbols of Pakistan, National symbols of India
Sudoku	Puzzles
Beatrix of the Netherlands	1938 births, Living people, Kings and Queens of the Netherlands, Order of Prince Henry, Knights Grand Cross of the Royal Victorian Order, Order of Merit of the Federal Republic of Germany
Qatar Airways	Airlines of the Middle East, Qatar
George Reid	1845 births, 1918 deaths, Prime Ministers of Australia, Premiers of New South Wales, Leaders of the Opposition (Australia), Government ministers of Australia, Politicians from Sydney, Members of the Australian House of Representatives
Spider Riders	2006 American television series debuts, 2007 American television series endings
Boudica	History of the British Isles, Kings and queens, People from Norfolk, 20s births, 60s deaths, Rebellions in Europe
Choir (music)	Choirs, Vocal music
Motherboard	Computer hardware
High-definition television	Television technology
Napoleon Dynamite	2004 movies, 2000s coming-of-age movies, 2000s teen comedy movies, American coming-of-age movies, American teen comedy movies, Cult movies, English-language movies, Idaho, American independent movies
Charlize Theron	Academy Award winning actors, Animal rights activists, Golden Globe Award winning actors, LGBT rights activists, American movie actors, American movie producers, Naturalized citizens of the United States, Screen Actors Guild Award winners, South African actors, American television actors, American voice actors, White South African people, 1975 births, Living people, South African models
Running	Running
Monster (movie)	2003 crime movies, 2003 drama movies, 2000s biographical movies, 2000s crime drama movies, 2000s LGBT movies, Academy Award winning movies, American biographical movies, American crime drama movies, American LGBT movies, American serial killer movies, Antisocial personality disorder in fiction, Borderline personality disorder in fiction, English-language movies, Female buddy movies, LGBT crime movies, LGBT drama movies, Movies set in Florida, Movies set in the 1980s, Movies set in the 1990s, NC-17 rated movies, American independent movies, Movies directed by Patty Jenkins
Guard dog	Working dogs
Andrew Fisher	Prime Ministers of Australia, 1862 births, 1928 deaths, Australian Labor Party politicians, Leaders of the Opposition (Australia), Treasurers of Australia, Politicians from Queensland, Members of the Australian House of Representatives
David Schwimmer	1966 births, Living people, Actors from New York City, American movie actors, American television actors, American voice actors, Jewish American actors
Sahrawi Arab Democratic Republic	Unrecognized countries, Dependent territories, Western Sahara
Plutonium	Actinides, Chemical elements, Nuclear physics
Superman Returns (video game)	2006 video games, PlayStation 2 games, Xbox games, Xbox 360 games, Nintendo DS games, Game Boy Advance games, Electronic Arts video games, Video games based on DC Comics, Video games based on movies
Al Jazeera	Television networks, Qatar
Boron	Semimetals
Fireplace	Fire, Home appliances
Dubnium	Chemical elements
Upland, California	Cities in California, Settlements in San Bernardino County, California
Neuchâtel	Capital cities in Switzerland, Municipalities of Neuchâtel
70s	70s
Sonic the Hedgehog	Sonic the Hedgehog games
The Silence of the Lambs	1991 crime movies, 1991 thriller movies, 1990s crime thriller movies, 1991 horror movies, 1990s serial killer movies, American crime thriller movies, American horror thriller movies, American serial killer movies, Antisocial personality disorder in fiction, BAFTA Award winning movies, Best Picture Oscar, English-language movies, FBI in fiction, Golden Globe Award winning movies, Hannibal Lecter movies, Movies about abduction, Movies based on books, Movies directed by Jonathan Demme, United States National Film Registry movies
Ammerland	Districts of Lower Saxony
Aurich (district)	Districts of Lower Saxony
Celle (district)	Districts of Lower Saxony
Cloppenburg (district)	Districts of Lower Saxony
Cuxhaven (district)	Districts of Lower Saxony
Diepholz (district)	Districts of Lower Saxony
Emsland	Districts of Lower Saxony
Friesland (district)	Districts of Lower Saxony
Gifhorn (district)	Districts of Lower Saxony
Göttingen (district)	Districts of Lower Saxony
Goslar (district)	Districts of Lower Saxony
Helmstedt (district)	Districts of Lower Saxony
George Cleveland	Canadian television actors, 1885 births, 1957 deaths
Legion of Net. Heroes	Fiction
Othello	Plays by William Shakespeare
Commonwealth Games	Commonwealth Games, 1930 establishments, Multi-sport events
Doncaster	Towns in South Yorkshire
Aly & AJ	2004 establishments in California, 2000s American music groups, 2010s American music groups, American girl groups, American pop music groups, Musical duos, Musical groups from Los Angeles, California, Torrance, California
Middlesbrough	Towns in North Yorkshire, Port cities and towns of the North Sea, Port cities and towns of England
Argentine National Anthem	Argentina, National anthems
Columbia Broadcasting System	1928 establishments in the United States, 1974 disestablishments in the United States
Emily Dickinson	1830 births, 1886 deaths, 19th-century American poets, Deaths from nephritis, Disease-related deaths in the United States, Writers from Massachusetts
Indianapolis 500	Formula One, IndyCar Series
Mahout	Occupations
John Wesley	1703 births, 1791 deaths, Academics of the University of Oxford, Alumni of the University of Oxford, Anglican priests, Bible translators, British abolitionists, Christian hymnwriters, Christian theologians, English activists, English Anglicans, English priests, English theologians, Evangelicals, Evangelists, Methodists, Missionaries, Writers from Lincolnshire
Joseph Cook	1860 births, 1947 deaths, Prime Ministers of Australia, People from Staffordshire, Leaders of the Opposition (Australia), Commonwealth Liberal Party politicians, Treasurers of Australia, Politicians from Sydney
Antihero	Fictional characters
Hestia	Twelve Olympians
Alison Balsom	Trumpeters, English musicians, 1978 births, Living people
Continuity	Entertainment
Håkan Hardenberger	Trumpeters, Swedish musicians, 1961 births, Living people, People from Malmo
Skink	Lizards
Geronimo Stilton (character)	Characters in written fiction
Dionysus	Twelve Olympians
Motor neurone disease	Diseases
Fields Medal	Mathematics, Science awards
Laugh	Human communication
Hi-5	Australian television, Australian musical groups, Children's musical groups, Children's television series, 1999 television series debuts, 1999 establishments in Australia, English-language television programs
Beaver	Rodents, Mammals of North America
Bladder	Anatomy of the urinary system
Time travel	Fiction, Physics
Dock	Transport buildings and structures, Water transport
They Might Be Giants	1982 establishments in the United States, American rock bands, Grammy Award winners, Musical groups from New York City, Musical groups established in 1982
Solomon	Kings of ancient Judah, Kings of ancient Israel, Old Testament people
Proverb	Cultural anthropology, Literature, Oral tradition
Santiago, Chile	Santiago de Chile, 1541 establishments, 1540s establishments in South America, 16th-century establishments in Chile
Psalms	Old Testament books
Television program	Television programs
Fatwa	Islamic law
Reggie Fils-Aimé	1961 births, Living people, Businesspeople from New York City, Nintendo people
Billy Hughes	1862 births, 1952 deaths, Prime Ministers of Australia, Politicians from London, Australian Labor Party politicians, Liberal Party of Australia politicians, Nationalist Party of Australia politicians, United Australia Party politicians, Australian ministers for Foreign Affairs, Attorneys General of Australia, Politicians from Sydney
Maid Marian	Robin Hood, Fictional characters
Graphite	Carbon
Allotropy	Chemistry, Physical chemistry
Covalent bond	Chemical bonding
Ionic bond	Chemical bonding
Chloride	Chlorine compounds
Bauhaus	Architecture, Art movements, Design, Schools in Germany, World Heritage Sites in Germany
Intelligence	Intelligence, Basic English 850 words
Nuevo León	Nuevo León, States of Mexico
Saale	Geography of Bavaria, Geography of Saxony-Anhalt, Geography of Thuringia, Rivers of Germany
Go Fish	Card games
Chicago White Sox	Chicago White Sox, 1901 establishments in the United States, 1900s establishments in Illinois
Pollination	Plants, Biological reproduction, Coevolution, Bees
Gull	Charadriiformes, Seabirds
The Warriors (movie)	1979 drama movies, 1970s action movies, American action movies, American drama movies, Cult movies, Movies set in New York City, English-language movies, Movies directed by Walter Hill
Coney Island	Islands of New York, Brooklyn, Neighborhoods of New York City
Ferris wheel	Ferris wheels
Four-horned antelope	Bovines, Mammals of Asia
New Orleans Privateers	Sports in New Orleans, Louisiana, Colleges and universities in Louisiana
Stanley Bruce	1883 births, 1967 deaths, Prime Ministers of Australia, Politicians from Melbourne, Nationalist Party of Australia politicians, United Australia Party politicians, Treasurers of Australia, Australian ministers for Foreign Affairs, Australian military people
James Scullin	1876 births, 1953 deaths, Prime Ministers of Australia, Politicians from Victoria (Australia), Australian Labor Party politicians, Leaders of the Opposition (Australia), Treasurers of Australia, People from Ballarat
World music	World music
Caprinae	Caprids
Domestic goat	Caprids, Domesticated animals
Domestic sheep	Caprids, Domesticated animals
Capra (genus)	Caprids
Richard Sharpe	Characters in written fiction
Protest	Basic English 850 words, Social sciences
Roskilde	Cities in Denmark
Hong Kong Stock Exchange	Stock exchanges, Hong Kong
Aarhus	Aarhus, 770 establishments, Establishments in Denmark
Odense	Odense, 988 establishments, 10th century establishments in Europe, Establishments in Denmark
Aalborg	Cities in Denmark, 700s establishments
Esbjerg	Cities in Denmark, Port cities and towns of the North Sea
Dirham	Currency of Africa, Currency of Asia, Currency of Europe
Desperate Housewives	2004 American television series debuts, 2012 American television series endings, 2000s American television series, 2010s American television series, American comedy-drama television series, American soap operas, English-language television programs
Ballroom dance	Ballroom dances
Wormhole	Relativity
Free kick	Football (soccer) terminology
Corner kick	Football (soccer) terminology
Referee	Sports occupations, Referees
Cataract	Diseases and disorders of the eye
Goal kick	Football (soccer) terminology
The Wiggles	2000s Australian television series, Disney Channel shows, Musical groups established in 1991, Children's television series, Children's musical groups, Musical groups from Sydney, English-language television programs
Throw-in	Football (soccer) terminology
Patch	Clothing
Savanna	Habitats, Grasslands
Peasant	People by wealth or status
Mary, Crown Princess of Denmark	1972 births, Living people, Danish royalty, People from Hobart, Princes and princesses
Racquet	Sports equipment, Racquet sports
Secondary school	Types of educational institutions
Cushion	Basic English 850 words, Furniture, Home
Choice	Social sciences, Causality
Lutheranism	Protestantism in Germany, Lutheranism, Martin Luther, Protestant Reformation
Ivy League	Ivy League, Colleges and universities in the United States
Joseph Lyons	1879 births, 1939 deaths, Prime Ministers of Australia, Premiers of Tasmania, Politicians from Tasmania, Australian Labor Party politicians, Leaders of the Opposition (Australia), United Australia Party politicians, Treasurers of Australia
Plow	Basic English 850 words, Agricultural machinery, Farming tools
Maglev train	High-speed trains
Lace	Cloth, Textile arts
Career	Occupations
Madeline	Series of books, Children's books, 1939 books
Professional	Occupations
Apartment	Accommodations
Blouse	Tops (clothing)
Pocket	Basic English 850 words
Dress shirt	Tops (clothing)
Gilmore Girls	2000 American television series debuts, 2007 American television series endings, 2000s American television series, American drama television series, American teen drama television series, Connecticut, Television series about families, Television series set in Connecticut, WB network shows, English-language television programs, The WB original programming
Nasal cavity	Head (body part), Anatomy of the respiratory system
Daniel Radcliffe	British atheists, British child actors, English movie actors, English stage actors, English television actors, English voice actors, Actors from London, 1989 births, Living people
Juice	Drinks
Subtropical cyclone	Subtropical cyclones
Morning	Basic English 850 words, Parts of a day
Disinfectant	Healthy lifestyle
Floor	Basic English 850 words
Okinawa	Islands of Japan, Ryukyu Islands, Okinawa Prefecture
Only Fools and Horses	1981 British television series debuts, 2003 British television series endings, 1980s British sitcoms, 1990s British sitcoms, 2000s British sitcoms, BBC television sitcoms, Television series about brothers, Television series about dysfunctional families, Television series set in London, English-language television programs
Ateneo de Manila University	Colleges and universities in the Philippines
Jerry Seinfeld	1954 births, Living people, Actors from New York City, American comedians, American television actors, American voice actors, Comedians from New York City, Jewish American actors, Jewish American comedians, Seinfeld
Subtropical Storm Nicole (2004)	Subtropical cyclones, Hurricanes in Bermuda, 2004 Atlantic hurricane season, 2004 in Canada, 2000s in Bermuda, 2004 in the United States
Cyanide	Chemical compounds, Poisons
Kindergarten	Education
2006 Atlantic hurricane season	2006 Atlantic hurricane season
Crash Bandicoot (character)	Video game protagonists, Crash Bandicoot games, Fictional animals, Fictional characters introduced in 1996
Elbląg	Cities in Poland
500 Series Shinkansen	High-speed trains, Shinkansen
Balaton	Lakes of Europe, Geography of Hungary
Ceres (dwarf planet)	Dwarf planets
Aquarium	Aquariums
Earle Page	Prime Ministers of Australia, Politicians from New South Wales, 1880 births, 1961 deaths, Monarchists, National Party of Australia politicians, Treasurers of Australia
Ronin	Japanese culture
İsmet Özel	1944 births, Living people, Turkish poets
Acarology	Branches of zoology
Fredrik Reinfeldt	1965 births, Living people, European Union politicians, Prime Ministers of Sweden
Coat of arms of Russia	Russia, National coats of arms
Brother Bear	2003 movies, 2003 animated movies, Disney animated movies, English-language movies, American family movies, American musical movies, Movies about bears, Movies about brothers, Movies set in prehistory
Logical volume management	Computer science
Metallica (album)	Metallica albums, 1991 albums, Grammy Award-winning albums
Rainbow trout	Teleosts, Edible fish
Fat-tailed gerbil	Rodents
Goku	Dragon Ball characters, Fictional characters introduced in 1984
Dragon Ball	Dragon Ball, Anime, Mass media franchises introduced in 1984
Flowers for Algernon	1960 books, Fiction books, 20th century American novels, Science fiction
Soapstone	Metamorphic rocks
Treaty of Tordesillas	15th century in Spain, History of South America, Treaties, 1494, History of Portugal
Mr. Magoo	Animated characters
Jam	Spreads
Old	Basic English 850 words
Penalty kick	Football (soccer) terminology
Vanilla	Spices, Orchids
Glatzer Neisse	Rivers of Poland
Oder River	Geography of Brandenburg, Geography of Mecklenburg-Vorpommern, Rivers of the Czech Republic, Rivers of Germany, Rivers of Poland
Robert Schumann	German composers, Romantic composers, Music critics, 1810 births, 1856 deaths
Lecture	Learning
Moselle (department)	Departments in Grand Est
Clara Schumann	German composers, Romantic composers, Women composers, German pianists, 1819 births, 1896 deaths
Four Noble Truths	Buddhist terminology
Theory of relativity	Theory of relativity, Relativity, Albert Einstein
BIOS	Software
Anna Politkovskaya	1958 births, 2006 deaths, Activists, Russian journalists, Murders by firearm in Russia, Russian murder victims, Russian writers, Unsolved murders, Writers from New York City
Bengali language	Dravidian languages, Languages of Bangladesh, Languages of India
Peso	Currency
Robert Menzies	1894 births, 1978 deaths, Deaths from myocardial infarction, Prime Ministers of Australia, Politicians from Victoria (Australia), Attorneys General of Australia, Monarchists, Liberal Party of Australia politicians, Leaders of the Opposition (Australia), United Australia Party politicians, Treasurers of Australia
Pauline Fowler	EastEnders characters
Will Young	Actors from Berkshire, English LGBT people, English movie actors, English pop musicians, English singers, English television actors, Gay men, LGBT actors, LGBT singers, Musicians from Berkshire, 1979 births, Living people
Concentration	Analytical chemistry
IPod shuffle	IPod
Nightshade	Nightshades, Plant families, Solanaceae
Woodworking	Woodworking
Chessmaster	1986 video games, Amstrad CPC games, Apple II games, Commodore 64 games, DOS games, Game Boy games, Mobile games, Nintendo Entertainment System games, Nintendo DS games, PlayStation games, PlayStation 2 games, PlayStation Portable games, Super Nintendo Entertainment System games, Windows games, Xbox 360 Live Arcade games, Game Gear games, Ubisoft games
1094	1094
Francis of Assisi	1182 births, 1226 deaths, Christian saints, Franciscans, Italian Roman Catholics
1182	1182
Printing	Written communication, Typography, Printing, Book terminology
Adelaide Cup	Horse racing, Adelaide, 2001 establishments in Australia
David Lynch	1946 births, Living people, Actors from Montana, American movie actors, American movie directors, American movie producers, American screenwriters, American television actors, American television directors, American television producers, American television writers, People from Missoula, Montana
The Dark Side of the Moon	1973 albums, Pink Floyd albums, Concept albums, Progressive rock albums
Arthur Fadden	1895 births, 1973 deaths, Prime Ministers of Australia, Politicians from Queensland, Monarchists, Leaders of the Opposition (Australia), National Party of Australia politicians, Treasurers of Australia, Members of the Australian House of Representatives
John Curtin	1885 births, 1945 deaths, Prime Ministers of Australia, Politicians from Victoria (Australia), Australian Labor Party politicians, Leaders of the Opposition (Australia), Politicians from Western Australia, Members of the Australian House of Representatives
Australian Capital Territory	Australian Capital Territory
Governor-General of Australia	Australian Governors-General, Lists of heads of state, Australia-related lists
Michael Jeffery	1937 births, 2020 deaths, Australian Governors-General, Governors of Western Australia, Order of Australia, People from Western Australia, Australian military people, Viceroys in Australia
Nanny	Personal service occupations, Domestic work
Frank Forde	1890 births, 1983 deaths, Prime Ministers of Australia, Politicians from Queensland, Australian Labor Party politicians, Government ministers of Australia, Members of the Australian House of Representatives
Ben Chifley	Politicians from New South Wales, Prime Ministers of Australia, 1885 births, 1951 deaths, Deaths from myocardial infarction, Australian Labor Party politicians, Leaders of the Opposition (Australia), Treasurers of Australia, Members of the Australian House of Representatives
High Court of Australia	Government of Australia, National supreme courts, 1903 establishments in Australia
Harold Holt	Accidental deaths by drowning, Liberal Party of Australia politicians, Missing people, Politicians from Sydney, Politicians from Victoria (Australia), Prime Ministers of Australia, Treasurers of Australia, 1908 births, 1967 deaths, People declared dead in absentia
Biosphere	Ecology
Drum and bugle corps	Music, Military
Piccolo	Flutes
Double reed	Double reed instruments, Musical instrument construction
Alto flute	Flutes
Stevenage	Towns in Hertfordshire
Yu-Gi-Oh!	Anime, Yu-Gi-Oh!
Travelling salesman problem	Theoretical computer science, Combinatorial optimization
Creditor	Economics
Anno Domini	Time, Chronology
Haze	Weather

