920s	920s
940s	940s
910s	910s
Canopic jar	Death customs, Ancient Egypt, Containers
Fellow	Colleges and universities
Millipede	Millipedes
Edwy of England	941 births, 959 deaths, House of Wessex, People buried in Winchester Cathedral
Oda of Canterbury	950s deaths, Archbishops of Canterbury, Christian saints, English Roman Catholics, Roman Catholic archbishops
Magdalen College School, Oxford	Schools in England, 1480 establishments, 15th century establishments in England
Edward V of England	1470 births, 1483 deaths, House of York
Lincolnshire	Ceremonial counties of England, Lincolnshire
Norfolk	Norfolk, Ceremonial counties of England, 1974 establishments in England
ISO 3166-2	Political geography, ISO 3166
Leicestershire	Leicestershire, East Midlands, Ceremonial counties of England
Northamptonshire	Northamptonshire, Ceremonial counties of England
Earl	Earls and countesses
Lobster	Decapods, Seafood
Spiny lobster	Decapods
Bromeliad	Poales, Plant families
Eucalyptus	Eucalyptus, Trees of Australia
Cell theory	Cell biology
Silicone	Cosmetics, Thermoplastics
Oxfordshire	Ceremonial counties of England, Oxfordshire
Minnie Mouse	Fictional mice and rats, Mickey Mouse universe characters
Notostraca	Branchiopods, Living fossils
Porphyria	Diseases, Genetic disorders
Diatom	Protista, Algae
Decapitation	Crime, Capital punishment
Dmitri Mendeleev	1832 births, 1907 deaths, Russian chemists
Wakizashi	Japanese swords
Albert Camus	1913 births, 1960 deaths, 20th century philosophers, Accidental deaths in France, French atheists, French Nobel Prize winners, French novelists, French philosophers, French playwrights, Marxism, Road accident deaths
Angevin Empire	History of France, History of the British Isles, Empires, 13th century in Europe, 12th century in Europe
Spine	Bones
Pyrenees	Mountain ranges, Pyrenees, Mountains of France, Geography of Andorra, Geography of Spain, Aragon, Basque Country, Catalonia, Navarre, Nouvelle-Aquitaine, Occitanie
Sea of Galilee	Lakes of Asia, Geography of Israel
Dartmoor	Geography of England, Devon, National parks in the United Kingdom
Cirencester	Towns in Gloucestershire
Seppuku	Japanese culture
Sow bug	isopods
Lady beetle	Polyphaga
Lou Pearlman	1954 births, 2016 deaths, American fraudsters, Cardiovascular disease deaths in Texas, Criminals from New York City, Deaths from stroke, People from Queens, People who died in prison custody in the United States
Thirteen Colonies	History of the United States, American Revolutionary War, Former British colonies
Stillbirth	Pregnancy and childbirth
Arizona Cardinals	Arizona Cardinals, 1988 establishments in the United States, 20th-century establishments in Arizona
Totnes	Towns in Devon
Chiffon cake	Cakes
Three Character Classic	China
Art film	Movies
Palm OS	operating systems
Ural Mountains	Mountain ranges, Mountains of Russia
Ishmael	Old Testament people
Steppe	Plains
Plain	Plains
French fries	Fast food, Potatoes, Fried foods
Champagne (wine)	French wines
Caesarion	Pharaohs, 47 BC births, 30 BC deaths
Lorca	Towns in Spain, Municipalities in the Region of Murcia
Alexander Pushkin	Deaths by firearm, Russian writers, Russian poets, 1799 births, 1837 deaths
Exile	Politics, Punishments
Lager	Types of beer
Ryszard Kapuściński	Polish writers, Polish journalists, 1932 births, 2007 deaths
Republican National Committee	United States Republican Party
Democratic National Committee	United States Democratic Party
Four Corners	Geography of New Mexico, Geography of Colorado, Geography of Utah, Geography of Arizona
Southwestern United States	Western United States
Flagellum	Protista, Organelles
Walkman	Audio technology, Music technology
Semantics	Linguistics
Governance	Government
Snowball	Snow
MPEG-4	Computer file formats, Audio technology, Display technology
Warship (TV series)	Royal Navy, Naval transport, Ships, English-language television programs
Jerry Lewis	1926 births, 2017 deaths, Actors from New Jersey, American movie actors, American movie directors, American movie producers, American philanthropists, American screenwriters, American television actors, American television personalities, American television presenters, American voice actors, Deaths from cardiomyopathy, Cardiovascular disease deaths in the United States, Comedians from New Jersey, Humanitarians, Jewish American actors, Jewish American musicians, Jewish American writers, Jewish businesspeople, Jewish philanthropists, Republicans (United States), Singers from New Jersey, Writers from New Jersey, Businesspeople from Newark, New Jersey, Businesspeople from Las Vegas, Nevada, Actors from Las Vegas, Nevada, Writers from Las Vegas, Nevada, Singers from Las Vegas, Nevada
Breakdance	Dance, Hip hop
Constantine (movie)	2005 movies, 2000s fantasy movies, 2005 horror movies, 2000s superhero movies, American fantasy movies, American horror movies, American science fiction movies, Cancer in movies, English-language movies, Movies set in Los Angeles, California, Science fiction horror movies, DC Comics movies, Warner Bros. movies, Apocalyptic movies, American superhero movies
East Anglia	Regions of England, Petty kingdoms of England
Simone de Beauvoir	1908 births, 1986 deaths, 20th century philosophers, Abortion-rights activists, Bisexual people, Deaths from pneumonia, Disease-related deaths in Paris, Feminist writers, French atheists, French autobiographers, French feminists, French LGBT people, French novelists, French philosophers, Infectious disease deaths in France, LGBT feminists, LGBT novelists, LGBT writers, Writers from Paris
Katie Couric	American journalists, American television personalities, American movie actors, American voice actors, People from Arlington, Virginia, 1957 births, Living people
Slave trade	Slavery, Human issues
List of U.S. states and territories by time zone	Lists about U.S. states, Time zones
Central line (London Underground)	London Underground lines, 1900 establishments in the United Kingdom, 1900s establishments in England
Lysergic acid diethylamide	Illegal drugs
Triple H	Paul Michael Levesque, 1969 births, Actors from New Hampshire, American movie actors, American professional wrestlers, American Roman Catholics, American television actors, Bodybuilders, Living people, Sportspeople from New Hampshire, WWE wrestlers, People from Nashua, New Hampshire
Ernő Rubik	1944 births, Living people, Architects, Inventors, People from Budapest
Michael Richards	1949 births, Living people, Actors from Los Angeles, California, American movie actors, American stand-up comedians, American television actors, American television writers, Comedians from Los Angeles, California, Emmy Award winning actors, Screen Actors Guild Award winners, Seinfeld, Writers from Los Angeles, California
Final Fantasy VII	Final Fantasy games, 1997 video games, PlayStation games, Windows games, IOS games, PlayStation 4 games, Android (operating system) games, Nintendo Switch games, Xbox One games
Tony O'Reilly	1936 births, Living people, Irish businesspeople
Prism (optics)	Optics
Fritjof Capra	1939 births, Living people, American physicists, Austrian scientists, Scientists from Vienna, Systems scientists
Vegeta	Dragon Ball characters, Fictional characters introduced in 1988, Fictional extraterrestrial characters
Minor Threat	American punk bands, Hardcore punk, Musical groups from Washington, D.C., Musical groups established in 1980, Musical groups disestablished in 1983
Ethelred the Unready	960s births, 1016 deaths, Kings and Queens of England
Elizabethan Religious Settlement	History of the British Isles, Protestant Reformation
Gecko	Lizards
Rutherfordium	Chemical elements, Transition metals
Lizard	Lizards, Reptiles
Philipp Tischendorf	1988 births, Living people, Figure skaters, German sportspeople, Sportspeople from Berlin
Miles per hour	Physics, Units of measurement, Imperial units
Nobility	Nobility
List of U.S. states by population	Lists about U.S. states
Trio (music)	Musical trios
List of U.S. state nicknames	Lists of United States state symbols
List of U.S. states by date of admission to the Union	Lists about U.S. states, History of the United States
List of U.S. states' largest cities	Lists about U.S. states, Lists of cities in the United States
Learning music by ear	Music education, Musical performance techniques
Shelton Benjamin	African-American wrestlers, American professional wrestlers, Sportspeople from South Carolina, Former WWE wrestlers, 1975 births, Living people
J. Robert Oppenheimer	1904 births, 1967 deaths, Alumni of the University of Cambridge, American physicists, Cancer deaths in New Jersey, Deaths from throat cancer, Harvard University alumni, Jewish American academics, Jewish American scientists, Nuclear physicists, Scientists from New York City, Theoretical physicists
Minor league baseball	Baseball
American League	American League
National League	National League
Statistical survey	Marketing, Statistics
Social sciences	Social sciences
Arts	Arts, Non-verbal communication
Nuclear proliferation	Nuclear weapons
François Bourdoncle	1964 births, Living people, French businesspeople
Chief executive officer	Chief executives, Occupations
Exalead	Websites
Amateur radio	Radio
Humanities	Humanities
John Hawkins	1532 births, 1595 deaths, English businesspeople, Slavers
Coconut palm	Trees, Arecaceae, National symbols of the Maldives, Coconuts
Shawarma	Sandwiches, Middle Eastern foods
Merchant	Commerce, Occupations
Warranty	Law
Giuseppe Verdi	Cardiovascular disease deaths in Italy, Deaths from stroke, Italian composers, Romantic composers, 1813 births, 1901 deaths
Blue box	Telephone, Electronics
Red box	Telephone, Electronics
Silicon Graphics	American technology companies
Constituency	Democracy
Local government	Local government
List of Parliamentary constituencies in the United Kingdom	Constituencies in the United Kingdom, United Kingdom-related lists
Stain	Everyday life
Stainless steel	Alloys
Ferrous	Metals, Iron
Carbon steel	Alloys
Yellowcake	Chemical elements, Nuclear energy
Ductility	Materials science
Defibrillation	Cardiology, Emergency medicine
Defibrillator	Cardiology, Emergency medicine
Curse	Superstitions
Ventricular fibrillation	Cardiology, Medical emergencies
Tachycardia	Medical emergencies, Cardiovascular system
Material fracture	Materials science
Shear stress	Materials science
Tension (mechanics)	Force, Mechanics
I.O.U.	Money
Deformation	Mechanics, Materials science
Ceramic	Ceramics
Inorganic compound	Chemical compounds
Applied mechanics	Mechanics
Mechanics	Mechanics
Paleobiology	Biology
Central venous catheter	Medical equipment
Macroscopic	Basic physics ideas
Naked eye	Astronomy
Order of magnitude	Mathematics
N-Gage	Handheld video games
Handheld game console	Handheld video games
Pinhead Gunpowder	American punk bands, Musical groups from San Francisco
Harry Connick Jr.	1967 births, Living people, American movie actors, American pianists, singers from Louisiana, actors from Louisiana, Musicians from Louisiana
Pantheism	Theology
Panentheism	Theology
Deuterium	Hydrogen, Isotopes
Boer	History of Africa
Muhammad Ali	1942 births, 2016 deaths, African-American boxers, American Muslims, American Olympic gold medalists, Converts to Islam, Deaths from sepsis, Disease-related deaths in Arizona, Infectious disease deaths in the United States, Medalists at the 1960 Summer Olympics, People with Parkinson's disease, Presidential Citizens Medal recipients, Sportspeople from Kentucky
Mechanician	Mechanics, Occupations
Compressive stress	Engineering
Cambuslang railway station	Railway stations in Scotland
Rotation	Geometry, Mechanics
Moment (physics)	Physical quantity
Tensile strength	Materials science
Bosconian	1981 video games, Arcade games, Namco video games
The Sunday Night Project	2005 British television series debuts, 2009 British television series endings, 2000s British television series, British comedy television series, English-language television programs
Grand Duchess Anastasia Nikolaevna of Russia	1901 births, 1918 deaths, Russian grand dukes and duchesses, House of Holstein-Gottorp-Romanov, Russian Orthodox saints, Murder victims, Children victims of violence
Anna Anderson	Deaths from pneumonia, Infectious disease deaths in the United States, Russian people, 1896 births, 1984 deaths
Celtic F.C.	Scottish Premier League clubs, Glasgow, 1888 establishments in the United Kingdom, 1880s establishments in Scotland
Grand Duchess Maria Nikolaevna of Russia (1899–1918)	1899 births, 1918 deaths, Russian grand dukes and duchesses, Russian Orthodox saints, Murder victims, House of Holstein-Gottorp-Romanov
Grand Duchess Tatiana Nikolaevna of Russia	1897 births, 1918 deaths, Russian grand dukes and duchesses, House of Holstein-Gottorp-Romanov, Murder victims, Russian Orthodox saints
Rally-X	1980 video games, Arcade games, Namco video games
Grand Duchess Olga Nikolaevna of Russia	1895 births, 1918 deaths, Murder victims, Russian grand dukes and duchesses, House of Holstein-Gottorp-Romanov, Russian Orthodox saints
Physical compression	Mechanics
Compressive strength	Materials science
Strength of materials	Materials science
Funeral Blues	20th-century British poems, 1936, 1930s works
W. H. Auden	1907 births, 1973 deaths, American LGBT people, American poets, American Protestants, English Anglicans, English LGBT people, English poets, Gay men, LGBT Christians, LGBT poets, Naturalized citizens of the United States, People from York, Writers from Birmingham, Writers from Yorkshire
Parsley	Herbs, Spices, Apiaceae, Gardening
Édith Piaf	1915 births, 1963 deaths, Actors from Paris, Cancer deaths in France, Deaths from liver cancer, French movie actors, French singers, Musicians from Paris
Weed	Types of plants
Ternopil	Cities in Ukraine
Justin Lee Collins	1974 births, Living people, Channel 4 presenters, Comedians from Bristol, English television presenters
Alan Carr	1976 births, Living people, British radio personalities, British stand-up comedians, British television talk show hosts, Channel 4 presenters, English comedians, English LGBT people, English movie actors, English television actors, English television presenters, English television writers, Gay men, LGBT actors, LGBT broadcasters, LGBT comedians, LGBT writers, People from Dorset, People from Northampton, Weymouth, Dorset
Cremation	Death customs
Spartacus	Roman people, Slaves, 120 BC births, 70 BC deaths
George Africanus	1763 births, 1834 deaths, Slaves
Booker T. Washington	Slaves, Politicians from Virginia, 1856 births, 1915 deaths
Scipio Africanus	236 BC births, 183 BC deaths, Roman generals
Blessing	Theology, Luck
Karel Svoboda	1938 births, 2007 deaths, Czech composers, Movie score composers, Musicians from Prague, Suicides by firearm
Third Servile War	Wars and battles of Ancient Rome, Slave rebellions, Rebellions in Europe
Vibrating string	Sound
Angular momentum	Basic physics ideas, Mechanics
Axle	Engineering, Machines
Gear	Engineering
Gearshift	Engineering
Transmission	Engineering, Mechanics
Hydraulics	Engineering
List of U.S. states and territories by area	Geography of the United States, Lists about U.S. states
Tom Vilsack	1950 births, Living people, Governors of Iowa, United States Secretaries of Agriculture, US Democratic Party politicians, Politicians from Pittsburgh, Pennsylvania
Actinide	Chemical elements
Opera Software	Opera ASA, 1995 establishments in Europe
Latin Grammy Award	Music awards, Latin music
Tiananmen Square	Buildings and structures in Beijing, National squares
Hot sauce	Condiments, Sauces
University of Prishtina	Colleges and universities in Europe, Kosovo, Buildings and structures in Serbia
Kosovska Mitrovica	Settlements in Serbia, Towns in Europe
Bending	Engineering, Mechanics
Torsion (mechanics)	Mechanics
Polar moment of inertia	Mechanics
Burial	Death customs
Gila monster	Reptiles of North America, Lizards
Elizabeth Smart	1987 births, Living people, American crime victims, Kidnapped American people, People from Salt Lake City, Utah
Bury	Bury
Salma Hayek	1966 births, Living people, Emmy Award winning actors, Mexican movie actors, Mexican television actors, Mexican movie directors, Mexican movie producers, Television producers, People from Veracruz
Pellagra	Diseases
Dermatitis	Diseases, Skin
Chet Culver	Governors of Iowa, 1966 births, Living people
Duel	Human behavior, Law, Dispute resolution
The Castle (movie)	1997 comedy movies, Australian comedy movies, Movies set in Australia
Documenta	Art
Al Pacino	1940 births, Living people, Best Actor Academy Award winners, Actors from New York City, American movie actors, American stage actors, American television actors, BAFTA Award winning actors, Drama Desk Award winners, Emmy Award winning actors, Golden Globe Award winning actors, Screen Actors Guild Award winners, Tony Award winning actors
Balfour Declaration of 1917	20th century in Israel, 1917 in the United Kingdom, Jewish history, Mandatory Palestine, Zionism, November 1917 events
Radius	Geometry
Morality	Ethics, Psychology, Philosophy
Saliva	Mouth, Digestive system
Villarosa	Towns in Italy, Settlements in Sicily
Maria Sharapova	1987 births, Living people, Australian Open champions, Doping cases in sport, Female tennis players, French Open champions, Medalists at the 2012 Summer Olympics, Olympic silver medalists, Russian models, Russian tennis players, US Open (tennis) champions, Wimbledon champions, World No. 1 tennis players
True bug	Hemiptera
Dayton, Ohio	1796 establishments in the United States, 1790s establishments in the Northwest Territory, County seats in Ohio, Dayton, Ohio
Native Esperanto speakers	Esperanto
Soldering iron	Electronics, tools
Hungarian Vizsla	Dog breeds
Drawing (manufacturing)	Tools
Manufacturing	Economics, Manufacturing
Finished goods	Factors of production
Good (economics)	Goods
Ruslana	1973 births, Living people, Ukrainian singers, Pop musicians, Eurovision Song Contest winners, Women who received the International Women of Courage Award
Mustard plant	Leaf vegetables, Brassicaceae
Mustard gas	Chemical warfare
Amelia Earhart	1897 births, 1937 deaths, American aviators, American writers, Aviation deaths, Missing American people, Writers from Kansas, People declared dead in absentia
Situation comedy	Comedy, Sitcoms, Television genres
Frank Sinatra	Frank Sinatra, Actors from New Jersey, American movie actors, American movie producers, American television actors, Cardiovascular disease deaths in the United States, Deaths from myocardial infarction, People from Hoboken, New Jersey, American musicians, American pop singers, Kennedy Center honorees, Singers from New Jersey, 1915 births, 1998 deaths
Bing Crosby	1903 births, 1977 deaths, Actors from Washington, American movie actors, American Roman Catholics, American television actors, Cardiovascular disease deaths in Madrid, Deaths from myocardial infarction, Grammy Award winners, National Radio Hall of Fame inductees, Singers from Washington, Best Actor Academy Award winners
Felt	Cloth
Dean Martin	Actors from Ohio, American movie actors, Comedians from Ohio, American television actors, American radio actors, American television presenters, Cancer deaths in the United States, Deaths from emphysema, Deaths from lung cancer, Stage names, Singers from Ohio, 1917 births, 1995 deaths, Former Roman Catholics, People from Steubenville, Ohio
Racial segregation	20th century in Poland, American civil rights, Apartheid, Discrimination, History of China, History of Germany, History of Ireland, History of Italy, History of Russia, History of South Africa, History of the United Kingdom, History of the United States, Human rights abuses, Jewish history, Race
Torrance, California	Torrance, California, 1911 establishments in the United States, 1910s establishments in California
Chuck Berry	1926 births, 2017 deaths, African American musicians, African-American singers, American criminals, American prisoners, American robbers, American rock guitarists, American rock singers, American singer-songwriters, Deaths from myocardial infarction, Singers from St. Louis, Missouri, Musicians from St. Louis, Missouri
Nagamaki	Japanese swords
Naginata	Japanese swords
Ainu language	Language isolates, Languages of Asia, Japan
Tenacious D	1994 establishments in California, 1990s music groups, 2000s music groups, 2010s music groups, American comedy bands, American rock bands, American hard rock bands, American heavy metal bands, Musical groups from Los Angeles, California
Saurischia	Saurischia
Stethoscope	Medical equipment
Gouda (cheese)	Dutch cheeses, Gouda
Passion bearer	Christian saints
Tile	Ceramics
Porcelain	Pottery
Kiln	Pottery
ChuChu	Manga
Mettā	Buddhist terminology
Oxide	Oxides
Proposal	Social sciences, Marriage
Versailles, Yvelines	Communes in Yvelines, Versailles, Departmental capitals in France
Major	Military ranks, Majors
Sibling	Family, Basic English 850 words
Silicate	Chemical compounds, Geology
Newton metre	SI units
Gamma ray	Nuclear physics
Cynicism	Philosophical movements and positions
Sonic the Hedgehog (TV series)	Animated television series, English-language television programs
Plutarch	40s births, 120s deaths, Ancient Greek historians, Ancient Greek writers
Crassus	2nd century BC births, 53 BC deaths, Roman generals
Pompey	Roman generals, 106 BC births, 48 BC deaths
Italia (Roman province)	Places of Ancient Rome
Shift key	Computer hardware
2000 United States Census	2000 in the United States, United States Census
Police procedural	Genres, Movie terminology, Television programs
List of U.S. states by population density	Lists about U.S. states
Girth	Geometry
Circumference	Geometry
Girth (tack)	Horse riding
Lusatian Neisse	Geography of Brandenburg, Geography of Saxony, Rivers of the Czech Republic, Rivers of Germany, Rivers of Poland
Anton Rubinstein	1829 births, 1894 deaths, Romantic composers, Russian composers, Russian pianists
List of InuYasha characters	InuYasha, Anime characters, Lists of fictional characters
Plane (tool)	Woodworking tools
Lumber	Wood, Forestry
El Puerto de Santa María	Cities in Andalusia, Municipalities in Andalusia
Bearing (mechanical)	Engineering
Bush (mechanical)	Objects
Suspension (vehicle)	Engineering
Suzuki method	Music education
Pará	Pará, States of Brazil
Constituent (linguistics)	Linguistics
Spindle (textiles)	Tools, Fibers, Textile arts
Flywheel	Energy, Engineering
Potter's wheel	Pottery, Metaphors
Nikolai Rubinstein	Russian composers, Romantic composers, Russian pianists, 1835 births, 1881 deaths
Okinawan language	Japonic languages, Languages of Asia, Ryukyu Islands, Ryukyuan languages
Imbolc	Ireland, Scotland, Festivals in the United Kingdom, Festivals in Europe, Religious festivals
Baseball (ball)	Baseball equipment
Battle of Worcester	Battles involving England, Worcester, 1651, 17th century in England, September events, 1650s in Europe, Battles
James Marsters	1962 births, Living people, American rock guitarists, American rock singers, American television actors, Whedonverse, Actors from California, Musicians from California, American blues musicians, Country musicians, Singers from California
Emma Caulfield	1973 births, Living people, American television actors, Whedonverse, Actors from San Diego, California
Michelle Trachtenberg	1985 births, Living people, American child actors, American movie actors, American television actors, American voice actors, Actors from New York City, Whedonverse
Summer Glau	1981 births, Living people, American movie actors, American dancers, Whedonverse, American television actors, Actors from San Antonio, Texas
Band (anthropology)	relationships
Infertility	Biological reproduction
Betrayal	ethics
Destruction	Basic English 850 words
Crane (machine)	Engineering
Data mining	Computer science
Japanese sword-making	Japanese swords
Ornamental plant	Flowers, Gardens
List of garden plants	Plants, Lists of plants
List of plants by common name	Lists of plants
Celts	Celtic peoples
Free good	Goods
Hoist	Tools
Eugene Onegin (opera)	Operas, Compositions by Pyotr Ilyich Tchaikovsky
Basingstoke	Towns in Hampshire
Flerovium	Chemical elements, Metals
Brontosaurus	Sauropods
Fate	Social sciences
Hoffmann von Fallersleben	German poets, 1798 births, 1874 deaths
Lake Peipus	Lakes of Europe, Lakes of Russia, Geography of Estonia
Tanto	Japanese swords
Clint Dempsey	1983 births, Living people, American footballers, Sportspeople from Texas
Runaway Brain	1934 movies, Disney animated movies, English-language movies
Maltese language	Semitic languages
Persuasion	Psychology
Ögedei Khan	1186 births, 1241 deaths, Mongolian people
Heligoland	Geography of Schleswig-Holstein, Islands of Germany
Cooperation	Sociology
Robert F. Kennedy	1925 births, 1968 deaths, American murder victims, People from Brookline, Massachusetts, American Roman Catholics, Assassinated people, Burials at Arlington National Cemetery, Harvard University alumni, Kennedy family, Murders by firearm in California, People murdered in California, Politicians from Massachusetts, Robert F. Kennedy, United States Attorneys General, 1968 United States presidential candidates, United States senators from New York, US Democratic Party politicians
Umbilical cord	Pregnancy and childbirth
Josef Mengele	1911 births, 1979 deaths, Accidental deaths by drowning, German doctors, German war criminals, Holocaust perpetrators, People from Bavaria, SS officers, Waffen-SS people
Francis I of Austria	1768 births, 1835 deaths, Holy Roman Emperors
Wilhelm I of Germany	1797 births, 1888 deaths, Kings and Queens of Prussia, German emperors, House of Hohenzollern
Amami Islands	Ryukyu Islands
Formal	Characteristics
Kyūshū	Islands of Japan, Kyushu region
Presentation	Marketing
Keynote (software)	IWork, Apple software
Claymore	Swords, Scotland
Tamahagane	Metals, Japanese swords
Graviton	String theory, Relativity, Subatomic particles
Presentation software	Software, Presentation software
Liqueur	Alcoholic spirits
Militarism	Military
The Queen of Spades (opera)	Compositions by Pyotr Ilyich Tchaikovsky, Operas
Growth-share matrix	Marketing
Microsoft PowerPoint	Microsoft Office, Presentation software
Qi Xi	Holidays, China
Anna Nicole Smith	Actors from Houston, Texas, American movie actors, American television actors, Drug-related accidental deaths in the United States, Models from Houston, Texas, People with borderline personality disorder, 1967 births, 2007 deaths
Ciao (magazine)	Manga
Sorting algorithm	Searching and sorting algorithms
Ciao	Words, Human communication
LaTeX	Programming languages, Mathematical tools
First War of Scottish Independence	History of the British Isles, Wars of independence, Wars involving England
John of Scotland	1248 births, 1314 deaths, Kings and Queens of Scotland
Soul patch	Facial hair
Wars of Scottish Independence	History of the British Isles, Wars involving England, Rebellions in Europe, 13th century in Europe, 14th century in Europe, Wars of independence
1314	1314
Autotroph	Ecology, Botany
Air France	1930s establishments in France, 1933 establishments, Airlines of France
Air Dolomiti	Airlines of Europe, Transport companies of Italy, Verona
Hampshire	Hampshire, Ceremonial counties of England
Manuel Pereira da Silva	1920 births, 2003 deaths, Portuguese artists, Sculptors
Yeti	Cryptozoology
Primality test	Number theory
Padding (cryptography)	Cryptography
Dictionary attack	Cryptography
Rocky Marciano	1923 births, 1969 deaths, American boxers, Aviation deaths in the United States, Sportspeople from Massachusetts
Exponentiation by squaring	Algorithms
Smart card	Money, Authentication methods
Coprime	Mathematics
Euler's totient function	Number theory
Key (cryptography)	Cryptography
Hollywood, Florida	Cities in Florida
Magnetic stripe card	Identification documents, Magnetism, Authentication methods
Payphone	Telephone
Sami people	Nordic people, Arctic, Finland, Lapland, Norway, Russia, Sweden
Lapland	Lapland
Judah	6th-century BC disestablishments, Former monarchies of Asia, Former countries in the Middle East, Ancient Israel and Judah
Gantt chart	Planning, Charts
Mind map	Diagrams, Learning
Dia	Free software
Talent	Psychology, Giftedness, Human skills
Cathay Pacific	Transport in Hong Kong, Airlines of Asia
Talent (measurement)	Old units of measurement, Units of mass
Bede	670s births, 730s deaths, Christian saints, Christian theologians, English historians, English poets, English Roman Catholics, English theologians, Monks, People from County Durham, Translators
Phototroph	Ecology, Botany
NTFS	Software, Microsoft
File system	software, Systems
David II of Scotland	1324 births, 1371 deaths, Kings and Queens of Scotland
Lied	Song forms
Aurora	Earth sciences, Meteorology
Nordic countries	Nordic countries
Going Underground	1980 songs
Paasselkä devil	Folklore, Finnish mythology
Aurora (mythology)	Roman gods and goddesses
Ukko	Finnish mythology
Väinämöinen	Finnish mythology
Ilmarinen	Finnish mythology
Finnish paganism	Finnish mythology, Paganism
Feedback	Engineering, Systems theory
Phosphate	Phosphorus compounds
Cerebrum	Anatomy of the brain
Karelia	History of Russia, History of Finland
Kalevala	Finnish mythology
Edred of England	923 births, 955 deaths, House of Wessex, People buried in Winchester Cathedral
Plant pathology	Plants
Chytridiomycota	Fungi, Protista
List of U.S. states by traditional abbreviation	Lists about U.S. states
Saprophyte	Biology
Giacomo Puccini	1858 births, 1924 deaths, 20th century composers, Cancer deaths in Belgium, Deaths from throat cancer, Italian composers, People from Lucca, Romantic composers
Pharaoh Hound	Dog breeds
Mycelium	Fungi
Lviv	Cities in Ukraine, 1240s establishments in Europe, Establishments in Ukraine
Orchestra pit	Theater
Will o' the wisp	Folklore
Ghost light	Folklore
Roman Giertych	Polish politicians, 1971 births, Living people, Polish lawyers
Smoothie	Drinks
Sheave (mechanical)	Tools
Unidentified flying object	UFOs, Pseudoscience
Second War of Scottish Independence	Wars of independence, History of the British Isles, Wars involving England
U.S. postal abbreviations	United States Postal Service
Booing	Non-verbal communication
Applause	Theater, Non-verbal communication
Kyle Busch	1985 births, Living people, NASCAR drivers, American racecar drivers, Sportspeople from Las Vegas, Nevada
498a	Legislation, Sociology, India
Caesar cipher	Cryptography
Social engineering (security)	Psychology, Sociology
Hydroponics	Agriculture, Botany
Crop rotation	Agriculture
A Hard Day's Night	The Beatles albums, 1964 albums, Rock and roll albums
Changeling	Folklore
Bomb	Explosives
Dieter Bohlen	1954 births, Living people, Entertainers from Lower Saxony, German pop musicians, Modern Talking, German television personalities
SWOT Analysis	Economics, Management, Planning
Project	Management
Central Time Zone	Time zones
Gioachino Rossini	1792 births, 1868 deaths, Italian composers, Classical era composers, Romantic composers
Salerno	Cities in Campania, Capital cities in Italy
Opera house	Opera houses
Kullervo	Finnish mythology
Ephraïm Inoni	1947 births, Living people, Prime Ministers of Cameroon, Criminals, Prisoners
Compton scattering	Wave physics
Scottsdale, Arizona	Scottsdale, Arizona, 1951 establishments in the United States, 20th-century establishments in Arizona
REO Speedwagon	1967 establishments in the United States, 1960s American music groups, 1960s establishments in Illinois, 1970s American music groups, 1980s American music groups, 1990s American music groups, 2000s American music groups, 2010s American music groups, American hard rock bands, Musical groups established in 1967, Musical groups from Illinois
Will	Basic English 850 words
Carlisle	County towns in England, Carlisle
Stanislas Konarski	Polish writers, Teachers, 1700 births, 1773 deaths
Gaetano Donizetti	1797 births, 1848 deaths, Romantic composers, Italian composers
Blonde	Hair
Harold Macmillan	1894 births, 1986 deaths, Alumni of the University of Oxford, British military personnel of World War I, Chancellors of the Exchequer, English Anglicans, Former Conservative MPs (UK), Former members of the British House of Commons for English constituencies, Leaders of the Conservative Party (UK), Members of the House of Lords, Order of Merit, People educated at Eton College, Politicians from London, Privy Councillors (UK), Secretaries of State of the United Kingdom, UK MPs 1931–1935, UK MPs 1935–1945, UK MPs 1945–1950, UK MPs 1950–1951, UK MPs 1951–1955, UK MPs 1955–1959, UK MPs 1959–1964, United Kingdom Earls
Crucifixion	Capital punishment, Christian symbols
Steeple	Church architecture
Baltic paganism	Paganism, Baltic states
Kaleva	Finnish mythology
Yellowstone National Park	Biosphere reserves, Calderas, National parks in the United States, Volcanoes of the United States, World Heritage Sites in the United States, Western United States, Idaho, Montana, Wyoming
National park	National parks
William Ewart Gladstone	1809 births, 1898 deaths, Alumni of the University of Oxford, Chancellors of the Exchequer, Christian theologians, English Anglicans, English theologians, Former Conservative MPs (UK), Former members of the British House of Commons for English constituencies, Leaders of the Liberal Party (UK), Liberal Party MPs (UK), People buried in Westminster Abbey, People educated at Eton College, People from Liverpool, Privy Councillors (UK), Secretaries of State of the United Kingdom
Anthony Eden	1897 births, 1977 deaths, Alumni of the University of Oxford, British military personnel of World War I, British people of World War II, Cancer deaths in England, Deaths from liver cancer, Deputy Prime Ministers of the United Kingdom, English Anglicans, Former Conservative MPs (UK), Former members of the British House of Commons for English constituencies, Leaders of the Conservative Party (UK), Members of the House of Lords, People educated at Eton College, People from County Durham, Privy Councillors (UK), Secretaries of State of the United Kingdom, UK MPs 1929–1931, UK MPs 1931–1935, UK MPs 1935–1945, UK MPs 1945–1950, UK MPs 1950–1951, UK MPs 1951–1955, UK MPs 1955–1959, United Kingdom Earls, World War II political leaders
Stanley Baldwin	1867 births, 1947 deaths, Alumni of the University of Cambridge, Chancellors of the Exchequer, English Anglicans, Former Conservative MPs (UK), Former members of the British House of Commons for English constituencies, Leaders of the Conservative Party (UK), Leaders of the Opposition (United Kingdom), Politicians from Worcestershire, Privy Councillors (Canada), Privy Councillors (UK), UK MPs 1929–1931, UK MPs 1931–1935, UK MPs 1935–1945, United Kingdom Earls
Alec Douglas-Home	1903 births, 1995 deaths, Alumni of the University of Oxford, Bankers, British Anglicans, English cricketers, Episcopalians, Former Conservative MPs (UK), Former members of the British House of Commons for Scottish constituencies, Leaders of the Conservative Party (UK), Leaders of the Opposition (United Kingdom), Members of the House of Lords, People educated at Eton College, People from the City of Westminster, Politicians from London, Privy Councillors (UK), Scottish Christians, Scottish Earls, Scottish politicians, Secretaries of State of the United Kingdom, Sportspeople from London, UK MPs 1931–1935, UK MPs 1935–1945, UK MPs 1950–1951, UK MPs 1959–1964, UK MPs 1964–1966, UK MPs 1966–1970, UK MPs 1970–1974, UK MPs 1974
Benjamin Disraeli	1804 births, 1881 deaths, Chancellors of the Exchequer, Former Conservative MPs (UK), Former members of the British House of Commons for English constituencies, United Kingdom Earls, United Kingdom Viscounts, British diplomats, British novelists, Fellows of the Royal Society, Freemasons, Jewish British politicians, Jewish British writers, Jews who converted to Christianity, Knights of the Garter, Members of the British House of Commons for English constituencies, Members of the House of Lords, Politicians from London, Prime Ministers of the United Kingdom, Privy Councillors (UK), Writers from London
William Pitt, 1st Earl of Chatham	1708 births, 1778 deaths, English Earls, Former members of the British House of Commons for English constituencies, People buried in Westminster Abbey, People from Westminster, Politicians from London, Whig party (UK) politicians, Prime Ministers of Great Britain
Herbert Asquith	1852 births, 1928 deaths, Alumni of the University of Oxford, British lawyers, British people of World War I, Chancellors of the Exchequer, Congregationalists, English Protestants, Former members of the British House of Commons for Scottish constituencies, Leaders of the Liberal Party (UK), Leaders of the Opposition (United Kingdom), Liberal Party MPs (UK), Members of the House of Lords, Politicians from Yorkshire, Privy Councillors (UK), Secretaries of State for the Home Department, Secretaries of State of the United Kingdom, United Kingdom Earls
Commerce	Commerce
Plantation	Agriculture
Pine	Conifers
Philip II of France	Kings and Queens of France, 1165 births, 1223 deaths
Pohjola	Finnish mythology
Gulf of Finland	Gulfs, Atlantic Ocean, Baltic states, Geography of Estonia, Geography of Finland, Geography of Russia
Edmund II of England	989 births, 1016 deaths, House of Wessex
Arthur Balfour	1848 births, 1930 deaths, Former Conservative MPs (UK), Government ministers, Knights of the Garter, Order of Merit, Privy Councillors (UK), United Kingdom Earls, Zionists
Henry Pelham	1694 births, 1754 deaths, People from Sussex, Whig party (UK) politicians, Prime Ministers of Great Britain
List of U.S. states by elevation	Lists about U.S. states, Geography of the United States
Household income in the United States	Economy of the United States, Income
Toxicology	Toxicology
Monte Carlo	Monte Carlo
Trickery	Comedy, Mythology
Slideshow	Photography
Slide	Photography
Slide projector	Photography, Machines
Video projector	Machines, Output devices
Peanut	Peanuts, Vegetables
Trans-Asian Railway	Rail transport in Asia, Rail transport in Europe
Wall Street Crash of 1929	1929 in the United States, Economic history
Greater London	Local government in London, Ceremonial counties of England
Chemical Weapons Convention	Treaties and Conventions
Levi Strauss	Businesspeople from San Francisco, 1829 births, 1902 deaths
Princess Peach	Fictional characters introduced in 1985, Mario series characters, Fictional princesses
Princess Daisy	Fictional characters introduced in 1989, Mario series characters
Fixed Dose Procedure	Toxicology
Tentacle rape	Anime, Pornography
Bel canto	Opera terminology
Midori Days	Anime
Matter	Matter
Innocence	Trials, Virtues
Symphonic poem	Musical forms
Melody	Music theory
Steve Jobs	American adoptees, American Buddhists, American chief executives, Deaths from pancreatic cancer, Deaths from respiratory arrest, Businesspeople from San Francisco, Cancer deaths in the United States, Democrats (United States), Disney people, Organ transplant recipients, Pixar, Steve Jobs, 1955 births, 2011 deaths, American company founders, Company founders
Apostolic Palace	Vatican City, Palaces
G-string	Underwear, Swimwear
Transcendental number	Transcendental numbers, Number theory
Flip-flop	Footwear
Thong, Kent	Villages in Kent
Hamlet (place)	Hamlets
Recording Industry Association of America	1952 establishments in the United States, Music industry, Washington, D.C.
Mar del Plata	Cities in Argentina, Buenos Aires Province
Pope Boniface VIII	Italian popes, 1235 births, 1303 deaths
Signal (electrical engineering)	Electronics, Engineering, Communication
Eddie August Schneider	1911 births, 1940 deaths, People from New York City, American aviators
Córdoba, Argentina	Capitals of Argentine provinces, Córdoba, Argentina, 1573 establishments, 16th-century establishments in Argentina
Air New Zealand	1965 establishments in Oceania, Airlines of Oceania, Auckland, Star Alliance, Transport in New Zealand, 1960s establishments in New Zealand, IATA members
Air Jamaica	Jamaica, Airlines of North America
Ecosystem valuation	Economics, Green politics
Economist	Economists, Financial occupations
Conservative Party (UK)	Conservative Party (UK), Conservative parties, 1834 establishments in Europe, 1830s establishments in the United Kingdom
Sandwich	Sandwiches
Artillery	Artillery
House of Lords	Politics of the United Kingdom, National upper houses
Acapulco	Cities in Mexico, Guerrero (state), 1520s establishments in Mexico
Deutsche Bahn	Rail transport in Europe, Transport companies of Germany, Train operating companies, 1994 establishments in Germany
Vienna Convention on the Law of Treaties	Treaties and Conventions
The Lost World	British novels, Science fiction books, Books by Arthur Conan Doyle
Amnesty International	1961 establishments in Europe, 1960s establishments in England, Capital punishment, Charities, Human rights organisations in the United Kingdom, Imprisonment and detention, International organizations
Teletubbies	1997 television series debuts, 1990s British television series, 1990s children's television series, 2000s British television series, 2000s children's television series, 2010s British television series, 2010s children's television series, British children's television series, Nickelodeon television series, Teletubbies, 1990s British television series debuts, 1997 establishments in the United Kingdom, English-language television programs
FLAC	Computer file formats for audio
Enabling Act	Legislation, Nazi Germany, 20th century in law, 1933, March events, 1930s in Germany
Pulmonary hypertension	Cardiovascular system, Respiratory system, Diseases
Decameron	1353 books
Lung transplant	Pulmonology, Surgery, Transplants
Commodity	Business
Commodity market	Commerce
Political economy	Economic policy
My Lai Massacre	Massacres, Vietnam War, 1968 in the United States, 20th century in Vietnam, 1960s in Asia
Henry II of England	1133 births, 1189 deaths, Dukes and Duchesses of Aquitaine, House of Plantagenet, People from Le Mans
Damascus	Damascus
Heart-lung transplant	Surgery, Heart, Respiratory system, Transplants
Ronnie Barker	People from Bedfordshire, Actors from Oxfordshire, British television writers, Cardiovascular disease deaths in England, Deaths from heart failure, English comedians, English movie actors, English television actors, English television presenters, English television writers, People from Bedford, People from Oxford, Writers from Oxfordshire, 1929 births, 2005 deaths
Guantánamo Bay	Bays, Atlantic Ocean, Geography of Cuba
Guantánamo Province	Provinces of Cuba, 1764 establishments, Establishments in Cuba
Havana Province	Provinces of Cuba, 2010 disestablishments
Santiago de Cuba Province	Provinces of Cuba
Granma Province	Provinces of Cuba
Vail, Colorado	Cities in Colorado
Holguín Province	Provinces of Cuba, 1978 establishments in North America, 20th-century establishments in Cuba
Las Tunas Province	Provinces of Cuba, 1978 establishments in North America, 20th-century establishments in Cuba
Paul Hartley	Scottish footballers, 1976 births, Living people
Camagüey Province	Provinces of Cuba
Ciego de Ávila Province	Provinces of Cuba, 1975 establishments in North America, 20th-century establishments in Cuba
Sancti Spíritus Province	Provinces of Cuba
Villa Clara Province	Provinces of Cuba
Cienfuegos Province	1819 establishments in North America, 19th-century establishments in Cuba
Matanzas Province	Provinces of Cuba
Pinar del Río Province	Provinces of Cuba
Isla de la Juventud	1925 establishments in North America, 20th-century establishments in Cuba
Hergé	1907 births, 1983 deaths, Belgian comics artists, People from Brussels-Capital Region, Cartoonists, Deaths from AIDS, Disease-related deaths in Belgium, Former Roman Catholics
Louisville, Kentucky	Louisville, Kentucky, County seats in Kentucky, 18th-century establishments in Kentucky, 1778 establishments in the United States
Mount Rushmore	Mountains of the United States, Geography of South Dakota, National Memorials of the United States, Symbols of the United States
2006 in movies	2006 movies
West Side Story	Broadway musicals, West End musicals, Musicals adapted to movies, Musicals based on plays, 1950s musicals
Lorscheid	Villages in Rhineland-Palatinate, Trier-Saarburg
Thrash metal	Heavy metal subgenres
Anthrax (US band)	1980s American music groups, 1990s American music groups, 2000s American music groups, 2010s American music groups, Thrash metal bands, American heavy metal bands, Speed metal bands, American rap music groups, Musical groups from New York City
Heinrich Himmler	1900 births, 1945 deaths, German military personnel of World War I, German military personnel of World War II, German war criminals, Government ministers of Nazi Germany, Holocaust perpetrators, Members of the Reichstag (Nazi Germany), Members of the Reichstag (Weimar Republic), Murderers who committed suicide, Nazis who committed suicide, People from Munich, Politicians from Bavaria, Politicians of the Nazi Party, RSHA people, SS officers, Suicides by poison, Suicides in Germany, Former Roman Catholics
Scone, Perth and Kinross	Towns in Scotland
Coronation	Royalty and nobility, Monarchy
Perth and Kinross	Scottish Council Areas
Cylon	Fictional races, Battlestar Galactica
Gestapo	1933 establishments, 1945 disestablishments in Germany, 1930s establishments in Germany, Intelligence agencies, Law enforcement agencies, Reichssicherheitshauptamt
Skrewdriver	1976 establishments in the United Kingdom, 1970s British music groups, 1980s British music groups, 1990s British music groups, 1993 disestablishments in the United Kingdom, English punk bands, Musical groups established in 1976, Musical groups disestablished in 1993, Rock Against Communism
Jarosław Kaczyński	1949 births, Living people, Polish movie actors, Politicians from Warsaw, Prime Ministers of Poland, Twin people
Sierpc	Cities in Poland
Heart failure	Cardiology, Diseases, Organ failure
George Bernard Shaw	Academy Award winning writers, Accidental deaths from falls, Deaths from renal failure, Irish novelists, Music critics, Nobel Prize in Literature winners, Writers from Dublin, Irish playwrights, Royal Society of Literature, Socialists, 1856 births, 1950 deaths, Irish Nobel Prize winners
Kalash	Ethnic groups in Pakistan, Ethnic groups in Khyber Pakhtunkhwa
Tuareg people	Berber people
Kinahmi	Finnish mythology
Giovanni Boccaccio	1313 births, 1375 deaths, Italian writers, Italian poets, Medieval poets
Hopwood, Worcestershire	Villages in Worcestershire
Integral	Mathematical analysis
Aneurysm	Diseases and disorders of the cardiovascular system, Blood vessels
Digimon	Anime, 1999 anime television series
Steve Ballmer	1956 births, Living people, American chief executives, American Jews, Harvard University alumni, Jewish businesspeople, Businesspeople from Detroit, Michigan, American Internet celebrities
Tears	Eye
1313	1313
1292	1292
1203	1203
1208	1208
1211	1211
1213	1213
15	10s
16	10s
17	10s
18	10s
19	19
20	20s
21	20s
22	20s
23	23
26	20s
27	20s
28	20s
29	20s
31	30s
32	32
33	30s
34	30s
36	30s
38	30s
Bonar Law	1858 births, 1923 deaths, British chess players, British Protestants, Canadian Christians, Cancer deaths in London, Chancellors of the Exchequer, Deaths from esophageal cancer, Former Conservative MPs (UK), Former members of the British House of Commons for English constituencies, Former members of the British House of Commons for Scottish constituencies, Leaders of the Conservative Party (UK), Leaders of the Opposition (United Kingdom), People buried in Westminster Abbey, People from New Brunswick, Presbyterians, Privy Councillors (UK), Secretaries of State of the United Kingdom
39	30s
Pulmonary artery	Blood vessels, Respiratory system
Artery	Blood vessels
Jönköping	Jönköping
Warwickshire	Warwickshire, Ceremonial counties of England
Doppler effect	Wave physics
Monagas Sport Club	Venezuelan football clubs
Vättern	Lakes of Sweden
Uppsala	Uppsala
Summer of Love	1967 in California, American culture, 20th century in San Francisco, Sexual revolution
Appenzell Innerrhoden	Appenzell Innerrhoden
Cataphile	Paris
Staffordshire	Staffordshire, Ceremonial counties of England
Upper Cretaceous	Cretaceous
Thai language	Thai language
New England Patriots	New England Patriots
Digenea	Flatworms
Aspidogastrea	Flatworms
Theropod	Theropods
Iwasawa theory	Number theory
Ring (mathematics)	Algebra
1294	1294
989	989
988	988
987	987
986	986
Pablo Neruda	1904 births, 1973 deaths, Chilean poets, Deaths from cancer, Deaths from heart failure, People from Parral, Pen names
The Truth about Nanjing	2007 movies
Nanjing Massacre	1937, 1938, 1930s in Asia, 20th century crimes, Crimes against humanity, Second Sino-Japanese War, War crimes, Nanjing
Neoliberalism	Liberalism, Economic theories
Cartel	Market forms
Market forms	Market forms
Perfect competition	Market forms
Supply and demand	Microeconomics
Elasticity (economics)	Microeconomics
Worcestershire	Worcestershire, Ceremonial counties of England
Zlín	Towns in the Czech Republic
Metamorphosis	Developmental biology, Animal anatomy
Resilience	Psychology, Ecology, Engineering
St Andrews	Towns in Fife
1911 Encyclopædia Britannica	Encyclopædia Britannica, Free encyclopedias
Pontiac	General Motors
Buick	General Motors
Cadillac	General Motors
Chevrolet	General Motors
Sports car	Sports cars
Oldsmobile	General Motors, 2004 disestablishments
GMC	1901 establishments in the United States, General Motors
Saturn Corporation	General Motors, Defunct companies of the United States, 1985 establishments in the United States, 2010 disestablishments in the United States
Holden	Companies of Australia, Holden
Hummer	General Motors vehicles, Sport utility vehicles
Vauxhall Motors	Opel automobiles, General Motors, British automobile companies
Battle of Dunkirk	1940 in France, Battles involving Belgium, Battles involving France, Battles involving Germany, Battles involving the United Kingdom, European battles of World War II, Hauts-de-France, May 1940 events, June 1940 events
1971 Bangladesh atrocities	1971 in Bangladesh, 1971 in Pakistan, Bangladesh Liberation War, Murder in the 1970s, War crimes
Iwao Takamoto	1925 births, 2007 deaths, American animators, Deaths from heart failure, People from Los Angeles, California
Mussel	Bivalves, Seafood
Gastropoda	Gastropods
Limpet	Gastropods
Abalone	Gastropods, Seafood
Shellfish	Seafood
Alban Berg	1885 births, 1935 deaths, 20th century composers, Austrian composers, Writers from Vienna
Herefordshire	Unitary authorities, Herefordshire, Ceremonial counties of England
Conch	Bivalves
Gloucestershire	Ceremonial counties of England, Gloucestershire
Cowry	Gastropods, Former currencies, Currency of Africa
Wiltshire	Wiltshire, Ceremonial counties of England
West Midlands (county)	West Midlands (county), Ceremonial counties of England
Conurbation	Settlements
Dunkirk	Communes in Nord, Subprefectures in France, Port cities and towns of the North Sea
Cephalopod	Cephalopods
Cuttlefish	Cephalopods
Nautilus	Cephalopods, Living fossils
Logarithmic spiral	Logorithms
Small white	Pieridae
Argonauta	Cephalopods
Camouflage	Coevolution, Ecology, Mimicry, Ethology
Extant	Biology
Echinoderm	Echinoderms
Das Rheingold	Compositions by Richard Wagner, Operas
Die Walküre	Compositions by Richard Wagner, Operas
Siegfried (opera)	Compositions by Richard Wagner, Operas
Götterdämmerung	Compositions by Richard Wagner, Operas
Der Ring des Nibelungen	Compositions by Richard Wagner, Operas
Väki	Finnish mythology
Sudetenland	History of Germany, Geography of the Czech Republic
1375	1375
Ochre	Pigments
Jochen Rindt	1942 births, 1970 deaths, Austrian sportspeople, Formula One drivers, People from Mainz, Sportspeople from Rhineland-Palatinate
Claudio Arrau	1903 births, 1991 deaths, Chilean people, Pianists, People from Bío Bío Region
Patriotism	Politics, Nationalism
Misogyny	Discrimination, Hatred
Malmeneich	Villages in Hesse
United Parcel Service	Companies listed on the New York Stock Exchange
Gómez Pereira	Spanish people, Philosophers, 1500 births, 1567 deaths
Spore (video game)	2008 video games, Nintendo DS games, Wii games
Tilia	Trees, Malvaceae
Cartesian coordinate system	Coordinate systems
Polar coordinate system	Coordinate systems
Provinces of Cuba	Provinces of Cuba
Singing	Singing
Amish	Anabaptism, Ethnic groups in the United States, Ohio, Pennsylvania
Jeddah	Jeddah, 6th-century BC establishments, Establishments in Saudi Arabia
Horatio Nelson	1758 births, 1805 deaths, Admirals, British Barons, British Viscounts, Knights Grand Cross of the Order of the Bath, People from Norfolk, Royal Navy officers, United Kingdom Barons, United Kingdom Viscounts
Sea captain	occupations, Ships
Brain stem	Brain
Ideology	Philosophy, Politics, Sociology
Iran–Iraq War	1980s in Asia, 1980s in Iran, Wars involving Iraq, 20th century in Iraq
Rajkumar	1924 births, 2006 deaths, Indian actors
Freedom fighter	Human rights, Freedom
Wood grain	Wood
Groove (joinery)	Manufacturing
Sepultura	Thrash metal bands, Heavy metal bands, Death metal bands, Groove metal bands, Belo Horizonte, 1984 establishments, 1980s establishments in Brazil
Dalai Lama	Asian people, Tibetan Buddhist lamas
Serenity (movie)	2000s action movies, 2005 science fiction movies, American action movies, American science fiction movies, Movies based on TV series, Movies directed by Joss Whedon, Screenplays by Joss Whedon, Whedonverse, Hugo Award winning movies, Post-apocalyptic movies
Woodworking joints	Woodworking
George Grenville	1712 births, 1770 deaths, Politicians from London, Whig party (UK) politicians, Prime Ministers of Great Britain
Harald Hardrada	1015 births, 1066 deaths, Kings and Queens of Norway
Normans	Ethnic groups in Europe, Germanic tribes, Middle Ages, Normans
Captain	Military ranks, Law enforcement occupations, Ships
Wire rope	Hardware (mechanical), Ropework
Liekkiö	Finnish mythology
Bastard	Pejoratives, English profanity
Gödel number	Mathematics, Numbers
Formal language	Mathematics, Programming languages
Alphabet (computer science)	Computer science, Mathematics
Empty string	Computer science, Mathematics
Old Possum's Book of Practical Cats	1939 books, 20th-century British poems
Concatenation	Computer science
Identity element	Mathematics
Inverse function	Mathematics
Countable set	Set theory
Computable function	Theoretical computer science
Pharmacist	Pharmacology, Drugs, Healthcare occupations, Pharmacists
Thoosa	Nymphs
Perch	Perciformes, Edible fish
Worship	Worship
Claudius	10 BC births, 54 deaths, Roman Emperors
Nero	37 births, 68 deaths, Roman Emperors
Trades union	Unions
Officer	Military ranks
Tachi	Japanese swords
Machaira	Swords
Field	Basic English 850 words
Lucerne	Lucerne, Imperial free cities
Eastern hemisphere	Hemispheres
Hertfordshire	Hertfordshire, Ceremonial counties of England
Lower Jurassic	Jurassic
Congress	Legislatures
Personal digital assistant	Computers
Iberian Peninsula	Ancient history, Regions of Europe, Peninsulas
Kim Kardashian	1980 births, Living people, Actors from Los Angeles, California, American crime victims, American fashion designers, American movie actors, American socialites, Bloggers, Businesspeople from Los Angeles, California, Democrats (United States), Kardashian family, Models from Los Angeles, California, Television personalities from Los Angeles, California, Writers from Los Angeles, California, American bloggers
Ilham Aliyev	1961 births, Living people, Prime Ministers of Azerbaijan, Presidents of Azerbaijan, Current national leaders, Politicians from Baku
Flag of Armenia	Armenian culture, National flags
Lake Sevan	Geography of Armenia, Lakes of Asia
Armenian Kingdom of Cilicia	History of Armenia, 1198 establishments, 1375 disestablishments, 1190s establishments in Asia, 14th century disestablishments in Asia, 1190s establishments in Europe, Disestablishments in Europe
Jean Genet	1910 births, 1986 deaths, Cancer deaths in France, Deaths from throat cancer, French criminals, French LGBT people, French novelists, French playwrights, French poets, LGBT writers, Political activists, Writers from Paris
Lisa Loeb	1968 births, Living people, Singers from Maryland, American rock guitarists, American folk musicians, Musicians from Maryland, People from Bethesda, Maryland
Mountain Time Zone	Time zones
Data structure	Data structures
Alex Lifeson	1953 births, Canadian guitarists, Living people, People from British Columbia, Musicians from Toronto
Hepatitis C	Diseases caused by viruses, Liver disease, Sexually transmitted diseases
Michel Foucault	1926 births, 1984 deaths, 20th century philosophers, Deaths from AIDS, French academics, French atheists, French LGBT people, French philosophers, French sociologists, Gay men, Infectious disease deaths in France, LGBT academics, LGBT scientists, LGBT writers, People from Poitiers
XHTML	Computer file formats
Suspension bridge	Suspension bridges
Sangria (colour)	Shades of violet, Shades of red
Coulomb	SI units
Leonhard Euler	1707 births, 1783 deaths, Swiss mathematicians, Music theorists, Swiss scientists, Theoretical physicists, People from Basel
Pigment	Pigments, Materials, Chemical synthesis
Anarchy in the U.K.	1976 songs, Sex Pistols, 1994 songs, Megadeth
My Chemical Romance	2000s establishments in New Jersey, 2000s American music groups, 2010s American music groups, American punk bands, Pop punk bands, Musical groups disestablished in 2013, Musical groups established in 2001, Musical groups from Jersey City, New Jersey, My Chemical Romance, Warner Bros. Records artists
1180	1180
Tarsier	Primates
Theoretical computer science	Theoretical computer science
Pedestrian	Land transport
Patti Deutsch	1943 births, 2017 deaths, Cancer deaths in Los Angeles, American movie actors, American voice actors, American comedians, American television actors, Actors from Pittsburgh, Pennsylvania
Body double	Entertainment occupations, Performing arts
Intergenerational conflict	Sociology
Intergenerational contract	Society
Inca rope bridge	Suspension bridges, Inca civilization, Ropework
Ewok	Fictional characters introduced in 1983, Star Wars species, Fictional races
Inca road system	Inca_civilization
Columbia Pictures	Movie studios, Sony, Coca-Cola, Companies based in California
Jason	People in Greek mythology
Color code	Color, Encodings
Complementary color	Color
Decriminalization	Law
Battledress	War
SketchUp	Software
Islamism	Islam
Poitiers	Poitiers, Departmental capitals in France, Former regional capitals in France
Valence, Drôme	Communes in Drôme, Departmental capitals in France
Anvil	Tools, Percussion instruments
Inca Empire	Inca civilization, Former empires, 1197 establishments, 1532 disestablishments, Former monarchies of South America, 16th century disestablishments in South America
Pre-Columbian era	Native American, Periods and ages in history
Duct tape	Tools
Text editor	software
Valency	Chemistry
OS	Redirects from acronyms
Valence (Charente)	Communes in Charente
Valence (Tarn-et-Garonne)	Communes in Tarn-et-Garonne
Valence-d'Albigeois	Communes in Tarn
Valence-en-Brie	Communes in Seine-et-Marne
Valence-sur-Baïse	Bastides, Communes in Gers
Bastide	Bastides
Arcade	Architectural elements
Military camouflage	War, Survival skills, Clothing
Assyrian genocide	Genocide
Democratic Republic of Georgia	Former republics, 1918 establishments in Europe, 1921 disestablishments, 1920s disestablishments in Europe
Alternative rock	Rock music, Alternative music
Anne Sullivan	1866 births, 1936 deaths, American teachers, People from Massachusetts, Blind people
Belgrade Philharmonic Orchestra	Orchestras, Belgrade, 1923 establishments in Europe, 20th century establishments in Serbia
Futrono	Cities in Chile
Tigranes the Great	History of Armenia, Monarchs of Armenia
George Canning	1770 births, 1827 deaths, Alumni of the University of Oxford, Chancellors of the Exchequer, People buried in Westminster Abbey, Politicians from London
Chester city walls	History of England, Monuments and memorials in England, Defensive walls, Chester
Physicalism	Epistemology, Philosophical movements and positions
Herd	Zoology, Ethology
Ungulate	Ungulates
Aylesbury	County towns in England, Towns in Buckinghamshire
Augusta, Georgia	Augusta, Georgia, County seats in Georgia, 1736 establishments, 1730s establishments in the Thirteen Colonies, 18th-century establishments in Georgia (U.S. state)
Landsberg Prison	Buildings and structures in Bavaria, Nazism, Prisons in Germany
Melun	Communes in Seine-et-Marne, Departmental capitals in France, Cities in France, World Heritage Sites in France
Midi-Pyrénées	Former administrative regions of France
Alsace	Alsace
Lorraine	Lorraine
Regions of France	Administrative regions of France
Auvergne	Former administrative regions of France, Auvergne-Rhône-Alpes
Lower Normandy	Former administrative regions of France, Normandy
Centre-Val de Loire	Centre-Val de Loire
Champagne-Ardenne	Former administrative regions of France, Grand Est
Upper Normandy	Former administrative regions of France
Limousin	Former administrative regions of France, Nouvelle-Aquitaine
Languedoc-Roussillon	Former administrative regions of France
Poitou-Charentes	Former administrative regions of France
Nord-Pas-de-Calais	Former administrative regions of France
Picardy	Former administrative regions of France, Hauts-de-France
Pays de la Loire	Pays de la Loire
Rhône-Alpes	Former administrative regions of France
Provence-Alpes-Côte d'Azur	Provence-Alpes-Côte d'Azur
Île-de-France	Île-de-France
Pont-l'évêque cheese	French cheeses, Normandy
Livarot cheese	French cheeses, Normandy
Ajaccio	Communes in Corse-du-Sud, Departmental capitals in France, Regional capitals in France
Prefectures in France	Subdivisions of France
Spectrum	Light
Arshak II	Monarchs of Armenia, 350 births, 367 deaths
Tiridates III of Armenia	Monarchs of Armenia, 286 births, 330 deaths
Aotearoa	Māori language
Hagia Sophia	Mosques in Turkey, Eastern Orthodox Church, Cathedrals
Incense	Religious objects, Magic (paranormal), Perfumery
Derbyshire	Derbyshire, Ceremonial counties of England
West Yorkshire	West Yorkshire, Ceremonial counties of England, Yorkshire and the Humber
South Yorkshire	South Yorkshire, Ceremonial counties of England
Salad	Salads, Appetizers
Nottinghamshire	Ceremonial counties of England, Nottinghamshire
Pennines	Mountains of the United Kingdom, Geography of England
International Phonetic Alphabet	Pronunciation, Language transcription
Lake District	Geography of England, World Heritage Sites in the United Kingdom
Khosrov III the Small	339 deaths, Monarchs of Armenia
Queen Isabella of Armenia	1252 deaths, Monarchs of Armenia
Argishti II of Urartu	Monarchs of Armenia, Urartu, Year of birth unknown, Year of death unknown
Xerxes of Armenia	212 BC deaths, Monarchs of Armenia
Yorkshire and the Humber	Yorkshire and the Humber
Sophene	Places of Ancient Rome, History of Armenia, 3rd-century BC establishments, 1st-century BC disestablishments
Seleucid Empire	History of Persia, Ancient history of Azerbaijan, History of Pakistan, History of the Middle East
Westmorland	1889 establishments in England, 1974 disestablishments in the United Kingdom, British shires, Historic counties of England
Historic counties of England	History of England, Historic counties of England, Lists of counties, Lists about England
Ceremonial counties of England	Counties of England
Counties of England	Counties of England
Lord Lieutenant	British monarchy
Samus Aran	Fictional characters introduced in 1986, Video game characters, Metroid, Nintendo video game characters
Metroid (series)	Metroid
Michelson–Morley experiment	Experiments, Relativity
Hydrogen sulfide	Sulfur compounds
William Petty, 2nd Earl of Shelburne	1737 births, 1805 deaths, Irish politicians, British Marquesses, People from Dublin, Whig party (UK) politicians
William Cavendish-Bentinck, 3rd Duke of Portland	1739 births, 1809 deaths, English Dukes, Politicians from Nottinghamshire
Newbie	Internet slang
Bodhisattva	Bodhisattvas
Tackey and Tsubasa	Japanese musical groups
Fruits Basket	1998 manga, 2010s anime, Anime series based on manga
Middle-earth characters	Middle-earth, Characters in written fiction
Feudalism	Feudalism
Leo III of Armenia	1236 births, 1289 deaths, Monarchs of Armenia
Armens	Ancient Armenia, Armenian people
History of Armenia	History of Armenia
First Republic of Armenia	1918 establishments, 1920 disestablishments
Smaug	Fictional characters introduced in 1937, Fictional dragons, Characters in The Hobbit
Georgian language	Caucasian languages, Languages of Azerbaijan
Mount Ararat	Mountains of Turkey
South Caucasus	Eastern Europe, Caucasus
Mongols	Ethnic groups in Asia, Mongol peoples, Mongolian people
La Liga	La Liga, 1929 establishments in Europe, 1920s establishments in Spain
Stanley Marcus	1903 births, 2002 deaths, Businesspeople from Texas
Collectivity of Saint Martin	Saint Martin, Overseas Territories of France
Sint Maarten	Dependent territories, Sint Maarten
French overseas collectivities	Subdivisions of France
Saint Barthélemy	Saint Barthélemy
Hispaniola	Caribbean islands, Geography of the Dominican Republic, Geography of Haiti
Juventus F.C.	Juventus F.C., 1897 establishments in Europe, 1890s establishments in Italy
William Cavendish, 4th Duke of Devonshire	1720 births, 1764 deaths, English Dukes, Knights of the Garter
John Stuart, 3rd Earl of Bute	1713 births, 1792 deaths, Politicians from Edinburgh, Scottish Earls
Spencer Compton, 1st Earl of Wilmington	1674 births, 1743 deaths, British Earls, Knights of the Garter, Knights of the Bath, Former members of the British House of Commons
Charles Watson-Wentworth, 2nd Marquess of Rockingham	1730 births, 1782 deaths, British Marquesses, People from South Yorkshire, Members of the House of Lords
Frederick North, Lord North	1732 births, 1792 deaths, British Earls, Knights of the Garter, Politicians from London
Flyweight	Boxing
Newtonian telescope	Telescopes
Project management	Business, Management
Vitré	Communes in Ille-et-Vilaine
Shiver me timbers	Phrases
Carcharodontosaurus	Dinosaurs of Africa, Cretaceous dinosaurs, Carnosaurs
Nastika	Hinduism, Philosophy
Capsicum	Vegetables, Capsicum, Spices
Cinnamomum	Lauraceae
London Stock Exchange	Stock exchanges
The 4400	Science fiction television series, English-language television programs
Foyle's War	2002 British television series debuts, British drama television series, Police television series, ITV television programmes, English-language television programs
Giant anteater	Xenarthrans
Sanctuary (TV series)	2008 Canadian television series debuts, 2011 television series endings, 2000s Canadian television series, 2010s Canadian television series, Fantasy television series, Science fiction television series, 2011 disestablishments in Canada
William Lamb, 2nd Viscount Melbourne	1779 births, 1848 deaths, Irish Viscounts, United Kingdom Barons
Silicon Valley	Business, San Francisco Bay Area
Signal (biology)	Physiology, Ethology
Robert Gascoyne-Cecil, 3rd Marquess of Salisbury	1830 births, 1903 deaths, British Marquesses, Politicians from Hertfordshire
Electrophysiology	Physiology, Medical imaging
Ion channel	Biochemistry
Henry Addington, 1st Viscount Sidmouth	1757 births, 1844 deaths, British Viscounts, Politicians from London, Legislative speakers, Chancellors of the Exchequer
Augustus FitzRoy, 3rd Duke of Grafton	1735 births, 1811 deaths, English Dukes, Knights of the Garter, Politicians from Suffolk, Privy Councillors (UK)
William Wyndham Grenville, 1st Baron Grenville	1759 births, 1834 deaths, Alumni of the University of Oxford, British Barons, People educated at Eton College, Politicians from Buckinghamshire
Robert Jenkinson, 2nd Earl of Liverpool	1770 births, 1828 deaths, British Earls, Politicians from London
Frederick John Robinson, 1st Viscount Goderich	1782 births, 1859 deaths, British Earls, British Viscounts, Politicians from London
Arthur Wellesley, 1st Duke of Wellington	1769 births, 1852 deaths, British military people, United Kingdom Barons, United Kingdom Viscounts, United Kingdom Earls, United Kingdom Marquesses, United Kingdom Dukes, Knights of the Garter, Knights Grand Cross of the Order of the Bath, Privy Councillors (UK), Fellows of the Royal Society, Knights of the Bath, People from Dublin, Members of the House of Lords
Charles Grey, 2nd Earl Grey	1764 births, 1845 deaths, United Kingdom Earls, People from Northumberland
John Russell, 1st Earl Russell	1792 births, 1878 deaths, United Kingdom Earls, Politicians from London
Henry Temple, 3rd Viscount Palmerston	1784 births, 1865 deaths, People buried in Westminster Abbey, Irish Viscounts
George Hamilton-Gordon, 4th Earl of Aberdeen	1784 births, 1860 deaths, Members of the House of Lords, Politicians from Edinburgh, Privy Councillors (UK), Scottish Earls, Secretaries of State of the United Kingdom, United Kingdom Viscounts
Edward Smith-Stanley, 14th Earl of Derby	1799 births, 1869 deaths, English Earls, Politicians from Lancashire
Archibald Primrose, 5th Earl of Rosebery	1847 births, 1929 deaths, Scottish Earls, United Kingdom Earls, United Kingdom Barons
Henry Campbell-Bannerman	1836 births, 1908 deaths, Scottish politicians
United States Census Bureau	United States government agencies, United States Census
Signal processing	Communication
Henri Troyat	French writers, Biographers, 1911 births, 2007 deaths, Members of the Académie française
Rondônia	Rondônia, States of Brazil
Singular	Grammar
Cantons of Switzerland	Cantons of Switzerland
Nervous system	Nervous system
Alexandre Dumas, fils	1824 births, 1895 deaths, French playwrights, French novelists, Burials at Montmartre Cemetery, Paris, Members of the Académie française
Conjunctivitis	Infectious diseases
John Barrowman	Actors from Glasgow, Actors from Illinois, American movie actors, American stage actors, American television actors, American television presenters, British television personalities, Dancing on Ice participants, Gay men, LGBT actors, LGBT broadcasters, LGBT people from Illinois, LGBT singers, Musicians from Glasgow, People from Joliet, Illinois, Scottish LGBT people, Scottish movie actors, Scottish singers, Scottish stage actors, Scottish television actors, Scottish television presenters, Singers from Illinois, Television personalities from Glasgow, Television personalities from Illinois, 1967 births, Living people
Swamp	Wetlands
Diego Rivera	1886 births, 1957 deaths, Deaths from congestive heart failure, Mexican painters, Mural artists
David Alfaro Siqueiros	1896 births, 1974 deaths, Mexican painters
Avenged Sevenfold	1999 establishments in California, 1990s American music groups, 2000s American music groups, 2010s American music groups, American heavy metal bands, American rock bands, Metalcore bands, Musical groups established in 1999, Musical groups from Huntington Beach, California
Siege	Sieges
River Hull	Rivers of England
Hull (watercraft)	Ship building
Buoyancy	Mechanics
Asura	Hindu gods and goddesses, Buddhist gods and goddesses
Intercontinental ballistic missile	Military
Elevation	Geography
Bastila Shan	Star Wars characters
Darth Revan	Star Wars characters, Video game characters
Kraft Foods	1903 establishments in the United States, 1900s establishments in Illinois, American food companies, Companies based in Illinois
Soft drink	Soft drinks
Lexington, Kentucky	Lexington, Kentucky, County seats in Kentucky, 1782 establishments in North America, 1780s establishments in Virginia
Toby Keith	1961 births, Actors from Oklahoma, American country musicians, American guitarists, American record producers, American singer-songwriters, Living people, Musicians from Oklahoma, Singers from Oklahoma
Redhead	Hair
Owen Spencer-Thomas	1940 births, Living people, People from Hertfordshire, British journalists, Anglicanism
John Inman	1935 births, 2007 deaths, Actors from Lancashire, Deaths from hepatitis, English movie actors, English stage actors, English television actors, English LGBT people, Infectious disease deaths in England, LGBT actors
Edward Abbey	1927 births, 1989 deaths, American military people, Writers from Pennsylvania, Green thinkers, American anarchists, American environmentalists, American novelists, American philosophers, American political writers, American writers, Yale University alumni
List of MPs elected in the 2005 United Kingdom general election	Elections in the United Kingdom, United Kingdom-related lists, 2005 in the United Kingdom, May 2005 events
Rio de Janeiro (state)	Rio de Janeiro (state), States of Brazil
Bretons	Celtic peoples
West Midlands (region)	West Midlands (region)
Midlands	Geography of England
Jaworzno	Cities in Poland
Volt	Electricity
Music competition	Music competitions
Adjudicator	Occupations, Competitions
Criticism	Words
Eduard Hanslick	1825 births, 1904 deaths, Music critics, Czech people
The Fairly OddParents	Animated television series, American television series, American animated television series, Canadian television series, Canadian animated television series, Nickelodeon television series, American television series revived after cancellation, 2001 American television series debuts, 2017 American television series endings, Television series created by Butch Hartman, English-language television programs
Invasion of Poland (1939)	1939 in Europe, 20th century in Poland, Invasions of World War II
Winter War	1939 in Europe, 1940 in Europe, 20th century in Finland, Wars involving the Soviet Union, World War II
Joiner	Woodworking, Construction occupations
Stairs	Construction
Minas Gerais	Minas Gerais, States of Brazil
Ceará	Ceará, States of Brazil
Espírito Santo	Espírito Santo, States of Brazil
Goiás	Goiás, States of Brazil
Maranhão	Maranhão, States of Brazil
Mato Grosso	Mato Grosso, States of Brazil
Hassium	Chemical elements, Transition metals
Roraima	Roraima, 1988 establishments in Brazil, States of Brazil
Santa Catarina (state)	Santa Catarina, 1540s establishments in South America, 16th-century establishments in Brazil, 1542 establishments, States of Brazil
Trail	Trails
The Pardoner's Prologue and Tale	The Canterbury Tales
Final Fantasy XII	Final Fantasy games, 2006 video games, PlayStation 2 games
Final Fantasy IX	Final Fantasy games, 2000 video games, PlayStation games
Final Fantasy (video game)	Final Fantasy games, 1987 video games, Nintendo Entertainment System games
Final Fantasy II	Final Fantasy games, 1988 video games, Nintendo Entertainment System games
Final Fantasy III	Final Fantasy games, 1990 video games, Nintendo Entertainment System games
Final Fantasy IV	1991 video games, Cancelled Nintendo Entertainment System games, Final Fantasy games, Super Nintendo Entertainment System games
Final Fantasy V	Final Fantasy games, 1992 video games, 1998 video games, 1999 video games, 2006 video games
Final Fantasy VI	Final Fantasy games, 1994 video games, 1999 video games, 2007 video games, Super Nintendo Entertainment System games
Final Fantasy VIII	Final Fantasy games, 1998 video games, PlayStation games
Final Fantasy X	Final Fantasy games, 2001 video games, PlayStation 2 games
Final Fantasy X-2	Final Fantasy games, 2003 video games, PlayStation 2 games
Final Fantasy XI	Final Fantasy games, 2002 video games, Massively multiplayer online role-playing games
Ditch	Landforms, War
Flags of Brazilian states	States of Brazil, Lists of flags
Chobits	Manga, Anime
Brossard, Quebec	Cities and towns in Quebec
Master of Puppets	Metallica albums, 1986 albums, Heavy metal albums
Anton Bruckner	Austrian composers, Romantic composers, Organists, 1824 births, 1896 deaths
Rondo	Musical forms
Military engineering	Engineering, War
Melisma	Musical performance techniques
Spinet	Keyboard instruments, Early musical instruments, Plucked string instruments
United Artists	Movie studios, Companies based in California, 1919 establishments in the United States, Time Warner
Metro-Goldwyn-Mayer	Movie studios, Companies based in Los Angeles, 1924 establishments in the United States, 1981 disestablishments in the United States, Time Warner, 1920s establishments in California, 1980s disestablishments in California
Intercontinental Cup	Football competitions, UEFA, CONMEBOL, FIFA, 2000 establishments
Hafizullah Amin	1929 births, 1979 deaths, Assassinated people, Presidents of Afghanistan, Prime Ministers of Afghanistan
Paraíba	Paraíba, 16th-century establishments in Brazil, States of Brazil
Mato Grosso do Sul	Mato Grosso do Sul, States of Brazil
Swimming pool	Water, Leisure
Danny Elfman	1953 births, Living people, Singer-songwriters from California, Singers from Los Angeles, California, American composers, Grammy Award winners, Emmy Award winners, Musicians from Los Angeles, California
FIFA 07	2007 video games, FIFA, Sports video games, PlayStation 2 games, PlayStation Portable games, Xbox games, Xbox 360 games, Game Boy Advance games, Nintendo GameCube games, Nintendo DS games, Windows games
Ralph Waldo Emerson	1803 births, 1882 deaths, 19th-century American poets, 19th century philosophers, American philosophers, Deaths from pneumonia, Disease-related deaths in Massachusetts, Infectious disease deaths in the United States, Writers from Massachusetts
Bushranger	History of Australia, Crime, Bushrangers
The bush	Biomes, Geography of Alaska, Geography of Australia, Geography of Canada, Geography of New Zealand
Moondyne Joe	1826 births, 1900 deaths, Australian criminals, Bushrangers, People from Cornwall
Fremantle, Western Australia	Cities in Western Australia, Perth, Western Australia
Standard deviation	Statistics
53 BC	53 BC
Harry Potter and the Deathly Hallows	2007 books, Harry Potter books
Boiling	Cooking methods, Chemical processes, Heat transfer, Gases
Swan River	Rivers of Western Australia, Perth, Western Australia
Dirk Nowitzki	1978 births, Dallas Mavericks players, German basketball players, Living people, People from Würzburg, Sportspeople from Bavaria
Volkach	Kitzingen Rural District
Kitzingen (district)	Kitzingen Rural District
Haflinger	Horse breeds
Kevin Kurányi	1982 births, Living people, German footballers, Footballers from Rio de Janeiro
Würzburger Kickers	German football clubs, Sport in Bavaria, Würzburg
Chico, California	Cities in California, Cities in the Central Valley of California, 1860 establishments in the United States, Settlements in Butte County, California, 1860s establishments in California
Repperndorf	Villages in Bavaria, Kitzingen Rural District
Großlangheim	Villages in Bavaria, Municipalities in Bavaria, Kitzingen Rural District
Falun Gong	Religion in China, New religious movements
Deflation	Inflation
Chemical symbol	Symbols, Chemical elements
Secretary of State	Government occupations
Official	Occupations
Heteroptera	Hemiptera
Snuff	Tobacco
The Nose (opera)	1930s operas, Compositions by Dmitri Shostakovich, 1930 works
Video game developer	Video game people
Video game publisher	Technology companies, Video game people
Cork (city)	Cork (city), 6th century establishments in Europe, County towns in Ireland
County Cork	Gaeltacht, County Cork
Genie	Islam, Middle East, Mythology, Folklore
Cork	Basic English 850 words
Suikoden	Role-playing video games
Kendo	Martial arts, Sport in Japan
Paleontology	Paleontology, Evolutionary biology, Earth sciences
Cotswolds	Warwickshire, Geography of England
Piauí	Piauí, States of Brazil
Rio Grande do Norte	Rio Grande do Norte, 1499 establishments, Establishments in Brazil, States of Brazil
Brazilian Federal District	Brazilian Federal District, 1960 establishments, 1960s establishments in Brazil
Hiromu Shinozuka	Japanese manga artists, 1979 births, Living people, People from Fukuoka Prefecture
Zvečan	Towns in Europe, Settlements in Serbia
Rosario	Cities in Argentina
Gymnastics	Gymnastics
Atahualpa	1500s births, 1533 deaths, South American people, Inca rulers
Die Meistersinger von Nürnberg	Operas, Compositions by Richard Wagner
Takbir	Islam
Shire	Counties of the United Kingdom
Fairy Tail	2012 anime OVAs
Viol	String instruments, Early musical instruments
Regnitz	Geography of Bavaria, Rivers of Germany
Geir Ivarsøy	Computer scientists, 1957 births, 2006 deaths, Opera ASA, Norwegian people
Color wheel	Color
Rerun	Television, Radio
Cutaway	Television, Movie production
Cherie Blair	1954 births, Living people, Spouses of Prime Ministers of the United Kingdom, Alumni of the London School of Economics, British lawyers, English Roman Catholics, People from Bury, Women lawyers, BBC 100 Women
Regions of Slovakia	Geography of Slovakia
Districts of Slovakia	Geography of Slovakia
Žilina	Cities in Slovakia
Renting	Economics, Property
Prešov	Cities in Slovakia
Trnava	Cities in Slovakia
Nitra	Cities in Slovakia
Trenčín	Cities in Slovakia
Banská Bystrica	Cities in Slovakia
Social realism	Genres, Russia, Art movements
Scottish Premier League	Scottish Football League, 1998 establishments in the United Kingdom, 2013 disestablishments in the United Kingdom, 1990s establishments in Scotland
Metropolitan county	Metropolitan counties of England
Unitary authority	Political systems, Local government in England, Local government in the United States, Government of Canada, Government of New Zealand
Administrative division	Political subdivisions
County council	Political systems, History of the United Kingdom, Scotland, Local government in England, Local government in the United States
L. Ron Hubbard	1911 births, 1986 deaths, Cardiovascular disease deaths in California, Deaths from stroke, Scientologists, Writers from Nebraska
East Midlands	East Midlands
List of Pirates of the Caribbean characters	Pirates of the Caribbean characters
Greater Nottingham	Nottinghamshire
Hanau	Towns in Hesse, Cities in Hesse, Hanau
John Montagu, 4th Earl of Sandwich	1718 births, 1792 deaths, People with foods named after them, British Earls
Nottingham	Nottingham, Unitary authorities
Little Red Riding Hood	Works by Charles Perrault, Grimms' Fairy Tales
Dettelbach	Kitzingen Rural District
Albertshofen	Kitzingen Rural District, Villages in Bavaria, Municipalities in Bavaria
Kitzingen	Kitzingen Rural District
Wiesenbronn	Villages in Bavaria, Municipalities in Bavaria, Kitzingen Rural District
Neuhof	Villages in Bavaria, Municipalities in Bavaria
Geiselwind	Municipalities in Bavaria, Kitzingen Rural District
Markt Einersheim	Villages in Bavaria, Municipalities in Bavaria, Kitzingen Rural District
Mainbernheim	towns in Bavaria, Kitzingen Rural District
Robert College	Schools, Buildings and structures in Turkey
Demonym	Words
Gettysburg Address	American Civil War, 1863 in Pennsylvania, Abraham Lincoln, Speeches, Gettysburg, Pennsylvania, November events
Gabriel Fauré	1845 births, 1924 deaths, Deaths from pneumonia, 20th century composers, Romantic composers, French composers, French organists, Legion of Honour
Music critic	Music critics
Pete Maravich	American basketball players, Atlanta Hawks players, Boston Celtics players, Utah Jazz players, Sportspeople from Pennsylvania, 1947 births, 1988 deaths, National Basketball Association players with retired numbers
John Batman	1801 births, 1839 deaths, Australian explorers, People from Sydney, Australian businesspeople, Australian politicians
Royal Leamington Spa	Spa towns in the United Kingdom, Towns in Warwickshire, Royal Towns in the United Kingdom
Violence	Violence
Pegnitz River	Geography of Bavaria, Rivers of Germany
Palaemon	Greek gods and goddesses
William Wordsworth	1770 births, 1850 deaths, Alumni of the University of Cambridge, British poets laureate, English poets, People from Cumbria
Short Parliament	History of the British Isles, Parliaments
Pelé	1940 births, 1958 FIFA World Cup players, 1962 FIFA World Cup players, 1966 FIFA World Cup players, 1970 FIFA World Cup players, Brazilian footballers, Living people
Rain shadow	Meteorology, Mountains
Lesson	Learning
Marián Hossa	1979 births, Atlanta Thrashers players, Chicago Blackhawks players, Detroit Red Wings players, Living people, Ottawa Senators players, Pittsburgh Penguins players, Portland Winterhawks players, Slovak ice hockey players, Stanley Cup champions, Memorial Cup winners, Swedish Hockey League players
Fashion	Fashion
South West England	South West England
South East England	South East England, 1994 establishments in England
North East England	North East England
Sussex	Sussex
Kingdom of Sussex	Anglo-Saxons, Petty kingdoms of England
Annals	History
Cicero	106 BC births, 43 BC deaths, Roman people, Ancient Roman writers
Heavyweight	Boxing
Genealogy	Family, Social sciences
Niels Bohr	1885 births, 1962 deaths, Danish Jews, Danish scientists, Jewish scientists, Nuclear physicists, People from Copenhagen, Theoretical physicists, Danish Nobel Prize winners
Świnoujście	Towns in Poland
Sky Odyssey	Simulator video games, 2000 video games, Activision games, PlayStation 2 games, PlayStation 2-only games, Video games developed in Japan
Landform	Landforms
Piri Reis map	Cartography
Shadow of the Colossus	2005 video games, PlayStation 2 games, PlayStation 2-only games, Video games developped in Japan
Verbandsgemeinde	Settlements in Rhineland-Palatinate, Settlements in Saxony-Anhalt
Osburg	Municipalities in Rhineland-Palatinate, Trier-Saarburg
Farschweiler	Municipalities in Rhineland-Palatinate, Trier-Saarburg
Requiem	Christian music, Musical forms
Middle C	Musical terminology, Musical notation
Principality	Forms of government
Vlad III the Impaler	1431 births, 1476 deaths, Romanian leaders, Princes and princesses
Fertile Crescent	Middle East, Ancient history
Crescent	Symbols, Religious symbols, Moons
The Levant	Middle East
Jordan River	Rivers of Israel, Rivers of Jordan, Rivers of Syria, West Bank
History of Islam	History of Islam
History of Christianity	History of Christianity
Timeline of Christianity	History of Christianity, Timelines
List of coats of arms of the districts in Rhineland-Palatinate	Germany-related lists, Rhineland-Palatinate, Coats of arms of Germany
Schism (religion)	Church organization, Controversies
Proselyte	Biblical people, Judaism
Twelve Apostles	Twelve Apostles
Oriental Orthodoxy	Oriental Orthodoxy
Dogma	Christian theology
State religion	Religion
Mass (music)	Masses (music)
Ecumenical council	Councils
Camille Saint-Saëns	French composers, Romantic composers, French pianists, French organists, 1835 births, 1921 deaths
Fly to the Sky	R&B bands, South Korean musical groups, 1998 establishments in Asia, 1990s establishments in South Korea
Bram Stoker	1847 births, 1912 deaths, Irish novelists, Writers from Dublin
Criss Angel	1967 births, Living people, Entertainers from New York, American magicians
TVXQ	South Korean boy bands, J-pop bands, K-pop music groups, 2003 establishments in South Korea
Ayumi Hamasaki	1978 births, Living people, Singers from Fukuoka Prefecture
Love Generation	Japanese television series, Drama television series
Psyche (mythology)	Greek gods and goddesses
Thomas Hopkins Gallaudet	1787 births, 1851 deaths, American teachers, People from Philadelphia, Pennsylvania, Yale University alumni
Annelid	Annelids
Polychaete	Annelids, Extremophiles
Lugworm	Annelids
Alitta succinea	Annelids
Protozoa	Protozoa
Hematophagy	Parasitism
Crinoidea	Echinoderms
Yorkshire Dales	North Yorkshire
Suwanee, Georgia	Gwinnett County, Georgia, Cities in Georgia (U.S. state)
Cumming, Georgia	Cities in Georgia (U.S. state), County seats in Georgia
Athens, Georgia	Cities in Georgia (U.S. state), County seats in Georgia
Anaerobic digestion	Energy, Zoology, Physiology
Clarke County, Georgia	Georgia (U.S. state) counties, 1801 establishments in the United States, 1800s establishments in Georgia (U.S. state)
Forsyth County, Georgia	Georgia (U.S. state) counties, 1832 establishments in Georgia (U.S. state)
Johns Creek, Georgia	Cities in Georgia (U.S. state), Fulton County, Georgia
The Black Parade	My Chemical Romance, 2006 albums
Biogas	Biofuels
Liturgy	Worship
Mass (liturgy)	Christian worship and liturgy
Woodpecker	Piciformes
Piri Reis	1460s births, 1554 deaths, Admirals, Cartographers, Asian explorers, Turkish military people
Walter Sutton	American biologists, American physicians, Cell biology, Columbia University alumni, scientists from New York, Scientists from Kansas, 1877 births, 1916 deaths, People from Utica, New York
Darth Maul	Fictional characters introduced in 1999, Star Wars Anthology characters, Star Wars Skywalker Saga characters, Tony Hawk's (series) guest characters
Probe droid	Star Wars
Count Dooku	Fictional characters introduced in 2002, Star Wars characters
Clone Wars	Star Wars
Prokaryote	Cell biology
Cuttlebone	Zoology
Decapodiformes	Cephalopods
Octopodiformes	Cephalopods
Octopoda	Cephalopods
Vampyromorphida	Cephalopods
Diana Burrell	English composers, People from Norwich, Women composers, 1948 births, Living people, Alumni of the University of Cambridge
James (son of Zebedee)	Year of birth unknown, 44 deaths, Early Christian saints, Twelve Apostles, 1st century births, Pharmacists
Vampire squid	Cephalopods
Classical Greece	Ancient Greece
Gwinnett County, Georgia	Georgia (U.S. state) counties, Gwinnett County, Georgia, 1818 establishments in Georgia (U.S. state)
University of Georgia	Colleges and universities in Georgia (U.S. state), Oak Ridge Associated Universities, Southeastern Conference, 1785 establishments in the United States, 18th-century establishments in Georgia (U.S. state)
Gerhard Armauer Hansen	1841 births, 1912 deaths, Norwegian physicians
Fire station	Buildings and structures, Firefighting
Outhouse	Waste
Fence	Architectural elements, Walls
Princeton University	Princeton University, Association of American Universities, Collegiate Water Polo Association, ECAC Hockey, Ivy League, 1746 establishments, 1740s establishments in the Thirteen Colonies, 18th-century establishments in New Jersey
Dill	Herbs, Apiaceae
Mummification	Death customs
Bandage	Medical equipment
Xenophobia	Phobias
Confederacy of Independent Systems	Star Wars
Hedone	Greek gods and goddesses
Psyche (psychology)	Psychology
Lamellibrachia	Annelids
Giant tube worm	Annelids
Trans-Siberian railway	Transport in Russia, Rail transport in Asia, Rail transport in Europe
Nuclear reaction	Nuclear physics
St Paul's Cathedral	Buildings and structures in London, Anglican Cathedrals, Cathedrals in England, City of London, Churches in the United Kingdom
Greenhouse	Gardening, Agricultural buildings
Apprenticeship	Learning
Battle droid	Fictional characters introduced in 1999, Star Wars characters
Western long-beaked echidna	Monotremes
Short-beaked echidna	Monotremes
Eastern long-beaked echidna	Monotremes
Long-beaked echidna	Monotremes
Sir David's long-beaked echidna	Monotremes
Bioluminescence	Physiology, Biochemistry, Light sources
Whittier, Alaska	Cities in Alaska
Kate Winslet	1975 births, Living people, Academy Award winning actors, Actors from Berkshire, BAFTA Award winning actors, Emmy Award winning actors, English movie actors, English singers, English television actors, Golden Globe Award winning actors, Grammy Award winners, Musicians from Berkshire, People from Reading, Berkshire, Screen Actors Guild Award winners
Joe DiMaggio	1914 births, 1999 deaths, American baseball players, Deaths from lung cancer, New York Yankees players, National Baseball Hall of Fame members, Sportspeople from Los Angeles, California
Mongol Empire	Mongol Empire, History of Mongolia, 1206 establishments, 1360s disestablishments, 1200s establishments in Asia, 14th century disestablishments in Asia
Parthia	Ancient Rome, Ancient history, Iran, History of Pakistan, History of Persia, Ancient history of Azerbaijan
238 BC	230s BC
1312	1312
1422	1422
Hydrolysis	Chemistry
Water (molecule)	Water
Lymphatic system	Physiology, Immunology, Lymphatic system
Chastity	Human sexuality
Metallic bond	Chemical bonding, Metals
Heat conduction	Basic physics ideas, Heat transfer
Judith Weir	1954 births, Living people, 20th century composers, 21st century composers, British composers, People from Cambridge, Women composers
Vassal	History
Migration period	Periods and ages in history
San Francisco Bay Area	San Francisco Bay Area
San Francisco Bay	San Francisco Bay Area, Bodies of water of California, Bays of the United States, Alameda County, California, Santa Clara County, California, Contra Costa County, California, Solano County, California, San Mateo County, California, Marin County, California
Ahmed Yassin	1937 births, 2004 deaths, Deaths by airstrike, Assassinated people, Muslim terrorists, Palestinian Muslims, Palestinian nationalists, Palestinian terrorists
Field strength	Physics
Field (physics)	Basic physics ideas
Gradient	Mathematics, Calculus
Trigonometric function	Trigonometry, Wave physics
Archery	Archery, War, Summer Olympic sports
John Cena	1977 births, Living people, American television actors, American movie actors, American professional wrestlers, WWE wrestlers, Actors from Massachusetts, Sportspeople from Massachusetts, American voice actors
Signal transduction	Cell biology, Molecular biology
Flux	Physical quantity, Mathematics
Neuroscience	Neuroscience
Conversation analysis	Science, Human communication
Mark-Anthony Turnage	1960 births, Living people, 20th century composers, 21st century composers, English composers
Hydrothermal vent	Geology, Extremophiles, Protista, Biomes
Guava	Myrtaceae, Tropical fruit
Resting potential	Biochemistry
Thrust	Force
Robert A. Heinlein	1907 births, 1988 deaths, Hugo Award winning writers, Writers from Missouri, Libertarians
List of video game genres	Video game genres
Fable	Fairy tales
Drainage	Agriculture, Engineering
Polder	Physical geography
Resistor	Electronic components
Death Star	Star Wars, Science fiction technology
Doctor of Philosophy	Academia, Academic degrees
Global 200	Ecozones
Ecoregion	Ecoregions
Wetland	Wetlands
Marsh	Wetlands
Ulan-Ude	Siberia
Pelagic zone	Biological oceanography, Ecology, Biomes
Vitamin A	Fat-soluble vitamins
Vitamin D	Fat-soluble vitamins, Steroid hormones
Biome	Biomes
Vitamin E	Fat-soluble vitamins
Vitamin K	Fat-soluble vitamins
B vitamins	B vitamins
Subarctic climate	Climate
ONS coding system	Geography of the United Kingdom, Geocodes
Michael Tippett	1905 births, 1998 deaths, 20th century composers, British autobiographers, Companions of Honour, Commanders of the Order of the British Empire, Deaths from pneumonia, English composers, English LGBT people, Gay men, Infectious disease deaths in England, Knights Bachelor, LGBT composers, Musicians from Middlesex, Musicians from Suffolk, Order of Merit
Claw	Animal anatomy
Max and Moritz	Comics, Fictional characters
Abstinence	Everyday life, Human sexuality
Sexual abstinence	Human sexuality
Council of Jerusalem	Councils, Jerusalem, New Testament, 1st century
Ironing	Home
Central European Time	Time zones
Central European Summer Time	Time zones
James the Just	1st century births, 62 deaths, Patriarchs, Early Christian saints, Twelve Apostles
Disciple (Christianity)	New Testament people
Ahmed Jibril	1938 births, 2021 deaths, Muslim terrorists, Palestinian Muslims, Palestinian nationalists, Palestinian terrorists
Jihad Ahmed Jibril	1961 births, 2002 deaths, Assassinated people, Muslim terrorists, Palestinian Muslims, Palestinian nationalists, Palestinian terrorists, People from Damascus
Topkapı Palace	palaces, Buildings and structures in Turkey
Acts of the Apostles	New Testament books
Firebreak	Firefighting
Slum	Cities, Shanty towns
Montauban	Cities in France, Communes in Tarn-et-Garonne, Departmental capitals in France
Layyah	Cities in Pakistan
Pope Leo III	8th century births, 816 deaths, Italian popes
Khanda	Sikhism, Religious symbols
Judi Dench	1934 births, Living people, Academy Award winning actors, Actors from Yorkshire, Actors who played M, BAFTA Award winning actors, Companions of Honour, English movie actors, English stage actors, English television actors, English voice actors, Golden Globe Award winning actors, Knights and Dames Commander of the Order of the British Empire, Musical theater actors, People from York, Royal Society of Arts, Tony Award winning actors
Arendal	Cities in Norway, Municipalities of Norway, Port cities and towns of the North Sea
S.S. Lazio	Italian football clubs, Lazio, 1900 establishments in Italy
Satire	Non-fiction literature, Satire
Iron Cross	Military honors, History of Germany, Orders, decorations, and medals of Germany, 1813 establishments, 1810s establishments in Germany
Manowar	American heavy metal bands, Power metal bands
Power series	Mathematics
Classical guitar	Guitars
Vålerenga Fotball	Norwegian football clubs, Oslo, 1913 establishments in Europe, 1910s establishments in Norway
Volga River	Rivers of Russia, Tatarstan
Oi!	Punk rock
Brothers Grimm	Fairy tales, People from Hanau, Writers from Hesse
Bryozoa	Invertebrates, Animal phyla
Placebo	Drugs
Identity (mathematics)	Mathematics
Equality (mathematics)	Mathematics, Geometry
Religious ministry	Church organization, Christian behavior and experience
Ministry (government department)	Government
Galerius	250s births, 311 deaths, Roman Emperors
Square foot gardening	Gardening
Blender	Cooking appliances
Drinking straw	Food utensils
Whole-tone scale	Music theory
Pentatonic scale	Music theory
Major scale	Major scales
Minor scale	Minor scales
Yeast	Fungi
Budding	Biological reproduction
Binary fission	Methods of reproduction, Bacteria
Charisma Carpenter	1970 births, Living people, American movie actors, Whedonverse, Actors from Las Vegas, Nevada, Actors from San Diego, California, American models, American television actors
Paul Watzlawick	American psychologists, Austrian people, People from California, 1921 births, 2007 deaths
Neurotransmitter	Neuroscience
Hard rock	Hard rock
Sally Beamish	1956 births, 20th century composers, 21st century composers, English composers, Living people, Women composers
Nakhodka	Cities in Russia
Sumatra	Greater Sunda Islands, Islands of Indonesia
Whigs	Former political parties in the United Kingdom, 1678 establishments, 1868 disestablishments, 1670s establishments in Europe, 17th century establishments in England, 19th century disestablishments in the United Kingdom, Liberal Party (UK)
Espionage	Espionage
Harrison Birtwistle	1934 births, Living people, 20th century composers, 21st century composers, English composers, Companions of Honour, Knights Bachelor
Lorsch	World Heritage Sites in Germany, Bergstraße (district)
Dominic Monaghan	1976 births, Living people, Actors from Berlin, English movie actors, English television actors
Crazy Horse (cabaret)	Buildings and structures in Paris, Theatres in France
Cnidaria	Cnidarians
Calvinism	Calvinism, John Calvin, Christian movements and denominational families, Protestant Reformation
John Calvin	1509 births, 1564 deaths, Calvinists, Christian ministers, Christian theologians, French Christians, French theologians, John Calvin, People from Geneva, People from Hauts-de-France, Protestant Reformers
Trebuchet	Weapons
Tarascon	Cities in France, Communes in Bouches-du-Rhône
Kurdistan	Iraq, Iran, Turkey, Syria, Kurdistan
Aigues-Mortes	Bastides, Communes in Gard
3 BC	3 BC
6 BC	6 BC
Leopold II of Belgium	1835 births, 1909 deaths, Kings and Queens of Belgium, Human rights abuses, Knights of the Golden Fleece, People from Brussels
George V	1865 births, 1936 deaths, Kings and Queens of the United Kingdom, Deaths by euthanasia, Order of St Michael and St George, Royalty from London, Philatelists
Candy	Candy
Loanword	Language, Words
Moray eel	Teleosts
Anguilloidei	Bony fish
Carcassonne	Bastides, Communes in Aude, Departmental capitals in France, World Heritage Sites in France
Villeneuve-sur-Lot	Bastides, Subprefectures in France, Communes in Lot-et-Garonne
Agen	Cities in France, Departmental capitals in France, Communes in Lot-et-Garonne
Libourne	Bastides, Subprefectures in France, Communes in Gironde, Wine regions of France
Mirepoix (Ariège)	Bastides, Communes in Ariège
Kiss (album)	Kiss albums, 1974 albums, Debut albums, Hard rock albums, Heavy metal albums
Hotter Than Hell	Kiss albums, 1974 albums, Hard rock albums, Heavy metal albums
Dressed to Kill	Kiss albums, 1975 albums, Hard rock albums, Heavy metal albums
Alive!	Kiss albums, 1975 albums, Hard rock albums, Heavy metal albums
Destroyer (album)	Kiss albums, 1976 albums, Hard rock albums, Heavy metal albums
12-hour clock	Clocks
Norfolk County Fair and Horse Show	Festivals in Canada, Ontario, 19th-century establishments in Canada
Bootylicious	2001 songs, Destiny's Child songs, Songs about sexuality
Rigor mortis	Death
Colosseum	Buildings and structures in Rome, 1st century establishments in Europe, Establishments in Italy
Amphitheatre	Buildings and structures
Circus Maximus	Buildings and structures in Rome
Peter Maxwell Davies	1934 births, 2016 deaths, 20th century composers, 21st century composers, Cancer deaths in Scotland, Deaths from leukemia, English composers, LGBT musicians, People from Salford, Greater Manchester, Scottish LGBT people
Take That	1990 establishments in England, 1990s British music groups, 2000s British music groups, 2010s British music groups, Brit Award winners, British boy bands, English pop music groups, Musical groups established in 1990, Boy bands, English boy bands
Ambulance	vehicles, Emergency services
Gan language	Sino-Tibetan languages
Rock and Roll Over	Kiss albums, 1976 albums, Hard rock albums, Heavy metal albums
Love Gun	Kiss albums, 1977 albums, Hard rock albums
Alive II	Kiss albums, 1977 albums, Hard rock albums, Heavy metal albums
Henry IV, Holy Roman Emperor	Holy Roman Emperors
Gene Simmons (album)	Kiss albums, 1978 albums, Rock albums
Paul Stanley (album)	Kiss albums, 1978 albums, Hard rock albums
Ace Frehley (album)	1978 albums, Debut albums, Hard rock albums, Heavy metal albums, Kiss albums
Tristan und Isolde	Operas, Compositions by Richard Wagner
Peter Criss (album)	Kiss albums, 1978 albums, Rock albums, Pop albums
Pop Rocks	Candy
Dynasty (album)	Kiss albums, 1979 albums, Hard rock albums, Disco albums
Master of the Queen's Music	British music, Musicians, British monarchy
Unmasked	Kiss albums, 1980 albums, Pop rock albums, Hard rock albums
Music from "The Elder"	Kiss albums, 1981 albums, Progressive rock albums, Hard rock albums
Cross-platform	Operating systems, Software
Investiture Controversy	History of Europe, Popes, Holy Roman Emperors
Cycas	Plant families, Gymnosperms, Living fossils
Heliconia	Zingiberales
Screenplay	Movie terminology, television
Pope Gregory VII	Italian popes, 1020 births, 1085 deaths, Benedictines
Excommunication	Christian terminology
Helen Clark	BBC 100 Women, 1950 births, Living people, Prime Ministers of New Zealand, Deputy Prime Ministers of New Zealand, Leaders of the Opposition (New Zealand)
Scalable Vector Graphics	Computer file formats, Computer graphics, Vector graphics
Creatures of the Night	Kiss albums, 1982 albums, Heavy metal albums
Full communion	Christian terminology, Church organization
Queue area	Society
Ecclesiology	Christian theology
Ecclesia (Church)	Christian theology, Christian terminology, Church organization
Communion (Christian)	Christian theology
Renewable resource	Economics
Derek Taylor	1932 births, 1997 deaths, Cancer deaths in England, English journalists, The Beatles, Writers from Liverpool, Writers from Suffolk
Hot chocolate	Drinks
Diuretic	Drugs
The Byrds	1964 establishments in the United States, 1960s American music groups, 1960s establishments in California, 1970s American music groups, 1980s American music groups, 1990s American music groups, 2000s American music groups, 2000 disestablishments in the United States, American pop music groups, American rock bands, Country bands, Folk music groups, Musical groups disestablished in 2000, Musical groups established in 1964, Musical groups from Los Angeles, California
Meningitis	Infectious diseases
Mental confusion	Symptoms
Lick It Up	Kiss albums, 1983 albums, Heavy metal albums, Hard rock albums
Wesleyan University	Methodism, Christianity in the United States, Colleges and universities in Connecticut, 1831 establishments in the United States, 19th-century establishments in Connecticut
Ben 10	Cartoon Network series, American animated television series, American science fiction television series, 2000s American television series, 2010s American television series, English-language television programs, 2005 television series debuts
Karol Szymanowski	20th century composers, Deaths from tuberculosis, Disease-related deaths in Switzerland, LGBT composers, Polish composers, 1882 births, 1937 deaths
Animalize	1984 albums, Heavy metal albums, Hard rock albums, Kiss albums
Eubie Blake	American jazz musicians, American composers, American pianists, Writers from Baltimore, Maryland, Musicians from Baltimore, Maryland, 1887 births, 1983 deaths
Television director	Television directors
Roseanne	1988 American television series debuts, 2018 television series endings, 1980s American sitcoms, 1990s American sitcoms, 2010s American sitcoms, Illinois in fiction, Television series about dysfunctional families, Television series about marriage, Television series about siblings, English-language television programs
Veronica Mars	2004 American television series debuts, 2007 American television series endings, 2000s American television series, American teen drama television series, Mystery television series, Television series set in California, UPN network shows, English-language television programs
Game Gear	Handheld video games, Sega video game consoles
God the Father	Gods and goddesses
Kevin Smith	1970 births, Living people, Actors from New Jersey, American movie actors, American screenwriters, American television actors, American television producers, American television writers, American voice actors, Kevin Smith, Movie directors from New Jersey, Movie producers from New Jersey, Writers from New Jersey, American bloggers
Nicene Creed	Christian creeds, Ancient Christianity
Apostles' Creed	Christian creeds, Ancient Christianity
Asylum (album)	Kiss albums, 1985 albums, Heavy metal albums, Hard rock albums
Green tea	Tea
Tatami	Japanese culture, Furniture
Sake	Fermented drinks, Japanese culture
Majority	Numbers
Charles Koechlin	1867 births, 1950 deaths, 20th century composers, French composers
Jastrzębie-Zdrój	Cities in Poland
Palm (unit)	Units of length
Schnapps	Alcoholic spirits
Standard time	Time zones
Span (unit of length)	Everyday life
Acting President of the United States	Presidents of the United States
Electric power transmission	Electricity
Electrical grid	Electricity
Darfur conflict	Darfur conflict, 21st century in Africa, Civil wars, Genocide
Darfur conflict bibliography	Darfur conflict
AIESEC	Rotterdam, International organizations, Youth organizations, 1948 establishments
Organelle	Organelles
That '70s Show	1998 American television series debuts, 2006 American television series endings, 1990s American sitcoms, 2000s American sitcoms, American teen television series, Fox television series, Television series set in Wisconsin, English-language television programs
Sivaya Subramuniyaswami	1927 births, 2001 deaths, Hindu gurus, People from Oakland, California
Crazy Nights	Kiss albums, 1987 albums
Hot in the Shade	Kiss albums, 1989 albums
Halfway Home (TV series)	Comedy television series, 2007 television series debuts, English-language television programs
Prime Minister of New Zealand	Prime Ministers of New Zealand, Lists of prime ministers
The Masque of the Red Death	19th-century American short stories, Short stories by Edgar Allan Poe
Darfur	States of Sudan
Mill (grinding)	Tools
Windmill	Tools, Wind energy
Blood transfusion	Blood
Delirium	Symptoms
Jaundice	Symptoms, Liver disease
Hildegard of Bingen	1098 births, 1179 deaths, Christian mystics, German composers, German esotericists, German Roman Catholics, German writers, Medieval composers, Women composers
Alternative medicine	Alternative medicine
Divaldo Pereira Franco	1927 births, Living people, Brazilian people, Bahia
Hindu gods	Hindu gods and goddesses
Coheed and Cambria	American rock bands, Musical groups from New York
Watermill	Tools, Engineering, Hydropower
Coma	Symptoms
Water wheel	Tools, Engineering, Hydropower
Favism	Diseases, Blood
Hydropower	Engineering, Hydropower
South Pacific	Pacific Ocean
Guido von List	1848 births, 1919 deaths, Nazism, Occultists, Writers from Vienna
Franklins	Supermarkets of Australia, 1941 establishments in Australia
Hannover 96	German Bundesliga, German football clubs, Hanover, Sport in Lower Saxony, 1896 establishments in Europe, 1890s establishments in Germany
Water turbine	Tools, Electricity, Hydropower
AWD-Arena	Buildings and structures in Lower Saxony, Football stadiums in Germany, Hanover, Sport in Lower Saxony
Renewable energy	Renewable energy, Environment, Green politics
Aral Sea	Lakes of Kazakhstan
Radiation	Basic physics ideas, Wave physics, Nuclear physics
Non-ionizing radiation	Electromagnetism
Electromagnetic spectrum	Electromagnetism
Revenge (album)	Kiss albums, 1992 albums
Continuum (theory)	Philosophy of science
Joseph Goebbels	1897 births, 1945 deaths, Chancellors of Nazi Germany, Former Roman Catholics, Gauleiters, Government ministers of Nazi Germany, Holocaust perpetrators, Members of the Reichstag (Nazi Germany), Members of the Reichstag (Weimar Republic), Murderers, Nazis who committed suicide, People from Mönchengladbach, Politicians from North Rhine-Westphalia, Politicians of the Nazi Party, Politicians who committed suicide, Suicides by firearm in Germany
Carl Maria von Weber	1786 births, 1826 deaths, German composers, Romantic composers
Alive III	Kiss albums, 1993 albums
Ter Hachatrjan	Russian nobility, Noble families
Turbine	Engineering
Electric power	Electricity, Electromagnetism
Kiss Unplugged	Kiss albums, 1996 albums
Head (hydraulic)	Fluid mechanics
Susan Brownmiller	1935 births, Living people, American activists, American feminists, American journalists, Jewish American writers, Time People of the Year, Writers from New York City
Erich Fromm	1900 births, 1980 deaths, 20th century philosophers, American atheists, American philosophers, American psychologists, Continental philosophers, German atheists, German philosophers, German psychologists, Humanists, Jewish American academics, Jewish American scientists, Jewish American writers, Jewish atheists, Jewish German scientists, Jewish German writers, Jewish philosophers, Psychoanalysts, Refugees from Nazism, Writers from Frankfurt
François Adrien Boieldieu	1775 births, 1834 deaths, French composers
Red Hot Riding Hood	1943 movies, Animated movies, Movies about animals, English-language movies
Turkish Van	Cat breeds
Turkish Angora	cat breeds
Work (physics)	Mechanics, Energy
Psycho Circus	Kiss albums, 1998 albums
Biological warfare	war, Biology
Frankfurt Stock Exchange	1585 establishments, Stock exchanges, Economy of Germany, Frankfurt, Establishments in Germany, 1580s establishments in Europe
General-purpose programming language	programming languages
Bikini	Swimwear
High Voltage	AC/DC albums, 1975 albums, Hard rock albums, Blues rock albums
Dirty Deeds Done Dirt Cheap	AC/DC albums, 1976 albums, 1981 albums, Hard rock albums, Blues rock albums, Rock and roll albums
Iron oxide	Chemical compounds, Iron compounds, Oxides
Jimi Hendrix	African American musicians, American blues musicians, American military people, American rock guitarists, American rock singers, American singer-songwriters, Drug-related accidental deaths in the United Kingdom, Grammy Award winners, Musicians from Seattle, Washington, 1942 births, 1970 deaths, Former Roman Catholics, Drug-related deaths in the United Kingdom
Incendiary device	Incendiary weapons
Napalm	Incendiary weapons
Midwestern United States	Midwestern United States, Census Regions of the United States
Maynard James Keenan	American rock guitarists, American rock singers, Musicians from Grand Rapids, Michigan, Singers from Grand Rapids, Michigan, Singers from Ohio, Musicians from Ohio, Singers from Los Angeles, California, Musicians from Los Angeles, California, American heavy metal musicians, 1964 births, Living people
Naphtha	Hydrocarbons
Lukas Podolski	1985 births, Living people, German footballers, Polish people
Naphthalene	Chemical compounds
MySQL	Free software, Databases, Sun Microsystems, Oracle Corporation
White phosphorus	Incendiary weapons
Miroslav Klose	1978 births, Living people, 2014 FIFA World Cup players, German footballers, Polish people
Mothball	Everyday life
Oliver Kahn	1969 births, Living people, German association football goalkeepers, People from Karlsruhe, Sportspeople from Baden-Württemberg
Timo Hildebrand	1979 births, Living people, German association football goalkeepers, People from Worms, Germany, Sportspeople from Rhineland-Palatinate
Philipp Lahm	1983 births, Living people, Association football defenders, Association football full-backs, 2006 FIFA World Cup players, 2010 FIFA World Cup players, 2014 FIFA World Cup players, German footballers, Sportspeople from Munich
Valencia CF	Spanish football clubs, Valencia, 1919 establishments in Europe, 1910s establishments in Spain
Bastian Schweinsteiger	1984 births, Living people, 2006 FIFA World Cup players, 2010 FIFA World Cup players, 2014 FIFA World Cup players, German footballers, Manchester United F.C. players, Sportspeople from Bavaria, UEFA Euro 2004 players, UEFA Euro 2008 players, UEFA Euro 2012 players, UEFA Euro 2016 players
Feller Bach	Geography of Rhineland-Palatinate, Rivers of Germany
Per Mertesacker	1984 births, Living people, German footballers, People from Hanover, Sportspeople from Lower Saxony
Bernd Schneider	1973 births, Living people, German footballers, People from Jena, Sportspeople from Thuringia
David Odonkor	1984 births, Living people, German footballers, Sportspeople from North Rhine-Westphalia
Black Entertainment Television	African-American history, American television networks, Viacom, 1980 establishments in the United States, African-American people
CMT (American TV channel)	American television channels, Country music, Music media
Johnny Carson	1925 births, 2005 deaths, Actors from Iowa, American television actors, American television talk show hosts, Comedians from Iowa, Deaths from emphysema, Deaths from respiratory failure, Disease-related deaths in the United States, Kennedy Center honorees, Emmy Award winners, Peabody Award winners
TNT (band)	Norwegian heavy metal bands, Hard rock bands, Glam metal bands
Anarcho-capitalism	Anarcho-capitalism, Libertarianism, Political movements
Walther von der Vogelweide	1170s births, 1230s deaths, Medieval composers, German composers, German poets, Medieval poets
Striptease	Dance types, Theatrical forms, Sex industry
Roald Dahl	1916 births, 1990 deaths, British autobiographers, British children's writers, Deaths from myelodysplastic syndrome, Disease-related deaths in England, Welsh novelists, Writers from Cardiff
Let There Be Rock	AC/DC albums, 1977 albums, Hard rock albums, Blues rock albums, Rock and roll albums, Heavy metal albums
Electrical energy	Electricity
Power (physics)	Physical quantity, Basic physics ideas
List of Byzantine Emperors	Lists of heads of state, Byzantine Emperors, Emperors and empresses
Maroon 5	1994 establishments in California, 1990s American music groups, 2000s American music groups, 2010s American music groups, American pop music groups, American rock bands, Maroon 5, Musical groups established in 1994, Musical groups from Los Angeles, California, Musical quintets, Pop rock bands
Jens Lehmann	1969 births, Living people, 1998 FIFA World Cup players, 2002 FIFA World Cup players, 2006 FIFA World Cup players, German association football goalkeepers, Sportspeople from Essen
Karlsruher SC	German Bundesliga, German football clubs, Karlsruhe, Sport in Baden-Württemberg
A.C. Milan	A.C. Milan
Germany national football team	National football teams, Football in Germany
Larissa	Cities in Greece
Steven Gerrard	1980 births, Living people, 2006 FIFA World Cup players, 2010 FIFA World Cup players, 2014 FIFA World Cup players, English autobiographers, English footballers, Liverpool F.C. players, Sportspeople from Merseyside, Premier League players
Ikebana	Flowers, Japanese culture
Venom (band)	Venom (band), Music groups from Newcastle upon Tyne, English heavy metal bands, Thrash metal bands, Black metal bands, English punk bands
Scottsdale, Tasmania	Towns in Tasmania
Torsten Frings	1976 births, Living people, German footballers, Sportspeople from North Rhine-Westphalia
David Letterman	Kennedy Center honorees, Comedians from Indiana, American television talk show hosts, 1947 births, Living people, Emmy Award winners
Tide	Oceanography
Tidal force	Force, Astronomical phenomena
Tidal energy	Water, Hydropower
Evangeline Lilly	1979 births, Actors from Alberta, Canadian television actors, Living people
View	Basic English 850 words
Greystones	Towns in Ireland, County Wicklow
Courtly love	Middle Ages, Poetry
Royal court	Palaces
Statesman	Political philosophy, Politics
Chris Gueffroy	1968 births, 1989 deaths, Berlin Wall, Deaths by firearm in Germany, East German people, People from Mecklenburg-Vorpommern
Electricity generation	Electricity
Casey Kasem	1932 births, 2014 deaths, Deaths from dementia with Lewy bodies, Deaths from sepsis, Actors from Detroit, Michigan, American movie actors, American radio actors, American stage actors, American television actors, American voice actors, Democrats (United States), National Radio Hall of Fame inductees, People with Parkinson's disease
Bloc Party	2003 establishments in England, 2000s British music groups, 2010s British music groups, Bloc Party, English rock bands, Indie bands, Musical groups established in 2003, Musical groups from London
VfR Mannheim	1911 establishments in Europe, German football clubs, Mannheim, Sport in Baden-Württemberg, 1910s establishments in Germany
SV Waldhof Mannheim	German football clubs, Mannheim, Sport in Baden-Württemberg
Popular science	Science, Literature, Communication
Lullaby	Song forms
Lund	Lund
Guadalcanal	Solomon Islands
1. FC Eintracht Bamberg	Bamberg, German football clubs, Sport in Bavaria
FSV Frankfurt	Frankfurt, German football clubs, Sport in Hesse, 1899 establishments in Germany
Joachim Löw	1960 births, Living people, German football managers, German footballers, Sportspeople from Baden-Württemberg
Polyhydroxyalkanoates	Polymers
SpVgg Bayreuth	Bayreuth, German football clubs, Sport in Bavaria
Max Reger	1873 births, 1916 deaths, 20th century composers, Romantic composers, German composers, German pianists
Saint Stephen	1 births, 30s deaths, Ancient Israeli people, Early Christian saints, Executed people, New Testament people
The Dark Tower (series)	Series of books, Books by Stephen King, Fantasy books
Jon Corzine	1947 births, Living people, Governors of New Jersey, United States senators from New Jersey, US Democratic Party politicians, Politicians from Illinois
James McGreevey	1957 births, LGBT people from New Jersey, Gay men, Governors of New Jersey, LGBT politicians, Living people, US Democratic Party politicians
Physical quantity	Physics, Measurement
Helicopter rotor	Helicopters
Variations (music)	Musical forms
Logo (programming language)	Programming languages
Lisp (programming language)	Programming languages
Lambda calculus	Mathematics, Recursion
Family Jewels	Music videos and DVDs
Power transmission	Energy
Ocean surface wave	Oceanography
Crest (physics)	Wave physics
Surface wave	Mechanics
Nausea	Symptoms
Anxiety	Anxiety disorders
Lumbar puncture	Medical procedures
Wave power	Hydropower
Port Royal	Settlements in Jamaica
List of bridges in the United States	Bridges in the United States, United States-related lists, Lists of bridges
Osborne's bull	Symbols
Desalination	Water
Solar energy	Solar energy
Photovoltaics	Solar power, Electricity
Solar cell	Solar energy, Electronic components, Electricity
Alternating current	Electricity
Direct current	Electricity
Snowmobile	Land vehicles
The Remo Four	English rock bands, People from Liverpool
Magnitude (mathematics)	Mathematics
Fraction (mathematics)	Mathematics, Numbers
Buckethead	American guitarists, American composers, Musicians from California, American heavy metal musicians, American funk musicians, American rock musicians, American jazz musicians, 1969 births, Living people, Multi-instrumentalists
Quotient	Numbers
Norman language	Languages of Europe, Romance languages
Division (mathematics)	Arithmetics
Division	Basic English 850 words
Divisor	Arithmetics
Remainder	Arithmetics
List of 20th Century Studios movies	20th Century Fox movies, Lists of movies
Andreas Starke	1956 births, Living people, Bamberg, German mayors, Politicians from Hamburg, Politicians of the Social Democratic Party of Germany
Robert Enke	1977 births, 2009 deaths, German association football goalkeepers, People from Jena, Sportspeople from Thuringia, Sportspeople who committed suicide, Suicides in Germany
Velikiy Novgorod	Cities in Russia
Nizhny Novgorod	Capital cities in Russia
Maxim Gorky	1868 births, 1936 deaths, Russian writers
Ankh	Religious symbols, Ancient Egypt
Ingrid Bergman	Academy Award winning actors, BAFTA Award winning actors, Cancer deaths in England, Deaths from breast cancer, Emmy Award winning actors, Golden Globe Award winning actors, Actors from Stockholm, Swiss stage actors, Swedish movie actors, Swedish television actors, Tony Award winning actors, 1915 births, 1982 deaths
Ruwer-Hochwald-Radweg	Cycling in Germany, Sport in Rhineland-Palatinate, Transport in Germany
Novosibirsk	Novosibirsk, Siberia, Capital cities in Russia
Alice Springs	Alice Springs
Recital	Music events

