Land grant	Business, Property
Pope Leo XIII	1810 births, 1903 deaths, Italian popes
Konzum	Companies of Croatia, Supermarkets of Europe, Establishments in Croatia, 1957 establishments in Europe
Mother Teresa	1910 births, 1997 deaths, Albanian people, Beatified people, Cardiovascular disease deaths in India, Deaths from heart failure, Nuns, Order of Merit, People from Skopje, Roman Catholics
JoJo (singer)	1990 births, Living people, People from Brattleboro, Vermont, American child actors, American child singers, American movie actors, American pop musicians, American R&B singers, American television actors, Musicians from New Hampshire, Musicians from Massachusetts, Musicians from Vermont, Singers from Massachusetts, Singers from Vermont, Singers from New Hampshire
Angela Aames	1956 births, 1988 deaths, American movie actors, Actors from South Dakota
Willie Aames	1960 births, Living people, American television actors, American voice actors, Actors from Los Angeles County, California
Bruce Abbott	1954 births, Living people, American television actors, Actors from Oregon, American movie actors
Bud Abbott	1895 births, 1974 deaths, Actors from New Jersey, American movie actors, American radio actors, American stage actors, Comedians from New Jersey
Kareem Abdul-Jabbar	1947 births, Living people, Actors from New York City, African-American basketball players, American movie actors, American Muslims, Sportspeople from New York City, Los Angeles Lakers players, Milwaukee Bucks players, People with cancer, National Basketball Association players with retired numbers, American basketball players
Betty Aberlin	1942 births, Living people, American movie actors, American television actors, Actors from New York City, Writers from New York City
Jake Abel	1987 births, Living people, American television actors, People from Canton, Ohio, Actors from Ohio, American movie actors
Baudrecourt, Moselle	Communes in Moselle
Hayden Panettiere	Actors from New York, American child actors, American movie actors, American television actors, American voice actors, Singers from New York, 1989 births, Living people
Toul	Communes in Meurthe-et-Moselle, Subprefectures in France
Blessthefall	American punk bands, Emo bands, Post-hardcore bands, Metalcore bands, Musical groups from Arizona, Musicians from Phoenix, Arizona, Musical groups established in 2004, 2004 establishments in the United States, 2000s establishments in Arizona
Amber	Minerals
Resin	Natural materials
Varnish	Materials
Secretion	Physiology
Adhesive	Materials
Natural gum	Natural materials, Polymers
Mineralization	Geology
Ali	599 births, 661 deaths, Caliphs, Imams, Shia Islam
Zakarid Armenia	History of Armenia
Women and Islam	Islam
Chador	Islamic dress
Vortex mixer	Laboratory equipment
Niqāb	Islamic dress
Hira	Islam
Ferdowsi	935 births, 1020 deaths, Persian poets
Abu-Mansur Daqiqi	10th century births, 10th century deaths, Persian poets
Edward VII	1841 births, 1910 deaths, Kings and Queens of the United Kingdom, Knights Grand Commander of the Order of the Indian Empire, Knights Companion of the Order of the Star of India, 1900s in the United Kingdom, 1910s in the United Kingdom
Adhesive tape	Tools
Roman Polanski	1933 births, Living people, Academy Award winning directors, Actors from Paris, Child sexual abusers, Extradition, French criminals, French movie actors, French screenwriters, Holocaust survivors, Jewish actors, Jewish businesspeople, Jewish criminals, Jewish French writers, Jewish screenwriters, Movie directors from Paris, Movie producers from Paris, Polish Jews, Polish movie actors, Polish movie directors, Polish movie producers, Polish screenwriters, Polish writers, Writers from Paris
Watford	Watford, Unitary authority districts of England
Home Alone	1990 comedy movies, 1990 crime movies, 1990s criminal comedy movies, 1990s family movies, 20th Century Fox movies, American criminal comedy movies, American crime movies, American family movies, Christmas movies, English-language movies, Movies about dysfunctional families, Movies composed by John Williams, Movies produced by John Hughes, Movies set in Chicago, Illinois, Movies shot in Chicago, Illinois, Screenplays by John Hughes, Movies directed by Chris Columbus
Hijab	Islamic dress, Headgear
Scooby-Doo	Animated television series, 1969 American television series debuts, 1960s American television series, 1970s American television series, 1980s American television series, 1990s American television series, 2000s American television series, Scooby-Doo characters
Akita Inu	Dog breeds
Nezami	Persian poets, 1141 births, 1209 deaths
List of Persian poets and authors	Lists of writers, Persian people, Persian poets, Iran-related lists
Metric (band)	1990s music groups, 2000s music groups, 2010s music groups, Canadian rock bands, Indie rock bands, New wave bands, Musical groups from New York City
Rudaki	859 births, 941 deaths, Persian poets
Baba Taher	10th century births, 11th century deaths, Persian poets
Amir Khosrow	1253 births, 1325 deaths, Persian poets
Hafez	14th century births, 14th century deaths, Persian poets, Iranian people, Iranian poets
Forough Farrokhzad	Persian poets, 1935 births, 1967 deaths
Ahmad Shamlou	1925 births, 2000 deaths, Persian poets
Parvin E'tesami	Persian poets, 1907 births, 1941 deaths
Jihad	Islam
Postfix notation	Mathematical notation
Infix notation	Mathematical notation
Fiqh	Islamic law
Dir en grey	Japanese rock bands, Hard rock bands, Japanese heavy metal bands, Metalcore bands, Visual kei bands, Osaka
Hurricane Wilma	2005 Atlantic hurricane season, 2005 in Canada, 2000s in Cuba, Category 5 Atlantic hurricanes, Retired tropical cyclone names, Hurricanes in Mexico, Hurricanes in the United States, 2005 in Florida, 2000s in Belize, History of the Cayman Islands, 2000s in Haiti, 2000s in Honduras, 2000s in Jamaica, 2000s in Nicaragua, 2000s in the Bahamas, Natural disasters in Canada, Hurricanes in Florida, October 2005 events
Yucatán Peninsula	Peninsulas, Geography of Belize, Geography of Guatemala, Geography of Mexico
Clarksville, Tennessee	Cities in Tennessee, County seats in Tennessee
Live Earth	2007 in music, Concerts, July events
Wembley Stadium (1923)	Football stadiums in London, 1923 establishments in England, 2003 disestablishments in England
Inch of mercury	Units of measurement, Meteorology
Lou Costello	1906 births, 1959 deaths, Actors from New Jersey, American movie actors, American radio actors, American stage actors, Comedians from New Jersey, Extras
Kirstie Alley	1951 births, Living people, American television actors, American movie actors, Golden Globe Award winning actors, Scientologists, Actors from Wichita, Kansas, Emmy Award winning actors, People's Choice Award winners
Seth Adkins	American television actors, American movie actors, American child actors, Actors from New Mexico, 1989 births, Living people
Danny Aiello	Emmy Award winning actors, 1933 births, 2019 deaths, Infectious disease deaths in the United States, Disease-related deaths in New Jersey, American movie actors, American television actors, American stage actors, American voice actors, Actors from New York City
Claude Akins	American television actors, American movie actors, Actors from Georgia (U.S. state), 1926 births, 1994 deaths
Don Adams	1923 births, 2005 deaths, American television actors, American movie actors, American voice actors, American stage actors, Actors from New York City, Emmy Award winning actors
Ben Affleck	1972 births, Living people, Academy Award winning writers, Actors from Massachusetts, American movie actors, Episcopalians, Businesspeople from Berkeley, California, Businesspeople from Massachusetts, American screenwriters, American television actors, American television producers, American television writers, American voice actors, Golden Globe Award winning writers, Movie directors from California, Movie directors from Massachusetts, Movie producers from California, Movie producers from Massachusetts, Actors from Berkeley, California, Saturn Award winners, Screenwriters from California, Screenwriters from Massachusetts, Actors who played Batman
The Cosby Show	1980s American black sitcoms, 1980s American television series, 1984 American television series debuts, 1990s American sitcoms, 1990s American television series, 1992 television series endings, 1992 American television series endings, Brooklyn in fiction, Emmy Award winning programs, English-language television programs, Golden Globe Award winning programs, NBC network shows, Television series set in New York City
Wembley Stadium	Football stadiums in London
Port Dover Composite School	Buildings and structures in Ontario, Schools in Canada, 2013 disestablishments in North America, 2010s disestablishments in Canada
Rouben Mamoulian	1897 births, 1987 deaths, Armenian movie directors, People from Tbilisi, Naturalized citizens of the United States, American theatre directors, American movie directors
Ivan Aivazovsky	Armenian artists, 1900 deaths, 1817 births
Thistle tube	Laboratory equipment
World Meteorological Organization	United Nations, Geneva, 1873 establishments
Static mixer	Laboratory equipment
Komárno	Settlements in Slovakia, Towns in Europe
Komarno	Cities in Ukraine, 1324 establishments, Establishments in Ukraine, 1320s establishments in Europe
Correlation	Mathematics, Statistics
Sunscreen	Care
First Council of Nicaea	Councils, 325
Oscypek	Cheeses, Polish food, Slovakia
Bigos	Polish food, Lithuanian culture
Kaliber 44	Hip hop bands, Polish musical groups, 1994 establishments in Europe, 1990s establishments in Poland
Lupin	Flowers, Faboideae
Bar (unit)	Units of measurement
Pascal (unit)	Units of measurement
Jerez de la Frontera	Jerez de la Frontera, Municipalities in Andalusia
Limited government	Forms of government
Azores	Archipelagos, Azores
Wade Robson	1982 births, Living people, Dancers, Choreographers, Australian entertainers, People from Brisbane
Adam Stefan Sapieha	1867 births, 1951 deaths, Cardinals of the Roman Catholic Church, Polish Roman Catholics, Roman Catholic archbishops
Cardinal (Catholicism)	Cardinals of the Roman Catholic Church
Faustyna Kowalska	Nuns, Polish Roman Catholics, Christian saints, 1905 births, 1938 deaths
Don Giovanni	1780s operas, Compositions by Wolfgang Amadeus Mozart, 1787
The Magic Flute	Compositions by Wolfgang Amadeus Mozart, 1790s operas, 1791
George Chuvalo	1937 births, Canadian boxers, Living people, Sportspeople from Toronto
Guest worker	Employment, Immigration
Tropical Storm Lee (2005)	Atlantic tropical storms
Lesser Antilles	Caribbean islands
Cold front	Meteorology
Separating funnel	Laboratory equipment
Plate reader	Laboratory equipment
Microtiter plate	Laboratory equipment
Bulgarian language	Slavic languages, Languages of Europe
Erlenmeyer flask	Laboratory equipment
Girlfriend	Basic English 850 words, Women
Native	Basic English 850 words
Concordia, Kansas	Cities in Cloud County, Kansas, County seats in Kansas
Indigenous peoples	Ethnic groups
Migrant worker	Occupations, Migration
Unicode	Computer science, Encodings, Internet
Low pressure area	Meteorology
Hill fort	Ancient history, Fortification, Stone Age
Troy, Michigan	Cities in Michigan
Gin	Alcoholic spirits
Prostitution	Prostitution
Girl	Basic English 850 words
Family Guy	Family Guy, 1990s American sitcoms, 2000s American sitcoms, 2010s American sitcoms, 2020s American sitcoms, 1999 American television series debuts, 1990s American comedy television series, 1990s animated television series, 2000s American comedy television series, 2000s animated television series, 2010s American comedy television series, 2010s animated television series, 2020s animated television series, Adult animated television series, Adult Swim, American animated television series, Fox television series, Television series about families, English-language television programs
Myspace	2003 establishments in the United States, Companies based in New York City, Social networking
RuneScape	Massively multiplayer online role-playing games, 2001 video games, Online games
Jagex	Video game companies, 2001 establishments in England
Ella Enchanted	1997 books, Children's books, Newbery Honor books, Movies about giants
Exploitation	Vocabulary
People (magazine)	American magazines, Weekly magazines
Eye of Horus	Egyptian mythology, Mathematics
The Great Khali	1972 births, Indian actors, Indian sportspeople, Living people, Professional wrestlers, WWE wrestlers, Punjabi people
Ani (god)	Etruscan gods and goddesses, Ancient Rome
Tecophilaea	Asparagales
Propolis	Bees
Unemployment rate	Economic indicators
Home and Away	1988 television series debuts, 1980s soap operas, 1990s soap operas, 2000s Australian television series, 2000s soap operas, 2010s soap operas, New South Wales, 1988 establishments in Australia, English-language television programs
Anthony Hopkins	1937 births, Living people, American movie actors, American stage actors, American television actors, Welsh movie actors, Welsh stage actors, Welsh television actors, BAFTA Award winning actors, Emmy Award winning actors, Golden Globe Award winners, Best Actor Academy Award winners, Naturalized citizens of the United States, People from Port Talbot, Actors from Glamorgan
Turner Classic Movies	Time Warner, American television channels, Cable television
Internet Broadway Database	Entertainment websites, Theater
Brigitte Bardot	Actors from Paris, Animal rights activists, French autobiographers, French movie actors, French Roman Catholics, 1934 births, Living people
Farben Lehre	Punk bands
Billy Crystal	American movie actors, Mark Twain Prize recipients, American television actors, Actors from New York City, 1948 births, Living people, Emmy Award winners
Carmen Electra	Actors from Ohio, American dancers, Models from Ohio, American movie actors, American television actors, American voice actors, Singers from Ohio, Television personalities from Ohio, 1972 births, Living people
Calista Flockhart	1964 births, Living people, American television actors, Golden Globe Award winning actors, Actors from Illinois
Dwight Schultz	American movie actors, American stage actors, American television actors, 1947 births, Living people, Actors from Baltimore, Maryland, American bloggers
Fred Savage	Actors from Illinois, American child actors, American movie actors, American television actors, People from Highland Park, Illinois, 1976 births, Living people
Gene Kelly	Academy Award Honorary Award winners, Actors from Pittsburgh, Pennsylvania, American choreographers, American dancers, American movie actors, Cardiovascular disease deaths in California, Deaths from heart failure, Emmy Award winning directors, Golden Globe Award winners, 1912 births, 1996 deaths, Former Roman Catholics
Islamic fundamentalism	Islam
Golden Globe Awards	Golden Globe Awards
AllMusic	1991 establishments in the United States, Entertainment websites, Music media
The Lord of the Rings (movie series)	2000s fantasy movies, American fantasy movies, New Zealand movies, Epic movies, Series of movies, Movies based on books, English-language movies, Movies directed by Peter Jackson, New Line Cinema movies, The Lord of the Rings (movie series)
Gary Coleman	1968 births, 2010 deaths, Deaths from hemorrhage, Accidental deaths from falls in the United States, Actors from Illinois, Actors from Utah, People from Provo, Utah, African American actors, American adoptees, American movie actors, American television actors, Organ transplant recipients
Cameo appearance	Movie terminology
George Peppard	Actors from Detroit, Michigan, American movie actors, American television actors, Deaths from pneumonia, Infectious disease deaths in the United States, 1928 births, 1994 deaths
Rotten Tomatoes	Entertainment websites
Halle Berry	1966 births, Living people, Actors from Ohio, Actresses who played Bond girls, Best Actress Academy Award winners, African-American movie actors, African-American television actors, Emmy Award winning actors, Golden Globe Award winning actors, Screen Actors Guild Award winners
Golden Raspberry Awards	Movie awards
Blowing a raspberry	Sound, The Bronx
Joshua Jackson	1978 births, Living people, Actors from Vancouver, Canadian movie actors, Canadian television actors
John Wayne	Academy Award winning actors, Actors from Iowa, American movie actors, American movie directors, American movie producers, American television actors, Cancer deaths in Los Angeles, Cancer survivors, Deaths from stomach cancer, Golden Globe Award winning actors, People from Glendale, California, Stage names, 1907 births, 1979 deaths
Tropical Storm Tammy (2005)	Atlantic tropical storms, Hurricanes in the United States, 2005 Atlantic hurricane season, 2005 in Florida, 2005 in the Bahamas, 2000s in Georgia (U.S. state)
Manuchehri	982 births, 1040 deaths, Persian poets
Piranshahr	Cities in Iran
Rumi	1207 births, 1273 deaths, Persian poets, Muslims, Asian Sufis, Afghan people, Turkish people, Mystics
Abu-Shakur Balkhi	Persian poets, 915 births, Year of death unknown
Nasir Khusraw	1004 births, 1088 deaths, Persian poets
Anvari	Persian poets, 1126 births, 1189 deaths
Old World Underground, Where Are You Now?	2003 albums
Mohammad Reza Pahlavi	1919 births, 1980 deaths, Deaths from chronic lymphocytic leukemia, Iranian people, Shahs of Iran, People from Tehran, Recipients of the Decoration for Services to the Republic of Austria
Mehdi Bazargan	Cardiovascular disease deaths in Switzerland, Deaths from myocardial infarction, Prime Ministers of Iran, 1907 births, 1995 deaths
Gazelle	Bovids
American Idiot (album)	2004 albums, Green Day albums, Concept albums, Punk albums
Kabyle language	Berber languages, Algeria
Slackware	Linux distributions
Tropical Storm Bret (2005)	Atlantic tropical storms, Hurricanes in Mexico, 2005 in Mexico
Tropical Storm Harvey (2005)	Atlantic tropical storms, Hurricanes in Bermuda, 2005 Atlantic hurricane season, 2005 in Bermuda
Flash Gordon	Science fiction, Flash Gordon
2 (number)	Integers, Prime numbers
Regina, Saskatchewan	Regina, Saskatchewan
Success	Basic English 850 words
Parachute	Sports equipment
United States Capitol	Buildings and structures in Washington, D.C., Buildings on the National Mall, Historic district contributing properties
Strut bar	Auto parts
Front-wheel drive	Automotive technologies
Rear-wheel drive	Automotive technologies
Wireless	Technology, Radio
Centrifuge	Laboratory equipment
Shah	Heads of state
Approval voting	Voting systems
Agar plate	Laboratory equipment
Mansur Al-Hallaj	Persian poets, 858 births, 922 deaths
Again	Basic English 850 words
Conical measure	Laboratory equipment
Unsuri	Persian poets, 1039 deaths
Ali Shariati	Persian poets, 1933 births, 1977 deaths, 20th century philosophers
Kisai Marvazi	953 births, 10th century deaths, Persian poets
Farrokhi Sistani	10th century births, 1037 deaths, Persian poets
Mu'izzi	1048 births, 1125 deaths, Persian poets
Khaqani Shirvani	1120 births, 1190 deaths, Persian poets
The Seasons (Haydn)	Compositions by Joseph Haydn, Oratorios
Sohrab Sepehri	Persian poets, 1928 births, 1980 deaths
Shabestari	Persian poets, 1288 births, 1340 deaths
Jami	1414 births, 1492 deaths, Persian poets
Saadi	1184 births, 1291 deaths, Persian poets
Saint-Paul, Réunion	Cities in overseas regions belonging to France, Communes in Réunion, Subprefectures in France
Iraj Mirza	1874 births, 1926 deaths, Persian poets
Federalism	Politics, Federations
Federation	Federations
Federal republic	Federations, Republics
Square (algebra)	Algebra
Pan (moon)	Saturn's moons
Tropical Storm Franklin (2005)	Atlantic tropical storms, Hurricanes in Bermuda, 2005 Atlantic hurricane season, 2005 in Bermuda, 2005 in the Bahamas, 2005 in Canada
Atlas (moon)	Saturn's moons
Prometheus (moon)	Saturn's moons
Chris Daughtry	1979 births, Living people, American Idol contestants, Singers from North Carolina
Pandora (moon)	Saturn's moons
Daphnis (moon)	Saturn's moons
Melinda Doolittle	Singers from Tennessee, American Idol contestants, 1977 births, Living people
Epimetheus (moon)	Saturn's moons
Janus (moon)	Saturn's moons
Enceladus (moon)	Saturn's moons
Tethys (moon)	Saturn's moons
Tropical Storm Jose (2005)	Atlantic tropical storms, Hurricanes in Mexico, 2005 Atlantic hurricane season, 2005 in Mexico
Thread	Basic English 850 words
Hurricane Cindy (2005)	Hurricanes in the United States, Category 1 Atlantic hurricanes
Single	Basic English 850 words
Cartridge (electronics)	Electronics, Storage devices
Hurricane Epsilon	2005 Atlantic hurricane season, Category 1 Atlantic hurricanes, Hurricanes
EFL Cup	Football League Cup
The Football Association	1863 establishments in the United Kingdom, The Football Association, UEFA
Tropical Storm Alpha (2005)	2005 Atlantic hurricane season, Atlantic tropical storms
Büchner funnel	Laboratory equipment
Hurricane Alicia	Retired tropical cyclone names, Category 3 Atlantic hurricanes, 1983 in the United States, 1980s in Texas, Hurricanes in Texas
Hanging Gardens of Babylon	Seven Wonders of the World, Mesopotamia, Botanical gardens
Statue of Zeus at Olympia	Seven Wonders of the World, Ancient Greece, Ancient Greek and Roman statues, Olympia, Greece
Temple of Artemis	Seven Wonders of the World, Ancient Greece
Büchner flask	Laboratory equipment
Mausoleum at Halicarnassus	Seven Wonders of the World
Colossus of Rhodes	Seven Wonders of the World, Ancient Greece, Buildings and structures in Greece, Statues, Ancient Greek and Roman statues, Ancient Greek bronze sculptures
Lighthouse of Alexandria	Buildings and structures in Ancient Egypt, Seven Wonders of the World, Alexandria, Lighthouses, Transport in Egypt, 3rd-century BC establishments, Establishments in Egypt
Telesto (moon)	Saturn's moons
Calypso (moon)	Saturn's moons
Pallene (moon)	Saturn's moons
Methone (moon)	Saturn's moons
Dione (moon)	Saturn's moons
Helene (moon)	Saturn's moons
Polydeuces (moon)	Saturn's moons
Boyfriend	Men, Relationships, Society
Aspirator	Laboratory equipment
Venturi effect	Physics
Santa Fe, Argentina	Cities in Argentina, Capitals of Argentine provinces
Geography of Argentina	Geography of Argentina
List of retired Atlantic hurricane names	Hurricanes, Weather lists
Asturian language	Romance languages, Asturias
Classical mythology	mythology
Jun Kazama	Fictional Japanese people, Tekken characters
Allen Klein	1931 births, 2009 deaths, American fraudsters, American Jews, Deaths from Alzheimer's disease, Disease-related deaths in the United States, Jewish businesspeople, Businesspeople from Newark, New Jersey, The Beatles
Mark David Chapman	1955 births, Living people, American Christians, American murderers, American prisoners, People from Fort Worth, Texas, People from Georgia (U.S. state), The Beatles
Diana, Princess of Wales	1961 births, 1997 deaths, Accidental deaths in France, English Anglicans, House of Windsor, People from Norfolk, Princes and Princesses of Wales, Road accident deaths
Hornswoggle	1986 births, Living people, American professional wrestlers, WWE wrestlers, Sportspeople from Wisconsin, People with dwarfism
Ink cartridge	Printers
Tezpur	Assam
D.Gray-man	Manga, Anime
Kyoto Station	Railway stations in Kyoto Prefecture
Stefan Kießling	1984 births, Living people, German footballers, Sportspeople from Bavaria
Sand filter	Water pollution, Water infrastructure
Filter	Computer science, Analytical chemistry
Guwahati	Cities in India
Henry Clay	1777 births, 1852 deaths, Democratic Republican party (US) politicians, National Republican party (US) politicians, Politicians from Virginia, Speakers of the United States House of Representatives, United States representatives from Kentucky, United States Secretaries of State, United States senators from Kentucky, Whig party (US) politicians, 19th-century American politicians
Daniel Webster	1782 births, 1852 deaths, American lawyers, American Protestants, National Republican party (US) politicians, Unitarians, United States representatives from Massachusetts, United States representatives from New Hampshire, United States Secretaries of State, United States senators from Massachusetts
The Catcher in the Rye	1951 books
Evan Lysacek	1985 births, Living people, American figure skaters, Sportspeople from Chicago
Richard Childress Racing	NASCAR
Bobby Darin	Singers from New York City, Deaths from surgical complications, 1936 births, 1973 deaths, People from the Bronx
Sasha Cohen	1984 births, Living people, Figure skaters from California, American Olympic silver medalists, People from Los Angeles, California
Justification (theology)	Christian theology, Christian terminology
Jury nullification	Trials, Legal terms
Jason Alexander	1959 births, Living people, American movie actors, American stage actors, American television actors, Comedians from New Jersey, Jewish American actors, Jewish American comedians, Actors from Newark, New Jersey, Seinfeld, Tony Award winning actors
Khandi Alexander	1957 births, Living people, American television actors, American dancers, American movie actors, Actors from New York City, American choreographers
Kirsten Dunst	1982 births, Actors from New Jersey, American movie actors, American television actors, German movie actors, German television actors, Living people
Mary Tyler Moore	1936 births, 2017 deaths, Actors from Brooklyn, American activists, American animal rights activists, Actors from Greenwich, Connecticut, American movie actors, American philanthropists, American stage actors, American television actors, Deaths from diabetes, Deaths from cardiopulmonary arrest, Deaths from pneumonia, Emmy Award winning actors, Golden Globe Award winning actors, Screen Actors Guild Award winners, Tony Award winning actors
Pamela Anderson	1967 births, Living people, Actors from British Columbia, American animal rights activists, American models, American movie actors, American television actors, American voice actors, Canadian models, Canadian movie actors, Canadian television actors, Canadian voice actors, Dancing on Ice participants, Dancing with the Stars participants
Sandra Bullock	1964 births, Living people, American movie actors, American television actors, People from Arlington, Virginia, Actors from Virginia, Screen Actors Guild Award winners
Miami Ink	2005 American television series debuts, 2008 American television series endings, 2000s American television series, American reality television series, Miami, Florida, Television series set in Florida, English-language television programs
Edmontonia	Ankylosauria
Adaminaby, New South Wales	Towns in New South Wales
Tropical Storm Delta (2005)	Atlantic tropical storms
High and Mighty Color	J-pop bands, 2004 establishments in Asia, 2010 disestablishments, 2000s establishments in Japan
Fall of Man	Old Testament
Colorado River	Rivers of Mexico, Rivers of Arizona, Rivers of Colorado, Rivers of Utah, Geography of Nevada, Rivers of California, Imperial County, California, Riverside County, California, San Bernardino County, California
Cola	Soft drinks
1035	1035
Slash (musician)	1965 births, Living people, English guitarists, American rock guitarists, American heavy metal musicians, Guns N' Roses, Musicians from Los Angeles, California
Hurricane Beta	2005 Atlantic hurricane season, Category 3 Atlantic hurricanes, October 2005 events, 2005 in North America, History of Colombia, 2000s in Nicaragua, 2000s in Honduras
Billie Joe Armstrong	LGBT people from California, American punk musicians, American rock musicians, American rock singers, Singers from Berkeley, California, Musicians from Berkeley, California, Writers from Berkeley, California, Singer-songwriters from California, Bisexual people, LGBT musicians, Green Day, Writers from Oakland, California, Singers from Oakland, California, Musicians from Oakland, California, 1972 births, Living people
The Importance of Being Earnest	British plays
Puerto Cabezas	Cities in Nicaragua
Tegucigalpa	National capitals in North America, Cities in Central America, Settlements in Honduras, 1578 establishments, 1570s establishments in North America
1062	1062
Zappanale	Music festivals, Festivals in Europe, Entertainment in Germany
Burlington Airpark	Transport in Ontario, Airports in Canada, 1962 establishments in North America, 1960s establishments in Canada
Pratibha Patil	Presidents of India, Governors of Rajasthan, 1934 births, Living people
Lily	Flowers, Liliaceae
Tropical Storm Zeta	Atlantic tropical storms
Dan Fogelberg	Singers from Illinois, 1951 births, 2007 deaths
Lettuce	Leaf vegetables, Asterales
Hadrosaurus	Hadrosauridae
William Shatner	1931 births, Living people, Actors from Montreal, People from Montreal, Canadian Jews, Canadian movie actors, Canadian movie directors, Canadian stage actors, Canadian television actors, Canadian television directors, Canadian television producers, Canadian television writers, Emmy Award winning actors, Golden Globe Award winning actors, Jewish actors, Jewish businesspeople, Jewish screenwriters, Writers from Montreal
Yeardley Smith	American movie actors, American television actors, American voice actors, Emmy Award winners, The Simpsons, 1964 births, Living people, Actors from Paris, Actors from Washington, D.C.
Denise Richards	1971 births, Living people, Actors from Illinois, Models from Illinois, American movie actors, American television actors, American television personalities, Actresses who played Bond girls
Ashley Judd	Actors from Los Angeles, California, American movie actors, American television actors, American voice actors, Democrats (United States), 1968 births, Living people
Barbara Stanwyck	Academy Award Honorary Award winners, Actors from New York, American movie actors, American stage actors, American television actors, Cardiovascular disease deaths in the United States, Deaths from COPD, Deaths from congestive heart failure, Golden Globe Award winning actors, 1907 births, 1990 deaths
Brooke Shields	Actors from New York City, American child actors, Models from New York City, American movie actors, American musical theatre actors, American television actors, American voice actors, 1965 births, Living people
Fujita scale	Tornadoes
Ticino	Ticino
Ticino (river)	Rivers of Switzerland, Rivers of Italy
Po (river)	Rivers of Italy
Cristiano Ronaldo	1985 births, Living people, Manchester United F.C. players, Portuguese footballers, UEFA European Championship players, FIFA World Cup players, 2018 FIFA World Cup players, 2014 FIFA World Cup players, 2010 FIFA World Cup players, 2006 FIFA World Cup players, UEFA Euro 2016 players, UEFA Euro 2012 players, UEFA Euro 2008 players, Premier League players
Oaxaca	Oaxaca, States of Mexico
Basic Law of the Federal Republic of Germany	Government of Germany, Constitutions, Politics of Germany, 1949 in Europe, 1940s in Germany
Oaxaca de Juárez	Capital cities in Mexico, Settlements in Oaxaca, 1530s establishments in Mexico, 1532 establishments
Armadillo	Xenarthrans, Mammals of South America
Niacin	B vitamins
Octagon	Polygons
Registration	Documents, Law
Eschweiler	Aachen Rural District, Eschweiler
Tropical Storm Arlene (2005)	2005 in Alabama, Atlantic tropical storms, Hurricanes in the United States, 2005 in Cuba, 2005 in Florida, June 2005 events
Sirenia	Sirenia
Keihan Main Line	Japanese railways
Sanjo Station (Kyoto)	Railway stations in Kyoto Prefecture
Tony Parker	1982 births, Living people, Basketball players, French sportspeople, People from Bruges, San Antonio Spurs players
Kawaramachi Station	Railway stations in Kyoto Prefecture
Girlfriend (Avril Lavigne song)	2007 songs, Avril Lavigne songs, Pop songs, Songs about infidelity
M×0	Manga
Chip Douglas	American guitarists, American pop musicians, American folk musicians, Musicians from Los Angeles, California, Musicians from Hawaii, 1942 births, Living people
Henry Wood	1869 births, 1944 deaths, British conductors, Companions of Honour, Knights Bachelor
Divine grace	Christian theology
Proxy server	Internet
Client	Internet
Cache (computing)	Computer science
DMOZ	Internet
Web directory	internet
File sharing	File sharing, Computer science, Internet
Ammonium sulfide	Sulfur compounds, Nitrogen compounds
Metre per second	Velocity, Units of measurement, SI units
Hydroxide	Chemistry
Cyclone	Natural events, Severe weather
Eye (cyclone)	Tropical cyclones
Glasgow Coma Scale	Psychiatry, Medicine
House of Habsburg	Habsburg Dynasty
Rhodesia	States and territories established in the 1960s, History of Zimbabwe, 1965 establishments, 1960s establishments in Africa, 1980 disestablishments, 1960s in Africa, 1970s in Africa
Westminster	Westminster
Ostara	Religious festivals
Megalosaurus	Megalosauridae
Parliament of the United Kingdom	Politics of the United Kingdom, National legislatures
Silicon dioxide	Chemical compounds, Oxides
Metallic hydrogen	Alkali metals
Giovanni Domenico Cassini	1625 births, 1712 deaths, Astrologers, French astronomers, French engineers, French esotericists, Italian astronomers, Italian esotericists
Christiaan Huygens	1629 births, 1695 deaths, Dutch astronomers, Dutch mathematicians, Dutch physicists, Dutch inventors, People from The Hague, Theoretical physicists
Hyperion (moon)	Saturn's moons
Iapetus (moon)	Saturn's moons
Nadezhda Mandelstam	1899 births, 1980 deaths, Russian Jews, Russian writers, Soviet Jews, Soviet writers, Writers from Kiev
Andrew Carnegie	1835 births, 1919 deaths, Deaths from pneumonia, American philanthropists, Businesspeople from New York City, People from Dunfermline, Massachusetts Republicans
German Bundesrat	German Bundesrat, Politics of Germany, Parliaments
Minister-President	Government occupations, Titles
Edward Rendell	1944 births, Living people, Governors of Pennsylvania, Mayors of Philadelphia, Jewish American politicians, Politicians from New York City
Jacques de Morgan	1857 births, 1924 deaths, French archaeologists, French geologists
Struthiomimus	Coelurosaurs
Prehistoric Armenia	History of Armenia
Royal Albert Hall	Concert halls in London
Home run	Baseball rules, Baseball statistics
City-state	Political geography, City-states
Junior Eurovision Song Contest	Junior Eurovision Song Contest, 2003 establishments in Europe
Styracosaurus	Ceratopsids
School colors	Educational institutions
Maya	Given names
Hebrew calendar	Calendars, Judaism
Moldavia	Geography of Ukraine, Moldova, Romania, Ottoman Empire
Smothers Brothers	Actors from New York City, American television actors, Comedians from California, Comedians from New York City, Folk music groups, Musical groups from San Francisco, Sibling musical duos
Lorenzo Music	1937 births, 2001 deaths, American musicians, American voice actors, Deaths from lung cancer, People from New York, People from Duluth, Minnesota
Ingmar Bergman	Academy Award winning directors, BAFTA Award winners, Golden Globe Award winning directors, Swedish movie directors, Swedish movie producers, People from Uppsala, Swedish screenwriters, 1918 births, 2007 deaths
Baryonyx	Theropods, Spinosauridae, Dinosaurs of Europe
Colorado State University	Colleges and universities in Colorado, Mountain West Conference
Heat capacity	Basic physics ideas, Heat, Physical quantity
Pope John I	460s births, 526 deaths, Italian popes
Limonite	Minerals
Hokkaidō	Islands of Japan, Japanese culture, Prefectures of Japan
Bad Godesberg	Towns in North Rhine-Westphalia, Spa towns in Germany, Bonn
Consulate	Government buildings
Diplomatic immunity	Diplomacy
The Illusionist	2006 movies, American drama movies, American fantasy movies, English-language movies, American independent movies
My Kazakhstan	Kazakhstan, National anthems
Flag of convenience	Law of the sea
Pizza Pizza	Canadian fast food restaurants, Companies listed on the Toronto Stock Exchange
Dipole	Electromagnetism, Functions and mappings, Partial differential equations
AFI (band)	1990s American music groups, 2000s American music groups, 2010s American music groups, American punk bands, Post-hardcore bands, Musical groups from California, Musical groups established in 1991, 1991 establishments in California
Scientific notation	Measurement, Notation, Numerals
Socialist Unity Party of Germany	1946 establishments in Germany, 1990 disestablishments in Germany, Communist parties, East Germany, Former political parties in Germany
Buck the World	2007 albums, Rap music, Hip hop albums
Samaveda	Vedas
Johannes Rau	1931 births, 2006 deaths, Cardiovascular disease deaths in Germany, German Lutherans, German mayors, Ministers-President of North Rhine-Westphalia, Order of Merit of the Federal Republic of Germany, People from Wuppertal, Politicians from North Rhine-Westphalia, Presidents of Germany
Peridot	Birthstones
Archivist	Occupations
Roman Herzog	1934 births, 2017 deaths, Chief justices, German academics, German judges, German Lutherans, Members of the German Bundesrat, Order of Merit of the Federal Republic of Germany, Politicians from Bavaria, Politicians of the Christian Democratic Union of Germany, Presidents of Germany
Voltaic pile	Batteries
Arshile Gorky	1904 births, 1948 deaths, American painters, Armenian artists
Voltmeter	Measuring tools, Energy
Powderfinger	1980s Australian music groups, 1990s Australian music groups, 2000s Australian music groups, 2010s Australian music groups, Australian alternative rock bands, Brisbane, Musical groups disestablished in 2010, Musical groups established in 1989, Musical groups from Queensland, Powderfinger, 1989 establishments in Australia, 2010 disestablishments, 2010s disestablishments in Australia
Schizanthus	Nightshades
Hadith	Islamic theology, Religious terminology, Arabic words and phrases, Muhammad
Fengyuan City	Cities in Taiwan
Billy Cox	1941 births, Living people, American military people, American guitarists, Musicians from West Virginia, Bassists
Clarksville, New Zealand	Cities in New Zealand
The Animals	1963 establishments in the United Kingdom, 1960s British music groups, 1970s British music groups, 1980s British music groups, 1980s disestablishments in the United Kingdom, English rock bands, Music groups from Newcastle upon Tyne, Musical groups disestablished in 1983, Musical groups established in 1963, 1983 disestablishments in Europe
Autograph	Documents
Stevie Ray Vaughan	American blues musicians, American guitarists, Aviation deaths in the United States, Blues guitarists, Musicians from Dallas, Texas, 1954 births, 1990 deaths
Didsbury	Manchester, Villages in England
Burnage	Districts of Manchester
Longsight	Districts of Manchester
Levenshulme	Districts of Manchester
Gorton	Districts of Manchester
Stockport	Stockport, Greater Manchester
Withington	Manchester
Fallowfield	Districts of Manchester
Harrisonburg, Virginia	Cities in Virginia, County seats in Virginia, 1730s establishments in Virginia, 1737 establishments
Hereditary monarchy	Monarchy
River Mersey	Rivers of England
Acid rock	Rock music
Fender Stratocaster	Guitars
Merseyside	Merseyside, Ceremonial counties of England, 1974 establishments in England
Metropolitan Borough of Wirral	English boroughs, Merseyside
Erin Sanders	American television actors, Actors from Santa Monica, California, 1991 births, Living people
Reproduction	Biological reproduction
Metropolitan borough	Local government in England
Carly Patterson	1988 births, Living people, American gymnasts, People from Baton Rouge, Louisiana
Local Government Act 1972	1970s in the United Kingdom, Counties of England, Counties of Wales, Acts of the Parliament of the United Kingdom
Act of Parliament	Law
Legislation	Law
Bill (proposed law)	Law
List of popes by length of reign	Lists of popes
Webkinz	toys, websites
List of popes	Lists of popes, Lists of heads of state
Towradgi	Settlements in New South Wales
ACID	Database modeling
Database transaction	Database modeling
Aargau	Aargau
List of municipalities of the Netherlands	Municipalities of the Netherlands
Provinces of the Netherlands	Provinces of the Netherlands
Flevoland	Flevoland
North Brabant	North Brabant
Local Government Act 1985	1985 in the United Kingdom, Acts of the Parliament of the United Kingdom, 1980s in London
List of zombie movies	Lists of movies
Greater London Council	Local government in London, 1965 establishments in England, 1986 disestablishments, 1980s disestablishments in England
Greater London Authority	Local government in London
Mayor of London	Mayors of London
Rock and Roll Hall of Fame	Rock music, Museums in the United States, Cleveland, Ohio, Buildings and structures in Ohio
Muddy Waters	1913 births, 1983 deaths, Deaths from heart failure, Blues guitarists, Singers from Mississippi, Musicians from Mississippi, Singers from Chicago, Musicians from Chicago, American guitarists, Chicago blues musicians
Suit (clothing)	Clothing
Deal or No Deal	2000 television series debuts, 2000s television series, 2010s television series, Television game shows
Lightning Hopkins	American guitarists, Singers from Houston, Texas, Singer-songwriters from Texas, Musicians from Houston, Texas, 1912 births, 1982 deaths
Lord Mayor of London	Mayors of London
Little Richard	African American musicians, American Christians, American pianists, American R&B musicians, American R&B singers, American rock musicians, American rock singers, American singer-songwriters, Bisexual Christians, Gospel musicians, LGBT African Americans, LGBT musicians, LGBT people from Georgia (U.S. state), LGBT singers, LGBT songwriters, Singers from Georgia (U.S. state), Singers from Tennessee, Musicians from Georgia (U.S. state), Musicians from Tennessee, Writers from Georgia (U.S. state), Writers from Tennessee, People from Macon, Georgia, People from Lynchburg, Tennessee, Deaths from bone cancer, 1932 births, 2020 deaths
Monterey Pop Festival	Pop music, Music festivals in the United States, 1967 in music, Music in California, 1967 in California
I Have a Dream	1963 in the United States, Martin Luther King Jr., Speeches, 1960s in Washington, D.C., August events
Secret Intelligence Service	Military of the United Kingdom, Intelligence agencies, Government agencies of the United Kingdom
Banksia	Proteaceae
Gollum	Fictional characters introduced in 1937, Dissociative identity disorder in fiction, Characters in The Hobbit, The Lord of the Rings characters
1184	1184
Fairy	Legendary creatures
1303	1303
1306	1306
1297	1297
1298	1298
1299	1299
1309	1309
1310	1310
1311	1311
1317	1317
1318	1318
1319	1319
1331	1331
1333	1333
1334	1334
1335	1335
1338	1338
1339	1339
1348	1348
1350	1350
1352	1352
1353	1353
1355	1355
1356	1356
1361	1361
1362	1362
1364	1364
1365	1365
1366	1366
1368	1368
1369	1369
1370	1370
1372	1372
1376	1376
1379	1379
1385	1385
1386	1386
1387	1387
London County Council	Local government in London, 1889 establishments in England, 1965 disestablishments in England
Denomination (currency)	Currency
Simulation	Research, Scientific modeling
Peter, Paul and Mary	1961 establishments in New York (state), 1960s American music groups, 1970s American music groups, 1980s American music groups, 1990s American music groups, 2000s American music groups, 2009 disestablishments in the United States, Folk music groups, Musical groups disestablished in 2009, Musical groups established in 1961, Musical groups from New York City, Musical groups disestablished in 1970, 1970 disestablishments in the United States, 1970s disestablishments in New York (state), Musical groups established in 1978, 1978 establishments in the United States, 1970s establishments in New York (state), 2000s disestablishments in New York (state)
Jennifer Warnes	1947 births, Living people, Singers from Los Angeles, California
Super Friends	Children's television series, English-language television programs
Warrabah National Park	Protected areas of New South Wales, National parks in Australia
Shepreth	Villages in Cambridgeshire
Everest College	Colleges and universities in Colorado, Colorado Springs, Colorado, 1897 establishments in the United States, 1890s establishments in Colorado
Ilocos	Regions of the Philippines
Bill Medley	1940 births, Living people, Singers from Los Angeles, California, Musicians from Los Angeles, California
Adventure	Sociology
Broom (shrub)	Faboideae
Broom	Cleaning tools
Cleanliness	Everyday life, Hygiene
Washing	Everyday life
The Wash	Geography of England, Ramsar sites
Thar Desert	Deserts of Pakistan, Geography of India, Rajasthan
List of shrubs	Lists of plants
Thyme	Lamiaceae, Herbs
Distribution	Basic English 850 words
Distributed computing	Computer science
Thymus	Lymphatic system
Frequency distribution	Statistics
British Overseas Territories	British overseas territories
Promenade concert	Concerts, London
1381	1381
1388	1388
1390	1390
1391	1391
1392	1392
1393	1393
1396	1396
1410	1410
1411	1411
1413	1413
1414	1414
1416	1416
1417	1417
1418	1418
1419	1419
1420	1420
1421	1421
1423	1423
1424	1424
1426	1426
1427	1427
1430	1430
1432	1432
1434	1434
1437	1437
1441	1441
National Air Traffic Services	Air traffic control, Companies of the United Kingdom, 2001 establishments in the United States
Czech Airlines	Czech Republic, Airlines of Europe, 1923 establishments in Europe
Arika Yumemiya	My-Otome
Protagonist	Fictional characters
That's So Raven	2003 American television series debuts, 2007 American television series endings, 2000s American sitcoms, American teen comedy television series, Disney Channel shows, Television series set in San Francisco, English-language television programs
Russian Armenia	History of Armenia, 19th century in Russia, 1829 establishments, 1918 disestablishments, 20th century in Russia
Ruben Studdard	1978 births, Living people, American Idol winners, Singers from Alabama
Monocotyledon	Monocots
Hornsby, New South Wales	Sydney
Glen Campbell	1936 births, 2017 deaths, Actors from Arkansas, American country musicians, American guitarists, American movie actors, American television actors, American voice actors, Deaths from Alzheimer's disease, Disease-related deaths in Tennessee, Musicians from Arkansas, Singers from Arkansas
Symphony No. 7 "Leningrad" (Shostakovich)	Compositions by Dmitri Shostakovich, Symphonies
Persian Armenia	History of Iran, History of Armenia
Iuridictum	Encyclopedias, Wikis
Rena Searrs	My-Otome
Nina Wang	Fictional Japanese people, My-Otome
Kidnapping	Kidnapping
Gurkha	Nepalese people
Moses of Chorene	Armenian writers, Armenian historians, 490s deaths, 5th century births
Decimal	Mathematics, Numbers
Numeral system	Numerals, Number theory, Systems
Mashiro Kazahana	My-Otome, My-HiME
Chairperson	Business
NeXTSTEP	Operating systems
Darwin (operating system)	Operating systems, Apple software
Mashiro	Given names
Graduation	Education, Ceremonies
Loyalty	Emotions, Virtues
ITunes	IPod, Apple software
AAC	Computer file formats for audio
WMA	Computer file formats for audio
Blair College	1996 establishments in the United States, 1990s establishments in Colorado, 2006 disestablishments in the United States
Regatta	Boat racing, Water sports
Touchscreen	Data input
My-HiME	My-HiME
Zodiac	Culture
Artemis Fowl	Series of books, Fantasy books, Lists of books
Lee Hazlewood	1929 births, 2007 deaths, Deaths from kidney cancer, Record producers, American singer-songwriters, American country singers, Singers from Oklahoma
Decimal separator	Mathematics
Moving Picture Experts Group	Computer file formats
Princess Iman bint Al Hussein	Jordanian people, Princes and princesses, 1983 births, Living people
Clannad	Irish rock bands, Grammy Award winners, County Donegal
Nicole Vaidišová	1989 births, Living people, Czech tennis players, Female tennis players, People from Nuremberg, Sportspeople from Bavaria
Tatiana Golovin	1988 births, Living people, Female tennis players, Russian tennis players
Home row	Typography
Arzashkun	Ancient Armenia, Urartu, Former national capitals, 9th century BC
Caucasus Mountains	Mountain ranges, Caucasus
Hayk	History of Armenia
Mol	Municipalities of Antwerp
Maya (software)	Graphics software
Gerry Adams	1948 births, Living people, British writers, Former members of Dáil Éireann, Former members of the British House of Commons for Northern Irish constituencies, Leaders of political parties in the United Kingdom, Northern Ireland Assembly, Former Members, Politicians from Belfast, Sinn Féin politicians, UK MPs 1983–1987, UK MPs 1987–1992, UK MPs 1997–2001, UK MPs 2001–2005, UK MPs 2005–2010, UK MPs 2010–2015
Northern Ireland Assembly	Northern Ireland Assembly, Belfast
Northern Ireland Office	Politics of Northern Ireland, Departments of the United Kingdom Government
Cyprian	Christian saints, African people, Christian writers, 3rd century births, 258 deaths
Flag of Cyprus	Republic of Cyprus, National flags
Simon Barere	Russian pianists, 1896 births, 1951 deaths
Tomsk	Capital cities in Russia, Siberia
Intelligent design	Intelligent design
Riaz Ahmed Gohar Shahi	1941 births, Missing people, Pakistani writers, Theologians, Asian Sufis, Living people
International Spiritual Movement Anjuman Serfaroshan-e-Islam	1980 establishments in Asia, Islamic organizations
Roman Curia	Vatican City, Roman Catholicism
In God We Trust	State mottos of the United States, Florida, Mottos of the United States
Apostolic Nunciature	Vatican City, Roman Catholicism
Software development	Software, Computers
Gag reflex	Reflexes
Flame	Fire
Kaliningrad	Kaliningrad, Exclaves, Capital cities in Russia
Roller derby	Skating
Sargon of Akkad	Mesopotamian people
Judea	History of the Middle East, Places of Ancient Rome, West Bank
Incubation period	Diseases
The New Yorker	American magazines, Magazines published in New York City, 1925 establishments in the United States, Weekly magazines
Cataplexy	Diseases
Sustainability	Everyday life, Sustainable development, Green politics
Brundtland Commission	History of the United Nations, Sustainable development, 1983 establishments
Mosleh Zamani	Iranian people
Climate change	Climate change
Gro Harlem Brundtland	Harvard University alumni, Norwegian diplomats, Politicians from Oslo, Prime Ministers of Norway, University of Oslo alumni, 1939 births, Living people
Allentown, Pennsylvania	County seats in Pennsylvania, Allentown, Pennsylvania, 1730s establishments in the Thirteen Colonies, 1735 establishments, 18th-century establishments in Pennsylvania
Mia Rose	Internet celebrities, 1988 births, Living people, YouTubers
Hepatitis A	Diseases caused by viruses, Liver disease
Hepatitis B	Diseases caused by viruses, Sexually transmitted diseases, Liver disease
Mir	Space stations
May Queen	Festivals
Mutual fund	Finance
Modular Audio Recognition Framework	Free software, Sound
Fullmetal Alchemist	Anime
My Dying Bride	Musical groups established in 1990, English heavy metal bands, Doom metal bands, Death metal bands, Gothic metal bands
Modular	Basic English 850 words
Framework	Logic
Documentation	Written communication
Bobby pin	Hair, Headgear
Pre-production	Movie production
Flax	Malpighiales, Edible nuts and seeds
Finite set	Set theory, Cardinal numbers
Vikram Samvat	History of India, 50s BC establishments, Calendars
Cardinality	Cardinal numbers, Set theory
Mitre	Christian clothing, Headgear
Boňkov	Boňkov, Villages in the Czech Republic
Utopia (book)	Novels, 1516 books
Order of the British Empire	Order of the British Empire
Slavníč	Villages in the Czech Republic
Milan Nakonečný	1932 births, Living people, Psychologists, Czech historians, Czech scientists
Skorkov	Villages in the Czech Republic
Antonín Klimek	Czech historians, Czech people, 2005 deaths, 1937 births
Neon Genesis Evangelion	Anime
Edward VIII	1894 births, 1972 deaths, Kings and Queens of the United Kingdom, Cancer deaths in France, Deaths from esophageal cancer, Fellows of the Royal Society, Knights and Dames Grand Cross of the Order of the British Empire, Knights Grand Commander of the Order of the Indian Empire, Knights Grand Commander of the Order of the Star of India, Knights Grand Cross of the Order of St Michael and St George, Knights Grand Cross of the Order of the Bath, Knights Grand Cross of the Royal Victorian Order, Knights of Justice of the Order of St John, Knights of the Garter, Knights of the Thistle, People from Surrey, United Kingdom Dukes, World record holders, Deaths from laryngeal cancer
Václav Benda	1946 births, 1999 deaths, Czech politicians
County borough	Political systems, Local government in England, 1974 disestablishments in the United Kingdom, 20th century disestablishments in England
Andie MacDowell	1958 births, Living people, Actors from South Carolina, American movie actors, American television actors
Goths	Germanic tribes, Ancient Rome
Arianism	Nontrinitarianism, Ancient Christianity
Ripening	Fruits
HTTP cookie	Internet
Chinese calendar	Chinese culture, Calendars
Music for the Royal Fireworks	Compositions by George Frideric Handel
Thora Birch	1982 births, Living people, Actors from Los Angeles, California, American child actors, American movie actors, American television actors
Sophia Loren	Academy Award Honorary Award winners, Academy Award winning actors, Actors from Campania, Actors from Rome, BAFTA Award winning actors, Golden Globe Award winning actors, Italian movie actors, Italian television actors, 1934 births, Living people
Helen Hunt	Actors from Culver City, California, Academy Award winning actors, American movie actors, American television actors, American voice actors, Emmy Award winning actors, Golden Globe Award winning actors, Screen Actors Guild Award winners, 1963 births, Living people
Jane Seymour (actress)	1951 births, Living people, Actors from Middlesex, Actresses who played Bond girls, Emmy Award winning actors, English movie actors, English television actors, Golden Globe Award winning actors
Goldie Hawn	Academy Award winning actors, Actors from Washington, D.C., American Buddhists, American movie actors, American television actors, Jewish American actors, Golden Globe Award winning actors, 1945 births, Living people
Meg Ryan	Actors from Fairfield, Connecticut, American movie actors, American movie producers, American television actors, Golden Globe Award winning actors, 1961 births, Living people
Dennis Quaid	1954 births, Living people, Actors from Houston, Texas, American movie actors
British Academy of Film and Television Arts	BAFTA Awards
Essay	Essays
Black Beauty	Children's books, 1877 books
Matilda (novel)	1988 books, Children's books, English-language novels
Leonard Nimoy	1931 births, 2015 deaths, Actors from Boston, Massachusetts, American activists, American movie directors, American movie actors, American photographers, American poets, American singer-songwriters, American television actors, American voice actors, Deaths from COPD, Disease-related deaths in Los Angeles, Musicians from Boston, Massachusetts, Singers from Boston, Massachusetts, Writers from Boston, Massachusetts
Hayden Christensen	1981 births, Actors from Toronto, Actors from Vancouver, Canadian movie actors, Canadian television actors, Living people
Stand-up comedy	Comedy, Theatrical forms
Car wash	Car wash, Automobiles
2007 Universal Forum of Cultures	Ecology, 2007 in Mexico, Monterrey
Midbrain	Anatomy of the brain
Dakota Fanning	Actors from Georgia (U.S. state), American Baptists, American child actors, American movie actors, American television actors, American voice actors, 1994 births, Living people
Hindbrain	Anatomy of the brain
Spanish broom	Faboideae
Salvia	Herbs, Salvia
Common sage	Herbs, Lamiaceae
List of Salvia species	Salvia, Lists of plants
Subshrub	Shrubs
Vinca	Apocynaceae
Shikoku (dog)	Dog breeds
Eddie Murphy	1961 births, Living people, Actors from New York City, African American comedians, African-American movie actors, African American movie producers, African-American screenwriters, African-American television actors, African-American voice actors, American stand-up comedians, American television producers, American television writers, Comedians from New York City, Golden Globe Award winning actors, Movie producers from New York City, Screen Actors Guild Award winners, Screenwriters from New York City
Jennifer Connelly	1970 births, Living people, American movie actors, Academy Award winning actors, Golden Globe Award winning actors, BAFTA Award winning actors, Actors from New York
Judy Garland	1922 births, 1969 deaths, Actors from Minnesota, American movie actors, American stage actors, Drug-related accidental deaths in the United Kingdom, Episcopalians, Golden Globe Award winning actors, Grammy Award winners, Singers from Minnesota, Stage names, Tony Award winning actors, Vaudeville performers
Liza Minnelli	1946 births, Living people, Academy Award winning actors, Actors from Hollywood, American movie actors, American musical theatre actors, American stage actors, BAFTA Award winning actors, Golden Globe Award winning actors, Tony Award winning actors
2007 Atlantic hurricane season	2007 Atlantic hurricane season
Yul Brynner	1920 births, 1985 deaths, Academy Award winning actors, American movie actors, American stage actors, American television actors, American television directors, Cancer deaths in New York City, Deaths from lung cancer, Naturalized citizens of the United States, Russian movie actors, Russian television actors, Tony Award winning actors, Vladivostok
Robert Redford	Kennedy Center honorees, Academy Award Honorary Award winners, Academy Award winning directors, Actors from Santa Monica, California, American movie actors, American television actors, BAFTA Award winning actors, Golden Globe Award winning actors, Golden Globe Award winning directors, Movie directors from California, Movie producers from California, 1937 births, Living people
Salvia pratensis	Salvia
Raymond Burr	1917 births, 1993 deaths, Actors from British Columbia, Canadian LGBT people, Canadian movie actors, Canadian television actors, Cancer deaths in the United States, Deaths from kidney cancer, Gay men, LGBT actors, Emmy Award winning actors
Michelle Pfeiffer	American movie actors, American television actors, BAFTA Award winning actors, Golden Globe Award winning actors, Actors from Santa Ana, California, 1958 births, Living people
Plant stem	Plant anatomy
NNDB	Websites
Vascular plant	Vascular plants
Treaty on the Final Settlement with Respect to Germany	History of Germany, Politics of Germany, East Germany, Berlin, World War II, Politics of France, Politics of the United Kingdom, Politics of the United States, Politics of the Soviet Union
Non-vascular plant	Non-vascular plants
Vascular tissue	Plant anatomy, Vascular plants
Phloem	Plant anatomy, Vascular tissue, Plant physiology, Plant tissues
Walter Matthau	Academy Award winning actors, American movie actors, American stage actors, American television actors, BAFTA Award winning actors, Golden Globe Award winning actors, Tony Award winning actors, Actors from New York City, 1920 births, 2000 deaths
Susan Sarandon	Academy Award winning actors, Actors from New Jersey, Actors from New York City, American movie actors, American movie producers, American television actors, American voice actors, BAFTA Award winners, Screen Actors Guild Award winners, 1946 births, Living people
Tim Robbins	1958 births, Living people, Academy Award winning actors, Actors from Los Angeles, California, Actors from New York City, American activists, American movie actors, American television actors, Golden Globe Award winning actors, Screen Actors Guild Award winners
Tigran Chukhajian	1837 births, 1898 deaths, Armenian composers
Jamie Lee Curtis	Actors from Santa Monica, California, American movie actors, American television actors, Jewish American actors, BAFTA Award winning actors, Golden Globe Award winning actors, 1958 births, Living people
People's Republic	Communism
Michael J. Fox	Actors from Alberta, American movie actors, American television actors, Canadian movie actors, Canadian television actors, Emmy Award winning actors, Entertainers from Edmonton, Golden Globe Award winning actors, Naturalized citizens of the United States, People with Parkinson's disease, 1961 births, Living people
Stomach flu	Diseases caused by viruses
Hurt (Christina Aguilera song)	2006 songs, Christina Aguilera songs
Movie producer	Movie producers, Movie occupations
Gastroenteritis	Infectious_diseases
Television pilot	Television series
James Doohan	1920 births, 2005 deaths, Actors from Vancouver, Canadian movie actors, Canadian television actors, Deaths from Alzheimer's disease, Deaths from pneumonia
Javanese language	Austronesian languages, Indonesia
Michael Douglas	Academy Award winning actors, Actors from New Jersey, American activists, American movie actors, Douglas family, American television actors, Cancer survivors, Golden Globe Award winning actors, 1944 births, Living people, New Brunswick, New Jersey
Kirk Douglas	1916 births, 2020 deaths, American centenarians, American stage actors, American radio actors, Television personalities from New York, Writers from New York, American autobiographers, Academy Award Honorary Award winners, Actors from New York, American movie actors, Douglas family, American television actors, Golden Globe Award winning actors, Kennedy Center honorees, American bloggers, People from Amsterdam, New York
James Stewart	1908 births, 1997 deaths, Deaths from pulmonary thrombosis, Academy Award winning actors, Actors from Pennsylvania, American aviators, American military people, American movie actors, American stage actors, Disease-related deaths in the United States, Golden Globe Award winning actors
James Cagney	1899 births, 1986 deaths, Academy Award winning actors, Presidents of the Screen Actors Guild, Actors from New York City, American movie actors, American stage actors, American television actors, Cardiovascular disease deaths in the United States, Deaths from myocardial infarction, Kennedy Center honorees
Spencer Tracy	Academy Award winning actors, Actors from Milwaukee, Wisconsin, American movie actors, American Roman Catholics, BAFTA Award winning actors, Deaths from myocardial infarction, Golden Globe Award winning actors, 1900 births, 1967 deaths
Gary Cooper	Academy Award Honorary Award winners, Academy Award winning actors, Actors from Montana, American movie actors, American Roman Catholics, Cancer deaths in the United States, Deaths from prostate cancer, Golden Globe Award winning actors, People from Helena, Montana, 1901 births, 1961 deaths
James Edward Keeler	1857 births, 1900 deaths, American astronomers
Cassini–Huygens	NASA spacecraft, Saturn
Fern	Pteridophyta
Horror movie	Horror movies, Movie genres
Laurence Fishburne	1961 births, Living people, Actors from Georgia (U.S. state), Actors from Brooklyn, American child actors, African-American movie actors, African American movie producers, African-American stage actors, African-American television actors, Drama Desk Award winners, Emmy Award winning actors, Movie producers from New York City, People from Augusta, Georgia, Tony Award winning actors, Writers from Brooklyn, Writers from Georgia (U.S. state)
Martin Sheen	Actors from Dayton, Ohio, American activists, American movie actors, American Roman Catholics, American television actors, Emmy Award winning actors, Emmy Award winning directors, Golden Globe Award winning actors, Movie producers from Ohio, 1940 births, Living people
Marlene Dietrich	1901 births, 1992 deaths, Actors from Berlin, American LGBT people, American movie actors, American singers, American stage actors, Bisexual people, Deaths from renal failure, Disease-related deaths in France, German atheists, German LGBT people, German movie actors, German stage actors, German singers, LGBT actors, LGBT musicians, Naturalized citizens of the United States, Radio actors, Silent movie actors, Tony Award winning actors
Northern Kurdistan	Kurdistan, Geography of Turkey
Mount Etna	Volcanoes of Italy, Sicily
Rojava	Kurdistan, Syria
Eastern Kurdistan	Kurdistan
John Terry	1980 births, Living people, 2006 FIFA World Cup players, 2010 FIFA World Cup players, Chelsea F.C. players, English footballers, People from Barking, Sportspeople from London, Premier League players
Umbrella (song)	2007 songs, Rihanna songs, Jay-Z songs, Hip hop songs, Pop songs, R&B songs
Shirley MacLaine	Academy Award winning actors, Actors from Richmond, Virginia, American movie actors, American television actors, BAFTA Award winning actors, Emmy Award winning actors, Golden Globe Award winning actors, 1934 births, Living people
Crown dependencies	Crown dependencies
Lieutenancies Act 1997	Government of the United Kingdom, British monarchy, Acts of the Parliament of the United Kingdom, 1997 in the United Kingdom
Meristem	Plant anatomy, Plant tissues
Vascular cambium	Vascular tissue
Cork cambium	Plant anatomy
Cork (material)	Wood
Cork oak	Fagales, Trees
Acorn	Nuts
President of Belarus	Politics of Belarus, Presidents of Belarus
Jay	Corvids
Clubmoss	Vascular plants, Plant taxonomy
Horsetail	Pteridophyta, Vascular plants
Green algae	Algae
Brackish water	Water, Ecology
Flagellate	Protista
Sustainable energy	Energy, Sustainable development
Neoprene	Polymers
Pioneer 11	Pioneer program
Medical tourism	Tourism, Medicine
Burrowing parakeet	Parakeets
Aquifer	Ecology, Aquifers
Voyager 2	Voyager program
World Party Day	Music festivals, Holidays
Tony Curtis	Actors from New York City, American movie actors, American television actors, Cardiovascular disease deaths in the United States, Deaths from cardiac arrest, Jewish American actors, 1925 births, 2010 deaths
Jack Lemmon	Academy Award winning actors, Actors from Massachusetts, American movie actors, American stage actors, American television actors, BAFTA Award winning actors, Deaths from bladder cancer, Deaths from colorectal cancer, Golden Globe Award winning actors, 1925 births, 2001 deaths
Errol Flynn	American movie actors, American movie directors, American movie producers, American screenwriters, American television actors, Australian movie actors, Australian television actors, Cardiovascular disease deaths in Canada, Deaths from myocardial infarction, Disease-related deaths in British Columbia, Naturalized citizens of the United States, People from Hobart, 1909 births, 1959 deaths
David Niven	1910 births, 1983 deaths, Academy Award winning actors, Actors from London, Actors who played James Bond, Actors who played M, Deaths from motor neurone disease, Disease-related deaths in Switzerland, English movie actors, English television actors, Extras, Golden Globe Award winning actors
Rudolph Valentino	1895 births, 1926 deaths, Italian actors, Silent movie actors
Raquel Welch	American movie actors, American television actors, Golden Globe Award winning actors, Actors from Chicago, 1940 births, Living people
Rita Hayworth	1918 births, 1987 deaths, Actors from Brooklyn, American dancers, American movie actors, Deaths from Alzheimer's disease, Disease-related deaths in New York City
Tommy Lee Jones	People from Midland, Texas, American movie actors, American movie directors, Academy Award winning actors, Golden Globe Award winning actors, Screen Actors Guild Award winners, Actors from Texas, 1946 births, Living people
James Garner	Actors from Oklahoma, American movie actors, American movie producers, American television actors, American voice actors, Emmy Award winning actors, Golden Globe Award winning actors, People from Norman, Oklahoma, Screen Actors Guild Award winners, Deaths from myocardial infarction, 1928 births, 2014 deaths
Anthony Quinn	Academy Award winning actors, American movie actors, American movie producers, American stage actors, American television actors, Cancer deaths in Massachusetts, Deaths from pneumonia, Deaths from throat cancer, Golden Globe Award winners, Infectious disease deaths in the United States, Mexican movie actors, Mexican television actors, 1915 births, 2001 deaths
Rock Hudson	Actors from Illinois, American movie actors, American television actors, Deaths from AIDS, Gay men, Golden Globe Award winning actors, Infectious disease deaths in California, LGBT actors, LGBT people from Illinois, People from Winnetka, Illinois, Stage names, 1925 births, 1985 deaths
Olivia de Havilland	1916 births, 2020 deaths, Actors from Tokyo, American centenarians, American movie actors, American stage actors, Best Actress Academy Award winners, British centenarians, British movie actors, British stage actors, Golden Globe Award winning actors, Naturalized citizens of the United States
Woody Allen	1935 births, Living people, Woody Allen, Academy Award winning directors, Academy Award winning writers, Actors from Brooklyn, Actors from the Bronx, American atheists, American movie actors, American stand-up comedians, American television actors, American television directors, American television writers, BAFTA Award winning directors, Comedians from New York City, Golden Globe Award winning writers, Jewish American actors, Jewish American writers, Jewish atheists, Movie directors from New York City, Screenwriters from New York City, Television personalities from New York City, Writers from Brooklyn, Writers from the Bronx
Maximus the Confessor	Christian saints
Toraja people	Ethnic groups in Asia, Indonesian people
Backmasking	Music
Separation of powers	Constitutions, Government, Politics
Exclusionary rule	United States law, Criminal investigation
Chitin	Carbohydrates, Macromolecules, Polymers, Natural materials
Radula	Molluscs, Animal anatomy
Exoskeleton	Animal anatomy
High Force	Waterfalls, Bodies of water of Europe, Geography of England, County Durham
Adetokunbo Ademola	Nigerian people, Chief justices, 1906 births, 1993 deaths
Endoskeleton	Zoology, Animal anatomy, Skeletal system
Kayfabe	Professional wrestling
Bruce Willis	Actors from New Jersey, American movie actors, American movie producers, American television actors, American television producers, American voice actors, Emmy Award winning actors, Golden Globe Award winning actors, Independent (United States), Musicians from New Jersey, 1955 births, Living people
Zoospore	Fungi
Gamete	Reproductive system
Morphology (biology)	Anatomy, Branches of zoology
Taxon	Taxonomy
Domain (biology)	Taxonomy
Keratin	Organic compounds, Proteins
Fibrous protein	Proteins
Protein filament	Molecular biology, Proteins
Hanami	Japanese culture
Landmarks	Geography
Neighbourhood	Neighborhoods
Lantern	Lamps
Cherry blossom	Japan, Trees, Rosaceae
Filamentation	Microbiology
Septum	Anatomy
National Youth Orchestra of Great Britain	Youth orchestras
Flag of Canada	Canada, National flags
The Wee Free Men	2003 books, Fantasy books, Children's books
Vandals	Germanic tribes
Order of the Thistle	Knights of the Thistle, British monarchy, 1687 establishments, 17th century establishments in Scotland, 1680s establishments in Europe
Nasal septum	Head (body part)
Nostril	Face
Ethmoid bone	Bones of the skull
Bundesverdienstkreuz	Order of Merit of the Federal Republic of Germany, 1951 establishments in Europe, 1950s establishments in Germany
Austin Lightning	American soccer teams, Sports in Texas, 2002 establishments in the United States, 2007 disestablishments in the United States
BBC Symphony Orchestra	BBC, British orchestras
Jiří Bělohlávek	1946 births, Czech people, 2017 deaths, Deaths from cancer, Conductors
Arturo Toscanini	1867 births, 1957 deaths, Cardiovascular disease deaths in the United States, Italian conductors, Musicians from Emilia-Romagna, Parma
Philip K. Dick	American novelists, Cardiovascular disease deaths in the United States, Deaths from stroke, Hugo Award winning writers, Writers from Chicago, 1928 births, 1982 deaths
Jet Propulsion Laboratory	United States government agencies, Astronomical organizations, Pasadena, California
Renewable energy commercialization	Renewable energy, Commerce, Climate change, Sustainable development
Mapudungun	Language isolates, Languages of Chile
Impurity	Chemistry
Queen's Hall	Concert halls in London
Avesta	Religious texts, Zoroastrianism
Darius I of Persia	Iranian people, Shahs of Iran
Pasargadae	History of Iran, World Heritage Sites in Iran
American Staffordshire Terrier	Terriers
Persepolis	History of Iran, World Heritage Sites in Iran
Xerxes	Shahs of Iran
Shell (zoology)	Zoology, Animal anatomy
Tortoise	Turtles
Sea turtle	Turtles, Marine reptiles
Report of 1800	1800, 18th century in the United States, United States law
Baykal (port)	Settlements in Russia
Rudder	Ship building
Exploration of Neptune	Neptune
Kinder Scout	Plateaus, Geography of England
Stern	Ship building
Urbain Le Verrier	1811 births, 1877 deaths, French mathematicians, French astronomers
John Malkovich	1953 births, Living people, Actors from Illinois, American movie actors, American television actors, Movie directors from Illinois, Movie producers from Illinois, Drama Desk Award winners, Emmy Award winning actors
Glenn Close	American movie actors, American movie producers, American stage actors, American television actors, American voice actors, Emmy Award winning actors, Golden Globe Award winning actors, Actors from Greenwich, Connecticut, Tony Award winning actors, 1947 births, Living people, People's Choice Award winners
Blaqk Audio	Musical groups from Oakland, California, Electronic music bands
Hugh Grant	Actors from London, BAFTA Award winning actors, English movie actors, English television actors, Golden Globe Award winning actors, 1960 births, Living people
James Caan	1940 births, Living people, American movie actors, American stage actors, American television actors, Jewish American actors, Actors from New York City
James Coburn	1928 births, 2002 deaths, Deaths from myocardial infarction, American movie actors, Academy Award winning actors, Actors from Nebraska, American television actors, People from Compton, California
4 Vesta	Asteroids
Animal liberation movement	Animal rights
Sex symbol	Celebrities, Feminism, Marketing, Sociology, Symbolism
Breakfast cereal	Breakfast foods, Grains
Sexual attraction	Human behavior, Human sexuality, Sexuality
Cheerios	Breakfast cereals
Rehearsal	Performing arts
London Symphony Orchestra	British orchestras
Obtuse angle	Angles
London Philharmonic Orchestra	British orchestras
Vladimir Jurowski	Russian conductors, 1972 births, Living people
Surrealism	Art movements
Pim Fortuyn	1948 births, 2002 deaths, Dutch academics, Dutch columnists, Dutch councillors, Dutch LGBT people, Dutch murder victims, Dutch party chairs, Dutch Roman Catholics, Dutch scientists, Former leaders of political parties in the Netherlands, Gay men, LGBT academics, LGBT Christians, LGBT politicians, LGBT scientists, LGBT writers, Murders by firearm, People from Rotterdam, People murdered in the Netherlands, Pim Fortuyn List politicians, Politicians from North Holland, Sociologists, Writers from North Holland
Cyrus the Great	6th century BC births, 530 BC deaths, Shahs of Iran
Rafał Wiechecki	1978 births, Living people, Polish politicians
Relative density	Basic physics ideas
Čejov	Čejov, Villages in the Czech Republic
Satsuma	Citrus
Data storage device	Storage devices
Relief	Sculpture
Frieze	Architectural elements
Entablature	Architectural elements
Flickr	Websites established in 2004, Social networking
Norton AntiVirus	Software
Haemophilia	Diseases, Genetic disorders
Otis Bowen	1918 births, 2013 deaths, Governors of Indiana, United States Secretaries of Health and Human Services, US Republican Party politicians
Guacamole	Condiments, Mexican sauces, Avocados
Gordan Nikolitch	Violinists, Concertmasters, Serbian musicians, 1968 births, Living people
1085	1085
Literal translation	Linguistics
Machine translation	Software, Linguistics, Languages
786	786
Interlinear text	Language
Transcription (linguistics)	Writing, Language transcription
Sumgait pogrom	1988, 1980s riots, 20th century in Armenia, 20th century in Azerbaijan
710	710
784	784
842	842
825	825
880	880
Momijigari	Japanese culture
Calm	Weather
Himeji Castle	Castles in Japan, World Heritage Sites in Japan, Japanese culture, Hyōgo Prefecture
Tang Dynasty	Chinese dynasties, 7th-century establishments in Asia, 10th century disestablishments in Asia, 618 establishments, 907 disestablishments
Divination	Occult
Emperor Saga	Emperors of Japan, 785 births, 842 deaths
Murder of Kriss Donald	2004 in the United Kingdom, 2000s in Scotland, British murder victims, Kidnapped British people, Murder in 2004, Murder in Scotland, Murders by blade weapons, People murdered in the United Kingdom, Racially-motivated violence
Imperial Court in Kyoto	History of Japan, Buildings and structures in Kyoto Prefecture, Kyoto, 8th century establishments in Japan, 1860s disestablishments in Japan, 794 establishments
Uhorilka	Villages in the Czech Republic
Ukiyo-e	Japanese culture, Printmaking, Art movements
Hiroshige	Japanese printmakers, 1797 births, 1858 deaths, People from Tokyo
Forecasting	Words
Japan Meteorological Agency	Japan
Ariwara no Narihira	825 births, 880 deaths, Japanese poets
Yoshino, Nara	Towns in Japan, Settlements in Nara Prefecture
Daigo, Ibaraki	Towns in Japan, Settlements in Ibaraki Prefecture
Ueno Park	Geography of Japan, Tokyo
Mansa Musa	1280 births, 1337 deaths, Kings and queens, Malian people, History of Africa
Macon, Georgia	Macon, Georgia, County seats in Georgia
The Tale of Genji	Japanese culture
Tokugawa Yoshimune	1684 births, 1751 deaths, Shoguns, People from Wakayama Prefecture
Toyotomi Hideyoshi	Daimyo, 1536 births, 1598 deaths, People from Aichi Prefecture
Motojirō Kajii	1901 births, 1932 deaths, Japanese writers, People from Osaka
Dumpling	Foods
Hank Williams	1923 births, 1953 deaths, American country musicians, American guitarists, American singer-songwriters, Drug-related accidental deaths, Blues musicians, Gospel musicians, Musicians from Alabama, Singers from Alabama
Sui Dynasty	Chinese dynasties, 581 establishments, Establishments in China, 618 disestablishments, 7th century disestablishments in Asia, 6th century establishments in Asia, Disestablishments in China
Bento	Japanese food
Clown	Entertainment occupations, Comedy, Circuses, Clowns
Dango	Japanese food
Music stand	Music
Cumulative voting	Voting
Proportional representation	Politics, Voting systems
Smokey Robinson	1940 births, Living people, African American musicians, American R&B musicians, American singer-songwriters, Singers from Detroit, Michigan
Andrew Davis	1944 births, Living people, British conductors, Knights Bachelor, Commanders of the Order of the British Empire, Alumni of King's College, Cambridge
Haiku	Japanese culture, Poetry forms
Gennady Rozhdestvensky	Russian conductors, 1931 births, 2018 deaths
Waka	Japanese culture, Poetry forms
Amiri Baraka	African American writers, American activists, American Muslims, American playwrights, American poets, American communists, Deaths from surgical complications, Writers from Newark, New Jersey, 1934 births, 2014 deaths
Jorge Luis Borges	1899 births, 1986 deaths, Argentine writers, People from Buenos Aires
Kobayashi Issa	1763 births, 1828 deaths, Japanese writers, Japanese poets, People from Nagano Prefecture
Masaoka Shiki	Japanese poets, Japanese journalists, 1867 births, 1902 deaths, People from Ehime Prefecture
Billy Collins	1941 births, Living people, Writers from New York City
Wind power in Texas	Wind energy, Texas
Yu Suzuki	Japanese video game designers, Sega people, 1958 births, Living people, People from Iwate Prefecture
Isra and Mi'raj	History of Islam, Quran
Fustat	Cities in Egypt, 641 establishments, Establishments in Egypt, 7th-century establishments in Africa
Vizier	Heads of state, Mughal Empire
Hank Williams Jr.	1949 births, Living people, American songwriters, American guitarists, Country musicians, Singers from Louisiana, Musicians from Louisiana
Utagawa Kunisada	Japanese printmakers, 1786 births, 1865 deaths, People from Tokyo
Tsukioka Yoshitoshi	Japanese printmakers, 1839 births, 1892 deaths, Artists from Tokyo
Odawara Castle	Castles in Japan
Ab urbe condita	Time
Mesosphere	Layers of Earth's atmosphere
Magnetosphere	Astrophysics, Solar System
Dorus Rijkers	1847 births, 1928 deaths, People from North Holland, Sailors
Prince of Wales	Princes and Princesses of Wales, British monarchy
Massachusetts Institute of Technology	Association of American Universities, Collegiate Water Polo Association, Cambridge, Massachusetts, Massachusetts Institute of Technology, 1861 establishments in the United States, 19th-century establishments in Massachusetts
The Colbert Report	2005 American television series debuts, 2014 American television series endings, 2000s American television series, 2010s American television series, American comedy television series, American television talk shows, Emmy Award winning programs, Television spin-offs, English-language television programs
Taneda Santoka	Japanese writers, 1882 births, 1940 deaths, Pen names, People from Yamaguchi Prefecture
Cid Corman	1924 births, 2004 deaths, Writers from Boston, Massachusetts
Lenard Moore	1958 births, Living people, American military people, Writers from North Carolina
Octavio Paz	1914 births, 1998 deaths, Cancer deaths in Mexico, Magazine founders, Mexican businesspeople, Mexican Nobel Prize winners, Mexican writers
Raymond Roseliep	Writers from Iowa, 1917 births, 1983 deaths, American poets
Kenneth Rexroth	1905 births, 1982 deaths, Writers from California, Writers from Indiana, Industrial Workers of the World
Sonia Sanchez	1934 births, Living people, Writers from Birmingham, Alabama
Gary Snyder	Writers from San Francisco, 1930 births, Living people, American environmentalists, Pulitzer Prize winners, Industrial Workers of the World
Genpei Akasegawa	1937 births, 2014 deaths, Deaths from sepsis, Japanese photographers, People from Kanagawa Prefecture
Aries	Astrological signs
Taurus (astrology)	Astrological signs
Christy Turlington	1969 births, Living people, Models from California
Premier	Government of Australia, Government of Canada, Government of the United Kingdom, Government occupations
Hispanidad	Spanish culture, Spanish language
Aviation	Aviation
Cyberpunk	Science fiction
Igbo language	Niger-Congo languages, Tonal languages
Wind shear	Winds
Polar cyclone	Severe weather
Geisha	Japanese words and phrases, Entertainment occupations, Entertainment in Japan
Thomas Midgley	American chemists, American inventors, Cornell University alumni, Scientists from Pennsylvania, Scientists from Columbus, Ohio, Businesspeople from Pennsylvania, Businesspeople from Columbus, Ohio, 1889 births, 1944 deaths
Hovhannes Shiraz	1915 births, 1984 deaths, Armenian poets
Polar low	Meteorology
Pericles	495 BC births, 429 BC deaths, Ancient Greek military people, Ancient Greek politicians, Generals
Wind speed	Winds
Thebes, Greece	Thebes, Greece
Minoan civilization	Minoan culture
Alliance	War
Epic poetry	Poetry forms
Kousuke Atari	1980 births, Living people, Japanese singers, People from Kagoshima Prefecture
The Apostles (Elgar)	Oratorios, Compositions by Edward Elgar
Knot (speed)	Units of measurement, Water transport
Royal Philharmonic Orchestra	British orchestras
Adrian Boult	1889 births, 1983 deaths, British autobiographers, British conductors, Companions of Honour, Knights Bachelor, Musicians from Cheshire, People from Chester
Franz Lehár	1870 births, 1948 deaths, Romantic composers, 20th century composers, Hungarian composers
Rings of Neptune	Neptune
Igor Diakonov	1914 births, 1999 deaths, Russian historians
Baudouin I of Belgium	1930 births, 1993 deaths, Belgian Roman Catholics, Cardiovascular disease deaths in Spain, Deaths from heart failure, Disease-related deaths in Andalusia, Kings and Queens of Belgium, Knights of the Golden Fleece, People from Brussels
Mesocyclone	Weather
Florida International University	Colleges and universities in Florida, Oak Ridge Associated Universities, Conference USA, Miami, Florida, 1965 establishments in the United States, 1960s establishments in Florida
Sash	Accessories
Willow	Trees, Malpighiales
Elegance	Vocabulary
Courtesan	Personal service occupations, Prostitution
Jester	Entertainment occupations, Middle Ages
Etiquette	Sociology, Traditions
Hairstyle	Hairstyles, Care
Patronage	Politics, Art
Reputation	Society
Lagunaria	Malvaceae
Warwick Estevam Kerr	1922 births, 2018 deaths, Biologists, São Paulo (state), Brazilian scientists
Indian national calendar	Calendars
Crane (bird)	Cranes
Estimation	Mathematics
Fee	Economics
Maid	Personal service occupations, Domestic work
Embroidery	Needlework
Banquet	Meals
Eccentricity	Sociology, Human behavior
Květinov	Villages in the Czech Republic
Úsobí	Villages in the Czech Republic
Conversation	Human communication, Everyday life
FK Viktoria Žižkov	Czech football clubs
Wit	Language
Joss stick	Religious objects, Perfumery
AFK Union Žižkov	Czech football clubs, 1907 establishments in Europe
2004 Atlantic hurricane season	2004 Atlantic hurricane season
Flirting	Human communication
Trustworthiness	Virtues
Shamisen	Japanese music, Plucked string instruments
Obi	Japanese clothing
Nitrogen fixation	Ecology, Biochemistry
Britské listy	Czech Republic, Politics of Europe, Publications
Nitrogen cycle	Ecology
Moscow State University	Colleges and universities in Russia, Buildings and structures in Moscow, 1755 establishments
Boarding school	Types of educational institutions
Sacha Baron Cohen	1971 births, Living people, Actors from London, BAFTA Award winners, Comedians from London, Commanders of the Order of the British Empire, English movie actors, English movie producers, English television actors, English television writers, Golden Globe Award winning actors, Jewish British actors, Jewish British writers, Jewish comedians, People from Hammersmith, Screenwriters from London
Utrecht (province)	Utrecht (province)
George II of Great Britain	1683 births, 1760 deaths, Electors and Electresses, Kings and Queens of Great Britain
List of Disney characters	Disney characters, Lists of fictional characters, Movie characters
Mandy Moore	Actors from Florida, Actors from New Hampshire, American child actors, American child singers, American movie actors, American pop musicians, Musicians from Florida, Singers from Florida, Musicians from New Hampshire, Singers from New Hampshire, American singer-songwriters, American television actors, American voice actors, 1984 births, Living people
Oiran	Personal service occupations, Japanese culture, Prostitution, Japanese people
Ryōtei	Asian restaurants, Japanese culture
Philharmonia	British orchestras
Taiko	Japanese music, Drums
Kitagawa Utamaro	1753 births, 1806 deaths, Japanese printmakers
Hanamachi	Japanese culture
Japanese traditional dance	Japanese culture, Dance types
Parkour	Parkour, Leisure
Shakuhachi	Japanese music, Flutes
Christian movements	Christian movements and denominational families
Li Guang	119 BC deaths, Han Dynasty generals, Year of birth unknown
Royal Borough of Kensington and Chelsea	Royal Borough of Kensington and Chelsea
London Borough of Enfield	London Borough of Enfield
List of English districts by area	Lists about England
Huo Qubing	140 BC births, 117 BC deaths, Han Dynasty generals
Kali Yuga	Hinduism, Time
Squash (plant)	Vegetables, Cucurbitaceae, Fruits
Nelumbo	Plant families, Proteales, Plants of Pakistan, National symbols of India, Aquatic plants
Nymphaeaceae	Plant families, Nymphaeales
Ugly Betty	2006 American television series debuts, 2010 American television series endings, 2000s American television series, 2010s American television series, ABC network shows, American comedy-drama television series, American sitcoms, Golden Globe Award winning programs, Peabody Award winners, Television series set in New York City, English-language television programs
Shinto shrine	Shinto shrines
Miko	Religious occupations, Shinto
Mineko Iwasaki	Japanese entertainers, Autobiographers, 1949 births, Living people, People from Kyoto Prefecture
List of English districts by population	Lists about England
Libra (astrology)	Astrological signs
Matsya	Hinduism, Hindu mythology
Kurma	Hinduism, Hindu mythology
Varaha	Hinduism, Hindu mythology
Prithvi	Hindu gods and goddesses
Daitya	Hinduism
Manu	Hinduism
Wild boar	Pigs
Narasimha	Hinduism, Hindu mythology
Prahlada	Hinduism
Yuga	Hinduism, Time
Vamana	Hinduism, Hindu mythology
Parashurama	Hinduism, Hindu mythology
Balarama	Hindu mythology
Ba Ðình Square	Hanoi, National squares
Ho Chi Minh Mausoleum	Buildings and structures in Vietnam, Burial monuments and structures, Hanoi
Meng Tian	210 BC deaths, Chinese generals
Kippah	Judaism, Religious clothing, Headgear
Judeo-Arabic languages	Judaism, Middle East, Semitic languages
The Clangers	1969 establishments in Europe, 1974 disestablishments in the United Kingdom, 1960s British television series, 1970s British television series, British children's television series, British science fiction television series, 1974 television series endings, 1960s establishments in the United Kingdom, English-language television programs
London Borough of Hammersmith and Fulham	London Borough of Hammersmith and Fulham
1 E9 m²	Orders of magnitude
1 E8 m²	Orders of magnitude
1 E7 m²	Orders of magnitude
Athletics at the Summer Olympics	Summer Olympic Games
1968 Summer Olympics	1968 Summer Olympics
Sima Qian	2nd century BC births, 1st century BC deaths, Chinese historians
Gymnastics at the 1972 Summer Olympics	Gymnastics, 1972 Summer Olympics
Rowing at the 1980 Summer Olympics	1980 Summer Olympics, Rowing
Coxless pair	Rowing
79	79
1976 Summer Olympics	1976 Summer Olympics
1960 Winter Olympics	1960 Winter Olympics, 1960 in sports, 1960 in California
1984 Winter Olympics	1984 Winter Olympics, 1984 in sports, 1984 in Europe, 20th century in Bosnia and Herzegovina
1988 Winter Olympics	1988 Winter Olympics
Records of the Grand Historian	History of China
Football at the Summer Olympics	Football at the Olympics
1976 Winter Olympics	1976 in sports, 1976 in Europe, 20th century in Austria, Innsbruck, Sport in Austria, Winter Olympics in Europe
Gymnastics at the Summer Olympics	Summer Olympic Games, Gymnastics
Biathlon	Skiing, Sport shooting
1972 Summer Olympics	1972 Summer Olympics
Royal borough	English boroughs
Emperor Wu of Jìn	Emperors and Empresses of China, 236 births, 290 deaths
John Couch Adams	1819 births, 1892 deaths, English astronomers, English mathematicians, People from Cornwall
Pygmy people	Ethnic groups in Africa
Itihasa	Hinduism, Hindu texts
Bhakti yoga	Hinduism
International Society for Krishna Consciousness	1966 establishments in the United States, 1960s establishments in New York (state), Hinduism, New religious movements
Hare Krishna	Hinduism
A. C. Bhaktivedanta Swami Prabhupada	1896 births, 1977 deaths, Hindu gurus
Purana	Hinduism, Hindu texts
Patti LaBelle	Singers from Philadelphia, Pennsylvania, 1944 births, Living people
Whitney Houston	Accidental deaths by drowning in the United States, Actors from Newark, New Jersey, African American actors, African American musicians, American movie actors, American movie producers, Emmy Award winners, Grammy Award winners, Writers from Newark, New Jersey, Musicians from Newark, New Jersey, Singers from Newark, New Jersey, 1963 births, 2012 deaths, Whitney Houston
Folklore	Folklore
Kappa	Greek alphabet
Văn Cao	Vietnamese people, composers, 1923 births, 1995 deaths
Kojiki	History of Japan, Japanese mythology, Shinto
Hindu philosophy	Hinduism
Guru	Hinduism, Buddhism, Sikhism, Spiritual teachers, Religious leaders
Moksha	Hinduism
Caste	Hinduism
Brahmin	Hinduism
Kshatriya	Hinduism
Vaishya	Hinduism
Shudra	Hinduism
Jnana Yoga	Hinduism
Atharva Veda	Hinduism, Vedas
London Borough of Tower Hamlets	London Borough of Tower Hamlets
Uriah Heep	English hard rock bands, English heavy metal bands, Musical groups from London
E-book	Books, Technology
Church–Turing thesis	Theoretical computer science
London Borough of Brent	London Borough of Brent
London Borough of Ealing	London Borough of Ealing
Tamamo-no-Mae	Japanese folklore, Japanese mythology
London Borough of Hounslow	London Borough of Hounslow
London Borough of Richmond upon Thames	London Borough of Richmond
Royal Borough of Kingston upon Thames	Royal Borough of Kingston upon Thames
London Borough of Sutton	London Borough of Sutton
London Borough of Bromley	London Borough of Bromley
London Borough of Lewisham	London Borough of Lewisham
London Borough of Bexley	London Borough of Bexley
London Borough of Havering	London Borough of Havering
London Borough of Barking and Dagenham	London Borough of Barking and Dagenham
London Borough of Redbridge	London Borough of Redbridge
London Borough of Newham	London Borough of Newham
London Borough of Waltham Forest	London Borough of Waltham Forest
London Borough of Haringey	London Borough of Haringey
London Borough of Barnet	London Borough of Barnet
London Borough of Harrow	London Borough of Harrow
London Borough of Hillingdon	London Borough of Hillingdon
John Shakespeare	1530s births, 1601 deaths, People from Warwickshire
Norwegian Elkhound	Dog breeds
Kim Dae-jung	1926 births, Presidents of South Korea, Roman Catholics, Deaths from multiple organ failure, 2009 deaths
Conway's Game of Life	Computers, Biology
Bio Booster Armor Guyver	1985 manga, 1986 horror movies, 1991 movies, 1994 movies, 2005 anime television series, American action movies, Anime OVAs, Anime series, Manga series
Repulse Bay	Geography of Hong Kong, Beaches of Asia
Pelagianism	Ancient Christianity‎
Goggles	Protective clothing, Headgear
Urashima Tarō	Japanese folklore, Japanese mythology
Electrical generator	Electricity, motors
Paste	Basic English 850 words
Inert gas	Gases
Emperor Gaozu of Han	Emperors of Han Dynasty, 3rd century BC births, 190s BC deaths
Unification Church	New religious movements, Nontrinitarianism
Philip Pullman	1946 births, Living people, Agnostics, English novelists, People from Norwich, Writers from Norfolk
Yomi	Japanese mythology, Shinto, Afterlife
Ryūgū-jō	Japanese mythology, Japanese folklore
Imp	Legendary creatures
British Asian	Ethnic groups in the United Kingdom
Black British	Black British people
Ryūjin	Japanese folklore, Japanese mythology, Shinto
Takamagahara	Shinto, Japanese mythology
Gospel music	Christian music, Music genres
Salsa	Musical forms, Latin dances
Gwen Stefani	1969 births, Living people, American fashion designers, American R&B singers, American pop singers, American rap musicians from California, American rock singers, Brit Award winners, Grammy Award winners, Gwen Stefani, No Doubt members, People from Anaheim, California, Singer-songwriters from California
Izumo Province	Former provinces of Japan, Shimane Prefecture
Mount Hiei	Mountains of Japan
Momotarō	Japanese mythology, Japanese folklore, Fairy tales
Ama-no-Uzume	Japanese deities, Shinto
Susanoo	Japanese deities, Shinto
Ninigi-no-Mikoto	Japanese mythology, Shinto
Preston	City of Preston, Lancashire, 2002 establishments in England
Onryō	Japanese folklore
British Chinese	Ethnic groups in the United Kingdom
British African-Caribbean community	Ethnic groups in the United Kingdom
Flag of Switzerland	Switzerland, National flags
Taizu Emperor	Emperors of Qing Dynasty, 1559 births, 1626 deaths
Japanese dragon	Japanese folklore, Japanese mythology
Japanese mythology	Japanese mythology, Shinto
Huang Taiji	1592 births, 1643 deaths, Emperors of Qing Dynasty
Japanese folklore	Japanese folklore
Meiji period	Japanese eras, 1868 establishments in Japan, 1912 disestablishments, 20th century disestablishments in Japan
Pheasant	Phasianidae
Polytonality	Music theory
M1 motorway	Motorways in England
Teddy Randazzo	Singers from New York City, Singer-songwriters from New York, 1935 births, 2003 deaths
Kaspar Hauser	1810s births, 1833 deaths, Children, Mysterious people, People from Nuremberg
Police station	Police stations
Twist (dance)	Dances, Pop music
Cover version	Musical terminology
The Kingsmen	American rock bands, Musical groups from Oregon, 1959 establishments in the United States, Musical groups established in 1959, 20th-century establishments in Oregon
Obscenity	Culture
Hank Ballard	Singers from Detroit, Michigan, American singer-songwriters, 1936 births, 2003 deaths
Disciples of Christ	Protestantism
Bruno Bauer	1809 births, 1882 deaths, German philosophers
Zsa Zsa Gábor	1917 births, 2016 deaths, Naturalized citizens of the United States, Actors from Budapest, American movie actors, American radio actors, American socialites, American stage actors, American television actors, American voice actors, Cardiovascular disease deaths in Los Angeles, Deaths from coronary artery disease, Deaths from cardiopulmonary arrest, Hungarian movie actors
Brittany Snow	1986 births, Living people, Actors from Florida, American movie actors, American television actors, Actors from Tampa, Florida, Singers from Tampa, Florida
Desk	Furniture
Coles Supermarkets	Supermarkets of Australia, 1914 establishments, 1910s establishments in Australia
Empire of Nicaea	Middle Ages, 1204 establishments, 1261 disestablishments, 1200s establishments in Asia, 13th century disestablishments in Asia
National Stock Exchange of India	Stock exchanges, Economy of India, 1992 establishments in Asia, 1990s establishments in India, Companies listed on the National Stock Exchange of India
John Whedon	1905 births, 1991 deaths, American screenwriters
List of Buffy the Vampire Slayer episodes	Whedonverse, Lists of television series episodes
Buffy Summers	Angel (TV series) characters, Buffy the Vampire Slayer characters, Fictional characters introduced in 1992, Whedonverse
Spike (Buffyverse)	Angel (TV series) characters, Buffy the Vampire Slayer characters, Buffyverse vampires, Fictional British people, Fictional characters introduced in 1997
Angel (Buffyverse)	Angel (TV series) characters, Buffy the Vampire Slayer characters, Buffyverse vampires, Fictional characters introduced in 1997
First Evil	Buffy the Vampire Slayer characters, Fictional characters introduced in 1998, Fictional mass murderers, Fictional shapeshifters
Shunzhi Emperor	Emperors of Qing Dynasty, 1638 births, 1661 deaths
Hush (Buffy the Vampire Slayer)	1999 television episodes, Buffy the Vampire Slayer episodes
David Greenwalt	American screenwriters, Writers from Los Angeles, California, Whedonverse, 1949 births, Living people
Đồng Hới	Cities in Vietnam, Quang Binh Province
Phong Nha-Kẻ Bàng National Park	World Heritage Sites in Asia, Quảng Bình Province, National parks in Vietnam, 2001 establishments in Asia, 21st century establishments in Vietnam
Tan Son Nhat International Airport	Airports in Vietnam, 1930s establishments in Asia, 20th century establishments in Vietnam
Romulus Augustus	461 births, 5th century deaths, Roman Emperors
463	463
476	476
395	395
Justinian I	482 births, 565 deaths, Byzantine Emperors
Diocletian	240s births, 310s deaths, Roman Emperors
Huns	Ethnic groups in Asia, Eurasian nomads
Visigoths	Germanic tribes, History of France, History of Spain
Turkic peoples	Turkic peoples
116	116
Trajan	53 births, 117 deaths, Roman Emperors
Amazons	People in Greek mythology
Tammy Faye Messner	1942 births, 2007 deaths, American television talk show hosts, Cancer deaths in Missouri, Deaths from colorectal cancer, Singers from Minnesota, The Surreal Life participants
Sapphire	Gemstones, Birthstones
Anne Hathaway	1982 births, Living people, Actors from Brooklyn, American movie actors, American stage actors, American television actors, American voice actors, BAFTA Award winning actors, Best Supporting Actress Academy Award winners, Emmy Award winning actors, Golden Globe Award winning actors, Saturn Award winners, Screen Actors Guild Award winners, Former Roman Catholics, American LGBT rights activists, Musicians from Brooklyn
Fear Factor	American reality television series, NBC network shows, English-language television programs
Joe Rogan	1967 births, Living people, Actors from Newark, New Jersey, American game show hosts, American martial artists, American television actors, American television presenters, Comedians from New Jersey, Participants in American reality television series, Podcasters, Television personalities from New Jersey
Endemol	1994 establishments in Europe, Entertainment companies, Companies of the Netherlands, Amsterdam, Hilversum
Hilton Hotels	Companies of the United States, Hotel chains
Emily Osment	1992 births, Living people, Actors from Los Angeles, California, American child actors, American movie actors, American television actors, Disney actors
Kerry Katona	1980 births, Living people, Actors from Cheshire, Big Brother contestants, Dancing on Ice participants, English movie actors, English pop singers, English television actors, Musicians from Cheshire, People from Warrington, People with bipolar disorder, Reality television participants, Television personalities from Cheshire
Atomic Kitten	1990s British music groups, 1998 establishments in England, 2000s British music groups, 2010s British music groups, British girl groups, English pop music groups, Musical groups established in 1998, Musical groups from Liverpool
Warrington	Towns in Cheshire, Unitary authorities
Darin Zanyar	1987 births, Living people, Swedish singers
Gästrikland	Provinces of Sweden
Uppland	Provinces of Sweden
Västmanland	Provinces of Sweden
Värmland	Provinces of Sweden
Gulf of Bothnia	Gulfs, Atlantic Ocean, Geography of Finland, Geography of Sweden
Lolo Ferrari	1963 births, 2000 deaths, Drug-related suicides, French movie actors, French models, French television personalities, People from Clermont-Ferrand, Pornographic actors, Prostitutes, Suicides in France, World record holders
Fluorescent lamp	Lamps
My December	2007 albums, Kelly Clarkson albums, Pop albums
Tropical Storm Chantal (2007)	Atlantic tropical storms, Hurricanes in Bermuda, 2007 Atlantic hurricane season, 2000s in Bermuda, 2007 in Canada
Flinders Street Station	Railway stations in Melbourne, 1854 establishments, 1850s establishments in Australia
RIOT!	2007 albums, Paramore albums
Paramore	2004 establishments in the United States, 2000s American music groups, 2010s American music groups, Alternative music, American punk bands, Musical groups established in 2004, Musical groups from Tennessee, Paramore, 2000s establishments in Tennessee, People's Choice Award winners
Stonemasonry	Art
Ouran High School Host Club	Manga
Wei Yuan	1794 births, 1857 deaths, Chinese scholars
Herbert von Karajan	1908 births, 1989 deaths, Austrian conductors, Grammy Award winners, Order of Merit of the Federal Republic of Germany, People from Salzburg, Nazis
Snape Maltings	Concert halls in England
Gladiator	Ancient Rome, Occupations
Ohm's law	Electricity
Lin Shu	1852 births, 1924 deaths, Chinese people, Chinese translators
Kamikaze	History of Japan, World War II, Military aviation
Ü	Latin letters with diacritics, Vowel letters
Umlaut	German language, Alphabetic diacritics
Ö	Latin letters with diacritics, Vowel letters
List of emperors of China	Emperors and Empresses of China, Lists of heads of state
Ä	Latin letters with diacritics, Vowel letters
Ulyanovsk	Ulyanovsk, Capital cities in Russia
Age of Enlightenment	Europe, 18th century in Europe
Hawk	Falconiformes
Bird of prey	Birds, Strigiformes, Falconiformes, Accipitriformes
O RLY?	Internet memes
World Peace One	Rock music, Culture, Music festivals
Jeffrey Buttle	1982 births, Living people, Sportspeople from Ontario, Canadian figure skaters
Ina Bauer	Figure skating
Shawn Sawyer	1985 births, Living people, Canadian figure skaters
Brian Orser	1961 births, Canadian figure skaters, Canadian LGBT people, Canadian Olympic silver medalists, Gay men, LGBT Olympians, Living people, Sportspeople from Ontario
Yuna Kim	1990 births, Living people, Competitors at the 2018 Winter Olympics, Figure skaters, Medalists at the 2010 Winter Olympics, Medalists at the 2014 Winter Olympics, Olympic gold medalists, Olympic silver medalists, South Korean sportspeople
Christopher Mabee	1985 births, Living people, Sportspeople from Ontario, Canadian figure skaters
Tanith Belbin	American figure skaters, Canadian figure skaters, Sportspeople from Ontario, 1984 births, Living people
Benjamin Agosto	American figure skaters, Sportspeople from Chicago, 1982 births, Living people
Ice dancing	Figure skating, Dance types, Winter Olympic sports
Charlie White	1987 births, Living people, American figure skaters, Sportspeople from Michigan
Meryl Davis	1987 births, Living people, American figure skaters, Sportspeople from Michigan
Treaty of Shimonoseki	History of Japan, Treaties involving China, 19th century treaties, 1895
Tessa Virtue	Canadian figure skaters
Scott Moir	Canadian figure skaters
Albena Denkova	1974 births, Living people, Bulgarian sportspeople, Figure skaters, People from Sofia
Maxim Staviski	1977 births, Living people, Bulgarian sportspeople, Russian figure skaters, Soviet figure skaters
First Sino-Japanese War	1894, 1895, 1890s in Asia, History of Korea, History of Taiwan, Wars involving China, Wars involving Japan
Johnny Weir	1984 births, Living people, American figure skaters, American LGBT people, American Olympians, Gay men, LGBT Olympians, Sportspeople from Pennsylvania
Nobunari Oda	1987 births, Living people, Japanese figure skaters, People from Osaka Prefecture
The Simpsons Movie	2007 animated movies, 2007 comedy movies, American animated movies, American comedy movies, The Simpsons, Movies based on TV series, English-language movies, Adult animated movies, 20th Century Fox movies
Male enhancement	Human sexuality
Californication (TV series)	2007 American television series debuts, 2000s American television series, 2010s American television series, 2014 American television series endings, American drama television series, Television series set in Los Angeles, California, English-language television programs
Honour	Virtues
Oil field	Fuel
Takeoff	Aviation
Brian Joubert	1984 births, Living people, 2002 Winter Olympics, 2006 Winter Olympics, 2010 Winter Olympics, 2014 Winter Olympics, Figure skaters, French Olympians, People from Poitiers
Pap	Cities in Uzbekistan
Gift	Giving
Timothy Goebel	1980 births, Living people, American adoptees, American figure skaters, American Olympic bronze medalists, Sportspeople from Illinois, Columbia University alumni
Angela Nikodinov	People from Spartanburg, South Carolina, American figure skaters, Sportspeople from South Carolina, 1980 births, Living people
Alberto Gonzales	Politicians from San Antonio, Texas, 1955 births, Living people, United States Attorneys General
Cantilever	Cantilevers, Figure skating
Mao Asada	1990 births, Living people, Japanese figure skaters, Japanese Olympic silver medalists, People from Aichi Prefecture, Medalists at the 2010 Winter Olympics, Radio personalities
Catia	Software
Brigham Young	1801 births, 1877 deaths, American Latter Day Saints, Christian religious leaders, Governors of Utah, 19th century in Utah, American abolitionists, American educators, American theologians, Christian mystics, Deaths from peritonitis, Freemasons, Mormonism, People from Salt Lake City, Utah, Politicians from Utah, Religious leaders
Speaker (politics)	Legislative speakers, Government occupations
Orator	Public speaking, Politics
Parsifal	Compositions by Richard Wagner, Operas, Works based on the Arthurian legend
Kana	Writing systems, Japanese language
Tropical Storm Erin (2007)	2007 in Texas, Atlantic tropical storms, Hurricanes in the United States, 2000s in Oklahoma
Antonio Banderas	1960 births, Living people, Entertainers from Andalusia, People from Malaga, Spanish movie actors, Spanish movie directors, Spanish movie producers, Spanish stage actors, Spanish television actors, Spanish voice actors
Jim Carrey	1882 births, 2009 deaths, Living people, Actors from Ontario, Canadian Christians, Canadian comedians, Canadian movie actors, Canadian television actors, Canadian voice actors, Canadian writers, Golden Globe Award winning actors, Naturalized citizens of the United States
Egyptian cobra	Elapidae
Mikhail Baryshnikov	1948 births, Living people, American movie actors, Ballet dancers, Emmy Award winners, People from Riga, Russian dancers
Batman Begins	2005 movies, English-language movies, Batman movies, Warner Bros. movies, Movies based on comic book characters, Movies shot in Chicago, Illinois, Nonlinear narrative movies, American action movies, American thriller movies, Movies composed by Hans Zimmer, Movies composed by James Newton Howard, Movies directed by Christopher Nolan, Movies produced by Charles Roven, The Dark Knight Trilogy, Reboot movies, American superhero movies
Liam Neeson	1952 births, Living people, Irish movie actors, Irish television actors, Irish voice actors, Actors from Northern Ireland, Irish stage actors, Irish radio actors, County Antrim
Great Seal of the United States	Symbols of the United States, National coats of arms
1444	1444
Biellmann spin	Figure skating
1445	1445
Omar Sharif	1932 births, 2015 deaths, Contract bridge players, Converts to Islam, Deaths from myocardial infarction, Disease-related deaths in Egypt, Egyptian movie actors, Egyptian Muslims, Egyptian sportspeople, Egyptian television actors, Former Christians, Golden Globe Award winning actors, People from Alexandria, People with Alzheimer's disease
Toshirō Mifune	1920 births, 1997 deaths, Deaths from multiple organ failure, Japanese movie actors
Andy García	American movie actors, Actors from Florida, Cuban actors, 1956 births, Living people
Rodrigo Santoro	1975 births, Living people, Brazilian actors
Michael Caine	1933 births, Living people, Actors from London, BAFTA Award winning actors, Best Supporting Actor Academy Award winners, English movie actors, English stage actors, English television actors, English voice actors, Golden Globe Award winning actors, Military personnel of the Korean War, Screen Actors Guild Award winners, Stage names
Begging	Occupations
Benicio del Toro	1967 births, Living people, Actors who played Bond villains, American movie actors, American movie producers, Puerto Rican actors, Academy Award winning actors, BAFTA Award winning actors, Golden Globe Award winning actors, Actors from Pennsylvania
Geoffrey Rush	Academy Award winning actors, Actors from Queensland, Australian movie actors, Australian of the Year Award winners, Australian television actors, Australian voice actors, BAFTA Award winning actors, Emmy Award winning actors, Golden Globe Award winning actors, Screen Actors Guild Award winners, 1951 births, Living people
Joaquin Phoenix	Actors who played the Joker, Best Actor Academy Award winners, Grammy Award winners, BAFTA Award winning actors, Golden Globe Award winning actors, Screen Actors Guild Award winners, 1974 births, Living people, American political activists, American animal rights activists, American child actors, American television actors, American stage actors, American voice actors, American movie actors, Humanitarians, American philanthropists, American movie producers, Jewish American actors, People from San Juan, Puerto Rico
William Hurt	1950 births, Living people, American movie actors, BAFTA Award winners, Academy Award winning actors, Actors from Washington, D.C.
Adrien Brody	1973 births, Living people, Best Actor Academy Award winners, Actors from New York City, American movie actors, American television actors
Mark Wahlberg	Actors from Boston, Massachusetts, American movie actors, American movie producers, American people convicted of assault, American pop musicians, American rap musicians from Massachusetts, American Roman Catholics, American television actors, American television producers, BAFTA Award winners, Businesspeople from Boston, Massachusetts, Musicians from Boston, Massachusetts, Singers from Boston, Massachusetts, 1971 births, Living people
Wesley Snipes	Actors from Orlando, Florida, Actors from the Bronx, African American actors, American movie actors, African American movie producers, American television actors, 1962 births, Living people
Jak 3	2004 video games, 3D platform games, Naughty Dog games, PlayStation 2 games, Jak and Daxter series
Edward Norton	1969 births, Living people, American movie actors, American television actors, American stage actors, American voice actors, American movie directors, Golden Globe Award winning actors, Actors from Boston, Massachusetts
Cardinal (bird)	Passeriformes
Magpie	Corvids
Final Fantasy Tactics	Final Fantasy games, 1997 video games
Vacuole	Organelles
College of Arms	Heraldry, 1484 establishments, British monarchy, 15th century establishments in England
City of Sunderland	Sunderland, Tyne and Wear, Ports and harbours of the United Kingdom, Settlements in Tyne and Wear
Self-Strengthening Movement	History of China
Michael Keaton	1951 births, Living people, Actors from Pennsylvania, Actors who played Batman, American movie actors, American television actors, American video game actors, American voice actors, Golden Globe Award winning actors, Satellite Award winners, Stage names
Inequality	Mathematics
Chechnya	Chechnya, Federal subjects of Russia, Republics of Russia
Hilbert's paradox of the Grand Hotel	Mathematics
Opposite number	Numbers
Nth root	Mathematics
Isle of Portland	Dorset, Islands of England
Weymouth, Dorset	Weymouth, Dorset
Chrysanthemum	Flowers, Asteraceae
Flagship	Ships
European magpie	Corvids
Sui generis	Legal terms, Latin words and phrases
Regular polygon	Polygons
Straightedge and compass construction	Ruler-and-compass construction, Mathematics
Carnation	Caryophyllaceae
Air Force One	United States Air Force, Presidency of the United States, Individual aircraft
Incubus	Demons
Commonwealth realm	History of the United Kingdom, Commonwealth realms, British monarchy
Dashiki	Tops (clothing), Africa
Colorado Avalanche	Colorado Avalanche, 1972 establishments in the United States, 1970s establishments in Colorado
Battle of Midway	1942 in Oceania, Battles involving Japan, Battles involving the United States, Pacific battles of World War II, Polynesia, June events
Minnesota Wild	Minnesota Wild
Ghassanids	Yemeni people
Boeing B-29 Superfortress	Boeing aircraft, United States Air Force aircraft, World War II American aircraft
Sewing	Manufacturing, Needlework
Saipan	Capital cities in Oceania, Northern Mariana Islands
Knitting	Needlework
Yarn	Fibers, Weaving
Royal Australian Navy	Military of Australia, Navies
Takijirō Ōnishi	1891 births, 1945 deaths, Admirals, Aviators, Japanese military people, Military personnel of World War II, People from Hyōgo Prefecture
Torpedo	Weapons
Undercarriage	Aircraft
Seven Years' War	Seven Years' War
Battlefield 2	2005 video games, Battlefield video games, Video games developed in Sweden
Battlefield (series)	Battlefield video games, Video games developed in Sweden
Subset	Set theory
Middle Temple	Inns of Court
Albanian Orthodox Church	Eastern Orthodox Church, Albanian culture
University of Padua	Colleges and universities in Italy, 1222 establishments, Padua, 1220s establishments in Europe, 13th century establishments in Italy
Anti-aircraft warfare	Missiles, Military aviation
National Museum of the United States Air Force	United States Air Force, Military aviation, Dayton, Ohio, Museums in the United States, Buildings and structures in Ohio
List of Tour de France winners	Lists of sportspeople, Tour de France winners
Inner Temple	Inns of Court
Inns of Court	Inns of Court
Lincoln's Inn	Inns of Court
Gray's Inn	Inns of Court
Battle of Okinawa	1945 in Japan, Battles involving the United Kingdom, Battles involving the United States, Pacific battles of World War II, Ryukyu Islands
Naomi Nari Nam	1985 births, Living people, Figure skaters from California, People from Anaheim, California
Themistocles Leftheris	1982 births, Living people, American figure skaters, Sportspeople from Florida
Ohka	Aviation, Ballistics
Stéphane Lambiel	1985 births, Living people, 2002 Winter Olympics, 2010 Winter Olympics, Figure skaters, Medalists at the 2006 Winter Olympics, Olympic silver medalists, Swiss Olympic medalists
Daisuke Takahashi	1986 births, Living people, Japanese figure skaters, Japanese Olympic bronze medalists, People from Okayama Prefecture
Evgeni Plushenko	Russian figure skaters, 1982 births, Living people
Bald eagle	Birds of North America, Symbols of the United States
Stacy London	American television presenters, Television personalities from New York City, 1969 births, Living people
Kaiten	Weapons
Blanket	Home
Crochet	Needlework
Weaving	Hobbies, Weaving
Loom	Hobbies, Weaving
Sweater	Tops (clothing)
Scarf	Accessories
Across the Universe (movie)	2007 movies, American musical movies, Columbia Pictures movies
Hugo Weaving	1960 births, Living people, Australian movie actors, Australian stage actors, Australian voice actors
Battle of the Philippine Sea	1944, Battles involving Japan, Battles involving the United States, Pacific battles of World War II, 1940s in Oceania, Micronesia, June 1944 events
Tour of Britain	Cycle races, Sport in the United Kingdom
Tengiz	Lakes of Kazakhstan
Aike	Lakes of Kazakhstan, Lakes of Russia
Tamgaly	Lakes of Kazakhstan
Union Cycliste Internationale	Cycling
Ashchikol	Lakes of Kazakhstan
Kajbagar	Lakes of Kazakhstan
Milk Marketing Board	Government of the United Kingdom, Agriculture
Smithsonian Institution	Smithsonian Institution, 1843 establishments in the United States, 19th-century establishments in Washington, D.C.
Battle of Leyte Gulf	Pacific battles of World War II, 1944 in Asia, 1940s in the Philippines, October 1944 events
Ottoman dynasty	History of Turkey, Royal dynasties, Lists
Grand Vizier	History of Turkey, Politics of Turkey
1446	1446
List of Ottoman Grand Viziers	History of Turkey, Politics of Turkey, Ottoman people, Lists of people
Köprülü family	Albanian people, Noble families
1281	1281
1283	1283
1287	1287
Ashley Tisdale	1985 births, Living people, American movie actors, American television actors, American voice actors, American child actors, Actors from New Jersey, Singers from New Jersey, High School Musical people, American Jews, American composers, American models, American musical theatre actors, American pop singers, American singer-songwriters, American stage actors, American television producers, Child actors, Disney people, High School Musical, Warner Bros. Records artists
Angela Beesley Starling	1977 births, Living people, British people
Derby (horse race)	Horse riding
Reef	Reefs
Luba Goy	1945 births, Living people, Canadian comedians, German entertainers
Tina Fey	1970 births, Living people, Actors from New York City, Actors from Philadelphia, Pennsylvania, American television actors, Comedians from Pennsylvania, Emmy Award winners, Extras, Mark Twain Prize recipients, Screen Actors Guild Award winners
Ashley Leggat	1986 births, Living people, Canadian television actors, People from Hamilton
Murder of Jessica Lunsford	2005 crimes, 2005 deaths, 2005 in Florida, 2000s crimes in the United States, American children, American murder victims, February events, Kidnapped American people, Murder in Florida, Murder in the 21st century in the United States, People murdered in the United States
Puncak Jaya	Mountains of Asia, Geography of Indonesia
Raviv Ullman	1986 births, Living people, Actors from Connecticut, American child actors, American drummers, American stage actors, American television actors, Israeli stage actors, Israeli television actors, Jewish American actors, Jewish American musicians, Jewish Israeli actors, Jewish Israeli musicians
Homosassa, Florida	Census-designated places in Florida
Jaws (movie)	1975 movies, 1970s thriller movies, American adventure movies, American thriller movies, English-language movies, Jaws movies, Movies about animals, Movies based on books, Movies directed by Steven Spielberg, Movies composed by John Williams, Movies set in Massachusetts, United States National Film Registry movies, Universal Pictures movies, People's Choice Award winners
Nostalgia	Emotions
Alcazar (band)	Swedish pop music groups
Julie Andrews	1935 births, Living people, Academy Award winning actors, Actors from Surrey, BAFTA Award winning actors, British child actors, British children's writers, Emmy Award winners, English movie actors, English singers, English stage actors, English voice actors, Golden Globe Award winning actors, Grammy Award winners, Musicians from Surrey, Screen Actors Guild Award winners, Writers from Surrey, People's Choice Award winners, Knights and Dames Commander of the Order of the British Empire
Odoacer	Kings and Queens of Italy, Roman people, 431 births, 493 deaths, Roman generals
Alexios I Komnenos	1081 births, 1118 deaths, Byzantine Emperors
Slayer	1980s American music groups, 1990s American music groups, 2000s American music groups, 2010s American music groups, Thrash metal bands, American heavy metal bands, Speed metal bands, Musical groups from Huntington Beach, California, Slayer
Megadeth	Megadeth, Musical groups established in 1990, Thrash metal bands, American heavy metal bands, Roadrunner Records, Speed metal bands, American hard rock bands, Musical groups from Los Angeles, California
Bonnaroo Music Festival	Music festivals in the United States, Tennessee, 2002 establishments in the United States, 2000s establishments in Tennessee
Pol'and'Rock Festival	Przystanek Woodstock, Music festivals, 1990s establishments in Poland, Festivals in Europe, 1995 establishments in Europe
Empire of Japan	History of Japan
Headband	Headgear
Cornflower	Flowers, Asterales
Axel jump	Figure skating
Kimmie Meissner	1989 births, Living people, American figure skaters, Sportspeople from Maryland
Flying ace	Occupations in aviation
Medal	Orders, decorations, and medals
Motoori Norinaga	1730 births, 1801 deaths, Japanese poets, Mie Prefecture
Valediction	Writing, Traditions
Saburo Sakai	1916 births, 2000 deaths, Japanese people, People from Saga Prefecture
Southern Cross Station	Railway stations in Melbourne
Flagstaff railway station, Melbourne	Railway stations in Melbourne
Melbourne Central railway station	Railway stations in Melbourne, 1981 establishments in Australia
Parliament railway station, Melbourne	Railway stations in Melbourne, 1983 establishments, 1980s establishments in Australia
Asphyxia	Medical emergencies, Health problems, Respiratory system
Toy Story 2	1999 animated movies, 1999 comedy movies, 1990s computer-animated movies, 2009 3D movies, American sequel movies, American comedy movies, Buddy movies, Disney animated movies, English-language movies, Movies composed by Randy Newman, Pixar movies, Toy Story, 3D re-releases, Movies directed by John Lasseter
Richmond railway station, Melbourne	Premium Melbourne railway stations
Bairnsdale railway line, Victoria	Victoria, Australia
Pakenham railway station, Melbourne	Premium Melbourne railway stations, 1877 establishments in Australia
North Melbourne railway station, Melbourne	Premium Melbourne railway stations
Shushi Massacres	20th century in Armenia, 1920, 20th century in Azerbaijan, 20th century in Turkey
Osip Mandelstam	1891 births, 1938 deaths, Jewish writers, Methodists, Polish Jews, Prisoners, Russian Christians, Russian Jews, Russian poets, Russian writers, Soviet Jews, Writers from Warsaw
Forestry Commission	Departments of the United Kingdom Government, Government agencies of the United Kingdom, Forests of the United Kingdom, Forestry
Fukushima Prefecture	Fukushima Prefecture, 1876 establishments, 1870s establishments in Japan, Prefectures of Japan
Arara, Paraíba	Cities in Paraíba, 1961 establishments in South America, 1960s establishments in Brazil
Juan Crisóstomo de Arriaga	1806 births, 1826 deaths, Spanish composers, Romantic composers
Conservatoire de Paris	Music schools, Buildings and structures in Paris, 1795 establishments, 1790s establishments in France
Prix de Rome	Art awards, Paris
Caulfield railway station, Melbourne	Premium Melbourne railway stations, 1879 establishments, 1870s establishments in Australia
Officer railway station, Melbourne	Railway stations in Melbourne
ß	German language, Latin letters
General Motors railway station, Melbourne	Railway stations in Melbourne, 1956 establishments, 1950s establishments in Australia, 2002 disestablishments in Australia
Agronomy	Botany, Ecology
Metlink	Public transport in Melbourne, Intermodal transport authorities
Sanyo	Technology companies of Japan, Electronics companies
Celtic Frost	Thrash metal bands, Death metal bands, Swiss heavy metal bands, Zürich, Musical groups established in 1984, 1984 establishments in Europe, 1980s establishments in Switzerland, Musical groups disestablished in 1993, Musical groups established in 2001, 2001 establishments in Europe, 2000s establishments in Switzerland, Musical groups disestablished in 2008, 2008 disestablishments in Europe, 2000s disestablishments in Switzerland
Cable knitting	Cloth
Maraghar Massacre	20th century in Armenia, 1992
Circular knitting	Cloth, Skills
Knitting machine	Machines
Kirovabad pogrom	20th century in Armenia, 20th century in Azerbaijan, 1988
Tree of Knowledge	Mythology
Royal Academy of Music	Music schools, Colleges and universities in London
Royal College of Music	Music schools, Colleges and universities in London
Automated teller machine	Money, Technology
Quilt	Cloth, Textile arts
Ribbon	Cloth
Garden of Eden	Old Testament
Wigmore Hall	Concert halls in London
Associated Board of the Royal Schools of Music	Music education
Engraving	Printmaking
Ron Dennis	1947 births, Living people, English businesspeople, Formula One people, People from Woking
Sabaragamuwa Province	Provinces of Sri Lanka
Skateboard	Skateboarding, Sports equipment
Interstate 95	Interstate Highways
U.S. Route 1	U.S. Highways
Let It Be (Beatles album)	The Beatles albums, 1970 albums, 1970 movies, Rock albums
Tiger Woods	African-American golfers, People from Orange County, California, Sportspeople from California, 1975 births, Living people
House of Commons of Canada	National lower houses, Parliament of Canada, 1867 establishments in Canada
Riboflavin	B vitamins
Earl Marshal	Occupations, England, Heraldry, Government
Crysis	Shooter video games, 2007 video games, Electronic Arts video games
Peerage	British royalty
Fertility	Reproductive system, Basic English 850 words
Fin de siècle	Phrases
Postmodernism	Architecture, Art movements, Philosophical movements and positions
Eraser	Writing tools
Sercquiais	Languages of the Channel Islands, Guernsey
Jèrriais	Languages of the Channel Islands, Jersey
Auregnais	Languages of the Channel Islands, Alderney
Colwyn Bay	Towns in Conwy
Maple syrup urine disease	Genetic disorders
Anglesey	Islands of the United Kingdom, Geography of Wales, Anglesey
Plateosaurus	Prosauropods, Triassic dinosaurs
Cotton Mather	1663 births, 1728 deaths, American Calvinists, Christian religious leaders, Christian writers, Colonial Americans, Puritanism, Salem Witch Trials, Writers from Boston, Massachusetts
Linda McCartney	1941 births, 1998 deaths, American pianists, Cancer deaths in Arizona, Deaths from breast cancer, Jewish American musicians, Musicians from New York City, Paul McCartney, Singers from New York City, The Beatles
Fethiye	Cities in Turkey
N-Dubz	2000 establishments in England, 2010s disestablishments in the United Kingdom, 2011 disestablishments in Europe, 2000s British music groups, 2010s British music groups, Hip hop bands, Musical groups disestablished in 2011, Musical groups established in 2000, Musical groups from London, English R&B bands
66	60s
70	70
674	670s
Pachycephalosaurus	Pachycephalosauria
Utopia	Society
Jeff Hardy	1977 births, American painters, American professional wrestlers, American rock musicians, Living people, Sportspeople from North Carolina
Durban	Durban, 1880 establishments, 1880s establishments in South Africa
Bantu people	Ethnic groups in Africa
Knight Bachelor	Knights Bachelor
Digital	Electronics
Hans Christian Ørsted	1777 births, 1851 deaths, Danish scientists, Physicists, Chemists
Ammeter	Measuring tools
Voltage divider	Electronic circuits
English Heritage	History of England, Conservation organisations of the United Kingdom, 1983 establishments in the United Kingdom, 1980s establishments in England
Filioque clause	Christianity of the Middle Ages, Christian creeds, Christian terminology
Krokus	Heavy metal bands, Hard rock bands, Swiss musical groups, Musical groups established in 1974, 1974 establishments in Europe, 20th century establishments in Switzerland, 1970s music groups, 1980s music groups, 1990s music groups, 2000s music groups, 2010s music groups
Historic Scotland	Scotland, Conservation organisations of the United Kingdom
Loudness (band)	Japanese heavy metal bands, Osaka
Gulf of Oman	Gulfs, Geography of Iran, Geography of Oman, Geography of Pakistan
Gulag	Human rights, Soviet Union, Concentration camps
Multimeter	Measuring tools
Hyattsville, Maryland	Cities in Maryland, 1886 establishments in the United States, 19th-century establishments in Maryland
Invitee	Law
Luciano Pavarotti	1935 births, 2007 deaths, Cancer deaths in Italy, Deaths from pancreatic cancer, Grammy Award winners, Italian singers, Musicians from Emilia-Romagna, Italian opera singers, People from Modena, Tenors
Negligence	Law
Cytokinesis	Cell biology
Femininity	Women, Gender
Battery (tort)	Legal terms, Types of crime
Assault	Types of crime, Violence
Megaloblastic anemia	Diseases
Legal code	Law
Plácido Domingo	1941 births, Living people, Grammy Award winners, Musicians from Madrid, Spanish opera singers, Spanish singers, Tenors, Latin Grammy Award winners, Honorary Knights Commander of the Order of the British Empire
José Carreras	1946 births, Living people, Grammy Award winners, Spanish opera singers, Order of Merit of the Federal Republic of Germany, Musicians from Barcelona, Spanish singers, Tenors
Leukemia	Cancer, Blood disorders, Blood cells
Tavern	Taverns, Places where alcohol is served
Gaucho	South America, Brazil, Argentina, Chile, Uruguay
Flag of Tunisia	National flags, Tunisia, 1831 establishments, 19th-century establishments in Africa, Establishments in Tunisia
Humat Al Hima	Tunisia, National anthems, 1987 establishments in Africa
Nymphadora Tonks	Harry Potter characters
Scelidosaurus	Thyreophora
Nissan Stadium	Football stadiums in Asia, Buildings and structures in Japan, Nissan
Scream 2	1997 crime movies, 1997 horror movies, 1990s sequel movies, 1990s serial killer movies, American sequel movies, Scream movies, American independent movies
DNA repair	DNA
Armiger	Heraldry
Genome	Genetics
Atomic force microscope	Microscopes
Zine El Abidine Ben Ali	1936 births, 2019 deaths, Deaths from prostate cancer, Presidents of Tunisia, Prime Ministers of Tunisia
Heraldry	Heraldry
Baronet	Baronets
Duchy of Saxe-Coburg and Gotha	Belgian royalty, Ernestine duchies, 1826 establishments, 1820s establishments in Europe, 1918 disestablishments in Germany, 19th century establishments in Germany
Berkelium	Chemical elements, Actinides, Berkeley, California
BBC Learning English	BBC
Omarosa Manigault Newman	1974 births, Living people, Participants in American reality television series, People from Youngstown, Ohio
The Apprentice	2004 American television series debuts, American reality television series, The Apprentice, English-language television programs
Survivor (TV series)	Survivor (TV series)
The Weakest Link	Television game shows
Anne Robinson	1944 births, Living people, British game show hosts, English journalists, English television presenters, Skin cancer survivors, Television personalities from Lancashire
Scooch	1998 establishments in the United Kingdom, 1990s British music groups, 2000s British music groups, 2010s British music groups, English pop music groups, Musical groups established in 1998
Rock art	Art, Painting, Ancient history, Stone Age
Edward Teach	1680 births, 1718 deaths, Pirates, Mysterious people
Jenolan Caves	Geography of New South Wales, Caves of Australia
Sizzler	American restaurants
Báb	Bahá'í Faith, Religious leaders, Babism
Breakfast at Tiffany's	1961 drama movies, 1960s comedy-drama movies, 1960s romantic comedy movies, 1960s romantic drama movies, American comedy-drama movies, American romantic comedy movies, American romantic drama movies, English-language movies, Movies based on books, Movies set in New York City, Movies directed by Blake Edwards
Juan Ignacio Molina	Naturalists, Zoologists
Mescaline	Illegal drugs
Psilocybin	Drugs
Ketamine	Drugs
Diazepam	Drugs used in psychiatry
Fluoxetine	Drugs used in psychiatry
Portable Document Format	Adobe Inc.
Ascension Island	Saint Helena, Ascension and Tristan da Cunha
Ashmore and Cartier Islands	Commonwealth dependent states, States and territories of Australia, Islands of Australia
Australian Antarctic Territory	Commonwealth dependent states, States and territories of Australia, Antarctic territorial claims, Postage stamps
British Antarctic Territory	British overseas territories, Antarctic territorial claims, 1962 establishments, 1962 establishments in the United Kingdom, Establishments in Antarctica
British Indian Ocean Territory	Territorial disputes of India, British Indian Ocean Territory
Christmas Island	Christmas Island, Commonwealth dependent states
Cocos (Keeling) Islands	Cocos (Keeling) Islands, Commonwealth dependent states, Dependent territories, Territorial disputes of India
Heard Island and McDonald Islands	Commonwealth dependent states, States and territories of Australia, Islands of Australia, World Heritage Sites in Australia, Protected areas of Australia
Ross Dependency	Commonwealth dependent states, New Zealand, Antarctic territorial claims
Tristan da Cunha	Saint Helena, Ascension and Tristan da Cunha
Frozen dinner	Frozen foods
Věž	Villages in the Czech Republic
Southern Lapwing	Charadriiformes
Reinforced concrete	Building materials
Courthouse	Government buildings, Courts (law)
Prosecutor	Trials
Ibiza	Balearic Islands, Phoenician colonies
Octave Mirbeau	1848 births, 1917 deaths, French novelists, French playwrights
Tumulus	History, Burial monuments and structures
Zapotec civilisation	Zapotec, History of Mesoamerica, Native American
Olmec	History of North America, Native American
Mixe-Zoque languages	Languages of Mexico, Mesoamerica
Step pyramid	Pyramids
Chichen Itza	Maya civilization, World Heritage Sites in Mexico, Archaeological sites in Mexico, Yucatán (state)
Common sense	Everyday life, Philosophy
Magic User's Club	Anime
Deryck Whibley	1980 births, Living people, Canadian singers, Canadian guitarists, Sum 41, People from Ontario
Glam rock	Rock music, Culture
Polish Aviation Museum	Aircraft museums, Kraków, Education in Poland, Buildings and structures in Poland
Eddy Merckx	1945 births, Belgian cyclists, Belgian nobility, Doping cases in cycling, Giro d'Italia winners, Living people, People from Flemish Brabant, Tour de France winners, Vuelta a España winners, World cycling champions
Monstera	Vines, Araceae, Epiphytes
Vine	Vines, Epiphytes
Aerial root	Plant tissues
Tropical wave	Weather
Brownsville, Texas	Cities in Texas, County seats in Texas
Agar	Polymers, Microbiology, Laboratory equipment
Australian Air Force Cadets	Air force, Organisations based in Australia, Military of Australia, 1941 establishments in Australia
Cable	Hardware (mechanical)
Yellow jersey	Cycling
Green jersey	Cycling
Rainbow jersey	Cycling
Derny race	Cycling
Escopetarra	Guitars, Weapons
Sylvère Maes	1909 births, 1966 deaths, Belgian cyclists, People from West Flanders, Tour de France winners
Maurice Garin	1871 births, 1957 deaths, French cyclists, Italian cyclists, Tour de France winners, Valle d'Aosta
Spiracle	Insects
Henri Cornet	1884 births, 1941 deaths, French cyclists, People from Hauts-de-France, Tour de France winners
Paris-Roubaix	Cycle racing in France, History of Paris, Roubaix
Asexuality	Human sexuality
Mongoose	Feliformia, Fictional animals
Macedonian language	Slavic languages, Languages of Europe
Patina	Furniture, Art
Crux	Constellations, National symbols
Richmond, Victoria	Melbourne
2006 Commonwealth Games	2006 in sports, 2000s in Australia, Commonwealth Games, Sport in Melbourne, History of Melbourne, March events
Deutschland Tour	Cycle racing in Germany
Stage race	Cycling
Eneco Tour of Benelux	UCI ProTour, Cycle races, Sport in the Netherlands, Sport in Belgium, 1948 establishments in Europe, 20th century establishments in the Netherlands
Lucas Cranach the Elder	1472 births, 1553 deaths, German painters, People from Bavaria, German printmakers
Edwards v. Aguillard	1987 in the United States, United States law, 1980s in law
Frýdlant	Cities in the Czech Republic
Kitzmiller, et al. v. Dover Area School District, et al.	2005 in Pennsylvania, Former good articles, Intelligent design, Trials in the United States
Psychometrics	Psychology
Consolevania	Video games, Entertainment websites
Drag (physics)	Fluid mechanics
Manatee	Sirenia
Natural history	Biology, Geology
Theistic evolution	Evolution, Religion
Queer	LGBT variations, Pejoratives
Abdus Salam	1926 births, 1996 deaths, Pakistani scientists, Theoretical physicists
Livermorium	Chemical elements
UCI ProTour	Cycling
Ohana	Culture of Hawaii
Grand Tour (cycling)	cycling
Mammoth	Extinct elephants, Megafauna
Right-wing politics	Conservatism
Polka dot jersey	Cycling
Pleistocene	Cainozoic, Ancient history
Louis XV	1710 births, 1774 deaths, Dauphins and Dauphines of France, Deaths from smallpox, House of Bourbon, Infectious disease deaths in France, Kings and Queens of France, People from Versailles, Princes of Andorra
Ram Dass	1931 births, 2019 deaths, American educators, Writers from Boston, Massachusetts
Psychedelic	Drugs
Rugby union	Rugby union
Try	Rugby
Avalon Peninsula	Geography of Newfoundland and Labrador
Cape Cod	Geography of Massachusetts, Capes of the United States
Chatham, Massachusetts	Towns in Massachusetts, 1665 establishments, 1660s establishments in Massachusetts
Whitbourne, Newfoundland and Labrador	towns in Newfoundland and Labrador
Wind power in South Australia	Wind farms, South Australia
Solar power plants in the Mojave Desert	Solar power plants, Energy in California
Discovery Channel Pro Cycling Team	UCI ProTour teams
Alkane	Alkanes, Organic compounds
Charles Gounod	French composers, Romantic composers, 1818 births, 1893 deaths
Operación Puerto doping case	Cycling, Doping cases in sport, Doping cases in cycling
Dover, Pennsylvania	Cities in Pennsylvania, 1764 establishments in the Thirteen Colonies
Rugby sevens	Rugby union
Rugby World Cup Sevens	Rugby union
Princess Margaret, Countess of Snowdon	Bailiffs Grand Cross of the Order of St John, Cardiovascular disease deaths in England, Deaths from stroke, House of Windsor, Princes and princesses, 1930 births, 2002 deaths, Elizabeth II
Romain Maes	1912 births, 1983 deaths, Belgian cyclists, People from West Flanders, Tour de France winners
Heir apparent	Royalty and nobility, Monarchy
Armenia national football team	National football teams, Sport in Armenia
Nostradamus	1503 births, 1566 deaths, Astrologers, Cardiovascular disease deaths in France, Deaths from cerebral edema, French esotericists, French physicians, Writers from Provence-Alpes-Cote d'Azur, Pharmacists
Trough (meteorology)	Meteorology
QuikSCAT	Satellites
Zakarid-Mxargrzeli	History of Armenia
Bermuda International Airport	Bermuda, Airports in the United Kingdom
Mikheil Saakashvili	1967 births, Living people, Presidents of Georgia, Politicians from Tbilisi
Waltham, Massachusetts	Cities in Massachusetts
Sea surface temperature	Oceans
National language	Languages, Nationality
Country Music Hall of Fame and Museum	Nashville, Tennessee, Country music, Museums in the United States, Buildings and structures in Tennessee
Flag of Iran	Iran, National flags
Real Zaragoza	Spanish football clubs, Zaragoza
Everton Tigers	Sport in England, Basketball teams, Liverpool, Merseyside
Eastman School of Music	Music schools, Schools in New York, Buildings and structures in New York
Henry Morgenthau	Businesspeople from New York City, Politicians from New York City, American Jews, 1856 births, 1946 deaths
Persian people	Iranian people, History of Iran, Persian people
Louis P. Lochner	1887 births, 1975 deaths, Writers from Illinois, American journalists, Pulitzer Prize winners
Shepherd	Agricultural occupations
Armenian Secret Army for the Liberation of Armenia	1975 establishments, Anti-Turkism, Armenian Genocide, Rebel militia groups in Asia, Terrorism
Kevork Ajemian	1932 births, 1998 deaths, Armenian writers, Armenian diaspora
Supabarn	Supermarkets of Australia, Canberra
Members of the United Nations	United Nations, Lists of countries
1960 Summer Olympics	1960 Summer Olympics
1948 Winter Olympics	1948 in sports, Winter Olympics in Europe, Sport in Switzerland, 1940s in Europe, 20th century in Switzerland
1932 Winter Olympics	1932 in sports, 1932 in the United States, 1930s in New York (state), Lake Placid, New York, Sports in New York, Winter Olympics in the United States
2010 Winter Olympics	2010 Winter Olympics, February 2010 events
Sexual assault	Rape
1994 Winter Olympics	1994 Winter Olympics, 1994 in sports, 1994 in Europe, 20th century in Norway
1992 Winter Olympics	1992 Winter Olympics, 1992 in sports, 1990s in France, 1992 in Europe
1980 Winter Olympics	1980 in sports, 1980 in the United States, 1980s in New York (state), Lake Placid, New York, Sports in New York, Winter Olympics in the United States
Maya people	Ethnic groups in North America, Maya civilization
Cor anglais	Double reed instruments
Topoxte	Archaeological sites in Guatemala, Maya civilization
Mayapan	Cities in Mexico, Maya civilization, Archaeological sites in Mexico, Yucatán (state)
Committee of Union and Progress	History of Turkey, Politics of Turkey, 1906 establishments, 1926 disestablishments
Dardanelles	Geography of Turkey, Straits
Biescas	Settlements in Huesca, Municipalities in Aragon
Gloucester	District and borough councils in England, Gloucester
Fore-Caucasus	Russia
North Caucasus	Geography of Russia
Greater Caucasus	Mountain ranges, Caucasus, Mountains of Russia, Geography of Azerbaijan, Geography of Georgia (country)
Mount Elbrus	Mountains of Russia
Provinces of the Dominican Republic	Provinces of the Dominican Republic
Reductio ad absurdum	Mathematics, Logical fallacies
Sandoz	Companies of Switzerland
Artificial sweetener	Sweeteners
Larry Sanger	1968 births, Living people, Wikipedia people, American bloggers
Cats (musical)	West End musicals, Broadway musicals, Musicals based on books, Musicals by Andrew Lloyd Webber, Tony Award winning musicals, Laurence Olivier Award winning musicals, 1980s musicals
Independent movie	Movies
Flower power	1960s
Cargo cult	New religious movements
Walloon language	Languages of Europe, Romance languages
Gallo language	Romance languages
Diethyl ether	Organic compounds
Carriage	Animal-powered vehicles
Lozi language	Niger-Congo languages
Ruhleben P.O.W. Camp	World War I, Berlin
M249 light machine gun	Light machine guns, Machine guns of the United States
Toronto Symphony Orchestra	Orchestras, Canadian musical groups, 1922 establishments in North America, 1920s establishments in Canada
Vattenfall Cyclassics	Cycle racing in Germany, Sport in Hamburg
Gothic language	Germanic languages, Languages of Europe, 9th century disestablishments in Europe
Ernest MacMillan	1893 births, 1973 deaths, Canadian musical entertainers, POW at Ruhleben, Knights Bachelor, Canadian composers
Colin McRae	Accidental deaths in the United Kingdom, Aviation deaths, Scottish racecar drivers, 1968 births, 2007 deaths
Benjamin Dale	1885 births, 1943 deaths, English composers, POW at Ruhleben
The Chaser's War On Everything	2006 television series debuts, 2009 television series endings, 2000s Australian television series, Comedy television series, Reality television series, 2006 establishments in Australia, 2000s disestablishments in Australia
Illyria	History of Greece
Battle of Kosovo	Battles of the Middle Ages, 1389, June events
Worcester	Unitary authorities, Worcester
Stoke-on-Trent	Stoke-on-Trent
Triton (moon)	Neptune's moons
Kulykol	Lakes of Kazakhstan
Pierre Curie	1859 births, 1906 deaths, French academics, French chemists, French Nobel Prize winners, Nuclear physicists, Scientists from Paris
Hindustani language	Urdu dialects, Indo-Aryan languages, Languages of India, Languages of Pakistan
Masala	Food ingredients
Mayan languages	Languages of North America, Maya civilization
Soconusco	Chiapas
Chiapas	Chiapas, States of Mexico
Urbanism	Urban and regional sciences
Teotihuacán	World Heritage Sites in Mexico, History of Mesoamerica, Archaeological sites in Mexico, Mexico (state)
Deadwood (TV series)	2004 American television series debuts, 2006 American television series endings, 2000s American television series, 1870s, American drama television series, HBO television series, South Dakota in fiction, Western television series, English-language television programs
Royal Society for the Prevention of Cruelty to Animals	1824 establishments, Charities, Royal Societies of the United Kingdom, 1820s establishments in the United Kingdom
Tim Minear	1963 births, Living people, American movie directors, American screenwriters, Whedonverse, Writers from New York, Writers from California, People from Whittier, California
Lamella (zoology)	Animal anatomy
Sütterlin	Typography, Writing systems
Runic calendar	Calendars
Agha Petros	1880 births, 1932 deaths, Assyrian people
Classical Latin	Ancient Rome, Latin language
Syriac language	Semitic languages, Assyria
Louis Charles Antoine Desaix	French generals, 1768 births, 1800 deaths
Monte Melkonian	1957 births, 1993 deaths, American military people, Armenian military people
Israel Defense Forces	1948 establishments in Israel, Israel Defense Forces
Government of the Dominican Republic	Dominican Republic
Massacres in Harput District	Armenian Genocide, Massacres in Turkey
Tour de Pologne	Cycle races, UCI ProTour, 1928 establishments in Europe, Sport in Poland, 1920s establishments in Poland
Atlas Shrugged	1957 books, 20th century American novels, English-language novels
Basilisk	Lizards
Hindu calendar	Calendars, Hinduism
Taíno	South American people, Ethnic groups in North America
The New York Times	1851 establishments in the United States, 1850s establishments in New York (state), Newspapers in New York City, English-language newspapers
Nairi	History of Armenia
Hayasa-Azzi	History of Armenia, Ancient Armenia
Ancient Armenia	History of Armenia, Ancient Armenia
Audition	Entertainment
Nikolai Gogol	1809 births, 1852 deaths, Ukrainian writers, Russian writers
List of presidents of the Dominican Republic	History of the Dominican Republic, Lists of politicians, Presidents of the Dominican Republic
Remus Lupin	Harry Potter characters
Anagram	Words
Werewolf	Monsters, Mythology, Folklore, Supernatural
Paneuropean Picnic	1989 in Europe, 20th century in Austria, 20th century in Hungary
San Diego Wild Animal Park	Buildings and structures in San Diego, California, Zoos in the United States, 1972 establishments in California
Tulip	Tulipa, Liliaceae, Flowers
Penicillium	Fungi
Wolverhampton	Settlements in the West Midlands (county), Cities in England, 985 establishments
Nubia	Ancient Egypt, History of Africa
Dave Batista	1969 births, Living people, Actors from Washington, D.C., Actors who played Bond villains, American mixed martial artists, American professional wrestlers, Doping cases in sport, People from Arlington, Virginia, Sportspeople from Virginia, WWE wrestlers
Risk (game)	Board games
Growth	Basic English 850 words
Cell growth	Cell biology
DNA replication	Cell biology, DNA
Pushing Daisies	2007 American television series debuts, 2009 American television series endings, 2000s American television series, American comedy television series, American crime television series, American drama television series, American fantasy television series, English-language television programs
Journeyman (TV series)	American science fiction television series, NBC network shows, American drama television series, English-language television programs
Chuck (TV series)	2007 American television series debuts, 2012 American television series endings, 2000s American television series, 2010s American television series, American science fiction television series, American sitcoms, Burbank, California, NBC network shows, Spy television series, Television series set in Los Angeles County, California, English-language television programs
Bionic Woman (2007 TV series)	American science fiction television series, NBC network shows, English-language television programs
1972 Winter Olympics	1972 Winter Olympics, 1972 in sports, 1970s in Japan, Sapporo
1956 Summer Olympics	1956 Summer Olympics, 1956 in Sweden, 1956 in sports, 1950s in Australia, History of Melbourne, History of Stockholm
1904 Summer Olympics	1904, 1900s in the United States, Sports in St. Louis, Missouri, Summer Olympics in the United States, History of St. Louis, Missouri
Stepanakert	Capital cities in Asia, Cities in Azerbaijan, Nagorno-Karabakh Republic
Charles Drummond Ellis	1895 births, 1980 deaths, English physicists, POW at Ruhleben, Knights Bachelor, Scientists from London
List of Southern Hemisphere cyclone seasons	Tropical cyclones, Weather lists
James Chadwick	1891 births, 1974 deaths, POW at Ruhleben, English physicists, British Nobel Prize winners
Francombat	Sport in France, European martial arts
Classic race	Cycle races
Criterium	Cycling
Valence electron	Physical chemistry
Flamingo	Birds
Magnesium oxide	Chemical compounds, Oxides
Movie studio	Movie studios
Critérium du Dauphiné Libéré	UCI ProTour, Cycle racing in France
1900 Summer Olympics	1900 in sports, 19th century in France, History of Paris, Summer Olympics in France, 1900s in Europe
1998 Winter Olympics	1998 Winter Olympics, 1998 in Japan, 1998 in sports, Nagano Prefecture
Mont Ventoux	Biosphere reserves, Alps, Mountains of France, Provence-Alpes-Côte d'Azur
Designated hitter	Baseball rules, Baseball positions, American League
1968 Winter Olympics	1968 Winter Olympics, 1968 in sports, Grenoble, 1960s in France
1964 Winter Olympics	1964 Winter Olympics, 1964 in sports, 20th century in Austria, 1960s in Europe
Counterculture	Sociology
Hippie	Human issues, Lifestyles, Sexual revolution
Halakha	Judaism, Law
Stereotype	Words, Printing
Tom Simpson	British cyclists, British Olympic bronze medalists, Cardiovascular disease deaths in France, Deaths from heart failure, Deaths in sport, Doping cases in cycling, Medalists at the 1956 Summer Olympics, Sportspeople from County Durham, Sportspeople from Nottinghamshire, World cycling champions, 1937 births, 1967 deaths
Electron cloud	Physical chemistry, Nuclear physics
9-1-1	Emergency phone numbers, Telephone numbers in the United States, Telephone numbers in Canada, N11 codes
911	911
Emergency	Safety
German Jews	German Jews
The Sexual Revolution	Sexual revolution, Non-fiction books
Peter Martyr d'Anghiera	1457 births, 1526 deaths, Italian historians, Italian people
Wilhelm Reich	1897 births, 1957 deaths, Deaths from heart failure, Austrian psychiatrists, Psychoanalysts, Psychiatry, American psychiatrists
Jules Massenet	Romantic composers, French composers, 1842 births, 1912 deaths
Tokyo Game Show	Video game events, Tokyo, Chiba Prefecture
Choline	Vitamins, Food supplements, Nutrients
La Borinqueña	Puerto Rico, National anthems, 1903 establishments in the United States, Establishments in Puerto Rico
Boy (album)	U2 albums, 1980 albums, Debut albums, Island Records albums, Rock albums, Punk albums
Ergastic substance	Cells, Tissues, Glands, Organic compounds
Adenine	Vitamins, Biochemistry
888	888
Trial and error	Psychology, Problem solving, Learning, Ethology
Harris Scarfe	Companies of Australia, Department stores
Flushing, Queens	Queens (New York City), Neighborhoods of New York City
Atlas	Cartography
T-Mobile Team	German cycling teams
T-Mobile	1990 establishments in Germany, Telephone companies, Mobile phones, Companies of Germany, Bonn
Simplified English	English language
Thymine	Organic compounds
Probability distribution	Probability distributions
Exponential distribution	Probability distributions
Binomial distribution	Probability distributions
Poisson distribution	Probability distributions
Samaná Province	Provinces of the Dominican Republic, 1867 establishments in North America, 1860s establishments in the Dominican Republic
Interpreter (computing)	Software, Computer programming
Flag of the United Arab Emirates	United Arab Emirates, National flags
The Donna Reed Show	1950s American television series, 1960s American television series, American sitcoms, Golden Globe Award winning programs, English-language television programs, Television series about families, Black and white television series
Dan Castellaneta	American movie actors, Comedians from Chicago, American television actors, American voice actors, Actors from Chicago, 1957 births, Living people, Emmy Award winning actors
Team Milram	UCI ProTour teams
Perrierbambus	Bamboo
Chi-square distribution	Probability distributions
Null hypothesis	Statistics
Timothy Leary	American psychologists, Deaths from prostate cancer, People from Springfield, Massachusetts, Writers from Massachusetts, 1920 births, 1996 deaths
Ralph Metzner	American psychologists, American writers, German writers, 1936 births, 2019 deaths
Rock band	Rock bands
Book of the Dead	Ancient Egypt, Books, Afterlife
Team Gerolsteiner	German cycling teams
2006-2007 UCI Oceania Tour	Cycling
Natural selection	Evolution, Metaphors referring to nature
Devanagari	Indo-Aryan languages, Writing systems
Continental circuits	Cycle races
Zac Efron	1987 births, Living people, High School Musical people, American movie actors, American television actors, Models from California, Actors from Los Angeles County, California, Singers from Los Angeles County, California, People from San Luis Obispo, California
Fiddle	String instruments, Folk instruments
Hardanger fiddle	String instruments, Folk instruments
Auguste Rodin	1840 births, 1917 deaths, Artists from Paris, French sculptors
Joe Cole	1981 births, Living people, 2002 FIFA World Cup players, 2006 FIFA World Cup players, 2010 FIFA World Cup players, Aston Villa F.C. players, British adoptees, Chelsea F.C. players, English footballers, Liverpool F.C. players, People from Camden (London borough), People from Paddington, Sportspeople from London, West Ham United F.C. players, Premier League players
Rebec	String instruments, early musical instruments
Resonator	Musical instrument construction, Physics
Joshua Bell	1967 births, Living people, People from Bloomington, Indiana, American violinists, Grammy Award winners, Musicians from Indiana

