Programme music	Music
Anaerobic organism	Microbiology, Metabolism
Tetanus	Diseases caused by bacteria
Immunization	Immunization
Whipped cream	Dairy products, Desserts
Tetanospasmin	Poisons, Biochemistry
Neurotoxin	Physiology
Paralysis	Diseases and disorders
Membrane protein	Molecular biology
Tampa Bay Buccaneers	Sports in Tampa, Florida, National Football League teams
Obelus	Mathematical notation, Symbols
Vinculum (symbol)	Mathematical notation
Colon (punctuation)	Punctuation, Typography
Tomorrow Never Knows	1966 songs, The Beatles songs, Songs about drugs
Gone with the Wind (movie)	1939 movies, 1930s drama movies, 1930s romance movies, Academy Award winning movies, American epic movies, American romantic drama movies, American war movies, English-language movies, Histrionic personality disorder in fiction, MGM movies, Movies based on books, Movies set in Georgia (U.S. state), Movies set in the 19th century, Screenplays by Ben Hecht, Movies directed by Victor Fleming, Movies directed by George Cukor
Santino Marella	1974 births, Canadian professional wrestlers, Living people, People from Ontario, WWE wrestlers
Fresco	painting
The Count of Monte Cristo	1844 books, French novels
Hallandale Beach, Florida	Cities in Florida
Nazi Party	1920 establishments in Europe, 1945 disestablishments in Germany, 1920s establishments in Germany, Nazi Party
Carl Nielsen	1865 births, 1931 deaths, 20th century composers, Danish composers
Madonna and Child	Christian art, Depictions of Mary (mother of Jesus)
National Gallery, London	Museums in London, Art museums in the United Kingdom, National museums
Unperson	Words
Düren	Düren Rural District
Gütersloh	Gütersloh Rural District
Iserlohn	Märkischer Rural District
Velbert	Mettmann Rural District
Lünen	Unna Rural District
Marl	Recklinghausen Rural District
Bocholt	Cities in North Rhine-Westphalia, Borken Rural District
Roman Abramovich	1966 births, Living people, British businesspeople, Russian businesspeople
Morena Baccarin	1979 births, Living people, Brazilian movie actors, Brazilian television actors, Whedonverse, People from Rio de Janeiro
José Mourinho	1963 births, Living people, Portuguese footballers, Portuguese football managers
Sawmill	Manufacturing buildings
Hazrat Babajan	1806 births, 1931 deaths, Asian Sufis, Muslims
Concept album	Concept albums
Convenience food	Foods
Zippo	1932 establishments, Tools, Smoking
1367	1367
Water heating	Energy, Water
Couëron	Communes in Loire-Atlantique
Room temperature	Temperature
Kraftwerk	1970s establishments in Germany, 1970s German music groups, 1980s German music groups, 1990s German music groups, 2000s German music groups, 2010s German music groups, Düsseldorf, Electronic music bands, German pop music groups, Musical groups established in 1970
Cricket ball	Sports equipment, Cricket
Baptist	Baptist
Techno	Electronic dance music, Techno music, Detroit, Michigan
Dog sled	Animal-powered vehicles
Multiset	Set theory
Tom Brokaw	American television news anchors, American journalists, Writers from South Dakota, People with cancer, 1940 births, Living people
Tuple	Set theory
Manure	Agriculture
Nutrient	Ecology, Nutrients
Histogram	Statistics
Green manure	Agriculture
Normal distribution	Probability distributions
Biomass	Energy, Ecology
Variance	Statistics
Tarzan's Treehouse	Disney, Tarzan (Disney)
Adam Małysz	Skiers, Polish sportspeople, 1977 births, Living people
Salome	14 births, 60s deaths, Ancient Israeli people, New Testament people
Winchester College	Schools in England, Winchester, 1382 establishments
Buffy the Vampire Slayer (movie)	1992 comedy movies, 1992 action movies, 1990s fantasy movies, American action movies, American fantasy movies, American teen comedy movies, English-language movies, Movies set in Los Angeles, California, Screenplays by Joss Whedon, Whedonverse, 20th Century Fox movies
Fran Rubel Kuzui	American movie directors, Year of birth missing (living people), Living people
Roseanne Barr	2016 United States presidential candidates, 2012 United States presidential candidates, Actors from Salt Lake City, Utah, American comedians, American television actors, American television producers, American television talk show hosts, Writers from Utah, 1952 births, Living people, Emmy Award winning actors, American bloggers
BI-LO (Australia)	Supermarkets of Australia, 1970s establishments in Australia
Sucrose	Carbohydrates, Chemical compounds, Sweeteners
Disaccharide	Carbohydrates
Biological hazard	Biology, Pollution, Safety, Security
Petri dish	Laboratory equipment
IGA Australia	Supermarkets of Australia, 1988 establishments in Australia
City of Chelmsford	1974 establishments in England, Essex boroughs
Communication studies	Communication, Social sciences, Media, Schools
Belote	Card games
Monosaccharide	Biochemistry, Carbohydrates
Lactose	Carbohydrates, Chemical compounds
Glycogen	Carbohydrates, Organic compounds
Pollutant	Ecology, Toxicology
Carbon monoxide	Toxicology, Organic compounds, Oxides
Falco	1957 births, 1998 deaths, Singers from Vienna, Musicians from Vienna, Pop musicians, Rap musicians, Road accident deaths, Rock musicians
Gabriel Pascal	1894 births, 1954 deaths, Hungarian movie directors, Transylvania, Hungarian movie producers
McLaren	Formula One constructors, Formula One current
Haylie Duff	1985 births, Living people, Actors from Houston, Texas, American movie actors, American pop singers, American television actors, Singers from Houston, Texas
20th Century Studios	Movie studios, Companies based in Los Angeles, 1935 establishments, Disney
Marquette, Michigan	Cities in Michigan, County seats in Michigan
John Taverner	1490s births, 1545 deaths, English composers, Renaissance composers
John Tavener	1944 births, 2013 deaths, 20th century composers, 21st century composers, English composers, Knights Bachelor, Musicians from Middlesex
Escape velocity	Astrophysics
Razor	Hair, Cutting tools, Hygiene
Mood stabilizer	Drugs used in psychiatry
International Baccalaureate	Education, Examinations
Wolfgang Schüssel	1945 births, Living people, Austrian Roman Catholics, Chancellors of Austria, Government ministers of Austria
Vaduz	National capitals in Europe, Cities in Liechtenstein, Municipalities of Liechtenstein
Luxembourgish language	West Germanic languages, Languages of Europe
Jean-Pierre Cassel	1932 births, 2007 deaths, French actors
Sea cucumber	Echinoderms
Yochanan Vollach	1945 births, Living people, Hebrew University of Jerusalem alumni, Israeli footballers, Israeli military people, Jewish Israeli sportspeople, Jewish military people, Majors
Maccabi Haifa	1913 establishments in Asia, Sports clubs, Sport in Israel, Football in Israel, Haifa, 1910s establishments in Israel
Hapoel Haifa	Israeli football clubs, Haifa, 1924 establishments, 1920s establishments in Israel
Swalwell, Alberta	Settlements in Alberta, Villages in North America
Polysaccharide	Carbohydrates, Polymers
Alfred Gusenbauer	1960 births, Living people, Chancellors of Austria, People from Lower Austria
Chinchilla	Rodents, Mammals of South America
Solubility	Chemistry
SpVgg Greuther Fürth	German football clubs, Sport in Bavaria
Taj Mahal (musician)	American blues musicians, American guitarists, American pianists, Singers from New York, Musicians from New York, 1942 births, Living people
Floyd Patterson	1935 births, 2006 deaths, African-American boxers, American Olympic gold medalists, Sportspeople from New York, Sportspeople from North Carolina
Clockwise	Basic physics ideas, Clocks
Manuel Friedrich	1979 births, Living people, German footballers, Sportspeople from Rhineland-Palatinate
Bruno Kreisky	1911 births, 1990 deaths, Austrian Jews, Chancellors of Austria, Government ministers of Austria, Jewish politicians, Politicians from Vienna
Viscacha	Rodents
Incisor	Teeth, Mammals
Gerbil	Rodents
Muridae	Rodents, Old World rats and mice
Muroidea	Rodents
Pierre Boulez	1925 births, 2016 deaths, 20th century composers, 21st century composers, French composers, French conductors, French LGBT people, Gay men, Grammy Award winners, LGBT musicians, People from Auvergne-Rhône-Alpes
Murinae	Old World rats and mice
Castorimorpha	Rodents
Arpeggio	Musical terminology
NKVD	Intelligence agencies, Soviet Union, Law enforcement agencies
Spyglass Entertainment	Movie studios
Hovercraft	Alternative propulsion, Vehicles
Duccio	1255 births, 1319 deaths, 14th century Italian painters, 13th century Italian painters
Castoridae	Rodents
IUCN Red List	International Union for the Conservation of Nature
Redruth	Towns in Cornwall, Civil parishes in Cornwall
Integrated Taxonomic Information System	Taxonomy, Science websites, Scientific organizations based in the United States, 1996 establishments in the United States, Biological databases
Yersinia pestis	Gram-negative bacteria, Plague
Leptospirosis	Diseases caused by bacteria, Animal diseases
François-Joseph Gossec	1734 births, 1829 deaths, Belgian composers, Classical era composers, Legion of Honour, People from Hainaut (province)
Josiah Wedgwood	1730 births, 1795 deaths, Potters, Smallpox survivors, Wedgwood family, Members of the Lunar Society
Tambourin	Musical forms, Percussion instruments
Thomas Wedgwood III	1685 births, 1739 deaths, Wedgwood family, Potters
Thomas Wedgwood IV	1716 births, 1773 deaths, Wedgwood family, Potters
Carl Philipp Emanuel Bach	1714 births, 1788 deaths, Bach family, Classical era composers, German composers, People from Weimar
Maria Barbara Bach	1684 births, 1720 deaths, German people, People from Thuringia, Bach family
Ligue 1	Football leagues, Football in France, 1932 establishments in Europe, 1930s establishments in France
Serie A	Football leagues, Football in Italy, 1898 establishments in Italy
Oath	Society
Jeffrey Archer	1940 births, Living people, English novelists, Former Conservative MPs (UK), Former members of the British House of Commons for English constituencies, United Kingdom Life Peers, Writers from Somerset
Return to Oz	Disney movies, 1980s fantasy movies, Cult movies, 1985 movies, English-language movies, Apocalyptic movies
Mordred	Arthurian legend
List of Miss America winners	Lists of American people, Miss America winners
Firewall (networking)	Software, Internet security
The Cask of Amontillado	19th-century American short stories, Short stories by Edgar Allan Poe
Osei Bonsu	Ghanaian people, Year of birth unknown, 1824 deaths
Uther Pendragon	Arthurian legend
Chocolate milk	Milk
Chocolate syrup	Sweeteners, Syrup
Wetsuit	Swimwear
Touch rugby	Rugby
Coven	Occult
First Geneva Convention	Medicine, War, Geneva Conventions, 19th century treaties, 1864, History of Geneva, 19th century in Europe
Second Geneva Convention	Geneva Conventions, 1906 in Europe, 20th century in Geneva, July events
Disc jockey	DJs, Entertainment occupations
Padniewko	Villages in Poland
Sierra Nevada (US)	Mountains of California, Geography of Nevada, Western United States
Flurbereinigung	Farms, Wine, German food, History of Germany
Live 8	2005 in music, Concerts
Rigveda	Vedas
Ecozone	Ecozones
Amorphous solid	Matter
Climate commitment studies	Environment, Climate
Slipknot	1995 establishments in the United States, 1990s American music groups, 2000s American music groups, 2010s American music groups, American heavy metal bands, American rap music groups, Des Moines, Iowa, Grammy Award winners, Musical groups established in 1995, Nu metal bands, Roadrunner Records, Slipknot
Archie Moore	American boxers, Sportspeople from Mississippi, 1916 births, 1998 deaths
Joe Frazier	1944 births, 2011 deaths, African-American boxers, American Olympic gold medalists, Cancer deaths in Pennsylvania, Deaths from liver cancer, Sportspeople from South Carolina
Hodgkin's lymphoma	Cancer, Diseases caused by viruses
Marvelous Marvin Hagler	1954 births, 2021 deaths, American boxers, Sportspeople from Newark, New Jersey
Sierra Nevada (Spain)	Mountains of Europe, Geography of Spain, Andalusia, National parks in Spain
Airline	Airlines
Wax	Chemical compounds
Polyethylene terephtalate	Thermoplastics
Nuclear energy	Nuclear energy
Card Sharks	Television game shows, ABC network shows, NBC network shows, CBS network shows, First run syndicated television programs, English-language television programs
Family Feud	1976 television series debuts, 1970s American television series, 1980s American television series, 1990s American television series, 2000s American television series, 2010s American television series, ABC network shows, American television game shows, CBS network shows, First run syndicated television programs, English-language television programs
Bank of America Stadium	National Football League venues, Carolina Panthers, Sports buildings in the United States, Buildings and structures in North Carolina, 1996 establishments in the United States, 1990s establishments in North Carolina
Aston Martin	British automobile companies, 1913 establishments in Europe, 1910s establishments in the United Kingdom
Sydney Opera House	Buildings and structures in Sydney, Opera houses, World Heritage Sites in Australia, 1973 establishments in Australia
Sydney Harbour Bridge	Buildings and structures in Sydney, Transport in Sydney, Bridges in Australia, Steel bridges, 1932 establishments, 1930s establishments in Australia
Sydney Cricket Ground	Buildings and structures in Sydney, Sports buildings in Australia, Sports in Sydney
Darling Harbour	Buildings and structures in Sydney, Transport in Sydney
Bondi Beach	Geography of New South Wales, Beaches, Sydney
Stadium Australia	Football stadiums, Football in Australia, Sports buildings in Australia, Buildings and structures in Sydney, 1999 establishments in Australia, Sports in Sydney
Sydney Aquarium	Aquariums, Buildings and structures in Sydney
Nigga	Pejoratives, Slang, English profanity
Germans	German people
Employment Non-Discrimination Act	:American civil rights, American civil rights
Cthulhu	Characters in written fiction
Diabetes insipidus	Diseases, Endocrinology
Caecilian	Caecilians
Bullet-proof vest	Protective clothing, Armour, Military
Dry suit	Protective clothing
Gauntlet	Protective clothing, Sports equipment
Nylon	Fibers
Forearm	Limbs and extremities
Mountain climbing	Mountain climbing
Figure of speech	Language, Writing, Figures of speech
Adobe Flash	Graphics software, Internet, Adobe software, 2002 software
Inheritance (object-oriented programming)	Computer science
Michael Jordan	1963 births, Living people, African-American baseball players, African-American basketball players, American Olympic gold medalists, Chicago Bulls players, Sportspeople from Chicago, Sportspeople from New York City, Sportspeople from North Carolina, Washington Wizards players, National Basketball Association players with retired numbers, American basketball players
Lawrence Taylor	1959 births, Living people, American football linebackers, Sportspeople from Virginia, New York Giants players
New York Giants	New York Giants, 1925 establishments in the United States, 1920s establishments in New York (state), 1920s establishments in New Jersey
Hakeem Olajuwon	1963 births, Living people, African-American basketball players, American Muslims, American Olympic gold medalists, Houston Rockets players, Nigerian sportspeople, People from Lagos, Toronto Raptors players, National Basketball Association players with retired numbers, American basketball players
Ecomuseum	Museums
Scottie Pippen	1965 births, Living people, African-American basketball players, American Olympic gold medalists, Chicago Bulls players, Houston Rockets players, Portland Trail Blazers players, Sportspeople from Chicago, Sportspeople from Arkansas, National Basketball Association players with retired numbers, American basketball players
Chicago Bulls	Chicago Bulls
Barry Bonds	1964 births, African-American baseball players, Baseball players from California, Living people, National League All-Stars, Pittsburgh Pirates players, San Francisco Giants players
Bill Russell	African-American basketball players, Boston Celtics players, Sportspeople from Louisiana, 1934 births, Living people, National Basketball Association players with retired numbers, American basketball players
Diving suit	Protective clothing
Kilt	Clothing, Scotland
Straitjacket	Psychiatry
Space suit	Protective clothing, Spaceflight
Weasel	Mustelids
Passport	Travel, Identification documents
University of Nottingham	Universities in England, Nottingham, 1798 establishments, 18th century establishments in England, 1790s establishments in Europe
Metastasis	Cancer
Dingo	Mammals of Australia, Canids
Silk Road	History of China, Trade routes, History of Asia, History of the Middle East
Isis	Egyptian gods and goddesses
Osiris	Egyptian gods and goddesses, Afterlife
Privy Council of the United Kingdom	Politics of the United Kingdom
Patrician	Roman people
W.A.S.P.	1982 establishments in California, 1980s American music groups, 1990s American music groups, 2000s American music groups, 2010s American music groups, American hard rock bands, American heavy metal bands, Glam metal bands, Musical groups established in 1982, Musical groups from Los Angeles, California
Virginia Tech massacre	2007 in the United States, 2000s crimes in the United States, 2000s in Virginia, April events, Attacks on buildings and structures in the 2000s, Attacks on schools in the United States, Crime in Virginia, Mass murder in the 2000s, Massacres in the United States, Murder in 2007, Murder in the 21st century in the United States, Murder-suicides in the United States, Murders by firearm in the United States, School shootings in the United States, Suicides by firearm in the United States
Shakira	1977 births, Living people, Colombian singers, Dancers, Grammy Award winners, Latin Grammy Award winners, Latin singers, People from Barranquilla, South American philanthropists, Pop musicians, Shakira, Songwriters
Joe Louis	1914 births, 1981 deaths, African-American boxers, African-American military personnel, American military personnel of World War II, Burials at Arlington National Cemetery, Cardiovascular disease deaths in the United States, Deaths from myocardial infarction, Disease-related deaths in Nevada, Sportspeople from Alabama
Larry Holmes	American boxers, Sportspeople from Georgia (U.S. state), 1949 births, Living people
Skiing	Skiing, Winter Olympic sports
1966 FIFA World Cup	FIFA World Cup, 1960s in England, 1966 in sports, July events, Football in England
Princess Taiping	Chinese royalty, Princes and princesses
Horus	Egyptian gods and goddesses
Seth	Egyptian gods and goddesses
Shaka Sankofa	1963 births, 2000 deaths, African-American people, American murderers, American rapists, American robbers, Criminals from Texas, Executed American people, People executed by lethal injection
Juliusz Słowacki	1809 births, 1849 deaths, Polish poets
Mistreat	Rock Against Communism, Punk bands, Finnish musical groups
Red dwarf	Red dwarfs, Types of stars
Ali Khamenei	1939 births, Living people, Current national leaders, Heads of state, Iranian clerics, Iranian Muslims, Iranian politicians, Razavi Khorasan Province
Canon law	Types of law, Roman Catholicism
Mstislav Rostropovich	1927 births, 2007 deaths, Cellists, Russian conductors, Grammy Award winners, Azerbaijani musicians, People from Baku, Russian musicians
New Super Mario Bros.	2006 video games, Nintendo DS games, Nintendo DS-only games, Nintendo Entertainment Analysis and Development games, Mario platform games
Galina Vishnevskaya	1926 births, 2012 deaths, Russian opera singers, Russian singers, Sopranos
Voting system	Voting systems
Single transferable vote	Voting systems
Individual Savings Account	Money
Bound for Glory	American heavy metal bands, Musical groups from Minnesota, Rock Against Communism, Thrash metal bands
Neo-Nazism	Neo-Nazism
Israeli West Bank barrier	Arab–Israeli conflict, Buildings and structures in Israel, Buildings and structures in Palestine, Politics of Palestine, Walls, West Bank
Joey Maxim	1922 births, 2001 deaths, American boxers, Sportspeople from Cleveland, Ohio
Armed Islamic Group	History of Algeria, Islamic terrorism
Takfir wal-Hijra	1960s establishments, Islamic terrorism, Rebel militia groups in Africa, Religion in Egypt
Ma'at	Egyptian gods and goddesses
Sermon on the Mount	Speeches, Jesus Christ, Gospels
Irmo, South Carolina	Cities in South Carolina
Mediterranean climate	Climate, Köppen climate classifications
Hans Richter	1843 births, 1916 deaths, Austrian conductors, Hungarian conductors
Thylacine	Dasyuromorphia, Marsupials of Australia
Rock Against Communism	Rock Against Communism
List of Metro-Goldwyn-Mayer movies	Lists of movies, MGM movies
Zoo Tycoon 2	Zoo Tycoon, 2004 video games
Zoo Tycoon	Zoo Tycoon, 2001 video games
Chapel	Churches
Clandestine chemistry	Chemistry, Illegal drugs
Flask	Laboratory equipment, Glass, Containers
Franks	Germanic tribes, Belgian people, Dutch people, French people, German people, Luxembourgian people
Zebra mussel	Bivalves
San Marcos, Texas	Cities in Texas, County seats in Texas
Bar (music)	Musical terminology
Rostov	Towns in Russia
Alaskan king crab fishing	Fishing
Link (The Legend of Zelda)	The Legend of Zelda characters, Fictional characters introduced in 1986, Soulcalibur series guest characters
Solar power station in Victoria	Solar power plants, Buildings and structures in Victoria, Australia
Waldpolenz Solar Park	Buildings and structures in Saxony, Power stations in Germany, Solar power plants
Masaccio	1401 births, 1428 deaths, 15th century Italian painters, Renaissance
Wind power in Germany	Wind farms, Germany
Wind power in Denmark	Denmark, Wind energy
Don River (Russia)	Rivers of Russia
Grace Hopper	American computer scientists, American military people, Scientists from New York City, 1906 births, 1992 deaths, Burials at Arlington National Cemetery
Marin Alsop	1956 births, Living people, American conductors, Yale University alumni
Nevada Solar One	Solar power plants, Buildings and structures in Nevada
Integrated pest management	Agriculture
Serpa solar power plant	Solar power plants, Buildings and structures in Portugal, 2007 establishments in Europe, Establishments in Portugal
Indian Solar Loan Programme	India, Solar energy
Clovis I	466 births, 511 deaths, Converts to Christianity, Kings and Queens of France
Merovingian dynasty	History of Europe, Royal dynasties, History of France
Dale Earnhardt	1951 births, 2001 deaths, Deaths in sport, People from Kannapolis, North Carolina, Sportspeople from North Carolina, NASCAR drivers, American racecar drivers
Homelessness	Homelessness, Social issues
Hideshi Hino	1946 births, Living people, Japanese manga artists
Salland	Regions of the Netherlands, Overijssel
Darkthrone	Norwegian heavy metal bands, Black metal bands, Death metal bands
Minutemen (band)	1980s American music groups, American punk bands, American rock bands, Musical groups from California
Hammurabi	Mesopotamian people, 18th century BC, Kings and queens
Double Nickels on the Dime	1984 albums, Punk albums
Timbaland	African American musicians, American rap musicians from Virginia, American R&B musicians, American record producers, People from Virginia Beach, Virginia, Singers from Virginia, 1972 births, Living people
Melvins	1980s American music groups, 1990s American music groups, 2000s American music groups, 2010s American music groups, American rock bands, American heavy metal bands, Grunge bands, Musical groups from Washington, Musical groups established in 1983, 1983 establishments in the United States, 1980s establishments in Washington (state)
1337	1337
Birth name	Surnames
Tom Whedon	American screenwriters, Year of birth missing (living people)
Zack Whedon	American screenwriters, Living people, 1979 births
Langnau im Emmental	Municipalities of Bern
Muri bei Bern	Cities in Switzerland, Municipalities of Bern
The Legend of Zelda (video game)	1986 video games, The Legend of Zelda games, Nintendo Entertainment System games, Virtual Console games for Wii U
Deadliest Catch	2005 television series debuts, American reality television series, English-language television programs
Garage rock	Rock music
Psychedelic rock	Rock music, Music in San Francisco
Doppelgänger	Folklore
Absurd (band)	German heavy metal bands, Black metal bands, Rock Against Communism
Nokturnal Mortum	Black metal bands, Ukrainian entertainers
Repo Man (movie)	American comedy movies, American science fiction movies, Cult movies, 1984 movies, English-language movies, American independent movies
Reggie Miller	Basketball players from California, Indiana Pacers players, 1965 births, Living people, People from Riverside, California, National Basketball Association players with retired numbers
Altarpiece	Art, Church architecture
Wood mouse	Rodents
Code of Hammurabi	Mesopotamia, Legislation
Media player	Software
19P/Borrelly	Comets
Microcontroller	Computer science
Melodrama	Theatrical forms
Skullhead	1984 establishments in the United Kingdom, 1980s British music groups, 1990s British music groups, 2000s British music groups, 2010s British music groups, English punk bands, Music groups from Newcastle upon Tyne, Musical groups established in 1984, Rock Against Communism
Landser (band)	German rock bands, Rock Against Communism
Lily Allen	1985 births, Living people, British feminists, British television talk show hosts, English pop singers, English television presenters, Singers from London, Television personalities from London
Zerah Colburn	Child prodigies, Autobiographers, 1839 deaths, 1804 births, People from Vermont, American teachers, People educated at Westminster School, London
Quedlinburg	Harz Rural District
DreamWorks	Movie studios, 1994 establishments in the United States
Universal Studios	Movie studios, Companies based in Los Angeles
Second Punic War	Punic Wars, 3rd century BC, Wars and battles of Ancient Rome
Battle of Zama	Battles of the Ancient World, 200s BC, October events
Touchstone Pictures	Disney companies, Movie studios
United States Coast Guard	United States Coast Guard, 1790 establishments in the United States
Sean Paul	Grammy Award winners, Jamaican singers, Reggae musicians, 1973 births, Living people
Bamberg (district)	Bamberg Rural District
Theo Jörgensmann	1948 births, Living people, Clarinetists, German composers, Jazz composers, Musicians from North Rhine-Westphalia
Italian Plague of 1629-1631	1620s in Europe, History of Italy, Plague pandemics, 1630s in Europe, 1629, 1630, 1631
Norwich	Norwich, County towns in England
Pir Sultan Abdal	1480 births, 1550 deaths, Poets
William Byrd	1540 births, 1623 deaths, Renaissance composers, English composers
Cuneiform	Writing systems, Mesopotamia
Menes	Pharaohs
Bast	Cats, Egyptian gods and goddesses
Ra	Egyptian gods and goddesses
Jim Morrison	American rock singers, Burials at Père Lachaise Cemetery, American musicians, Singers from Florida, 1943 births, 1971 deaths
Anchovy	Clupeiformes, Teleosts
Indigenous Australians	Indigenous peoples of Australia
Ian Thorpe	1982 births, Living people, Australian LGBT people, Australian Olympic bronze medalists, Australian Olympic gold medalists, Australian Olympic silver medalists, Australian swimmers, Gay men, LGBT Olympians, Sportspeople from Sydney
Cathy Freeman	1973 births, Living people, Australian Olympic gold medalists, Australian Olympic silver medalists, Bahá'ís, Commonwealth Games medallists, Indigenous Australian sportspeople, Order of Australia, Sportspeople from Queensland, World champions, Australian athletes
Paris Hilton	1981 births, Living people, Actors from New York City, American movie actors, American socialites, American television actors, American television producers, American R&B singers, American pop singers, American dance musicians, Participants in American reality television series, Singers from New York City
Amun	Egyptian gods and goddesses
Aten	Egyptian gods and goddesses
Clam	Bivalves, Seafood
Bes	Egyptian gods and goddesses
Hokkaido Wolf	Wolves
Hornet	Wasps
Geb	Egyptian gods and goddesses
Type O Negative	1980s American music groups, 1990s American music groups, 2000s American music groups, 2010s American music groups, American heavy metal bands, Doom metal bands, Gothic metal bands, Thrash metal bands
Doom metal	Heavy metal subgenres
Candlemass	Swedish heavy metal bands, Doom metal bands
Split album	Albums
Brown dwarf	Types of stars
Dividend	Stock market, Income
Camille Dalmais	1978 births, Living people, French singers
Germanicus	Roman generals, 15 BC births, 19 deaths
PS10 solar power plant	Buildings and structures in Spain, Solar power plants, 2007 establishments in Europe, 2000s establishments in Spain
Feyenoord	Dutch football clubs, Rotterdam, 1908 establishments in Europe, 1900s establishments in the Netherlands
Headquarters	Business, Military, Administrative buildings
Estates Theatre	Opera houses, Theatres, Prague, Buildings and structures in the Czech Republic, 18th century establishments in Europe
National Theatre (Prague)	Opera houses, Theatres, Prague, Buildings and structures in the Czech Republic, 1881 establishments in Europe
Drone (music)	Musical terminology
Pedal point	Musical terminology
Euclidean geometry	Geometry
János Bolyai	1802 births, 1860 deaths, Hungarian people, Mathematicians, Deaths from disease
Diana (mythology)	Roman gods and goddesses
Thoth	Egyptian gods and goddesses
List of Germanic deities	Norse gods and goddesses, Lists of gods and goddesses
List of Egyptian gods and goddesses	Egyptian gods and goddesses, Lists of gods and goddesses
Nut (goddess)	Egyptian gods and goddesses
Dennis Kearney	1847 births, 1907 deaths, Politicians from California, People from County Cork
Cross of Gold speech	Events in the United States, Speeches, 1896, 1890s in Illinois, 19th century in Chicago
Paolo Uccello	1396 births, 1475 deaths, 15th century Italian painters
Fallen Leaves	2006 songs, Songs about drugs
Sumer Is Icumen In	Medieval music
Carmen	Compositions by Georges Bizet, Operas set in Spain
Kumquat	Citrus
Teton Mountains	Mountains of the United States, Geography of Wyoming, Geography of Idaho
Baunach	Bamberg Rural District
Burgebrach	Municipalities in Bavaria, Bamberg Rural District
Ostinato	Musical terminology
Coffee system	Cooking appliances, Coffee
1492 Pictures	Movie studios, 1995 establishments in the United States
Life in Hell	Comic strips
Iraq War	2003 in the United States, 21st century in Iraq, George W. Bush, Wars involving the United States, Wars involving the United Kingdom, Wars involving Australia
Feijoa	Myrtaceae, Trees, Fruits
Wessex	Anglo-Saxons
Barrel racing	Horse riding
Clover	Faboideae
Discus throw	Events in athletics
Eragon	2003 books, Inheritance Cycle
William Baillie	1723 births, 1810 deaths, People from the Republic of Ireland, Artists
Rusty Anderson	American guitarists, Singer-songwriters from California, American rock musicians, 1959 births, Living people
Handshake	Non-verbal communication, Messaging
Wave (gesture)	Non-verbal communication
Baseball bat	Baseball equipment
Softball	Team sports
Dietrich Buxtehude	1630s births, 1707 deaths, Baroque composers, Danish composers, German composers, German organists
Summit Entertainment	1991 establishments in California, American entertainment companies, Movie production
Harlem Renaissance	1920s in the United States, African-American history, American music history, Literature
Hollywood Pictures	Movie studios, Disney, Defunct companies
Third World	politics, economics, Country classifications
Thirty Years' War	17th century in Europe, Thirty Years' War, Wars involving England, Wars involving France
Database normalisation	Database modeling
Clipboard	Tools
Ugliness	Characteristics
Texture	Vocabulary, Sensory system
Outlook Express	Microsoft software, E-mail
Michael Spinks	American boxers, American Olympic gold medalists, Sportspeople from St. Louis, Missouri, 1956 births, Living people
Candy cane	Candy, Christmas
Leon Spinks	1953 births, 2021 deaths, Deaths from prostate cancer, American boxers, American Olympic gold medalists, Sportspeople from St. Louis, Missouri
Cruiserweight	Boxing
Botanic	Northern Ireland
Steve Jay	1951 births, Living people, Bassists
Minimum wage	Macroeconomics
Joe Manchin	1947 births, Living people, United States senators from West Virginia, Governors of West Virginia
Renaissance art	Art, Renaissance
Renaissance architecture	Architecture, Renaissance
Fiji One	Television networks, Fiji
Comet Group	Shops
Sainsbury's	Supermarkets of the United Kingdom, Shops, 1869 establishments in the United Kingdom
Venus of Willendorf	Archaeology, Statues
Acts of Supremacy	1550s in England, 1558, Protestant Reformation
Compact fluorescent lamp	Lamps
PL Kyodan	New religious movements, Japanese culture, Organisations based in Japan
Winston Smith	Characters in written fiction
Yantai	Cities in China
Qiemo	Cities in China
Fictional universe	Fictional universes, Children's literature, Fantasy movies
Ronnie James Dio	American rock singers, Bassists, Cancer deaths in the United States, Deaths from stomach cancer, People from Portsmouth, New Hampshire, Singers from New York, Singers from New Hampshire, 1942 births, 2010 deaths
Chow Yun-Fat	1955 births, Living people, Actors from Hong Kong
Anglican Communion	Anglicanism
1019	1019
Joan of Acre	English royalty, 1272 births, 1307 deaths
Jules Verne	1828 births, 1905 deaths, French writers, French politicians
Teenage Mutant Ninja Turtles	1984 establishments, American animated television series, Comic books, Fictional characters introduced in 1984, Fictional turtles, Teenage Mutant Ninja Turtles
Atze Schröder	1965 births, Living people, Fictional characters
Autonomy	Philosophy
Georg Wilhelm Friedrich Hegel	Continental philosophers, German philosophers, People from Stuttgart, 1770 births, 1831 deaths
London Borough of Croydon	London Borough of Croydon
Nicolas Sarkozy	French Roman Catholics, French lawyers, Politicians from Paris, Honorary Knights Grand Cross of the Order of the Bath, Presidents of France, Princes of Andorra, 1955 births, Living people, French Ministers of Finance
RVV Hillesluis	1932 establishments in Europe, 2012 disestablishments in Europe, Dutch football clubs, Rotterdam
Tyrant	Politics, Ancient Greece
Johann Pachelbel	1653 births, 1706 deaths, Baroque composers, Entertainers from Bavaria, German composers, German organists, People from Nuremberg
Opioid	Opioids, Analgesics
Analgesic	Analgesics
Blender (program)	Graphics software, Free software, Animation
Mark Shuttleworth	White South African people, South African businesspeople, 1973 births, Living people
Paracetamol	Analgesics
Morphine	Opioids, Analgesics
Ségolène Royal	1953 births, Living people, Government ministers of France, Socialist Party (France) politicians, People from Dakar
Codeine	Opioids, Analgesics
Opium	Opioids
Union for a Popular Movement	2002 establishments in France, 2015 disestablishments in Europe, Conservative parties, Political parties in France
Oxycodone	Opioids, Analgesics
Pethidine	Opioids, Analgesics
National Assembly (France)	Politics of France, Parliaments
Hyperthyroidism	Diseases, Endocrine system
99942 Apophis	Asteroids
Dance music	Dance music
Baruch Spinoza	1632 births, 1677 deaths, 17th century philosophers, Dutch Jews, Dutch philosophers, Jewish philosophers, Writers from Amsterdam
Rationalism	Epistemology, Philosophical movements and positions
List of Universal Pictures movies	Lists of movies, Universal Pictures movies
2029	2029, Years in the future
Elephants Dream	Animated movies, 2006 movies, English-language movies
Chapel Royal	Churches in the United Kingdom, British royalty, Church architecture
Orlando Gibbons	1583 births, 1625 deaths, Baroque composers, English composers, English organists, People from Oxford, Renaissance composers
Waits	Music, History of Europe
Tennis Court Oath	1789, French Revolution
Chart	Charts
Samuel Adams	1722 births, 1803 deaths, American Calvinists, Congregationalists, Founding Fathers of the United States, Governors of Massachusetts, Politicians from Boston, Massachusetts, Signers of the U.S. Declaration of Independence
Bar chart	Charts
Pie chart	Charts
Biographical Directory of the United States Congress	Legislative branch of the United States government
Teapot	Tea, Cooking appliances
Le Monde	French-language newspapers
Begging the question	Logical fallacies
Ciwan Haco	1957 births, Living people, Kurdish people, Singers
Tata Young	1980 births, Living people, People from Bangkok, Thai singers, Thai actors, Bollywood playback singers
Practice	Skills
Stevens' power law	Psychology
Logic gate	Logic gates, Electronic circuits
Plaza Mayor of Madrid	Madrid, Town squares, 1400s establishments, 15th century establishments in Spain
Gran Vía	Buildings and structures in Madrid
Fountain of Cibeles	Buildings and structures in Madrid
Puerta del Sol	Buildings and structures in Madrid
Royal Palace of Madrid	Palaces in Spain, Buildings and structures in Madrid
Puerta de Alcalá	Buildings and structures in Madrid
Plaza	Town squares, Spanish culture
Transduction (physiology)	physiology
Sport Club Corinthians Paulista	Football clubs in São Paulo (state), 1910 establishments in South America, 1910s establishments in Brazil
Lyrics	Songs, Poetry, Writing
Judicial review	Law
Asian Dust	Weather events
Aden Abdullah Osman Daar	1908 births, 2007 deaths, Presidents of Somalia
Service of worship	Worship
Bandidos	Motorcycle clubs
Hells Angels	Motorcycle clubs
Outlaws Motorcycle Club	Motorcycle clubs
Blood and Honour	Rock Against Communism
Perry Rhodan	Science fiction books, Series of books
Wieluń	Cities in Poland
Nasjonal Samling	Political parties in Norway, 1940s in Norway, 1933 establishments, 1945 disestablishments in Europe, 20th century establishments in Norway, 1930s establishments in Europe, World War II
One Piece	Anime
Style guide	Writing, Language, Graphics
Parque del Buen Retiro	Madrid, Parks, 1868 establishments in Europe, 19th century establishments in Spain
Crystal Palace (Madrid)	Buildings and structures in Madrid, 1887 establishments in Europe, 19th century establishments in Spain
Las Ventas	Sports buildings, Buildings and structures in Madrid, 1929 establishments in Europe, 1920s establishments in Spain
Yellow spot	Eye anatomy
Retina	Eye anatomy
The Exploited	Scottish rock bands, British punk bands
4Kids	1970 establishments in the United States, Companies based in New York City, Entertainment companies
Cubism	Art movements
Sham 69	English punk bands
Visual acuity	Optometry
Robert Baker	American boxers, Sportspeople from Pennsylvania, 1926 births, 2002 deaths
Michaëlle Jean	Canadian journalists, Haitian people, 1957 births, Living people, Order of Canada, Governors General of Canada, Knights of Justice of the Order of St John, Port-au-Prince
Pascal Duquenne	1970 births, Living people, Belgian movie actors, Belgian stage actors, Belgian television actors, Belgian voice actors, People from Flemish Brabant
Catherine Emmerich	1774 births, 1824 deaths, German Roman Catholics, Nuns, Stigmata
New Year	Holidays, Years
Polyethylene	Thermoplastics
Polyvinyl chloride	Thermoplastics, Chlorine compounds
Polyamide	Polymers
Clarence Henry	American boxers, Sportspeople from San Antonio, Texas, 1926 births, 1999 deaths
Supreme Leader of Iran	Iran, Heads of state, Religious leaders, 1979 establishments in Asia, 1970s establishments in Iran
President of Iran	Presidents of Iran, Lists of heads of state
Ayatollah Khomeini	1902 births, 1989 deaths, Deaths from cancer, Deaths from myocardial infarction, Disease-related deaths in Iran, Heads of state, Iranian clerics, Iranian Muslims, Iranian politicians, Time People of the Year
Theocracy	Forms of government
Ahmad Jannati	Iranian people, Religious leaders, Muslims, 1926 births, Living people
Guardian Council	Government agencies, Iran, Courts (law), 1979 establishments in Asia, 1970s establishments in Iran
Incumbent	Voting
Assembly of Experts	Iran, Islam
Ali Meshkini	Iranian people, Religious leaders, 1922 births, 2007 deaths, Legislative speakers
Judiciary	Law
Mahmoud Hashemi Shahroudi	Chief Justices of Iran, Deaths from cancer, 1948 births, 2018 deaths
Expediency Discernment Council	Iran
Mata Hari	1876 births, 1917 deaths, Dutch artists, Erotic dancers, People executed by firearm, People from Leeuwarden, Spies
Father Damien	1840 births, 1889 deaths, Belgian priests, Belgian Roman Catholics, Christian saints, Hawaii, Missionaries, People from Flemish Brabant
Jack Dempsey	American boxers, Sportspeople from Colorado, 1895 births, 1983 deaths
Jess Willard	1881 births, 1968 deaths, American boxers, Sportspeople from Kansas
Nicholas II of Russia	1868 births, 1918 deaths, House of Romanov, People executed by firearm, Russian Revolution, Russian tsars, Russian Orthodox saints
William Tell	Swiss people
Antioch	4th-century BC establishments
Board	Basic English 850 words
Pitman arm	Auto parts
F1	Computing
Solvent	Chemistry
Chemically inert	Chemical nomenclature, Noble gases
Electron shell	Physics, Quantum mechanics, Chemical bonding
Wheelchair	Disability, Human-powered vehicles
Fuel oil	Fossil fuels, Chemical compounds, Oils
List of large wind farms	Wind farms, Science-related lists
Horse Hollow Wind Energy Center	Wind farms in Texas
List of solar thermal power stations	Solar power plants, Science-related lists, Environment
Andasol Solar Power Station	Solar power plants, Buildings and structures in Spain, Andalusia, 2009 establishments in Europe, 2000s establishments in Spain
Atlantic slave trade	Historic slave trade
African slave trade	History of Africa, Historic slave trade
Pocking Solar Park in Germany	Buildings and structures in Bavaria, Power stations in Germany, Solar power plants
Fractional distillation	Chemistry
Monte Alto solar power plant	Spain, Solar power plants
Odor	Chemistry
European ash	Trees, Oleaceae
Solar power in Spain	Solar energy, Spain
Sensation	Psychology, Physiology
Instant soup	Soups
Perception	Psychology, Perception
Soba	Noodles
Carmen Basilio	American boxers, Sportspeople from New York, 1927 births, 2012 deaths, Deaths from pneumonia
Johnny Saxton	2008 deaths, American boxers, Sportspeople from Newark, New Jersey, 1930 births
Weber-Fechner law	Psychology, Perception
Logarithmic scale	Logorithms
Noodle soup	Soups, Noodles
Scale (ratio)	Measurement
Scale (map)	Cartography, Measurement
Midnight sun	Astronomical phenomena
Eight Below	Disney movies, American adventure movies, 2006 movies, Movies about animals, 2000s adventure movies, American drama movies
Susilo Bambang Yudhoyono	1949 births, Living people, Muslims, Presidents of Indonesia
Order of the Garter	Knights of the Garter, 1348 establishments, 1340s establishments in England
HD DVD	Optical discs
Bruges	Bruges, World Heritage Sites in Europe
Immortality	Life, Death
European Union budget	European Union
Golden Gloves	Boxing
Sonny Liston	African-American boxers, American people convicted of assault, American robbers, Drug-related deaths in the United States, Sportspeople from Arkansas, 1932 births, 1970 deaths
Buckwheat	Caryophyllales, Edible nuts and seeds, Breakfast foods
Kinston Indians	Baseball teams, Sports in North Carolina
Columbia University	Columbia University, Association of American Universities, Ivy League, Pulitzer Prizes, Buildings and structures in Manhattan, 1754 establishments, 1750s establishments in the Thirteen Colonies
Columbian Exchange	History of Africa, Trade, History of Asia, History of Europe, History of North America, History of South America
Ragusa	Capital cities in Italy, Cities in Sicily
Elliott Carter	1908 births, 2012 deaths, 20th century composers, 21st century composers, American centenarians, American composers, Grammy Award winners
Dubrovnik	Cities in Croatia, World Heritage Sites in Europe
Sichuan pepper	Sapindales, Spices
Antiparticle	Subatomic particles, Antimatter
Hamo Beknazarian	1891 births, 1965 deaths, Armenian movie directors
Henrik Malyan	Armenian movie directors, 1925 births, 1988 deaths
Septuagint	Septuagint
Katharine McPhee	1984 births, Living people, Singers from Los Angeles, California, American Idol contestants
World Heavyweight Championship (WWE)	World Wrestling Entertainment championships, 2002 establishments, 2013 disestablishments
Islamic calendar	Calendars, Islamic calendar
Town privileges	Middle Ages
Afternoon	Parts of a day
Medieval music	Medieval music, Periods in music history
Neolithic	Neolithic
Crotchet	Note values
44 BC	44 BC
Burzum	Black metal bands, Thrash metal bands, Norwegian heavy metal bands, Musical groups from Bergen, Musical groups established in 1991, 1991 establishments in Europe, 1990s establishments in Norway, Musical groups disestablished in 1999, 1999 disestablishments in Europe, Musical groups established in 2009, 2009 establishments in Europe, 21st century establishments in Norway
John Collins	1968 births, Living people, Scottish footballers
Mayhem (band)	Black metal bands, Norwegian heavy metal bands
Shrek (movie)	2001 movies, 2001 animated movies, 2001 computer-animated movies, Academy Award winning movies, American adventure movies, American animated movies, American family movies, American comedy movies, DreamWorks Pictures movies, English-language movies, Movies based on books, Movies composed by Danny Elfman, Movies composed by Harry Gregson-Williams, Movies composed by John Powell, Movies that won the Best Animated Feature Academy Award, Shrek, 2000s adventure movies, Screenplays by Joe Stillman, United States National Film Registry movies
Mom at Sixteen	2005 movies, 2000s teen drama movies, American teen drama movies, English-language movies
Danielle Panabaker	1987 births, Living people, American movie actors, American television actors, Disney actors, Actors from Georgia (U.S. state)
Renaissance music	Renaissance, Periods in music history
Kay Panabaker	1990 births, Living people, American movie actors, American television actors, American child actors, Disney actors, Actors from Texas
Haley Hudson	American movie actors, Actors from Chicago, 1986 births, Living people
Enslaved (band)	Black metal bands, Norwegian heavy metal bands
Viking metal	Heavy metal subgenres
Musica ficta	Musical notation, Medieval music
Universal Studios Japan	2001 establishments in Japan, Companies of Japan, Osaka, Theme parks in Japan
Gap year	Colleges and universities, Travel, Leisure
Beam bridge	Bridge types
Gene Simmons	1949 births, Living people, Kiss, Singers from New York City, American rock guitarists, American heavy metal musicians, American heavy metal singers, Musicians from New York City, American Jews, American bloggers
Fox News	Cable television, Fox Broadcasting Company
Omsk	Cities in Russia, Siberia, Capital cities in Russia
Question mark	Punctuation, Typography
Kevin Federline	1978 births, Living people, American dancers, American rap musicians from California, Britney Spears, People from Fresno, California
Mercyful Fate	Black metal bands, Danish heavy metal bands, People from Copenhagen, Musical groups established in 1980
Electrical circuit	Electricity
Quiz	Games
John Hancock	1737 births, 1793 deaths, American revolutionaries, Founding Fathers of the United States, Governors of Massachusetts, Signers of the U.S. Declaration of Independence
Huldrych Zwingli	1484 births, 1531 deaths, Calvinists, Christian theologians, Protestant Reformers, Swiss people
20th-century classical music	20th century in music, Classical music, Periods in music history
Cuxhaven	Port cities and towns of the North Sea
Haifa Wehbe	1967 births, Living people, Lebanese Muslims, Lebanese singers, Models, Movie actors, People from Beirut
Dynamics (music)	Musical notation
Francesco Botticini	15th century Italian painters, People from Florence, 1446 births, 1498 deaths
Grana Padano	Italian cheeses
North American Free Trade Agreement	1994 in the United States, 1994 in Canada, 1990s in Mexico, Commerce, 1990s treaties, International organizations, Economics organizations, Economy of North America, Economy of Canada, Economy of Mexico, Economy of the United States, 1994 works
Language revival	Language
John Travolta	1954 births, Living people, Actors from New Jersey, People from Englewood, New Jersey, American aviators, American movie actors, American television actors, Golden Globe Award winning actors, American musicians, Scientologists
Objectivity (science)	Science
Roundhay Garden Scene	Silent movies, 1888
Herpetology	Branches of zoology, Reptiles, Amphibians
Hector Barbossa	Pirates of the Caribbean characters
Alpha Kappa Alpha	Fraternities and sororities, 1908 establishments, Organizations based in the United States
Fraud	Types of crime
Pump	Engineering, Mechanics, Tools
Ioan P. Culianu	1950 births, 1991 deaths, Romanian writers, Romanian historians, Poets, 20th century philosophers
Single (music)	Marketing, Songs
Captain America	Comic books, Fictional characters introduced in 1941, Marvel Comics adapted into movies, Marvel Comics superheroes, Marvel vs. Capcom fighters, Fictional American people, Fictional characters
Objectivity (journalism)	Mass media, Journalism
Genesis Nomad	Handheld video games, Sega video game consoles
Erlasee Solar Park	Buildings and structures in Bavaria, Power stations in Germany, Solar power plants
Khula	Marriage, Islamic culture
Hashemi Rafsanjani	1934 births, 2017 deaths, Deaths from myocardial infarction, Iranian clerics, Iranian Muslims, Speakers of the Islamic Consultative Assembly, Presidents of Iran
Evander Holyfield	African-American boxers, American Olympic bronze medalists, Celebrity Big Brother contestants, Dancing with the Stars participants, Medalists at the 1984 Summer Olympics, Sportspeople from Alabama, 1962 births, Living people
Porthmadog F.C.	Welsh football clubs, 1884 establishments in the United Kingdom, 1880s establishments in Wales
Sharia	Islamic law
Wadowice	Cities in Poland
Piano duet	Musical forms, Piano
Piano six hands	Musical terminology, Piano
Pedal	Mechanics
Rice wine	Wine
Alcopop	Alcoholic drink
Pedal (music)	Musical terminology
Alcoholism	Addiction, Alcohol drinking habits, Diseases
Sprain	Skeletal system
Second Sino-Japanese War	Second Sino-Japanese War, Wars involving Japan, Wars involving China
Ligament	Skeletal system
Powiat	Poland
1. FC Köln	Cologne, German football clubs, Sport in North Rhine-Westphalia, 1948 establishments in Germany
Carolina Gynning	1978 births, Living people, Big Brother winners, Swedish entertainers, Swedish models
Carrie Underwood	1983 births, Living people, American Idol winners, Grammy Award winners, Singers from Oklahoma, Christian music singers, Country musicians, American Music Awards
Nicole Richie	American movie actors, American television actors, American television personalities, American voice actors, American socialites, Participants in American reality television series, Singers from California, Actors from San Francisco, 1981 births, Living people
The Simple Life	2003 American television series debuts, 2007 American television series endings, 2000s American television series, American reality television series, Fox television series, English-language television programs
Jordin Sparks	American Idol winners, Singers from Phoenix, Arizona, 1989 births, Living people, Mezzo-sopranos, People from Glendale, Arizona
Taylor Hicks	1976 births, Living people, American blues singers, American rock singers, American soul singers, American blues musicians, American rock musicians, American soul musicians, Musicians from Birmingham, Alabama, Writers from Birmingham, Alabama, Singers from Birmingham, Alabama, American Idol winners
Oba Chandler	1946 births, 2011 deaths, American people executed for murder, American robbers, American thieves, Criminals from Ohio, People executed by lethal injection, People from Cincinnati, Ohio
All Saints' Day	Christian holidays, November events
Ishy Bilady	National anthems, United Arab Emirates, 1971 establishments in Asia, Establishments in the United Arab Emirates
JSPWiki	Wiki software
Salvation	Theology
Polyhedron	Polyhedra
Pentagon	Polygons
Calendar date	Calendars
Persian calendar	Calendars
Hexagon	Polygons
West Edmonton Mall	Malls, Alberta
Ahmad Khatami	Muslims, Iranian people, Religious leaders, 1960 births, Living people
Tendon	Skeletal system
Coffee substitute	Coffee
Kuzcham Dherai	Towns in Pakistan
Croatian language	Slavic languages, Croatia, Languages of Europe
Prize	Awards
Christian Church	Christian terminology, Church organization
Religious denomination	Religious denominations
Christian denomination	Christian denominations
List of Christian denominations by number of members	Christian denominations, Religion-related lists
Christendom	Christian terminology, Christianity of the Middle Ages
Creed	Christian genres, Christian creeds
Shahada	Arabic words and phrases, Islam
Purgatory	Roman Catholicism, Afterlife
William Blake	1757 births, 1827 deaths, Artists from London, British abolitionists, British esotericists, Christian mystics, Christian theologians, English activists, English painters, English poets, English Protestants, English theologians, Printmakers, Writers from London
Institution	Social sciences
Race (biology)	Taxonomy
Phenotype	Classical genetics, Developmental biology
Key lime	Citrus
Age of Discovery	History of Europe
Persian lime	Citrus
Kaffir lime	Citrus, Herbs, Spices
Medina	Medina
Doctrine	Christian genres, Politics, Christian theology
Citron	Citrus
Citric acid	Acids, Citrus
Geber	Chemists, Muslims, Philosophers, Physicians, Physicists, Pharmacists
Carl Wilhelm Scheele	1742 births, 1786 deaths, German chemists, People from Mecklenburg-Vorpommern, Swedish scientists
Micheline Calmy-Rey	1945 births, Living people, Presidents of the Swiss Confederation
Criss Angel Mindfreak	2005 American television series debuts, 2010 American television series endings, 2000s American television series, 2010s American television series, American reality television series, Magic, English-language television programs
Piano trio	Musical groups, Piano
Franz Grillparzer	1791 births, 1872 deaths, Austrian poets, Writers from Vienna
Pastry	Foods
Johann Georg Albrechtsberger	1736 births, 1809 deaths, Austrian composers, Classical era composers, Music theorists, Organists, People from Lower Austria
Fidelio	Compositions by Ludwig van Beethoven, Operas
Für Elise	Compositions by Ludwig van Beethoven, Solo piano pieces
Teplice	Spa towns in the Czech Republic, Cities in the Czech Republic
Symphony No. 9 "Choral" (Beethoven)	Compositions by Ludwig van Beethoven, Symphonies
Shatin Pui Ying College	Education in Hong Kong
Heuristic	Problem solving, Mathematics, Computer science
Mersenne prime	Number theory, Prime numbers
Insolation	Solar energy, Climate
The Settlers II	1996 video games, Real-time strategy video games
Hugo Chávez	Deaths from colorectal cancer, Deaths from respiratory failure, Deaths from myocardial infarction, Cancer deaths in Venezuela, Presidents of Venezuela, Democratic socialists, Roman Catholics, 1954 births, 2013 deaths
Granule (cell biology)	Cell biology
Cytosol	Biochemistry
Joan Jett	1960 births, Living people, American rock guitarists, American rock singers, Singers from Pennsylvania, Musicians from Pennsylvania, American punk musicians, Rock and Roll Hall of Fame inductees
Marble	Metamorphic rocks, Building materials, Carbonate rocks
Fan fiction	Fiction, Fandom
Three Laws of Robotics	Science fiction, Isaac Asimov
Nathuram Godse	1910 births, 1949 deaths, Assassins, Indian Hindus, Indian criminals, Indian activists, People executed by hanging, Political activists
Cradle of Filth	English heavy metal bands
Makoto Sakurai	1972 births, Japanese activists, Bloggers, People from Fukuoka Prefecture, Living people
George Adamski	1891 births, 1965 deaths, Writers from California, Writers from Oregon, Writers from New York City, Writers from Wyoming
Manga Kenkanryu	Manga, Korea, History of Japan
Donkey Kong	Fictional animals, Fictional characters introduced in 1981, Mario series characters, Donkey Kong
Sharin Yamano	1971 births, Living people, Japanese manga artists
Categorical imperative	Ethics
Multiculturalism	Sociology
Comfort women	Military of Japan, World War II, Prostitution, Sexuality
Glycolysis	Cellular respiration, Metabolism
Archetype	Psychology
Prototype	Manufacturing
Microdon	Flies
Pattern	Everyday life, Computer science
Bean	Beans
Luxembourg franc	Luxembourg, Former currencies of Europe
Belgian franc	Former currencies of Europe, Economy of Belgium, 1848 establishments in Europe, 1999 disestablishments in Europe
Paradise Island	Islands of the Bahamas
Eddie Izzard	British stand-up comedians, British television producers, Drama Desk Award winners, English comedians, English movie actors, English television actors, English voice actors, LGBT actors, LGBT comedians, English LGBT people, 1962 births, Living people
Emulator	Software, Computer science
ReactOS	Operating systems
MenuetOS	Operating systems
SkyOS	Operating systems
Jodie Foster	1962 births, Living people, Academy Award winning actors, Actors from Los Angeles, California, American child actors, American movie actors, American television actors, BAFTA Award winning actors, Golden Globe Award winning actors, Lesbians, LGBT actors, LGBT directors, LGBT people from Los Angeles, California, LGBT producers, Movie directors from Los Angeles, California, Movie producers from Los Angeles, California, Screen Actors Guild Award winners
President of the French Republic	Presidents of France, Princes of Andorra
Orthodoxy	Theology, Christian terminology
Corn Pops	Breakfast cereals
Końskowola	Villages in Poland
Erich Maria Remarque	1898 births, 1970 deaths, German Roman Catholics, German writers, Naturalized citizens of the United States, Order of Merit of the Federal Republic of Germany, Pen names, People from Osnabrück
Bellinzona	Municipalities of Ticino, Capital cities in Switzerland
J. R. Richard	1950 births, 2021 deaths, American baseball players, Houston Astros players, Sportspeople from Louisiana, National League All-Stars, Deaths from the COVID-19 pandemic in the United States
Conrad Lant	Venom (band), 1963 births, Living people
County Wicklow	County Wicklow
Lusaka	Capital cities in Africa, Cities in Zambia
Shield	Armour
Kite shield	Armour
Gerbilling	Folklore
Socialist Party (France)	Socialist International, Social democratic parties, Political parties in France
Anomie	Sociology, Words
Fog	Weather
Frost	Water, Weather
1983 Atlantic hurricane season	Atlantic hurricane seasons, 1983
Alexandra Feodorovna (Alix of Hesse)	1872 births, 1918 deaths, People executed by firearm, People from Darmstadt, Russian nobility, Russian Orthodox saints
Richard Gere	Actors from New York, Actors from Philadelphia, Pennsylvania, American Buddhists, American human rights activists, American movie actors, American movie producers, American television actors, Golden Globe Award winning actors, People from Syracuse, New York, Screen Actors Guild Award winners, 1947 births, Living people
Rikishi	Wrestling
Thorax	Animal anatomy
Edda	Norse mythology
Njord	Norse gods and goddesses
Freyr	Norse gods and goddesses
Folkvang	Norse mythology
Sessrumnir	Norse mythology
Spinach	Leaf vegetables, Amaranthaceae
Arta Prefecture	Prefectures of Greece
Cardiomyopathy	Heart disease
Fire salamander	Salamandridae
Clamp	Tools
Miamisburg, Ohio	Cities in Ohio, 1797 establishments in the United States, 1790s establishments in the Northwest Territory
Salamandridae	Salamandridae
Legalism	History of China, Philosophical movements and positions
Gold Coast Art Centre	Buildings and structures in Queensland
Reynoldsburg, Ohio	Cities in Ohio
Sekhmet	Egyptian gods and goddesses
Heterodoxy	Christian theology
Isotherm	Meteorology, Thermodynamics
Plate boundary	Plate tectonics
Hourglass dolphin	Oceanic dolphins
Berberis	Shrubs, Ranunculales
Magic (card game)	Card games, 1993 establishments
Giant salamander	Salamanders
Manfred von Richthofen	1892 births, 1918 deaths, German aviators, German military personnel of World War I, Military people killed in action, People from former German territories, People from Wrocław
Fokker Dr.I	World War I aircraft, Military aircraft, Fokker aircraft
Butch Hartman	1965 births, Living people, American animators, American screenwriters, Writers from Michigan
Modes of limited transposition	Music theory
Olivier Messiaen	1908 births, 1992 deaths, 20th century composers, Avignon, French composers, French military people, French organists, French Roman Catholics, Grammy Award winners, Musicians from Provence-Alpes-Cote d'Azur, World War II people
Simplified Chinese characters	Chinese language, Writing systems
Traditional Chinese characters	Chinese language, Writing systems
Windows Server 2008	Microsoft operating systems
Windows Server 2003	Microsoft operating systems
Perry	Fermented drinks
Plate tectonics	Plate tectonics
Lithosphere	Structure of the Earth
New Jersey Devils	New Jersey Devils, 1974 establishments in the United States, 1970s establishments in New Jersey
Nashville Predators	Nashville Predators, 1997 establishments in the United States, 1990s establishments in Tennessee
Crookes	Sheffield
Dallas Stars	Dallas Stars, 1990s establishments in Texas
Pharmaconomist	Pharmacology, Drugs, Care, Healthcare occupations
Broomhill	Sheffield
Owen Hargreaves	1981 births, English footballers, Living people, Manchester United F.C. players, Sportspeople from Calgary, Premier League players
Asthenosphere	Structure of the Earth
Carlo Airoldi	Italian athletes, 1869 births, 1929 deaths
Joseph Priestley	1733 births, 1804 deaths, Unitarians, English chemists, English philosophers, Members of the Lunar Society
Vince McMahon	1945 births, Businesspeople from North Carolina, American professional wrestlers, Living people, Professional Wrestling broadcasters, Sportspeople from North Carolina, WWE people
Ogden Nash	1902 births, 1971 deaths, American poets, Disease-related deaths in the United States, Writers from New York, People from Rye, New York
1986 Atlantic hurricane season	Atlantic hurricane seasons, 1986
Abidjan	Capital cities in Africa, Cities in Ivory Coast, 1931 establishments, 20th-century establishments in Africa
Accra	Settlements in Ghana, Capital cities in Africa, 15th-century establishments, Establishments in Africa
César Franck	1822 births, 1890 deaths, Belgian composers, French composers, French organists, People from Liège, Romantic composers
Addis Ababa	1886 establishments, Addis Ababa, 19th-century establishments in Africa, Regions of Ethiopia
Home directory	Software
Nowruz	Holidays
Earth's mantle	Structure of the Earth
Robert Burns	1759 births, 1796 deaths, Scottish writers, Scottish poets
Book club	Books, Organizations
Video Relay Service	Electronics
Florida Panthers	1993 establishments in Florida, Ice hockey teams in the United States, National Hockey League teams, Sports in Florida
Carolina Hurricanes	Carolina Hurricanes, 1972 establishments in the United States, 20th-century establishments in North Carolina
Dakar	Cities in Senegal, Capital cities in Africa
IRCAM	Music technology, Paris
Yaoundé	Settlements in Cameroon, Capital cities in Africa, 1888 establishments, 19th-century establishments in Africa
Asmara	Capital cities in Africa, Eritrea, 12th-century establishments in Africa, History of Italy
Bamako	Capital cities in Africa, Cities in Mali, 17th-century establishments in Africa
Lomé	Togo, Capital cities in Africa
2002 Atlantic hurricane season	2002 Atlantic hurricane season
Wireless Markup Language	Markup languages
Maseru	Lesotho, Capital cities in Africa
Fandom	Fandom
New York Islanders	New York Islanders
Arizona Coyotes	Arizona Coyotes, 1990s establishments in Arizona
Buffalo Sabres	1970 establishments in New York (state), Ice hockey teams in the United States, National Hockey League teams, Sports in Buffalo, New York
Columbus Blue Jackets	Columbus Blue Jackets
Atlanta Thrashers	2011 disestablishments in the United States, Defunct National Hockey League teams, Ice hockey teams in the United States, Sports in Atlanta, Georgia, 1999 establishments in Georgia (U.S. state)
Rachael Ray	1968 births, Living people, Emmy Award winners, Writers from New York
Sophora	Faboideae, Trees
Cyanobacteria	Gram-negative bacteria, Cell biology, Photosynthesis
Teletypewriter	Electronics, Writing
Of Montreal	American pop music groups, American rock bands, Funk bands, Musical groups from Georgia (U.S. state), Indie rock bands
Alcalá de Henares	Cities in the Community of Madrid, Municipalities in the Community of Madrid
Alpine newt	Newts
Differential equation	Differential equations
Windhoek	Windhoek
Boiling tube	laboratory equipment
1982 Atlantic hurricane season	Atlantic hurricane seasons, 1982
Ouagadougou	Ouagadougou
Venetian language	Languages of Europe, Romance languages, Venice
Yamoussoukro	Capital cities in Africa, Cities in Ivory Coast
Bloemfontein	Bloemfontein, 1846 establishments, 19th-century establishments in South Africa, 1840s establishments in Africa
Jack Black	1969 births, Living people, Actors from Santa Monica, California, American guitarists, American movie actors, American movie producers, American rock musicians, American rock singers, American television actors, American television producers, American television writers, American voice actors, Comedians from California, Singers from California, Writers from California
Dough	Slang, Doughs
Muffin	Cakes, Sweet breads
English muffin	Breads, Breakfast foods, British food
Cornbread	Breads
Cupcake	Cakes
Curry	Indian food, Pakistani food
Shore	Landforms
Bleach (manga)	Manga, Afterlife
Whyalla, South Australia	Cities in South Australia
Ron Paul	1935 births, Living people, American Baptists, Politicians from Pittsburgh, Pennsylvania, 2008 United States presidential candidates, 2012 United States presidential candidates, United States representatives from Texas, US Libertarian Party politicians
Djibouti (city)	Capital cities in Africa, Djibouti
Jamestown, Saint Helena	Capital cities in Africa, Saint Helena, 1659 establishments, 17th-century establishments in Africa
Markus Näslund	1973 births, Living people, New York Rangers players, Pittsburgh Penguins players, Swedish ice hockey players, Vancouver Canucks players, International Hockey League (1945–2001) players, Swedish Hockey League players
Pier Gerlofs Donia	1480 births, 1520 deaths, People from Friesland, Pirates
Erasmus	1466 births, 1536 deaths, 16th century philosophers, Bible translators, Christian theologians, Dutch philosophers, Dutch Roman Catholics, Protestant Reformation, Writers from Rotterdam
Elfstedentocht	Friesland, Skating, Sport in the Netherlands, 1909 establishments in Europe, 1900s establishments in the Netherlands, De Fryske Marren, Leeuwarden, Noardeast-Fryslân, Súdwest-Fryslân, Waadhoeke
Sneek	Cities in Friesland, Former municipalities of Friesland, Súdwest-Fryslân
Huelva	Cities in Andalusia, Capital cities in Spain, Municipalities in Andalusia
Richard Dawkins	1941 births, Living people, British academics, English atheists, English evolutionary biologists, English science writers, People from Nairobi, HuffPost writers and columnists, Academics of the University of Oxford
Stalactite	Caves
Ranma ½	Anime, Manga, 1993 television series debuts, 2002 television series endings
Engagement	Marriage
Enrique Gaspar y Rimbau	1842 births, 1902 deaths, Spanish writers
Laksa	Soups, Noodles
Scarface (1983 movie)	1983 crime movies, 1983 thriller movies, 1980s crime thriller movies, American crime thriller movies, American gangster movies, American movie remakes, Antisocial personality disorder in fiction, English-language movies, Movies directed by Brian De Palma, Movies set in Miami, Florida, Universal Pictures movies, American drama movies, Movies about the illegal drug trade
Contract killing	Types of crime
Ecstasy (drug)	Illegal drugs
Saffir–Simpson scale	Tropical cyclones, Winds
Eastern Catholic churches	Eastern Catholicism
Sanjaya Malakar	1989 births, Living people, singers from Washington, American Idol contestants
Pangolin	Mammals
Antananarivo	Capital cities in Africa, Madagascar, 1625 establishments, 17th-century establishments in Africa
Alex (parrot)	Parrots, Individual animals
Lobamba	Cities in Eswatini
Bobby Lashley	1976 births, Living people, African-American movie actors, African-American wrestlers, American military people, American mixed martial artists, American professional wrestlers, Former WWE wrestlers, Sportspeople from Kansas, TNA wrestlers
Newry	Cities in Northern Ireland, County Armagh, County Down
Shizuka Arakawa	Japanese figure skaters, 1981 births, Living people, Japanese Olympic gold medalists, Sportspeople from Tokyo
Ellipsis	Punctuation, Typography
Mamoudzou	Capital cities in Africa, Communes in Mayotte, Departmental capitals in France, Regional capitals in France
Moroni, Comoros	Comoros, Capital cities in Africa
Porto-Novo	Capital cities in Africa, Settlements in Benin
Praia	Capital cities in Africa, Cape Verde, Municipalities of Cape Verde
Coptic Catholic Church	Eastern Catholicism, Religion in Egypt
Roberto Luongo	1979 births, Acadie–Bathurst Titan players, American Hockey League players, Canadian ice hockey goaltenders, Canadian Olympic gold medalists, Florida Panthers players, Ice hockey people from Quebec, Living people, New York Islanders players, People from Montreal, Val-d'Or Foreurs players, Vancouver Canucks players
Robert De Niro	1943 births, Living people, Academy Award winning actors, Actors from New York City, American movie actors, American movie directors, American movie producers, American Roman Catholics, American television actors, American voice actors, Kennedy Center honorees, Movie directors from New York City, Movie producers from New York City
Internet Archive	Internet-related organizations, Archives, Non-profit organizations of California, 1996 establishments in California
Archive	Documents
Confirmation (Christianity)	Sacraments
My-Otome	My-Otome
Difference	Basic English 850 words
Osprey	Accipitriformes
Thought	Thought, Physiology, Philosophy
Dauria (movie)	1971 drama movies, 1970s action movies, 1970s romantic drama movies, Movies based on books, Russian movies
Petr Shelokhonov	1929 births, 1999 deaths, Deaths from cardiac arrest, People from Saint Petersburg, Soviet actors, Russian movie actors, Russian television actors, Russian stage actors
Conakry	Settlements in Guinea, Capital cities in Africa
Cotonou	Capital cities in Africa, Settlements in Benin
Dodoma	Cities in Tanzania, Capital cities in Africa
N'Djamena	Capital cities in Africa, Cities in Chad, Regions of Chad
San Jose Sharks	San Jose Sharks, 1990 establishments in California
Bujumbura	Capital cities in Africa, Cities in Burundi
Stem (music)	Musical notation
Hope	Basic English 850 words
Corn flakes	Breakfast cereals
Frosted Flakes	Breakfast cereals
Aqua Teen Hunger Force	2000 television series debuts, 2000s American television series, 2010s American television series, American animated television series, American teen television series, Aqua Teen Hunger Force, English-language television programs
Cowley, Wyoming	Towns in Wyoming, Big Horn County, Wyoming, 1900 establishments in the United States, 20th-century establishments in Wyoming
Big Horn County, Wyoming	Big Horn County, Wyoming, 1897 establishments in the United States, 19th-century establishments in Wyoming
Byron, Wyoming	Towns in Wyoming, Big Horn County, Wyoming
Fort Bragg, California	Cities in California, Settlements in Mendocino County, California
Mendocino County, California	Mendocino County, California, 1850 establishments in California
Brigham Young University	Colleges and universities in Utah, Mormonism, West Coast Conference, Provo, Utah, 1875 establishments in the United States, 19th-century establishments in Utah
Provo, Utah	Provo, Utah, County seats in Utah, 1849 establishments in the United States
Lil' Kim	1970s births, Living people, American rap musicians from New York, Singers from New York
Lovell, Wyoming	Towns in Wyoming, Big Horn County, Wyoming
Basin, Wyoming	Towns in Wyoming, Big Horn County, Wyoming, County seats in Wyoming
Lehi	Mormonism
Otto, Wyoming	Unincorporated communities in Wyoming, Big Horn County, Wyoming
Saint-Denis, Réunion	Capital cities in Africa, Communes in Réunion, Cities in overseas regions belonging to France, Departmental capitals in France, Regional capitals in France
Chen Shui-bian	1950 births, Living people, Presidents of the Republic of China
The Suite Life of Zack & Cody	Television series by Disney, American sitcoms, 2005 television series debuts, English-language television programs
São Tomé	Capital cities in Africa, São Tomé and Príncipe
Everglades	Geography of Florida, Animals of North America, National parks in the United States, World Heritage Sites in the United States, Biosphere reserves, Wilderness Areas of the United States, Wetlands
Lost (TV series)	2004 American television series debuts, 2010 American television series endings, 2000s American television series, 2010s American television series, ABC network shows, American drama television series, American science fiction television series, American time travel television series, Emmy Award winning programs, Golden Globe Award winning programs, Saturn Award winners, Screen Actors Guild Award winners, English-language television programs
Western United States	Western United States, Census Regions of the United States
Monaco Grand Prix	Formula One Grands Prix
Bangui	Capital cities in Africa, Central African Republic
ITV	1955 establishments in Europe, 1950s establishments in the United Kingdom, ITV
Burlington, Wyoming	Towns in Wyoming, Big Horn County, Wyoming
Secularism	Religion
Jérémie Aliadière	1983 births, Living people, French footballers
Walgreens	1901 establishments in the United States, 1900s establishments in Illinois, Chicago, Illinois, Companies based in Illinois
Cascade Volcanic Arc	Volcanoes of Washington (U.S. state), Geography of Oregon, Geography of California, Volcanoes of British Columbia
Satoru Iwata	1959 births, 2015 deaths, Japanese businesspeople, Deaths from cholangiocarcinoma, Disease-related deaths in Japan, People from Sapporo, Nintendo people
Lint (material)	Fibers, Materials
Subtropical Storm Andrea (2007)	Subtropical cyclones, Hurricanes in the United States, 2007 Atlantic hurricane season, May events, 2000s in North Carolina, 2000s in South Carolina, 2007 in Georgia (U.S. state), 2007 in Florida
Force field	Physics, Science fiction technology
Shaman	Religious people
Plasma window	Physics
Bari	Bari, Regional capitals in Italy
Plautus	254 BC births, 184 BC deaths, Playwrights, Ancient Roman writers
Mount Edziza	Mountains of British Columbia, Volcanoes of British Columbia
Omar Khayyám	1048 births, 1131 deaths, Persian mathematicians, Persian poets, Muslims, Asian Sufis
Bobby Robson	1933 births, 2009 deaths, British autobiographers, Cancer deaths in England, Deaths from lung cancer, England national football team managers, English football managers, English footballers, Knights Bachelor, Sportspeople from County Durham, Eredivisie managers
Deomyinae	Rodents
Spiny mouse	Rodents
Anglicanism	Anglicanism
Khayyam	Surnames
The Cumshots	Norwegian heavy metal bands
Pocket gopher	Geomyoid rodents
Geomyoidea	Geomyoid rodents
Heteromyidae	Geomyoid rodents
Kangaroo mouse	Geomyoid rodents
Silky pocket mouse	Rodents
Chaetodipus	Geomyoid rodents
Zarbon	Dragon Ball characters, Fictional characters introduced in 1989
Dodoria	Dragon Ball characters, Fictional characters introduced in 1989
Perognathinae	Rodents
Frieza	Dragon Ball characters, Fictional characters introduced in 1989, Fictional extraterrestrial characters, Galactic emperors
Myrmecophile	Insects
Argemone	Ranunculales
Grist	Grains
Banjul	Cities in the Gambia, Capital cities in Africa, Local Government Areas of the Gambia
Medieval Latin	Latin language
Armen Grigoryan	1960 births, Living people, Russian singers, Armenian diaspora
Krematorij	Russian musical groups, Rock bands, Hard rock bands, Musical groups established in 1983, 1980s establishments in the Soviet Union
Kristopher Schau	1970 births, Living people, Norwegian comedians, Norwegian singers, Norwegian television presenters, Musicians from Oslo
Ole Petter Andreassen	Norwegian musical entertainers, Heavy metal guitarists, 1975 births, Living people
InterCityExpress	Rapid transit systems in Germany
Honeydew	Botany, Insects
Ecclesiastical Latin	Latin language
Mate (drink)	Drinks, Argentine food, Chilean food
Yerba mate	Asterids
Guarana	Sapindaceae, Fruits
Broken English	English language, Pidgins and creoles, English-based pidgins
Sacred cow	Figures of speech, Hinduism
Murti	Hinduism, Religious objects
Virtual memory	Computer science
Bolshoi Theatre	Opera houses, Buildings and structures in Moscow
Guild	Middle Ages
Delara Darabi	1986 births, 2009 deaths, Human rights, Iranian people, Murderers, People executed by hanging
Freestyle football	Football
Croydon	London Borough of Croydon, Towns in London
Addington	London Borough of Croydon, Villages in England
Flag of India	India, National flags
Coat of arms of India	India, National coats of arms, National symbols of India
Spanish Wikipedia	Wikipedias, Spanish language
Crystal Palace	Towns in London
Al-Askari mosque	Mosques in Iraq
Hathor	Egyptian gods and goddesses
Santorini	Wine regions, Calderas, Volcanoes of Europe, Islands of Greece
Samarra	Cities in Iraq
Holy See	Popes
Tigris	Rivers of Iraq, Rivers of Turkey, Rivers of Syria, Mesopotamia
Tawaret	Egyptian gods and goddesses
Seshat	Egyptian gods and goddesses
Apep	Egyptian gods and goddesses
Ville Valo	1976 births, Living people, Finnish singers, Songwriters, Baritones, People from Helsinki
Prefix notation	Mathematical notation
Nephthys	Egyptian gods and goddesses
Anuket	Egyptian gods and goddesses
Proto-Indo-European language	Indo-European languages
Ptah	Egyptian gods and goddesses
Kurt Waldheim	1918 births, 2007 deaths, Austrian people of World War II, Autobiographers, Deaths from heart failure, Government ministers of Austria, Military personnel of World War II, Writers from Vienna, Politicians from Vienna, Presidents of Austria, Recipients of the Decoration for Services to the Republic of Austria
Mop	Cleaning tools
Pan (mythology)	Greek gods and goddesses
Hypothesis	Philosophy of science, Words
Observation	Science, Philosophy of science, Basic English 850 words
East Sutton	Towns in Kent
City and town halls	Local government, Administrative buildings
Spectrometer	Physics, Laboratory equipment
Province of Carolina	1660s establishments in the Thirteen Colonies, History of North Carolina, 18th century in South Carolina, 1663 establishments, 18th-century disestablishments in the United States, History of Georgia (U.S. state), History of Florida, 1729 disestablishments, 1660s establishments in England, 18th century disestablishments in Europe
Adenosine diphosphate	Cellular respiration
Tefnut	Egyptian gods and goddesses
Sobek	Egyptian gods and goddesses
Lucky Town	1992 albums
Juli	German rock bands
Dar es Salaam	Cities in Tanzania
National Hurricane Center	Tropical cyclones, Miami, Florida
Gaborone	Cities in Botswana, Capital cities in Africa
Libreville	Capital cities in Africa, Gabon
Brahmaputra River	Rivers of Bangladesh, Rivers of China, Tibet, Rivers of Assam, Rivers of India
Lilongwe	Settlements in Malawi, Capital cities in Africa
Shu (god)	Egyptian gods and goddesses
Malabo	Capital cities in Africa, Equatorial Guinea
Multimedia	Communication
Shield volcano	Volcanoes
Caldera	Calderas
Addiscombe	London Borough of Croydon
South Norwood	London Borough of Croydon
Software bug	Software
Telephone tapping	Telephone, Criminal investigation
Sara Paxton	1988 births, Living people, Actors from Los Angeles, California, American movie actors, Jewish American actors, Jewish American musicians, Singers from Los Angeles, California
Lipstick	Cosmetics
Lip gloss	Cosmetics
Mbabane	Cities in Eswatini, Capital cities in Africa
Pentecostalism	Pentecostalism, Christian movements and denominational families
Pentecost	Christian holidays
Niamey	Capital cities in Africa, Cities in Niger
Basic Roman	English language, Pronunciation
Wadjet	Egyptian gods and goddesses
Buto	Ancient Egypt
Scribe	Ancient Egypt, Occupations, Writing systems
Ascension	Christian holidays
Need for Speed	Need for Speed games, Video game series
Jeanne Calment	1875 births, 1997 deaths, French centenarians, People from Provence-Alpes-Cote d'Azur, Supercentenarians
François Truffaut	Actors from Paris, Cancer deaths in France, Deaths from brain cancer, French movie actors, French screenwriters, French voice actors, French movie critics, Movie directors from Paris, Movie producers from Paris, Writers from Paris, 1932 births, 1984 deaths
Leif Erikson	970 births, 1020 deaths, Icelandic people, Explorers
Thomas More	1478 births, 1535 deaths, British lawyers, Christian saints, English Roman Catholics, English writers, Executed English people, Legislative speakers, Lord Chancellors, People executed by decapitation, Politicians from London
Juan Perón	1895 births, 1974 deaths, Argentine generals, Former dictators, Presidents of Argentina, Vice Presidents of Argentina
Kosher	Food and drink, Judaism
Cartagena, Colombia	Cities in Colombia, Geography of Colombia, 1533 establishments, 1530s establishments in the Spanish Empire
Greta Garbo	American child actors, American movie actors, Breast cancer survivors, Deaths from pneumonia, Deaths from renal failure, Infectious disease deaths in New York City, Naturalized citizens of the United States, Actors from Stockholm, Silent movie actors, Swedish movie actors, 1905 births, 1990 deaths
Anita Ekberg	Disease-related deaths in Italy, People from Malmo, Swedish models, Swedish movie actors, Swedish television actors, 1931 births, 2015 deaths
World Championship Wrestling	1988 establishments in the United States, 2001 disestablishments in the United States, Companies based in Atlanta, Georgia, Sports in Atlanta, Georgia, Time Warner subsidiaries, World Championship Wrestling
The Fresh Prince of Bel-Air	1990 American television series debuts, 1996 American television series endings, 1990s American comedy television series, American sitcoms, NBC network shows, Television series about families, Television series set in Los Angeles, California, English-language television programs
The Nation of Domination	WWE teams and stables
Potomac River	Rivers of Maryland, Rivers of West Virginia, Washington, D.C., Rivers of Virginia
Greenbrier County, West Virginia	West Virginia counties, 1782 establishments in North America, 1780s establishments in the United States
Emperor Go-Sanjō	Emperors of Japan
Emperor Jimmu	Emperors of Japan, Japanese mythology
585 BC	580s BC
Posthumous name	Names
You Can't Do That on Television	1979 television series debuts, 1990 television series endings, 1970s comedy television series, 1980s Nickelodeon shows, 1980s Canadian television series, 1980s comedy television series, 1990s Canadian television series, 1990s comedy television series, Canadian children's television series, Television sketch shows, 1979 establishments in Canada, 1990s disestablishments in Canada, English-language television programs
Medellín	Cities in Colombia, 1616 establishments, 17th-century establishments in the Spanish Empire
Nouakchott	Capital cities in Africa, Mauritania
Saint Nicholas	Christian saints, 270 births, 343 deaths
HBO	1972 establishments in New York (state), HBO
The Electric Company	PBS Kids shows, 1971 establishments in the United States, 1977 disestablishments in the United States, English-language television programs, 1971 television series debuts, 1977 television series endings
Model (person)	Art, Models
Jacques Rougeau	1960 births, Canadian professional wrestlers, Former WWE wrestlers, Living people, Sportspeople from Quebec
Ezzard Charles	American boxers, Sportspeople from Georgia (U.S. state), 1921 births, 1975 deaths
Religion of Ancient Egypt	Egyptian mythology
Kyle Broflovski	Comedy movie characters, Fictional characters introduced in 1992, South Park characters
Eric Cartman	Comedy movie characters, Fictional characters introduced in 1997, South Park characters
...And Justice for All (album)	Metallica albums
Armenian Apostolic Church	Oriental Orthodoxy, 3rd-century establishments
National church	Church organization
List of football clubs in Armenia	Armenian football clubs, Lists of football teams
FC Zvartnots	Armenian football clubs
Armenian Premier League	Armenian football clubs
Football Federation of Armenia	UEFA, 1992 establishments, 20th century establishments in Armenia, Sport in Armenia
Orhan Pamuk	1952 births, Living people, Writers from Istanbul, Turkish Nobel Prize winners
Urartu	Urartu
Lake Van	Lakes of Asia, Geography of Turkey
Kurdish language	Iranian languages
Annual plant	Botany
Pea	Faboideae, Model organisms
Biennial	Types of plants
The WB	American television networks, 1995 establishments in the United States, 2006 disestablishments in the United States, The WB
Port Louis	Settlements in Mauritius, Capital cities in Africa
Freetown	Sierra Leone, Capital cities in Africa, 1792 establishments, Establishments in Africa
Michelle Obama	African-American people, African American lawyers, First Ladies of the United States, Barack Obama, American autobiographers, Writers from Chicago, Obama family, 1964 births, Living people
Fame (musical)	Musicals based on movies, West End musicals, 1980s musicals
Prime Minister of Japan	Prime Ministers of Japan
Emperor Suizei	Emperors of Japan
Emperor Annei	Emperors of Japan
Emperor Itoku	Emperors of Japan
Coptic Orthodox Church of Alexandria	Oriental Orthodoxy, Religion in Egypt
Pretoria	Pretoria, 1855 establishments, 19th-century establishments in South Africa, 1850s establishments in Africa
Reza Alinejad	1985 births, Living people, Human rights, Iranian people
Bigotry	Sociology
Bukkake	Human sexuality
Melleruds IF	Swedish football clubs, 1908 establishments in Sweden
Lisa Lampanelli	1961 births, Living people, Comedians from Connecticut
Detroit Tigers	Detroit Tigers
Oscilloscope	Laboratory equipment, Electronics, Measuring tools, Machines
Girl Scout cookie	Cookies
Nancy Drew	Characters in written fiction, Series of books, Fiction books
Arthur Abraham	Armenian boxers, People from Yerevan, Living people, 1980 births
International Boxing Federation	Sports organizations, Boxing
Vic Darchinyan	Armenian boxers, Living people, 1976 births, Australian boxers
Atenism	Egyptian mythology
Religion in ancient Armenia	Paganism, Armenian culture, Ancient Armenia
Steak	Meat dishes
Jet engine	Motors
Dawn Fraser	1937 births, Living people, Australian of the Year Award winners, Australian Olympic gold medalists, Australian Olympic silver medalists, Australian swimmers, Commonwealth Games medallists, Independent politicians in Australia, Medalists at the 1952 Summer Olympics, Medalists at the 1956 Summer Olympics, Medalists at the 1960 Summer Olympics, Members of the Order of the British Empire, Order of Australia, Politicians from Sydney, Sportspeople from Sydney
NBC News	NBC, NBC network shows
CBS News	Columbia Broadcasting System
The Masters Tournament	Golf tournaments, Sports in the United States, Augusta, Georgia
NFL Europa	National Football League
Ennead	Egyptian mythology
Heliopolis (ancient)	Ancient Egypt
Akhenaten	Pharaohs, Religious leaders
Bartonella rochalimae	Gram-negative bacteria
Tipi	Tipis, Native American
Karen Carpenter	1950 births, 1983 deaths, American pop musicians, Deaths from heart failure, Deaths from anorexia, American pop singers, Musicians from New Haven, Connecticut, Singers from Connecticut, People from Downey, California, Singers from California
Luke the Evangelist	New Testament people
Walid Eido	1942 births, 2007 deaths, Assassinated people, Lebanese Muslims, Lebanese politicians, People from Beirut
Toyama Prefecture	Toyama Prefecture, Prefectures of Japan
Fouad Siniora	1943 births, Living people, Lebanese Muslims, Government ministers, Presidents of Lebanon, Prime Ministers of Lebanon
Hassan Nasrallah	1960 births, Living people, Lebanese Muslims, Lebanese nationalists, Lebanese politicians, Lebanese terrorists, Muslim terrorists
Sidon	Cities in Lebanon, Phoenicia
Chisel	Cutting tools, Woodworking tools
Parallel	Basic English 850 words
Oak Park, Illinois	Cities in Illinois, Suburbs of Chicago, Illinois, Settlements in Cook County, Illinois
Ring Lardner	American columnists, Deaths from tuberculosis, Infectious disease deaths in the United States, Writers from Michigan, 1885 births, 1933 deaths
Björk	Björk, Brit Award winners, Icelandic movie actors, Rock musicians, Singers, Songwriters, 1965 births, Living people, People from Reykjavík, Trip hop musicians
List of years	Year lists
Volumetric flask	Laboratory equipment
Florence flask	Laboratory equipment
Motion Picture Association of America	Movie organizations, Non-profit organizations of the United States, 1922 establishments in the United States
Long Beach, California	Long Beach, California
São Carlos	Cities in São Paulo (state)
51st state	States of the United States
Mogadishu	Capital cities in Africa, Cities in Somalia
J1 League	Football leagues, Football in Japan, 1993 establishments in Asia, 1990s establishments in Japan
Philippine Revolution	History of the Philippines, Wars of independence, Rebellions in Asia, 19th century rebellions
Victoria, Seychelles	Seychelles, Capital cities in Africa
Roe	Seafood
Television licence	Television
Nicosia	Nicosia
Gob	Canadian punk bands, Musical groups established in 1994, 1994 establishments in Canada
Auckland Grammar School	Auckland, Schools in New Zealand, 1868 establishments, 1860s establishments in New Zealand
Virginia Beach, Virginia	Beaches of the United States, Virginia Beach, Virginia
Rose Tattoo	1970s Australian music groups, 1980s Australian music groups, 1990s Australian music groups, 2000s Australian music groups, 2010s Australian music groups, Australian hard rock bands, Musical groups established in 1976, Musical groups from Sydney
Patriots' Day	Holidays, Massachusetts
Woodside, London	London Borough of Croydon
Sofia	Sofia, Provinces of Bulgaria
Burette	Laboratory equipment
Maghen Abraham Synagogue	Synagogues, Beirut, Buildings and structures in Lebanon, 1925 establishments in Asia, 20th century establishments in Lebanon
Georg Danzer	Austrian musicians, Songwriters, 1946 births, 2007 deaths
Bentheuphausia amblyops	Krill
Grosse Ile Township, Michigan	Townships in Michigan
Malacostraca	Malacostraca
Decapod	Decapods
Rafik Hariri	1944 births, 2005 deaths, Assassinated people, Billionaires, Business people, Lebanese Muslims, Prime Ministers of Lebanon
Antenna (biology)	Crustaceans, Insects
Sepp Dietrich	1892 births, 1966 deaths, German prisoners, German war criminals, People from Bavaria, SS officers, Waffen-SS generals
Hue	Color
Freeview (New Zealand)	Television, New Zealand culture, 2007 establishments, 2000s establishments in New Zealand
Burqa	Islamic dress
Motion Picture Association of America film rating system	Movie ratings
The Satanic Verses	1988 books, English novels, English-language novels
Satanic verses	Islam, Quran
National Democrats (Sweden)	2001 establishments in Sweden, Nationalist organizations in Europe, Political parties in Sweden
Broad Green	London Borough of Croydon, Villages in England
Kanji	Writing systems, Japanese language
Chris Moyles	BBC radio presenters, British autobiographers, English radio personalities, English television presenters, People from Leeds, Television personalities from Yorkshire, 1974 births, Living people
Libretto	Opera terminology
Hmong people	Ethnic groups in Asia, Thai people, Laos, Vietnamese people
Toplessness	Nudity
Westminster Cathedral	Cathedrals in England, Roman Catholic Cathedrals, Buildings and structures in the City of Westminster, Westminster
Cachoeira do Sul	Cities in Rio Grande do Sul
Median	Statistics
Mode (statistics)	Statistics
S.S.C. Napoli	Italian football clubs, Naples, 1926 establishments in Italy
At War with Satan	Venom (band), 1983 albums, Heavy metal albums
Antichrist	New Testament, Christian eschatology
Baker	Baking
Statistical hypothesis test	Statistics
Luxembourg City	Luxembourg City, World Heritage Sites in Europe
Vacuum cleaner	Home appliances
TV Tokyo	Japanese television networks
Drawer	Furniture
Chest of drawers	Furniture
Puzzle	Puzzles
On-Line Encyclopedia of Integer Sequences	Mathematics, Science websites
Ramanujan prime	Number theory
Prime counting function	Number theory
Bertrand's postulate	Number theory
Paul Erdős	1913 births, 1996 deaths, Hungarian scientists, Mathematicians, Wolf Prize winners
Erdős number	Numbers
John Morrison (wrestler)	1979 births, Living people, American professional wrestlers, Former WWE wrestlers, Sportspeople from Los Angeles, California, American Roman Catholics
Candice Michelle	1978 births, Living people, American professional wrestlers, Former WWE wrestlers, Female professional wrestlers, American models, Actors from Milwaukee, Wisconsin, Sportspeople from Wisconsin
Star of David	Judaism, Religious symbols
Belz Beis HaMedrash HaGadol	Synagogues, Judaism in Israel, Buildings and structures in Jerusalem
Samson (band)	British heavy metal bands, 1977 establishments in the United Kingdom, Musical groups established in 1977, Musical groups disestablished in 2002, 2002 disestablishments in the United Kingdom
Thornton Heath	Towns in London, London Borough of Croydon
Stamford Bridge (stadium)	Football stadiums in London
Freeganism	Lifestyles, Recycling
British Board of Film Classification	1912 establishments in the United Kingdom, Movie organizations, Video game ratings, Organisations based in London
Electrology	Hair, Medical procedures
Film rating systems	Movie ratings
Eve Ensler	1953 births, Living people, American activists, American feminists, American playwrights, People with cancer, Writers from New York City
Roger Pearson	British writers, British anthropologists, 1927 births, Living people
Colorado Springs, Colorado	Colorado Springs, Colorado, County seats in Colorado, 1886 establishments in the United States, 1880s establishments in Colorado
Janice Raymond	1943 births, Living people, American academics, American LGBT people, American radical feminists, Lesbian feminists, LGBT scientists, Prostitution
Energy efficiency	Energy
Tulsa, Oklahoma	Tulsa, Oklahoma, County seats in Oklahoma
Anchorage, Alaska	Anchorage, Alaska, 1914 establishments in the United States, 20th-century establishments in Alaska
Boundary Peak	Geography of Nevada, Mountains of the United States
Skopje	Skopje
Norwegian Dawn	Cruise ships
Lea Fastow	1961 births, Living people, American Jews, American criminals, People from Houston, Texas
Lawrence Higby	Year of birth missing (living people), Living people, Businesspeople from Washington, D.C., American political activists
Endorsement test	Government, United States law, Religion in the United States
Terry Rakolta	American activists, 1943 births, Living people
Snake River	Rivers of Washington (U.S. state), Rivers of Oregon, Rivers of Wyoming, Rivers of Idaho
Mount Hood	Geography of Oregon, Mountains of the United States
Crater Lake	Geography of Oregon, Lakes of the United States, Volcanoes of the United States, Calderas
Driftwood	Wood
List of United States cities by population	Lists of cities in the United States
What Not to Wear	British reality television series, BBC Television programmes
Public figure	Law
Elm	Trees, Ulmaceae
Governor of Massachusetts	Governors of Massachusetts, Lists of politicians from the United States, Politicians from Massachusetts
Produce	Fruits, Vegetables
Highway	Roads
Beverly Cleary	1916 births, 2021 deaths, American centenarians, American children's writers, American autobiographers, Writers from Oregon
London, Ontario	Cities in Ontario
Amy Winehouse	1983 births, 2011 deaths, Brit Award winners, British jazz musicians, British R&B musicians, British soul musicians, Contraltos, Drug-related accidental deaths in the United Kingdom, Grammy Award winners, Singers from London
Canuck	Canada, Slang
Charles Kirk Clarke	1857 births, 1924 deaths, People from Ontario, Psychiatrists, Medical researchers
The Internationale	Songs, Communism, Socialism
Hartley, Kent	Villages in Kent
Stephanie McMahon	1976 births, Living people, WWE people, American screenwriters, Writers from Connecticut
Cienfuegos	Cities in Cuba, 1819 establishments in North America, 19th-century establishments in Cuba
Gribble	Isopods
Tuatara	Scaled reptiles, Living fossils, Animals of New Zealand
Dinosaur Jr	1984 establishments in the United States, 1980s American music groups, 1990s American music groups, 2000s American music groups, 2010s American music groups, American rock bands, Musical groups established in 1984, Musical groups from Massachusetts
Band Aid (band)	1984 establishments in the United Kingdom, Musical groups established in 1984
Hüsker Dü	American punk bands, Musical groups from Minnesota, Musicians from Saint Paul, Minnesota, Musical groups established in 1979, 1979 establishments in the United States, 1970s establishments in Minnesota, Musical groups disestablished in 1988, 1988 disestablishments in the United States, 20th-century disestablishments in Minnesota
Deir el Qamar Synagogue	Synagogues, Buildings and structures in Lebanon, 17th century establishments in Asia, Establishments in Lebanon
Interstate 75	Interstate Highways
Kumho Tire Co. v. Carmichael	United States law, Politics
Deodorant	Hygiene
Silesia	Geography of the Czech Republic, Geography of Poland, Geography of Saxony, Regions of Germany
Josh Holloway	1969 births, Living people, American television actors, Actors from Santa Clara County, California, People from San Jose, California
Levon Mkrtchyan	1953 births, Living people, Armenian movie directors
Manuel Fraga Iribarne	Galician people, Spanish politicians, 1922 births, 2012 deaths
Galicia (Spain)	Galicia
Bilirubin	Biochemistry, Physiology
Nelly Furtado	1978 births, Living people, Canadian pop singers, Grammy Award winners, Musicians from British Columbia, Nelly Furtado, People from Victoria, British Columbia, Portuguese singers, R&B musicians, Latin Grammy Award winners
Anna Jurkiewicz	1984 births, Living people, Polish sportspeople, Figure skaters
Exmoor	Devon, Somerset, National parks in the United Kingdom
Barnstaple	Towns in Devon
Bideford	Towns in Devon
Tiverton	Mid Devon, Towns in Devon
Torbay	Unitary authorities in Devon
1215	1215
391	391
Beyond (album)	2007 albums
Mitt Romney	Businesspeople from Massachusetts, United States senators from Utah, American chief executives, Governors of Massachusetts, Politicians from Detroit, Michigan, Businesspeople from Detroit, Michigan, Businesspeople from Utah, 2008 United States presidential candidates, 2012 United States presidential candidates, US Republican Party politicians, 1947 births, Living people, 21st-century American politicians, Massachusetts Republicans
Laboratory glassware	Laboratory equipment
Volta (album)	2007 albums, Björk albums, Pop albums
Mulatto	Ethnic groups, Spanish language
Water polo	Water polo, Summer Olympic sports
Fishstick	Seafood, Fast food
Nelly	1974 births, Living people, American rap musicians from Texas, Grammy Award winners, Singers from Missouri, Singers from Austin, Texas, Nelly, Musicians from Austin, Texas
Boy band	Boy bands
Solo (music)	Music
Antarctic krill	Krill
Cubic metre	Units of volume
Food and Agriculture Organization	United Nations, Green politics
Colorimeter	Laboratory equipment
Valletta	National capitals in Europe, Cities in Malta
Basketball Bundesliga	Basketball leagues, Sport in Germany, 1939 establishments, 1930s establishments in Germany
Butterfield, Missouri	Cities in Missouri
Andorra la Vella	National capitals in Europe, Parishes of Andorra
Woodland	Forests
Limburg (Netherlands)	Limburg (Netherlands)
Mount Cayley	Volcanoes of British Columbia, Mountains of British Columbia
Limburg (Belgium)	Limburg (Belgium)
Limbourg	Municipalities of Liège
Illusion	Illusions
Charcoal	Fuel, Biofuels
Brose Baskets	Bamberg, Basketball teams, Sports clubs, Sport in Bavaria
Armenian Revolutionary Federation	Politics of Armenia, Socialist International, Political parties in Europe, Nationalist organizations in Europe, Tbilisi, 1890 establishments
Christapor Mikaelian	Armenian politicians, 1859 births, 1905 deaths
Varazdat	Monarchs of Armenia
Adana massacre	Adana massacre, Anti-Armenianism, Massacres in Turkey, Armenian Genocide, April events, 1909, 20th century in Turkey
Adana	Cities in Turkey
Parsley Massacre	20th century in the Dominican Republic, Massacres, 20th centuy in Haiti, 1937 in North America
Heat pump	Engineering
Second law of thermodynamics	Thermodynamics, Laws of physics
Air conditioner	Engineering
First law of thermodynamics	Thermodynamics, Laws of physics
Conservation of energy	Thermodynamics, Laws of physics
Differences between butterflies and moths	Lepidoptera
Monophyly	Cladistics
Lepidoptera	Lepidoptera
Diurnal	Zoology
Skipper (butterfly)	Hesperiidae
Energy conservation	Energy, Engineering, Environment
Cogeneration	Electricity
Dew point	Weather, Weather measurements
Podgorica	Cities in Montenegro, Municipalities of Montenegro, National capitals in Europe
Región Autónoma del Atlántico Sur	Geography of Nicaragua
Región Autónoma del Atlántico Norte	Geography of Nicaragua
Gas compressor	Engineering
Cash	Currency
Hemer	Märkischer Rural District
Heat engine	Basic physics ideas, Heat, Thermodynamics
Thermodynamic cycle	Thermodynamics
Christoph Metzelder	1980 births, Living people, German footballers, Sportspeople from North Rhine-Westphalia
Thermodynamic system	Thermodynamics, Systems, Systems theory
Piston	Auto parts
Pinyin	Chinese language
Susianna Kentikian	1987 births, Living people, Armenian boxers
Banknote	Currency
Common cold	Diseases caused by viruses
Qajar dynasty	History of Iran, History of Azerbaijan, Azerbaijani dynasties, Royal dynasties, 1781 establishments, 1925 disestablishments, 18th century establishments in Iran, 1920s disestablishments in Asia, 1780s establishments in Asia
Zenwalk Linux	Linux distributions
Thermodynamic equilibrium	Thermodynamics
Thermodynamic potential	Thermodynamics
Thermal efficiency	Thermodynamics, Engineering
Thermodynamic state	Thermodynamics
Thermal physics	Thermodynamics
Statistical mechanics	Mechanics, Thermodynamics
Kinetic theory	Thermodynamics
Frik	Armenian poets, 13th century births, 14th century deaths
Yeghishe Charents	1987 births, 1937 deaths, Armenian poets
Kars	Cities in Turkey
Kars Province	Provinces of Turkey
Manny Gamburyan	Armenian sportspeople, Living people, 1981 births, Martial artists
The Mickey Mouse Club	Television series by Disney, Children's television series, English-language television programs
Fanta	Soft drinks
Parameter	Mathematics
Agavaceae	Agavaceae, Plant families
Succulent plant	Types of plants
Lu Xun (Three Kingdoms)	183 births, 254 deaths, Three Kingdoms generals
List of Jupiter's moons	Jupiter's moons, Astronomy lists
Moons of Saturn	Saturn's moons, Astronomy lists
Vande Mataram	Indian culture, National symbols of India
List of Uranus' moons	Astronomy lists, Uranus' moons
List of Neptune's moons	Astronomy lists, Neptune's moons
King (chess)	Chess pieces
Work (thermodynamics)	Thermodynamics
Internal energy	Thermodynamics, Mechanics, Energy
Physical law	Science
Pipe (material)	Engineering
Cameron Diaz	Actors from San Diego, California, Models from San Diego, California, American movie actors, American television actors, American voice actors, 1972 births, Living people
Bacon number	Entertainment, Games
Pondicherry	Capital cities in India, Settlements in Puducherry
Zanzibar	Geography of Tanzania
Enya	1961 births, Living people, Grammy Award winners, Irish singers, Mezzo-sopranos, New Age music, People from County Donegal
Downing Street	Buildings and structures in London, 1680s establishments in Europe, 17th century establishments in England
Armenian illuminated manuscript	Illuminated manuscripts, Armenian culture
Alcatraz Island	Islands of the United States, Landmarks in San Francisco, Prisons, Museums in California, 1963 establishments in California
Illuminated manuscript	Illuminated manuscripts
Manuscript	Manuscripts
Matenadaran	Armenian culture, Yerevan, Manuscripts
Blue Mosque, Yerevan	Yerevan, Buildings and structures in Armenia, Mosques, 1766 establishments
235 BC	235 BC
302 BC	302 BC
San Marino City	National capitals in Europe, Municipalities of San Marino
Fort Worth, Texas	Fort Worth, Texas, 1873 establishments in the United States, 1870s establishments in Texas, County seats in Texas
Akdamar Island	Armenian Apostolic Churches
Gandzasar monastery	Churches in Armenia, Armenian Apostolic Churches
Deportation	Forced migration, Law
912	912
Vahe	Monarchs of Armenia
Rhadamistus	Monarchs of Armenia
Construction	Construction
Infrastructure	Civil engineering, Infrastructure, Architecture, Planning
Ceremony	Ceremonies
Kirk Kerkorian	1917 births, 2015 deaths, Businesspeople from Los Angeles, California
Chemical property	Chemistry
Bass drum	Drums
Drum kit	Drums
Drum stick	Drums
Khachkar	Armenian culture, Monuments and memorials
Back Dorm Boys	Chinese people, Comedy, Musical groups
Nattō	Japanese food
Kichijōji	Tokyo Prefecture
Udon	Noodles, Japanese food
Hachiōji, Tokyo	Cities in Japan, Settlements in Tokyo Prefecture
Nerima, Tokyo	Wards of Tokyo, Settlements in Tokyo Prefecture, 1947 establishments in Japan
Suginami, Tokyo	Wards of Tokyo, Settlements in Tokyo Prefecture
Higashi-Nagasaki Station	Railway stations in Tokyo
Sagamihara, Kanagawa	Cities in Kanagawa Prefecture
Aomori, Aomori	Cities in Japan, Settlements in Aomori Prefecture
HM Land Registry	Departments of the United Kingdom Government, Government agencies of the United Kingdom, 1862 establishments in the United Kingdom
Yamuna	Rivers of India
Ahmedabad	Cities in India, Settlements in Gujarat
Dachau, Bavaria	Dachau (district)
Odonata	Odonata
Chordophone	String instruments
Will Ferrell	1967 births, Living people, American voice actors, American movie actors, American television actors, People from Irvine, California, Actors from Orange County, California, Comedians from California, Mark Twain Prize recipients
Tritium	Hydrogen, Isotopes
Wood fibre	Fibers, Wood
Christian theology	Christian theology
Professional wrestling	Professional wrestling
Monaco-Ville	Monaco
Hıdırlık Tower	Fortification, Towers in Asia, Buildings and structures in Turkey
Mesa, Arizona	Mesa, Arizona, 1878 establishments in the United States, 19th-century establishments in Arizona Territory
Tucson, Arizona	Tucson, Arizona, County seats in Arizona
Arlington, Texas	Arlington, Texas
Tarrant County, Texas	Texas counties, Tarrant County, Texas
Spectrophotometer	Spectroscopy
Russian Orthodox Church	Russian Orthodox Church, 988 establishments, Establishments in Russia
Form	Geometry
Martiros Saryan	1880 births, 1972 deaths, Russian painters, Armenian artists, Recipients of the Order of Lenin
Library of Congress	Buildings and structures in Washington, D.C., Libraries in the United States, National libraries, 1800 establishments in the United States, 19th-century establishments in Washington, D.C.
Forest, Ontario	Towns in Ontario
Soul music	Music genres
Garni	Settlements in Armenia
Irredentism	International relations, Territorial disputes, Nationalism
Greater Armenia (political concept)	Middle East, Nationalism
Fume hood	Laboratory equipment
Ghevont Alishan	1820 births, 1901 deaths, Armenian poets, Armenian historians, Christian clergy, Eastern Catholics
Armenian Catholic Church	Eastern Catholicism
Armin T. Wegner	1886 births, 1978 deaths, Armenian Genocide, German journalists, German people of World War II, German political activists, German writers, Holocaust survivors, Humanitarians
Activism	Activism
Assyrian people	Assyrian people
Uncertainty principle	Quantum mechanics
Assyria	Assyria, Former countries in the Middle East
Yuri Andropov	1914 births, 1984 deaths, Deaths from renal failure, Directors of intelligence agencies, Former dictators, Russian communists, Russian politicians, Soviet politicians, Time People of the Year, Recipients of the Order of Lenin
Van, Turkey	Cities in Turkey
Van Province	Provinces of Turkey, Kurdistan
Urartian language	Urartu
Yamaha Corporation	1887 establishments, Companies of Japan, Musical instrument makers, 1880s establishments in Japan
Grease (movie)	1978 comedy movies, 1970s musical movies, 1970s romance movies, 1970s teen movies, American high school movies, American musical comedy movies, American romantic comedy movies, American teen comedy movies, American teen romance movies, English-language movies, Movies set in Los Angeles, California, Movies set in the 1950s, United States National Film Registry movies, Movies directed by Randal Kleiser
Eastern Time Zone	Time zones
Armenian Legion	Military of Armenia, Nazi Germany, History of Armenia, 1944
Garegin Njdeh	Armenian politicians, 1886 births, 1955 deaths
Wehrmacht	Military of Germany, Nazi Germany
Drastamat Kanayan	Armenian politicians, 1884 births, 1956 deaths, Armenian Genocide, Armenian military people, Assassins, Disease-related deaths in Massachusetts, German people of World War II, Terrorists
Jack White	1975 births, Living people, American guitarists, American songwriters, American composers, American movie actors, Actors from Detroit, Michigan, Singers from Detroit, Michigan
Meg White	1974 births, Living people, Singers from Michigan, American drummers, Musicians from Michigan, American rock musicians, American blues musicians
Adriatic Sea	Seas of the Atlantic Ocean
Time in Australia	Time zones, Time by country
Human sacrifice	Superstitions
Tomomi Kahala	1974 births, Living people, Singers from Tokyo
Observer effect	Quantum mechanics
Canton Township, Michigan	Townships in Michigan, 1834 establishments in Michigan Territory
Probability theory	Probability theory
The Raven	19th-century American poems, Poems by Edgar Allan Poe
Mayan civilization	Maya civilization
Mesoamerican chronology	History of Mesoamerica
Beck	1970 births, Living people, American rock guitarists, American songwriters, American composers, Musicians from Los Angeles, California, Singers from Los Angeles, California, Electronic musicians, Multi-instrumentalists
Prime Meridian	Lines of longitude
Retirement	Society, Leisure
Trdat the Architect	Byzantine Empire
Byzantium	Ancient Greece
Coat of arms of Armenia	Armenian culture, National coats of arms
Arsacid Dynasty of Armenia	History of Armenia, Royal dynasties, 1st-century establishments, 5th-century disestablishments
Hakob Kojoyan	1883 births, 1959 deaths, Armenian artists
Alexander Tamanian	Armenian people, 1878 births, 1936 deaths
Ani	History of Armenia, Ruins, Buildings and structures in Armenia, 5th century establishments in Asia, Establishments in Armenia
Armenian Soviet Socialist Republic	20th century in Armenia, Republics of the Soviet Union, 1920 establishments in the Soviet Union, 1920 disestablishments, Disestablishments in the Soviet Union
Extinct language	Extinct languages
Armenian Americans	Ethnic groups in the United States
Thomas Cavendish	1560 births, 1592 deaths, English explorers
William Saroyan	People from Fresno, California, 1908 births, 1981 deaths, American writers
Raphael Lemkin	1900 births, 1959 deaths, Belarusian Jews, Genocide, Polish lawyers, Polish Jews, Refugees from Nazism, Jewish lawyers
Vakıflı	Cities in Turkey
Spanish colonization of the Americas	History of Native Americans, History of Spain
Conquistador	History of Spain
Shushanik Kurghinian	Armenian poets, Autobiographers, 1876 births, 1927 deaths
Gyumri	Cities in Armenia
Arminianism	Protestant theology, Christian movements and denominational families, Protestant Reformation
Ruben Sevak	Armenian poets, 1885 births, 1915 deaths
Armenian Evangelical Church	Protestantism
Armenian alphabet	Armenian language
Orontid Dynasty	Monarchs of Armenia, Royal dynasties
Armenian Highland	Geography of Armenia, Mountains of Asia, Mountains of Europe
Armenian Quarter	Armenian diaspora, Neighbourhoods of Jerusalem
Paulo César Fonseca do Nascimento	1978 births, Living people, Brazilian footballers, People from Porto Alegre
Lina Hahne	1984 births, Living people, Beauty pageant winners, Swedish models
Miss Universe	Beauty pageants, 1952 establishments
Frank Thomas	1968 births, Living people, American baseball players, Sportspeople from Georgia (U.S. state), Chicago White Sox players, Oakland Athletics players, Toronto Blue Jays players, National Baseball Hall of Fame members, People from Columbus, Georgia
Northwest	Compass directions
Southeast	Compass directions
Silvia Night	Fictional characters
Donald Trump	1946 births, Living people, Donald Trump, 2016 United States presidential candidates, 2020 United States presidential candidates, 21st-century American politicians, Actors from Florida, Actors from New York City, American billionaires, American conservatives, American game show hosts, American Presbyterians, Businesspeople from Florida, Businesspeople from New York City, People from Queens, Politicians from Florida, Politicians from New York City, Real estate developers, Television personalities from New York City, Time People of the Year, Trump family, US Republican Party politicians, WWE Hall of Fame
Northeast	Compass directions
Mona Sahlin	1957 births, Living people, Government ministers of Sweden
Swedish Social Democratic Party	1889 establishments in Europe, Socialist International, Social democratic parties, Political parties in Sweden, 1880s establishments in Sweden
Olof Palme	1927 births, 1986 deaths, Anti-Communists, Feminists, Government ministers of Sweden, Murders by firearm, Politicians from Stockholm, Prime Ministers of Sweden, Socialists, Unsolved murders
Elena Paparizou	1982 births, Greek singers, Living people, Swedish singers, Eurovision Song Contest winners
Miss World	Beauty pageants
Gregory the Illuminator	Armenian Apostolic Churches
Bow Wow	1987 births, Living people, Singers from Ohio, American rap musicians from Ohio, American movie actors, Actors from Columbus, Ohio, Musicians from Columbus, Ohio, Singers from Columbus, Ohio
John Cage	1912 births, 1992 deaths, 20th century composers, American composers, Cardiovascular disease deaths in New York City, Deaths from stroke, LGBT artists, LGBT composers, LGBT musicians, LGBT people from Los Angeles, California, LGBT writers, Musical entertainers from Los Angeles, California, Writers from Los Angeles, California
4′33″	Compositions
McDonnell Douglas F/A-18 Hornet	United States Navy aircraft, United States Marine Corps aircraft, Australian military aircraft, Spain
McDonnell Douglas F-15 Eagle	United States Air Force aircraft, Military of Japan, Israel Defense Forces, Saudi Arabia
Dicotyledon	Flowering plants
James Clark Ross	1800 births, 1862 deaths, English explorers, British military people, British naturalists, English botanists, Fellows of the Royal Society, Knights Bachelor, Legion of Honour, People from London, Royal Navy officers, Royal Society, Scientists from London
Hrant Dink	Armenian writers, Turkish journalists, Murder victims, 1954 births, 2007 deaths
Agos	Newspapers published in Turkey, Istanbul
St Kilda Football Club	Australian Football League
Ingvar Carlsson	1934 births, Living people, Swedish economists, Prime Ministers of Sweden
Shilpa Shetty	1975 births, Living people, Big Brother winners, Celebrity Big Brother contestants, Indian models, Indian movie actors
Third party (politics)	Political parties
Paula DeAnda	Singers from Texas, People from Corpus Christi, Texas, 1989 births, Living people
Canton of Fribourg	Canton of Fribourg
Compass rose	Navigation, Cartography
Cardinal direction	Compass directions
Knight (chess)	Chess pieces
Queen (chess)	Chess pieces
Dennis the Menace	Comic strips
5 BC	5 BC
Taner Akçam	Turkish writers, 1953 births, Living people, Turkish historians, Turkish scientists
International Date Line	Lines of longitude
Boredom	Emotions
Circle of latitude	Lines of latitude
J-pop	J-pop
List of J-pop artists	J-pop, Music-related lists, Lists of entertainers
Ara Darzi	1960 births, Living people, Armenian diaspora, Iraqi people, British politicians
Puffy AmiYumi	J-pop bands, Pop punk bands
Mika Nakashima	1983 births, Living people, Japanese movie actors, Japanese singers, Japanese models, People from Kagoshima Prefecture
Yui (singer)	Singers from Fukuoka Prefecture, 1987 births, Living people
Zard	J-pop bands, Japanese rock bands
Wyolica	J-pop bands, Folk music groups
Crystal Kay	1986 births, Living people, Singers from Kanagawa Prefecture
Speed (band)	Japanese musical groups, People from Okinawa Prefecture
Glay	Japanese rock bands
Aiko (singer)	Japanese singers, 1975 births, Living people, People from Osaka Prefecture
Ringo Shiina	1978 births, Living people, Singers from Fukuoka Prefecture, Songwriters, Japanese guitarists
GO!GO!7188	Japanese rock bands
Porno Graffitti	J-pop bands, Japanese rock bands, People from Hiroshima Prefecture, 1990s music groups
Yuki Isoya	Japanese singers, 1972 births, Living people, People from Hokkaido
Mr. Children	Japanese musical groups
3B LAB.*	J-pop bands
Ellegarden	Japanese rock bands, Punk bands, Emo bands, Japanese musical groups, Musical groups established in 1998, Musical quartets, Pop punk bands
Def Tech	Japanese musical groups
Ai Otsuka	Japanese singers, J-pop, 1982 births, Living people, People from Osaka
Remioromen	Japanese rock bands, J-pop bands
Ayaka	Japanese singers, 1987 births, Living people, People from Osaka Prefecture
Kyu Sakamoto	1941 births, 1985 deaths, Singers from Kanagawa Prefecture, Japanese movie actors
Orange Range	Japanese rock bands
Bump of Chicken	Japanese rock bands
Kumi Koda	1982 births, Living people, Japanese singers, People from Kyoto Prefecture
Zeebra	1971 births, Living people, Musicians from Tokyo, Rap musicians
Dreams Come True	Japanese musical groups, J-pop bands, Jazz bands
Every Little Thing (band)	1990s music groups, 2000s music groups, 2010s music groups, Japanese rock bands, Musical duos, Musical groups established in 1996, Pop rock bands
KAT-TUN	Japanese rock bands, J-pop bands, Japanese boy bands
BoA	1986 births, Living people, South Korean singers, K-pop singers, J-pop singers, C-pop singers
Namie Amuro	1977 births, Living people, Japanese singers, People from Okinawa Prefecture
Saturn (mythology)	Roman gods and goddesses
Comanche	Native American
Cuvette	Laboratory equipment
John Abbot	1587 births, 1650 deaths, English poets, English priests, English Roman Catholics, Roman Catholic priests
Lemuel Abbott	1730 births, 1776 deaths, English poets
Thomas Eastoe Abbott	1780s births, 1854 deaths, English poets, Writers from Norfolk
Division of labour	Sociology, Anthropology
Euphrates	Rivers of Iraq, Rivers of Turkey, Rivers of Syria, Mesopotamia
JC Chasez	1976 births, Living people, American songwriters, Mouseketeers, NSYNC, Singers from Washington, D.C.
Herl	Municipalities in Rhineland-Palatinate, Trier-Saarburg
Ricky Martin	Ricky Martin, 1973 births, Living people, People from San Juan, Puerto Rico, Puerto Rican actors, Puerto Rican singers, Latin singers, American singers, American dancers, American pop musicians, American movie actors, American television actors, LGBT actors, LGBT musicians, Grammy Award winners
Fiefdom	Middle Ages
Nicky Hilton Rothschild	American fashion designers, Models from New York City, American socialites, 1983 births, Living people, American bloggers
Disappearance of Madeleine McCann	2007 crimes, 2007 in Europe, 2000s crimes in Europe, 2000s in Portugal, May events, Missing people
Linda Thelenius	1974 births, Living people, Autobiographers, Big Brother contestants, Political activists, Swedish models
Linda Bengtzing	1974 births, Living people, Swedish singers
Melodifestivalen	Music competitions, Swedish music, 1958 establishments in Europe, 1950s establishments in Sweden
Katie Price	1978 births, Living people, Big Brother winners, Cancer survivors, Celebrity Big Brother contestants, English models, English television personalities, Entertainers from Brighton, I'm a Celebrity...Get Me Out of Here! contestants, Singers from Sussex
Nikki Grahame	1982 births, 2021 deaths, Big Brother contestants, English models, Television personalities from Hertfordshire, People from Watford, Deaths from anorexia
Venus Williams	1980 births, Living people, African-American tennis players, American female tennis players, American Olympic gold medalists, American Protestants, Australian Open champions, Competitors at the 2016 Summer Olympics, French Open champions, Jehovah's Witnesses people, Medalists at the 2000 Summer Olympics, Medalists at the 2008 Summer Olympics, Medalists at the 2012 Summer Olympics, Medalists at the 2016 Summer Olympics, Olympic silver medalists, Sportspeople from Los Angeles, California, US Open (tennis) champions, Wimbledon champions, World No. 1 tennis players
Serena Williams	1981 births, African-American tennis players, American autobiographers, American female tennis players, American Olympic gold medalists, American Protestants, Australian Open champions, Competitors at the 2016 Summer Olympics, French Open champions, Jehovah's Witnesses people, People from Saginaw, Michigan, Living people, Medalists at the 2000 Summer Olympics, Medalists at the 2008 Summer Olympics, Medalists at the 2012 Summer Olympics, Sportspeople from Michigan, US Open (tennis) champions, Wimbledon champions, World No. 1 tennis players
Miki Ando	1987 births, Living people, 2006 Winter Olympics, 2010 Winter Olympics, Japanese figure skaters, People from Aichi Prefecture
Kelly Ripa	1970 births, Living people, American movie actors, American television actors, American television presenters, Television talk show hosts, Actors from New Jersey, People from Camden, New Jersey, Emmy Award winners
Faith Ford	1964 births, Living people, American movie actors, Actors from Louisiana, American television actors
Hope & Faith	American sitcoms, 2003 American television series debuts, 2006 American television series endings, English-language television programs
Live! with Kelly	American television talk shows, First run syndicated television programs, English-language television programs
Sven-Göran Eriksson	1948 births, Living people, Swedish footballers, Swedish football managers, England national football team managers
Jade Goody	1981 births, 2009 deaths, Cancer deaths in England, Celebrity Big Brother contestants, Deaths from cervical cancer, English television personalities, Nurses, People from Southwark (London borough), Reality television participants, Television personalities from London
Sara Rue	American television actors, Actors from New York City, 1979 births, Living people
Less Than Perfect	2000s American sitcoms, 2002 American television series debuts, 2006 American television series endings, ABC network shows, English-language television programs
Hilary Hahn	American violinists, Grammy Award winners, 1979 births, Living people
Larry King	1933 births, 2021 deaths, Actors from Brooklyn, American atheists, American movie actors, American television news anchors, American television talk show hosts, CNN people, Deaths from sepsis, Jewish American actors, Jewish American writers, Jewish atheists, Journalists from New York City, Peabody Award winners, Television personalities from New York City, Writers from Brooklyn
Norfolk, Virginia	Norfolk, Virginia
Cream Lemon	Anime, 2001 anime OVAs, 2006 anime OVAs
Vahan Tekeyan	1878 births, 1948 deaths, Armenian poets
Pontic Greeks	Greece
Nynorsk	Germanic languages, Languages of Norway
Austrian Armenian Cultural Society	20th century establishments in Armenia, 1970s establishments in Austria, 1974 establishments in Europe
Laredo, Texas	Cities in Texas, County seats in Texas, 1755 establishments, 18th-century establishments in Mexico
German-Armenian Society	Armenia, Germany, Europe, 1914 establishments in Europe, 1910s establishments in Germany
Asbarez	Newspapers in California, Companies based in Los Angeles, 1908 establishments in California, Fresno, California
Nuevo Laredo	Cities in Mexico, Tamaulipas, 1847 establishments in North America, 19th-century establishments in Mexico
United States military chocolate	American food, Military of the United States, 1937 establishments in the United States
Marion Bartoli	1984 births, Female tennis players, French tennis players, Living people, People from Geneva, Wimbledon champions
Bandana	Accessories, Headgear
Roger Federer	1981 births, Living people, Australian Open champions, French Open champions, Male tennis players, Medalists at the 2008 Summer Olympics, Medalists at the 2012 Summer Olympics, Olympic gold medalists, Olympic silver medalists, Sportspeople from Basel, Swiss Olympic medalists, Swiss tennis players, US Open (tennis) champions, Wimbledon champions, World No. 1 tennis players
Martina Hingis	Australian Open champions, Coaches, Doping cases in sport, Female tennis players, French Open champions, Slovakian sportspeople, Strictly Come Dancing participants, Swiss tennis players, US Open (tennis) champions, Wimbledon champions, World No. 1 tennis players, 1980 births, Living people, Medalists at the 2016 Summer Olympics, Olympic silver medalists
Noisettes	English rock bands, English punk bands, Indie rock bands, Funk bands, Soul bands, Musical groups from London
Rafael Nadal	1986 births, Living people, Agnostics, Australian Open champions, Balearic Islands, French Open champions, Male tennis players, Medalists at the 2008 Summer Olympics, Medalists at the 2016 Summer Olympics, Olympic gold medalists, Spanish Olympic medalists, US Open (tennis) champions, Wimbledon champions, World No. 1 tennis players
Justine Henin	1982 births, Belgian sportspeople, Female tennis players, French Open champions, Living people, Medalists at the 2004 Summer Olympics, People from Liège, US Open (tennis) champions, World No. 1 tennis players
Carla Garapedian	Year of birth missing (living people), Living people, American movie directors
Massacres of Erzurum	Massacres in Turkey, Armenian Genocide
Lake Kari	Lakes of Asia, Geography of Armenia
Mount Aragats	Mountains of Asia, Geography of Armenia
Crystle Stewart	Beauty pageant winners, People from Houston, Texas, 1981 births, Living people
Victoria Cross for Australia	Orders, decorations, and medals of Australia, 1856 establishments in Australia
White Pines Forest State Park	Illinois, State parks in the United States
George Stainforth	British military people, British aviators, 1899 births, 1942 deaths
Ion Heliade Rădulescu	1802 births, 1872 deaths, Romanian writers, Romanian journalists, Poets, Romanian social scientists, 19th century philosophers, Romanian politicians
Chosroid Dynasty	Georgian people, Royal dynasties
Guaramid Dynasty	Georgian people, Royal dynasties
George II of Imereti	1585 deaths, Georgian people, Year of birth unknown, Kings and queens
Bagrat III of Imereti	Kings and queens, 1495 births, 1565 deaths
1982 Glasgow Hillhead by-election	1982 in the United Kingdom, 1982 elections, Elections in the United Kingdom, Politics of Scotland, 1980s in Scotland, March events
Solaris	Operating systems, Unix, Sun Microsystems, Oracle Corporation
Puja Gupta	Beauty pageant winners, 1984 births, Living people, Indian models
Charles A. Johns	1857 births, 1932 deaths, American lawyers, Politicians from Oregon
Saved!	2004 movies, 2000s LGBT movies, 2000s teen comedy movies, American LGBT movies, American teen comedy movies, Movies set in Maryland
Gibraltar Chronicle	English-language newspapers, Gibraltar, 1801 establishments
Alan Johnston	British journalists, 1962 births, Living people
BBC Television Centre	BBC
Liberty Bell	Philadelphia, Pennsylvania, Bells, Symbols of the United States
Frank Lloyd Wright	1867 births, 1959 deaths, Deaths from bowel obstruction, Architects from Chicago, Frank Lloyd Wright, Unitarians, American philosophers, American philanthropists, Businesspeople from Chicago, Businesspeople from Wisconsin, Deaths from surgical complications, People from Richland Center, Wisconsin
Law enforcement in Cuba	Cuba, Law enforcement by country
Battle of Damascus	Battles of World War II, Damascus, 1941, 20th century in Syria
Laurence Mancuso	1934 births, 2007 deaths, American Eastern Orthodox Christians, Christian religious leaders, Monks, People from New York
Joseph Jukes	1811 births, 1869 deaths, English geologists, People from Birmingham
Second Severn Crossing	1996 establishments in the United Kingdom, Bridges in the United Kingdom, Concrete bridges, Gloucestershire, Monmouthshire, Steel bridges
Spitz (band)	Japanese rock bands
Yakima, Washington	Cities in Washington (U.S. state), County seats in Washington, Yakima County, Washington
Sprite	Soft drinks
University of Washington	Association of American Universities, Colleges and universities in Washington, Pac-12 Conference, Seattle, Washington, 1861 establishments in the United States
The Hershey Company	American food companies, Pennsylvania, 1894 establishments in the United States
Totally Spies!	Animated television series, 2001 television series debuts, 2013 television series endings, Spy television series, English-language television programs
Screamers (2006 movie)	American documentary movies, 2006 movies, Multilingual movies
Ross Bagdasarian	1919 births, 1972 deaths, American pianists, American songwriters, American voice actors, People from Fresno, California
Shawn Michaels	1965 births, American Christians, American professional wrestlers, American television actors, Former WWE wrestlers, Living people, Actors from San Antonio, Texas, Sportspeople from Arizona, Sportspeople from San Antonio, Texas, WWE Hall of Fame
Denali	Mountains of the United States, Geography of Alaska
Dune	Landforms
Detective	Law enforcement occupations, Criminal investigation
Kieran Richardson	1984 births, Living people, English footballers, Sportspeople from London, Premier League players
Juan Pablo Montoya	1975 births, Living people, People from Bogotá, Colombian sportspeople, NASCAR drivers, Formula One drivers
Riyo Mori	Miss Universe winners, 1986 births, Living people, People from Shizuoka Prefecture
Eolian processes	Winds, Erosion, Landforms
American Girl	Series of books, Children's books, Dolls
Hot spring	Geology
Sergei Parajanov	1924 births, 1990 deaths, Movie directors from Georgia (country), Armenian movie directors
Artavazd Peleshyan	1938 births, Living people, Armenian movie directors, Armenian writers
Dress	Dresses
Giza	Giza
Thorns, spines and prickles	Plant anatomy
Pope Pius IX	1792 births, 1878 deaths, Deaths from epilepsy, Italian popes, Beatified people
Sickle	Farming tools, Cutting tools
Kilometres per hour	Units of measurement
Amanda Bynes	1986 births, Living people, Actors from Ventura County, California, American child actors, American movie actors, American television actors, American voice actors, People from Ventura County, California, People with bipolar disorder, People with schizophrenia
Exclamation mark	Punctuation
Yupik	People from Alaska, Ethnic groups in the United States
Anna Kournikova	1981 births, Female tennis players, Living people, Participants in American reality television series, Russian models, Russian tennis players, Sportspeople from Moscow
Sk8er Boi	2002 songs, Avril Lavigne songs
Talk show	Television programs, Radio
Graduated cylinder	Laboratory equipment
Edmond Keosayan	Armenian movie directors, 1936 births, 1994 deaths
Amerigo Vespucci	1454 births, 1512 deaths, Deaths from infectious disease, Italian explorers, People from Florence
Titanic (1997 movie)	1997 drama movies, 1997 romance movies, 1990s disaster movies, 1990s romantic drama movies, 2012 3D movies, 20th Century Fox movies, American disaster movies, American epic movies, American romantic drama movies, Best Picture Oscar, Movies with underwater settings, Movies based on real life events, Movies composed by James Horner, Movies directed by James Cameron, Movies set in the 1910s, Movies that won the Best Original Song Academy Award, Movies that won the Best Visual Effects Academy Award, Murder-suicide in movies, RMS Titanic, Survival movies, 3D re-releases
Rip Slyme	Musical groups from Kanagawa Prefecture, Hip hop bands
Names for large numbers	Numbers
Acetylene	Hydrocarbons
Ralf Schumacher	1975 births, Living people, Formula One drivers, German racecar drivers, Sportspeople from North Rhine-Westphalia
Auto racing	Auto racing
Lascelles Abercrombie	English poets, 1881 births, 1938 deaths
Eliza Acton	1799 births, 1859 deaths, British chefs, English poets, Writers from Suffolk, Writers from Sussex
Ralph Fiennes	1962 births, Living people, Actors from Suffolk, Actors who played M, BAFTA Award winners, Drama Desk Award winners, English movie actors, English movie directors, English movie producers, English stage actors, English television actors, English voice actors, People from Ipswich, Tony Award winning actors
Wellington Koo	Chinese politicians, 1887 births, 1985 deaths
Wade-Giles	Romanization
Natalia Oreiro	1977 births, Living people, Uruguayan entertainers, Latin singers, People from Montevideo
Democratic Progressive Party	Political parties in Taiwan, Liberal parties, Social democratic parties, Nationalist organizations in Taiwan, 1986 establishments in Asia, 1980s establishments in Taiwan
President of the Republic of China	Politics of China, Presidents of the Republic of China
Anastas Mikoyan	1895 births, 1978 deaths, Armenian people, Communists, Recipients of the Order of Lenin
Mitanni	Assyria, Mesopotamia
Russians in the United Kingdom	Ethnic groups in the United Kingdom, Russian people
Larry Griffin	American criminals, People from Missouri, 1954 births, 1991 deaths
Nassau County, New York	New York (state) counties, 1899 establishments in the United States, 1890s establishments in New York (state)
First Nagorno-Karabakh War	1988, 1989, 1990, 1991, 1992, 1993, 1994, Anti-Armenianism, Anti-Azerbaijani sentiment, 20th century in Armenia, 20th century in Azerbaijan, Nagorno-Karabakh, Nagorno-Karabakh Republic
Trentino-Alto Adige/Südtirol	Trentino-Alto Adige/Südtirol
SMAP	Japanese boy bands
Kick the Can Crew	Japanese musical groups, Hip hop bands, Musical groups established in 1996, 2004 disestablishments, 1996 establishments in Japan, 21st century disestablishments in Japan, 2000s disestablishments in Asia
Judy and Mary	Japanese rock bands
Angela Aki	Japanese singers, Japanese songwriters, 1977 births, Living people, People from Tokushima Prefecture
Spanish Empire	Empires, History of Spain, 1492 establishments, 1975 disestablishments
Viceroyalty of New Spain	History of Spain, Viceroys, 1520s establishments in North America, 1820s disestablishments in North America, 1821 disestablishments
Matt LeBlanc	1967 births, Living people, Actors from Massachusetts, American movie actors, American television actors, People's Choice Award winners
Tango	Dance music, Ballroom dances, Latin dances
Ethane	Alkanes
Cracking (chemistry)	Chemical processes, Organic reactions
Christchurch	1848 establishments, 1840s establishments in New Zealand, Cities in New Zealand
Phosphine	Phosphorus compounds
Planetary ring	Planets
Kingdom of Castile	History of Spain
Luigi Galvani	Italian physicians, Italian scientists, 1737 births, 1798 deaths
Lorem ipsum	Typography, Latin phrases
Planetary core	Geology, Planets
Redox	Chemistry
Van Resistance	Armenian Genocide
100 (number)	Integers, Square numbers
1021	1021
1332	1332
Wasabi	Spices, Brassicaceae, Condiments
Prion disease	Infectious diseases, Neurology, Dementia
Help!	The Beatles albums, 1965 albums, Rock and roll albums, Folk albums
Please Please Me	The Beatles albums, Debut albums, 1963 albums, Rock and roll albums, Pop albums
Maritime, Fluvial and Harbor Museum of Rouen	Museums in France, Rouen
Echternach	Communes in Luxembourg
Breast cancer	Breast cancer
Cue sports	Cue sports
Cher	Academy Award winning actors, Actors from California, American movie actors, American pop singers, American rock singers, American television actors, Emmy Award winners, Golden Globe Award winning actors, Grammy Award winners, Singers from California, 1946 births, Living people, Warner Bros. Records artists
Frunzik Mkrtchyan	Armenian actors, Soviet actors, 1930 births, 1993 deaths
Yuzu (band)	J-pop bands, Folk music groups
Pestilence	Infectious diseases
List of historical plagues	Infectious diseases, Disease-related lists
Pandemic	Infectious diseases
Training	Training, Learning
Demi Moore	Actors from Idaho, Actors from New Mexico, American movie actors, American movie producers, American television actors, 1962 births, Living people
Fergie	The Black Eyed Peas, Actors from Los Angeles County, California, American movie actors, American R&B singers, American rap musicians from California, Singer-songwriters from California, American television actors, American voice actors, Bisexual Christians, LGBT musicians, 1975 births, Living people, People from Whittier, California, Bisexual people
Zuleyka Rivera Mendoza	1987 births, Living people, Puerto Rican people, Miss Universe winners
Amanda Peet	American movie actors, American television actors, Actors from New York City, 1972 births, Living people
Rupert Everett	1959 births, Living people, Actors from Norfolk, Gay men, English LGBT people, English movie actors, English stage actors, English television actors, English voice actors, LGBT actors
Shiri Maymon	1981 births, Living people, Eurovision Song Contest entrants, Israeli pop singers, Israeli singers, Jewish Israeli musicians, People from Haifa
Tom Selleck	Actors from Detroit, Michigan, American movie actors, American television actors, American television producers, American television writers, Emmy Award winning actors, Golden Globe Award winning actors, Writers from Detroit, Michigan, 1945 births, Living people
Rob Schneider	1963 births, Living people, Actors from San Francisco, American movie actors, American television actors, American television producers, American television writers, Movie directors from California, Movie producers from California, Screenwriters from California, Writers from San Francisco
Växjö	Växjö
Carolina Klüft	1983 births, Living people, 2008 Summer Olympics, Competitors in athletics, Medalists at the 2004 Summer Olympics, Olympic gold medalists, Swedish Olympians
Jonas Björkman	Swedish sportspeople, 1972 births, Living people, Tennis players
Do As Infinity	Japanese rock bands, J-pop bands
Myleene Klass	Classical musicians, English pianists, English pop musicians, English singers, English television presenters, I'm a Celebrity...Get Me Out of Here! contestants, Television personalities from Norfolk, 1978 births, Living people
Kym Marsh	1976 births, Living people, English pop singers, English television actors, Musicians from Merseyside, Reality television participants
Mackenzie Rosman	American television actors, American child actors, Actors from South Carolina, 1989 births, Living people
David Gallagher	1985 births, Living people, American television actors, Actors from New York City
Jessica Biel	1982 births, Living people, American movie actors, American television actors, Actors from Minnesota
7th Heaven	1996 American television series debuts, 2007 American television series endings, 1990s American television series, 2000s American television series, American drama television series, Television series about families, Television series set in California, WB network shows, English-language television programs, The WB original programming
Beverley Mitchell	American movie actors, American television actors, Actors from Los Angeles County, California, 1981 births, Living people
Nanne Grönvall	1962 births, Living people, Swedish singers, Songwriters, Writers from Stockholm, Singers from Stockholm
Human biology	Biology, Humans, Anthropology, Physical anthropology
Flavor Flav	African-American rappers, American rap musicians from New York, American robbers, Singers from New York, 1959 births, Living people
Schapelle Corby	1977 births, Living people, Australian criminals, Australian prisoners, Drug dealers, People convicted of drug offenses, People from Queensland
Autogenic training	Psychology
Mathematical notation	Mathematical notation
Ian Craig Marsh	1956 births, Living people, English musicians
Laboratory equipment	Laboratory equipment
Sarah Palin	1964 births, Living people, American Evangelicals, Writers from Alaska, Writers from Idaho, American journalists, American mayors, Businesspeople from Alaska, Governors of Alaska, Politicians from Idaho, United States vice-presidential candidates, 2008, US Republican Party politicians
Samvel Babayan	Living people, 1957 births, Armenian military people
Nagorno-Karabakh Defense Army	Military of Armenia
Republic of Artsakh	Nagorno-Karabakh Republic
Brandon Lee	Accidental deaths in the United States, Actors from Oakland, California, American movie actors, American television actors, 1965 births, 1992 deaths, Bruce Lee
Matt Dillon	American movie actors, Actors from New York, 1964 births, Living people
Matt Damon	Academy Award winning writers, Actors from Boston, Massachusetts, Actors from Cambridge, Massachusetts, American movie actors, American movie producers, American screenwriters, American television actors, American voice actors, Golden Globe Award winning writers, Golden Globe Award winning actors, Writers from Boston, Massachusetts, 1970 births, Living people
Robert Urich	Actors from Ohio, American movie actors, American television actors, American television producers, Cancer deaths in the United States, Emmy Award winning actors, Deaths from sarcoma, 1946 births, 2002 deaths
Vic Morrow	Accidental deaths in California, Actors from the Bronx, American movie actors, American television actors, American television directors, Aviation deaths in the United States, Movie directors from New York City, Screenwriters from New York City, 1929 births, 1982 deaths
Lal Masjid siege	2000s in Pakistan, Islamabad, 2007 in Asia
Mourning dove	Doves, Birds of North America, Birds of Pakistan
Mai Kuraki	Japanese singers, 1982 births, Living people, Musicians from Chiba Prefecture
Saint Mesrob	360 births, 440 deaths, Armenian people, Armenian language, Christian saints
Ashlee Simpson	Singers from Texas, American television actors, Actors from Texas, 1984 births, Living people, People from Waco, Texas
Airbus A340	Airbus aircraft
Autonomic nervous system	Nervous system
Peripheral nervous system	Nervous system
IKEA	Companies of Sweden, Shops, 1943 establishments in Sweden
Central nervous system	Nervous system
Spinal cord	Anatomy of the nervous system
Who Wants to Be a Millionaire?	1998 British television series debuts, 1990s television series, 2000s television series, 2010s television series, British television game shows
Danny Saucedo	1986 births, Living people, Swedish singers
Agnes Carlsson	1988 births, Living people, Swedish singers
Daniel Lindström	Swedish singers, 1978 births, Living people
Destiny's Child	1997 establishments in the United States, 2006 disestablishments in the United States, 1990s American music groups, 2000s American music groups, African-American musical groups, American girl groups, Beyoncé, Destiny's Child, Grammy Award winners, Musical groups disestablished in 2006, Musical groups established in 1997, Musical groups from Texas, Musical trios
Kelly Rowland	1981 births, Living people, Actors from Atlanta, Georgia, Actors from Houston, Texas, African American actors, African American musicians, American dancers, American movie actors, American R&B singers, American songwriters, American television actors, Destiny's Child, Grammy Award winners, Musicians from Houston, Texas, Singers from Atlanta, Georgia
Pop Idol	2001 television series debuts, 2000s British television series, ITV reality television programmes, 2001 establishments in the United Kingdom, English-language television programs
Rachel Smith	1985 births, Living people, Beauty pageant winners, People from Tennessee
Natalie Glebova	Miss Universe winners, Living people, People from Toronto, Russian models, 1981 births
Michelle Williams (singer)	1980 births, Living people, African American musicians, American R&B singers, Singers from Illinois, Strictly Come Dancing participants, Destiny's Child, People from Rockford, Illinois
Simon Cowell	American Idol, Businesspeople from London, Television personalities from Hertfordshire, Television personalities from London, 1959 births, Living people
Reality television	Reality television series
Tengwar	Middle-earth
Petros Duryan	1851 births, 1872 deaths, Armenian poets, Armenian actors
Adriana Lima	1981 births, Living people, Brazilian models, People from Salvador, Bahia
Cuban Missile Crisis	1962, 1960s in the United States, Cold War, Fidel Castro, History of the Soviet Union, John F. Kennedy, Nuclear weapons
Berber people	Berber people
Prosencephalon	Anatomy of the brain
Gag	Human sexuality
Meänkieli dialects	Uralic languages, Languages of Europe
Toni Braxton	1967 births, Living people, Actors from Maryland, African American musicians, Grammy Award winners, Musicians from Maryland, Actors from Atlanta, Georgia, Musicians from Atlanta, Georgia, Singers from Atlanta, Georgia, Singers from Maryland, Atlantic Records artists, American contemporary R&B singers
Joan Rivers	Emmy Award winners, 1933 births, 2014 deaths, Deaths from heart failure, Deaths from cardiac arrest, Deaths from respiratory arrest, Deaths from surgical complications, Actors from New York City, American Jews, Stage names, American movie actors, American stand-up comedians, American television actors, American television talk show hosts, American voice actors, Businesspeople from New York City, Comedians from New York City, Writers from New York City
Melissa Rivers	1968 births, Living people, American television presenters, Television personalities from New York City
Teri Hatcher	1964 births, Living people, American movie actors, Golden Globe Award winning actors, American television actors, Actors from Santa Clara County, California, Actresses who played Bond girls
Felicity Huffman	1962 births, Living people, American movie actors, Criminals from New York, Golden Globe Award winning actors, American television actors, Emmy Award winning actors, Actors from New York
Marcia Cross	American movie actors, Actors from Massachusetts, American television actors, Cancer survivors, 1962 births, Living people
Eva Longoria	1975 births, Living people, American movie actors, American television actors, Democrats (United States), Actors from Corpus Christi, Texas, Restaurateurs
Nicollette Sheridan	1963 births, Living people, Actors from Sussex, English movie actors, English television actors, People from West Sussex
Contiki	Operating systems
Princess Madeleine of Sweden	1982 births, Living people, Swedish royalty
Queen Silvia of Sweden	1943 births, Living people, Kings and Queens of Sweden, People from Munich, Order of Merit of the Federal Republic of Germany, Kings and Queens consort
Princess Victoria of Sweden	1977 births, Living people, Swedish royalty
Prince Carl Philip, Duke of Värmland	1979 births, Living people, Swedish royalty
Hermeskeil	Trier-Saarburg
Reinsfeld	Villages in Rhineland-Palatinate, Municipalities in Rhineland-Palatinate, Trier-Saarburg
Hunsrück	Geography of Rhineland-Palatinate, Mountain ranges of Germany
International Space Station	Space stations
Kentwood, Louisiana	Towns in Louisiana
I'm with You	Avril Lavigne songs, 2002 songs
Somersault	Gymnastics
Lisa Donovan	1980 births, Living people, Writers from New York City, Actors from New York City, Writers from Los Angeles, California, American television actors, Internet celebrities, Comedians from New York City
Augite	Minerals
Onyx	Minerals
Opal	Gemstones, Birthstones
Amethyst	Gemstones, Birthstones
Emerald	Gemstones, Birthstones
Garnet	Gemstones, Birthstones
Ralph Macchio	1961 births, Living people, American movie actors, American television actors, American voice actors, Actors from New York
French Armenian Legion	20th century in Armenia, 1916 in France
Vahan Kurkjian	Armenian historians, Armenian writers, 1863 births, 1961 deaths, Aleppo
North India	Regions of India
Yalta Conference	World War II
Potsdam Conference	1945 in Germany, Potsdam, World War II
Nahe	Geography of Rhineland-Palatinate, Rivers of Germany
Palatinate (region)	Geography of Rhineland-Palatinate, Regions of Germany
Taunus	Geography of Hesse, Mountain ranges of Germany
Antonov An-225	Civil aircraft, Soviet & Russian aircraft
Edmund Burke	1729 births, 1797 deaths, Irish philosophers, Irish politicians, British politicians, People from Dublin
Muslim occasions	Religious holidays, Islam
Guys and Dolls	Broadway musicals, 1950s musicals
Ichiro Mizuki	Actors from Tokyo, Singers from Tokyo, Japanese songwriters, Japanese voice actors, 1948 births, Living people
Saalburg	Buildings and structures in Hesse, History of Germany
Kesha Wizzart	1988 births, 2007 crimes, 2007 deaths, Black English musicians, British child singers, English murder victims, Musicians from Manchester, People murdered in England
Names for small numbers	Numbers
Military of ancient Rome	Ancient Rome
Roman legion	Ancient Rome
Alpha helix	Biochemistry
Allied-occupied Germany	1949 disestablishments, 1945 establishments in Germany, 1940s disestablishments in Germany
Topaz	Gemstones, Birthstones
Beautiful (song)	2002 songs, Christina Aguilera songs
Fundamental theorem of algebra	Mathematics
R.E.M. (band)	1980s American music groups, 1980 establishments in the United States, 1990s American music groups, 2000s American music groups, 2010s American music groups, 2011 disestablishments in the United States, American rock bands, Brit Award winners, Grammy Award winners, Musical groups disestablished in 2011, Musical groups established in 1980, Musical groups from Georgia (U.S. state), Warner Bros. Records artists
Israel	Israel, 1948 establishments
Lake Champlain	Lakes of the United States, Lakes of Canada, Geography of Vermont, Geography of New York, Geography of Quebec, Biosphere reserves
Fumie Suguri	Japanese figure skaters, 1980 births, Living people, People from Kanagawa Prefecture
Occupational Safety and Health Administration	United States government agencies, United States Department of Labor, Medical and health organizations in the United States, 1970 establishments in the United States
Arsenio Hall	Actors from Cleveland, Ohio, African American actors, African American comedians, African American television personalities, American movie actors, American television actors, Comedians from Ohio, Television personalities from Ohio, 1956 births, Living people
Bezenye	Villages in Hungary
Royal Proclamation of 1763	1760s in the Thirteen Colonies, 1763, Resistance to the British Empire, 1760s in the Kingdom of Great Britain
Inkscape	Free software, Graphics software

