Collingwood, Victoria	Melbourne
George M. Dallas	1792 births, 1864 deaths, United States senators from Pennsylvania, Vice Presidents of the United States, Politicians from Philadelphia, Pennsylvania, 19th-century American politicians
William R. King	1786 births, 1853 deaths, Vice Presidents of the United States, United States senators from Alabama, Politicians from North Carolina, Presidents pro tempore of the United States Senate, Deans of the United States Senate, 19th-century American politicians
Harnett County, North Carolina	North Carolina counties, 1850s establishments in North Carolina, 1855 establishments in the United States
Chatham County, North Carolina	North Carolina counties, 1771 establishments, 1770s establishments in North Carolina
Carteret County, North Carolina	Carteret County, North Carolina, 1739 establishments, 1730s establishments in North Carolina
Doctor (Doctor Who)	Doctor Who characters
Roger Penrose	1931 births, Living people, Academics of the University of Oxford, Alumni of the University of Cambridge, Alumni of University College London, British Nobel Prize winners, English mathematicians, English physicists, English science writers, Fellows of the Royal Society, Jewish British academics, Jewish British scientists, Jewish Nobel Prize winners, Jewish Wolf Prize winners, Order of Merit, People from Essex, Theoretical physicists
Arthur (TV series)	1996 American television series debuts, 1990s American television series, 2000s American television series, 2010s American television series, American children's television series, Emmy Award winning programs, PBS Kids shows, Arthur (TV series), English-language television programs
Langur	Old World monkeys, Mammals of Asia, National symbols of India
WWE Raw	1993 American television series debuts, American television series, WWE Raw, English-language television programs
Doctor Who companions	Doctor Who characters
Moomba	Festivals, Melbourne, Australian culture
Astrid Peth	Doctor Who characters
Barbara Wright (Doctor Who)	Doctor Who characters
Grace Holloway	Doctor Who characters
Ian Chesterton	Doctor Who characters
Susan Foreman	Doctor Who characters
Ludwig Wittgenstein	1889 births, 1951 deaths, 20th century philosophers, Cancer deaths in England, Deaths from prostate cancer, Gay men, LGBT writers, Writers from Vienna
Wittgenstein (disambiguation)	Surnames
Adam Mitchell	Doctor Who characters
Vislor Turlough	Doctor Who characters
Kamelion	Doctor Who characters
Peri Brown	Doctor Who characters
Mickey Smith	Doctor Who characters
John C. Breckinridge	1821 births, 1875 deaths, American esotericists, American lawyers, Confederate Army generals, Deaths from cirrhosis, Freemasons, People from Lexington, Kentucky, United States representatives from Kentucky, United States senators from Kentucky, US Democratic Party politicians, 19th-century American politicians
Michael Dante DiMartino	Year of birth missing (living people), Living people, American animators, American editors
Barbara Meier	1986 births, Living people, People from Bavaria, German models
Bryan Konietzko	1975 births, Living people, Animators
Hannibal Hamlin	1809 births, 1891 deaths, Ambassadors of the United States, American lawyers, Governors of Maine, United States representatives from Maine, United States senators from Maine, US Democratic Party politicians, US Republican Party politicians, People from Bangor, Maine, 19th-century American politicians
Busan subway	Busan, Rapid transit systems, Transport in South Korea, 1985 establishments in Asia, 1980s establishments in South Korea
Tsing Hua University	Colleges and universities in Beijing, Technical colleges and universities in Asia, 1911 establishments
Yui Horie	Japanese singers, 1976 births, Living people, Actors from Tokyo, Japanese voice actors
Bathymetry	Cartography, Oceanography
Cave painting	Painting, Caves, Ancient history, Stone Age
Radiocarbon dating	Archaeology, Carbon, Radiometric dating
Passage tomb	Prehistoric buildings and structures, Burial monuments and structures
Hallstatt culture	Ancient history, Archaeological sites in Europe, Austrian culture
La Tène culture	Ancient history
Ringfort	Buildings and structures in the Middle Ages, Fortification
Beowulf	Germanic mythology, Epic poems
Melanie Bush	Doctor Who characters
Ace (Doctor Who)	Doctor Who characters
Romana (Doctor Who)	Doctor Who characters
K-9 (Doctor Who)	Doctor Who characters
Adric	Doctor Who characters
Tegan Jovanka	Doctor Who characters
Leela (Doctor Who)	Doctor Who characters
Stigma (botany)	Flowers, Plant anatomy
Empress Dowager Cixi	1835 births, 1908 deaths, Emperors and Empresses of China
Human trafficking	Organized crime, Slavery
Controversy	Controversies
Deutscher Gewerkschaftsbund	Trade unions in Germany
The Best Damn Thing (song)	2007 songs, Avril Lavigne songs
Vereinte Dienstleistungsgewerkschaft	Trade unions in Germany
Deutscher Beamtenbund	Trade unions in Germany
Gewerkschaft Deutscher Lokomotivführer	Trade unions in Germany
TRANSNET Gewerkschaft	Trade unions in Germany
Can-can	Dances, French culture, American movies
Jacques Offenbach	1819 births, 1880 deaths, French composers
Shane MacDougall	Canadian comedians, Living people, Year of birth missing (living people)
Henri de Toulouse-Lautrec	1864 births, 1901 deaths, French painters, French printmakers, Infectious disease deaths in France, People from Occitanie
Alleghany County, North Carolina	Alleghany County, North Carolina, 1859 establishments in North Carolina
Sparta, North Carolina	Towns in North Carolina, Alleghany County, North Carolina, County seats in North Carolina
Anson County, North Carolina	Anson County, North Carolina, 1750 establishments, 1750s establishments in North Carolina
Wadesboro, North Carolina	Anson County, North Carolina, Towns in North Carolina, County seats in North Carolina
Alexander County, North Carolina	North Carolina counties, 1847 establishments in the United States, 1840s establishments in North Carolina
Ashe County, North Carolina	North Carolina counties, 1799 establishments in the United States, 1790s establishments in North Carolina
Long March	1934, 1935, 1930s in China
Avery County, North Carolina	North Carolina counties, 1911 establishments in the United States, 20th-century establishments in North Carolina
Hersfeld-Rotenburg	Districts of Hesse, Kassel (district)
Rings of Rhea	Saturn's moons
Werra-Meißner-Kreis	Districts of Hesse, Kassel (district)
Waldeck-Frankenberg	Districts of Hesse, Kassel (district)
Schwalm-Eder-Kreis	Districts of Hesse, Kassel (district)
Velvet Revolver	2002 establishments in the United States, 2000s American music groups, 2000s establishments in California, American hard rock bands, Grammy Award winners, Musical groups established in 2002, Musical groups from California, Orange County, California
Manchu	Ethnic groups in China
Kristanna Loken	1979 births, Living people, Actors from New York, LGBT people from New York, Models from New York, American movie actors, American television actors, Bisexual people, LGBT actors, LGBT models
Geneva	Geneva, Municipalities of Geneva
Concubinage	Marriage
Mistress (lover)	Adultery
List of counties in Wisconsin	Wisconsin counties, Lists of counties of the United States
Eastern Front (World War I)	World War I
Gibbon	Apes
Same-sex marriage	Same-sex marriage
Chiron (hypothetical moon)	Saturn's moons
Dual monarchy	Monarchy
Carl von Moers	1871 births, 1957 deaths, Equestrians, German Olympic silver medalists, German sportspeople, Sportspeople from Rhineland-Palatinate
Burnham Grammar School	1960 establishments in the United Kingdom, 1960s establishments in England, Grammar schools in England, Schools in Buckinghamshire
Avant-garde	Philosophy, Art
Dumb Luck	2001 movies, American independent movies
Gil Fates	1914 births, 2000 deaths, American television producers, American stage actors, American game show hosts, American television directors, American television writers, Businesspeople from Newark, New Jersey, Screenwriters from New Jersey
Innovation	Innovation, Science
Santieh River	Rivers of Taiwan
Scott S. Sheppard	Living people, Year of birth missing (living people), American astronomers
List of rivers of Taiwan	Rivers of Taiwan, Lists of rivers of Asia, Lists of rivers by country
List of mountains in Taiwan	Mountains of Asia, Geography of Taiwan, Geography-related lists
Mario Kart DS	2005 video games, Mario Kart games, Nintendo DS games, Nintendo DS-only games
Metacritic	Entertainment websites
Marktbreit	Towns in Bavaria, Kitzingen Rural District
Eclipse	Astronomical phenomena, Eclipses
Lena Gercke	German models, 1988 births, Living people
Twilight (series)	21st century American novels, Romance novels, Series of books, Vampire novels, Young adult novels
Karl Popper	1902 births, 1994 deaths, 20th century philosophers, Austrian educators, Austrian Jews, Austrian scientists, Austrian writers, British philosophers, Companions of Honour, Fellows of the Royal Society, Jewish British academics, Jewish British scientists, Jewish British writers, Jewish philosophers, Knights Bachelor, Naturalised citizens of the United Kingdom, Refugees from Nazism, Scientists from Vienna, Teachers
Eliot Spitzer	Governors of New York, US Democratic Party politicians, 1959 births, Living people
Arena, Wisconsin	Villages in Wisconsin, Iowa County, Wisconsin
List of rivers of Wisconsin	Lists of rivers of the United States, Rivers of Wisconsin
List of rivers of Africa	Lists of rivers of Africa
Community Identification Number	Geocodes, Law
List of rivers of Alabama	Lists of rivers of the United States, Rivers of Alabama
List of rivers of Alaska	Lists of rivers of the United States, Rivers of Alaska, Alaska-related lists
List of rivers of Arizona	Lists of rivers of the United States, Rivers of Arizona, Arizona-related lists
List of rivers of Arkansas	Lists of rivers of the United States, Rivers of Arkansas, Arkansas-related lists
List of rivers of California	Lists of rivers of the United States, Rivers of California, California-related lists
Hexadecimal	Numbers
List of rivers of Colorado	Lists of rivers of the United States, Rivers of Colorado
List of rivers of Albania	Geography of Albania, Lists of rivers by country, Lists of rivers of Europe
List of rivers of Antarctica	Lists of rivers by continent, Rivers of Antarctica
Battle of Tannenberg (1914)	1914 in Europe, 20th century in Poland, Battles involving Germany, Battles involving Russia, Battles of World War I
List of rivers of Argentina	Lists of rivers by country, Rivers of Argentina, Lists of rivers of South America
List of rivers of Asia	Lists of rivers of Asia
List of rivers of Assam	Lists of rivers of Asia, Rivers of Assam, India-related lists
List of rivers of Australia	Lists of rivers by country, Lists of rivers of Oceania, Rivers of Australia, Australia-related lists
Erich Ludendorff	1865 births, 1937 deaths, German generals, German military personnel of World War I
List of rivers of Austria	Rivers of Austria, Lists of rivers by country, Lists of rivers of Europe
List of rivers of Bangladesh	Rivers of Bangladesh, Lists of rivers by country, Lists of rivers of Asia
List of rivers of Delaware	Lists of rivers of the United States, Rivers of Delaware, Delaware-related lists
List of rivers of Florida	Lists of rivers of the United States, Rivers of Florida, Florida-related lists
Austro-Hungarian Compromise of 1867	19th century in Austria, History of Hungary, 1867, Austria-Hungary
Franz Joseph I of Austria	1830 births, 1916 deaths, Austrian people, Emperors and empresses, Kings and queens
Cantuta	Solanales
Mie Prefecture	Mie Prefecture, Prefectures of Japan
WWE Studios	WWE
776 Berbericia	Asteroids
Chris Benoit	Canadian professional wrestlers, Former WWE wrestlers, Murderers who committed suicide, Murder-suicides in the United States, Sportspeople from Montreal, Sportspeople who committed suicide, Suicides by hanging in the United States, 1967 births, 2007 deaths
Glitch	Computing
Jack (Tekken)	Tekken characters
My Little Lover	Japanese rock bands, Pop music groups
Beaufort County, North Carolina	North Carolina counties, 1730s establishments in North Carolina, 1739 establishments
Bertie County, North Carolina	North Carolina counties, 1722 establishments, 1720s establishments in the Thirteen Colonies, 18th-century establishments in North Carolina
Bladen County, North Carolina	North Carolina counties, 1734 establishments, 1730s establishments in North Carolina
Brunswick County, North Carolina	North Carolina counties, 1764 establishments in the Thirteen Colonies, 1760s establishments in North Carolina
Buncombe County, North Carolina	North Carolina counties, 1791 establishments in the United States, 1790s establishments in North Carolina
List of rivers of Georgia (U.S. state)	Lists of rivers of the United States, Rivers of Georgia (U.S. state)
List of rivers of Hawaii	Rivers of Hawaii, Lists of rivers of the United States, Hawaii-related lists
Alph River	Rivers of Antarctica
Escapology	Entertainment
Burke County, North Carolina	North Carolina counties, 1777 establishments in North Carolina
Rezovski Creek	Rivers of Antarctica
Raidió Teilifís Éireann	Television networks, Radio, Republic of Ireland, 1926 establishments in Europe
Onyx River	Rivers of Antarctica
Wailua River	Rivers of Hawaii
Waimea River (Hawaii)	Rivers of Hawaii
Cabarrus County, North Carolina	North Carolina counties, 1792 establishments in the United States, 1790s establishments in North Carolina
ZX Spectrum	Computer science, Computers, Video game consoles
Home computer	Electronics, Computer science, Home appliances
Z80	Computer processors, Computer science
Caldwell County, North Carolina	North Carolina counties, 1840s establishments in North Carolina, 1841 establishments in the United States
Sinclair Research Ltd	Electronics companies, Computer science
Kane (wrestler)	1967 births, Actors from Tennessee, American movie actors, American professional wrestlers, Living people, Sportspeople from Tennessee, WWE wrestlers, Libertarians
Hipparchus	190 BC births, 120 BC deaths, Ancient Greek astronomers, Greek geographers
Battle of Verdun	Battles of the Western Front (World War I), 1916 in France
Bank of America Tower	Skyscrapers in New York City, 2003 establishments in the United States, 2000s establishments in New York (state), Buildings and structures in Manhattan
The New York Times Building	Skyscrapers in New York City, 2007 establishments in the United States, 2000s establishments in New York (state), Buildings and structures in Manhattan
GameShark	Video game technology
70 Pine Street	Skyscrapers in New York City, 1932 establishments in North America, 1930s establishments in New York (state), Buildings and structures in Manhattan, New York City Designated Landmarks
King penguin	Penguins, Animals of Antarctica
Citigroup Center	Skyscrapers in New York City, 1977 establishments in the United States, 1970s establishments in New York (state), Buildings and structures in Manhattan, New York City Designated Landmarks
Industrial engineering	Engineering
Trump World Tower	Skyscrapers in New York City, Donald Trump, 2001 establishments in the United States, 2000s establishments in New York (state), Buildings and structures in Manhattan
30 Rockefeller Plaza	Skyscrapers in New York City, 1933 establishments in the United States, 1930s establishments in New York (state), Buildings and structures in Manhattan, New York City Designated Landmarks
Roger Taney	1777 births, 1864 deaths, Chief Justices of the United States, People from Maryland, United States Attorneys General
Supreme court	National supreme courts, International law
Lee Chaolan	Tekken characters
Scooter	Land vehicles, Cycling
Tricycle	Human-powered vehicles, Cycling, Motorcycles
ECW World Heavyweight Championship	World Wrestling Entertainment championships
List of rivers of China	Lists of rivers of Asia, Rivers of China
List of rivers of Idaho	Lists of rivers of the United States, Rivers of Idaho, Idaho-related lists
List of rivers of Illinois	Lists of rivers of the United States, Rivers of Illinois
List of rivers of Indiana	Lists of rivers of the United States, Rivers of Indiana
The Golden Compass (movie)	2007 movies, 2000s fantasy movies, British fantasy movies, American fantasy movies, English-language movies, Movies based on books
Independent body	Public services
Limbourg brothers	Dutch painters, Nijmegen, Renaissance
Anthony Head	1954 births, Living people, English movie actors, Musical theater actors, English television actors, English voice actors, Whedonverse
Uluru	Mountains of the Northern Territory, World Heritage Sites in Australia, Pitjantjatjara
Elapid	Elapidae
Colubrid	Colubrids
Central Finland	Regions of Finland
Sea snake	Elapidae
Archduke	Nobility, Austria, Titles, Holy Roman Empire
Trench warfare	War
Port-de-Paix	Cities in Haiti
Device controller	Computer science, Electronics
Rostov-on-Don	Capital cities in Russia, 1749 establishments, 18th century establishments in Russia
Staples Center	Sports buildings in Los Angeles, California, WrestleMania host
Camden County, North Carolina	North Carolina counties, 1777 establishments in North Carolina
Caswell County, North Carolina	North Carolina counties, 1777 establishments in North Carolina
Internet forum	Internet communication
Catawba County, North Carolina	North Carolina counties, 1842 establishments in the United States, 1840s establishments in North Carolina
Stone tool	Stone Age
DJ BoBo	1968 births, Living people, DJs, Swiss entertainers, Swiss singers, Songwriters, Dancers
Cherokee County, North Carolina	North Carolina counties, 1839 establishments in the United States, 1830s establishments in North Carolina
Chowan County, North Carolina	North Carolina counties, 1739 establishments, 1730s establishments in North Carolina
Clay County, North Carolina	North Carolina counties, 19th-century establishments in North Carolina, 1861 establishments in the United States
Character (computing)	Computer science, Typography, Encodings
Optical disc drive	Computer science, Machines, Electronics
WWE Heat	World Wrestling Entertainment television programs, 1998 American television series debuts, 2008 American television series endings
Sarojini Sahoo	Indian writers, 1956 births, Living people
Eddie Guerrero	1967 births, 2005 deaths, American professional wrestlers, Deaths from myocardial infarction, Former WWE wrestlers, Sportspeople from El Paso, Texas, WWE Hall of Fame
Nabta Playa	Prehistoric buildings and structures, Archaeological sites in Egypt, Ancient Egypt
Video card	Computer graphics
Barahona, Dominican Republic	Settlements in Dominican Republic, 1802 establishments in North America, 19th-century establishments in the Spanish West Indies
Jamie McCrimmon	Doctor Who characters
Victoria Waterfield	Doctor Who characters
Zoe Heriot	Doctor Who characters
Sindh	Sindh, Provinces of Pakistan
Khyber Pakhtunkhwa	Khyber Pakhtunkhwa, 1972 establishments in Asia, Provinces of Pakistan
Balochistan (Pakistan)	Balochistan (Pakistan), Provinces of Pakistan
Italian Campaign (World War I)	Battles of World War I, 1910s in Italy, 20th century in Austria, 20th century in Hungary, 1915 in Europe, 1916 in Europe, 1917 in Europe, 1918 in Europe
Choudhary Rahmat Ali	1897 births, 1951 deaths, Pakistani culture, Pakistani politicians, Punjabi people
Abbottabad	Hill Stations in Pakistan, Abbottabad, 1863 establishments, 1860s establishments in Pakistan
Abbottabad District	Abbottabad District, Districts of British India
Bannu District	Districts of Khyber Pakhtunkhwa
Battagram District	Districts of Khyber Pakhtunkhwa
Buner District	Districts of Khyber Pakhtunkhwa
Charsadda District	Districts of Khyber Pakhtunkhwa
Dera Ismail Khan District	Districts of British India, Districts of Khyber Pakhtunkhwa
Hangu District	Districts of Khyber Pakhtunkhwa
Haripur District	Districts of Khyber Pakhtunkhwa
Karak District	Districts of Khyber Pakhtunkhwa
Kohat District	Districts of British India, Districts of Khyber Pakhtunkhwa
Kohistan District, Pakistan	Districts of Khyber Pakhtunkhwa
Lakki Marwat District	Districts of Pakistan
Lower Dir District	Lower Dir District
Malakand District	Districts of Khyber Pakhtunkhwa
Mansehra District	Districts of Khyber Pakhtunkhwa
Mardan District	Mardan District
Nowshera District	Districts of Khyber Pakhtunkhwa
Peshawar District	Districts of British India, Districts of Khyber Pakhtunkhwa
Shangla District	Shangla District
Middle Eastern theatre of World War I	Middle East, World War I
Swabi District	Districts of Khyber Pakhtunkhwa
Swat District	Districts of British India, Districts of Khyber Pakhtunkhwa
Tank District	Districts of Khyber Pakhtunkhwa
Upper Dir District	Districts of Khyber Pakhtunkhwa
Bannu	Cities in Pakistan
Battagram	Cities in Pakistan
Charsadda	Cities in Pakistan
Chitral District	Districts of Khyber Pakhtunkhwa, Regions of Pakistan
Dera Ismail Khan	Cities in Pakistan
Hangu (Pakistan)	Cities in Pakistan
Haripur, Pakistan	Cities in Pakistan
Karak, Pakistan	Cities in Pakistan
Kohat	Cities in Pakistan
Lakki Marwat	Cities in Pakistan
Mansehra	Cities in Pakistan
Mardan	Cities in Pakistan, Mardan District
Nowshera	Cities in Pakistan
Alpuri	Settlements in Shangla District, Cities in Pakistan
Saidu Sharif	Cities in Pakistan
Tank, Pakistan	Cities in Pakistan
Theatre (warfare)	War
Charlotte Perrelli	1974 births, Living people, Swedish singers, Eurovision Song Contest winners, Eurovision Song Contest entrants
Attock District	Districts of Punjab (Pakistan), Rawalpindi Division
Bahawalnagar District	Districts of Punjab (Pakistan), Bahawalpur Division
Bahawalpur District	Bahawalpur Division
Bhakkar District	Districts of Punjab (Pakistan), Sargodha Division
Chakwal District	Chakwal District, Rawalpindi Division
Dera Ghazi Khan District	Districts of British India, Districts of Punjab (Pakistan), Dera Ghazi Khan Division
Faisalabad District	Districts of British India, Districts of Punjab (Pakistan), Faisalabad Division
Gujranwala District	Districts of British India, Districts of Punjab (Pakistan), Gujranwala Division
Gujrat District	Districts of British India, Districts of Punjab (Pakistan), Gujranwala Division
Hafizabad District	Gujranwala Division
Jhang District	Districts of Punjab (Pakistan), Faisalabad Division
Jhelum District	Rawalpindi Division
Kasur District	Lahore Division
Khanewal District	Districts of Punjab (Pakistan), Multan Division
Khushab District	Districts of Punjab (Pakistan), Sargodha Division
Lahore District	Districts of British India, Districts of Punjab (Pakistan), Lahore Division
Layyah District	Districts of Punjab (Pakistan), Dera Ghazi Khan Division
Lodhran District	Districts of Punjab (Pakistan), Multan Division
Mandi Bahauddin District	Gujranwala Division
Mianwali District	Districts of British India, Districts of Punjab (Pakistan), Sargodha Division
Multan District	Districts of British India, Districts of Punjab (Pakistan), Multan Division
Muzaffargarh District	Districts of British India, Districts of Punjab (Pakistan), Dera Ghazi Khan Division
Nankana Sahib District	Lahore Division
Narowal District	Gujranwala Division
Okara District	Districts of Punjab (Pakistan), Sahiwal Division
Taito Corporation	Video game companies, Electronics companies
Pakpattan District	Sahiwal Division
Rahimyar Khan District	Districts of Punjab (Pakistan), Bahawalpur Division
Space Invaders	Arcade games
Rajanpur District	Districts of Punjab (Pakistan), Dera Ghazi Khan Division
Rawalpindi District	Districts of British India, Rawalpindi District, Rawalpindi Division
Sahiwal District	Districts of British India, Sahiwal Division
Sargodha District	Districts of British India, Districts of Punjab (Pakistan), Sargodha Division
Sialkot District	Districts of British India, Districts of Punjab (Pakistan), Gujranwala Division
Toba Tek Singh District	Districts of Punjab (Pakistan), Faisalabad Division
Vehari District	Districts of Punjab (Pakistan), Multan Division
Attock	Cities in Pakistan
Bahawalnagar	Cities in Pakistan
Bahawalpur	Cities in Pakistan
Bhakkar	Cities in Pakistan
Chakwal	Cities in Pakistan
Dera Ghazi Khan	Cities in Pakistan
Faisalabad	Cities in Pakistan
Union councils of Pakistan	Union Councils of Pakistan, Local government of Pakistan
Seer Gharbi	Union Councils of Abbottabad District
Tranmere Rovers F.C.	1884 establishments in England, Birkenhead, English football clubs
Corumbá	Cities in Mato Grosso do Sul
Christopher Lee	1922 births, 2015 deaths, Actors from London, Actors who played Bond villains, Deaths from heart failure, Deaths from respiratory failure, English movie actors, English radio actors, English stage actors, English television actors, English voice actors, Singers from London, Writers from London
Liv Tyler	1977 births, Living people, Actors from Maine, Actors from Manhattan, American movie actors, Models from Manhattan
Dourados	Cities in Mato Grosso do Sul
Carlo Gesualdo	1566 births, 1613 deaths, Renaissance composers, Italian composers, Murderers, Lutenists
AdventureQuest	Online games, Role-playing video games
Conflict	Conflicts, War
Constructed script	Writing systems
An Inspector Calls	British plays
Justice and Equality Movement	Darfur conflict, Rebel militia groups in Africa
Holden (disambiguation)	Surnames
Languages constructed by J. R. R. Tolkien	Middle-earth, Constructed languages
Lope de Vega	1562 births, 1635 deaths, Spanish poets, Playwrights
Pedro Calderòn de la Barca	1600 births, 1681 deaths, Spanish writers
Chemical vapor deposition	Technology, Chemical processes
States of Sudan	States of Sudan
WrestleMania XXIV	WrestleMania, 2008 in professional wrestling, Sports in Orlando, Florida, 2008 in American television, 2000s in Orlando, Florida, 2008 in Florida
Nazim	Pakistani people
Dogon people	Ethnic groups in Africa, Malian people
Ipswich	Hanseatic League, Ipswich, Port cities and towns of the North Sea, Port cities and towns of England, County towns in England
Self-esteem	Psychology
Freetown Christiania	Buildings and structures in Denmark, Politics of Denmark
I'm Not There	2000s biographical movies, 2007 drama movies, American biographical movies, American drama movies, English-language movies, Golden Globe Award winning movies, American independent movies
Lanthanide	Chemistry
The New Zealand Story	1988 video games, Arcade games, Commodore 64 games, Nintendo DS games, Nintendo Entertainment System games
Ungdomshuset	Buildings and structures in Denmark, Copenhagen, Political movements, 1897 establishments in Europe, 19th century establishments in Denmark, 2007 disestablishments in Europe, 2000s disestablishments in Denmark
Bagh, Khyber Pakhtunkhwa	Union Councils of Abbottabad District
Tehsil	Local government of Pakistan, Local government in India
Baekdu Mountain	Biosphere reserves, Volcanoes of Asia, Mountains of China, Geography of Korea
Pakistan Standard Time	Time zones
Dhamtour	Union Councils of Abbottabad District
Kate Beckinsale	1973 births, Living people, Actors from London, English movie actors, English television actors, People from Chiswick
Printed circuit board	Electronics, Manufacturing
Pantera	1981 establishments in the United States, 1980s American music groups, 1990s American music groups, 2000s American music groups, American heavy metal bands, American hard rock bands, Arlington, Texas, Groove metal bands, 2003 disestablishments in the United States, Musical groups established in 1981, Musical groups from Texas, Thrash metal bands, 1980s establishments in Texas, 21st-century disestablishments in Texas
Pan's Labyrinth	2006 movies, 2000s fantasy movies, Hugo Award winning movies, Movies set in the 1940s, Spanish movies, Mexican movies, American fantasy movies, French movies, Movies directed by Guillermo del Toro, Movies set in Spain
List of rivers of Iowa	Lists of rivers of the United States, Rivers of Iowa
Transubstantiation	Christian theology
Children of Bodom	Heavy metal bands, Finnish musical groups, Espoo, Musical groups established in 1993, 1993 establishments in Europe, 20th century establishments in Finland
Near-Earth asteroid	Asteroids
Abbottabad Central	Union Councils of Abbottabad District, Abbottabad
Subahdar	Pakistan
Cherbourg-Octeville	Communes in Manche, Former communes in France, Subprefectures in France
3 Inches of Blood	Canadian heavy metal bands, Canadian thrash metal bands, Power metal bands, Speed metal bands, People from British Columbia, Musical groups established in 2000, 2000s establishments in Canada, Musical groups disestablished in 2015, 2015 disestablishments in Canada
List of rivers of Kansas	Lists of rivers of the United States, Rivers of Kansas, Kansas-related lists
List of rivers of Kentucky	Lists of rivers of the United States, Rivers of Kentucky
List of rivers of Louisiana	Lists of rivers of the United States, Rivers of Louisiana
List of rivers of Maine	Lists of rivers of the United States, Geography of Maine
Federal Council (Switzerland)	Politics of Switzerland
Bengal	Geography of Bangladesh, Geography of India, Divided regions
World Wrestling Entertainment programs	World Wrestling Entertainment television programs, World Wrestling Entertainment pay-per-view events
Borat	2006 comedy movies, 20th Century Fox movies, American comedy movies, British comedy movies, English-language movies, Mockumentaries, Movies based on TV series, Movies set in Asia, Movies set in Atlanta, Georgia, Movies set in Alabama, Movies set in Texas, Movies set in Los Angeles, California, Movies set in New York City, Movies set in Washington, D.C.
Miley Stewart	Disney characters, Fictional American people, Fictional characters introduced in the 2000s
Nazareth	Bible, Ancient Israel and Judah, Nazareth
Scanlation	Manga
KolibriOS	Operating systems
Obergösgen	Municipalities of the canton of Solothurn
Oekingen	Municipalities of the canton of Solothurn
Oensingen	Municipalities of the canton of Solothurn
Olten	Cities in Switzerland, Municipalities of the canton of Solothurn
O. J. Simpson	Actors from San Francisco, African American actors, African American players of American football, American burglars, American kidnappers, American movie actors, American people convicted of assault, American prisoners, American robbers, American television producers, Buffalo Bills players, People acquitted of murder, San Francisco 49ers players, Sportspeople from San Francisco, 1947 births, Living people, Heisman Trophy winners
Woody Guthrie	Deaths from neurodegenerative disease, American folk musicians, American singer-songwriters, American guitarists, Industrial Workers of the World, Musicians from Oklahoma, 1912 births, 1967 deaths
Seer Sharqi Bhattian	Union Councils of Abbottabad District
Bagnotar	Union Councils of Abbottabad District
Clinton, Oneida County, New York	Villages in New York
List of counties in Mississippi	Mississippi counties, Lists of counties of the United States
Charleston, South Carolina	Charleston, South Carolina, Former United States state capitals, County seats in South Carolina
Taunton, Massachusetts	Cities in Massachusetts, County seats in Massachusetts, 1637 establishments, 1630s establishments in Massachusetts
Gerhard Ertl	1936 births, Living people, German academics, German Nobel Prize winners, German physicists, People from Stuttgart, Wolf Prize winners
Francesco Hayez	1791 births, 1882 deaths, Italian painters, People from Venice
John William Waterhouse	1849 births, 1917 deaths, English painters, Artists from London, People from Rome, Royal Academicians
Toontown	Disney
Semantic Web	Internet
Langlade County, Wisconsin	Langlade County, Wisconsin, 1879 establishments in the United States, 1870s establishments in Wisconsin
Adams County, Wisconsin	Adams County, Wisconsin, 1853 establishments in the United States, 1850s establishments in Wisconsin
Ligaria cuneifolia	Santalales
Hypersonic	Fluid mechanics
Great Langton	Villages in North Yorkshire
Leonid Hurwicz	1917 births, 2008 deaths, American economists, American Nobel Prize winners, Deaths from renal failure, Holocaust survivors, Jewish American academics, Jewish American scientists, Jewish Nobel Prize winners, Naturalized citizens of the United States, People from Moscow, Polish Jews, Refugees from Nazism, Russian Jews, Scientists from Minneapolis, Minnesota, Soviet Jews
Virtual private network	Internet
Dial-up	Internet, Telecommunications
IPass	Internet
Shai Hulud (band)	American heavy metal bands, American punk bands, progressive metal bands, Metalcore bands, Musical groups from Florida
Lloyds Bank	1765 establishments, Banks of the United Kingdom
Gresham Street	Roads in London
Thomas Gresham	1510s births, 1579 deaths, People from London
List of Renaissance artists	Renaissance, Artists, Lists of people
Rose Bowl Game	College football, Pasadena, California, 1902 establishments in the United States, 1900s establishments in California, January events
Fiesta Bowl	College football, Sports in Phoenix, Arizona, 1971 establishments in the United States
Sugar Bowl	College football
Uffizi	Buildings and structures in Florence, Art museums in Italy, Renaissance
Whitehall	City of Westminster, Roads in London
Dawlish Warren	Villages in Devon
Fuchsia	Myrtales
Joseba Sarrionandia	1958 births, Living people, Spanish writers
SpongeBob SquarePants (character)	Animated characters, Fictional characters introduced in 1999, SpongeBob SquarePants characters
Lorenzo Milani	1923 births, 1967 deaths, Italian Roman Catholics
Ariel Rubinstein	1951 births, Living people, Economists, Israeli academics, Israeli Jews, Israeli scientists, Jewish academics, Jewish scientists, People from Jerusalem
Mosaic	Art, Architecture
Odilon Redon	1840 births, 1916 deaths, French painters, French printmakers, People from Bordeaux
Pinniped	Pinnipeds
Wizards of Waverly Place	2007 television series debuts, English-language television programs
Cory in the House	2007 television series debuts, Children's television series, Television series by Disney, English-language television programs
John A. Macdonald	1815 births, 1891 deaths, Politicians from Glasgow, Premiers of Ontario, Privy Councillors (Canada), Privy Councillors (UK), Knights Commander of the Order of St Michael and St George, Knights Grand Cross of the Order of the Bath, Leaders of the Opposition (Canada), Canadian Queen's Counsel
Justice League	Justice League
Even Stevens	2000 television series debuts, Television series by Disney, English-language television programs
Trojan asteroid	Trojan asteroids
Christopher Lloyd	1938 births, Living people, Actors from Stamford, Connecticut, American movie actors, American stage actors, American television actors, American voice actors, Emmy Award winning actors
The Buzz on Maggie	2005 television series debuts, 2010 television series endings, Animated television series, Television series by Disney, English-language television programs
Green Arrow	DC Comics superheroes
Aquaman	DC Comics superheroes, DC Comics adapted into movies, Fictional characters introduced in 1941, Justice League
Green Lantern	DC Comics superheroes, DC Comics adapted into movies
August Kopff	1882 births, 1960 deaths, German astronomers
Great Yarmouth	Towns in Norfolk, Ports and harbours of the United Kingdom
S/2004 S 3	Saturn's moons
S/2004 S 4	Saturn's moons
S/2004 S 6	Saturn's moons
Joel Hastings Metcalf	1866 births, 1925 deaths, American astronomers, Scientists from Massachusetts, Scientists from Vermont
Imaginary number	Number theory
Eric Maskin	1950 births, Living people, American economists, American Nobel Prize winners, Harvard University alumni, Harvard University faculty, Jewish American academics, Jewish American scientists, Jewish Nobel Prize winners, Scientists from New York City
Roger Myerson	1951 births, Living people, American economists, American Nobel Prize winners, American political scientists, Harvard University alumni, Jewish American academics, Jewish American scientists, Jewish Nobel Prize winners, Scientists from Boston, Massachusetts
Mario Capecchi	1937 births, Living people, American academics, American geneticists, American Nobel Prize winners, Harvard University alumni, Naturalized citizens of the United States, People from Verona, Wolf Prize winners, Italian Nobel Prize winners
Wizard	Magic (paranormal)
Kaunas	Cities in Lithuania
Warp drive	Star Trek
Christian Heinrich Friedrich Peters	American astronomers, German astronomers, 1813 births, 1890 deaths
Soest, Germany	Towns in North Rhine-Westphalia, Soest Rural District
History of Europe	History of Europe
World Games	World Games
Peace of Westphalia	1648, Diplomacy, Treaties, Eighty Years' War, Thirty Years' War, 1640s in Europe, Holy Roman Empire, Münster, Osnabrück, Protestant Reformation, May events, October events
Flanimals	2004 books, Children's books
Trolleybus	Trolleybus, Buses
Van Hool	Transport companies of Europe, Bus transport, Companies of Belgium, Antwerp (province)
Battle of Antietam	American Civil War battles, 1862 in the United States, Maryland Campaign, 19th century in Maryland, September 1862 events
Spirited Away	2001 movies, Japanese movies, Anime, Studio Ghibli, Movies directed by Hayao Miyazaki, Movies that won the Best Animated Feature Academy Award
Rachel Weisz	1970 births, Living people, Academy Award winning actors, Actors from London, Alumni of the University of Cambridge, English movie actors, English television actors, English voice actors, Jewish British actors, Jewish models, Models from London
Old French	French language
Deborah Sampson	1760 births, 1827 deaths, American revolutionaries, People from Massachusetts
Groundskeeper Willie	The Simpsons characters, Fictional characters introduced in 1991
Dialectic	Philosophy
Hans Luther	1879 births, 1962 deaths, Bankers, Chancellors of the Weimar Republic, Ambassadors of Germany, German lawyers, German mayors (Weimar Republic), Government ministers of the Weimar Republic, Politicians from Berlin, Presidents of the Weimar Republic
Crossover (music)	Music industry
Crossover	Land vehicles, Automobile body styles
Council of Trent	Councils, Trentino-Alto Adige/Südtirol, 16th century in Italy, 1545 establishments, 1563 disestablishments, 1540s establishments in Europe, Disestablishments in Italy, Counter-Reformation
Du gamla, du fria	National anthems, Swedish music
Gospel of Matthew	Gospels, New Testament books
Gospel of Mark	Gospels, New Testament books
Gospel of Luke	Gospels, New Testament books
Gospel of John	Gospels, New Testament books
Sofia Rotaru	1947 births, Living people, Ukrainian singers, Ukrainian actors, Soviet actors, Soviet singers
Epistle to the Romans	Pauline epistles, New Testament books
Moe Szyslak	The Simpsons characters, Fictional characters introduced in 1989
First Epistle to the Corinthians	Pauline epistles, New Testament books
Epistle to the Hebrews	Pauline epistles, New Testament books
Alan Kuo	1981 births, C-pop singers, Living people, Singers, Songwriters, Taiwanese actors, Taiwanese singers
C-rock	C-rock
Cleo Lemon	1979 births, Living people, African American players of American football, American football quarterbacks, Baltimore Ravens players, Sportspeople from Mississippi
Reformed churches	Calvinism
Augsburg Confession	1530, Augsburg, Protestantism in Germany, History of Germany, Lutheranism, Protestant theology, Christian creeds, 16th century works
Norbert Brainin	1923 births, 2005 deaths, Austrian Jews, British violinists, Jewish British musicians, Musicians from Vienna, Naturalised citizens of the United Kingdom, Refugees from Nazism
Amadeus Quartet	String quartets
Valeri Brainin	1948 births, Living people, German poets, Jewish German musicians, Jewish German writers, Jewish musicians, Musicologists, Russian Jews, Russian musicians, Russian poets, Soviet Jews
Partisan Review	American magazines
List of Russian language poets	Lists of writers, Russian poets, Russia-related lists, Russian language
Blue-eyed soul	Soul music, R&B music
Recherswil	Municipalities of the canton of Solothurn
Boston, Lincolnshire	Boston, Lincolnshire
Stade	Towns in Lower Saxony
Stade (district)	Districts of Lower Saxony
Hasselt, Netherlands	Cities in the Netherlands, Settlements in Overijssel, Former municipalities of Overijssel
Chain letter	E-mail, Postal service
Stanisław Ulam	1909 births, 1984 deaths, American mathematicians, Jewish American academics, Jewish American scientists, Naturalized citizens of the United States, Polish Jews
Reichsuniversität Straßburg	Nazism, Strasbourg, Colleges and universities in France, 1941 establishments in Europe, 1944 disestablishments, 1940s establishments in France, 20th century disestablishments in France, 1940s disestablishments in Europe
Somatosensory system	Sensory system
Schandmaul	German rock bands, Folk metal bands
Flash (tattoo)	Body art
Itch	Symptoms
Tony Hibbert	English footballers, Sportspeople from Liverpool, 1981 births, Living people, Premier League players
Leighton Baines	1984 births, Living people, English footballers, Sportspeople from Merseyside, Premier League players
Joseph Yobo	1980 births, Living people, Nigerian footballers
Joleon Lescott	1982 births, Living people, Black British sportspeople, English footballers, Manchester City F.C. players, Sportspeople from Birmingham, Premier League players
Mikel Arteta	1982 births, Living people, Spanish footballers, People from San Sebastian
John Winter	1967 births, 2007 deaths, Businesspeople from Florida, American meteorologists, Scientists from Florida, People from Tampa, Florida
Saskia van Uylenburgh	1612 births, 1642 deaths, Dutch models
Ecliptic	Celestial mechanics
Janggu	Drums, Korean music
Kkwaenggwari	Percussion instruments, Korean music
Singapore Changi Airport	Transport in Singapore, Airports in Asia, Buildings and structures in Singapore, Changi, 1981 establishments in Asia, 1980s establishments in Singapore
Middle class	Economics, Social groups
No Mercy (2007)	2007 in American television, 2007 in professional wrestling, Sports in Chicago, Illinois, WWE No Mercy, 2007 in Illinois
Reverse osmosis	Water
Transport Layer Security	Cryptography, Internet standards, Internet protocols, Communication
Democratic-Republican Party	Political parties in the United States, 1792 establishments in the United States, 1820s disestablishments in North America, 19th-century disestablishments in the United States
Strict construction	Law
Race Horses (band)	2005 establishments in the United Kingdom, 2010s disestablishments in the United Kingdom, British pop music groups, Musical groups disestablished in 2012, Musical groups established in 2005, Welsh musical groups, 2000s establishments in Wales
Assisi	Towns in Italy, World Heritage Sites in Italy, Settlements in Umbria
Federalist Party	Political parties in the United States, 1792 establishments in the United States, 1816 disestablishments, 1810s disestablishments in the United States
Special Forces Command	Military, Turkey
Coalition	Diplomacy
International relations	International relations
Political science	Social sciences
Thnks fr th Mmrs	2007 songs, Fall Out Boy songs
That's What You Get	2008 songs, Paramore songs, Pop rock songs
Dimensionless quantity	Mathematics
Dancing with the Stars	2004 television series debuts, 2000s television series, 2010s television series, Dancing with the Stars, ABC network shows
Tartu	Cities in Estonia, Hanseatic League
Infinity on High	2007 albums, Fall Out Boy albums, Island Records albums, Pop punk albums, Rock albums
Yellow Submarine	The Beatles, Animated movies, English-language movies, Movies with underwater settings, 1968 comedy movies
Discrete cosine transform	Technology
Donald Tusk	1957 births, Living people, Presidents of the European Council, People from Gdańsk, Prime Ministers of Poland
French polish	Woodworking
Representative	Basic English 850 words
Irregular bone	Bones
Representation (politics)	Politics
Lag	Video games
Allotment	Ancient Greece, Politics
Round Table	Arthurian legend
This Ain't a Scene, It's an Arms Race	2007 songs, Fall Out Boy songs
The Carpal Tunnel of Love	2007 songs, Fall Out Boy songs
The Take Over, the Breaks Over	Fall Out Boy songs, 2007 songs
Doge	Heads of state, Government occupations
Valverde Province	Provinces of the Dominican Republic, 1959 establishments in North America, 1950s establishments in the Dominican Republic
Serket	Egyptian gods and goddesses
Tempera	Painting, Paints
Decision-making	Psychology
Trichotillomania	Impulse control disorders
Reign of Terror	French Revolution, Terrorism, 1793, 1794 in France
Political faction	Politics
French Constitution of 1791	1791, 1790s in France, Constitutions
Knights of the Round Table	Arthurian legend, Fictional knights
Executive (government)	Government
Intergovernmental Panel on Climate Change	1988 establishments, International environmental organizations, United Nations specialized agencies, Climate change
Zimmermann Telegram	World War I
Battle of Stalingrad	1942, 1943 in Europe, 1940s in the Soviet Union, Battles involving Germany, Battles involving the Soviet Union, European battles of World War II, Volgograd
World War I reparations	World War I
Richard III (play)	Plays by William Shakespeare, Plays based on British history
Lojban	Constructed languages
Annulment	Family, Relationships, Roman Catholicism
Osroene	Former countries in Asia
BRIT Awards	Music awards
Sound of the Underground	Girls Aloud albums, Debut albums, 2003 albums, Dance pop albums
What Will the Neighbours Say?	Girls Aloud albums, 2004 albums
Chemistry (album)	Girls Aloud albums, 2005 albums
The Sound of Girls Aloud	Girls Aloud albums, 2006 albums
Tangled Up	Girls Aloud albums, 2007 albums, Pop albums
Oil paint	Painting, Paints
John Law	People from Edinburgh, Economists, 1671 births, 1729 deaths
List of The Simpsons characters	The Simpsons characters, Lists of television characters
Edicts of Ashoka	Buddhist texts, Religion in India
Proselytism	Religious terminology, Religious conversion
Ken Hitchcock	1951 births, Ice hockey people from Alberta, Jack Adams Award winners, Living people, Sportspeople from Edmonton
Armistice	War
Armistice with Germany (Compiègne)	1918 in Europe, 1910s in France, World War I, 1910s in Germany, November events
WWE SmackDown	1999 American television series debuts, American television series, WWE SmackDown!, UPN network shows, English-language television programs
Nationwide Arena	Sports buildings in the United States, Columbus, Ohio, Buildings and structures in Ohio, Arena Football League, 2000 establishments in the United States, 20th-century establishments in Ohio
The Beatles (album)	The Beatles albums, 1968 albums, Rock albums
Albert Fert	1938 births, Living people, French academics, French Nobel Prize winners, French physicists, People from Occitanie, Wolf Prize winners
Peter Grünberg	1939 births, 2018 deaths, German academics, German Nobel Prize winners, German physicists, Wolf Prize winners
Easter eggplant	Nightshades, Vegetables, Fruits, Solanum
Sienna Guillory	1975 births, Living people, English models, English movie actors, English television actors
Super Mario Bros. 2	1988 video games, Game Boy Advance games, Mario platform games, Nintendo Entertainment Analysis and Development games, Nintendo Entertainment System games, Nintendo Research & Development 2 games, Super Nintendo Entertainment System games, Video game remakes, Virtual Console games
Sierra Mist	Soft drinks
Khan (title)	Feudalism, Heads of state
Crime in Russia	Crime by country, Russia
Crime in India	Crime in India
Birthmark	Skin
Pskov	Capital cities in Russia
Perth, Scotland	Cities in Scotland, Port cities and towns of the North Sea, Port cities and towns of Scotland
Nevermore	Thrash metal bands, Death metal bands, Musical groups from Seattle, Washington, Musical groups established in 1991, 1991 establishments in the United States, 1990s establishments in Washington (state)
Machine Head	1990s American music groups, 2000s American music groups, 2010s American music groups, Thrash metal bands, Nu metal bands, American heavy metal bands, Musical groups from Oakland, California, Roadrunner Records
Fritz Haber Institute of the MPG	Research organizations in Europe, Berlin, 1911 establishments in Europe, 1910s establishments in Germany
Microformat	Internet
VCard	E-mail
British War Medal	Military of the United Kingdom, Orders, decorations, and medals of the United Kingdom
Michel Fourniret	1942 births, 2021 deaths, Deaths from respiratory failure, Child sexual abusers, French criminals, French prisoners, Kidnappers, People from Grand Est, Rapists, Serial killers
Amber-coloured salamander	Hynobius
Clouded Salamander	Hynobius
Pontius Pilate	1st century BC births, 1st century BC deaths, Roman people, New Testament people
Ezo salamander	Hynobius
Asiatic salamander	Salamanders
Stockbroker	Financial occupations, Stock market
Kori salamander	Salamanders
Hynobius amjiensis	Hynobius
Zutphen	Cities in the Netherlands, Settlements in Gelderland, Municipalities of Gelderland
Satu Mare	County capitals of Romania, Municipalities of Romania
Schwaz	Cities and towns in Tyrol (state)
Philadelphia Phillies	Philadelphia Phillies, 1884 establishments in the United States, 1880s establishments in Pennsylvania
Marc Dutroux	1956 births, Living people, People from Brussels-Capital Region, Child sexual abusers, Drug dealers, People with antisocial personality disorder, Prisoners sentenced to life imprisonment, Rapists, Robbers, Serial killers, Thieves
Trento	Cities in Trentino-Alto Adige/Südtirol, Regional capitals in Italy
Znojmo	Cities in the Czech Republic
Candelaria Municipality	Municipalities of Campeche, 1998 establishments in North America, 1990s establishments in Mexico
Šilalė	Cities in Lithuania
Rosignano Solvay	Towns in Tuscany
Rolando Filidei	Italian sculptors, 1914 births, 1980 deaths
Diplom	Education in Germany, Austria, Switzerland, Greece
Traralgon, Victoria	Cities in Victoria
Yerzin, Salih Yusupovich	Tatars, Business people, 1830 births, 1911 deaths
Tatars	Tatars
Gupta Empire	History of India, History of Bangladesh, Royal dynasties, 4th-century establishments, 6th-century disestablishments, Establishments in Asia, Disestablishments in Asia
North Melbourne Football Club	Australian Football League
England national football team	National football teams, Football in England, The Football Association, UEFA, English football clubs
Portman Road	Football stadiums in England, Ipswich, 1884 establishments in England
Norwich City F.C.	Premier League clubs, Norwich
Queens Park Rangers F.C.	Premier League clubs, 1882 establishments in England
List of Bangkok universities	Lists of universities, Colleges and universities in Thailand, Bangkok
List of palaces in Bangkok	Lists of buildings, Palaces, Buildings and structures in Bangkok, Thai culture, Asia-related lists
List of sport venues in Bangkok	Sports buildings, Sports lists, Sport in Thailand, Buildings and structures in Bangkok
Watford F.C.	English football clubs, Watford, 1881 establishments in England
Sheffield United F.C.	English football clubs, Sheffield, 1889 establishments in England
Barnsley F.C.	English football clubs, 1887 establishments in Europe, 1880s establishments in England
Burnley F.C.	Premier League clubs, 1882 establishments in England, Sport in Lancashire
Azua Province	Provinces of the Dominican Republic
Cardiff City F.C.	Welsh football clubs, Cardiff, 1899 establishments in the United Kingdom, 1890s establishments in Wales
Colchester United F.C.	English football clubs, 1937 establishments in England
Coventry City F.C.	Coventry, English football clubs, 1883 establishments in the United Kingdom
Crewe Alexandra F.C.	1877 establishments in England, Crewe, English football clubs
Crystal Palace F.C.	Premier League clubs, Football clubs in London, 1905 establishments in England
Hull City A.F.C.	1904 establishments in England, English football clubs, Kingston upon Hull
Golden Age of India	History of India
Enoch Powell	1912 births, 1998 deaths, Alumni of the University of Cambridge, British academics, British Army people, British military personnel of World War II, Converts to Christianity, Deaths from Parkinson's disease, English Anglicans, English poets, Former Conservative MPs (UK), Former members of the British House of Commons for English constituencies, Former members of the British House of Commons for Northern Irish constituencies, Politicians from Birmingham, Privy Councillors (UK), UK MPs 1950–1951, UK MPs 1951–1955, UK MPs 1955–1959, UK MPs 1959–1964, UK MPs 1964–1966, UK MPs 1966–1970, UK MPs 1970–1974, UK MPs 1974–1979, UK MPs 1979–1983, UK MPs 1983–1987, University of Sydney faculty, Writers from Birmingham
Monetarism	Macroeconomics
Super Mario All-Stars	1993 video games, Super Nintendo Entertainment System games, Compilation video games
Super Mario Sunshine	2002 video games, Mario platform games, Nintendo Entertainment Analysis and Development games, Nintendo GameCube-only games
African elephant	Elephants
History of the United Kingdom	History of the United Kingdom
Leeds United F.C.	English football clubs, 1919 establishments in the United Kingdom, 1910s establishments in England
Acts of Union 1707	1707, 18th century in the Kingdom of Great Britain, Acts of the Parliament of the United Kingdom, 1700s in Europe
El Paso, Guyana	Villages, Settlements in South America, Guyana
Provinces of Iran	Provinces of Iran
Counties of Iran	Counties of Iran, Lists of counties, Iran-related lists
Tehran Province	Provinces of Iran
Leicester City F.C.	English football clubs, Leicester, 1884 establishments in England
Damavand County	Counties of Iran
Eslamshahr County	Counties of Iran
Firouzkouh County	Counties of Iran
Karaj County	Counties of Iran
Luton Town F.C.	1885 establishments in England, English football clubs, Luton
Millwall F.C.	English football clubs, 1885 establishments in England
Nazarabad County	Counties of Iran
Pakdasht County	Counties of Iran
Preston North End F.C.	1880 establishments in the United Kingdom, City of Preston, Lancashire, English football clubs, Sport in Lancashire
Rey County	Counties of Iran
Robat-Karim County	Counties of Iran
Savojbolagh County	Counties of Iran
Shahriar County	Counties of Iran
Shemiranat County	Counties of Iran
Tehran County	Counties of Iran
Varamin County	Counties of Iran
The New Den	Football stadiums in London
Les Cayes	Cities in Haiti, 1726 establishments, 18th-century establishments in Haiti, 1720s establishments in North America
Spitz (dog)	Dog breeds
Southampton F.C.	Premier League clubs, Southampton, 1885 establishments in England
Southend United F.C.	English football clubs, 1906 establishments in England
Stoke City F.C.	1863 establishments in England, Premier League clubs, Stoke-on-Trent
Stanley Matthews	1915 births, 2000 deaths, 1950 FIFA World Cup players, 1954 FIFA World Cup players, British military personnel of World War II, Commanders of the Order of the British Empire, Disease-related deaths in England, English autobiographers, English footballers, English football managers, Knights Bachelor, People from Stoke-on-Trent, Sportspeople from Staffordshire
Blackpool F.C.	1887 establishments in Europe, 1880s establishments in England, Blackpool, English football clubs
Articles of Confederation	1781 in North America, Official documents of the United States, 1780s in the United States
History of the United States	History of the United States
Exponential function	Mathematics
Computer file	Computing
File (tool)	Cutting tools
Sheffield Wednesday F.C.	English football clubs, Sheffield, 1867 establishments in England
De Wallen	Amsterdam, Red light districts
Wolverhampton Wanderers F.C.	English football clubs, 1877 establishments in England
A.F.C. Bournemouth	Premier League clubs, Bournemouth, 1899 establishments in England
Jamie Redknapp	1973 births, Living people, English footballers, Sportspeople from Hampshire, Louise Redknapp, Premier League players
Bradford City A.F.C.	Bradford, English football clubs, 1903 establishments in the United Kingdom
Arenal Volcano National Park	National parks in Costa Rica, Alajuela Province
Faded (song)	2006 songs
Emergency (song)	2005 songs, Paramore songs
Roger D. Kornberg	1947 births, Living people, American chemists, American Nobel Prize winners, Harvard University alumni, Jewish American academics, Jewish American scientists, Jewish Nobel Prize winners, Scientists from St. Louis, Missouri, Stanford University faculty
All We Know Is Falling	2005 albums, Paramore albums, Debut albums, Pop punk albums, Rock albums
Businessperson	Occupations, Business people
Werl	Towns in North Rhine-Westphalia, Soest Rural District
Tangent (geometry)	Geometry
History of North America	History of North America
Brentford F.C.	English football clubs, 1889 establishments in England
Harry Redknapp	1947 births, Living people, English football managers, English footballers, Sportspeople from London
Cough	Reflexes, Symptoms
Creation myth	Creation myths
Tarantula	Spiders, Venomous animals
Hunter-gatherer	Anthropology, Everyday life, Hunting
File format	Computer file formats
Lascaux	Caves, Geography of France, World Heritage Sites in France, Nouvelle-Aquitaine, Archaeological sites in France
Bobby Charlton	1937 births, Living people, English footballers, English football managers, Manchester United F.C. players, Sportspeople from Northumberland
Gary Lineker	1960 births, Living people, 1986 FIFA World Cup players, 1990 FIFA World Cup players, English footballers, English sports commentators, Sportspeople from Leicester, Tottenham Hotspur F.C. players
Geoff Hurst	1941 births, 1966 FIFA World Cup players, 1970 FIFA World Cup players, English autobiographers, English cricketers, English football managers, English footballers, Knights Bachelor, Living people, Members of the Order of the British Empire, Sportspeople from Essex, Sportspeople from Lancashire, West Ham United F.C. players
Parliament of Scotland	History of Scotland, Politics of Scotland, 1707 disestablishments, Parliaments, 1700s disestablishments in Europe
Coco Islands	National parks in Costa Rica, Islands of Central America, World Heritage Sites in North America
Decoritidae	Goniatitina
Gastrioceratoidea	Goniatitina
Goniatitina	Goniatitina, Cephalopods
Alf Ramsey	1920 births, 1999 deaths, Deaths from myocardial infarction, English football managers, English footballers, England national football team managers, Sportspeople from Essex
Qom Province	Provinces of Iran
Qom County	Counties of Iran
Markazi Province	Markazi Province
Ashtian County	Counties of Iran, Markazi Province
Arak County	Counties of Iran, Markazi Province
Delijan County	Counties of Iran, Markazi Province
Khomein County	Counties of Iran, Markazi Province
Komeijan County	Counties of Iran, Markazi Province
Mahallat County	Counties of Iran, Markazi Province
Saveh County	Counties of Iran, Markazi Province
Shazand County	Counties of Iran, Markazi Province
Tafresh County	Counties of Iran, Markazi Province
Zarandieh County	Counties of Iran, Markazi Province
E.T. the Extra-Terrestrial	1982 drama movies, 1982 science fiction movies, Academy Award winning movies, American drama movies, American family movies, American science fiction movies, English-language movies, Golden Globe Award winning movies, Movies composed by John Williams, Movies directed by Steven Spielberg, Saturn Award winning movies, United States National Film Registry movies, Universal Pictures movies, Movies set in California
Alex Ferguson	1941 births, Living people, Scottish footballers, Association football forwards, Scottish football managers, Commanders of the Order of the British Empire, Knights Bachelor
Tocharians	Asian people
Information technology	Computers
History of Asia	History of Asia
International Mathematical Olympiad	Mathematics, Competitions
Edmund Phelps	1933 births, Living people, American academics, American economists, American Nobel Prize winners, People from Illinois, Yale University alumni, Columbia University faculty
Nanotechnology	Nanotechnology
Hattem	Hanseatic League, Cities in the Netherlands, Municipalities of Gelderland, Settlements in Gelderland
Alex McLeish	1959 births, Living people, Scottish footballers, Scottish football managers
Óscar Arias	1940 births, Living people, Presidents of Costa Rica
Universal history	History
Brewery	Beer
Butane	Alkanes, Fuel
Liquefied petroleum gas	Chemical compounds
Aerosol spray	Tools, Air pollution, Art materials, Environmental issues
Max Born	1882 births, 1970 deaths, British mathematicians, British Nobel Prize winners, British physicists, German mathematicians, German physicists, Jewish British academics, Jewish British scientists, Jewish German academics, Jewish German scientists, Jewish Nobel Prize winners, Naturalised citizens of the United Kingdom, Nuclear physicists, People from former German territories, People from Wrocław, Refugees from Nazism, Theoretical physicists, German Nobel Prize winners
United Nations Office for Outer Space Affairs	United Nations, Spaceflight
Craig Mello	1960 births, Living people, American academics, American biologists, American Nobel Prize winners, Scientists from New Haven, Connecticut, Yale University alumni
Vicar of Bray	Songs, History of England, Berkshire
Maharishi Mahesh Yogi	1918 births, 2008 deaths, Deaths from natural causes, New religious movements, Spiritual teachers
Bristol City F.C.	English football clubs, 1894 establishments in the United Kingdom
Chesterfield F.C.	English football clubs, 1867 establishments in England
Doncaster Rovers F.C.	English football clubs, 1879 establishments in England
Huddersfield Town F.C.	English football clubs, Huddersfield, 1908 establishments in England
Sanskara	Hinduism, Buddhist terminology
Supernanny	2004 British television series debuts, 2005 American television series debuts, 2011 American television series endings, 2012 British television series endings, 2000s American television series, 2000s British television series, 2010s American television series, 2010s British television series, American reality television series, Channel 4 reality television programmes, English-language television programs
Keyboard (computer)	Computer hardware, Writing tools, Data input
Rhythm guitar	Music
Book of Revelation	New Testament books, Christian eschatology
Theodor Fontane	1819 births, 1898 deaths, German poets, Writers from Brandenburg, Pharmacists
Pachelbel's Canon	Chamber music compositions
Damme	Municipalities of West Flanders
Hit record	Music industry
Pauline epistles	Pauline epistles
Viljandi	Settlements in Estonia
Sinners in the Hands of an Angry God	Speeches, Puritanism, 1741
Physical constant	Physical quantity
Cookstown	Towns in Northern Ireland
Dungannon	Towns in Northern Ireland
Coagh	Villages in Northern Ireland
Stewartstown	Villages in Northern Ireland
Ballymena	Towns in Northern Ireland, Settlements in County Antrim
Society of St. John the Evangelist	Anglicanism, Christian religious orders
Magherafelt	Towns in Northern Ireland
Constituent country	Countries
Leyton Orient F.C.	English football clubs, 1881 establishments in England
Northampton Town F.C.	English football clubs, Northampton, 1897 establishments in the United Kingdom
Counties of Northern Ireland	Counties of Northern Ireland
Nottingham Forest F.C.	English football clubs, Nottingham, 1865 establishments in the United Kingdom
Brian Clough	1935 births, 2004 deaths, British autobiographers, Cancer deaths in England, Deaths from stomach cancer, English footballers, English football managers, Organ transplant recipients, People from North Yorkshire, Sportspeople from Yorkshire
Irish national grid reference system	Political geography, Ireland
Districts of Northern Ireland	Northern Ireland
Post town	Postal services in the United Kingdom
Hudson Motor Car Company	American automobile companies, 1909 establishments in the United States
BT postcode area	Northern Ireland
Northern Ireland Fire and Rescue Service	Northern Ireland
Northern Ireland Ambulance Service	Transport in Northern Ireland, Emergency services, 1995 establishments in the United Kingdom, 20th century establishments in Northern Ireland
Września	Towns in Poland
Police Service of Northern Ireland	Northern Ireland, Law enforcement in the United Kingdom
Grameen Bank	1983 establishments in Asia, Economy of Bangladesh, Banks, Autobiographers, Buildings and structures in Bangladesh, Dhaka, 20th century establishments in Bangladesh
United Kingdom Census 2001	2001 in the United Kingdom, Ethnic groups in the United Kingdom
Hug	Relationships, Emotions, Non-verbal communication
WWE Intercontinental Championship	World Wrestling Entertainment championships, 1979 establishments
List of members of the European Parliament for the United Kingdom, 2004–09	MEPs for the United Kingdom, British politicians, Lists of politicians, United Kingdom-related lists
Polygamy	Marriage, Mating systems
Rickenbach, Solothurn	Municipalities of the canton of Solothurn
Neal Cassady	American LGBT people, Bisexual people, Beat Generation, LGBT writers, Writers from Salt Lake City, Utah, Writers from Colorado, 1926 births, 1968 deaths
Riedholz	Municipalities of the canton of Solothurn
Northern Ireland (European Parliament constituency)	MEPs for the United Kingdom, Politics of Northern Ireland
Feldbrunnen-St. Niklaus	Municipalities of the canton of Solothurn
Rodersdorf	Municipalities of the canton of Solothurn
Beat Generation	Beat Generation
Brill Building	Music industry, Buildings and structures in Manhattan, New York City Designated Landmarks
Chris Stewart	British autobiographers, English drummers, Genesis (band), English writers, 1950 births, Living people
John Silver	1950 births, Living people, English drummers, Genesis (band)
John Mayhew	1947 births, 2009 deaths, Australian drummers, Australian rock musicians, Carpenters, English drummers, English rock musicians, Genesis (band), People from Ipswich
Larch	Conifers
Louise Goodman	English television presenters, Year of birth missing (living people), Living people
Second Epistle to the Corinthians	Pauline epistles, New Testament books
Visby	World Heritage Sites in Sweden, Settlements in Gotland County
Kollam	Cities in India, Cities in Kerala
Aiglun, Alpes-Maritimes	Communes in Alpes-Maritimes
Alpes-Maritimes	Alpes-Maritimes
Communes of France	Communes in France
Cantons of France	Cantons of France
Arrondissements of France	Arrondissements of France
List of arrondissements of France	Lists of arrondissements of France
List of cantons of France	France-related lists, Cantons of France
Cantons of the Ain department	France-related lists, Auvergne-Rhône-Alpes, Cantons of France
Prince Philip, Duke of Edinburgh	1921 births, 2021 deaths, British Anglicans, British Army officers, British military personnel of World War II, British royalty, Danish royalty, Greek people, House of Windsor, Kings and Queens consort of the United Kingdom, Knights and Dames Grand Cross of the Order of the British Empire, Knights of the Garter, Knights of the Thistle, Naturalised citizens of the United Kingdom, Order of Australia, Order of Merit, Order of Merit of the Federal Republic of Germany, Privy Councillors (UK), Recipients of the Decoration for Services to the Republic of Austria, Royal Navy officers, United Kingdom Dukes, Elizabeth II
George IV	1762 births, 1830 deaths, Kings and Queens of the United Kingdom, People Buried in St. George's Chapel at Windsor Castle
William IV of the United Kingdom	1765 births, 1837 deaths, Kings and Queens of the United Kingdom, People Buried in St. George's Chapel at Windsor Castle, Kings and Queens of Hanover
Cantons of the Aisne department	France-related lists, Hauts-de-France, Cantons of France
Communes of the Alpes-Maritimes department	Lists of communes of France, Communes in Alpes-Maritimes
Energy (society)	Energy
Transformer	Electricity, Electronics, Transformers (electrical)
Ballycastle, County Antrim	Towns in Northern Ireland, Settlements in County Antrim
Bangor, County Down	Towns in County Down
Munich (district)	Munich Rural District
Act of Union 1800	History of Ireland, 19th century in the United Kingdom, Acts of the Parliament of the United Kingdom, 1800
Ebersberg (district)	Rural Districts in Upper Bavaria
Freising (district)	Rural Districts in Upper Bavaria
Starnberg (district)	Starnberg (district)
Traunstein (district)	Rural Districts in Upper Bavaria
Berchtesgadener Land	Berchtesgadener Land
Rosenheim (district)	Rosenheim (district)
Banne	Communes in Ardèche
Ardèche	Ardèche
Cantons of the Ardèche department	Ardèche, France-related lists, Cantons of France
Arrondissements of the Ardèche department	Arrondissements of Ardèche, Lists of arrondissements of France
Communes of the Ardèche department	Lists of communes of France, Communes in Ardèche
Accons	Communes in Ardèche
Ailhon	Communes in Ardèche
Aizac	Communes in Ardèche
Muhammad Yunus	1940 births, Living people, Bangladeshi people, Economy of Bangladesh, Bangladeshi Muslims
John Keats	1795 births, 1821 deaths, Deaths from tuberculosis, English poets, Literature since 1500, Writers from London
Endymion (poem)	19th-century British poems
Hyperion (poem)	19th-century British poems
Arlo Guthrie	American guitarists, Singer-songwriters from New York, Musicians from New York City, Singers from New York City, American folk musicians, 1947 births, Living people, Warner Bros. Records artists
Sonnet	Poetry forms
Golden ratio	Irrational numbers
Relational database	Computer science
Kingdom of Scotland	Former countries in Europe, History of Scotland
Ajoux	Communes in Ardèche
Alba-la-Romaine	Communes in Ardèche
Albon-d'Ardèche	Communes in Ardèche
Alboussière	Communes in Ardèche
Alissas	Communes in Ardèche
Arrondissement of Largentière	Arrondissements of Ardèche
Arrondissement of Privas	Arrondissements of Ardèche
Jackson, Michigan	Cities in Michigan, County seats in Michigan, 1820s establishments in Michigan Territory
Protostome	Invertebrates, Groups of phyla
Earth, Texas	Cities in Texas
Amazing Grace (2006 movie)	2006 drama movies, 2000s biographical movies, American biographical movies, American drama movies, British biographical movies, British drama movies, Movies directed by Michael Apted
Relation (mathematics)	Mathematics, Computer science
María Isabel Carvajal	1888 births, 1949 deaths, Teachers, Costa Rican people, Writers, People from San José, Costa Rica
How Pop Can You Get?	1982 albums, Pop albums
San Pedro de Macorís Province	Provinces of the Dominican Republic, 1885 establishments, 1880s establishments in the Dominican Republic
Kurt Warner	1971 births, American Christians, American football quarterbacks, Arena Football League, Arizona Cardinals players, Green Bay Packers players, Living people, New York Giants players, Sportspeople from Iowa, St. Louis Rams players
Skokie, Illinois	Villages in Illinois, 1888 establishments in the United States, 1880s establishments in Illinois, Suburbs of Chicago, Illinois, Settlements in Cook County, Illinois
WAV	Computer file formats for audio
L. Frank Baum	Writers from New York, Literature since 1500, 1856 births, 1919 deaths
Book of Jonah	Old Testament books
Book of Malachi	Old Testament books
Trey Lewis	American football defensive tackles, Sportspeople from Kansas, 1985 births, Living people, People from Topeka, Kansas
Polotsk	Cities in Belarus
Andance	Communes in Ardèche
Annonay	Communes in Ardèche
Antraigues-sur-Volane	Former communes in Ardèche
Arcens	Communes in Ardèche
Ardoix	Communes in Ardèche
Arlebosc	Communes in Ardèche
Arras-sur-Rhône	Communes in Ardèche
Asperjoc	Former communes in Ardèche
Les Assions	Communes in Ardèche
Astet	Communes in Ardèche
Aubenas	Communes in Ardèche, Cities in France
Aubignas	Communes in Ardèche
Baix	Communes in Ardèche
Balazuc	Communes in Ardèche
Barnas	Communes in Ardèche
Beggars Banquet	1968 albums, The Rolling Stones, Rock albums, R&B albums
Hyles-Anderson College	Christian colleges and universities in the United States, Colleges and universities in Indiana, 1972 establishments in the United States, 20th-century establishments in Indiana
Simon Fraser University	Colleges and universities in Canada, Surrey, Vancouver
Albi	Cities in France, Communes in Tarn, Departmental capitals in France, World Heritage Sites in France
Bambi II	Bambi, 2006 movies, 2006 animated movies, Disney animated movies, Disney direct-to-video movies, American family movies, American musical movies, Sequel movies
Deportivo Saprissa	Football clubs, Sport in Costa Rica, 1935 establishments in North America, 20th-century establishments in Costa Rica
Chirripó National Park	National parks in Costa Rica
National Parks of Costa Rica	National parks in Costa Rica, Lists of national parks
Blue Flag beach	Water pollution, Conservation, Beaches
Sarchí, Costa Rica	Cities in Costa Rica
José Figueres Ferrer	1906 births, 1990 deaths, Presidents of Costa Rica
Jaw	Head (body part)
Battle of Santa Rosa	Battles, History of Costa Rica, History of Nicaragua, 1856, 19th century in North America, March events
Editus	Costa Rica, Jazz bands
San José, Costa Rica	National capitals in North America, San José, Costa Rica, 1738 establishments, Establishments in Costa Rica, 1730s establishments in North America
CowParade	Sculpture, Festivals
Poás Volcano	Volcanoes of North America, Alajuela Province
Gandhi (band)	Rock bands, San José, Costa Rica, Musical groups established in 1993, 1993 establishments in North America, 20th-century establishments in Costa Rica
Clodomiro Picado	Costa Rican people, Biologists, 1887 births, 1944 deaths
From Me to You	The Beatles songs, 1963 songs
Epistle to the Ephesians	Pauline epistles, New Testament books
Endymion	People in Greek mythology
Samuel Taylor Coleridge	1772 births, 1834 deaths, Alumni of the University of Cambridge, English Anglicans, English poets, Royal Society of Literature, Writers from Devon
With the Beatles	The Beatles albums, 1963 albums, Rock and roll albums, Pop albums
Beatles for Sale	The Beatles albums, 1964 albums, Rock and roll albums, Folk albums
Rubber Soul	The Beatles albums, 1965 albums, Folk albums, Pop rock albums
Abbey Road	The Beatles albums, 1969 albums, Rock albums
Magical Mystery Tour	The Beatles albums, 1967 albums, Rock albums
Hyperinflation	Inflation
Brian May	1947 births, Living people, Astrophysicists, English rock guitarists, English rock singers, English singer-songwriters, English scientists, Musicians from Middlesex
John Deacon	1951 births, Living people, Bass guitarists, Musicians from Leicestershire
Roger Taylor	1949 births, Living people, English rock drummers, English rock singers, English singer-songwriters, Entertainers from Cornwall, People from Norfolk
Le Béage	Communes in Ardèche
Beauchastel	Communes in Ardèche
Beaulieu, Ardèche	Communes in Ardèche
Paul Rodgers	1949 births, Living people, English singers, English songwriters
Beaumont, Ardèche	Communes in Ardèche
Beauvène	Communes in Ardèche
Rouffiac-des-Corbières	Communes in Aude
Berrias-et-Casteljau	Communes in Ardèche
Berzème	Communes in Ardèche
Bessas	Communes in Ardèche
Bidon	Communes in Ardèche
Boffres	Communes in Ardèche
Bogy	Communes in Ardèche
Borée	Communes in Ardèche
Borne, Ardèche	Communes in Ardèche
Boucieu-le-Roi	Communes in Ardèche
Boulieu-lès-Annonay	Communes in Ardèche
Bourg-Saint-Andéol	Communes in Ardèche
Bozas	Communes in Ardèche
Brossainc	Communes in Ardèche
Burzet	Communes in Ardèche
Cellier-du-Luc	Communes in Ardèche
Chalencon	Communes in Ardèche
Le Chambon, Ardèche	Communes in Ardèche
Chambonas	Communes in Ardèche
Peyrepertuse Castle	Castles in France, Occitanie
Remlingen, Lower Saxony	Former municipalities in Lower Saxony
Bryan Ruiz Gonzalez	1985 births, Living people, Costa Rican footballers, People from San José, Costa Rica
Jacó, Costa Rica	Cities in Costa Rica
Irazu Volcano	National parks in Costa Rica
Puerto Viejo de Talamanca	Limón Province, Cities in Costa Rica
List of Cantons of Switzerland by area	Switzerland-related lists, Cantons of Switzerland
Cathar castles	Castles in France
Château d'Usson	Castles in France, Occitanie
Sertab Erener	1964 births, Living people, Eurovision Song Contest winners, Musicians from Istanbul, Pop singers, Turkish singers
Scouting	Youth organizations, Scouting
History of Indonesia	History of Asia, History of Indonesia
Book of Leviticus	Old Testament books
John C. Mather	1946 births, Living people, American astronomers, American physicists, Astrophysicists, Scientists from Virginia, People from Roanoke, Virginia, American Nobel Prize winners
Book of Joshua	Old Testament books
Home education	Education
Shinjuku Station	Railway stations in Tokyo
San Pedro de Macorís	Settlements in Dominican Republic, 1856 establishments, 19th-century establishments in the Spanish West Indies, 1850s establishments in North America
Epistle to the Galatians	Pauline epistles, New Testament books
Neanderthal	Hominins
Oldenzaal	Hanseatic League, Cities in the Netherlands, Settlements in Overijssel, Municipalities of Overijssel
Homo erectus	Hominins, Prehistoric Africa
Paramilitary	Military
Champagne, Ardèche	Communes in Ardèche
Champis, Ardèche	Communes in Ardèche
Chandolas	Communes in Ardèche
Chanéac	Communes in Ardèche
Charmes-sur-Rhône	Communes in Ardèche
Charnas	Communes in Ardèche
Palaeolithic	Stone Age, Anthropology
Bolas	Weapons
Cord	Basic English 850 words
Howard Hughes	American aviators, Businesspeople from Texas, Movie directors from Texas, Movie producers from Texas, 1905 births, 1976 deaths
Tarzan	Tarzan, Fictional characters, Books with jungle settings, Fictional characters with immortality
Surfer Rosa	1988 albums
OK Go	American rock bands, Indie rock bands, Musical groups from Chicago, Musical groups established in 1998, 1998 establishments in the United States, 1990s establishments in Illinois, American Internet celebrities
Death zone	Atmosphere
George F. Smoot	1945 births, Living people, American astronomers, American physicists, Astrophysicists, American Nobel Prize winners, Scientists from Florida
Soundgarden	Soundgarden, Musical groups from Seattle, Washington, 1980s American music groups, 1990s American music groups, 2000s American music groups, 2010s American music groups, American heavy metal bands, Grunge bands, Musical groups established in 1984, 1984 establishments in the United States, 1980s establishments in Washington (state), Musical groups disestablished in 1997, 1990s disestablishments in Washington (state), Musical groups established in 2010, 2010 establishments in the United States, 21st-century establishments in Washington (state), 2017 disestablishments in the United States, Musical groups disestablished in the 2010s, 21st-century disestablishments in Washington (state)
Book of Judges	Old Testament books
Black people	Ethnic groups, Race
Book of Ruth	Old Testament books
Mesolithic	Stone Age
Epipalaeolithic	Stone Age
Neolithic revolution	Agriculture, Neolithic, Revolutions
British Army	British Army
Mario Kart	Mario Kart games
City Loop, Melbourne	Railway stations in Melbourne
Percy Bysshe Shelley	1792 births, 1822 deaths, Accidental deaths by drowning, British atheists, English poets, Nonviolence advocates, Writers from Sussex
Romani language	Indo-Aryan languages, Roma
Fudge	Candy
Sinti	Ethnic groups, Roma
Strapping Young Lad	1990s music groups, 2000s music groups, Canadian heavy metal bands, Canadian thrash metal bands, progressive metal bands, Musical groups established in 1994, 1994 establishments in Canada, Musical groups disestablished in 2007, 2000s disestablishments in Canada, 2007 disestablishments
Rock climbing	Rock climbing
Doug Henning	1947 births, 2000 deaths, Cancer deaths in Los Angeles, Deaths from liver cancer, Entertainers from Winnipeg, Magicians
Rancid (band)	1991 establishments in California, 1990s American music groups, 2000s American music groups, 2010s American music groups, American punk bands, Musical groups from California, Musical groups established in 1991
Glen Canyon Dam	Dams in the United States, Buildings and structures in Arizona, 1963 establishments in the United States, 20th-century establishments in Arizona
Superunknown	1994 albums, Soundgarden albums
Badmotorfinger	1991 albums, Soundgarden albums
Bernoulli's principle	Fluid mechanics
Book of Proverbs	Old Testament books
Welwitschia	Gymnosperms
Petasites	Petasites, Asteraceae, Flowers
Death Angel	People from Concord, California, Musical groups established in 1982, 1982 establishments in California, 1980s American music groups, 1990s American music groups, Musical groups disestablished in 1991, 1991 disestablishments in the United States, 1990s disestablishments in California, 2000s American music groups, Musical groups established in 2001, 2001 establishments in California, 2010s American music groups, Thrash metal bands, American heavy metal bands, Musical groups from California, Enigma Records artists
Arch Enemy	Swedish heavy metal bands, Death metal bands, Thrash metal bands, Musical groups established in 1996
Living fossil	Living fossils, Evolutionary biology, Metaphors referring to nature
Caliban (band)	German heavy metal bands, Metalcore bands, Roadrunner Records, 1997 establishments in Germany
NetBSD	Free software, Operating systems, BSD
Soilwork	Swedish heavy metal bands, Death metal bands, Alternative metal bands, Helsingborg, Musical groups established in 1995
Lamb of God	1990s American music groups, 2000s American music groups, 2010s American music groups, Thrash metal bands, American heavy metal bands, Metalcore bands, Musical groups from Virginia, People from Richmond, Virginia
Carabiner	Sports equipment, Rock climbing, Mountain climbing
Cyclamen	Flowers, Primulaceae
Bambi (character)	Bambi characters, Kingdom Hearts characters
Grigri	Rock climbing
Thumper (Bambi)	Bambi characters, Disney characters, Fictional hares and rabbits
Jacmel	Cities in Haiti, 1698 establishments, 1690s establishments in North America, Establishments in the French colonial empire
Honda S2000	Honda automobiles, 2000s automobiles
Narre Warren railway station, Melbourne	Premium Melbourne railway stations
Premium station	Public transport in Melbourne
Gary the Snail	SpongeBob SquarePants characters, Fictional characters introduced in 1999
Walker Percy	1916 births, 1990 deaths, writers from Alabama
Talcott Parsons	1902 births, 1979 deaths, American sociologists, Scientists from Colorado
Edward Hopper	American artists, People from New York, 1882 births, 1967 deaths
Elias Canetti	1905 births, 1994 deaths, Austrian writers
Gao Xingjian	1940 births, Living people, Chinese Nobel Prize winners, Chinese novelists, Chinese painters, French critics, French Nobel Prize winners, French novelists, French painters, French playwrights, French screenwriters, Chinese translators, People who lost Chinese citizenship
English Renaissance drama	Plays, English literature, Literature since 1500
Blank verse	Poetry forms
Cave of Altamira	Caves, Stone Age, World Heritage Sites in Spain, Cantabria, 12 Treasures of Spain
F.C. Kuban Krasnodar	Russian football clubs, 1928 establishments, 1920s establishments in the Soviet Union
Liiga	Ice hockey leagues, Sport in Finland, 1975 establishments in Europe, 20th century establishments in Finland, 2013 disestablishments in Europe
Aurochs	Bovines
Privas	Communes in Ardèche, Departmental capitals in France
Guilherand-Granges	Communes in Ardèche
Tournon-sur-Rhône	Communes in Ardèche, Subprefectures in France
Battle of Marion	American Civil War battles, December events, 1864 in Virginia
F.C. Angusht Nazran	Russian football clubs, 1993 establishments, 1990s establishments in Russia
Union Army	Military of the United States, Union Army, 1860s in the United States
Confederate States Army	Confederate States of America
Stand Watie	1806 births, 1871 deaths, Native American people, People from Oklahoma, Cherokee Nation
George Stoneman	Governors of California, American Civil War generals, 1822 births, 1894 deaths
Cornas	Communes in Ardèche
Military history	War
Coux, Ardèche	Communes in Ardèche
Cruas	Communes in Ardèche
Davézieux	Communes in Ardèche
Désaignes	Communes in Ardèche
Félines, Ardèche	Communes in Ardèche
Jaujac	Communes in Ardèche
Joyeuse, Ardèche	Communes in Ardèche
Labégude	Communes in Ardèche
Lachapelle-sous-Aubenas	Communes in Ardèche
Chauvet Cave	Ardèche, Archaeological sites in France
Druid	Religion, Celtic peoples
Lalevade-d'Ardèche	Communes in Ardèche
Lamastre	Communes in Ardèche
Lavilledieu	Communes in Ardèche
Saint-Péray	Communes in Ardèche
La Voulte-sur-Rhône	Communes in Ardèche
Viviers, Ardèche	Communes in Ardèche
Druidism	New religious movements
Shutter (2008 movie)	2008 horror movies, 2000s mystery movies, 2000s horror thriller movies, American mystery movies, American horror thriller movies, English-language movies, Ghost movies
Rajput	History of India, Rajputs
Metcard	Public transport in Melbourne
Piety	Religious ethics
Anne of Green Gables	1908 books, British novels, English-language novels
Secondary sex characteristic	Sexuality
Poltergeist	Folklore
Pura Cup	Sports trophies and awards, Cricket
Mercy	Everyday life
Tatnet	Internet, Tatars, Tatarstan
Tatarstan	Tatarstan, Autonomous areas, Federal subjects of Russia
Charles Chesnutt	1858 births, 1932 deaths, Writers from Ohio, Writers from Cleveland, Ohio
Kansas City Royals	Kansas City Royals, 1969 establishments in the United States, 1960s establishments in Missouri
Edwidge Danticat	1969 births, Living people, Haitian people, Writers from New York City, Caribbean people
Detroit Pistons	National Basketball Association teams, Sports in Detroit, Michigan
History of the Americas	History of North America, History of South America
Lifeguard	Emergency services
A Night at the Opera (Queen album)	Queen albums, 1975 albums, Rock albums
News of the World (album)	Queen albums, 1977 albums, Rock albums
The Scream	20th century paintings
Jazz (album)	Queen albums, 1978 albums, Rock albums
The Game (album)	Queen albums, 1980 albums, Rock albums
Flash Gordon (album)	Queen albums, 1980 albums, Rock albums, Flash Gordon
Mark Speight	English television presenters, People from Staffordshire, Suicides by hanging in the United Kingdom, 1965 births, 2008 deaths
Mettingen	Steinfurt Rural District
Mauves	Communes in Ardèche
Mercuer	Communes in Ardèche
Le Pouzin	Communes in Ardèche
Quintenas	Communes in Ardèche
Rochemaure	Communes in Ardèche
Rosières, Ardèche	Communes in Ardèche
Ruoms	Communes in Ardèche
Ucel	Communes in Ardèche
Tokio Jokio	1943 movies, Looney Tunes, English-language movies
List of Solar System objects	Solar System, Astronomy lists
Daimyo	History of Japan, Samurai, Daimyo, 10th century establishments in Japan, 19th century disestablishments in Japan
Evil on Your Mind	1966 songs, Country songs
Jan Howard	1929 births, 2020 deaths, Deaths from pneumonia, American country musicians, American singer-songwriters, American country singers, Writers from Missouri, Musicians from Missouri, Singers from Missouri
Howell County, Missouri	1857 establishments in Missouri, Missouri counties
Oregon County, Missouri	Missouri counties, 1845 establishments in Missouri
Oregon Territory	19th century in the United States, History of Oregon, History of Idaho, History of Washington (U.S. state), History of Montana, 19th century in Wyoming, Former territories of the United States, Oregon Trail
Continental divide	Landforms
Terrain	Physical geography
First Baptist Church of Hammond	Baptist churches, Churches in the United States, Buildings and structures in Indiana, 1887 establishments in the United States, 19th-century establishments in Indiana
Yves Chauvin	1930 births, 2015 deaths, French chemists, French Nobel Prize winners, People from West Flanders
Robert Grubbs	1942 births, Living people, American academics, American autobiographers, American chemists, American Nobel Prize winners, Columbia University alumni, Scientists from Kentucky, University of Florida alumni
Console manufacturer	Video game companies
History of computer and video games	Video games
Jimboomba, Queensland	Towns in Queensland
Charles, Prince of Wales	English Dukes, Knights of the Garter, Order of Merit, Royalty from London, Princes and Princesses of Wales, Privy Councillors (UK), Scottish nobility, 1948 births, Living people, Elizabeth II
Formaldehyde	Organic compounds
Tulu language	Dravidian languages
SMart	BBC Television programmes, English-language television programs
Hot Space	Queen albums, 1982 albums, Rock albums
The Works (Queen album)	Queen albums, 1984 albums, Rock albums
A Kind of Magic	Queen albums, 1986 albums, Rock albums
The Miracle (album)	Queen albums, 1989 albums
Innuendo (album)	Queen albums, 1991 albums
Made in Heaven	Queen albums, 1995 albums
Sassanid Empire	History of Pakistan, History of Persia, Ancient history of Azerbaijan, Mesopotamia, Former countries in the Middle East, Royal dynasties, Empires, 224 establishments, 651 disestablishments, 3rd century establishments in Asia, Establishments in Africa, 7th century disestablishments in Asia, Disestablishments in Africa
Edguy	Power metal bands, Hard rock bands, German heavy metal bands
Turbonegro	Punk bands, Hard rock bands, Norwegian heavy metal bands
Cheek	Face
Simony	Types of crime
Flesh	Body parts
Locomotive	Locomotives
The Man Who Knew Too Much	1934 movies, 1930s thriller movies, British thriller movies, Movies directed by Alfred Hitchcock, Movies composed by Bernard Herrmann, English-language movies
Regent	Regents
Transcendental Meditation	Meditation, New religious movements
Honshū	Honshu
Most Haunted Live!	British reality television series, English-language television programs
Gerolamo Cardano	1501 births, 1576 deaths, Astrologers, Italian esotericists, Italian mathematicians, Italian physicians
Violent crime	Types of crime, Violence
Roentgenium	Transition metals
Michigan International Speedway	NASCAR tracks, 1968 establishments in the United States, 1960s establishments in Michigan, IndyCar Series tracks
International health	Health, Travel
Salam	Islam, Arabic words and phrases
Tekken (series)	Tekken, Video game series
Tekken 3	Tekken, 1998 video games
Tekken Tag Tournament	Tekken, 2000 video games, PlayStation 2 games
Tekken 4	Tekken, 2002 video games, PlayStation 2 games
Discussion	Basic English 850 words
Tekken 5	Tekken, 2004 video games
Tekken 6	Tekken, 2008 video games, PlayStation 3 games, Xbox 360 games, Video game sequels, Video games developed in Japan
Sola scriptura	Protestant theology
Human Rights Watch	Organizations in New York City, International organizations, Human rights organizations in the United States
Arms trafficking	Types of crime
Sola fide	Protestant theology
Society of Jesus	Jesuits
Rosenhan experiment	Psychiatry, Experiments
Chassiers	Communes in Ardèche
Châteaubourg, Ardèche	Communes in Ardèche
Châteauneuf-de-Vernoux	Communes in Ardèche
Dominican Order	Roman Catholic religious orders
M-Train	Australian transport companies, Public transport in Melbourne, 2004 disestablishments
Diploma	Academia, Qualifications
Authorized King James Version	King James Bible, Bible versions, 1611, 17th century works
809 Lundia	Asteroids
Hato Mayor Province	Provinces of the Dominican Republic, 1984 establishments in North America, 1980s establishments in the Dominican Republic
Rheine	Towns in North Rhine-Westphalia, Steinfurt Rural District
Recke	Steinfurt Rural District
Bryggen	World Heritage Sites in Europe, Buildings and structures in Norway
Ibbenbüren	Towns in North Rhine-Westphalia, Steinfurt Rural District
Westerkappeln	Steinfurt Rural District
Michelle Branch	1983 births, Living people, Singers from Arizona
Scanning electron microscope	Microscopes
Leporidae	Lagomorphs
Casimir III of Poland	1310 births, 1370 deaths, Kings of Poland, Piast dynasty
Thunbergia	Acanthaceae
The Pillows	Japanese musical groups, People from Hokkaido
Rio Negro (Amazon)	Rivers of Brazil, Rivers of Venezuela, Rivers of Colombia
Castella	Cakes
Mallow, County Cork	Towns in Ireland, County Cork
List of Gumby episodes	Lists of animated television series episodes
Krishnadevaraya	1509 births, 1529 deaths, Indian monarchs, Kings and queens
Tocantins River	Rivers of Brazil
Bukka	Emperors and empresses, Indian monarchs, 1356 births, 1377 deaths
McGill University	Association of American Universities, Colleges and universities in Canada, 1821 establishments in North America, 1820s establishments in Canada, Montreal
Renault Koleos	Sport utility vehicles, Renault automobiles, Busan
Beagle	Dog breeds
N. T. Rama Rao	1923 births, 1996 deaths, Indian actors, Indian movie directors, Indian movie producers, Indian politicians
Piast dynasty	Piast dynasty
M-Tram	Public transport in Melbourne, Australian transport companies
Scrooge McDuck	Fictional characters introduced in the 1940s, Fictional ducks, Disney characters
Money Bin	Fictional buildings and structures, DuckTales
Resurrection Ship	Battlestar Galactica
DIY	Construction, Culture
Boleslaw I of Poland	967 births, 1025 deaths, Polish dukes, Kings of Poland, Piast dynasty
Bo Diddley	1928 births, 2008 deaths, Cardiovascular disease deaths in the United States, Musicians from Mississippi, Singers from Mississippi
DuckTales	DuckTales, Television series by Disney, Animated television series, First run syndicated television programs, 1987 American television series debuts, 1990 American television series endings, English-language television programs
All Grown Up!	2003 American television series debuts, 2008 American television series endings, 2000s American television series, American animated television series, Nickelodeon television series, Television series set in California, Television spin-offs, English-language television programs
Randalstown	Towns in Northern Ireland, Settlements in County Antrim
Connex Melbourne	Australian transport companies, Public transport in Melbourne, Rail transport in Australia
Battlestar Galactica	Battlestar Galactica, 1978 television series debuts, 1979 television series endings
Black-capped chickadee	Birds of North America, Passeriformes
Harihara	Hindu mythology
Harihara I	Indian monarchs, 1336 births, 1356 deaths, Emperors and empresses
Tibetan people	Tibetan people, Ethnic groups in China
Li people	Ethnic groups in China
Altes Museum	Buildings and structures in Berlin, Museums in Germany
The Sleepers	1860s paintings, French paintings
Religion in China	Religion in China
Kim Ungyong	Child prodigies, South Korean people, 1963 births, Living people
Hikaru	Given names
Hikaru Nakamura	Child prodigies, People from Osaka Prefecture, American chess players, 1987 births, Living people, Chess grandmasters
Quickdraw	Rock climbing
Seedling	Plant anatomy
David Boreanaz	1969 births, Living people, American movie actors, American Roman Catholics, American television actors, American voice actors, Actors from Buffalo, New York, Actors from Philadelphia, Pennsylvania, Whedonverse, American movie directors, American movie producers, American television directors, American television producers, Saturn Award winners
Ocean	Oceans
Work (song)	Kelly Rowland songs, 2008 songs
Eluveitie	Swiss heavy metal bands, Death metal bands, Folk metal bands, Musical groups established in 2002, 2002 establishments in Europe, 2000s establishments in Finland
Heaven Shall Burn	German heavy metal bands, Death metal bands, Deathcore bands, Metalcore bands
Paranaguá	Cities in Paraná State, 1648 establishments, 17th-century establishments in Brazil
Datura stramonium	Nightshades
Indiana Jones and the Kingdom of the Crystal Skull	2008 action movies, 2000s adventure movies, Indiana Jones movies, Jungle movies, Movies set in South America, Movies set in the 1950s, Movies composed by John Williams
Indian Premier League	Indian Premier League, 2008 establishments in India
Fernando Pessoa	People from Lisbon, Portuguese writers, Deaths from liver disease, 1888 births, 1935 deaths
Gaeltacht	Gaeltacht
Harassment	Human behavior
Brná nad Labem	Villages in the Czech Republic
Goodies (song)	2004 songs, Ciara, R&B songs, Songs about sexuality
James I of Scotland	House of Stuart, Kings and Queens of Scotland, 1394 births, 1437 deaths
Shameless	2004 British television series debuts, 2000s British television series, 2010s British television series, BAFTA Award winners, British drama television series, Television series set in Manchester, English-language television programs
Stele	Archaeology, Art
Qingzang railway	Tibet, Transport in the People's Republic of China, Rail transport in Asia
Ostrava	Cities in the Czech Republic
Sleep disorder	Sleep disorders
Kirk Cameron	1970 births, Living people, Actors from Los Angeles, California, American child actors, American Evangelicals, American movie actors, American television actors, Christian ministers, Christian writers, Converts to Christianity, Creationists, Left Behind, People's Choice Award winners
Get on the Bus	Destiny's Child songs, 1999 songs
South China Sea	Geography of China, Seas of the Pacific Ocean
Leo Belgicus	Cartography
Tebibyte	Computing measurement
Petabyte	Computing measurement
Exabyte	Computing measurement
Zettabyte	Computing measurement
Yottabyte	Computing measurement
Nature's services	Economics, Ecology
Signing Time!	American television series, 2002 television series debuts, 2008 television series endings
Wuthering Heights	1847 books, English novels, English-language novels, Yorkshire
Capitol Hill Baptist Church	Southern Baptist Convention, Churches in the United States, Buildings and structures in Washington, D.C., 1877 establishments in the United States, 19th-century establishments in Washington, D.C.
Gerry and the Pacemakers	English rock bands, Musical groups from Liverpool
Left Behind (series)	Left Behind, Christian eschatology
Master Chief	Fictional characters introduced in 2001, Halo characters, Video game protagonists
Arrowhead	Ammunition
Obsidian	Gemstones, Igneous rocks
Isle of Arran	Islands of Scotland
Kurud	Towns in India, Settlements in Chhattisgarh
Germanic paganism	Paganism
Miguel Ángel Asturias	1899 births, 1974 deaths, Guatemalan writers, Guatemalan politicians
Plymouth Colony	Plymouth Colony, 1620 establishments, 1691 disestablishments
Open proxy	Computing
Zombie (computing)	Computing
Rapture	Christian eschatology
Zeeland	Zeeland
Edo period	Periods in Japanese history, Samurai, 1603 establishments, 17th century establishments in Japan, 1868 disestablishments in Japan, 1600s establishments in Asia
Graduation (album)	2007 albums, Kanye West albums, Hip hop albums
Savior	Theology
Pebibyte	Computing measurement
Exbibyte	Computing measurement
Okrouhlička	Villages in the Czech Republic
Water buffalo	Bovines
Lípa (Havlíčkův Brod District)	Villages in the Czech Republic
Věžnička	Villages in the Czech Republic
Kamenná (Jihlava District)	Villages in the Czech Republic
Větrný Jeníkov	Villages in the Czech Republic
Florida State University	Atlantic Coast Conference, Colleges and universities in Florida, Oak Ridge Associated Universities, Tallahassee, Florida, 1851 establishments in the United States, 1850s establishments in Florida
1989 Tiananmen Square protests	1989, 1980s in Asia, 20th century in China, April events, Beijing, Mass murder in the 1980s, Massacres in Asia, Politics of the People's Republic of China
Evangelism	Christian theology, Evangelicalism
Southern Baptist Convention	Southern Baptist Convention, 1845 establishments in the United States
Times Square	Town squares, Manhattan
FutureSex/LoveSounds	2006 albums, Justin Timberlake albums, Pop albums, R&B albums
Dilemma (song)	2002 songs, 2000s ballads, Kelly Rowland songs, Nelly songs
Bring Me to Life	2003 songs, Daredevil (movie series), Grammy Award winning songs, Music memes, Evanescence songs
Charybdis	Greek legendary creatures
Scylla	Greek legendary creatures, Mythology
Going commando	Slang, Underwear
Smurfette	Smurfs, Comics characters
Smuggler's Run	2000 video games, Game Boy Advance games, PlayStation 2 games
My Gym Partner's A Monkey	Animated television series, Cartoon Network series, English-language television programs, 2005 television series debuts, 2008 television series endings
Systems science	Systems scientists, Systems theory
Systems theory	Systems theory
Emotion (song)	Destiny's Child songs, 2001 songs
McDonaldland	Advertising, McDonald's
Atlético Madrid	Spanish football clubs, Madrid, 1903 establishments in Europe, 1900s establishments in Spain
Buttocks	Torso
Toyota Camry	Toyota automobiles, 1980s automobiles, 1990s automobiles, 2000s automobiles, Sedans, Front wheel drive vehicles
Kush	History of Africa, Ancient Egypt
Cybernetics	Systems, Systems theory
Complexity	Systems, Systems theory
Complex system	Systems
Control theory	Systems, Systems theory
Acura	Automobile companies of Japan, 1986 establishments in Japan
Cabal Online	Online games
Blackletter	Middle Ages, Typography, Writing
Super Smash Bros.	Super Smash Bros., 1999 video games, Nintendo 64 games, Virtual Console games
Falkland Islands wolf	Canids
SNoW	1985 births, Living people, Singers from Tokyo
Funnel cloud	Clouds
Wallington High School	Schools in New Jersey
Waterspout	Weather
Bob Jones University	Colleges and universities in South Carolina, Greenville, South Carolina, 1917 establishments in the United States, Christian colleges and universities in the United States, 20th-century establishments in South Carolina
Mordecai Ham	1877 births, 1961 deaths, American Baptists, Christian religious leaders, Evangelists, People from Kentucky
Charles Templeton	1915 births, 2001 deaths, Deaths from Alzheimer's disease, Canadian politicians, Cartoonists, Canadian journalists, Canadian inventors, Canadian writers, People from Toronto
Billy Graham Evangelistic Association	Christian organizations
Washington National Cathedral	Anglican Cathedrals, Cathedrals in the United States, Buildings and structures in Washington, D.C.
United States Postal Service	United States Postal Service, 1971 establishments in the United States
Parkinson's disease	Parkinson's disease
Samford University	Christian colleges and universities in the United States, Colleges and universities in Alabama, 1841 establishments in the United States, 1840s establishments in Alabama
Hainanese chicken rice	Rice dishes
Vortex	Fluid mechanics
Libertia	Iridaceae
Alan Dawazhouma	1987 births, Living people, C-pop singers, Chinese musicians, Chinese singers, J-pop singers, People from Sichuan, Pop musicians, Tibetan people
V/Line	Public transport in Melbourne, Australian transport companies
Carpool	Road transport
Middleweight	Boxing
Moneymore	Villages in Northern Ireland
Denpasar	Cities in Indonesia, Bali
Toome	Villages in Northern Ireland, Settlements in County Antrim
Kuta	Bali, Towns in Indonesia
An Inconvenient Truth	2006 movies, Climate change, American documentary movies, Energy, Green politics, Movies that won the Best Original Song Academy Award
Gary Megson	English football managers
Matt Hardy	1974 births, American professional wrestlers, Former WWE wrestlers, Living people, Sportspeople from Raleigh, North Carolina, Total Nonstop Action Wrestling alumni, American bloggers
Kerobokan Prison	Prisons, Bali, Buildings and structures in Indonesia
Edmund Spenser	1552 births, 1599 deaths, People buried in Westminster Abbey, English poets, British poets laureate
Papuan languages	Languages
Lombok	Lombok, Islands of Indonesia, Lesser Sunda Islands, Australasia, Gondwana
The Faerie Queene	16th-century British poems, Epic poems
Torres Strait Islanders	Indigenous peoples of Australia, Queensland
Australian megafauna	Lists of animals, Animals of Australia
Omagh bombing	1998 in the United Kingdom, 1990s crimes in the United Kingdom, 1990s explosions, 1990s in Northern Ireland, 1990s murders in Europe, Attacks on buildings and structures in Northern Ireland, Attacks on buildings and structures in the 1990s, August events, Building bombings in the United Kingdom, Car and truck bombings in Europe, County Tyrone, Explosions in Northern Ireland, Irish Republican Army, Mass murder in Northern Ireland, Mass murder in the 1990s, Massacres in the United Kingdom, Terrorist incidents in the 1990s, The Troubles
Themis (hypothetical moon)	Saturn's moons
Real Irish Republican Army	Northern Ireland, Nationalist organizations in Europe, National liberation movements, Irish Republican Army, 1997 establishments in the United Kingdom, Organisations based in the United Kingdom
The Life and Times of Scrooge McDuck	Comic books, Disney
General Certificate of Secondary Education	General Certificate of Secondary Education, Education in the United Kingdom
Edo	History of Tokyo, 1457 establishments, Establishments in Japan, 1868 disestablishments in Japan, 15th century establishments in Asia
Renault Vel Satis	Renault automobiles
Korean food	Korean food
Cryptanalysis	Mathematics
International General Certificate of Secondary Education	Education
Sánchez Ramírez Province	Provinces of the Dominican Republic, 1952 establishments in the Dominican Republic
Diane Abbott	1953 births, Living people, Alumni of the University of Cambridge, BBC people, Black British people, British feminists, Democratic socialists, Labour MPs (UK), Members of the British House of Commons for English constituencies, People from Paddington, Politicians from London, UK MPs 1987–1992, UK MPs 1992–1997, UK MPs 1997–2001, UK MPs 2001–2005, UK MPs 2005–2010, UK MPs 2010–2015, UK MPs 2015–2017, UK MPs 2017–2019, UK MPs 2019–, Women politicians
Hywel Francis	1946 births, 2021 deaths, British historians, Former Labour MPs (UK), Former members of the British House of Commons for Welsh constituencies, UK MPs 2001–2005, UK MPs 2005–2010, UK MPs 2010–2015
Frank Doran	1949 births, 2017 deaths, Members of the British House of Commons for Scottish constituencies, Labour MPs (UK)
Anne Begg	1955 births, Living people, Members of the British House of Commons for Scottish constituencies, Labour MPs (UK)
John Reid, Baron Reid of Cardowan	1947 births, Living people, Former members of the British House of Commons for Scottish constituencies, Former Labour MPs (UK)
Gerald Howarth	1947 births, Living people, Members of the British House of Commons for English constituencies, Conservative MPs (UK)
Mount Agung	Bali, Volcanoes of Indonesia
Mount Batur	Bali, Volcanoes of Indonesia
Mount Rinjani	Lombok, Volcanoes of Indonesia
Mataram	Lombok, Cities in Indonesia, West Nusa Tenggara
Megawati Sukarnoputri	1947 births, Living people, Muslims, Presidents of Indonesia, Vice-Presidents of Indonesia
Kingdom of Kerma	History of Africa, Ancient Egypt
Aladdin (1992 movie)	1992 romance movies, 1990s adventure movies, 1990s musical movies, Aladdin (Disney), American family movies, American musical movies, American romance movies, Disney animated movies, Disney Renaissance, Movies based on fairy tales, Movies composed by Alan Menken, Movies composed by Harry Gregson-Williams
D. B. Cooper	American criminals, Mysterious people, Missing people
Alistair Darling	1953 births, Living people, Chancellors of the Exchequer, Labour MPs (UK), UK MPs 1987–1992, UK MPs 1992–1997, UK MPs 1997–2001, UK MPs 2001–2005, UK MPs 2005–2010, UK MPs 2010–2015, Members of the British House of Commons for Scottish constituencies
Moa	Birds of New Zealand, Ratites, Extinct species, Flightless birds, Struthioniformes, Megafauna
Malacology	Branches of zoology, Molluscs
Placard	Human communication
Budíkov	Villages in the Czech Republic
Typha	Poales
Sickle-cell disease	Diseases, Genetic disorders, Blood
David Miliband	1965 births, Living people, Alumni of the University of Oxford, British atheists, Former Labour MPs (UK), Jewish atheists, Jewish British politicians, Members of the British House of Commons for English constituencies, People from Camden (London borough), Politicians from London, UK MPs 2001–2005, UK MPs 2005–2010, UK MPs 2010–2015
Jack Straw	1946 births, Living people, English Anglicans, Former Labour MPs (UK), Former members of the British House of Commons for English constituencies, Lord Chancellors, Politicians from Essex, Privy Councillors (UK), Secretaries of State for the Home Department, Secretaries of State of the United Kingdom, UK MPs 1979–1983, UK MPs 1983–1987, UK MPs 1987–1992, UK MPs 1992–1997, UK MPs 1997–2001, UK MPs 2001–2005, UK MPs 2005–2010, UK MPs 2010–2015
Jacqui Smith	1962 births, Living people, Alumni of the University of Oxford, Former Labour MPs (UK), Former members of the British House of Commons for English constituencies, Politicians from Worcestershire, Secretaries of State for the Home Department, BBC 100 Women
Des Browne, Baron Browne of Ladyton	1952 births, Living people, Former members of the British House of Commons for Scottish constituencies, Former Labour MPs (UK)
Alan Johnson	Labour MPs (UK), Members of the British House of Commons for English constituencies, Politicians from London, 1950 births, Living people
Hilary Benn	Labour MPs (UK), Members of the British House of Commons for English constituencies, Politicians from London, 1953 births, Living people
Douglas Alexander	1967 births, Living people, Members of the British House of Commons for Scottish constituencies, Labour MPs (UK)
John Hutton, Baron Hutton of Furness	1955 births, Living people, Former members of the British House of Commons for English constituencies, Former Labour MPs (UK), UK MPs 1992–1997, UK MPs 1997–2001, UK MPs 2001–2005, UK MPs 2005–2010, United Kingdom Life Peers
Harriet Harman	British feminists, Labour MPs (UK), Leaders of the Opposition (United Kingdom), Members of the British House of Commons for English constituencies, Politicians from London, 1950 births, Living people
James Purnell	1970 births, Living people, Former members of the British House of Commons for English constituencies, Former Labour MPs (UK)
Paul Murphy, Baron Murphy of Torfaen	1948 births, Living people, Members of the British House of Commons for Welsh constituencies, Labour MPs (UK)
Ruth Kelly	1968 births, Living people, Former members of the British House of Commons for English constituencies, Former Labour MPs (UK)
Hazel Blears	1956 births, Living people, Members of the British House of Commons for English constituencies, Labour MPs (UK)
Geoff Hoon	1953 births, Living people, Former Labour MPs (UK), Former members of the British House of Commons for English constituencies, People from Derby
Ed Balls	1967 births, Living people, Alumni of the University of Oxford, Co-operative movement, Harvard University alumni, Labour MPs (UK), Members of the British House of Commons for English constituencies, People from Norwich, Politicians from Nottinghamshire, UK MPs 2005–2010, UK MPs 2010–2015
Ed Miliband	1969 births, Living people, Jewish British politicians, Labour MPs (UK), Leaders of the Labour Party (UK), Leaders of the Opposition (United Kingdom), Members of the British House of Commons for English constituencies, People from Camden (London borough), Politicians from London, Privy Councillors (UK), Secretaries of State of the United Kingdom, UK MPs 2005–2010, UK MPs 2010–2015, UK MPs 2015–2017, UK MPs 2017–2019, UK MPs 2019–
Andy Burnham	Labour MPs (UK), Members of the British House of Commons for English constituencies, UK MPs 2001–2005, UK MPs 2005–2010, UK MPs 2010–2015, UK MPs 2015–2017, Privy Councillors (UK), British socialists, British feminists, English Roman Catholics, People from Merseyside, People from Warrington, Politicians from Lancashire, 1970 births, Living people, Alumni of the University of Cambridge
Shaun Woodward	1958 births, Living people, English politicians, Former Conservative MPs (UK), Labour MPs (UK), Members of the British House of Commons for English constituencies, People from Bristol
Yvette Cooper	1969 births, Living people, Labour MPs (UK), Members of the British House of Commons for English constituencies, People from Inverness, Scottish politicians
John Denham	1953 births, Living people, Members of the British House of Commons for English constituencies, Labour MPs (UK)
Limnology	Earth sciences
Toyota RAV4	1990s automobiles, 2000s automobiles, 2010s automobiles, 2020s automobiles, Toyota automobiles
Toyota MR2	1980s automobiles, 1990s automobiles, 2000s automobiles, Toyota automobiles
Wheaton College	Colleges and universities in Illinois, Council for Christian Colleges and Universities, Oberlin Group of Libraries, 1860 establishments in the United States, 1860s establishments in Illinois
Sacred site	Religious places
Basil II	Byzantine Emperors
Battle of Manzikert	Byzantine Empire, Battles of the Middle Ages, 1071, August events
Mark Lawrenson	1957 births, Living people, Liverpool F.C. players
Red Square	Moscow, World Heritage Sites in Russia, National squares
George I of Great Britain	1660 births, 1727 deaths, Kings and Queens of Great Britain, People from Osnabrück
Official Opposition (United Kingdom)	Politics of the United Kingdom
Leader of the Opposition (United Kingdom)	Leaders of the Opposition (United Kingdom), Opposition leaders
David Davis	1948 births, Living people, Conservative MPs (UK), Libertarians, Members of the British House of Commons for English constituencies, People from York, Politicians from Yorkshire, Privy Councillors (UK), Secretaries of State of the United Kingdom, UK MPs 1987–1992, UK MPs 1992–1997, UK MPs 1997–2001, UK MPs 2001–2005, UK MPs 2005–2010, UK MPs 2010–2015, UK MPs 2015–2017, UK MPs 2017–2019, UK MPs 2019–
William Hague	1961 births, Living people, Alumni of the University of Oxford, English historians, Former Conservative MPs (UK), Former members of the British House of Commons for English constituencies, Leaders of the Conservative Party (UK), Leaders of the Opposition (United Kingdom), Politicians from Yorkshire, Privy Councillors (UK), Royal Society of Literature, Secretaries of State of the United Kingdom, UK MPs 1987–1992, UK MPs 1992–1997, UK MPs 1997–2001, UK MPs 2001–2005, UK MPs 2005–2010, UK MPs 2010–2015
George Osborne	1971 births, Living people, Chancellors of the Exchequer, Conservative MPs (UK), Members of the British House of Commons for English constituencies, Politicians from London, UK MPs 2001–2005, UK MPs 2005–2010, UK MPs 2010–2015, UK MPs 2015–2017
Trojanus of Saintes	Christian saints, French Roman Catholics, Year of birth unknown, 530 deaths
530	530
Celestus microblepharis	Anguids
Anguidae	Anguids
Celestus	Anguids
Celestus warreni	Anguids
Duquesney's galliwasp	Anguids
Celestus fowleri	Anguids
Jamaica giant galliwasp	Anguids
Tammy Wynette	American country musicians, American guitarists, Deaths from pulmonary thrombosis, Cardiovascular disease deaths in the United States, Musicians from Mississippi, Singers from Mississippi, 1942 births, 1998 deaths
Tricity	Cities in Poland
Kaliningrad Oblast	Kaliningrad Oblast, Oblasts of Russia, Federal subjects of Russia
Coat of arms of Poland	Polish culture, National coats of arms
Christianization	Christian terminology, Religious conversion, Culture
Adam Sandler	1966 births, Living people, Actors from New Hampshire, Actors from Brooklyn, American movie actors, Jewish American actors, Comedians from New York City, Movie producers from New York City, Musicians from New York City, Singers from New York City, Musicians from New Hampshire, Singers from New Hampshire, Screenwriters from New York City, Writers from Brooklyn
Anguis	Anguids
Anguis fragilis	Anguids
Major League Baseball on ESPN Radio	Major League Baseball, Radio programs
Calixa Lavallée	1842 births, 1891 deaths, Canadian composers, Romantic composers
Sepsis	Diseases
Patrick McLoughlin	1957 births, Living people, UK MPs 1983–1987, UK MPs 1987–1992, UK MPs 1992–1997, UK MPs 1997–2001, UK MPs 2001–2005, UK MPs 2005–2010, UK MPs 2010–2015, UK MPs 2015–2017, UK MPs 2017–2019, Members of the British House of Commons for English constituencies, Conservative MPs (UK)
Oliver Letwin	1956 births, Living people, Alumni of the University of Cambridge, Former Conservative MPs (UK), Former members of the British House of Commons for English constituencies, Jewish British politicians, Politicians from London
Caroline Spelman	1958 births, Living people, Former Conservative MPs (UK), Former members of the British House of Commons for English constituencies, Politicians from Hertfordshire, Privy Councillors (UK), Secretaries of State of the United Kingdom, UK MPs 1997–2001, UK MPs 2001–2005, UK MPs 2005–2010, UK MPs 2010–2015, UK MPs 2015–2017, UK MPs 2017–2019, Women politicians
Philip Hammond	1955 births, Living people, Alumni of the University of Oxford, Chancellors of the Exchequer, Conservative MPs (UK), Members of the British House of Commons for English constituencies, Politicians from Essex, UK MPs 1997–2001, UK MPs 2001–2005, UK MPs 2005–2010, UK MPs 2010–2015, UK MPs 2015–2017, UK MPs 2017–2019
Andrew Mitchell	1956 births, Living people, Conservative MPs (UK), Members of the British House of Commons for English constituencies, Politicians from London
David Mundell	1962 births, Living people, Gay men, Members of the British House of Commons for Scottish constituencies, LGBT politicians, Conservative MPs (UK), Scottish LGBT people
Cheryl Gillan	1952 births, 2021 deaths, Former Conservative MPs (UK), Members of the British House of Commons for English constituencies, People from Cardiff, Politicians from Glamorgan, Disease-related deaths in England
Owen Paterson	1956 births, Living people, Members of the British House of Commons for English constituencies, Conservative MPs (UK)
Alan Duncan	1957 births, Living people, Conservative MPs (UK), English LGBT people, Gay men, LGBT politicians, Members of the British House of Commons for English constituencies, Politicians from Hertfordshire
Theresa May	1956 births, Living people, Alumni of the University of Oxford, Commonwealth Chairpersons-in-Office, Conservative MPs (UK), English Anglicans, Leaders of the Conservative Party (UK), Members of the British House of Commons for English constituencies, People from Eastbourne, People from Oxfordshire, Politicians from Sussex, Privy Councillors (UK), Secretaries of State for the Home Department, UK MPs 1997–2001, UK MPs 2001–2005, UK MPs 2005–2010, UK MPs 2010–2015, UK MPs 2015–2017, UK MPs 2017–2019, UK MPs 2019–, Women politicians
Francis Maude	1953 births, Alumni of the University of Cambridge, British lawyers, Conservative MPs (UK), English politicians, Living people, Members of the British House of Commons for English constituencies, People from Berkshire
Jeremy Hunt	1966 births, Living people, Alumni of the University of Oxford, Conservative MPs (UK), UK MPs 2005–2010, UK MPs 2015–2017, UK MPs 2017–2019, Members of the British House of Commons for English constituencies, Politicians from London
Eric Pickles	1952 births, Living people, Conservative MPs (UK), Members of the British House of Commons for English constituencies, Politicians from Yorkshire
Peter Ainsworth	1956 births, 2021 deaths, UK MPs 1992–1997, UK MPs 1997–2001, UK MPs 2001–2005, UK MPs 2005–2010, Former members of the British House of Commons for English constituencies, Former Conservative MPs (UK)
Chris Grayling	1962 births, Living people, Members of the British House of Commons for English constituencies, Conservative MPs (UK)
Nick Herbert	1963 births, Living people, Members of the British House of Commons for English constituencies, Conservative MPs (UK)
Theresa Villiers	1968 births, Living people, Conservative MPs (UK), Former MEPs, Members of the British House of Commons for English constituencies, MEPs for the United Kingdom
Andrew Lansley	1956 births, Living people, Commanders of the Order of the British Empire, English Anglicans, Former Conservative MPs (UK), Former members of the British House of Commons for English constituencies, Politicians from Essex, Privy Councillors (UK), Secretaries of State of the United Kingdom, UK MPs 1997–2001, UK MPs 2001–2005, UK MPs 2005–2010, UK MPs 2010–2015, United Kingdom Life Peers
David Willetts	1956 births, Living people, Conservative MPs (UK), Members of the British House of Commons for English constituencies, Politicians from Birmingham
Michael Gove	1967 births, Living people, Alumni of the University of Oxford, BBC newsreaders and journalists, British adoptees, British Anglicans, British columnists, British journalists, Conservative MPs (UK), Members of the British House of Commons for English constituencies, People from Aberdeen, Politicians from Edinburgh, Privy Councillors (UK), Scottish Christians, Secretaries of State of the United Kingdom, UK MPs 2005–2010, UK MPs 2010–2015, UK MPs 2015–2017, UK MPs 2017–2019, UK MPs 2019–
Liam Fox	1961 births, Living people, Scottish politicians, Members of the British House of Commons for English constituencies, UK MPs 1992–1997, UK MPs 1997–2001, UK MPs 2001–2005, UK MPs 2005–2010, UK MPs 2010–2015, UK MPs 2015–2017, UK MPs 2017–2019, Conservative MPs (UK), Privy Councillors (UK)
Missionary	Missionaries, Christian religious occupations
Partnership	Society, Business
Ruth Graham	1920 births, 2007 deaths, American painters, American philanthropists, American poets, American Presbyterians, Deaths from pneumonia, Writers from North Carolina
Patrick Star	Fictional characters introduced in 1999, SpongeBob SquarePants characters, Television characters
Nick Clegg	1967 births, Living people, Alumni of the University of Cambridge, Deputy Prime Ministers of the United Kingdom, Former Liberal Democrats MPs (UK), Former members of the British House of Commons for English constituencies, Former MEPs, Leaders of the Liberal Democrats (UK), MEPs for the United Kingdom, People educated at Westminster School, London, Politicians from Buckinghamshire, Privy Councillors (UK), UK MPs 2005–2010, UK MPs 2010–2015, UK MPs 2015–2017
Magnús Eiríksson	1806 births, 1881 deaths, Christian theologians, Icelandic writers, Lutherans, Unitarians
John Wark	1957 births, Living people, Scottish footballers
Nusa Penida	Bali, Islands of Indonesia
Dungeons & Dragons	Role-playing games
Sakoku	History of Japan
Borneo	Islands of Malaysia, Islands of Brunei, Islands of Indonesia, Greater Sunda Islands
List of islands by area	Lists of islands
Baffin Island	Islands of Canada, Nunavut
Substitution cipher	Cryptography
Ken Spreitzer	1965 births, Living people, Computer scientists
Brandy & Mr. Whiskers	2004 television series debuts, 2006 television series endings, Animated television series, Television shows about rabbits and hares, Television series by Disney, Television series by Buena Vista Television
Dwyane Wade	1982 births, Living people, American basketball players, American Olympic gold medalists, Miami Heat players, Sportspeople from Chicago
Himalayan wolf	Wolves, Mammals of Pakistan, Plants and animals of Kashmir
Angelroda	Settlements in Thuringia, Villages in Germany
Hull, Florida	Unincorporated communities in Florida
Seii	Kings and queens, 1326 births, 1354 deaths, People from Okinawa Prefecture
Cecil Rhodes	1853 births, 1902 deaths, South African businesspeople
Kaioo	Web 2.0, Non-profit organizations, Social networking
Akira Toriyama	Japanese manga artists, 1955 births, Living people, People from Aichi Prefecture
I. M. Pei	1917 births, 2019 deaths, American architects, American centenarians, Chinese people, Pritzker Prize winners, Guangzhou
Isaac Bashevis Singer	1902 births, 1991 deaths, American Nobel Prize winners, American novelists, American short story writers, Jewish American writers, Jewish Nobel Prize winners, Naturalized citizens of the United States, Polish Jews, Polish Nobel Prize winners
John von Neumann	1903 births, 1957 deaths, American mathematicians, American physicists, Cancer deaths in the United States, Disease-related deaths in Washington, D.C., Hungarian scientists, People from Budapest, Systems scientists
Iwan Roberts	1968 births, Living people, Welsh footballers
Ballpoint pen	Writing tools
Bando kickboxing	Kickboxing
Spratly Islands	Islands  of Asia
Sumba	Islands of Indonesia, Lesser Sunda Islands
Gili Trawangan	Islands of Indonesia, Lesser Sunda Islands, Lombok
Gili Meno	Islands of Indonesia, Lesser Sunda Islands, Lombok
Gili Air	Islands of Indonesia, Lesser Sunda Islands, Lombok
Gili Islands	Islands of Indonesia, Lesser Sunda Islands, Lombok
Cidomo	Animal-powered vehicles, Horses, Transport in Indonesia
Grease (musical)	Broadway musicals, West End musicals, 1970s musicals
Ryan Giggs	1973 births, Living people, 2012 Summer Olympics, British Olympians, Manchester United F.C. players, Sportspeople from Cardiff, Welsh football managers, Welsh footballers
Ian Rush	1961 births, Living people, Liverpool F.C. players, Welsh footballers, Welsh football managers
Ogoh-ogoh	Bali, Hinduism, Mythology
Padangbai	Bali, Towns in Indonesia
Tokugawa shogunate	History of Japan, Samurai, 1603 establishments, 17th century establishments in Japan, 1600s establishments in Asia
Liberal Democrats (UK)	Liberal Democrats (UK), 1988 establishments in the United Kingdom, Liberal parties
Houten	Settlements in Utrecht (province), Municipalities of Utrecht (province)
Northampton	County towns in England, Northampton
West Slavs	Slavic peoples
WWE Judgment Day	WWE Judgment Day
Tokugawa Ieyasu	Shoguns, 1543 births, 1616 deaths, People from Aichi Prefecture
Billy Graham Center	Christian organizations, 1981 establishments in the United States
Revival meeting	Christian behavior and experience, Christian worship and liturgy
Bob Jones, Sr.	1883 births, 1968 deaths, American Methodists, Christian religious leaders, Evangelists, People from Greenville, South Carolina
Auditorium	Buildings and structures, Rooms
Pulpit	Church architecture
Level crossing	Rail transport, Traffic signs
Macaulay Culkin	1980 births, Living people, Actors from New York City, American movie actors, American television actors, American voice actors, Musicians from New York City, Singers from New York City
Tencent QQ	Instant messaging software
Princess Jasmine	Aladdin (Disney) characters, Fictional Arabs, Fictional characters introduced in 1992, Fictional princesses, Kingdom Hearts characters
Fürstenfeldbruck (district)	Rural Districts in Upper Bavaria
José Zorrilla y Moral	1817 births, 1893 deaths, Spanish poets
Ottobrunn	Munich Rural District
Aying	Munich Rural District
Höhenkirchen-Siegertsbrunn	Munich Rural District
Habitation at Port-Royal	History of Canada
Mi'kmaq	Native American, Canadian people
Wang Xiaobo	1952 births, 1997 deaths, Chinese writers
Chengdu	Cities in China
Hohenbrunn	Munich Rural District
Albert Schweitzer	1875 births, 1965 deaths, 19th century philosophers, 20th century philosophers, Christian ministers, French Christians, French Nobel Prize winners, French organists, French philosophers, French scientists, French theologians, German academics, German doctors, German Lutherans, German Nobel Prize winners, German organists, German philosophers, German theologians, Humanitarians, Lutherans, Order of Merit, People from Grand Est
Coweta, Oklahoma	Cities in Oklahoma
Tularemia	Diseases caused by bacteria
Neubiberg	Munich Rural District
Brunnthal	Munich Rural District
Putzbrunn	Munich Rural District
Unterföhring	Munich Rural District
Fur trade	Commerce, Trade routes
Argyle, Wisconsin	Villages in Wisconsin, Lafayette County, Wisconsin
Miyuki Komatsu	Japanese movie actors, 1971 births, Living people, People from Fukushima Prefecture
Aschheim	Munich Rural District
NetSolve	American technology companies
Third-person shooter	Shooter video games, Types of video games, Video game genres
Klaus Ebner	1964 births, Living people, Austrian writers, Austrian poets
Wagoner County, Oklahoma	Oklahoma counties, 1907 establishments in Oklahoma
Tulsa County, Oklahoma	Oklahoma counties, 1907 establishments in Oklahoma
National Register of Historic Places	National Register of Historic Places, 1966 establishments in the United States
Wagoner, Oklahoma	County seats in Oklahoma, Cities in Oklahoma
Muskogee County, Oklahoma	Oklahoma counties, 1907 establishments in Oklahoma
Polans	Slavic peoples, Polish people
Cherokee County, Oklahoma	Oklahoma counties, 1907 establishments in Oklahoma
Mao	Settlements in Dominican Republic, 1875 establishments in North America, 19th-century establishments in the Spanish West Indies
Mayes County, Oklahoma	Oklahoma counties, 1907 establishments in Oklahoma
Rogers County, Oklahoma	Oklahoma counties, 1907 establishments in Oklahoma
Koweta Mission Site	Christian organizations
Sean Hannity	1961 births, Living people, Television talk show hosts, American conservatives, Writers from New York City
Brett Favre	Atlanta Falcons players, Green Bay Packers players, Minnesota Vikings players, New York Jets players, Sportspeople from Mississippi, American football quarterbacks, 1969 births, Living people
Headline	Newspaper publishing
Transistor–transistor logic	Electronics
Northwest Ordinance	United States federal legislation, 1787 in the United States
Protactinium	Actinides, Chemical elements
Troy Aikman	1966 births, Living people, Dallas Cowboys players, American football quarterbacks, Football players from California
Johnny Unitas	1933 births, 2002 deaths, Pittsburgh Steelers players, San Diego Chargers players, Sportspeople from Pittsburgh, Pennsylvania, American football quarterbacks
Dick Butkus	1942 births, Living people, American football linebackers, Chicago Bears players, Sportspeople from Chicago
Mike Ditka	1939 births, Living people, American football tight ends, Chicago Bears players, Dallas Cowboys players, New Orleans Saints players, Philadelphia Eagles players, Sportspeople from Pennsylvania, Sportspeople from Chicago, National Football League coaches
The Sean Hannity Show	Radio programs
John Elway	1960 births, Living people, American football quarterbacks, Denver Broncos players, Sportspeople from Washington
Detroit Lions	Detroit Lions
Michael Irvin	American football wide receivers, Dallas Cowboys players, Sportspeople from Florida, People from Fort Lauderdale, Florida, 1966 births, Living people
Howie Long	American football defensive ends, National Football League players, Oakland Raiders players, Sportspeople from Massachusetts, 1960 births, Living people
Hoang Hoa Tham	Vietnamese people, 1858 births, 1913 deaths
Pro Football Hall of Fame	Pro Football Hall of Fame, Canton, Ohio, 1963 establishments in the United States, 1960s establishments in Ohio
Cypress	Cupressaceae
Míkmaq language	Languages of North America
Los Angeles Chargers	National Football League teams, Sports in Los Angeles
Metal leaf	Metals
Foo Fighters	1994 establishments in Washington (state), 1990s American music groups, 2000s American music groups, 2010s American music groups, American rock bands, Brit Award winners, Grammy Award winners, Grunge bands, Musical groups established in 1994, Musical groups from Seattle, Washington, Post-grunge bands
Ronnie O'Sullivan	1975 births, Living people, Snooker players, Sportspeople from Essex, Sportspeople from West Midlands (county)
Rain (entertainer)	South Korean singers, 1982 births, Living people, K-pop singers
Algonquian languages	Languages of North America
Ismaning	Munich Rural District
Grünwald, Bavaria	Munich Rural District
Kirchheim bei München	Munich Rural District
Haar, Bavaria	Munich Rural District
Garching bei München	Munich Rural District
Taufkirchen (bei München)	Munich Rural District
Arena Football League	Arena Football League
Elmo	Sesame Street characters, Muppets
San Francisco 49ers	San Francisco 49ers, 1946 establishments in the United States, 1940s establishments in California
Tennessee Titans	Nashville, Tennessee, National Football League teams, 1960 establishments in the United States, 1960s establishments in Tennessee
Mumps	Diseases caused by viruses
Civilian Conservation Corps	20th century in the United States, Franklin D. Roosevelt, New Deal, Great Depression
Killer app	Video games
Chiang Mai	Cities in Thailand
Hyōgo Prefecture	Hyōgo Prefecture, Prefectures of Japan
Adelaide Zoo	Buildings and structures in Australia, Adelaide, Zoos in Australia
Ruth Harkness	1900 births, 1947 deaths, American fashion designers, American socialites
Brookfield Zoo	Buildings and structures in Chicago, Illinois, Zoos in Illinois
Shirahama, Wakayama	Towns in Japan, Settlements in Wakayama Prefecture
Wakayama Prefecture	Wakayama Prefecture, Prefectures of Japan
Webcast	Internet
Kansas City Chiefs	Kansas City Chiefs, 1960 establishments in the United States, 1960s establishments in Missouri
Jacksonville Jaguars	National Football League teams, Jacksonville, Florida, 1995 establishments in the United States, 1990s establishments in Florida
Houston Texans	National Football League teams, Sports in Houston, Texas
Cleveland Browns	National Football League teams, Sports in Cleveland, Ohio
Cincinnati Bengals	Cincinnati Bengals, Sports in Cincinnati, Ohio, 1968 establishments in the United States, 1960s establishments in Ohio
Commentary	Television, Radio
Kelvedon	Towns in Essex
Baltimore Ravens	Baltimore Ravens, 1996 establishments in Maryland
Buffalo Bills	1959 establishments in the United States, Buffalo Bills, 1950s establishments in New York (state)
Washington Football Team	National Football League teams
Super Princess Peach	2005 video games, Mario platform games, Nintendo DS games, Nintendo DS-only games
Minnesota Vikings	Sports in Minneapolis, Minnesota, National Football League teams, 1961 establishments in the United States, 1960s establishments in Minnesota
Reno, Nevada	Cities in Nevada, County seats in Nevada
Wolong National Nature Reserve	People's Republic of China, Biosphere reserves
Charles Spurgeon	1834 births, 1892 deaths, Charles Spurgeon, Baptists, Christian ministers, Christian religious leaders, Christian theologians, Christian writers, English autobiographers, English Protestants, English theologians, Evangelists, Writers from Suffolk
George Müller	1805 births, 1898 deaths, Autobiographers, British Protestants, Evangelicals, Evangelists, German Protestants, Missionaries, Naturalised citizens of the United Kingdom, People from Saxony-Anhalt
Spectacled bear	Ursidaes
Convergent evolution	Evolution
Michelangelo Antonioni	Italian movie directors, Italian screenwriters, People from Ferrara, 1912 births, 2007 deaths
Salvador de Madariaga	1886 births, 1978 deaths, Spanish writers, Spanish historians, People from A Coruña
Bislama	Languages, Vanuatu
Tariq Ramadan	1962 births, Living people, Muslims, Theologians, Swiss people, People from Geneva
Unterschleißheim	Munich Rural District
Baierbrunn	Munich Rural District
Fitna	2008 movies, Multilingual movies
Geert Wilders	1963 births, Living people, Dutch councillors, Dutch party chairs, Islamophobia, Independent politicians in the Netherlands, Leaders of political parties in the Netherlands, Members of the House of Representatives of the Netherlands, Nationalists, Party for Freedom politicians, People from The Hague, People from Utrecht (city), People from Venlo, People's Party for Freedom and Democracy politicians, Politicians from Limburg (Netherlands), Writers from Limburg (Netherlands)
Cessna 182	Civil aircraft, Cessna aircraft
Asparagus	Vegetables, Asparagales
Armand David	1826 births, 1900 deaths, French botanists, French Roman Catholics, Missionaries, French zoologists
Père David's deer	Deer, Mammals of Asia
Finite element method	Differential equations, Engineering
Sipoo	Municipalities of Uusimaa
Slow	Basic English 850 words
Collar	Basic English 850 words, Clothing
Frame	Basic English 850 words
Parcel	Basic English 850 words
Land hemisphere	Hemispheres
Water hemisphere	Hemispheres, Oceans, Geography
Pasadena, California	Pasadena, California, 1874 establishments in California
202 BC	200s BC
Surprise	Basic English 850 words
Red fox	Foxes, Mammals of North America, Mammals of Europe, Mammals of Asia, Mammals of Australia
Royal Surrey Gardens	Botanical gardens in the United Kingdom, Buildings and structures in London, Charles Spurgeon
Iron Man (movie)	2008 science fiction movies, 2000s superhero movies, American science fiction movies, English-language movies, Iron Man movies, Movies directed by Jon Favreau, Movies set in Afghanistan, Movies set in Los Angeles, California, Marvel Cinematic Universe movies
Molar	Teeth
Qinling Mountains	Mountains of China
Love in This Club Part II	2008 songs, Usher songs, Beyoncé songs
Lower Silesian Voivodeship	1999 establishments in Europe, Voivodeships of Poland
Unterhaching	Munich Rural District
Air France-KLM	Airlines of Europe, Airlines of France
Oberschleißheim	Munich Rural District
Gräfelfing	Munich Rural District
Neuried, Bavaria	Munich Rural District
Oberhaching	Munich Rural District
Upper Bavaria	Upper Bavaria
Ansbach	Ansbach (district), Towns in Bavaria
Kempten	Swabia, Bavaria
USA Today	Newspapers in the United States, 1982 establishments in the United States, English-language television programs
Cologne Cathedral	Buildings and structures in North Rhine-Westphalia, Cathedrals in Germany, Cologne, Roman Catholic Cathedrals, World Heritage Sites in Germany, 1248 establishments, 1240s establishments in Europe, 13th-century establishments in Germany
T.N.T. (album)	AC/DC albums, 1975 albums, Hard rock albums, Rock and roll albums, Blues rock albums
Taxi (TV series)	1978 establishments in the United States, 1978 television series debuts, 1983 disestablishments in the United States, 1970s American sitcoms, 1970s American workplace television series, 1970s workplace comedy television series, 1980s American sitcoms, 1980s American workplace television series, 1980s workplace comedy television series, American workplace comedy television series, NBC network shows, Television series about friendship, Television series set in New York City, English-language television programs
Amiens Cathedral	Roman Catholic Cathedrals, Cathedrals in France, Amiens, World Heritage Sites in France
Auburn University	Colleges and universities in Alabama, Oak Ridge Associated Universities, Southeastern Conference, 1856 establishments in the United States, 1850s establishments in Alabama
Baltimore Orioles	Baltimore Orioles, 1900s establishments in the United States, 20th-century establishments in Maryland
Arizona Diamondbacks	Arizona Diamondbacks, Sports in Phoenix, Arizona, 1998 establishments in the United States, 1990s establishments in Arizona
Atlanta Braves	Atlanta Braves, Sports in Milwaukee, Wisconsin, 1871 establishments in the United States
Colorado Rockies	Colorado Rockies
Miami Marlins	Miami Marlins, 1993 establishments in Florida
Houston Astros	Houston Astros, 1962 establishments in the United States, 1960s establishments in Texas
Dizzy Gillespie	1917 births, 1993 deaths, American jazz musicians, Bahá'ís, Cancer deaths in New Jersey, Deaths from pancreatic cancer, Musicians from South Carolina, Trumpeters
Ganz (toy company)	Companies of Canada, 1950 establishments in North America, 1950s establishments in Canada
John Dowland	1563 births, 1626 deaths, English composers, Lutenists, Renaissance composers
Partsong	Vocal music
Nin Cathedral	Cathedrals, Croatia, Buildings and structures in Europe
Neume	Musical notation
Masovian Voivodeship	1990s establishments in Poland, 1999 establishments in Europe, Voivodeships of Poland
Steelyard	Areas of London
Hazard symbol	Symbols
Pictogram	Symbols
Świętokrzyskie Voivodeship	Voivodeships of Poland
Commensalism	Symbiosis
820s	820s
Lindane	Chemical compounds
Fumaric acid	Acids, Organic compounds
Tinia	Etruscan gods and goddesses
Endospore	Microbiology, Biochemistry
WonderSwan Color	Handheld video games
Gel electrophoresis	Chemistry, Biochemistry, Laboratory techniques
Heinrich Schliemann	1822 births, 1890 deaths, German archaeologists, People from Mecklenburg-Vorpommern
Cyclone Nargis	Cyclone Nargis, Tropical cyclones in Asia, Deadly storms, 2008 in weather
Toilet paper	Waste, Hygiene, Paper
Fox Interactive	Video game companies, 1982 establishments in California, News Corporation
Sauropod	Sauropods
Blockade	War, Law of the sea, Conflicts
Bursa	Bursa, Ottoman Empire
2008 United States presidential election	2008 in the United States, Barack Obama, 2008 elections, United States presidential elections, November 2008 events
2008 Democratic Party presidential primaries	2008 elections, 2008 in the United States, United States presidential primary elections, United States Democratic Party
Theodor Schwann	1810 births, 1882 deaths, German biologists
Dubbo	Cities in New South Wales
Antiwar.com	Websites, War, Libertarianism, 1995 establishments in the United States
Barium chloride	Chlorine compounds, Barium compounds
North Atlantic Treaty	1940s treaties, NATO, 20th century in Washington, D.C., 1949
Blockade of Germany	World War I
LeBron James	LeBron James, 1984 births, Living people, African-American basketball players, American Olympic bronze medalists, American Olympic gold medalists, Los Angeles Lakers players, Cleveland Cavaliers players, Miami Heat players, American movie actors, Sportspeople from Akron, Ohio, Actors from Akron, Ohio, National Basketball Association high school draftees, American basketball players
Silesian Voivodeship	Voivodeships of Poland
First Battle of the Atlantic	Battles of World War I, 1910s in Europe
Sukhoi	Soviet military aircraft, Military aviation
Biomedical engineering	Engineering, Medicine
This Love (The Veronicas song)	2008 songs, Pop songs
VeggieTales	Children's television series, Mass media franchises introduced in the 1990s, 1993 television series debuts
Kroppenstedt	Towns in Saxony-Anhalt
Righteousness	Theology
I Decided	2008 songs, Soul songs
Here I Stand	2008 albums, Usher albums
Social equality	Civil rights
JavaServer Pages	Programming languages, Sun Microsystems
Match	Basic English 850 words, Tools, Fire
Bill Gothard	1934 births, Living people, American Evangelicals, Christian religious leaders, Christian writers, Writers from Chicago
Institute in Basic Life Principles	Christian organizations based in the United States
Master of Arts	Academic degrees
American Fork River	Rivers of Utah
Frank O'Connor	1897 births, 1979 deaths, Actors from Ohio, American movie actors, American painters, Ranchers
Alma mater	Educational institutions
Amplitude modulation	Mechanical vibrations, Radio technology
Sam Allardyce	1954 births, Living people, English footballers, English football managers, England national football team managers, Sportspeople from West Midlands (county)
Chief Constable	Law enforcement in the United Kingdom
Hugh Orde	Northern Ireland people
Candy Lo	1974 births, Living people, C-pop singers, C-rock, Actors from Hong Kong, Singers from Hong Kong
Say It Right	2007 songs, Nelly Furtado, R&B songs
Greater Poland Voivodeship	1999 establishments in Europe, Voivodeships of Poland
Northumbria	Northumberland, History of England, Anglo-Saxons
Hanging (death)	Death
Moons of Mars	Moons of Mars
James Horner	1953 births, 2015 deaths, Academy Award winning composers, Satellite Award winners, Accidental deaths in California, Aviation deaths in the United States, American movie score composers, Golden Globe Award winners, Grammy Award winners, People from Los Angeles, California, Saturn Award winners, Best Original Song Academy Award-winning songwriters
MP3 player	Electronics, Audio technology
Wi-Fi Protected Access	Computer networking
Wired Equivalent Privacy	Computer networking
Congress of Vienna	1810s treaties, 1810s in Europe, 19th century in Austria, 1814, 1815, Vienna
Coin collecting	Money, Collecting, Coins
Blood Red Shoes	English rock bands, Indie bands, Brighton, Musical groups established in 2005, 2005 establishments in England
Bret Hart	Hart family members, 1957 births, Living people, Canadian professional wrestlers, Canadian stage actors, Canadian television actors, Former WWE wrestlers, Sportspeople from Calgary, WWE Hall of Fame
La Grange, Illinois	Villages in Illinois, Suburbs of Chicago, Illinois, Settlements in Cook County, Illinois
Eurovision Song Contest 2008	2008 in music, 2008 in Europe, Belgrade, Eurovision Song Contest, History of Serbia
All We Know	Paramore songs, 2006 songs
Misery Business	Paramore songs, 2007 songs
Wesfarmers	Companies of Australia
Pressure (Paramore song)	Paramore songs, 2006 songs
Hazelwood North, Victoria	Towns in Victoria (Australia)
Hasselt	Municipalities of Limburg, Provincial capitals of Belgium
Focus on the Family	Focus on the Family, 1977 establishments in the United States, 1970s establishments in Colorado
Adventures in Odyssey	Adventures in Odyssey, 1987 establishments in the United States, 1980s establishments in Colorado
Youth for Christ	Christian organizations
Henry Luce	1898 births, 1967 deaths, American journalists, writers from Connecticut
Big Bear Lake, California	Cities in California, Settlements in San Bernardino County, California
Memorial	Monuments and memorials, Architecture
Logging	Forestry
Kølig Kaj	1971 births, Living people, Rap musicians, Danish singers
Forbidden Planet (bookstore)	Toys
Tobey Maguire	American movie actors, Vegetarians, Actors from Santa Monica, California, 1975 births, Living people
Chaplain	Religious occupations
Northwestern College	Colleges and universities in Minnesota, Council for Christian Colleges and Universities, Saint Paul, Minnesota, 1902 establishments in the United States, 1900s establishments in Minnesota
Walker (tool)	Tools
George Beverly Shea	American centenarians, American singer-songwriters, Canadian centenarians, Canadian singer-songwriters, Cardiovascular disease deaths in the United States, Deaths from stroke, Musicians from Ontario, Naturalized citizens of the United States, 1909 births, 2013 deaths
James Dobson	1936 births, Living people, American activists, American conservatives, American Evangelicals, American writers, Anti-LGBT rights activists, Christian religious leaders, Christian writers, Focus on the Family, People from Shreveport, Louisiana, Writers from Louisiana
QuickTime	Multimedia software, Graphics software, Apple software, MacOS
Subspecies	Taxonomy
Centrifugal force	Mechanics
Peeter Volkonski	1954 births, Living people, Rock composers, Estonian singers, Movie actors, Rock musicians, Princes and princesses, Television actors, People from Tallinn
Bobby V	1980 births, Living people, Singers from Mississippi, Singers from Atlanta, Georgia, American R&B singers, People from Jackson, Mississippi
Anonymous (song)	2007 songs
Mixed drink	Alcoholic drink
Smash Mouth	American rock bands, Musical groups from California, People from San Jose, California
Cancuén	Archaeological sites in Guatemala, Maya civilization
Rum	Alcoholic spirits
Pridon Khalvashi	1925 births, 2010 deaths, Poets, Writers from Georgia (country)
Western Front (World War I)	1910s in Europe, World War I
Artifact (archaeology)	Archaeology
Coba	Cobá, Cities in Mexico, Maya civilization, Archaeological sites in Mexico, Quintana Roo
Tectonics	Plate tectonics
Tajal Chan Ahk	South American people, Maya civilization, 8th century births, 8th century deaths
Elsa Einstein	1876 births, 1936 deaths, Disease-related deaths in the United States, German people
Creation Museum	Museums in the United States, Christian organizations based in the United States, Buildings and structures in Kentucky
George Whitefield	1714 births, 1770 deaths, Alumni of the University of Oxford, American Calvinists, American Evangelicals, American Methodists, Anglican priests, Christian religious leaders, English Anglicans, English priests, Evangelists, Gloucester, Missionaries, People from Gloucestershire
Timiş River	Rivers of Serbia, Tributaries of the Danube, Rivers of Romania
Communes of Romania	Communes in Romania, Romania-related lists
Municipalities of Romania	Municipalities of Romania
The Way of the Master	Christian organizations
Don't Stop the Music	2007 songs, Rihanna songs, Dance songs
Nick Carter	1980 births, Living people, Singers from New York
Howie Dorough	1973 births, Living people, singers from Florida
A. J. McLean	Singers from Florida, 1978 births, Living people
Brian Littrell	Singers from Kentucky, 1975 births, Living people
Kevin Richardson	Singers from Kentucky, 1971 births, Living people
Spanish conquest of Yucatán	History of Mesoamerica, 1546
Becquerel	Units of measurement
Popol Vuh	Religious texts, Maya civilization, Creation myths
North Berwick	Towns in Scotland
Jean-Luc Picard	Star Trek: The Next Generation characters
McCune-Reischauer	Romanization
Revised Romanization of Korean	Writing systems, Romanization, ISO standards
Lake Annecy	Lakes of France, Auvergne-Rhône-Alpes
Haute-Savoie	Departments in Auvergne-Rhône-Alpes
Chartres Cathedral	Cathedrals in France, Roman Catholic Cathedrals, Centre-Val de Loire, World Heritage Sites in France
Lough Neagh	Lakes of the United Kingdom, Northern Ireland
Intel Core 2	Computer processors
Deanna Troi	Star Trek: The Next Generation characters
Soulcalibur	1998 video games, Arcade games, Dreamcast games, Xbox 360 Live Arcade games, Soulcalibur series
Disney's Aladdin Junior	Broadway musicals, Musicals based on fairy tales, Musicals based on movies, Musicals by Tim Rice
Polynomial	Mathematics, Algebra
Unknown (math)	Algebra, Science
Agnieszka Włodarczyk	Polish movie actors, Polish singers, Polish television actors, Pop musicians, 1980 births, Living people
The Last of the Clan McDuck	DuckTales
The Master of the Mississippi	DuckTales
The Richest Duck in the World	DuckTales
Online pharmacy	Medicine, Drugs
Juan Egenau	1927 births, 1987 deaths, Chilean sculptors, People from Santiago
Foramen magnum	Head (body part)
Bipedalism	Physiology, Anatomy
Taung Child	Hominins, Fossils, Prehistoric Africa
Dennis Rodman	African-American basketball players, Chicago Bulls players, Dallas Mavericks players, Detroit Pistons players, Los Angeles Lakers players, San Antonio Spurs players, Sportspeople from New Jersey, 1961 births, Living people, National Basketball Association players with retired numbers, American basketball players
Coconut water	Drinks, Coconuts
Ralph Ellison	Writers from Oklahoma, 1913 births, 1994 deaths
Federal government of the United States	Government of the United States
Draco Malfoy	Harry Potter characters, Fictional characters introduced in 1997
PCLinuxOS	Linux distributions, Live CD
Nutrition	Nutrition, Healthy lifestyle, Physiques
Lei (Hawaii)	Culture of Hawaii, Flowers
Orchid	Orchids
Steve Buscemi	1957 births, Living people, Actors from Brooklyn, American movie actors, American television actors, American television directors, American voice actors, Emmy Award winning actors, Golden Globe Award winning actors, Movie directors from New York City, Movie producers from New York City, Screenwriters from New York City
Closet	Furniture
FreeDOS	Operating systems
List of The Buzz on Maggie Episodes	Lists of animated television series episodes
Coahoma County, Mississippi	Mississippi counties, 1836 establishments in Mississippi
Province of Trento	Autonomous areas, Tyrol, Provinces of Trentino-Alto Adige/Südtirol
King Power Stadium	Football stadiums in England
Botoșani	County capitals of Romania
Little Ice Age	Climate change
Trade route	Business
Zircon	Gemstones, Minerals
Labradorite	Gemstones, Minerals
Beryl	Gemstones, Minerals
Hallstatt	Cities and towns in Upper Austria
Mayflower Compact	Official documents of the United States, 1620, 1620s in the Thirteen Colonies, November events
John Piper (theologian)	1946 births, Living people, American Baptists, American Calvinists, Christian writers, People from Chattanooga, Tennessee, Writers from South Carolina, Writers from Tennessee
Bill Gates	1955 births, Living people, American agnostics, American billionaires, American chief executives, American philanthropists, Bill Gates, Harvard University alumni, Microsoft people, Writers from Seattle, Washington, Businesspeople from Seattle, Washington, Recipients of the Order of the Aztec Eagle, Recipients of the Order of the Rising Sun, Time People of the Year, American company founders, Honorary Knights Commander of the Order of the British Empire
Fibula (brooch)	Archaeology, Jewelry
United States Supreme Court building	Buildings and structures in Washington, D.C.
Bethlehem Baptist Church (Minneapolis)	Baptist churches, Churches in the United States, Minneapolis, Minnesota, 1871 establishments in the United States, 19th-century establishments in Minnesota
Megachurch	Churches
Medieval Warm Period	Middle Ages, Climate
Motor sports	Motor sports
Niagara IceDogs	Canadian Hockey League teams, Ice hockey teams in Ontario, Ontario Hockey League, 1998 establishments in Canada
Haan	Towns in North Rhine-Westphalia, Mettmann Rural District
Gas chamber	Torture, Capital punishment
Impact Wrestling	2002 establishments in the United States, Impact Wrestling
Battle of the Bulge	1944 in Europe, 1945 in Europe, European battles of World War II, 20th century in Belgium, History of Luxembourg, Wallonia, Liège (province), Luxembourg (Belgium), Namur (province)
Nothing	Matter
Moon	Moon, Basic English 850 words

