Positron emission tomography	Medical imaging
Home Run Derby	Major League Baseball, 1985 establishments in the United States
The Star (1952 movie)	1952 drama movies, 1950s romantic drama movies, American romantic drama movies, Movies directed by Stuart Heisler, English-language movies
Claudio Báez	1948 births, 2017 deaths, Mexican television actors
Waiuku	Towns in New Zealand
Adalberto Giazotto	1940 births, 2017 deaths, Deaths from myocardial infarction, Italian scientists, Physicists
Meissner effect	Magnetism
Gillian Rolton	1956 births, 2017 deaths, Deaths from endometrial cancer, Cancer deaths in Australia, Australian Olympic gold medalists, Sportspeople from South Australia, People from Adelaide
Alex Ifeanyichukwu Ekwueme	1932 births, 2017 deaths, Accidental deaths from falls, Nigerian politicians, Vice presidents
Milan Moguš	1927 births, 2017 deaths, Deaths from coronary artery disease, Croatian people, Educators, Linguists
Warren "Pete" Moore	1939 births, 2017 deaths, American singer-songwriters, American R&B singers, American soul singers, American funk singers, American rock singers, African-American singers, Singers from Detroit, Michigan
Jana Novotná	1968 births, 2017 deaths, Australian Open champions, Czech tennis players, Deaths from cancer, Disease-related deaths in the Czech Republic, Female tennis players, French Open champions, Lesbians, LGBT Olympians, Medalists at the 1988 Summer Olympics, Medalists at the 1996 Summer Olympics, Olympic bronze medalists, Olympic silver medalists, People from Brno, US Open (tennis) champions, Wimbledon champions, World No. 1 tennis players
Terry Glenn	1974 births, 2017 deaths, Road accident deaths in the United States, American football wide receivers, New England Patriots players, Green Bay Packers players, Dallas Cowboys players, Sportspeople from Columbus, Ohio
Janusz Wójcik	1953 births, 2017 deaths, Polish politicians, Polish footballers, Sportspeople from Warsaw
Robert Clotworthy	Living people, 1955 births, American movie actors, American television actors, American television presenters, American voice actors, American video game actors, Actors from Los Angeles, California
Bob Clotworthy	1931 births, 2018 deaths, Divers, American Olympic gold medalists, American Olympic bronze medalists, Sportspeople from Newark, New Jersey
Víctor Hipólito Martínez	1924 births, 2017 deaths, Deaths from pneumonia, Vice Presidents of Argentina
Kamala (wrestler)	1950 births, 2020 deaths, Deaths from the COVID-19 pandemic in the United States, Deaths from diabetes, Deaths from cardiac arrest, American professional wrestlers, Sportspeople from Mississippi
Tongkang LRT Station	Light Rail Transit (Singapore) stations, Sengkang
Bobby Mahal	Living people, Canadian sportspeople
Ryza Cenon	Living people, Filipino actors, 1987 births, Television presenters
Merrill Cook	1946 births, Living people, American Latter Day Saints, Businesspeople from Utah, Harvard University alumni, Politicians from Philadelphia, Pennsylvania, United States representatives from Utah, US Republican Party politicians
Karen Shepherd	1940 births, Living people, Politicians from New Mexico, United States representatives from Utah, US Democratic Party politicians
Yanam	Towns in India, Settlements in Puducherry
Firozabad district	Districts of Uttar Pradesh
Machilipatnam	Settlements in Andhra Pradesh, Cities in India
Machilipatnam mandal	Andhra Pradesh
Mohammad Fathy Saoud	Living people, Qatar Foundation people
Earl of Bothwell	Scottish Earls
Indawgyi Lake	Geography of Myanmar, Lakes of Asia
Ned Jarrett	Living people, 1932 births, NASCAR drivers, Sportspeople from North Carolina
John Gordon	1925 births, 2017 deaths, Deaths from Alzheimer's disease, English novelists, English children's writers
John A. Gordon	1946 births, 2020 deaths, American military people, Politicians from Missouri
Rodney Bewes	1937 births, 2017 deaths, Actors from Yorkshire, Deaths from vascular dementia, Disease-related deaths in England, English movie actors, English stage actors, English television actors, English television writers, Writers from Yorkshire
Zoltan Istvan	2020 United States presidential candidates, 2016 United States presidential candidates, 1973 births, Living people, American novelists, American journalists, American philosophers, American educators, American activists, Businesspeople from Los Angeles, California, Politicians from Los Angeles, California, Writers from Los Angeles, California, US Libertarian Party politicians
Ham sandwich theorem	Geometry
Kaji Khalak family	History of Nepal
Layar LRT Station	Sengkang, Light Rail Transit (Singapore) stations
Sengkang	Sengkang, Places in Singapore
Renjong LRT Station	Sengkang, Light Rail Transit (Singapore) stations
Zahir Raihan	1935 births, 1972 deaths, 2020 deaths, Bangladeshi movie directors, Novelists, Missing people, People from Dhaka, Bangla Academy Literary Award winners, Recipients of the Ekushey Padak, Bangladeshi Muslims, Recipients of the Independence Day Award, Recipients of Bangladesh National Film Awards
Red Army F.C.	Pages created with the Article Wizard from 2017, 2013 establishments, Football clubs
PFC Levski Sofia	Bulgarian football clubs
Taipei Metro	Rapid transit systems
PFC Lokomotiv Plovdiv	Bulgarian football clubs
Ibrahim AlHaidos	Living people, 1986 births, Qatar Foundation people
Subprefectures in France	Subprefectures in France
Zibelemärit	Swiss culture, Retail markets, Bern, 1850s establishments in Europe, 19th century establishments in Switzerland
Peter Berling	1934 births, 2017 deaths, German movie actors, German movie producers, German novelists, People from former German territories, People from Prussia
Munster cheese	French cheeses
Pigniu	Former municipalities of Graubünden
Ion exchange chromatography	Laboratory techniques, Chemistry
La Chaux-de-Fonds	Cities in Switzerland, Municipalities of Neuchâtel, World Heritage Sites in Switzerland
Rueun	Former municipalities of Graubünden
Pitasch	Former municipalities of Graubünden
Kerzers	Municipalities of Fribourg
Communauté d'agglomération d'Agen	Agglomeration communities in France
Astaffort	Communes in Lot-et-Garonne
APOEL FC	Cypriot football clubs, Nicosia
Fire bucket	Firefighting
Stuffed peppers	Foods
Communauté d'agglomération du Grand Annecy	Agglomeration communities in France
Agglomeration community of Annemasse – Les Voirons	Agglomeration communities in France
Dmitri Hvorostovsky	1962 births, 2017 deaths, Deaths from brain cancer, Cancer deaths in London, Russian singers, Russian opera singers
Frontotemporal dementia	Diseases and disorders of the cardiovascular system, Dementia
István Konkoly	1930 births, 2017 deaths, Hungarian Roman Catholics, Roman Catholic bishops
Thanggam LRT Station	Sengkang, Light Rail Transit (Singapore) stations
Cheng Lim LRT Station	Sengkang, Light Rail Transit (Singapore) stations
Mombar	Egypt, Foods
Wayne Cochran	1939 births, 2017 deaths, American soul musicians, Singers from Georgia (U.S. state), Musicians from Georgia (U.S. state), Musicians from Miami, Florida, Singers from Miami, Florida, People from Miramar, Florida
Valentin Huot	1929 births, 2017 deaths, Deaths from bronchopneumonia, Disease-related deaths in France, French cyclists
George Avakian	1919 births, 2017 deaths, American educators, Businesspeople from New York City, Musicians from New York City, Writers from New York City
Jon Hendricks	Grammy Award winners, 1921 births, 2017 deaths, American jazz musicians, American singer-songwriters, Singers from Ohio, Musicians from Ohio, Writers from Ohio
Robert Durst	1943 births, Living people, Real estate developers, People acquitted of murder, Businesspeople from New York City, Criminals from New York City, American people convicted of murder, American serial killers
Elizabeth Eckford	1941 births, Living people, People from Little Rock, Arkansas
Luis Garisto	1945 births, 2017 deaths, Deaths from respiratory failure, Uruguayan footballers, Uruguayan football managers, Sportspeople from Montevideo
Reg Watson	1926 births, 2019 deaths, Television producers, Television writers, People from Brisbane, Writers from Queensland
Elle (magazine)	Monthly magazines, Fashion magazines, 1945 establishments in Europe, 1940s establishments in France
Resistance welding	Engineering, Metals
River Annalee	Rivers of Ireland
Ank Bijleveld	1962 births, Living people, Christian Democratic Appeal politicians, Deputy government ministers of the Netherlands, Dutch councillors, Dutch mayors, Dutch Roman Catholics, Dutch women politicians, Former members of the House of Representatives of the Netherlands, Government ministers of the Netherlands, Politicians from Overijssel
IJsselmuiden	Settlements in Overijssel, Former municipalities of Overijssel
Overdinkel	Settlements in Overijssel, Losser
Carole Samaha	1972 births, Living people, Lebanese entertainers, People from Beirut
Stela Popescu	1935 births, 2017 deaths, Deaths from stroke, Romanian entertainers, Romanian movie actors, Romanian television actors, Television personalities, Humanitarians
Pete Stark	1931 births, 2020 deaths, Deaths from leukemia, United States representatives from California, American atheists, Bankers, Politicians from San Francisco, Politicians from Milwaukee, Wisconsin, Businesspeople from San Francisco, Businesspeople from Wisconsin, US Democratic Party politicians
Joe Barton	1949 births, Living people, United States representatives from Texas, People from Waco, Texas, US Republican Party politicians
William Reynolds Archer Jr.	1928 births, Living people, United States representatives from Texas, Politicians from Houston, Texas, US Republican Party politicians
Kevin Brady	1955 births, Living people, United States representatives from Texas, Politicians from South Dakota, US Republican Party politicians
United States House Committee on Ways and Means	1795 establishments in the United States, Committees of the United States House of Representatives
ERTU	1971 establishments in Africa, Media, 1970s establishments in Egypt
Richard Neal	1949 births, Living people, United States representatives from Massachusetts, American mayors, People from Springfield, Massachusetts, US Democratic Party politicians
Temuera Morrison	1960 births, Living people, New Zealand movie actors, New Zealand television actors, New Zealand voice actors, New Zealand stage actors
Psephology	Elections
Farmway LRT Station	Sengkang, Light Rail Transit (Singapore) stations
Chinese calligraphy	Writing
Turkey Time	Turkey, Time by country
Compassvale LRT Station	Sengkang, Light Rail Transit (Singapore) stations
Kupang LRT Station	Sengkang, Light Rail Transit (Singapore) stations
Rumbia LRT Station	Sengkang, Light Rail Transit (Singapore) stations
Bakau LRT Station	Sengkang, Light Rail Transit (Singapore) stations
Kangkar LRT Station	Sengkang, Light Rail Transit (Singapore) stations
Ranggung LRT Station	Sengkang, Light Rail Transit (Singapore) stations
Bentley, Suffolk	Settlements in Babergh, Civil parishes in Suffolk, Villages in Suffolk
Youm7	Newspapers, Egypt, 2008 establishments in Africa, Establishments in Egypt
De Lutte	Settlements in Overijssel, Losser
Beuningen, Overijssel	Settlements in Overijssel, Losser
Glane, Overijssel	Settlements in Overijssel, Losser
Losser	Losser, Settlements in Overijssel
Logelheim	Communes in Haut-Rhin
Lucelle, Haut-Rhin	Communes in Haut-Rhin
Twente	Overijssel, Regions of the Netherlands
Carl-Henrik Hermansson	1917 births, 2016 deaths, Swedish politicians, Swedish writers, Communists
God in Hinduism	Hinduism
Izabella Zielińska	1910 births, 2017 deaths, Polish pianists, Polish educators, Centenarians
Kamchatka Time	Russia, Time zones
Pliny's Comedy and Tragedy villas	Buildings and structures in Ancient Rome
Walid Mostafa	Living people, Arab people, Egyptian businesspeople, 1972 births, People from Cairo, Pharmacists
Aulonemia patriae	Bamboo species
Aulonemia purpurata	Bamboo species
Time in Kazakhstan	Kazakhstan, Time by country
Time in Cyprus	Time by country, Cyprus
Juan Luis Maurás	1922 births, 2017 deaths, Presidents of the Senate of Chile, People from Santiago
Jonathan Haze	Actors from Pittsburgh, Pennsylvania, American television actors, American movie actors, 1929 births, Living people
William Kennedy	Pulitzer Prize winners, 1928 births, Living people, American novelists, American journalists, Writers from New York, People from Albany, New York
Peter Fernandez	1927 births, 2010 deaths, Deaths from lung cancer, Cancer deaths in New York, American movie actors, American voice actors, American television actors, American child actors, Models from New York City, American novelists, American video game actors, American stage actors, American radio actors, American military personnel of World War II, American television writers, American television directors, Screenwriters from New York City, Actors from New York City
Courage the Cowardly Dog	Courage the Cowardly Dog, 1999 American television series debuts, American animated television series, American comedy television series, American horror television series, Cartoon Network series, English-language television programs
Thea White	1940 births, 2021 deaths, American voice actors, American television actors, Actors from Newark, New Jersey, Deaths from surgical complications, Infectious disease deaths in New Jersey, Deaths from liver cancer
John R. Dilworth	1968 births, Living people, Animators, Cartoonists, British television actors, British voice actors, British television directors, British television producers, British television writers, Actors from Manchester
Miguel Alfredo González	1983 births, 2017 deaths, Road accident deaths, Philadelphia Phillies players, Cuban sportspeople, People from Havana
Neil Gillman	1933 births, 2017 deaths, American philosophers, American rabbis, Canadian Jews, Cardiovascular disease deaths in New York City, Conservatives, Deaths from thrombosis, Jewish American academics, People from Quebec City
Zeki Zorlu	1939 births, Living people, Turkish businesspeople
Microservices	Computer science
Ahmed Hassan al-Bakr	Presidents of Iraq, 1914 births, 1982 deaths, Vice Presidents of Iraq, People from Tikrit, Iraqi military people, Leaders of political parties, Prime Ministers of Iraq
Ahmad Shah Massoud	Afghan military people, Assassinated people, 2011 deaths, Afghan politicians
John Thierry	1971 births, 2017 deaths, Deaths from myocardial infarction, Cardiovascular disease deaths in the United States, American football defensive ends, Chicago Bears players, Green Bay Packers players, Cleveland Browns players, Atlanta Falcons players, Sportspeople from Houston, Texas, Sportspeople from Mississippi
List of parish councils in Cornwall	Politics of Cornwall
Gudrun Pausewang	1928 births, 2020 deaths, German children's writers, German educators, German novelists, Science fiction writers
Anna Kuzmina	1933 births, 2017 deaths, Russian movie actors, Russian television actors, Russian stage actors, Russian writers
Jaime Ortí	1947 births, 2017 deaths, Deaths from lung cancer, Cancer deaths in Spain, Spanish sportspeople, Spanish businesspeople, People from Valencia
Bashkurdistan	Federal subjects of Russia
Jackie Shroff	Indian actors, 1957 births, Living people
Bertha Calloway	1925 births, 2017 deaths, Deaths from pneumonia, American civil rights activists, American historians, Writers from Omaha, Nebraska
Machiko Kyō	1924 births, 2019 deaths, Deaths from heart failure, Japanese movie actors, Japanese television actors, Japanese stage actors, Silent movie actors, People from Osaka
Zorlu Holding	Holding companies of Turkey
Product piracy	Property crimes, Piracy
Doğuş Group	Holding companies of Turkey
Mathura district	Districts of Uttar Pradesh
Mirzapur district	Districts of Uttar Pradesh
Intermediate value theorem	Mathematics
Miroslav Lajčák	1963 births, Living people, Slovakian politicians, Ambassadors, Presidents of the United Nations General Assembly
Wood Moy	1918 births, 2017 deaths, Deaths from pneumonia, Disease-related deaths in New York City, Chinese movie actors, Naturalized citizens of the United States, American movie actors, Actors from New York City
Gene Kotlarek	1940 births, 2017 deaths, American Olympians, American skiers, Sportspeople from Minnesota
Erika Remberg	1932 births, 2017 deaths, Austrian movie actors
Stefan Radt	1927 births, 2017 deaths, Dutch academics, Dutch historians, Dutch Jews, German Jews, Jewish academics, Jewish writers, Naturalised citizens of the Netherlands, Refugees from Nazism, Writers from Berlin
Ángel Berni	1931 births, 2017 deaths, Paraguayan footballers
Sotir Ferrara	1937 births, 2017 deaths, Albanian people, Italian Roman Catholics, Bishops
Milein Cosman	1921 births, 2017 deaths, Illustrators, German artists, British artists
Korean Standard Time	Time by country, South Korea
Georgia Time	Time by country, Georgia (country)
You Make It Feel Like Christmas	2017 albums, Gwen Stefani albums, Pop albums, Christmas albums, R&B albums
Armando Hart	1930 births, 2017 deaths, Deaths from respiratory failure, Cuban politicians, Communists, Political activists, People from Havana
Harry Pregerson	1923 births, 2017 deaths, Deaths from respiratory failure, Disease-related deaths in Los Angeles, American military personnel of World War II, American judges, Politicians from Los Angeles, California, US Democratic Party politicians
Andrzej Wincenty Górski	1920 births, 2017 deaths, Deaths from stroke, Polish educators, Polish scientists, Chemists, Writers from Warsaw
Maurice Chevalier	1888 births, 1972 deaths, Actors from Paris, Deaths from renal failure, Disease-related deaths in Paris, French entertainers, French military personnel of World War I, French movie actors, French prisoners, French singers, French stage actors, French television actors, French voice actors, Jazz musicians, Musicians from Paris, Prisoners of war, Radio actors, Silent movie actors, Tony Award winners
Roddy Maude-Roxby	1930 births, English movie actors, English television actors, English voice actors, English stage actors, Actors from London, Comedians from London
Marni Nixon	1930 births, 2016 deaths, Deaths from breast cancer, Cancer deaths in New York City, American movie actors, American television actors, American stage actors, American voice actors, American musical theatre actors, Singers from Los Angeles County, California, Actors from Los Angeles County, California
Jacques Hamel	1930 births, 2016 deaths, French murder victims, French Roman Catholics, Roman Catholic priests
Arthur Dion Hanna	1928 births, 2021 deaths, Governors-General of the Bahamas
Miloš Radulović	1929 births, 2017 deaths, Presidents of Montenegro, Educators, Ambassadors
Michael J. Williams (politician)	1929 births, Living people, Presidents of Trinidad and Tobago, Business people
Maria Schneider (politician)	1923 births, Living people, Members of the Volkskammer, Politicians from Saxony, Politicians of the Socialist Unity Party of Germany
Krastyu Trichkov	1923 births, Living people, Bulgarian politicians, Communists
Alfonso Lovo Cordero	1927 births, 2018 deaths, Presidents of Nicaragua
Alfred Miodowicz	1929 births, 2021 deaths, Polish politicians, Activists, People from Poznań
Ravan A. G. Farhâdi	1929 births, Living people, Educators, Ambassadors of Afghanistan
Tehreek-e-Labaik	Politics, Pakistan
Rosario Green	1941 births, 2017 deaths, Mexican educators, Mexican economists, Ambassadors of Mexico, Politicians from Mexico City
Frederick Forsyth	1938 births, Living people, British military people, Commanders of the Order of the British Empire, English journalists, English novelists, Writers from Kent, People from Ashford, Kent
The Wind in the Willows	1908 books, British novels, Children's books, English-language novels
Beuningen	Municipalities of Gelderland, Settlements in Gelderland
Kenneth Grahame	1859 births, 1932 deaths, Bankers, British children's writers, People from Edinburgh, Scottish novelists
Stevens MRT station	Mass Rapid Transit (Singapore) stations, 2015 establishments in Asia, 2010s establishments in Singapore
Sir Bani Yas	Geography of the United Arab Emirates, Islands of Asia
Libyan Desert	Deserts
Lenno	Settlements in Lombardy
Abraham Ortelius	European geographers, Cartographers, Flemish people, 1527 births, 1598 deaths
Augustin-Louis Cauchy	1789 births, 1857 deaths, French mathematicians, Theoretical physicists
Wilbur Smith	1933 births, Living people, British novelists, Naturalised citizens of the United Kingdom, South African writers, Zambia
Georges Charpak	1924 births, 2010 deaths, French Nobel Prize winners, French people of World War II, French physicists, Holocaust survivors, Jewish French scientists, Jewish Nobel Prize winners, Polish Jews
Arthrostylidium merostachyoides	Bamboo species
Arthrostylidium multispicatum	Bamboo species
Arthrostylidium pubescens	Bamboo species
Ogdoad (Egyptian)	Egyptian gods and goddesses, Creation myths
Brandon Sanderson	Writers from Nebraska, 1975 births, Living people, People from Lincoln, Nebraska, American science fiction writers
Henry Emeleus	1930 births, 2017 deaths, Deaths from myocardial infarction, British geologists, People from Belfast
Julio Oscar Mechoso	1955 births, 2017 deaths, Deaths from myocardial infarction, Cardiovascular disease deaths in California, American movie actors, American television actors, American voice actors, Actors from Miami, Florida
Loïc Bouvard	1929 births, 2017 deaths, French politicians
Bill Harris	1934 births, 2017 deaths, American military personnel of the Korean War, American military personnel of the Vietnam War, Politicians from Tennessee, Politicians from Ohio, Businesspeople from Tennessee, Businesspeople from Ohio, Military people from Tennessee, Military people from Ohio, US Republican Party politicians
Smashburger	American fast food restaurants, Denver, Colorado, 2007 establishments in the United States
Surfactant	Chemistry
Atatürk Olympic Stadium	Football stadiums in Turkey, Istanbul, 2002 establishments
Bellagio	Towns in Italy, Settlements in Lombardy
Emily Davison	1872 births, 1913 deaths, People from London
Impalement	Torture, Capital punishment
Packet switching	Computer networking
Per Zennstrom	Living people, Swedish photographers
Kyle McCulloch	1962 births, Living people, Actors from Winnipeg, Canadian television producers, Canadian television writers, Canadian voice actors
Dubrovytsia	Cities in Ukraine
Tomb Raider (2013 video game)	2013 video games, Adventure games, MacOS games, PlayStation 3 games, PlayStation 4 games, Windows games, Xbox 360 games, Xbox One games
Meghan, Duchess of Sussex	1981 births, Living people, Actors from Los Angeles, California, American movie actors, American television actors, Humanitarians, Models from Los Angeles, California
Cristina Stamate	1946 births, 2017 deaths, Deaths from stroke, People from Bucharest, Romanian movie actors, Romanian stage actors, Romanian television actors
Golshifteh Farahani	1983 births, Living people, French movie actors, French singers, French stage actors, Iranian actors, Iranian singers, People from Tehran
Zla Kolata	Mountains of Europe, Montenegro
Luemschwiller	Communes in Haut-Rhin
Luttenbach-près-Munster	Communes in Haut-Rhin
Amboise	Communes in Indre-et-Loire
Grammy Award for Best Spoken Word Album	Grammy Awards
Bogdan Maglich	Naturalized citizens of the United States, Serbian people, American physicists, 1928 births, 2017 deaths
Hou Bo	1924 births, 2017 deaths, Chinese people, Photographers, Communists
Bud Moore	Purple Heart recipients, 1925 births, 2017 deaths, NASCAR drivers, American military personnel of World War II, Sportspeople from South Carolina, People from Spartanburg, South Carolina
Richard Cordray	1959 births, Living people, American lawyers, Directors of the Consumer Financial Protection Bureau, Politicians from Ohio, US Democratic Party politicians
Consumer Financial Protection Bureau	2011 establishments in the United States, United States government agencies
Patrícia Gabancho	1952 births, 2017 deaths, Deaths from lung cancer, Cancer deaths in Spain, Argentine writers, Spanish writers, Argentine journalists, People from Barcelona, People from Buenos Aires, Spanish journalists
Unit load device	Aviation, Containers
Landmass	Geology
Dhyan Chand	1905 births, 1979 deaths, Field hockey players, Olympic gold medalists, Indian sportspeople, Autobiographers, People from Uttar Pradesh
Irrawaddy River	Rivers of Myanmar
Google Pixel	Google mobile phones
Domhnall Gleeson	1983 births, Living people, Actors from Dublin, Irish movie actors, Irish stage actors, Irish television actors, Irish voice actors, Writers from Dublin
Will Poulter	1993 births, Living people, Actors from London, BAFTA Award winning actors, English movie actors, English television actors, People from Hammersmith
Slobodan Praljak	1945 births, 2017 deaths, Croatian people, Deaths from heart failure, Criminals who committed suicide, Engineers, Generals, Movie directors, People who committed suicide in prison custody, Prisoners, Suicides by poison, War criminals
The Shadows No. 2	Music
Robert Bosch GmbH	Companies of Germany, Baden-Württemberg, 1886 establishments in Europe, 1880s establishments in Germany
Robert Batailly	1934 births, 2017 deaths, French politicians
Medel (Lucmagn)	Municipalities of Graubünden
Rhäzüns	Municipalities of Graubünden
Tamins	Municipalities of Graubünden
Trin	Municipalities of Graubünden
Lukman Haruna	1990 births, Nigerian footballers, People from Lagos, Living people
Lutter, Haut-Rhin	Communes in Haut-Rhin
Günther Jauch	1956 births, Living people, German journalists, German television presenters, Writers from North Rhine-Westphalia, Writers from Brandenburg, People from Münster, People from Potsdam
Sargans	Municipalities of St. Gallen, Cities in Switzerland
Voov	Social networking
Luis Gutiérrez	1953 births, Living people, United States representatives from Illinois, Politicians from Chicago, US Democratic Party politicians
Belmiro de Azevedo	1938 births, 2017 deaths, Portuguese businesspeople
Life Is Strange	2015 video games, Adventure games, PlayStation 3 games, PlayStation 4 games, Windows games, Xbox 360 games, Xbox One games
Raj Kapoor	1924 births, 1988 deaths, Indian movie actors, Indian movie directors, Indian movie producers, Actors from Mumbai
Hilary B. Price	1969 births, Living people, American cartoonists, People from Massachusetts
Umberto Pettinicchio	People from Apulia, Living people, Italian painters, Italian sculptors
Incus	Bones
Siege of Leningrad	World War II, Saint Petersburg, Sieges
Kirsty MacColl	1959 births, 2000 deaths, Accidental deaths, English pop singers, English singer-songwriters, Manslaughter victims, Singers from Surrey
Eluru	Settlements in Andhra Pradesh, Cities in India
West Godavari district	Districts of Andhra Pradesh
Rob Brydon	1965 births, Living people, Actors from Glamorgan, British comedians, British radio personalities, British television presenters, Members of the Order of the British Empire, Musicians from Glamorgan, Welsh movie actors, Welsh singers, Welsh television actors, Welsh voice actors
Lee Mack	1968 births, Living people, Actors from Lancashire, British stand-up comedians, Comedians from Lancashire, English autobiographers, English television actors
Tommy Cooper	1921 births, 1984 deaths, British stand-up comedians, Cardiovascular disease deaths in London, Deaths from myocardial infarction, British magicians, Welsh entertainers
Gomer Pyle, U.S.M.C.	American television, 1964 television series debuts, American sitcoms, CBS network shows, English-language television programs
2001 southern Peru earthquake	Earthquakes in the 2000s, Peru
Opinion poll	Social sciences
Lester Holt	NBC, American television presenters
Deaths in December 2017	2017 deaths
Ethereum	Cryptocurrency, Software
Adarsh Sein Anand	1936 births, 2017 deaths, Chief Justices of India, Indian lawyers
Patrick O'Brian	1914 births, 2000 deaths, British military personnel of World War II, Commanders of the Order of the British Empire, English novelists, Translators, Writers from Buckinghamshire
Joel Edgerton	1974 births, Living people, Actors from Sydney, Australian movie actors, Australian movie directors, Australian movie producers, Australian screenwriters, Australian television actors, Australian voice actors, Writers from Sydney
Allianz	1890 establishments in Europe, Banks of Germany, Insurance companies, Munich, 1890s establishments in Germany
Schlans	Former municipalities of Graubünden
Vals, Switzerland	Municipalities of Graubünden, Ski areas and resorts in Switzerland, Spa towns
Sagogn	Municipalities of Graubünden
Wanna One	South Korean boy bands, K-pop music groups, 2017 establishments in South Korea
Smart	1994 establishments in Germany, Automobile companies of Germany, Baden-Württemberg
Lutterbach	Communes in Haut-Rhin
Sumvitg	Municipalities of Graubünden
Delsa Solórzano	1971 births, Venezuelan people, Living people
Dr. Oetker	1890s establishments in Germany, 1891 establishments in Europe, Companies of Germany, Food companies of Europe, Bielefeld
Corbynmania	Jeremy Corbyn
Robert Mueller	1944 births, Living people, American military personnel of the Vietnam War, American lawyers, Directors of the Federal Bureau of Investigation, Politicians from New York City, US Republican Party politicians
Republic of Liberia national defence forces	Liberia
Saintes, Charente-Maritime	Subprefectures in France, Communes in Charente-Maritime
Charles C. McDonald	1933 births, 2017 deaths, Deaths from motor neurone disease, Disease-related deaths in Florida, American military personnel of the Vietnam War, People from Wisconsin
Stephen Knapp	1947 births, 2017 deaths, Deaths from acute myeloid leukemia, American artists, Cancer deaths in Massachusetts
Aminul Islam (academic)	1935 births, 2017 deaths, Bangladeshi people, Bangladeshi educators
Surin Pitsuwan	1949 births, 2017 deaths, ASEAN, Deaths from heart failure, Asian diplomats, Thai politicians
Time in the United Arab Emirates	Time by country, United Arab Emirates
Time in Indonesia	Time by country, Indonesia
Cliff Williams	1949 births, Living people, English rock guitarists, English rock singers, Musicians from Essex, Rock and Roll Hall of Fame inductees
Charles E. Merrill Jr.	1920 births, 2017 deaths, Harvard University alumni, American educators, American philanthropists, Writers from Massachusetts
Colin Groves	1942 births, 2017 deaths, Australian writers, Australian educators, People from Canberra
Marina Popovich	1931 births, 2017 deaths, Military people, Russian scientists, Russian engineers
Vincent Scully	1920 births, 2017 deaths, American historians, Writers from New Haven, Connecticut
James Kisicki	1938 births, 2017 deaths, American movie actors, American television actors, American stage actors, American voice actors, Actors from Chicago, Actors from Florida, Actors from Detroit, Michigan, People from Ocala, Florida
Physical unclonable function	Cryptography, Numbers
Amar Singh Thapa	1751 births, 1816 deaths, History of Nepal
Israel Horovitz	1939 births, 2020 deaths, Cancer deaths in New York City, American playwrights, Screenwriters from Massachusetts
Fredy Schmidtke	1961 births, 2017 deaths, Deaths from myocardial infarction, German cyclists, German Olympic gold medalists, People from Cologne, Sportspeople from North Rhine-Westphalia
Philipp Graf Lerchenfeld	1952 births, 2017 deaths, Accountants, Cancer deaths in Germany, Deaths from lung cancer, Former members of the German Bundestag, German Roman Catholics, People from Regensburg, Politicians from Bavaria, Politicians of the Christian Social Union of Bavaria
Grand Prix (TV programme)	BBC Television programmes, Sports television series, 1970s British television series, 1980s British television series, 1990s British television series
Zastava M84	General-purpose machine guns
Asepsis	Medicine, Microbiology
Time in Hungary	Time by country, Hungary
Crato	Cities in Ceará
Trun	Municipalities of Graubünden
CBS Morning News	American television news programs, CBS network shows, English-language television programs
Rondon Pacheco	1919 births, 2016 deaths, Brazilian politicians, Deaths from pneumonia, Disease-related deaths in Brazil, Minas Gerais
Tujetsch	Municipalities of Graubünden, Ski areas and resorts in Switzerland
Gladys Nordenstrom	1924 births, 2016 deaths, American classical musicians, American composers, American pianists, Musicians from Minnesota, Recipients of the Decoration for Services to the Republic of Austria
Valendas	Former municipalities of Graubünden, 2013 disestablishments in Switzerland
Irina Bilyk	1970 births, Ukrainian singers
Versam	Former municipalities of Graubünden, 2013 disestablishments in Switzerland
Safien	Former municipalities of Graubünden, 2013 disestablishments in Switzerland
Garth Ennis	1970 births, Living people, American atheists, American comics writers, British atheists, British writers, People from County Down
Schmitten, Graubünden	Municipalities of Graubünden
Magny, Haut-Rhin	Communes in Haut-Rhin
Alain Jessua	1932 births, 2017 deaths, French movie directors, French screenwriters, Writers from Paris
Magstatt-le-Bas	Communes in Haut-Rhin
Magstatt-le-Haut	Communes in Haut-Rhin
Randall Park	1974 births, Living people, Actors from Los Angeles, California, American comedians, American movie actors, American television actors, American television writers, Comedians from Los Angeles, California, Writers from Los Angeles, California
2017–18 Premier League	Football leagues in the United Kingdom, 2017 in association football, 2018 in association football, Premier League
Time in Oman	Time by country, Oman
Saint-Michel-sur-Orge	Communes in Essonne
Mundell Lowe	1922 births, 2017 deaths, American guitarists, American jazz musicians, Musicians from Mississippi
Jerzy Kłoczowski	1924 births, 2017 deaths, Military personnel of World War II, Polish academics, Polish historians, Polish military people
Dick Gernert	1928 births, 2017 deaths, American baseball players, Boston Red Sox players, Chicago Cubs players, Cincinnati Reds players, Detroit Tigers players, Houston Astros players, Sportspeople from Pennsylvania
Reg Varney	1916 births, 2008 deaths, Deaths from respiratory tract infection, Actors from Essex, Comedians from Essex, English stage actors, English television actors, English movie actors, Infectious disease deaths in England
Tenna, Switzerland	Former municipalities of Graubünden, 2013 disestablishments in Switzerland
Safiental	Municipalities of Graubünden, 2013 establishments in Switzerland
Morissen	Former municipalities of Graubünden
Mahsun Kırmızıgül	1968 births, Living people, Turkish movie actors, Turkish singers, Turkish screenwriters
Waltensburg/Vuorz	Former municipalities of Graubünden
Deckstar	2006 establishments in the United States, Entertainment companies, American entertainment companies
Michelin	1880s establishments in France, 1889 establishments in Europe, Tire manufacturers, Companies of France, Clermont-Ferrand
Malmerspach	Communes in Haut-Rhin
Oophorectomy	Reproductive system, Anaphrodisiacs, Surgery
Arriva Southern Counties	Arriva Southern Counties, Bus transport
Leoš Šimánek	1946 births, Living people, Czech writers, Photographers, Mountain climbers
Ewald Schurer	1954 births, 2017 deaths, Politicians of the Social Democratic Party of Germany, Politicians from Bavaria
IPhone X	IPhone, Mobile phones released in 2017, Mobile phones with multiple rear cameras, Mobile phones with 4K video recording
Kjell Opseth	1936 births, 2017 deaths, Government ministers, Norwegian politicians
St. Martin, Graubünden	Former municipalities of Graubünden
Surcuolm	Former municipalities of Graubünden
Vella, Switzerland	Former municipalities of Graubünden
Vignogn	Former municipalities of Graubünden
Vrin	Former municipalities of Graubünden
San Martín de Trevejo	Municipalities in Extremadura
Oliva de Plasencia	Municipalities in Extremadura
Naudiha pranpur	Villages in India
Ulli Lommel	1944 births, 2017 deaths, Deaths from heart failure, German movie actors, German movie directors
Nava Semel	1954 births, 2017 deaths, Deaths from cancer, Jewish Israeli writers, Jewish screenwriters, Novelists, People from Tel Aviv, Playwrights
Thomas Finlay (judge)	1922 births, 2017 deaths, Irish politicians, Irish judges, People from Dublin
Buangkok MRT station	Mass Rapid Transit (Singapore) stations, Sengkang
Hermann Schwörer	1922 births, 2017 deaths, Former members of the German Bundestag, Former MEPs, MEPs for Germany, Politicians from Berlin, Politicians of the Christian Democratic Union of Germany
Anne Buydens	1919 births, 2021 deaths, Naturalized citizens of the United States, German movie actors, Belgian movie actors, American movie actors, American movie producers, American philanthropists, People from Hanover, Actors from Los Angeles, California
All the Money in the World	2017 movies, 2010s crime drama movies, American crime drama movies, British crime drama movies, English-language movies, J. Paul Getty, Kidnapping in fiction, Movies about dysfunctional families, Movies about extortion, Movies based on books, Movies directed by Ridley Scott, Movies set in Italy, Movies set in the 1970s, Movies set in Rome
David R. Bowen	1932 births, Living people, United States representatives from Mississippi, US Democratic Party politicians, 20th-century American politicians
Jean Spencer Ashbrook	1934 births, Living people, United States representatives from Ohio, Politicians from Cincinnati, Ohio, US Republican Party politicians
Ed Weber	1931 births, Living people, United States representatives from Ohio, People from Toledo, Ohio, US Republican Party politicians
Bill Gradison	1928 births, Living people, American mayors, United States representatives from Ohio, Politicians from Cincinnati, Ohio, Jewish American politicians, US Republican Party politicians
Ronald M. Mottl	1934 births, Living people, United States representatives from Ohio, American conservatives, US Democratic Party politicians, Politicians from Cleveland, Ohio
Tom Luken	1925 births, 2018 deaths, American mayors, American military personnel of World War II, Politicians from Cincinnati, Ohio, United States Marine Corps personnel, United States representatives from Ohio, US Democratic Party politicians
William J. Keating	1927 births, 2020 deaths, United States representatives from Ohio, Businesspeople from Ohio, Politicians from Cincinnati, Ohio, US Republican Party politicians
Jean Schmidt	1951 births, Living people, United States representatives from Ohio, Politicians from Cincinnati, Ohio, US Republican Party politicians
Brad Wenstrup	1958 births, Living people, United States representatives from Ohio, American physicians, American military people, Politicians from Cincinnati, Ohio, US Republican Party politicians
Graham McTavish	1961 births, Living people, Scottish movie actors, Scottish television actors, Scottish voice actors, Actors from Glasgow
Andhra University	Colleges and universities in India, 1920s establishments in India, 1926 establishments in Asia
Katrín Jakobsdóttir	1976 births, Living people, Current national leaders, Environmentalists, People from Reykjavík, Prime Ministers of Iceland
Reinforcement learning	Artificial intelligence, Learning
Sylvester Igboun	1990 births, Living people, Nigerian footballers, People from Lagos
Luka Đorđević	1994 births, Living people, Montenegrin footballers
Edwin Mosquera	1985 births, 2017 deaths, Colombian people, Murders by firearm, Weightlifters
Rizvan Utsiyev	1988 births, Living people, Russian footballers
Yevgeni Markov (footballer, born 1994)	1994 births, Living people, Russian footballers
Moscow "Southern Gate" Central Bus Terminal	Buildings and structures in Moscow, Bus transport
Vitinho	1993 births, Living people, Brazilian footballers, Brazilian sportspeople
Old Moscow Central Bus Terminal	Buildings and structures in Moscow, Bus transport
PSL Research University	Colleges and universities in France, 2010 establishments in Europe, Paris, 2010s establishments in France
Marek Frąckowiak	1950 births, 2017 deaths, Cancer deaths in Poland, Deaths from spinal cancer, People from Łódź, Polish movie actors, Polish stage actors, Polish television actors, Polish voice actors
James Marriott	CS1 errors: external links, 1730 births, 1803 deaths, Knights Bachelor, Members of the British House of Commons for English constituencies
Swiss Federal Railways	Transport companies of Switzerland, Train operating companies, 20th century establishments in Switzerland, 1902 establishments in Europe, Bern
Mon, Switzerland	Former municipalities of Graubünden
Davos Wiesen	Former municipalities of Graubünden
Nufenen	Former municipalities of Graubünden
Mozaffar ad-Din Shah Qajar	Kings and Queens consort, History of Iran, Iranian culture, 1853 births, 1907 deaths
Carles Santos	1940 births, 2017 deaths, Spanish movie directors, Spanish actors, Spanish artists, Spanish screenwriters, Photographers
Arif Dirlik	1940 births, 2017 deaths, Naturalized citizens of the United States, American historians, American educators, Turkish writers
Manuel Marín	1949 births, 2017 deaths, Deaths from lung cancer, Presidents of the Congress of Deputies (Spain), European Commissioners
Jimmy Hood	1948 births, 2017 deaths, Deaths from myocardial infarction, Scottish politicians
Ian Twitchin	1952 births, 2017 deaths, English footballers, English football managers, People from Devon
Mackenzie Crook	1971 births, Living people, Actors from Kent, BAFTA Award winning writers, British stand-up comedians, Comedians from Kent, English movie actors, English screenwriters, English stage actors, English television actors, English television directors, Writers from Kent
The Office (British TV series)	2001 establishments in the United Kingdom, 2001 television series debuts, 2003 British television series endings, 2000s British sitcoms, 2000s British workplace television series, 2000s satirical television series, 2000s workplace comedy television series, BBC television sitcoms, Berkshire, British satirical television series, British workplace comedy television series, Office comedy television series, English-language television programs
Bocconi University	Colleges and universities in Italy, Milan, 1902 establishments in Italy
Men's rights movement	Men
Elmar Faber	1934 births, 2017 deaths, German autobiographers, Publishers, People from Thuringia
Dylan Moran	1971 births, Living people, BAFTA Award winning actors, Irish movie actors, Irish stand-up comedians, Irish television actors, Irish writers
Henning Jensen	1949 births, 2017 deaths, Danish footballers, Disease-related deaths in Denmark
Jáchym Topol	1962 births, Living people, Czech journalists, Writers from Prague
Mutten, Switzerland	Former municipalities of Graubünden
Tiefencastel	Former municipalities of Graubünden
Manspach	Communes in Haut-Rhin
St. Margrethen	Municipalities of St. Gallen
Rudolf Gramlich	1908 births, 1988 deaths, German footballers, Sportspeople from Frankfurt
Ahmed Osman (politician)	1930 births, Living people, Prime Ministers of Morocco
Christine Keeler	1942 births, 2017 deaths, Deaths from COPD, English models, English entertainers, People from Middlesex
Lateran Treaty	1929 in Europe, Vatican City, 1920s treaties, 20th century in Italy
Ali Amini	1905 births, 1992 deaths, People from Tehran, Prime Ministers of Iran
Christmas card	Christmas
Johnny Hallyday	1943 births, 2017 deaths, Actors from Paris, Cancer deaths in France, Deaths from lung cancer, Disease-related deaths in Paris, French movie actors, French pop singers, French television actors, Musicians from Paris, Rock singers
Sheila Hancock	1933 births, Living people, Breast cancer survivors, Commanders of the Order of the British Empire, English movie actors, English stage actors, English television actors, People from the Isle of Wight
Rudolph G. Wilson	1935 births, 2017 deaths, African American writers, American academics, American educators, Writers from Detroit, Michigan
IC 418	Nebulae
Sculptor galaxy	Spiral galaxies
NGC 6861	Lenticular galaxies
Obi (store)	1970 establishments in Europe, Companies of Germany, North Rhine-Westphalia, 1970s establishments in Germany
Mulegns	Former municipalities of Graubünden
August Ames	1994 births, 2017 deaths, Actors from Colorado, Adult models, American adult models, American pornographic actors, Canadian models, Canadian movie actors, Canadian sex industry people, Entertainers from Nova Scotia, Naturalized citizens of the United States, People from Colorado Springs, Colorado, Suicides by hanging in the United States, Suicides in California
Me Too movement	October 2017 events, Time People of the Year, Internet culture, Feminism, Sexual abuse, Women's rights
1958 Atlantic hurricane season	Atlantic hurricane seasons
Parisa Damandan	Iran, Photographers, Iranian historians, 1967 births
Olivier Chansou	1965 births, Living people, Alumni of the École nationale de l'aviation civile, French aviators, Heads of the French Civil Aviation University
Parisa (given name)	Given names
Wakaleo schouteni	Marsupials of Australia, Extinct species
Anusvara	Writing systems
William H. Gass	1924 births, 2017 deaths, Deaths from heart failure, American critics, American novelists, American essayists, American short story writers, Writers from Ohio, People from Fargo, North Dakota, Writers from North Dakota
Ivan Korsak	1946 births, 2017 deaths, Editors, Ukrainian journalists, Novelists, Poets, Short story writers, Ukrainian writers
Philippe Maystadt	1948 births, 2017 deaths, Bankers, Belgian academics, Deaths from lung disease, Disease-related deaths in Belgium, Government ministers of Belgium, Jurists, Parti social-chrétien politicians, People from Verviers, Walloon politicians
Stephen Wiltshire	1974 births, Living people, Artists from London, Autistic savants, Black British people, Members of the Order of the British Empire
Mirza	Titles, Surnames, Noble families
Advent calendar	Calendars, Christmas
Edward Fox	1937 births, Living people, BAFTA Award winning actors, English movie actors, English television actors, English stage actors, Actors from London, Actors who played M
Ciara (album)	2004 albums
Catherine Tate	1968 births, living people, English movie actors, English television actors, English television writers, English voice actors, English stage actors, Actors from London, Comedians from London, Writers from London
The Blue Marble	Apollo program
Cherkasy Oblast	Oblasts of Ukraine
Chernihiv Oblast	Oblasts of Ukraine
Chernivtsi Oblast	Oblasts of Ukraine
Dnipropetrovsk Oblast	Oblasts of Ukraine
Donetsk Oblast	Oblasts of Ukraine
Ivano-Frankivsk Oblast	Oblasts of Ukraine
Kharkiv Oblast	Oblasts of Ukraine
Time in Greece	Time by country, Greece
Kherson Oblast	Oblasts of Ukraine
Khmelnytskyi Oblast	Oblasts of Ukraine
Kyiv Oblast	Oblasts of Ukraine
Lilac Fire	2017 in weather, 2017 California wildfires, December events
Alamo Fire (wildfire)	2017 California wildfires, 2017 in weather, July 2017 events
Detwiler Fire	2017 California wildfires, 2017 in weather, Mariposa County, California
Wikipedia administrators	Wikipedias, Internet, Occupations
Stierva	Former municipalities of Graubünden
Surava	Former municipalities of Graubünden
Israel Standard Time	Time by country, Israel
Time in Germany	Time by country, Germany
Alofi	Capital cities in Oceania, Niue
Karl Hohmann	1908 births, 1974 deaths, German footballers, People from Düsseldorf, Sportspeople from North Rhine-Westphalia
Inanna	Mesopotamia, Gods and goddesses
Ivo Frosio	1930 births, Swiss footballers, Living people
Guillaume Bieganski	1932 births, 2016 deaths, French footballers
Masevaux	Former communes in Haut-Rhin, 2016 disestablishments in France
Male breast cancer	Cancer
Roland Taylor	1946 births, 2017 deaths, Deaths from male breast cancer, Denver Nuggets players, Sportspeople from Washington, D.C.
Vladimir Curbet	1930 births, 2017 deaths, Moldovan people, Choreographers
The Facts of Life	1979 American television series debuts, 1988 disestablishments in the United States, 1970s American sitcoms, 1980s American sitcoms, American television spin-offs, American teen comedy television series, High school television series, Television series set in New York, English-language television programs
George Frederick Addison	Pages created with the Article Wizard from 2017
Bikol languages	Languages of Asia
Arthrostylidium distichum	Bamboo species
Arauca Department	Departments of Colombia
Atlántico Department	Departments of Colombia
Bolívar Department	Departments of Colombia
Caldas Department	Departments of Colombia
Caquetá Department	Departments of Colombia
Casanare Department	Departments of Colombia
Time in Sweden	Time by country, Sweden
Albula/Alvra	Municipalities of Graubünden, 2015 establishments in Switzerland
Vaz/Obervaz	Municipalities of Graubünden, Ski areas and resorts in Switzerland
Lenzerheide	Villages in Graubünden, Ski areas and resorts in Switzerland
Riom-Parsonz	Former municipalities of Graubünden
Sur, Switzerland	Former municipalities of Graubünden
Mertzen	Communes in Haut-Rhin
Merxheim, Haut-Rhin	Communes in Haut-Rhin
Cool colors	Color
Israel Daylight Time	Israel, Time zones
Time in Namibia	Time by country, Namibia
Joe Newton	1929 births, 2017 deaths, Coaches, Sportspeople from Illinois
Yılmaz Erdoğan	Living people, 1967 births, Turkish businesspeople, Turkish actors
Dan Harmon	1973 births, Living people, Actors from Milwaukee, Wisconsin, American screenwriters, American television writers, American voice actors, Writers from Wisconsin
Atsutoshi Nishida	1943 births, 2017 deaths, Deaths from myocardial infarction, Disease-related deaths in Japan, Japanese businesspeople, Presidents (organizations), Waseda University alumni
Santo Monti	Italian historians, Roman Catholic priests, People from Como, 1855 births, 1923 deaths
Maurice Green	1926 births, 2017 deaths, Scientists from New York City
Louis Henri de Pardaillan de Gondrin	1640 births, 1691 deaths, French people, French nobility
Booza	Mastic ice creams
Jacques Simon	1941 births, 2017 deaths, French footballers
Tinizong-Rona	Former municipalities of Graubünden
Salouf	Former municipalities of Graubünden
Surses	2016 establishments in Switzerland, Municipalities of Graubünden
Sunny Murray	1936 births, 2017 deaths, American jazz musicians, American drummers, Musicians from Philadelphia, Pennsylvania
Rapperswil-Jona	Municipalities of St. Gallen, Cities in Switzerland, 2000s establishments in Switzerland, 2007 establishments in Europe
James Joseph Brady	1944 births, 2017 deaths, Deaths from myocardial infarction, American lawyers, Politicians from St. Louis, Missouri, US Democratic Party politicians
Metzeral	Communes in Haut-Rhin
Meyenheim	Communes in Haut-Rhin
Lando Fiorini	1938 births, 2017 deaths, Deaths from mesothelioma, Cancer deaths in Italy, Italian movie actors, Italian television actors, Italian singers
Michelbach-le-Bas	Communes in Haut-Rhin
Michelbach-le-Haut	Communes in Haut-Rhin
Mittelwihr	Communes in Haut-Rhin
Manno Charlemagne	1948 births, 2017 deaths, Deaths from laryngeal cancer, Cancer deaths in Florida, Haitian people, Folk singers, Singer-songwriters, Guitarists, Political activists, Mayors
Antonio Riboldi	1923 births, 2017 deaths, Deaths from Alzheimer's disease, Disease-related deaths in Italy, Italian Roman Catholics, Roman Catholic bishops
History of Uruguay	History of Uruguay
Simeon Booker	1918 births, 2017 deaths, Deaths from pneumonia, Disease-related deaths in Maryland, African American writers, Writers from Baltimore, Maryland, Journalists from Ohio, People from Youngstown, Ohio
Volodymyr Groysman	1978 births, Living people, Prime Ministers of Ukraine, Ukrainian Jews, Mayors, Legislative speakers
Les Whitten	1928 births, 2017 deaths, Deaths from sepsis, Disease-related deaths in Maryland, American journalists, Writers from Jacksonville, Florida
Time in Ethiopia	Time by country, Ethiopia
2016-2017 South America floods	2016 disasters, 2017 disasters, 2010s floods, 2010s in South America, 21st century in Peru, Disasters in South America, History of Ecuador
Viktor Potapov	1947 births, 2017 deaths, Russian sportspeople, Olympic bronze medalists, Sailors
2026 Winter Olympics	2020s in sports, Winter Olympics in Europe
Baked beans	Beans, British food
Jack Welch	1935 births, 2020 deaths, Deaths from renal failure, Disease-related deaths in New York City, Engineers from Massachusetts, American chief executives, Scientists from Boston, Massachusetts, Businesspeople from Boston, Massachusetts, Writers from Boston, Massachusetts, People from Salem, Massachusetts
Peabody, Massachusetts	Cities in Massachusetts
Severance package	Employment
Cheese curd	Cheese
Cottage cheese	Cheese
Granola	Breakfast foods, Snack foods
Beans On Toast (musician)	1980 births, Living people, English singer-songwriters, Folk singers, Singers from Essex, Writers from Essex
Jewel-Osco	1890s establishments in Illinois, 1899 establishments in the United States, Companies based in Chicago, Illinois, Supermarkets of the United States
Ronald Venetiaan	1935 births, Living people, Presidents of Suriname, Mathematicians
Lalji Singh	1947 births, 2017 deaths, Deaths from myocardial infarction, Cardiovascular disease deaths in India, Indian scientists, Zoologists, People from Uttar Pradesh
Kazimierz Pawełek	1936 births, 2017 deaths, Polish journalists, Polish politicians, Polish writers
Kirovohrad Oblast	Oblasts of Ukraine
Luhansk Oblast	Oblasts of Ukraine
Lviv Oblast	Oblasts of Ukraine
Mykolaiv Oblast	Oblasts of Ukraine
Jessica Mauboy	1989 births, Living people, Australian movie actors, Australian pop singers, Australian singer-songwriters, Australian television actors, Eurovision Song Contest entrants, Indigenous Australian musicians, Musicians from the Northern Territory, R&B musicians, People from Darwin, Northern Territory
Odessa Oblast	Oblasts of Ukraine
Poltava Oblast	Oblasts of Ukraine
Rivne Oblast	Oblasts of Ukraine
Sumy Oblast	Oblasts of Ukraine
Ternopil Oblast	Oblasts of Ukraine
Vinnytsia Oblast	Oblasts of Ukraine
Volyn Oblast	Oblasts of Ukraine
Zaporizhia Oblast	Oblasts of Ukraine
Zhytomyr Oblast	Oblasts of Ukraine
Estádio da Luz	Buildings and structures in Portugal, Football in Portugal, Football stadiums in Europe, Lisbon, 2003 establishments in Europe
South Sudan national football team	National football teams, South Sudan
Keith Chegwin	1957 births, 2017 deaths, Actors from Liverpool, Deaths from idiopathic pulmonary fibrosis, Disease-related deaths in England, English child actors, English movie actors, English television actors, English television presenters, Television personalities from Lancashire
Tears for Fears	1981 establishments in England, English pop music groups, English rock bands, Musical groups established in 1981, New wave bands, People from Bath, Somerset
Molly Quinn	1993 births, Living people, Actors from Texas, American child actors, American movie actors, American stage actors, American television actors, American voice actors
Yellowstone Caldera	Volcanoes of the United States, Calderas, Wyoming, National parks in the United States
Cy Young (athlete)	1928 births, 2017 deaths, Deaths from vascular dementia, Disease-related deaths in California, American Olympic gold medalists, American track and field athletes, Sportspeople from California
Grant Munro	1923 births, 2017 deaths, Disease-related deaths in Canada, Canadian filmmakers, Canadian movie actors, Canadian animators, Actors from Winnipeg
Arroux	Rivers of France, Bourgogne-Franche-Comté, Auvergne-Rhône-Alpes
Vera Katz	1933 births, 2017 deaths, Deaths from leukemia, German Jews, Jewish American politicians, Jewish women politicians, Mayors of Portland, Oregon, Naturalized citizens of the United States, People from Düsseldorf, Politicians from New York City, Politicians from North Rhine-Westphalia, Refugees from Nazism, US Democratic Party politicians
Frank Ivancie	1924 births, 2019 deaths, American conservatives, Businesspeople from Portland, Oregon, Businesspeople from Minnesota, Mayors of Portland, Oregon, Politicians from Minnesota
Uriel	Angels, Christian saints
Perfect (Ed Sheeran song)	Beyoncé songs, 2017 songs, Ballads
Beaucamps-le-Vieux	Communes in Somme
Stadio San Paolo	Buildings and structures in Italy, Football in Italy, Football stadiums in Europe, Naples, 1959 establishments in Europe, 1950s establishments in Italy
MLS Cup 2016	Soccer in the United States, 2016 in the United States
Charles Robert Jenkins	1940 births, 2017 deaths, Deaths from heart failure, American military people, People from North Carolina
Roberto Firmino	1991 births, Living people, 2018 FIFA World Cup players, Footballers from Maceió, Liverpool F.C. players
Bud Clark	1931 births, Living people, Mayors of Portland, Oregon, Politicians from Idaho, US Democratic Party politicians
Denise Kandel	1933 births, Living people, Naturalized citizens of the United States, Holocaust survivors, French sociologists, American sociologists, Scientists from Paris
Song rhythm tracks	Music
Ed Lee (politician)	1952 births, 2017 deaths, American lawyers, Cardiovascular disease deaths in California, Deaths from myocardial infarction, Mayors of San Francisco, Politicians from Seattle, Washington, US Democratic Party politicians, 21st-century American politicians
Ilan Gilon	1956 births, Living people, Former Members of Knesset, Israeli former political leaders, Jewish Israeli politicians, Meretz politicians, Naturalized citizens of Israel, Romanian Jews
TamilFunda	Websites, India
Faizon Love	1968 births, Living people, American movie actors, American television actors
Aline Griffith, Dowager Countess of Romanones	1923 births, 2017 deaths, Spanish royalty, Spanish writers, Writers from New York
Suzanna Leigh	1945 births, 2017 deaths, Deaths from liver cancer, Cancer deaths in Florida, British movie actors, British television actors, British stage actors, Actors from Berkshire
Zarley Zalapski	1968 births, 2017 deaths, American Hockey League players, Calgary Flames players, Canadian ice hockey defencemen, Canadian Olympians, Hartford Whalers players, International Hockey League (1945–2001) players, Montreal Canadiens players, Philadelphia Flyers players, Pittsburgh Penguins players, Sportspeople from Edmonton, Swedish Hockey League players, Swiss ice hockey players
Bramall Lane	Football stadiums in England
David Chase	1945 births, Living people, American movie directors, American movie producers, American screenwriters, American television directors, American television producers, American television writers, Writers from New York, Emmy Award winners, People from Mount Vernon, New York
Doug Jones (politician)	1954 births, Living people, American lawyers, United States senators from Alabama, People from Fairfield, Alabama, Politicians from Alabama, US Democratic Party politicians
Pat DiNizio	1955 births, 2017 deaths, Disease-related deaths in New Jersey, American rock guitarists, American rock singers, American singer-songwriters, Writers from New Jersey, Musicians from New Jersey, Singers from New Jersey
Mountain States	Regions of the United States
David Lau	1966 births, Living people, Chief Rabbis of Israel, People from Tel Aviv
Yitzhak Yosef	1952 births, Living people, Chief Rabbis of Israel, People from Jerusalem
Bodice	Tops (clothing)
Mellophone	Musical instruments
Museum for Architectural Drawing	Buildings and structures in Berlin, Museums in Germany
Stanley Baxter	1926 births, Living people, Scottish movie actors, Scottish television actors, Radio actors, Scottish voice actors, Scottish comedians, Actors from Glasgow
Eileen Derbyshire	1931 births, Living people, English television actors, English movie actors, English stage actors, Actors from Lancashire
Barbara Knox	1933 births, Living people, British television actors, British movie actors, British stage actors, Actors from Greater Manchester, Actors from Lancashire
WWE Network	WWE
LFO (American band)	1995 establishments in the United States, 1990s establishments in Massachusetts, Musical groups established in 1995, 2002 disestablishments in the United States, Musical groups disestablished in 2002, 2009 establishments in the United States, Musical groups established in 2009, 2010 disestablishments in the United States, Musical groups disestablished in 2010, 2017 establishments in the United States, Musical groups established in the 2010s, American R&B bands, American pop rock bands, Musicians from Massachusetts, 2000s establishments in Massachusetts, 2000s disestablishments in Massachusetts
Warrel Dane	1961 births, 2017 deaths, Deaths from myocardial infarction, American singer-songwriters, American heavy metal musicians, American television actors, American voice actors, Singers from Seattle, Washington, Musicians from Seattle, Washington, Actors from Seattle, Washington, Writers from Washington
Idiopathic pulmonary fibrosis	Diseases
Pulmonary fibrosis	Diseases
Simon Dickie	1951 births, 2017 deaths, Accidental deaths from falls, New Zealand sportspeople, Olympic gold medalists, Olympic bronze medalists
Riot Games	Video game companies, American entertainment companies
Ivan Stoyanov	1949 births, 2017 deaths, Bulgarian footballers, People from Sofia
Alessandro Kokocinski	1948 births, 2017 deaths, Deaths from lymphoma, Cancer deaths in Italy, Argentine painters, Italian painters, Italian sculptors, People from Buenos Aires
Alma Adamkienė	1928 births, Living people, Lithuanian people, American philanthropists, Naturalized citizens of the United States, First Ladies
Neeraj Vora	1963 births, 2017 deaths, Cardiovascular disease deaths in India, Deaths from myocardial infarction, Deaths from stroke, Indian movie actors, Indian movie directors, Indian movie producers, Indian screenwriters
Lilian Marijnissen	1985 births, Living people, Dutch councillors, Dutch trade unionists, Dutch women politicians, Leaders of political parties in the Netherlands, Members of the House of Representatives of the Netherlands, People from Oss, Politicians from North Brabant, Socialist Party (Netherlands) politicians
Munier Choudhury	1925 births, 1971 deaths, Bangladeshi playwrights, Harvard University alumni, Recipients of the Independence Day Award, Bangla Academy Literary Award winners
Oss	Oss, Settlements in North Brabant, Cities in the Netherlands
Fred J. Doocy	1913 births, 2017 deaths, American centenarians, American military personnel of World War II, Bankers, Businesspeople from Hartford, Connecticut, Politicians from Hartford, Connecticut, Lieutenant Governors of Connecticut
List of Chief Rabbis of Israel	Chief Rabbis of Israel, Lists of Israeli people, Religion-related lists
Bangla Academy Literary Award	Bangladeshi awards, Literary awards, 1960 establishments in Asia, 20th century establishments in Bangladesh
Naagin (2015 TV series)	Hindi-language television series, 2015 Indian television series debuts, 2016 television series endings, 2010s disestablishments in India
Chief Rabbinate of Israel	Chief Rabbinate of Israel
Mad World	1982 songs, Rock songs
National Movie Awards (Bangladesh)	Bangladeshi awards, Movie awards, 1975 establishments in Asia, 1970s establishments in Bangladesh
Mouni Roy	1985 births, Living people, Indian television actors, Indian movie actors
Philosophy of mathematics	Mathematics, Philosophy
Mohammed El Filali	1945 births, Living people, Moroccan footballers
Savoy Truffle	The Beatles songs, 1968 songs
Jack Davis	1924 births, 2016 deaths, American comics artists, American cartoonists, American illustrators, People from Atlanta, Georgia, Deaths from stroke
Departments of Colombia	Departments of Colombia
Mittlach	Communes in Haut-Rhin
Mathon	Municipalities of Graubünden
Mitzach	Communes in Haut-Rhin
Krampus	Christmas, Folklore
Yu Kwang-chung	1928 births, 2017 deaths, Deaths from pneumonia, Taiwanese people, Poets, Taiwanese educators, Critics, Novelists, People from Nanjing
Dan Johnson (Kentucky politician)	1960 births, 2017 deaths, Suicides by firearm in the United States, American Christians, Politicians from Kentucky, Politicians from Louisiana, US Republican Party politicians
Tina Smith	1958 births, Living people, United States senators from Minnesota, Lieutenant Governors of Minnesota, Politicians from Albuquerque, New Mexico, US Democratic Party politicians
Karl-Erik Nilsson	1922 births, 2017 deaths, Swedish Olympians, Olympic gold medalists, Olympic bronze medalists
R. C. Sproul	1939 births, 2017 deaths, Deaths from COPD, Disease-related deaths in Florida, American radio personalities, American theologians, Writers from Pittsburgh, Pennsylvania
Conservative Democrat	United States Democratic Party
Frank Lary	1930 births, 2017 deaths, Deaths from pneumonia, Detroit Tigers players, New York Mets players, Milwaukee Braves players, Chicago White Sox players, Sportspeople from Alabama
Mark Takai	1967 births, 2016 deaths, Cancer deaths in the United States, Deaths from pancreatic cancer, Military people from Hawaii, Politicians from Honolulu, United States representatives from Hawaii
Bill Hudson (American football)	1935 births, 2017 deaths, American football defensive tackles, San Diego Chargers players, Sportspeople from South Carolina, People from Spartanburg, South Carolina
Rod (Slavic religion)	Slavic gods and goddesses
Jarilo	Slavic gods and goddesses
Eric the Victorious	Kings and Queens of Sweden
Rian Johnson	1973 births, Living people, Actors from Maryland, American movie actors, American movie directors, American movie producers, American screenwriters, American television actors, American television directors, People from Silver Spring, Maryland, Writers from Maryland
Gwendoline Christie	1978 births, Living people, English models, English movie actors, English stage actors, English television actors, People from West Sussex
Byron Dorgan	US Democratic Party politicians, United States senators from North Dakota, Writers from North Dakota, 1942 births, Living people
Charles Grodin	1935 births, 2021 deaths, Actors from Pittsburgh, Pennsylvania, American movie actors, American stage actors, American television actors, American television talk show hosts, Cancer deaths in Connecticut, Comedians from Pennsylvania, Deaths from bone marrow cancer, Jewish American actors, Jewish American writers, Jewish American comedians, Writers from Pittsburgh, Pennsylvania, Emmy Award winners
Dillon, Read & Co.	1832 establishments in the United States, 1997 disestablishments in the United States
Morgan Stanley Wealth Management	2009 establishments in New York (state), Finance, Companies based in New York City
Kannauj district	Districts of Uttar Pradesh
Arrondissements of the Haut-Rhin department	Arrondissements of France, Grand Est
Black Mamba (drug)	Drugs
Arrondissement of Altkirch	Arrondissements of France, Grand Est
Lones Wigger	1937 births, 2017 deaths, American Olympic gold medalists, American Olympic silver medalists, Cancer deaths in Colorado, Deaths from pancreatic cancer, Medalists at the 1964 Summer Olympics, Medalists at the 1972 Summer Olympics, People from Great Falls, Montana, Sportspeople from Montana, Sport shooters
Georges Loinger	1910 births, 2018 deaths, French centenarians, French Jews, French military people, Holocaust survivors, Military personnel of World War II, Order of Merit of the Federal Republic of Germany, People from Strasbourg
2017 eruption of Mount Agung	2017 in Asia, 2010s in Indonesia
A. B. M. Mohiuddin Chowdhury	1944 births, 2017 deaths, Bangladeshi politicians, Bangladeshi Muslims, Mayors
List of Chief Military Rabbis	Chief Military Rabbis of Israel, Lists of Israeli people, Lists of military people, Religion-related lists
Military Rabbinate	Israel Defense Forces, Judaism in Israel
OS X El Capitan	MacOS
Bruce Gray	1936 births, 2017 deaths, Deaths from brain cancer, Cancer deaths in Los Angeles, Canadian movie actors, Canadian television actors, Puerto Rican actors
Gerald O'Brien	1924 births, 2017 deaths, New Zealand politicians, Military personnel of World War II, People from Wellington
Yurizan Beltran	1986 births, 2017 deaths, Actors from Los Angeles, California, American pornographic actors, Drug-related deaths in the United States
Marilyn Ware	1943 births, 2017 deaths, Deaths from Alzheimer's disease, Ambassadors of the United States, American philanthropists, Businesspeople from Philadelphia, Pennsylvania, Politicians from Philadelphia, Pennsylvania, US Republican Party politicians
Heinz Wolff	1928 births, 2017 deaths, Alumni of University College London, British biologists, British engineers, British radio personalities, British television presenters, Cardiovascular disease deaths in London, Deaths from heart failure, Entertainers from Berlin, German Jews, Jewish British academics, Jewish British scientists, Jewish entertainers, Naturalised citizens of the United Kingdom, Refugees from Nazism, Scientists from Berlin
The Prophet (book)	1923 books
Tu An	1923 births, 2017 deaths, Deaths from Parkinson's disease, Chinese poets, Chinese translators
Sharon Laws	1974 births, 2017 deaths, Deaths from cervical cancer, British cyclists, Environmentalists
List of neighbourhoods of Chennai	Neighbourhoods of Chennai, India-related lists
Taramani	Neighbourhoods of Chennai
Avadi	Neighbourhoods of Chennai
Arrondissement of Colmar-Ribeauvillé	Arrondissements of France, Grand Est
Heavy Vehicles Factory	Chennai
Garfield Heights, Ohio	Cities in Ohio
Pratval	Former municipalities of Graubünden
Flag of Slovakia	Slovakia, National flags
Pangasinan language	Austronesian languages, Languages of the Philippines
Mœrnach	Communes in Haut-Rhin
Mollau	Communes in Haut-Rhin
Alaska Thunderfuck	1985 births, Living people, American musicians, American rap musicians from Pennsylvania, American R&B singers, American pop singers, Grammy Award winners, LGBT musicians, LGBT singers, Gay men, Drag queens, Musicians from Pennsylvania, Singers from Pennsylvania
Collapse of Hotel New World	20th century in Singapore, 1986 in Asia
Takeshi Kitano	1947 births, Living people, Japanese movie directors, Japanese movie actors, Japanese comedians, Japanese television personalities, Novelists, Designers, Japanese screenwriters, Japanese television actors, Japanese voice actors, Actors from Tokyo
Adam Darius	1930 births, 2017 deaths, Deaths from myocardial infarction, American dancers, American educators, American choreographers, American playwrights, Entertainers from New York City, Writers from New York City
Jo Baer	1929 births, Living people, American painters, Writers from Washington, People from Seattle, Washington
E. Hunter Harrison	1944 births, 2017 deaths, Deaths from myocardial infarction, Cardiovascular disease deaths in Florida, Businesspeople from Tennessee, People from Memphis, Tennessee
Len Ceglarski	1926 births, 2017 deaths, American ice hockey players, American Olympic silver medalists, Sportspeople from Massachusetts
Rodels	Former municipalities of Graubünden
Rothenbrunnen	Municipalities of Graubünden
Montreux-Jeune	Communes in Haut-Rhin
Montreux-Vieux	Communes in Haut-Rhin
Turco-Mongol	Ethnology, Mongol peoples, Turkic peoples
Gorno-Altaysk	Siberia, Capitals of republics of Russia
Arrondissement of Mulhouse	Arrondissements of France, Grand Est
Arrondissement of Thann-Guebwiller	Arrondissements of France, Grand Est
Byrsonima crassifolia	Malpighiales
List of political parties in Malaysia	Malaysia, Lists of political parties, Politics of Asia
Minster-in-Thanet	Villages in Kent
Djembe	Drums, Folk instruments
Siquijor	Islands of the Philippines, Provinces of the Philippines
Drapetomania	Pseudoscience
243 (number)	Integers
6000 (number)	Integers
Walter Mafli	1915 births, 2017 deaths, Swiss painters, Swiss centenarians
Ye Zhengda	1927 births, 2017 deaths, Chinese politicians, Chinese academics, Communists, Chinese engineers
Bernard Sherman	1942 births, 2017 deaths, Canadian businesspeople, Billionaires, People from Toronto
Ralph Carney	1956 births, 2017 deaths, Accidental deaths from falls in the United States, American composers, American jazz musicians, American saxophonists, American clarinetists, Singers from Ohio, Musicians from Ohio
Richard Dobson	1942 births, 2017 deaths, Deaths from esophageal cancer, Cancer deaths in Switzerland, American singer-songwriters, American country guitarists, American folk singers, American folk musicians, Singers from Texas, Musicians from Texas, Writers from Texas
777 (number)	Integers
Z'EV	1951 births, 2017 deaths, Deaths from sepsis, American poets, Musicians from Los Angeles, California, Writers from Los Angeles, California
Argumentum ad lazarum	Rhetoric
Johnny Fox (performer)	1953 births, 2017 deaths, Deaths from liver cancer, American magicians, People from Minneapolis, Minnesota, People from Hartford, Connecticut
Bob Glidden	1944 births, 2017 deaths, Deaths from colorectal cancer, American racecar drivers, Sportspeople from Indiana
Jonghyun	1990 births, 2017 deaths, Suicides by poison, Deaths from carbon monoxide poisoning, South Korean actors, South Korean singers, Radio personalities, K-pop singers
Kevin Mahogany	1958 births, 2017 deaths, Deaths from heart failure, Cardiovascular disease deaths in the United States, American jazz musicians, American jazz singers, Singers from Kansas City, Missouri, Musicians from Kansas City, Missouri
Basque alphabet	Basque language, Alphabets
Dotted and dotless I	Vowel letters, Turkic languages, Latin letters with diacritics
Tree of Jesse	Christian symbols, Christian art
List of Bangla Academy Literary Award winners (1960s)	Bangla Academy Literary Award winners, Lists of people
List of Bangla Academy Literary Award winners (1970s)	Bangla Academy Literary Award winners, Lists of people
List of Bangla Academy Literary Award winners (1980s)	Bangla Academy Literary Award winners, Lists of people
List of Bangla Academy Literary Award winners (1990s)	Bangla Academy Literary Award winners, Lists of people
List of Bangla Academy Literary Award winners (2000s)	Bangla Academy Literary Award winners, Lists of people
List of Bangla Academy Literary Award winners (2010s)	Bangla Academy Literary Award winners, Lists of people
Dana Gould	1964 births, Living people, Actors from Massachusetts
Prothom Alo	1998 establishments in Asia, Newspapers in Asia, 20th century establishments in Bangladesh
Avadi Railway Station	Railway stations in Asia, Chennai District
Royapuram railway station	Chennai District, Transport in India
Syed Waliullah	1922 births, 1971 deaths, Bangladeshi writers, Bangla Academy Literary Award winners, Recipients of the Ekushey Padak, Bangladeshi Muslims, Recipients of Bangladesh National Film Awards
List of world champion football clubs	FIFA, CONMEBOL, Football competitions, UEFA
Glamtron	2009 albums, Mixtape albums
Blue raspberry flavor	Food ingredients
Trannyshack	Events, LGBT entertainers, San Francisco
Heklina	Year of birth missing (living people), Living people, American movie actors, American television actors
World of Wonder	Companies based in Los Angeles, 1991 establishments in California
Meskhenet	Egyptian gods and goddesses
Jua Cali	Kenyan people, Rap musicians, 1979 births, Living people
Charles Byron Renfrew	1928 births, 2017 deaths, American lawyers, American judges, Politicians from Detroit, Michigan, US Democratic Party politicians, United States Deputy Attorneys General
Altero Matteoli	1940 births, 2017 deaths, Road accident deaths, Italian politicians, Mayors, Politicians from Tuscany
Josef Pešice	1950 births, 2017 deaths, Czech footballers, Czech football managers, Sportspeople from Prague
Arseny Roginsky	1946 births, 2017 deaths, Russian historians, Activists
Newcomb's paradox	Thought, Experiments, Philosophy, Logical paradoxes
Bernard Francis Law	1931 births, 2017 deaths, American Roman Catholics, Cancer deaths in Italy, Cardinals of the Roman Catholic Church, Deaths from prostate cancer, Roman Catholic archbishops
Lito Cruz	1941 births, 2017 deaths, Deaths from myocardial infarction, Argentine movie actors, Argentine television actors, Argentine stage actors, Argentine writers, Argentine playwrights, Argentine movie directors, Argentine theatre directors
Lin Shaye	1943 births, Living people, American movie actors, American television actors, American voice actors, American stage actors, Jewish American actors, Actors from Detroit, Michigan
A Wrinkle in Time (2018 movie)	2018 science fiction movies, 2010s fantasy movies, 2010s adventure movies, American science fiction movies, American fantasy movies, American adventure movies, Movies based on books, English-language movies, Disney movies, Movies set in Los Angeles, California
Agostino Cacciavillan	1926 births, Living people, Cardinals of the Roman Catholic Church, Italian Roman Catholics, Diplomats
Japanese name	Names, Japan
Deindustrialization	Society, Industries
Halbe Zijlstra	1969 births, Living people, Deputy government ministers of the Netherlands, Dutch councillors, Former members of the House of Representatives of the Netherlands, Government ministers of the Netherlands, People's Party for Freedom and Democracy politicians, Politicians from Friesland
Oosterwolde, Friesland	Settlements in Friesland
Zijlstra	Surnames
House of Representatives (Netherlands)	States General of the Netherlands, National lower houses
Episcopal Church	Anglicanism
Danish resistance movement	20th century in Denmark, Resistance movements of World War II
Janet Benshoof	1947 births, 2017 deaths, Deaths from uterine cancer, Cancer deaths in New York City, American human rights activists, American lawyers, People from Minnesota
Uterine cancer	Cancer, Deaths from uterine cancer
Florence Bjelke-Petersen	1920 births, 2017 deaths, Deaths from cardiopulmonary arrest, Australian politicians, Politicians from Brisbane
Henryk Cioch	1951 births, 2017 deaths, Deaths from staphylococcal infection, Polish politicians, Polish educators, Polish lawyers
List of A.N.T. Farm episodes	Lists of television series episodes, Children's television series
Annie Goetzinger	1951 births, 2017 deaths, Cancer deaths in France, Comics artists, Deaths from endometrial cancer, French artists, French novelists, Writers from Paris
Red Murrell	1933 births, 2017 deaths, Deaths from coronary artery disease, Cardiovascular disease deaths in the United States, American basketball players, Sportspeople from Missouri
Len Cariou	Tony Award winning actors, Drama Desk Award winners, 1939 births, Living people, Canadian movie actors, Canadian television actors, Canadian stage actors, Canadian voice actors, Canadian singers, Actors from Manitoba
Spotlight (movie)	Academy Award winning movies, 2015 drama movies, American crime movies, American drama movies, American biographical movies, Movies set in Boston, Massachusetts, Movies set in the 2000s
Arash Behzadi	Living people, Musicians from Ontario, Canadian pianists
Dunblane massacre	1996 in the United Kingdom, 1990s crimes in the United Kingdom, 1990s murders in Europe, 20th century in Scotland, Attacks on buildings and structures in the 1990s, Attacks on buildings and structures in the United Kingdom, Attacks on schools in Europe, March events, Mass murder in 1996, Mass shootings in Europe, Mass shootings in the 1990s, Massacres in the United Kingdom, Murder in Scotland, Murder-suicides in Europe, Murders by firearm in the United Kingdom, School shootings
Borsele	Municipalities of Zeeland
Mortimer L. Downey	Living people, 1936 births, United States Secretaries of Transportation, Yale University alumni
Antigonish	Towns in Nova Scotia
Middleton, Nova Scotia	Towns in Nova Scotia
The Terminal	2004 comedy-drama movies, 2004 romance movies, American comedy-drama movies, American romance movies, English-language movies, French-language movies, Movies composed by John Williams, Movies directed by Steven Spielberg
Thusis	Municipalities of Graubünden, Cities in Switzerland
Cousin marriage	Marriage, Genetic disorders
Jamie Kennedy	1970 births, Living people, American comedians, American movie actors, American television actors, American voice actors, Actors from Pennsylvania
Cathy Weseluck	1970 births, Living people, Actors from Toronto, Actors from Vancouver, Canadian singers, Canadian movie actors, Radio actors, Canadian television actors, Canadian comedians, Canadian voice actors, Musicians from Ontario, Musicians from Vancouver, Canadian Christians
Kapampangan language	Austronesian languages, Languages of the Philippines
Rudawa, Lesser Poland Voivodeship	Villages in Poland
Rząska	Villages in Poland
FC Ingolstadt 04	2004 establishments in Europe, German football clubs, Sport in Bavaria
Moosch	Communes in Haut-Rhin
Cesar Department	Departments of Colombia
Chocó Department	Departments of Colombia
WWE Clash of Champions	WWE
Cham (singer)	Jamaican singers, Reggae musicians, 1979 births, Living people
June Rowlands	1924 births, 2017 deaths, Deaths from Parkinson's disease, Disease-related deaths in Canada, Mayors of Toronto
Spartacus League	Communist parties, Marxism
Manouchehr Boroumand	1934 births, 2017 deaths, Deaths from cerebral hemorrhage, Iranian sportspeople, Olympians, Weightlifters
Jerry Yellin	1924 births, 2017 deaths, Deaths from lung cancer, Cancer deaths in Florida, American military personnel of World War II, People from Newark, New Jersey
Clifford Irving	1930 births, 2017 deaths, Deaths from pancreatic cancer, Cancer deaths in Florida, American novelists, Journalists from New York City, Criminals from New York City, American fraudsters, American literature, Cornell University alumni, People from Manhattan, Writers from New York City
Stan Pilecki	1947 births, 2017 deaths, Australian rugby union players, Disease-related deaths in Queensland, People from Brisbane, Sportspeople from Queensland
Ken Catchpole	1939 births, 2017 deaths, Australian rugby union players, Sportspeople from New South Wales
Hiep Thi Le	1971 births, 2017 deaths, Deaths from stomach cancer, Cancer deaths in Los Angeles, Naturalized citizens of the United States, Vietnamese people, American movie actors, American television actors, Actors from Los Angeles, California
Francelino Pereira	1921 births, 2017 deaths, Deaths from pneumonia, Disease-related deaths in Brazil, Brazilian politicians
Dylan Bruce	1980 births, Living people, Actors from Vancouver, Canadian movie actors, Canadian television actors
Steven Van Zandt	1950 births, Living people, Actors from Massachusetts, Actors from New Jersey, American movie actors, American rock guitarists, American television actors, Mandolinists, Musicians from Massachusetts, Musicians from New Jersey
Tram stop	Tram transport
Flag of the Gambia	National flags, The Gambia
Sils im Domleschg	Municipalities of Graubünden
Springdale, Ohio	Cities in Ohio
Mooslargue	Communes in Haut-Rhin
Pia Olsen Dyhr	Danish politicians
Starrkirch-Wil	Municipalities of the canton of Solothurn
National Volleyball Association	Sports in the United States, Volleyball, Sports leagues
Charles Zentai	1921 births, 2017 deaths, Deaths from peripheral neuropathy, Cardiovascular disease deaths in Australia, People from Perth, Western Australia, War criminals, People from Budapest, Extradition
Reinhart Fuchs	1934 births, 2017 deaths, East German sportspeople, German chess players, People from Berlin
Åke Hellman	1915 births, 2017 deaths, Finnish artists, People from Helsinki
Seal (musician)	1963 births, Living people, Black British musicians, Brit Award winners, British soul musicians, English singer-songwriters, Grammy Award winners, People from Paddington, Singers from London, Warner Bros. Records artists
March Fong Eu	1922 births, 2017 deaths, Deaths from surgical complications, Ambassadors of the United States, Politicians from California, US Democratic Party politicians, State legislators of the United States
Halvard Kausland	1945 births, 2017 deaths, Deaths from thyroid cancer, Cancer deaths in Norway, Norwegian entertainers, Jazz musicians, Guitarists
Bruce McCandless II	1937 births, 2017 deaths, American astronauts, American military people, Engineers from Massachusetts, Scientists from Boston, Massachusetts
Roswell Rudd	1935 births, 2017 deaths, Deaths from prostate cancer, Cancer deaths in New York, American jazz musicians, American composers, American trombonists, Musicians from Connecticut
Jason Lowndes	1994 births, 2017 deaths, Cyclists, Road accident deaths, Sportspeople from Western Australia
Gerald B. Greenberg	1936 births, 2017 deaths, Academy Award winners, American movie editors, BAFTA Award winners, Cardiovascular disease deaths in California, Deaths from stroke, People from New York City
Silvia Legrand	1927 births, 2020 deaths, Deaths from cardiac arrest, Argentine actors
Mirtha Legrand	1927 births, Living people, Argentine actors
Dick Savitt	1927 births, Living people, American tennis players, Sportspeople from New Jersey, People from Bayonne, New Jersey
Reimerswaal	Municipalities of Zeeland
Doki Doki Literature Club!	2017 video games, Horror, Visual novels, Windows games, MacOS games
Shinjitai	Writing systems, Chinese language, Chinese characters
Your Name	2016 drama movies, 2010s anime, Japanese movies, Japanese-language movies, 2010s fantasy movies, Time travel movies, 2016 animated movies, Movies about dreams
Jesús Castillo Rangel	1896 births, 2017 deaths, Deaths from respiratory failure, Military people, Mexican people, Supercentenarians
John Joubert	1927 births, 2019 deaths, South African writers, British composers, People from Cape Town
The Equals	1965 establishments in England, English pop music groups, English R&B bands, English rock bands, Musical groups established in 1965, Musical groups from London
Eddy Grant	1948 births, Living people, Black British musicians, English rock guitarists, English singer-songwriters, Reggae musicians, Singers from London
Drea de Matteo	1972 births, Living people, Actors from Queens, American movie actors, American television actors, Emmy Award winning actors
Cash Levy	Living people, American stand-up comedians, American comedians, Actors from St. Louis, Missouri
Edgar Wright	1974 births, Living people, Actors from Somerset, British movie actors, British movie directors, British movie producers, British screenwriters, British television actors, British television directors, British television writers, People from Poole, Writers from Dorset, Writers from Somerset
The New Zealand Herald	1863 establishments, Newspapers, New Zealand, 1860s establishments in New Zealand
Paulo Costanzo	1978 births, Living people, Actors from Ontario, Canadian Jews, Canadian movie actors, Canadian television actors, Jewish actors
Andrey Zaliznyak	1935 births, 2017 deaths, Russian historians, Russian educators, Linguists, People from Moscow
Charlotte Mailliard Shultz	1933 births, Living people, American diplomats, American socialites, Businesspeople from Texas, Businesspeople from San Francisco, Politicians from Texas, Politicians from San Francisco, Women diplomats
Thann, Haut-Rhin	Communes in Haut-Rhin, Subprefectures in France
Cyril Beavon	1937 births, 2017 deaths, English footballers
Gotthard Base Tunnel	Tunnels, Buildings and structures in Switzerland, Canton of Uri, Ticino, Graubünden
Mike Rutherford	1950 births, English guitarists, English songwriters
Trans, Switzerland	Former municipalities of Graubünden, Villages in Graubünden
Steve Hackett	English guitarists, English singers
Goran Višnjić	1972 births, American movie actors, American television actors, American Roman Catholics, Croatian actors, Stage actors, Living people
Morschwiller-le-Bas	Communes in Haut-Rhin
TUI Group	1923 establishments in Europe, Companies of Germany, Tourism, Hanover, 1920s establishments in Germany
Putumayo Department	Departments of Colombia
Jerry Kindall	1935 births, 2017 deaths, Deaths from stroke, Cardiovascular disease deaths in Arizona, Chicago Cubs players, Cleveland Indians players, Minnesota Twins players, Sportspeople from Saint Paul, Minnesota
Diana Athill	1917 births, 2019 deaths, British centenarians, Editors, British novelists, Writers from Norfolk
Stephanie Cole	1941 births, Living people, English movie actors, English television actors, English voice actors, English stage actors, English radio actors, People from Solihull
Olympiacos S.C.	Volleyball clubs, Sports organizations, Sport in Greece, 1926 establishments in Greece
Pedro Pablo Kuczynski	1938 births, Living people, Presidents of Peru, Prime Ministers of Peru, Economists, Civil servants, People from Lima
Aden	Cities in Yemen, Port cities in the Arabian Peninsula, Port cities and towns of the Red Sea, Capital cities in Asia, Former national capitals
2019 Cricket World Cup	Cricket World Cup, 2019 in sports, 2010s in England
Ig Nobel Prize	Parodies, Science awards
Cybercrime	Computing
Magnetic levitation	Physics
Horseland (TV series)	2006 television series debuts, 2008 television series endings, Animated television series, Television series by Cookie Jar Entertainment
Heather Menzies	1949 births, 2017 deaths, Deaths from brain cancer, Cancer deaths in Ontario, Canadian movie actors, Canadian television actors, Canadian voice actors, Canadian models, Naturalized citizens of the United States, American movie actors, American television actors, American voice actors, American activists, American models, Actors from Toronto, Actors from Utah
Rod Sykes	1929 births, Living people, Mayors, Politicians from Montreal, People from Calgary
Heather North	1945 births, 2017 deaths, Deaths from cardiopulmonary arrest, Deaths from bronchitis, Disease-related deaths in California, American movie actors, American television actors, American voice actors, Actors from Pasadena, California
LaToya Cantrell	1972 births, Living people, Mayors of New Orleans, Politicians from Los Angeles, California, US Democratic Party politicians
Dimitri (clown)	1935 births, 2016 deaths, Clowns, Swiss people
Cervelat	Sausage, German food, Italian food, Swiss food
Stelio De Carolis	1937 births, 2017 deaths, Politicians from Lazio, Road accident deaths
Mortzwiller	Former communes in Haut-Rhin
Muespach	Communes in Haut-Rhin
The Blue Party (Germany)	Political parties in Germany, Conservative parties, Eurosceptic parties, 2017 establishments in Europe, 2010s establishments in Germany, 2010s disestablishments in Germany
Julio Medina	1933 births, Living people, Colombian entertainers, Colombian movie actors, Colombian television actors
Piyaa Albela	Hindi-language television series, Soap operas, Indian culture, 2017 Indian television series debuts
Larry Libertore	1939 births, 2017 deaths, Deaths from aortic aneurysm, Cardiovascular disease deaths in Florida, American football players, Sportspeople from Florida, Politicians from Florida, Businesspeople from Ohio, Sportspeople from Ohio, Politicians from Ohio, US Democratic Party politicians
Shahnon Ahmad	1933 births, 2017 deaths, Deaths from bladder cancer, Malaysian politicians, Novelists, Essayists, Educators
Don Hogan Charles	1938 births, 2017 deaths, American photographers, People from New York City, African-American photographers
William Agee	1938 births, 2017 deaths, Deaths from respiratory failure, Disease-related deaths in Washington (state), Businesspeople from Idaho, People from Boise, Idaho
Willie Toweel	1934 births, 2017 deaths, Deaths from Alzheimer's disease, South African sportspeople, Boxers, Olympic bronze medalists
Héctor Morera Vega	1926 births, 2017 deaths, Deaths from pneumonia, Costa Rican people, Bishops
Louise Redknapp	Louise Redknapp, People from London, 1974 births, Living people, Musicians from Kent, British R&B musicians, English pop singers
Wyśmierzyce	Towns in Poland
Mahabharat	Hindi-language television series, Indian culture, 2013 television series debuts, 2013 establishments in India, 2014 Indian television series endings
Eco-nationalism	Nationalism
Haguenau	Communes in Bas-Rhin, Subprefectures in France
Gualtiero Marchesi	1930 births, 2017 deaths, Deaths from cardiac arrest, Italian chefs, People from Milan
Molsheim	Communes in Bas-Rhin, Subprefectures in France
Linda Hunt	Academy Award winning actors, 1945 births, Living people, American movie actors, American television actors, American voice actors, American stage actors, American video game actors, American activists, Lesbians, LGBT actors, People with dwarfism, Actors from New Jersey, Actors from Chicago, Actors from Connecticut, LGBT people from New Jersey, LGBT people from Chicago, LGBT people from Connecticut, DePaul University alumni
Naked (Louise album)	1996 albums, Debut albums, Louise albums, Pop albums, Blue-eyed soul albums, R&B albums
Woman in Me (Louise album)	1997 albums, Louise albums, Pop albums, Dance albums, R&B albums
Elbow Beach (album)	2000 albums, Louise albums, Pop albums, Hip hop soul albums, R&B albums
Evan Goldberg	1982 births, Living people, Canadian movie directors, Canadian movie producers, Canadian Jews, Canadian screenwriters, Canadian television writers, Jewish writers, People from Vancouver
2021 German federal election	Elections in Germany, German Bundestag, 2020s in Germany, 2021 in Europe, 2021 elections, September 2021 events
Dermot Morgan	1952 births, 1998 deaths, Actors from Dublin, Irish comedians, Irish movie actors, Irish television actors, Teachers
Goes	Cities in the Netherlands, Municipalities of Zeeland, Settlements in Zeeland
Veere	Cities in the Netherlands, Municipalities of Zeeland, Settlements in Zeeland
Your Lie in April	Japanese movies, 2016 movies, Japanese-language movies
Sergio Magaña Martínez	1949 births, 2017 deaths, Mexican politicians, People from Michoacán, Mayors
Andrijevica	Cities in Montenegro, Municipalities of Montenegro
Bar, Montenegro	Cities in Montenegro, Municipalities of Montenegro
Berane	Cities in Montenegro, Municipalities of Montenegro
Bijelo Polje	Cities in Montenegro, Municipalities of Montenegro
Chimie ParisTech	Technical colleges and universities in Paris, 1896 establishments in Europe, 1890s establishments in France
Budva	Cities in Montenegro, Municipalities of Montenegro
Žabljak	Municipalities of Montenegro
Tumegl/Tomils	Former municipalities of Graubünden
Muespach-le-Haut	Communes in Haut-Rhin
Muhlbach-sur-Munster	Communes in Haut-Rhin
Munchhouse	Communes in Haut-Rhin
Eider	Geography of Schleswig-Holstein, Rivers of Germany
Munster, Haut-Rhin	Communes in Haut-Rhin
Muntzenheim	Communes in Haut-Rhin
Munwiller	Communes in Haut-Rhin
World of Quest	2008 American television series debuts, 2009 television series endings, Animated television series, Television series by Cookie Jar Entertainment, 2008 Canadian television series debuts, 2009 disestablishments in the United States, 2000s disestablishments in Canada
Saverne	Communes in Bas-Rhin, Subprefectures in France
Model Town Lahore	Towns in Lahore
Sélestat	Communes in Bas-Rhin, Subprefectures in France
Evin Salgut Şahin	Pages created with the Article Wizard from 2017, Living people, 1979 births, Kurdish people
Jack Blessing	1951 births, 2017 deaths, Deaths from pancreatic cancer, Cancer deaths in California, American movie actors, American television actors, American voice actors, Actors from Baltimore, Maryland
Muriel Turner, Baroness Turner of Camden	1927 births, Politicians from London
Ben Barres	1954 births, 2017 deaths, Deaths from pancreatic cancer, Cancer deaths in California, American biologists, Transgender and transsexual people, LGBT people from New Jersey, Scientists from New Jersey
Osvaldo Fattori	1922 births, 2017 deaths, Italian footballers
Gonzalo Morales Sáurez	1945 births, 2017 deaths, Deaths from myocardial infarction, Costa Rican people, Painters
Alfie Curtis	1930 births, 2017 deaths, British movie actors, British television actors, British voice actors, British stage actors, Actors from London
F(x) (band)	Musical groups established in 2009, Musical quartets
Shih Ming-teh	1941 births, Living people, Taiwanese politicians, Activists, Writers
Henry Fok	1923 births, 2006 deaths, Chinese businesspeople
Cystocele	Reproductive system, Surgery, Urinary system
Hazro	Districts of Turkey
European School of Strasbourg	2008 establishments in France, Schools in France, Strasbourg
Bob Katter	1945 births, Living people, Australian Roman Catholics, Independent politicians in Australia, Members of the Australian House of Representatives, Politicians from Queensland
2 Faced	2000 songs, Louise songs, Hip hop soul songs, Blue-eyed soul songs, R&B songs
Savage Garden	Musical groups disestablished in 2001, Australian pop music groups, Musical groups established in 1993, Musicians from Queensland, 1990s establishments in Australia, 2000s disestablishments in Australia
Bruche (river)	Rivers of France, Grand Est
Wei Jingsheng	1950 births, Human rights activists, Living people
Moder (river)	Rivers of France, Grand Est
Virgil van Dijk	1991 births, Living people, Dutch footballers, Liverpool F.C. players, People from Breda, Sportspeople from North Brabant
Wang Dan	1969 births, Chinese people, Human rights activists, Harvard University alumni, Living people
Veritas (mythology)	Roman gods and goddesses
Jean-François Hory	1949 births, 2017 deaths, French politicians
Murbach	Communes in Haut-Rhin
Nambsheim	Communes in Haut-Rhin
Fernando Birri	1925 births, 2017 deaths, Deaths from respiratory arrest, Accidental deaths from falls, Argentine movie actors, Argentine movie directors, Critics, Actors from Buenos Aires
Neuf-Brisach	Communes in Haut-Rhin, World Heritage Sites in France
Neuwiller	Communes in Haut-Rhin
Sufers	Municipalities of Graubünden
Zorn (river)	Rivers of France, Grand Est
Hsu Hsin-liang	1941 births, Taiwanese politicians, Living people
John Thomaides	Mayors
D Shivakumar	Living people, Year of birth missing (living people), Management, Bangalore
Wiltz (river)	Rivers of Belgium, Rivers of Luxembourg, Luxembourg (Belgium)
Niederbruck	Former communes in Haut-Rhin, 2016 disestablishments in France
Niederentzen	Communes in Haut-Rhin
Niederhergheim	Communes in Haut-Rhin
Niedermorschwihr	Communes in Haut-Rhin
Sue Grafton	1940 births, 2017 deaths, American novelists, American screenwriters, Cancer deaths in California, Writers from Louisville, Kentucky
Pacific Islands Rugby Alliance	Rugby
Jimmie C. Holland	1928 births, 2017 deaths, Deaths from myocardial infarction, Cardiovascular disease deaths in New York City, American psychiatrists, Scientists from Texas
Thomas Hunter	1932 births, 2017 deaths, Deaths from pulmonary edema, Disease-related deaths in Connecticut, American movie actors, American television actors, American stage actors, American screenwriters, Actors from Georgia (U.S. state), Writers from Georgia (U.S. state), Actors from Connecticut, Writers from Connecticut
Carmen Franco, 1st Duchess of Franco	1926 births, 2017 deaths, Deaths from lymphoma, Cancer deaths in Spain, Princes and princesses, Spanish royalty
Sid and Marty Krofft	1929 births, 1937 births, Living people, Sibling duos, Television producers, People from Montreal
Zubin Mehta	1936 births, Living people, Conductors, People from Mumbai
Chuck Close	1940 births, 2021 deaths, American photographers, American painters, People from Everett, Washington, Artists from New York City, Deaths from congestive heart failure, Deaths from frontotemporal dementia
Alcee Hastings	1936 births, 2021 deaths, American judges, Deaths from pancreatic cancer, Cancer deaths in Florida, United States representatives from Florida, US Democratic Party politicians
Deaths in 2018	2018 deaths, Index lists
Van Nuys	Neighborhoods of Los Angeles
Deaths in January 2018	2018 deaths, January 2018 events
Rampage (2018 movie)	2018 science fiction movies, 2010s action movies, 2010s monster movies, English-language movies, American action movies, American monster movies, American science fiction movies, Movies set in Chicago, Illinois, Movies shot in Chicago, Illinois, Warner Bros. movies, Movies about animals, Giant gorilla movies
2017 UK Independence Party leadership election	2017 in the United Kingdom, September 2017 events, 2017 elections
Bulgarian Communist Party	1919 establishments in Europe, 1989 disestablishments in Europe, Communist parties
Type 56 assault rifle	Assault rifles
William Wright	1925 births, Living people, Northern Ireland politicians, British businesspeople, Activists
Recy Taylor	1919 births, 2017 deaths, Deaths from congestive heart failure, American civil rights activists, American crime victims, People from Alabama
Hulst	Municipalities of Zeeland, Settlements in Zeeland, Cities in the Netherlands
Terneuzen	Cities in the Netherlands, Municipalities of Zeeland, Settlements in Zeeland
Tabarnia	Catalonia, Politics of Spain
Sluis	Cities in the Netherlands, Municipalities of Zeeland, Settlements in Zeeland
Action camera	Cameras, Electronics, Sports equipment
Michael Massee	1952 births, 2016 deaths, American movie actors, American television actors, American voice actors, Actors from Kansas City, Missouri, Cancer deaths in California, Deaths from stomach cancer
Niffer	Communes in Haut-Rhin
Oberbruck	Communes in Haut-Rhin
Davido	1992 births, Nigerian people
Oberentzen	Communes in Haut-Rhin
Oberhergheim	Communes in Haut-Rhin
Oberlarg	Communes in Haut-Rhin
Obermorschwihr	Communes in Haut-Rhin
Obermorschwiller	Communes in Haut-Rhin
Obersaasheim	Communes in Haut-Rhin
Oderen	Communes in Haut-Rhin
Oltingue	Communes in Haut-Rhin
Orbey	Communes in Haut-Rhin
Orschwihr	Communes in Haut-Rhin
Erica Garner	1990 births, 2017 deaths, Deaths from myocardial infarction, Cardiovascular disease deaths in New York City, American activists, People from Brooklyn
Jean-Pierre Lehmann	1945 births, 2017 deaths, Deaths from pulmonary embolism, Disease-related deaths in Switzerland, American economists, Swiss scientists, Scientists from Washington, D.C.
John C. Portman Jr.	1924 births, 2017 deaths, Deaths from heart failure, American architects, Real estate developers, People from South Carolina, Businesspeople from Atlanta, Georgia
Khalid Shameem Wynne	1953 births, 2017 deaths, Road accident deaths, Pakistani people, Military people
Juyin Sarauta	2017 movies, Nigeria
Yacht charter	Water transport
George Walker (composer)	Pulitzer Prize winners, 1922 births, 2018 deaths, Accidental deaths from falls in the United States, American autobiographers, American composers, American educators, Writers from Washington, D.C.
Fire sprinkler	Fire
Kennington tube station	Northern Line stations, Transport in Lambeth, London Travelcard zone 2
Christine King Farris	1927 births, Living people, American educators, American civil rights activists, Martin Luther King Jr., Writers from Atlanta, Georgia
J. Joseph Curran Jr.	1931 births, Living people, American lawyers, Politicians from Florida, Lieutenant Governors of Maryland, US Democratic Party politicians
María Vicuña	1978 births, Living people, Vice Presidents of Ecuador, People from Guayaquil
Hans Frauenfelder	1922 births, Living people, Naturalized citizens of the United States, American physicists, American biologists, Swiss scientists, Schaffhausen
Alain Touraine	1925 births, Living people, French sociologists
Robert Mundell	1932 births, 2021 deaths, Deaths from cholangiocarcinoma, Canadian economists, Writers from Ontario, University of Waterloo, Canadian Nobel Prize winners, Columbia University faculty
Adrienne	Given names
Adrienne Shelly	People murdered in North America, Murdered entertainers, Actors from New York City, 1966 births, 2006 deaths
MusicBrainz	Music media, Entertainment websites
Dhaka International Film Festival	Movie festivals, Bangladesh, 1992 establishments in Asia
Christine Lakin	American movie actors, American television actors, American voice actors, 1979 births, Living people
The Centaurus	Buildings and structures in Islamabad
Johnson County War	19th century in Wyoming, Benjamin Harrison
Payerne	Municipalities of Vaud, Cities in Switzerland
Pignia	Former municipalities of Graubünden
Rongellen	Municipalities of Graubünden
Gerd Cintl	1938 births, 2017 deaths, Sportspeople from North Rhine-Westphalia, German people, Rowers
Didier Burkhalter	1960 births, Living people, Presidents of the Swiss Confederation
Osenbach	Communes in Haut-Rhin
Ostheim, Haut-Rhin	Communes in Haut-Rhin
Coalisland	Towns in Northern Ireland
Arson in royal dockyards	Acts of the Parliament of the United Kingdom, 1772, 1770s in the Kingdom of Great Britain
Prince François, Count of Clermont	1961 births, 2017 deaths, French royalty, Princes and princesses
Henri, Count of Paris (1933–2019)	1933 births, 2019 deaths, French royalty, French painters, French military people, French writers
Cheryll Sotheran	1945 births, 2017 deaths, Deaths from stroke, New Zealand people, Civil servants, Philanthropists
Flag of Egypt	National flags, Egypt
John Clarke (satirist)	1948 births, 2017 deaths, Deaths from myocardial infarction, Cardiovascular disease deaths in Australia, New Zealand movie actors, New Zealand television actors, New Zealand voice actors, New Zealand comedians, New Zealand writers, Australian movie actors, Australian television actors, Australian voice actors, Australian novelists, Australian screenwriters, Australian comedians
J. Richard Clarke	1927 births, Living people, People from Idaho
John Clarke (actor)	1932 births, 2019 deaths, Deaths from pneumonia, Disease-related deaths in California, American television actors, American movie actors, Actors from Indiana
Zimmersheim	Communes in Haut-Rhin
Tessa Jowell	1947 births, 2018 deaths, Deaths from brain cancer, Deaths from cerebral hemorrhage, Former Labour MPs (UK), Politicians from London
June Brown	1927 births, Living people, English television actors, English stage actors, English movie actors, Actors from Suffolk
Mark E. Smith	1957 births, 2018 deaths, Deaths from lung cancer, Deaths from kidney cancer, Cancer deaths in England, English guitarists, English pianists, English singer-songwriters, Musicians from Lancashire, Singers from Lancashire, Writers from Lancashire
Makoto Shinkai	Living people, 1973 births, Japanese animators, Japanese movie producers, Japanese screenwriters, Japanese movie directors, Anime directors
PM md. 63	Assault rifles
Beautiful Inside	Louise songs, 2000 songs, Hip hop soul songs, Blue-eyed soul songs, R&B songs
Light of My Life	1995 songs, Debut singles, Louise songs, Pop songs, Blue-eyed soul songs, R&B songs
Atalanta	People in Greek mythology
Disco (Grace Jones album)	1977 albums, 1978 albums, 1979 albums, 2015 albums, Grace Jones albums, Compilation albums, Disco albums, R&B albums
National League Division Series	Major League Baseball
Ebrahim Nafae	1934 births, 2018 deaths, Deaths from lung cancer, Deaths from surgical complications, Egyptian writers, Egyptian journalists
Manuel Olivencia	1929 births, 2018 deaths, Deaths from respiratory failure, Accidental deaths from falls, Spanish writers, Spanish politicians, Spanish diplomats, Spanish educators, Spanish economists
Lalo Schifrin	1932 births, Living people, Argentine pianists, Jazz musicians, Composers, Conductors, People from Buenos Aires
Präz	Former municipalities of Graubünden
Ottmarsheim	Communes in Haut-Rhin
Kundali Bhagya	2010s television series, Drama television series, 2017 Indian television series debuts
Saoirse Ronan	1994 births, Living people, Irish actors
Annette Crosbie	BAFTA Award winning actors, 1934 births, Living people, Scottish movie actors, Scottish television actors, Scottish voice actors, Scottish stage actors
The Founder	2010s biographical movies, 2016 drama movies, American biographical movies, American drama movies, Movies set in the 1950s, Movies set in Illinois, Movies set in California, McDonald's
John Carroll Lynch	1963 births, Living people, American movie actors, American television actors, American voice actors, American movie directors, Actors from Denver, Colorado, People from Boulder, Colorado
Richard and Maurice McDonald	1909 births, 1902 births, 1998 deaths, 1971 deaths, Deaths from myocardial infarction, Deaths from heart failure, Businesspeople from California, Sibling duos, McDonald's, People from Manchester, New Hampshire, People from San Bernardino, California
Mauro Staccioli	1937 births, 2018 deaths, Deaths from pneumonia, Disease-related deaths in Italy, Italian educators, Italian sculptors, People from Milan
Inverse element	Algebra
Zumbastico Fantástico	Cartoon Network, Cartoon Network series, 2011 television series debuts, 2012 television series endings
Khoisan	South African people
Steatopygia	Anthropology, Human sexuality, Human body features, Physical anthropology
Luo	Ethnic groups in Africa
Ferdinando Imposimato	1936 births, 2018 deaths, Italian human rights activists, Italian politicians, Italian judges, Italian lawyers, People from Campania
Tim Sweeney	1929 births, 2018 deaths, Irish sportspeople
Persistence hunting	Hunting
DStv	Television, Africa, 1991
Bâgé-Dommartin	2018 establishments in France, Communes in Ain
Subaru Ascent	Sport utility vehicles, 2010s automobiles, 2020s automobiles
Lil Pump	2000 births, Living people, Warner Bros. Records artists
Petit-Landau	Communes in Haut-Rhin
Jahn Otto Johansen	1934 births, 2018 deaths, Norwegian writers, Norwegian journalists, Novelists
Ali Akbar Moinfar	1928 births, 2018 deaths, Deaths from renal failure, Iranian politicians
Rick Hall	1932 births, 2017 deaths, Deaths from prostate cancer, Cancer deaths in the United States, American songwriters, American record producers, American country musicians, American soul musicians, American funk musicians, Musicians from Mississippi, Musicians from Alabama, Musicians from Illinois, Writers from Mississippi, Writers from Alabama, Writers from Illinois, People from Rockford, Illinois
George Clements	1932 births, 2019 deaths, Deaths from stroke, Deaths from myocardial infarction, American Roman Catholics, Roman Catholic priests, American civil rights activists, People from Chicago
Jack F. Matlock Jr.	1929 births, Living people, American educators, American historians, Ambassadors of the United States, Politicians from North Carolina, People from Greensboro, North Carolina
Rebecca Matlock	1928 births, Living people, American photographers, Writers from Tennessee
Naina Yeltsina	1932 births, Living people, First Ladies, People from Moscow
Joseph Rose	Canadian singer-songwriters, Living people, Musicians from Vancouver
Robert Mann	1920 births, 2018 deaths, American composers, American conductors, American violinists, American educators, Musicians from New York City, Musicians from Portland, Oregon
The Conjuring 2	2016 horror movies, American horror movies, American ghost movies, Movies set in the 1970s, Movies set in London, Warner Bros. movies
Hurricane Julia (2010)	Category 4 Atlantic hurricanes
American League Division Series	American League, Baseball, Major League Baseball
Wolf Point East Tower	Proposed skyscrapers in the United States
Rock N Roll McDonald's	Buildings and structures in Chicago, Illinois, McDonald's, 1983 establishments in the United States, 1980s establishments in Illinois
1000M	Proposed skyscrapers in the United States
Helmut Jahn	1940 births, 2021 deaths, German architects, Naturalized citizens of the United States, Architects from Chicago, Road accident deaths in the United States
Gateway Tower (Chicago)	Proposed skyscrapers in the United States
Streeterville	Neighborhoods in Chicago
Humboldt Park, Chicago	Community areas of Chicago
Kappalottiya Tamizhan	Tamil-language movies
West Side, Chicago	Neighborhoods in Chicago
North Side, Chicago	Neighborhoods in Chicago
East Side, Chicago	Community areas of Chicago
Oak Street Beach	Landmarks in Chicago, Beaches of the United States
Chicago Park District	Parks in Chicago
Time-Life Building (Chicago)	1969 establishments in Illinois
Cloud Gate	Buildings and structures in Chicago, Illinois
Harold Washington Library	Buildings and structures in Chicago, Illinois
The Loop (CTA)	Transport in Chicago, 1890s establishments in Illinois
Jefferson Park, Chicago	Community areas of Chicago
Happy Birthday to You	Songs
Norwood Park, Chicago	Community areas of Chicago
Mahé, India	Towns in India, Settlements in Puducherry
Coonoor	Nilgiris district
Zillis-Reischen	Municipalities of Graubünden
Pfaffenheim	Communes in Haut-Rhin
Pfastatt	Communes in Haut-Rhin
NGC 6025	Open star clusters
Taye Taiwo	1985 births, Nigerian footballers, People from Lagos, Living people
Pulversheim	Communes in Haut-Rhin
Ton Fan Group	Art movements, Taiwan
Fred Bass	1928 births, 2018 deaths, Deaths from congestive heart failure, Cardiovascular disease deaths in New York City, Businesspeople from New York City
Lawal Kaita	1932 births, 2018 deaths, Deaths from liver failure, Nigerian politicians
Conan the Indomitable	1989 books, American novels, Fantasy books
Yadgir district	Districts of Karnataka
John Skehel	1941 births, Living people, British biologists, Virologists, Knights Bachelor, Fellows of the Royal Society
Francis Crick Institute	Research organizations in the United Kingdom, London Borough of Camden
Nine-dart finish	Darts
Waadhoeke	Waadhoeke, 2018 establishments in the Netherlands
WWE Roadblock	World Wrestling Entertainment pay-per-view events
Bühler	Municipalities of Appenzell Ausserrhoden
Sarn, Switzerland	Former municipalities of Graubünden
Pfetterhouse	Communes in Haut-Rhin
Raedersdorf	Communes in Haut-Rhin
Aharon Appelfeld	1932 births, 2018 deaths, Hebrew University of Jerusalem alumni, Holocaust survivors, Israeli academics, Jewish academics, Jewish Israeli writers, Naturalized citizens of Israel, Novelists, Romanian Jews
Bruce Halle	1930 births, 2018 deaths, American philanthropists, Businesspeople from Massachusetts, American conservatives, Republicans (United States), People from Springfield, Massachusetts, Businesspeople from Phoenix, Arizona
Frank Buxton	1930 births, 2018 deaths, Cardiovascular disease deaths in Washington (state), American movie actors, American television actors, American voice actors, American stage actors, American television directors, American television writers, American screenwriters, Actors from Massachusetts, Writers from Massachusetts, Actors from Washington, Writers from Washington
Trust (U.S. TV series)	American crime television series, Fox television series, J. Paul Getty, English-language television programs
West Orange, New Jersey	Townships in New Jersey
Livingston, New Jersey	Townships in New Jersey
Guida Maria	1950 births, 2018 deaths, Deaths from pancreatic cancer, Portuguese movie actors, Portuguese television actors, Portuguese voice actors, Portuguese stage actors, People from Lisbon
New Glasgow, Nova Scotia	Towns in Nova Scotia
Vladimir Yankilevsky	1938 births, 2018 deaths, Deaths from leukemia, Cancer deaths in France, Russian artists, Painters, Sculptors, People from Moscow
Mary Anne Krupsak	1932 births, Living people, American lawyers, Lieutenant Governors of New York (state), Businesspeople from Buffalo, New York, Politicians from Buffalo, New York, US Democratic Party politicians, People from Schenectady, New York
Ryakuji	Japanese language, Writing systems
Amanda Cottreau	Canadian songwriters, Musicians from Ontario
Grauman's Chinese Theatre	1920s establishments in California, 1927 establishments in the United States
Ravenswood, Chicago	Neighborhoods in Chicago
Lincoln Square, Chicago	Community areas of Chicago
Logan Square, Chicago	Community areas of Chicago
Wicker Park, Chicago	Neighborhoods in Chicago
West Town, Chicago	Community areas of Chicago
Chicago Tonight	1984 American television series debuts, Television series set in Chicago, Illinois, American television news programs, 1980s establishments in Illinois
Asghar Khan	1921 births, 2018 deaths, Deaths from Parkinson's disease, Pakistani politicians, Historians, Military people, Activists
Respiratory tract infection	Infectious diseases
North Center, Chicago	Community areas of Chicago
2003 Chicago balcony collapse	2003 in the United States, 2000s in Chicago
Rogers Park, Chicago	Community areas of Chicago
West Ridge, Chicago	Community areas of Chicago
Uptown, Chicago	Community areas of Chicago
Edison Park, Chicago	Community areas of Chicago
North Park, Chicago	Community areas of Chicago
Albany Park, Chicago	Community areas of Chicago
Hermosa, Chicago	Community areas of Chicago
Belmont Cragin, Chicago	Community areas of Chicago
Montclare, Chicago	Community areas of Chicago
Dunning, Chicago	Community areas of Chicago
River Grove, Illinois	Villages in Illinois, Suburbs of Chicago, Illinois, Settlements in Cook County, Illinois
Avondale, Chicago	Community areas of Chicago
Austin, Chicago	Community areas of Chicago
Johannes Brost	1946 births, 2018 deaths, Deaths from pancreatic cancer, Cancer deaths in Sweden, Swedish movie actors, Swedish television actors, Swedish voice actors, Swedish comedians, Actors from Stockholm
West Garfield Park, Chicago	Community areas of Chicago
East Garfield Park, Chicago	Community areas of Chicago
North Lawndale, Chicago	Community areas of Chicago
South Lawndale, Chicago	Community areas of Chicago
Lower West Side, Chicago	Community areas of Chicago
Englewood, Chicago	Community areas of Chicago
Mia Love	1975 births, Living people, United States representatives from Utah, American activists, American mayors, Politicians from Brooklyn, US Republican Party politicians
Range Rover	Rover automobiles
Annapolis Royal	Towns in Nova Scotia
Bombycidae	Moths
Stewiacke	Towns in Nova Scotia, 1906 establishments in North America, 1900s establishments in Canada
Demographics of Nova Scotia	Nova Scotia
List of population centres in Nova Scotia	Settlements in Nova Scotia
List of Nanalan' episodes	American animated television series, Lists of animated television series episodes
Ni Hao, Kai-Lan	2008 American television series debuts, 2011 television series endings, Animated television series, Television series by Cookie Jar Entertainment, Nickelodeon television series, 2008 Canadian television series debuts, 2011 disestablishments in the United States, 2010s disestablishments in Canada, English-language television programs
Midden-Groningen	Midden-Groningen, 2018 establishments in the Netherlands
Westerwolde	Westerwolde, 2018 establishments in the Netherlands
John Byron (British Army officer)	1756 births, 1791 deaths, British Army officers
Marián Labuda	1944 births, 2018 deaths, Slovakian actors, Movie actors, Stage actors, Television actors
John Byron (Royal Navy officer)	1723 births, 1786 deaths, Royal Navy officers
Urmein	Municipalities of Graubünden
Man of the Woods	Justin Timberlake albums, 2018 albums
Filthy (song)	Justin Timberlake, 2018 songs
Senichi Hoshino	1947 births, 2018 deaths, Deaths from pancreatic cancer, Japanese baseball players, People from Okayama Prefecture
Philipp Jenninger	1932 births, 2018 deaths, Former members of the German Bundestag, Ambassadors of Germany, Government ministers of Germany, Politicians from Baden-Württemberg, Politicians of the Christian Democratic Union of Germany
Wolfgang Schäuble	1942 births, Living people, Presidents of the German Bundestag
Aydın Boysan	1921 births, 2018 deaths, Deaths from multiple organ failure, Disease-related deaths in Turkey, Turkish writers, Architects, Essayists, Turkish educators, Columnists, People from Istanbul
Marina Ripa Di Meana	1941 births, 2018 deaths, Deaths by euthanasia, Drug-related suicides, People with cancer, Italian movie actors, Italian television actors, Italian movie directors, Italian writers, Italian television personalities, Italian models, Autobiographers, Italian human rights activists, Animal rights activists, Environmentalists
Carlo Ripa di Meana	1929 births, 2018 deaths, Deaths from skin cancer, Italian politicians, Environmentalists
Armour Square, Chicago	Community areas of Chicago
Douglas, Chicago	Community areas of Chicago
Oakland, Chicago	Community areas of Chicago
Fuller Park, Chicago	Community areas of Chicago
Grand Boulevard, Chicago	Community areas of Chicago
Kenwood, Chicago	Community areas of Chicago
Washington Park, Chicago	Community areas of Chicago
Hyde Park, Chicago	Community areas of Chicago
Jackson Park (Chicago)	Parks in Chicago
Woodlawn, Chicago	Community areas of Chicago
South Shore, Chicago	Community areas of Chicago
Greater Grand Crossing, Chicago	Community areas of Chicago
Emily Dole	1957 births, 2018 deaths, Disease-related deaths in California, American professional wrestlers, American track and field athletes, American movie actors, American television actors, Samoan people, Actors from Orange County, California, Sportspeople from California
Ashburn, Chicago	Community areas of Chicago
Fourier inversion theorem	Mathematics
Ellicott's Mills Historic District	Historic districts in the United States, National Register of Historic Places, 1775 establishments in the Thirteen Colonies, 18th-century establishments in Maryland
Michael Pfeiffer	1925 births, 2018 deaths, German football managers, German footballers, People from Eschweiler, Sportspeople from North Rhine-Westphalia
Flag of Chad	National flags, Chad
Flag of Cameroon	National flags, Cameroon
Tartar, Switzerland	Former municipalities of Graubünden
Tschappina	Municipalities of Graubünden
Raedersheim	Communes in Haut-Rhin
Flag of Nigeria	National flags, Nigeria
Flag of Ghana	National flags, Ghana
Crêpe paper	Paper
Rammersmatt	Communes in Haut-Rhin
Chatham, Chicago	Community areas of Chicago
Carlos Heitor Cony	1926 births, 2018 deaths, Deaths from multiple organ failure, Brazilian writers, Brazilian journalists, People from Rio de Janeiro
Gruyère cheese	Swiss cheeses
David Bennent	1966 births, Swiss movie actors, Swiss television actors, Swiss stage actors, Living people, People from Lausanne
Jim Anderton	1938 births, 2018 deaths, Deputy Prime Ministers of New Zealand
Gossau, St. Gallen	Municipalities of St. Gallen, Cities in Switzerland
New City, Chicago	Community areas of Chicago
Ranspach	Communes in Haut-Rhin
Volzhsky	Cities in Russia
Finesse (song)	R&B songs, 2018 songs
Rumersheim-le-Haut	Communes in Haut-Rhin
Rita Crocker Clements	1931 births, 2018 deaths, Deaths from Alzheimer's disease, Disease-related deaths in Texas, Republicans (United States), People from Texas, People from Kansas
Garfield Ridge, Chicago	Community areas of Chicago
Archer Heights, Chicago	Community areas of Chicago
Brighton Park, Chicago	Community areas of Chicago
McKinley Park, Chicago	Community areas of Chicago
West Elsdon, Chicago	Community areas of Chicago
Gage Park, Chicago	Community areas of Chicago
Gage Park murders	Murders by blade weapons, Murders by firearm in the United States, 2016 in Chicago
Clearing, Chicago	Community areas of Chicago
West Lawn, Chicago	Community areas of Chicago
Chicago Lawn, Chicago	Community areas of Chicago
West Englewood, Chicago	Community areas of Chicago
Antonio Valentín Angelillo	1937 births, 2018 deaths, Deaths from lung cancer, Cancer deaths in Italy, Italian footballers, Argentine footballers, Sportspeople from Buenos Aires
Auburn Gresham, Chicago	Community areas of Chicago
Reino Ragnar Lehto	1898 births, 1966 deaths, Prime Ministers of Finland
Dan Ryan Expressway	Transport in Chicago
Kennedy Expressway	Transport in Chicago, John F. Kennedy
Interstate 290 (Illinois)	Transport in Chicago
Elk Grove Village, Illinois	Villages in Illinois, Suburbs of Chicago, Illinois, Settlements in Cook County, Illinois, Settlements in DuPage County, Illinois
Beverly, Chicago	Community areas of Chicago
Washington Heights, Chicago	Community areas of Chicago
Mount Greenwood, Chicago	Community areas of Chicago
Merrionette Park, Illinois	Villages in Illinois, Suburbs of Chicago, Illinois, Settlements in Cook County, Illinois
Chicago Fire Department	Chicago, Illinois
Bungalow	Houses
Morgan Park, Chicago	Community areas of Chicago
Avalon Park, Chicago	Community areas of Chicago
2018 Northern Cyprus parliamentary election	2018 in Asia, 2018 elections, January 2018 events, Northern Cyprus
Dina Titus	Politicians from Georgia (U.S. state), 1950 births, Living people, US Democratic Party politicians
Planned Parenthood	Non-profit organizations of the United States, 1916 establishments in the United States
Małgorzata Bocheńska	1949 births, 2018 deaths, Polish journalists, Writers from Warsaw
South Chicago, Chicago	Community areas of Chicago
Burnside, Chicago	Community areas of Chicago
Calumet Heights, Chicago	Community areas of Chicago
Liza Egbogah	Living people, Year of birth missing (living people), People from Toronto
Pill Hill, Chicago	Neighborhoods in Chicago
Roseland, Chicago	Community areas of Chicago
Pullman, Chicago	Community areas of Chicago
South Deering, Chicago	Community areas of Chicago
West Pullman, Chicago	Community areas of Chicago
Riverdale, Chicago	Community areas of Chicago
Hegewisch, Chicago	Community areas of Chicago
Chicago Tylenol murders	1982 in the United States, 1980s in Chicago, 1980s murders in the United States, Mass murder in the 1980s, Mass murder in the United States, Unsolved murders in the United States
Horace Ashenfelter	1923 births, 2018 deaths, American Olympic gold medalists, American track and field athletes, American military personnel of World War II, Sportspeople from New Jersey, Sportspeople from Pennsylvania
Shoichiro Toyoda	1925 births, Living people, Japanese businesspeople, Toyota
France Gall	1947 births, 2018 deaths, Deaths from cancer of unknown primary origin, Cancer deaths in France, Eurovision Song Contest winners, French pop singers, Infectious disease deaths in France, Musicians from Paris
Gerhard Weinberg	Pritzker Prize winners, 1928 births, Living people, Naturalized citizens of the United States, German historians, American historians, American educators, People from Hanover
Tony Britton	1924 births, 2019 deaths, English movie actors, English television actors, English stage actors, Actors from Birmingham
Anatoly Filipchenko	1928 births, Living people, Cosmonauts, Soviet people
Daniel Ellsberg	1931 births, Living people, American activists, American economists, American political writers, Writers from Chicago
Peter Sutherland	1946 births, 2018 deaths, Irish politicians, Lawyers, Irish businesspeople, World Trade Organization Directors-General
Florissant, Missouri	Cities in Missouri
Ray Thomas	1941 births, 2018 deaths, Deaths from prostate cancer, English singer-songwriters, English rock musicians, English rock singers, Keyboardists, Musicians from Worcestershire
Jai Shri Krishna	Indian television series, 2008 television series debuts, 2008 establishments in India, 2009 television series endings, Disestablishments in India
Flag of Serbia	National flags, Serbia, 2010 establishments in Europe, Establishments in Serbia
Flag of Moldova	National flags, Moldova
Craig Shoemaker	1958 births, Living people, American game show hosts, American comedians, American movie actors, American television actors, American voice actors, Actors from Philadelphia, Pennsylvania
Ranspach-le-Bas	Communes in Haut-Rhin
Mohammad Manzarpour	1972 births, Living people, People from Tehran, Iranian writers, Iranian journalists, BBC television presenters, BBC newsreaders and journalists
Woodlands MRT station	Mass Rapid Transit (Singapore) stations, Establishments in Singapore
Bicycle path	Cycling
Utility cycling	Cycling
Zevenaar	Cities in the Netherlands, Municipalities of Gelderland, Settlements in Gelderland
Turkmen people	Turkic peoples
Pamiri people	Ethnic groups in Asia
Badakhshan	Tajikistan, Geography of Afghanistan
Bugatti Type 35	Sports cars
Nuristani people	Ethnic groups in Afghanistan
Greg Herman	American filmmakers, American editors, Movie directors from Indiana, 1977 births, People from Bloomington, Indiana, Living people
Kyrgyz people	Ethnic groups in Asia
Kyrgyz language	Turkic languages
Barnstable County, Massachusetts	1680s establishments in Massachusetts, 1685 establishments, Massachusetts counties
Thomas Bopp	1949 births, 2018 deaths, American astronomers, People from Youngstown, Ohio, People from Denver, Colorado
Chris Tsangarides	1956 births, 2018 deaths, Deaths from heart failure, Deaths from pneumonia, British record producers
Anna Mae Hays	1920 births, 2018 deaths, Deaths from myocardial infarction, Cardiovascular disease deaths in Washington, D.C., American military personnel of World War II, American military personnel of the Korean War, People from Buffalo, New York
Peter Preston	1938 births, 2018 deaths, Deaths from melanoma, British journalists, British columnists, Writers from Leicestershire
Marjorie Holt	1920 births, 2018 deaths, American lawyers, United States representatives from Maryland, Politicians from Birmingham, Alabama, US Republican Party politicians
Markku Into	1945 births, 2018 deaths, Finnish poets
Kato Ottio	1994 births, 2018 deaths, Deaths from cardiac arrest, Rugby league players
Donnelly Rhodes	1937 births, 2018 deaths, Deaths from liver cancer, Cancer deaths in Canada, Canadian movie actors, Canadian television actors, Canadian stage actors, Canadian voice actors, Canadian radio actors, Actors from Manitoba
Castle Rock Entertainment	Movie studios, American entertainment companies, 1987 establishments in the United States
Uilleann pipes	Musical instruments
Stark's Park	Football stadiums in Scotland, Fife, 1891 establishments, 1890s establishments in Scotland
Edge effect	Electricity
Juan Carlos García	1988 births, 2018 deaths, Honduran footballers, Deaths from leukemia
Vojtěch Lindaur	1957 births, 2018 deaths, Czech journalists, Record producers
Parpan	Former municipalities of Graubünden
Ranspach-le-Haut	Communes in Haut-Rhin
2054	2054, Years in the future
Rantzwiller	Communes in Haut-Rhin
List of Latin phrases (V)	Latin phrases
Denise LaSalle	1939 births, 2018 deaths, Cardiovascular disease deaths in the United States, Accidental deaths from falls in the United States, American singer-songwriters, American record producers, American blues musicians, American soul musicians, American R&B singers, Singers from Mississippi, Musicians from Mississippi, Writers from Mississippi
Britain First	2011 establishments in the United Kingdom, Political parties in the United Kingdom, Nationalist organisations in the United Kingdom, Islamophobia
Havana (song)	2017 songs, Latin music, Cuban music
Greta Thyssen	1927 births, 2018 deaths, Deaths from pneumonia, Disease-related deaths in New York City, Naturalized citizens of the United States, Danish movie actors, Danish television actors, American movie actors, American television actors, American models, People from Copenhagen, Actors from New York City
Paul Hester	1959 births, 2005 deaths, Australian drummers, Australian rock musicians, Australian television presenters, Musicians from Melbourne, Musicians who committed suicide, Rock drummers, Suicides in Australia
Civic Platform	Political parties in Europe, Conservative parties, 2001 establishments in Europe, Establishments in Poland
Intrinsic factor	Proteins, Digestive system, Vitamins
Tommy Lawrence	1940 births, 2018 deaths, British association football goalkeepers, Liverpool F.C. players, Scottish footballers
Praden	Villages in Graubünden, Former municipalities of Graubünden
Réguisheim	Communes in Haut-Rhin
Khitan people	Asian people
Wagyu beef	Beef
Khitan language	Languages
Hazaristan	Geography of Afghanistan
Abe Tsimiklis	Mixed martial artists, Taekwondo practitioners, 1996 births, Living people, Australian sportspeople
Jim Renacci	1958 births, Living people, Businesspeople from Ohio, American mayors, United States representatives from Ohio, US Republican Party politicians, American Roman Catholics
Ramsar, Mazandaran	Cities in Iran, Mazandaran Province
Hamadan	Round cities, Cities in Iran
Rose black spot	Fungal diseases
Richard Henry Lee	1732 births, 1794 deaths, British politicians, United States senators from Virginia, Founding Fathers of the United States, American judges, Presidents pro tempore of the United States Senate, Signers of the U.S. Declaration of Independence
Karni Mata Temple	Hindu temples
Karni Mata	Hindu gods and goddesses
Reiningue	Communes in Haut-Rhin
Retzwiller	Communes in Haut-Rhin
Misandry	Discrimination, Hatred
Gender differences in crime	Crime
Bank robbery	Crime, Banks
Peoria Heights, Illinois	Villages in Illinois
Carpentersville, Illinois	Villages in Illinois, Suburbs of Chicago, Illinois
Work Bitch	Britney Spears songs, 2013 songs, Electronic dance music, House songs
The Nore	River Thames
Carrauntoohil	County Kerry
Gothic rock	Rock music, 1980s in music, 1990s in music
Martha McSally	1966 births, Living people, United States senators from Arizona, Politicians from Rhode Island, People from Warwick, Rhode Island, American aviators, United States representatives from Arizona, US Republican Party politicians
Zee Bangla	Kolkata, Television channels, 1999 establishments in Asia, 1990s establishments in India
Vanumotir Khel	2018 Indian television series debuts
Bokul Kotha	2017 Indian television series debuts
Canvey Island	Essex boroughs, Islands of England
ViVA Trio	Canadian musical groups
Zenzenzense	2016 songs, Japanese music
Anpan	Japanese food, Sweet breads
Stree	Indian television series, 2016 Indian television series debuts, 2018 television series endings, 2018 disestablishments in India
Peter Wells (athlete)	1929 births, 2018 deaths, British athletes, New Zealand people, British Olympians, Sportspeople from London
Dave Toschi	1931 births, 2018 deaths, Deaths from Alzheimer's disease, Disease-related deaths in San Francisco, American police officers, People from San Francisco
Bob Bailey	1942 births, 2018 deaths, Pittsburgh Pirates players, Los Angeles Dodgers players, Montreal Expos players, Cincinnati Reds players, Boston Red Sox players, Sportspeople from California
Robert Minlos	1931 births, 2018 deaths, Russian mathematicians, People from Moscow
Milton J. Rosenberg	1925 births, 2018 deaths, Deaths from pneumonia, Disease-related deaths in Chicago, Illinois, American psychologists, American educators, American radio personalities, Scientists from New York City, Writers from New York City, Scientists from Chicago, Writers from Chicago
Eddie Clarke	1950 births, 2018 deaths, Deaths from pneumonia, Disease-related deaths in London, Heavy metal guitarists, English rock guitarists, Musicians from London
Mikhail Derzhavin	1936 births, 2018 deaths, Russian movie actors, Russian stage actors, Actors from Moscow
Doug Barnard, Jr.	1922 births, 2018 deaths, Deaths from pneumonia, Disease-related deaths in Georgia (U.S. state), United States representatives from Georgia, People from Augusta, Georgia, US Democratic Party politicians
Edgar Ray Killen	1925 births, 2018 deaths, American murderers, People convicted of manslaughter, People from Mississippi
Takis Loukanidis	1937 births, 2018 deaths, Deaths from myocardial infarction, Greek footballers
John V. Tunney	1934 births, 2018 deaths, Deaths from prostate cancer, Cancer deaths in California, United States senators from California, United States representatives from California, Politicians from New York City, US Democratic Party politicians
Keith Jackson	1928 births, 2018 deaths, American radio personalities, American television personalities, Sportspeople from Georgia (U.S. state)
Tzimis Panousis	1954 births, 2018 deaths, Deaths from myocardial infarction, Comedians, Rock musicians, People from Athens
Eliyahu Winograd	1926 births, 2018 deaths, Deaths from respiratory failure, Hebrew University of Jerusalem alumni, Israeli Jews, Israeli judges, Jewish judges, People from Tel Aviv
Robert Marchand	1911 births, 2021 deaths, French cyclists, French centenarians
Fauja Singh	1911 births, Living people, British sportspeople, British centenarians, Indian sportspeople
Stanisław Kowalski	Living people, 1910 births, Centenarians, Polish sportspeople
Raage Anuraage	Soap operas, 2013 television series debuts, 2015 television series endings, Indian television series
Hidekichi Miyazaki	1910 births, 2019 deaths, Deaths from cerebral hemorrhage, Japanese sportspeople, Japanese centenarians
Madonna Buder	1930 births, Living people, American Olympians, American Roman Catholics, Sportspeople from Missouri, People from St. Louis, Missouri
Star Jalsha	Indian television, Television channels
Belfast International Airport	Airports in the United Kingdom, Buildings and structures in Northern Ireland, Transport in Northern Ireland
Jessica Falkholt	1988 births, 2018 deaths, Road accident deaths, Australian movie actors, Australian television actors, Australian stage actors, Actors from Sydney
Flag of Morocco	National flags, Morocco, 1915 establishments, 1910s establishments in Africa, 20th-century establishments in Morocco
Flag of Ivory Coast	National flags, Ivory Coast
Flag of Burkina Faso	National flags, Burkina Faso, 1984 establishments, 1980s establishments in Africa
Flag of Togo	National flags, Togo
Richwiller	Communes in Haut-Rhin
Oriental Pearl Tower	Buildings and structures in Shanghai, Towers in Asia, 1994 establishments in Asia, 1990s establishments in China, Buildings and structures completed in the 20th century
Bodhu Kon Alo Laaglo Chokhe	Soap operas, Indian television series, 2012 television series debuts, 2012 establishments in India, 2014 Indian television series endings
Miguel Díaz-Canel	1960 births, Living people, Presidents of Cuba, Current national leaders, Vice presidents
Anerood Jugnauth	1930 births, 2021 deaths, Presidents of Mauritius, Prime Ministers of Mauritius
Fletcher Thompson	1925 births, Living people, American lawyers, United States representatives from Georgia, Politicians from Atlanta, Georgia, US Republican Party politicians
Benjamin B. Blackburn	1927 births, Living people, United States representatives from Georgia, Politicians from Atlanta, Georgia, US Republican Party politicians
Jack Thomas Brinkley	1930 births, 2019 deaths, Deaths from myocardial infarction, United States representatives from Georgia, American conservatives, US Democratic Party politicians
Elliott H. Levitas	1930 births, Living people, United States representatives from Georgia, Politicians from Atlanta, Georgia, US Democratic Party politicians
J. Roy Rowland	Living people, 1926 births, United States representatives from Georgia, American physicians, US Democratic Party politicians
Cato Street conspiracy	1820, Punishments, Politics of the United Kingdom, 1820s in the United Kingdom
Flag of Senegal	National flags, Senegal
Flag of Niger	National flags, Niger
Flag of Norway	National flags, Norway
Flag of Iceland	National flags, Iceland
Riedisheim	Communes in Haut-Rhin
Tschiertschen-Praden	2009 establishments in Switzerland, Municipalities of Graubünden
Flag of Somalia	National flags, Somalia
Hashem Asad Allah	1985 births, Living people
Kache Aye Shoi	Indian television series, 2013 television series debuts, 2013 establishments in India, 2014 Indian television series endings
Tumi Robe Nirobe	2014 Indian television series debuts, 2016 television series endings, Indian television series, 2010s disestablishments in India
Rannaghor	Indian television series
2018 Hawaii false missile alert	February 2018 events, 2018 in Hawaii
Doodhnath Singh	1936 births, 2018 deaths, Deaths from prostate cancer, Cancer deaths in India, Indian academics, Indian playwrights, Indian poets, Indian novelists, Indian critics, People from Uttar Pradesh
Yılmaz Onay	1937 births, 2018 deaths, Deaths from stomach cancer, Turkish writers, Novelists, Playwrights, Critics, Artists
Stephane Gauger	1969 births, 2018 deaths, Deaths from stroke, Cardiovascular disease deaths in Los Angeles, Vietnamese people, Naturalized citizens of the United States, American cinematographers, Movie directors from California, Screenwriters from California
Claude Lelouch	Academy Award winning writers, 1937 births, Living people, French movie actors, French screenwriters, Cinematographers, Movie directors from Paris, Writers from Paris
Tschiertschen	Villages in Graubünden, Former municipalities of Graubünden
Flag of Gabon	National flags, Gabon
Flag of Eswatini	National flags, Eswatini
Spanky Manikan	1942 births, 2018 deaths, Deaths from lung cancer, Filipino actors, Filipino movie actors, Stage actors, Filipino television actors, People from Manila
Flag of Namibia	National flags, Namibia
Mohammed Hazzaz	1945 births, 2018 deaths, Moroccan footballers
Flag of Rwanda	National flags, Rwanda
Jeraldine Saunders	1923 births, 2019 deaths, Deaths from surgical complications, Deaths from kidney disease, American television writers, American columnists, American educators, Models from Los Angeles, California, Writers from Los Angeles, California
Albert Dekker	1905 births, 1968 deaths, Accidental deaths from erotic asphyxiation, Accidental deaths in the United States, American movie actors, American stage actors, American radio actors, Politicians from New York City, Politicians from California, Actors from New York City, Actors from California, US Democratic Party politicians, State legislators of the United States
Stephen Milligan	1948 births, 1994 deaths, Accidental deaths from erotic asphyxiation, Accidental deaths in the United Kingdom, British journalists, Writers from Surrey
William Howard Taft High School (Chicago)	Schools in Illinois, William Howard Taft
Lane Technical College Prep High School	Schools in Illinois
Mark Herring	1961 births, Living people, American lawyers, Politicians from Virginia, Politicians from Tennessee, US Democratic Party politicians
Victoria, Grenada	Towns in North America, Grenada
Steve Smith (cricketer)	Australian cricketers, Living people, 1989 births
Doug Harvey (umpire)	1930 births, 2018 deaths, Deaths from esophageal cancer, Cancer deaths in California, Sportspeople from San Diego, California
Jean Porter	1922 births, 2018 deaths, Deaths from natural causes, Disease-related deaths in California, American movie actors, American child actors, American television actors, Actors from Texas, Actors from California
Engels, Saratov Oblast	Cities in Russia
Saratov Oblast	Oblasts of Russia, Politics, Federal subjects of Russia
Nina Turner	1967 births, Living people, American progressives, Politicians from Cleveland, Ohio, US Democratic Party politicians, State legislators of the United States
Jim Hightower	1943 births, Living people, American columnists, American progressives, American political activists, Writers from Texas, Politicians from Texas, US Democratic Party politicians, People from Denison, Texas, American bloggers
Doreen Tracey	1943 births, 2018 deaths, Actors from London, American child actors, American models, American movie actors, American television actors, Cancer deaths in California, Deaths from pneumonia, Disease-related deaths in California, Models from London
Cyrille Regis	1958 births, 2018 deaths, Deaths from cardiac arrest, English footballers, Premier League players
Northerly Island	Parks in Chicago
Birobidzhan	Cities in Russia, Capital cities in Russia
Ray Anthony	1922 births, Living people, Trumpeters, American songwriters, American jazz musicians, American movie actors, American bandleaders, Musicians from Pennsylvania, Actors from Pennsylvania, Writers from Pennsylvania
DARPA	Military of the United States, Research organizations in the United States, Technology
Fritter	Fried foods
Ke Apon Ke Por	Indian television series, 2016 Indian television series debuts
Rozendaal	Municipalities of Gelderland, Settlements in Gelderland
Lillian Cox	1907 births, 2018 deaths, American supercentenarians, People from Tallahassee, Florida, People from Texas
Jean-Louis Koszul	1921 births, 2018 deaths, French mathematicians
Masahito, Prince Hitachi	1935 births, Princes and princesses, Living people, People from Tokyo
Atsuko Ikeda	1931 births, Living people, Japanese people, Princes and princesses
Dolores O'Riordan	1971 births, 2018 deaths, Accidental deaths by drowning, Drug-related deaths in the United Kingdom, Irish guitarists, Irish rock musicians, Irish singer-songwriters, Irish television personalities, People from Limerick, People with bipolar disorder
Bobby Rush	1946 births, Living people, African American politicians, United States representatives from Illinois, American civil rights activists, Politicians from Chicago, Politicians from Georgia (U.S. state), US Democratic Party politicians
Danny K. Davis	1941 births, Living people, United States representatives from Illinois, Democratic socialists, Politicians from Arkansas, Politicians from Chicago, US Democratic Party politicians
Bobby Rush (musician)	1933 births, Living people, American blues musicians, American composers, American rap musicians from Illinois, American funk musicians, Musicians from Louisiana, Musicians from Arkansas, American funk singers, Musicians from Chicago, Singers from Louisiana, Singers from Arkansas, Singers from Chicago, People from Pine Bluff, Arkansas
Flag of Sudan	National flags, Sudan
Edwin Hawkins	1943 births, 2018 deaths, 20th century composers, 21st century composers, African American musicians, African-American singers, American composers, American gospel musicians, American gospel singers, American Pentecostals, American pianists, Singers from Oakland, California, Cancer deaths in California, Deaths from pancreatic cancer, Grammy Award winners, Musicians from Oakland, California
Erling Mandelmann	2018 deaths, 1935 births, Deaths from aortic aneurysm, Cardiovascular disease deaths in France, Photographers, Danish journalists, People from Copenhagen
Viktor Anpilov	1945 births, 2018 deaths, Deaths from stroke, Russian politicians, Political activists, Russian communists
Bella Emberg	1937 births, 2018 deaths, English television actors, English movie actors, Actors from Sussex
Ogun State	1976 establishments in Africa, States of Nigeria
Bruno Latour	1947 births, Living people, People from Bourgogne-Franche-Comté, French sociologists, French academics, French philosophers, French Roman Catholics, French essayists, Continental philosophers
Battle of the Dnieper	1943 in Europe, Battles involving Germany, Battles involving the Soviet Union, 1940s in the Soviet Union, European battles of World War II, History of Belarus, 20th century in Ukraine
Ashish Sharma	Indian movie actors, Living people, 1984 births
Polsheer House	Pages created with the Article Wizard from 2018
Lou Barletta	1956 births, Living people, Businesspeople from Pennsylvania, American mayors, United States representatives from Pennsylvania, US Republican Party politicians
Le Haut-Soultzbach	2016 establishments in France, Communes in Haut-Rhin
Max Labovitch	1924 births, 2018 deaths, New York Rangers players, Sportspeople from Winnipeg, Eastern Hockey League players
Joe Frank	1938 births, 2018 deaths, Deaths from kidney cancer, Cancer deaths in California, American radio personalities, People from Strasbourg
Óscar Pérez	1981 births, 2018 deaths, Assassinated people, Deaths by firearm, Political activists, Terrorists, People from Caracas
Manasha	2018 Indian television series debuts, Indian television series
Madalena Iglésias	1939 births, 2018 deaths, Portuguese singers, Portuguese movie actors, Portuguese television actors, Portuguese stage actors, Portuguese voice actors, Eurovision Song Contest entrants, People from Lisbon
Hugh Wilson	Emmy Award winners, 1943 births, 2018 deaths, Deaths from emphysema, Cancer deaths in Virginia, American movie directors, American screenwriters, American television directors, American television producers, American television writers, Writers from Miami, Florida
Oliver Ivanović	1953 births, 2018 deaths, Assassinated people, Kosovan people, Politicians, Political activists
Henry B. Eyring	1933 births, Living people, American educators, American Latter Day Saints, Christian religious leaders, Christian writers, Writers from New Jersey, People from Princeton, New Jersey
Jo Jo White	1946 births, 2018 deaths, Deaths from pneumonia, Deaths from dementia, Disease-related deaths in Massachusetts, People with cancer, Boston Celtics players, Golden State Warriors players, Sacramento Kings players, American Olympic gold medalists, Sportspeople from St. Louis, Missouri, National Basketball Association players with retired numbers
Tom Heinsohn	1934 births, 2020 deaths, Boston Celtics players, National Basketball Association coaches, Sportspeople from New Jersey, People from Jersey City, New Jersey, National Basketball Association players with retired numbers
Ted Owens (basketball)	1929 births, Living people, Sportspeople from Oklahoma
Paul Gérin-Lajoie	1920 births, 2018 deaths, Canadian lawyers, Canadian philanthropists, Politicians from Montreal
Air gap (networking)	Computer networking
Bhim Singh Thapa	Nepalese people, 1959 deaths, Year of birth missing
Tug of war	Games
Zofis and Koko	Anime, Anime characters
Zuoz	Municipalities of Graubünden
Flag of Madagascar	National flags, Madagascar
Flag of Bosnia and Herzegovina	National flags, Bosnia and Herzegovina
Riedwihr	Former communes in Haut-Rhin, 2016 disestablishments in France
Karl-Heinz Kunde	1938 births, 2018 deaths, German cyclists, People from Cologne, Sportspeople from North Rhine-Westphalia
George Bandy	1945 births, 2018 deaths, Deaths from pulmonary fibrosis, Politicians from Alabama, US Democratic Party politicians, State legislators of the United States
Steve Guttenberg	1958 births, Actors from New York City, American movie actors, American television actors, Jewish American actors, People from Brooklyn, Jewish American writers, Living people
Glen Sather	1943 births, Boston Bruins players, Canadian ice hockey left wingers, Hockey Hall of Fame inductees, Ice hockey people from Alberta, Jack Adams Award winners, Living people, Minnesota North Stars players, Montreal Canadiens players, New York Rangers players, Pittsburgh Penguins players, Sportspeople from Alberta, Stanley Cup champions, St. Louis Blues players, World Hockey Association players
Khoo Chin-bee	1977 births, Female tennis players, Living people, Malaysian sportspeople
Pakistan's Message	Government of Pakistan
Soyarabai	1680 deaths, Indian murder victims, Year of birth unknown
Black Country	West Midlands (county)
Alma, Arkansas	Cities in Arkansas
Kevin J Worthen	1956 births, Living people
Guinea-Bissau war of Independence	Wars of independence, Wars involving Portugal
Abdul Khaliq Hazara	Hazara people, Persian people, People from Kabul
Esther Mahlangu	1935 births, South African people
Luc Beyer de Ryke	1933 births, 2018 deaths, Alderman of Belgium, Belgian journalists, Belgian writers, Deaths from cardiovascular disease, Former MEPs, MEPs for Belgium, People from Ghent, Television presenters, Disease-related deaths in France
Molinis	Former municipalities of Graubünden
Peist	Former municipalities of Graubünden
Saas im Prättigau	Former municipalities of Graubünden
St. Antönien Ascharina	Villages in Graubünden, Former municipalities of Graubünden
Flag of the Central African Republic	National flags, Central African Republic
Saint-Louis, Haut-Rhin	Communes in Haut-Rhin
Joyee	Indian television series, 2017 Indian television series debuts
Khanaspur	Towns in Pakistan
Sorry, Wrong Number	1948 movies, 1940s thriller movies, English-language movies, American thriller movies, Movies directed by Anatole Litvak
John Pierik	1949 births, 2018 deaths, Dutch Olympians, Sportspeople from Overijssel
Roderick Rijnders	1941 births, 2018 deaths, Dutch sportspeople, Olympic silver medalists, People from Batavia, Rowers
Bill Bain	1937 births, 2018 deaths, Deaths from Alzheimer's disease, Disease-related deaths in Florida, Republicans (United States), Businesspeople from Boston, Massachusetts, People from Tennessee
Peter Groeger	1933 births, 2018 deaths, East German people, German movie actors, German stage actors, German television actors, German voice actors, People from Saxony-Anhalt
Ishfaq Ahmad	1930 births, 2018 deaths, Pakistani people, Physicists, Pakistani educators
Augusto Polo Campos	1932 births, 2018 deaths, Deaths from diabetes, Composers, Peruvian people
Chick Webster	1920 births, 2018 deaths, Canadian ice hockey centres, Eastern Hockey League players, New York Rangers players, Sportspeople from Toronto
Bradford Dillman	1930 births, 2016 deaths, Deaths from pneumonia, Infectious disease deaths in California, American movie actors, American television actors, American stage actors, American voice actors, Actors from San Francisco, Writers from San Francisco
Bhimsen Thapa	1775 births, 1839 deaths, Nepalese politicians
Geo Super	Television channels
Concours Advance	Engineering schools, Colleges and universities in France, 2011 establishments in France

