Elastic modulus	Materials science, Mechanics
ISO 3166-1	ISO 3166, Lists of countries, Country codes
Lira da braccio	String instruments, Early musical instruments
Atlas (missile)	Engineering, Rockets
Flag of Dominican Republic	Dominican Republic, National flags
Southampton	Unitary authorities, Southampton, Ports and harbours of the United Kingdom
Lhasa Apso	Dog breeds
States and territories of Australia	States and territories of Australia, Australia
The Rocky and Bullwinkle Show	Animated television series, Comedy television series, 1950s television series, 1960s television series
Jimmy Finlayson	1887 births, 1953 deaths, Scottish movie actors, American comedians, American movie actors
Body mass index	Fitness
Middle age	Society
Tribute	Taxation, Musical terminology
Brandy (singer)	1979 births, Living people, Actors from Mississippi, African American actors, African-American singers, American movie actors, American R&B musicians, American singer-songwriters, American television actors, Brandy Norwood, Dancing with the Stars participants, Grammy Award winners, Singers from Mississippi
Kew Gardens	Buildings and structures in London, World Heritage Sites in the United Kingdom, Botanical gardens in the United Kingdom
Yo Gabba Gabba!	2007 American television series debuts, 2015 American television series endings, 2000s American television series, 2000s children's television series, 2010s American television series, 2010s children's television series, American children's television series, Nickelodeon television series, English-language television programs
Post (album)	Björk albums, 1995 albums
Landscape	Geography, Geology, Ecology
Dell	1984 establishments in the United States, 1980s establishments in Texas, American technology companies, Companies based in Texas
Svartahrid	Black metal bands, Norwegian heavy metal bands
Marcel Marceau	1923 births, 2007 deaths, French actors, French entertainers, French Jews, Jewish actors, Legion of Honour, Mimes, People from Strasbourg, Burials at Père Lachaise Cemetery
Bugs Bunny	Looney Tunes characters, Fictional hares and rabbits, Fictional characters introduced in the 1930s
Kaz II mystery	Ships, 2000s in Australia, 2007
The Simpsons shorts	The Simpsons
James L. Brooks	1940 births, Living people, American movie directors, American screenwriters, Emmy Award winners, Writers from New York City
Wi-Fi	Computer networking
Digital Object Identifier	Documents
Encyclopaedia Metallum	Entertainment websites, Heavy metal
Tropical Depression Ten (2007)	Hurricanes in the United States, Tropical depressions, 2007 Atlantic hurricane season, September events, 2007 in Florida, 2007 in Georgia (U.S. state), 2000s in Alabama
Software piracy	Copyright, Software
Bionicle	Lego, DC Comics
Flora	Botany, Ecology, Reference works
Eric Cantona	1966 births, Living people, Actors from Marseille, French footballers, French movie actors, Manchester United F.C. players, Sportspeople from Provence-Alpes-Cote d'Azur
Twin town	Diplomacy, Settlements
Buffyverse	Whedonverse
Loudness	Sound
Atlas Mountains	Mountains of Africa, Geography of Algeria, Geography of Morocco, Tunisia
Genetic drift	Evolutionary biology, Classical genetics
1956 Winter Olympics	1956 in sports, 1956 in Europe, 1950s in Italy, Sport in Italy, Veneto, Winter Olympics in Europe
Feather duster	Cleaning tools
Electrostatics	Electricity
Coat of arms of Dominican Republic	National coats of arms, Dominican Republic, 1844 establishments in the Dominican Republic
Eustis, Florida	Cities in Florida
Fort Walton Beach, Florida	Cities in Florida
Supercell	Severe weather
Kathleen Blanco	1942 births, 2019 deaths, Governors of Louisiana, Deaths from liver cancer, Deaths from melanoma, Deaths from eye neoplasm, US Democratic Party politicians, Lieutenant Governors of Louisiana
Armenian hypothesis	Indo-European, Armenian language, Ancient Armenia, Origin hypotheses of ethnic groups
Wilsonian Armenia	History of Armenia
Yasuo Fukuda	1936 births, Living people, Prime Ministers of Japan, People from Gunma Prefecture
Mercenary	Military
Kere	Lakes of Kazakhstan
Jean-Pierre Jeunet	1953 births, Living people, French movie directors
Graham Yost	1959 births, Living people, Canadian screenwriters, Emmy Award winners
Longboat	Boats
Jarrow	Towns in Tyne and Wear
1952 Winter Olympics	1952 Winter Olympics, 1952 in sports, 1952 in Europe, 20th century in Norway, History of Oslo
1940 Summer Olympics	1940 in sports, 1940s in Japan, Cancelled Olympic Games, Summer Olympic Games
1936 Winter Olympics	1936 in Germany, 1936 in sports, History of Bavaria, Olympic Games in Germany, Sport in Bavaria, Winter Olympics in Europe
Atlas (anatomy)	Bones
Vertebra	Bones
1928 Winter Olympics	1928 in sports, Winter Olympics in Europe, Sport in Switzerland, 20th century in Switzerland, 1928 in Europe
Local government in England	Local government in England
1928 Summer Olympics	1928 in sports, Summer Olympics in Europe, Sport in the Netherlands, History of Amsterdam, 20th century in the Netherlands, 1928 in Europe
1924 Winter Olympics	1924 in sports, 1920s in France, Chamonix, Sport in France, Winter Olympics in Europe, 1924 in Europe
Realism	Philosophical movements and positions‎, Art movements, Literature, Music
Ridge (meteorology)	Meteorology
Hurricane Hunters	Hurricanes
St. Vincent Island, Florida	Islands of Florida
Phencyclidine	Illegal drugs
Philodendron	Vines, Araceae
Sagittarius (astrology)	Astrological signs
Shell Oil Company	Companies based in Houston
Noble Energy	Companies based in Houston
Pakenham railway line, Melbourne	Australian railways, Transport in Melbourne
Austrian Empire	19th century in Austria, 1804 establishments in Europe, 1867 disestablishments, 19th century disestablishments in Europe, 1860s disestablishments in Europe
Pilot fish	Perciformes
Bălţi	Cities in Moldova
Floyd Landis	1975 births, Living people, American cyclists, Doping cases in cycling, Sportspeople from Pennsylvania, Tour de France cyclists
Óscar Pereiro	1977 births, Living people, Doping cases in cycling, Spanish cyclists
Hawksbill sea turtle	Turtles, Marine reptiles, Critically endangered species
1924 Summer Olympics	1924 in sports, 1920s in France, History of Paris, Summer Olympics in France, 1924 in Europe
1906 Summer Olympics	1906 in Europe, Summer Olympics in Europe, Sport in Athens, 20th century in Greece
2012 Summer Olympics	2012 Summer Olympics
1952 Summer Olympics	1952 Summer Olympics, Helsinki, 20th century in Finland, 1952 in sports, 1952 in Europe
1948 Summer Olympics	1948 Summer Olympics, 1948 in sports, 1940s in England, 20th century in London
1944 Summer Olympics	1944 in Europe, 1944 in sports, 1940s in England, Cancelled Olympic Games, Summer Olympic Games, 20th century in London
1920 Summer Olympics	1920 in Europe, 20th century in Belgium, Summer Olympics in Europe, Sport in Belgium, Antwerp
1916 Summer Olympics	1916 in Europe, 1910s in Germany, 20th century in Berlin, Cancelled Olympic Games, Olympic Games in Germany, Sport in Berlin, Summer Olympic Games
Morphology (linguistics)	Grammar
Syntax	Grammar
1912 Summer Olympics	1912, 1910s in Europe, 20th century in Sweden, Sport in Stockholm, Summer Olympics in Europe
Vyacheslav Vsevolodovich Ivanov	Linguists, Russian scientists, 1929 births, 2017 deaths
Tamaz V. Gamkrelidze	1929 births, 2021 deaths, Scientists from Georgia (country)
Georgian alphabet	Georgia (country), Alphabets
Cytosine	Molecular biology, Organic compounds
1908 Summer Olympics	1908, 1900s in the United Kingdom, Sport in London, Summer Olympics in Europe
Guanine	Biochemistry
Glottalic theory	Pronunciation
Proto-Indo-Europeans	Indo-European
Urheimat	Indo-European, Origin hypotheses of ethnic groups
Anatolian hypothesis	Indo-European, Origin hypotheses of ethnic groups
Rafael Ishkhanyan	1922 births, 1996 deaths, Armenian historians
Cross-country race	Running
Long distance race	Running
Warsaw Convention	Aviation, 1929 in Europe, 20th century in Poland, 1955, 1950s in the Netherlands, 1975, 1970s in Canada, 20th century in Montreal, 1920s treaties, 1950s treaties, 1970s treaties
Coroner (band)	1980s establishments in Switzerland, 1985 establishments in Europe, 1996 disestablishments, 2010 establishments in Switzerland, Swiss heavy metal bands, Thrash metal bands, Zürich, Musical groups established in 1985, Musical groups disestablished in 1996, Musical groups established in 2010, Disestablishments in Switzerland
Ritchies	Supermarkets of Australia
Maggie Smith	Academy Award winning actors, Actors from Essex, Actors from Oxfordshire, BAFTA Award winning actors, Breast cancer survivors, Emmy Award winning actors, English movie actors, English stage actors, English television actors, Golden Globe Award winning actors, People from Ilford, People from Oxford, Tony Award winning actors, 1934 births, Living people, Knights and Dames Commander of the Order of the British Empire
Blood Tsunami	Thrash metal bands, Norwegian heavy metal bands, Oslo, Musical groups established in 2004, 2004 establishments in Europe, 21st century establishments in Norway
Bates College	Colleges and universities in Maine, Oberlin Group of Libraries, Lewiston, Maine, 1855 establishments in the United States, 19th-century establishments in Maine
Suffolk University	Colleges and universities in Massachusetts, 1906 establishments in the United States, 1900s establishments in Massachusetts
French literature	French literature
Treaty of Warsaw (1970)	1970, 1970s in Germany, 20th century in Poland, 1970s treaties
History of Poland	History of Poland
Polish-Lithuanian Union	History of Poland, History of Lithuania
Personal union	Political systems
Scordatura	Musical performance techniques
2028 Summer Olympics	2028, 2020s in sports, Summer Olympics in the United States, 21st century in California
Etruscan origins	Etruscan civilization
Etruscan language	Language isolates, Etruscan civilization
Albanian language	Indo-European languages, Languages of Europe
Trialeti culture	History of Armenia, History of Georgia (country)
Kura-Araxes culture	History of Georgia (country), History of Armenia, History of Azerbaijan
Biodiesel	Biofuels
Nimrod	Old Testament people
Julie Kavner	1950 births, Living people, American television actors, Actors from Los Angeles, California, Emmy Award winning actors
Age of Empires	Real-time strategy video games, Video game series, Windows games
Bridge (instrument)	String instrument construction
Brazilwood	Trees, Fabaceae
Chav	British culture, Pejoratives, Slang
Council house	Public services in the United Kingdom, Houses
Midnight Madness	1980 movies, Disney movies, English-language movies
Barvas	Villages in Scotland
Lewis	Inner and Outer Hebrides
Stornoway	Towns in Scotland
Skye	Inner and Outer Hebrides
2024 Summer Olympics	2020s in France, 2020s in sports, August events, History of Paris, July events, Summer Olympics in France
2022 Winter Olympics	2022 in sports, Winter Olympics in Asia, 21st century in China
Guarneri	Musical instrument makers, People from Cremona
Amati	Musical instrument makers, Italian families
Guardians of Scotland	History of Scotland, 1292 establishments, Establishments in Scotland, 14th century disestablishments in Europe, 1292 disestablishments, 1295 establishments, 1302 disestablishments, 1290s establishments in Europe
Montel Vontavious Porter	1973 births, African-American wrestlers, American agnostics, American burglars, American kidnappers, American professional wrestlers, American rap musicians from Florida, American robbers, Converts to Islam, Living people, Former WWE wrestlers, Sportspeople from Miami, Florida, TNA wrestlers
Pretzel	Snack foods, German food
Shoplifting	Theft
Portrait	Art
Steroid	Steroid hormones, Drugs
Road rage	Human behavior, Violence
Graceland	Memphis, Tennessee, Elvis Presley, Buildings and structures in Tennessee
Harry Shearer	American television actors, American voice actors, Comedians from Los Angeles, California, Actors from Los Angeles, California, HuffPost writers and columnists, 1943 births, Living people
Nancy Cartwright	1957 births, Living people, American voice actors, Ohio University alumni
Coco Lee	1975 births, Living people, Singers from Hong Kong, C-pop singers, American composers, Singer-songwriters from California, Actors from Hong Kong
Daniel Schneidermann	1958 births, Living people, French writers, French journalists
Pound (mass)	Imperial units, Units of mass
Eastern Armenia	History of Armenia
Western Armenia	History of Armenia
Kingdom of Poland (1385–1569)	History of Poland
Jagiellon dynasty	History of Poland, Royal dynasties
D'oh!	The Simpsons
Aqua regia	Acids
Inari (mythology)	Japanese deities
Kurgan hypothesis	Indo-European, Origin hypotheses of ethnic groups
Marija Gimbutas	1921 births, 1994 deaths, Archaeologists, Lithuanian people, People from Vilnius
Luwians	Indo-European
Phrygia	Former monarchies of Asia, Former vassal states, History of Turkey
White Genocide	Armenian Genocide, Genocide
Didier Drogba	1978 births, Living people, Ivorian footballers, Chelsea F.C. players
Muscatine, Iowa	Cities in Iowa, County seats in Iowa
Armenian Army	Military of Armenia, Armies, 1992 establishments, 20th century establishments in Armenia
Armenian Air Defense	Military of Armenia
Armed Forces of Armenia	Military of Armenia
President of Armenia	Presidents of Armenia, 1991 establishments, 20th century establishments in Armenia
Levon Ter-Petrossian	1945 births, Living people, Presidents of Armenia
Intonation (music)	Musical performance techniques, Vocal music
Musical tuning	Musical instruments
List of members of the Red Army Faction	Germany-related lists, German terrorists, Red Army Faction
Captain of Köpenick	1849 births, 1922 deaths, German criminals
Hittites	Hittite Empire, Mesopotamia
Suppiluliuma II	Hittite Empire
Battle of Rhandeia	History of Armenia, Wars and battles of Ancient Rome, 62
Hydrochloric acid	Acids, Chlorine compounds, Medicine
Kobayr monastery	Churches in Armenia
Hnevank	Churches in Armenia
Huntington's disease	Genetic disorders, Diseases
Adenoidectomy	Surgery
Turkish Armenian Reconciliation Commission	Establishments in Armenia, 2000s establishments in Turkey, 2001 establishments in Asia, Political organizations based in Asia
ROT13	Cryptography
Tony Kahn	American radio personalities, American journalists, Columbia University alumni, Writers from Los Angeles, California, Year of birth missing (living people), Living people
DDT	Poisons, Organic compounds, Carcinogens, Pollution
Nucleobase	Biochemistry
Kėdainiai	Cities in Lithuania
Base pair	Molecular biology
Complementarity (molecular biology)	Molecular biology
Glissando	Musical performance techniques, Musical terminology
Almudena Cathedral	Roman Catholic Cathedrals, Cathedrals in Spain, Buildings and structures in Madrid, 1993 establishments in Europe, 1990s establishments in Spain
KIO Towers	Buildings and structures in Madrid, 1996 establishments in Europe, 1990s establishments in Spain
Portamento	Musical performance techniques, Musical terminology
Hydrogen bond	Chemical bonding
Thalidomide	Drugs, Health problems
United Arab Republic	1957 establishments, 1961 disestablishments, Former countries in Africa, Former countries in Asia, 20th century in Egypt, 20th century in Syria
Drop goal	Rugby
Southern Rhodesia	History of Zimbabwe, Former British colonies
Sibylline Books	Roman mythology, Religious texts
2020 Summer Olympics	2021 in Asia, 2021 in sports, 21st century in Japan, History of Tokyo, July 2021 events, August 2021 events, 2020 Summer Olympics
2016 Summer Olympics	2016 Summer Olympics
Molecular biology	Biochemistry, Cell biology, Molecular biology
Uracil	Biochemistry
Double stopping	Musical performance techniques
Saar (protectorate)	Former countries in Europe, 20th century in Germany, 20th century in France, Saarland, 1947 establishments in Europe, 1956 disestablishments in Europe
Law of large numbers	Statistics
Hennes & Mauritz	Companies of Sweden, Clothing companies, 1947 establishments in Sweden
Luchegorsk	Settlements in Russia
The Tell-Tale Heart	19th-century American short stories, Short stories by Edgar Allan Poe
Boxe pieds-poings	Martial arts
Vibrato	Musical performance techniques
Titan A.E.	2000 movies, 2000 animated movies, 2000 science fiction movies, American animated movies, American science fiction movies, 20th Century Fox movies, Movies directed by Don Bluth, Screenplays by Joss Whedon, Dystopian movies
Nigella Lawson	1960 births, Living people, Alumni of the University of Oxford, British chefs, English television presenters, Jewish British writers, Jewish entertainers, Journalists from London, People educated at Westminster School, London, People from Wandsworth, Television personalities from London, Writers from London
Pittsburg, Texas	Cities in Texas, County seats in Texas
Level 42	1970s British music groups, 1979 establishments in the United Kingdom, 1980s British music groups, 1990s British music groups, 2000s British music groups, 2010s British music groups, British pop rock bands, English pop music groups, English rock bands, Isle of Wight, Musical groups established in 1979, New wave bands
Johann Heinrich Schmelzer	1623 births, 1688 deaths, Baroque composers, Austrian composers
Oireachtas	Politics of Ireland, Government of the Republic of Ireland, National legislatures
Quasar	Galaxies, Black holes
Dáil Éireann	Politics of Ireland, Government of the Republic of Ireland, National lower houses, 1918 establishments in Europe, 1920s establishments in the United Kingdom, 20th century establishments in the Republic of Ireland
Taoiseach	Taoisigh of Ireland, Government of the Republic of Ireland, Government occupations
Anton Webern	1883 births, 1945 deaths, 20th century composers, Austrian composers, People from Vienna
Seanad Éireann	Politics of Ireland, Government of the Republic of Ireland, National upper houses
Protein biosynthesis	Proteins
List of hurricanes in California	California-related lists, Hurricanes in the United States, Weather lists
National Weather Service	United States government agencies, Weather services
Yuma, Arizona	Cities in Arizona, County seats in Arizona, 1914 establishments in the United States, 20th-century establishments in Arizona
Storm surge	Severe weather
California Current	Pacific Ocean, Ocean currents
Baja California Peninsula	Geography of Mexico, Peninsulas
Sukkot	Jewish festivals and holidays
Waterworld	1995 action movies, 1990s adventure movies, 1990s science fiction movies, American action movies, American adventure movies, American science fiction movies, English-language movies, Movies set in the future, Universal Pictures movies, Post-apocalyptic movies, Movies with underwater settings
Kevin Costner	1955 births, Living people, American movie actors, American television actors, American stage actors, American voice actors, Democrats (United States), Academy Award winning directors, Actors from Los Angeles County, California, American Baptists, Musicians from Los Angeles County, California, Movie directors from Los Angeles County, California, Movie producers from Los Angeles County, California
Douglas Hyde	1860 births, 1949 deaths, Presidents of Ireland, Politics of Ireland, Former members of Seanad Éireann
Cearbhall Ó Dálaigh	1911 births, 1978 deaths, Presidents of Ireland, Irish judges, People from Dublin, Chief justices, Attorneys general
Translation (genetics)	Molecular biology, Cell biology
Gene expression	Genetics, Cell biology, Molecular biology, Epigenetics
Curtis (50 Cent album)	2007 albums, 50 Cent, Hip hop albums
Šarplaninac	Dog breeds
El Limón, Samaná	Settlements in Dominican Republic, 2001 establishments in the Dominican Republic
Théodore Chassériau	1819 births, 1856 deaths, French painters, Burials at Montmartre Cemetery, Paris
Intermolecular force	Chemistry
Spineshank	American heavy metal bands, Alternative metal bands, Musical groups from Los Angeles, California
Tanystropheus	reptiles
Yuryuzan, Chelyabinsk Oblast	Towns in Russia
Sim (town)	Towns in Russia, 18th century establishments in Russia, 1759 establishments
Duff Beer	The Simpsons, Beer
Sassuntsi-Davit Tank Regiment	20th century in Armenia, History of Azerbaijan, 1940s in the Soviet Union, Military
Sursk	Towns in Russia, 1860 establishments, 19th century establishments in Russia
Lipki	Towns in Russia
Lage	Lippe Rural District
Venture capital	Economics
Moment of inertia	Mechanics, Physical quantity
Multiple choice	Tests
Angular velocity	Physical quantity, Mechanics
Angular frequency	Physical quantity, Mechanics
Pseudovector	Algebra, Mathematics
Twister (1996 movie)	1996 drama movies, 1990s disaster movies, American disaster movies, American drama movies, English-language movies, Movies set in Oklahoma, Warner Bros. movies, Movies composed by Ennio Morricone
Spoke	Engineering
Examination	Education, Tests
Irish Republic	History of Ireland, 1919 establishments in Europe, 1922 disestablishments in Europe
Super Smash Bros. Brawl	Super Smash Bros., 2008 video games, Wii games
Final Fantasy Tactics Advance	Final Fantasy games
X-Men (movie)	2000 movies, 2000s superhero movies, X-Men movies, Movies directed by Bryan Singer, Movies produced by Avi Arad, Movies produced by Lauren Shuler Donner, Movies set in New York City, Movies set in the 1940s, 20th Century Fox movies
Kingston upon Hull	Kingston upon Hull, Unitary authorities, 12th century establishments in Europe
Riding (division)	Counties of the United Kingdom, Politics of Canada
Pulkkila	Former municipalities of Finland
Emmental cheese	Swiss cheeses
Emmental	Valleys of Switzerland, Canton of Bern
2001 Pacific hurricane season	2001 in North America, Pacific hurricane seasons
2000 Pacific hurricane season	Pacific hurricane seasons, 2000
2006 Pacific hurricane season	2006 Pacific hurricane season
1997 Pacific hurricane season	1997 Pacific hurricane season
1987 Pacific hurricane season	Pacific hurricane seasons, 1987
1976 Pacific hurricane season	Pacific hurricane seasons, 1976 in North America
Kronosaurus	Plesiosaurs
Fermat number	Number theory
Blowup	1960s mystery movies, 1966 drama movies, British mystery movies, British drama movies, English-language movies, Movies set in London, MGM movies, Italian drama movies, Movies directed by Michelangelo Antonioni
Improper rotation	Geometry
Endorphins	Endocrine system, Proteins
Team Fortress 2	2007 video games, Shooter video games
Big Black	1981 establishments in the United States, 1980s American music groups, 1987 disestablishments in the United States, 1980s establishments in Illinois, American punk bands, American rock bands, Musical groups disestablished in 1987, Musical groups established in 1981, Musical groups from Illinois, 20th-century disestablishments in Illinois
Company of Heroes	2006 video games, Real-time strategy video games
Game & Watch	Handheld video games
Fecundity	Biological reproduction
Séan T. O'Kelly	1882 births, 1966 deaths, Former members of Dáil Éireann, Order of Merit of the Federal Republic of Germany, People from Dublin, Presidents of Ireland
Teachta Dála	Politics of Ireland, Members of Dáil Éireann
Léo Delibes	1836 births, 1891 deaths, Romantic composers, French composers, Burials at Montmartre Cemetery, Paris
Rugrats	1991 American television series debuts, 2004 American television series endings, 1990s animated television series, 1990s American sitcoms, 1990s children's television series, 2000s American sitcoms, 2000s animated television series, 2000s children's television series, American animated television series, American children's television series, Nickelodeon television series, Rugrats, Nicktoons, Emmy Award winning programs, English-language television programs
Displacement vector	Geometry, Physics, Linear algebra, Vectors
Enkephalin	Endocrine system, Proteins
Receptor (cell biology)	Cell biology, Biochemistry
Coppélia	Ballets, Compositions by Léo Delibes
Pan-German movement	German people, Nationalism
IMVU	Free software, Instant messaging software
Constance Georgine, Countess Markiewicz	1868 births, 1927 deaths, Politicians from London, Sinn Féin politicians, Fianna Fáil politicians
Nas	1973 births, Living people, African American musicians, American rap musicians from New York
United Kingdom of Great Britain and Ireland	1922 disestablishments in Europe, 1801 establishments, 1800s establishments in Europe
Xerox	American technology companies, Companies listed on the New York Stock Exchange
Agneta Sjödin	1967 births, Living people, Swedish television presenters
Baroque	Art movements, Architectural styles
Éamon de Valera	1882 births, 1975 deaths, Fianna Fáil politicians, Former members of Dáil Éireann, Government ministers of Ireland, Politicians from New York City, Prisoners of war, Sinn Féin politicians, Taoisigh of Ireland
Operetta	Musical forms, Opera genres
Investiture	Ceremonies
Insignia	Symbols, Military
Irish War of Independence	20th century in Ireland, Wars involving the United Kingdom, Irish War of Independence, Rebellions in Europe, 20th century rebellions, 1919 in the United Kingdom, 1920 in the United Kingdom, 1921 in the United Kingdom
Bishop (chess)	Chess pieces
Bathurst 1000	Auto racing, Sport in Australia, New South Wales
South Atlantic tropical cyclone	Tropical cyclones
Opera buffa	Opera genres
Opera seria	Opera genres
Counties of Ireland	Counties of Northern Ireland, Europe-related lists, Counties of the Republic of Ireland, Lists of counties
Melk Abbey	Benedictine abbeys, Buildings and structures in Austria, Christianity in Austria, Lower Austria
Walenstadt	Municipalities of St. Gallen, Cities in Switzerland
Exhibitionism	Human sexuality
Norman Rockwell	1894 births, 1978 deaths, American painters, Artists from New York City, Deaths from emphysema, Disease-related deaths in Massachusetts
Zuiderzee Works	Dams, Water infrastructure, Seven Wonders of the Modern World, Buildings and structures in the Netherlands, Geography of the Netherlands, History of the Netherlands, Flevoland
Hugo Alvar Henrik Aalto	1898 births, 1976 deaths, Finnish people, Architects
Crook of Devon	Villages in Scotland
Opéra-comique	Opera genres
Vaudeville	Song forms, Opera genres
Capelle aan den IJssel	Cities in the Netherlands, Settlements in South Holland, Municipalities of South Holland
Poppy	Flowers, Ranunculales
Time signature	Musical notation, Music theory
Really Simple Syndication	Computer file formats, Internet
European Union member state	European Union, European Union member states, Europe-related lists
Porter	Basic English 850 words
Quetzal	Birds
The Powerpuff Girls	American children's television series, American animated television series, Cartoon Network series, 1998 television series debuts, 1990s American comedy television series, 2000s American comedy television series, American science fiction television series, Animated adventure television series, American sitcoms, The Powerpuff Girls, American satirical television series, Action television series, Comedy television series, American television series revived after cancellation, Television series about sisters, Comedy science fiction, English-language television programs
Teutonic Knights	Roman Catholicism, History of Europe, Middle Ages, Orders, decorations, and medals, 12th century establishments in Europe
Renju	Board games, Japanese culture
Nainital	Towns in India, Settlements in Uttarakhand
24 (TV series)	2001 American television series debuts, 2010 American television series endings, 2000s American television series, 2010s American television series, American crime television series, American drama television series, Emmy Award winning programs, Fox television series, Golden Globe Award winning programs, Spy television series, Television series set in Los Angeles, California, Television series set in New York City, Television series set in Washington, D.C., English-language television programs
Tony Award for Best Musical	Tony Awards
Tony Award for Best Play	Tony Awards
Queen Anne's Revenge	Ships, Piracy, History of North Carolina
Mouthpiece (brass)	Brass instruments, Former good articles, Musical instrument construction
Erskine Hamilton Childers	1905 births, 1974 deaths, Presidents of Ireland, Tánaistí of Ireland, Former members of Dáil Éireann, Politicians from London
Tánaiste	Politics of Ireland
Irish Free State	Irish Free State, Politics of Ireland, Former countries in Europe, 1922 establishments in Europe, 1930s disestablishments in Europe, 1937 disestablishments
2018 Winter Olympics	2018 in Asia, 2018 in sports, February 2018 events, Sport in South Korea, Winter Olympics in Asia, 2010s in South Korea
Kabyles people	Berber people
Berber languages	Berber languages
Southern Ireland	Former countries in Europe, 1920s in Ireland, 1920s in the United Kingdom, 1922 in Europe
Züsedom	Settlements in Mecklenburg-Vorpommern, Villages in Germany
Bankstown Bunker	1945 establishments in Europe, 1940s in Australia, Fortifications of World War II, Air force, Buildings and structures in New South Wales, Military of Australia, 1940s disestablishments
Coldplay	1990s British music groups, 1997 establishments in England, 2000s British music groups, 2010s British music groups, English rock bands, Coldplay, Grammy Award winners, Musical groups established in 1997, Musical groups from London, Musical quartets
Sleeping sickness	Diseases spread by insects, Diseases caused by protozoa
Ayyubid dynasty	History of Islam, Kurdistan, History of the Middle East, Royal dynasties
Vice-President of the Executive Council of the Irish Free State	Politics of Ireland, Irish Free State
Tsetse fly	Flies
Pun	Figures of speech, Humor
North American P-51 Mustang	United States Army aircraft, Royal Air Force aircraft, World War II American aircraft
Airsoft	Sports
Mikoyan-Gurevich MiG-15	Soviet military aircraft, Military of China, North Korea, Korean War, 1947 establishments
North American F-86 Sabre	United States Air Force aircraft, Royal Air Force aircraft, Korean War
Patrick Hillery	1923 births, 2008 deaths, European Commissioners, Government ministers of Ireland, People from County Clare
Mikoyan-Gurevich MiG-21	Soviet military aircraft, Indian military aircraft, Vietnamese military aircraft, Polish military aircraft, Vietnam War aircraft
Pantyhose	Underwear
Tights	Clothing
Cockatiel	Birds of Australia, Cockatoos, Pets
North Hollywood shootout	1997 in California, 1990s crimes in California, 1990s in Los Angeles, California, February events, Robberies, Suicides by firearm in the United States, Suicides in California
AR-15	Rifles, 5.56 mm firearms
Timpani	Drums
Hurricane Lorenzo (2007)	Hurricanes in Mexico, Category 1 Atlantic hurricanes, 2007 Atlantic hurricane season, 2007 in Mexico
Supergiant	Supergiants
Tipton	Towns in the West Midlands (county)
Organic matter	Organic compounds, Organic chemistry
Mary Robinson	1944 births, Living people, Former members of Seanad Éireann, Presidents of Ireland, United Nations officials
MotorStorm	2006 video games
Athletic shoe	Footwear, Sports clothing
Achtung Baby	U2 albums, 1991 albums
Trail of Tears	1830s in the United States, Cherokee Nation, Crimes against humanity, History of Native Americans, Migration, 19th century in Oklahoma, 19th century in Georgia (U.S. state)
Tropical cyclogenesis	Tropical cyclones
Archbishop	Christian religious occupations
Devolution	Forms of government
5566 (band)	C-pop, 2000s music groups, Pop music groups, Taiwanese musical groups
Fahrenheit (band)	2000s establishments in Taiwan, 2000s music groups, 2010s music groups, Boy bands, C-pop, Musical groups established in 2005, Pop music groups, Taiwanese musical groups, 2005 establishments in Asia
Laborschule Bielefeld	Education in North Rhine-Westphalia, Bielefeld
Jody Scheckter	1950 births, Living people, Formula One drivers, Jewish sportspeople, South African Jews, South African sportspeople, White South African people
Programme for International Student Assessment	Education
Doris Lessing	1919 births, 2013 deaths, Deaths from stroke, English autobiographers, Companions of Honour, Royal Society of Literature, Booker Prize winners, British Nobel Prize winners, British academics, British communists, British feminists, English novelists, English playwrights, English poets, English science fiction writers, British socialists, Nobel Prize in Literature winners, Officers of the Order of the British Empire, Writers from London
An Najaf	Cities in Iraq, 8th century establishments in Iraq
Karbala	Cities in Iraq
Are You Smarter Than a 5th Grader?	2007 television series debuts, Fox television series, First run syndicated television programs, Television game shows
Washington State University	Colleges and universities in Washington, Pac-12 Conference, 1890 establishments in the United States, 19th-century establishments in Washington (state)
Land-grant university	Colleges and universities
Pullman, Washington	Cities in Washington (U.S. state)
Vought F-8 Crusader	United States Navy aircraft, United States Marine Corps aircraft, French military aircraft, Vietnam War aircraft
LTV A-7 Corsair II	United States Air Force aircraft, United States Navy aircraft, Vietnam War aircraft
McDonnell Douglas F-4 Phantom II	United States Air Force aircraft, United States Navy aircraft, United States Marine Corps aircraft, Vietnam War aircraft
Kappa (folklore)	Japanese folklore
Oni (folklore)	Japanese folklore
Tengu	Japanese folklore
John McCain	1936 births, 2018 deaths, American aviators, American Baptists, American military personnel of the Vietnam War, Cancer deaths in Arizona, Deaths from glioblastoma, Prisoners of war, Purple Heart recipients, 2000 United States presidential candidates, 2008 United States presidential candidates, United States representatives from Arizona, United States senators from Arizona, US Republican Party politicians
WikiHow	Wikis, MediaWiki websites
Oregano	Herbs, Lamiaceae
Origanum	Herbs, Lamiaceae
Basil	Lamiaceae, Herbs
Cockapoo	Dog breeds
Short story	Short stories
2014 Winter Olympics	2014 Winter Olympics, 2014 in sports, 2010s in Russia, Sochi, February events
1944 Winter Olympics	1944 in Italy, 1944 in sports, Cancelled Olympic Games, Sport in Italy, Veneto, Winter Olympic Games
1940 Winter Olympics	1940 in Europe, 1940 in sports, 1940s in Germany, 1940s in Japan, Cancelled Olympic Games, Olympic Games in Germany, Sport in Japan, Sport in Switzerland, Winter Olympic Games, February events
Alonso Berruguete	1488 births, 1561 deaths, Spanish painters
Alonso Sánchez Coello	1530s births, 1588 deaths, Spanish painters
Western European Union	European Union, International organizations, 1948 establishments in Europe, Military alliances
Guy Fawkes Night	British culture, Anniversary days in the United Kingdom
National Oceanic and Atmospheric Administration	United States government agencies, Scientific organizations based in the United States
Tracey Ullman	1959 births, Living people, Actors from Buckinghamshire, English comedians, English movie actors, English stage actors, English television actors, English voice actors, English writers, BAFTA Award winning actors, Emmy Award winning actors, Golden Globe Award winning actors, American comedians, American movie actors, American stage actors, American television actors, American voice actors, American writers, Knights and Dames Commander of the Order of the British Empire
The Tracey Ullman Show	1987 American television series debuts, 1980s American television series, American comedy television series, Fox television series, The Simpsons, English-language television programs
Joaquín Sorolla	1863 births, 1923 deaths, Spanish painters, People from Valencia
Laienspiegel	1509, Law, Non-fiction books, History of Germany, Mainz
Berlin Blockade	1948, 1949 in Europe, 1940s in Berlin, Cold War
Francisco Herrera the Younger	1622 births, 1685 deaths, Spanish painters, Spanish architects
Francisco Herrera the Elder	1576 births, 1656 deaths, Spanish painters
Lancelet	Chordates
Regional internet registry	Internet
Anna Göldi	1734 births, 1782 deaths, People executed for witchcraft, Swiss people
Neue Zürcher Zeitung	Newspapers in Europe, Zürich
KOffice	KOffice
Senna (herb)	Shrubs, Fabaceae
Tropical Storm Gabrielle (2007)	Atlantic tropical storms, Hurricanes in the United States
Donkey vote	Voting systems
Mariano Fortuny (painter)	1838 births, 1874 deaths, Spanish painters, People from Catalonia
No Doubt	1986 establishments in the United States, 1980s American music groups, 1990s American music groups, 2000s American music groups, 2010s American music groups, American new wave bands, American pop music groups, American rock bands, Anaheim, California, Musical groups established in 1986, Musical groups from California, No Doubt, 1980s establishments in California, Musical groups disestablished in 2004, 2004 disestablishments in the United States, 2000s disestablishments in California, Musical groups established in 2009, 2009 establishments in California, Musical groups disestablished in 2015, 2015 disestablishments in the United States, 2010s disestablishments in California
Matchbox Twenty	American rock bands, Post-grunge bands, Musical groups from Orlando, Florida, Atlantic Records artists
Albany, Western Australia	Cities in Western Australia
Kalgoorlie	Cities in Western Australia, 1890s establishments in Australia
Joondalup, Western Australia	Suburbs of Perth, Western Australia
Mandurah, Western Australia	Cities in Western Australia
Bunbury, Western Australia	Cities in Western Australia
Rockingham, Western Australia	Suburbs of Perth, Western Australia
Esperance, Western Australia	Cities in Western Australia
Mandurah railway line, Perth	Australian railways
Transperth	Australian railways
Joondalup railway line, Perth	Australian railways
Armadale railway line, Perth	Australian railways
Silverchair	1990s Australian music groups, 2000s Australian music groups, 2010s Australian music groups, Australian rock bands, Grunge bands, Musical groups disestablished in 2011, Musical groups established in 1992, Musical groups from New South Wales, Post-grunge bands, 1992 establishments in Australia, 2010s disestablishments in Australia
Avet Terterian	1929 births, 1994 deaths, Armenian composers, 20th century composers, Armenian diaspora
Bob Denard	1929 births, 2007 deaths, Anti-Communists, Converts to Islam, Converts to Judaism, French military people, French prisoners, French Roman Catholics, Jewish military people, People from Bordeaux, Police officers
Eutheria	Mammals
Tito Beltrán	Tenors, Opera singers, 1965 births, Living people, Chilean singers
Cetartiodactyla	Mammals
Leonardo	Given names
Tetrapod	Tetrapods
Voivodeship	History of Ukraine, History of Poland
President of the Republic of Poland	Presidents of Poland
Tadeusz Kościuszko	1746 births, 1817 deaths, American generals, American revolutionaries, Generals, Naturalized citizens of the United States, Polish military people
Wes Archer	American animators, 1961 births, Living people
David Silverman	American movie directors, The Simpsons, American animators, American screenwriters, writers from New York City, 1957 births, Living people
Bill Kopp	American animators, American voice actors, 1962 births, Living people, People from Rockford, Illinois, Actors from Illinois
Klasky Csupo	American animation studios, Companies based in Los Angeles
Bergkamen	Unna Rural District
Renewable energy commercialisation in Australia	Renewable energy, Economy of Australia
Renewable energy commercialization in the United States	Energy in the United States, Renewable energy
Low kick	Martial art techniques
Spider-Man (movie)	2002 movies, 2000s superhero movies, English-language movies, Impact of the September 11 attacks, Movies composed by Danny Elfman, Movies directed by Sam Raimi, Spider-Man (2002 movie series), Spider-Man movies, Columbia Pictures movies
John Bunyan	1628 births, 1688 deaths, Baptists, Christian ministers, Christian religious leaders, Christian theologians, Christian writers, English Protestants, English theologians, English writers, Puritanism
Smith (metalwork)	Occupations
Allegory	Genres, Literary terms
Newport Pagnell	Towns in Buckinghamshire
Amniote	Tetrapods, Evolutionary biology
List of mayors of Hamburg	Mayors of Hamburg, Germany-related lists
Synapsid	Synapsids
The Pilgrim's Progress	1678 books, English novels, English-language novels
The Need for Speed	1994 video games, Need for Speed games, PlayStation games, Sports video games, Sega Saturn games
Louis de Broglie	1892 births, 1987 deaths, Dukes and duchesses of France, French academics, French Nobel Prize winners, French physicists, People from Normandy, Theoretical physicists
Las Galeras, Samaná	Settlements in Dominican Republic
Induno Olona	Cities in Lombardy
Swordfish	Edible fish, Perciformes
Carreño de Miranda	1614 births, 1685 deaths, Spanish painters
Late Old Japanese	Japanese language
Old Japanese	Japanese language
Tom and Jerry	Animated television series, Academy Award winners, Fictional animals, Cartoon Network series, Kids WB series, Spacetoon shows, Tom and Jerry, 1940s American television series, 1950s American television series, 1960s American television series, 1970s American television series, 1980s American television series, 1990s American television series, 2000s American television series, 2010s American television series, 2020s American television series, Comedy television series
Tynwald	Isle of Man, Parliaments, Devolved legislatures in the United Kingdom
Possum	Diprotodonts, Marsupials of Australia
1130	1130
Gotha	Verwaltungsgemeinschaftfrei towns in Thuringia, Gotha Rural District
Palm Island, Queensland	Islands of Australia, Indigenous Australian communities, Geography of Queensland
100 Greatest Britons	BBC, Lists of people
Igrejinha	Cities in Rio Grande do Sul, 1964 establishments in Brazil
Arroyo Barril, Samaná	Settlements in Dominican Republic, 2003 establishments, 21st-century establishments in the Dominican Republic
Intolerable Acts	1774, Law, 1770s in the United States, 1770s in the Kingdom of Great Britain
Mike Zambidis	Greek sportspeople, Martial artists, 1980 births, Living people
Indo-Greek Kingdom	Ancient Greece, History of Pakistan
Dassault Mirage 2000	French military aircraft, Dassault Aviation
Helensburgh, New South Wales	Towns in New South Wales
Hugo Award	Hugo Award
Schlenkerla	Beer, Buildings and structures in Bamberg, Taverns
Gabelmann	Buildings and structures in Bamberg, Statues
Bamberg Symphony Orchestra	German orchestras, Bamberg
Lübeck law	History of Germany
Alfonso Daniel Rodríguez Castelao	Spanish politicians, Spanish writers, Spanish Civil War, 1886 births, 1950 deaths, Galician people
Emilia Pardo Bazán	Spanish writers, 1851 births, 1921 deaths, People from A Coruña
Bamberg Cathedral	Buildings and structures in Bamberg, Cathedrals in Germany, Roman Catholic Cathedrals
Hypothalamus	Glands, Endocrine system
Square yard	Imperial units, Units of area
Ahmednagar	Cities in India, Settlements in Maharashtra, 1490 establishments, 15th century establishments in Asia
Steering wheel (ship)	Ship building
Grumman F-14 Tomcat	United States Navy aircraft, Iran, Grumman aircraft
General Dynamics F-16 Fighting Falcon	United States Air Force aircraft
M1 Garand	7.62 mm rifles, Rifles of the Cold War
Dark Horse Comics	Comic companies, 1986 establishments in the United States, 20th-century establishments in Oregon
Ernst Theodor Amadeus Hoffmann	1776 births, 1822 deaths, German painters, German writers, Music critics, People from former German territories, People from Kaliningrad
Hydrogen atom	Physics
Fuel cell	Energy
Königsberg	Kaliningrad
Live at Wembley (album)	2004 albums, Beyoncé albums, Dance pop albums, Hip hop albums, R&B albums
IPod classic	2001 establishments in the United States, 2014 disestablishments, IPod
Leo von Caprivi	1831 births, 1899 deaths, Admirals, Chancellors of Germany, German generals, German nobility, German Empire politicians, Politicians from Berlin, German Protestants, Prussian politicians
Columbia, Missouri	1821 establishments in Missouri, Cities in Missouri, County seats in Missouri
Santa Bárbara de Samaná	Settlements in Dominican Republic, 1756 establishments, 18th-century establishments in the Spanish Empire, 1750s establishments in North America
Amateur	Everyday life
Jogging	Fitness
Birdwatching	Birds, Hobbies
Albert, Prince Consort	1819 births, 1861 deaths, British Anglicans, British royalty, Deaths from typhoid fever, Disease-related deaths in England, Dukes and duchesses, German Lutherans, House of Wettin, Kings and Queens consort of the United Kingdom, Knights Companion of the Order of the Star of India, Naturalised citizens of the United Kingdom, People with foods named after them, Privy Councillors (UK)
East Berlin	Former polities of the Cold War, East Germany
Württemberg-Baden	Baden-Württemberg, Former states in Germany, 1950s disestablishments in Germany
Württemberg-Hohenzollern	Baden-Württemberg, Former states in Germany, 1945 establishments in Europe, 1950s disestablishments in Germany
Noraduz cemetery	Buildings and structures in Armenia, Cemeteries, Establishments in Armenia
Safavid dynasty	History of Iran, History of Azerbaijan, History of Islam, Azerbaijani dynasties, Royal dynasties, 1500s establishments, 18th century disestablishments in Asia, 16th century establishments in Asia, 1722 disestablishments
La Scala	Opera houses in Italy, Milan, 1778 establishments, 18th century establishments in Italy, 1770s establishments in Europe
Roger Guillemin	1924 births, Living people, American Nobel Prize winners, American physicians, French Nobel Prize winners, French physicians, Naturalized citizens of the United States, Neuroscientists, People from Dijon, Scientists from San Diego, California
Andrew Schally	1926 births, Living people, American Nobel Prize winners, American physicians, Jewish American academics, Jewish American scientists, Jewish Nobel Prize winners, Naturalized citizens of the United States, People from Vilnius, Polish Jews, Refugees from Nazism
Hyde Park, London	City of Westminster, Parks in the United Kingdom
Kensington Gardens	Parks in the United Kingdom, Buildings and structures in London
Delfzijl	Port cities and towns of the North Sea, Cities in the Netherlands, Settlements in Groningen (province), Former municipalities of Groningen (province), Eemsdelta
The Great Exhibition	1851, Buildings and structures in London
Peterborough	Settlements in Cambridgeshire, Cities in England, Unitary authorities, 1541 establishments, 16th century establishments in England, 1540s establishments in Europe
TSV Schwieberdingen	German football clubs, Sport in Baden-Württemberg
Las Terrenas, Samaná	Settlements in Dominican Republic, 1996 establishments in North America, 1990s establishments in the Dominican Republic
Schwieberdingen	Cities in Baden-Württemberg
Sánchez, Samaná	Settlements in Dominican Republic, 1866 establishments, 1860s establishments in the Dominican Republic
Parking	Traffic
Horsham	Towns in West Sussex
Lemgo	Lippe Rural District
Community of Madrid	Community of Madrid
Kit-Cat Klock	Clocks, Art Deco
St Michael's Church, Bamberg	Buildings and structures in Bamberg, Churches in Germany
Punta Arenas	Cities in Chile
Santiago Rusiñol	1861 births, 1931 deaths, Spanish painters, Spanish writers
Slaughterhouse	Agricultural buildings
Alfons Schuhbeck	1949 births, Living people, Chefs, German entertainers, German television personalities, People from Bavaria, Restaurateurs
Skatval	Settlements in Norway
Gefjun	Norse mythology
Stade de France	1998 establishments in Europe, 1990s establishments in France, Football stadiums in France, Île-de-France
Melbourne Cricket Ground	Cricket, Australian Football League, Sports buildings in Australia, Buildings and structures in Melbourne, 1853 establishments in Oceania, 1850s establishments in Australia
Tanning	Manufacturing
Romanesque architecture	Architectural styles
Bypass (road)	Roads
Rhine-Main-Danube Canal	Buildings and structures in Bavaria, Canals
B'Day Anthology Video Album	2007 albums, Beyoncé albums
Upgrade U	2006 songs, Beyoncé songs, Jay-Z songs
Beyoncé discography	Discographies, Beyoncé
The Beyoncé Experience	Beyoncé concert tours, 2007 in music
Beautiful Liar	2007 songs, Beyoncé songs, Shakira songs
DNA polymerase	DNA, Enzymes
Recep Tayyip Erdoğan	1954 births, Living people, Current national leaders, Mayors, Muslims, People from Istanbul, Presidents of Turkey, Prime Ministers of Turkey
Abu Talib	539 births, 619 deaths, Muslims
Doom 2	Shooter video games, 1994 video games, Doom series, DOS games, Video game sequels
Deathmatch	Video game gameplay
Samaná Bay	Bodies of water of North America, Geography of the Dominican Republic, Bays
Halibut	Flatfish, Edible fish
Sola (manga)	Anime
Ornithischia	Ornithischia
Miss Earth	Beauty pageants
Krauchthal	Municipalities of Bern
Dangerously in Love	2003 albums, Beyoncé albums, Hip hop soul albums, Neo soul albums, R&B albums
Until the End of Time	Beyoncé songs, 2007 songs
Inquisition	Christianity of the Middle Ages, Catholicism, Courts (law)
Lahore	Lahore, Cities in Pakistan, Capital of Pakistan
Punjab (Pakistan)	Punjab (Pakistan), 1972 establishments in Asia, 1970s establishments in Pakistan, Provinces of Pakistan
Peshawar	Peshawar
B'Day	Beyoncé albums, 2006 albums, Hip hop albums, Funk albums, R&B albums, 2006 in music, Pop albums
Aldeburgh Festival	Classical music festivals, Music festivals in England, Suffolk, 1948 establishments in Europe, 1940s establishments in England
Peter Pears	1910 births, 1986 deaths, Commanders of the Order of the British Empire, English LGBT people, English singers, Gay men, Knights Bachelor, LGBT musicians, Musicians from Surrey, English opera singers, Tenors
Me, Myself and I	2003 songs, Beyoncé songs, Songs about infidelity, Hip hop soul songs, R&B songs
Sexy Little Thug	2003 songs, Beyoncé songs
Encore (concert)	Performing arts
Cay	Islands
Sarcopterygii	Lobe-finned fish
Actinopterygii	Ray-finned fish
Extended play	Albums
Richard von Weizsäcker	1920 births, 2015 deaths, Former members of the German Bundestag, German lawyers, German Lutherans, German writers, Order of Merit of the Federal Republic of Germany, People from Stuttgart, Politicians from Baden-Württemberg, Politicians of the Christian Democratic Union of Germany, Presidents of Germany
Millennium Stadium	Football stadiums in the United Kingdom, Buildings and structures in Wales, Sport in Wales, Football in Wales, Cardiff
National Collegiate Athletic Association	National Collegiate Athletic Association, 1906 establishments in the United States, 20th-century establishments in Indiana
Happy Mondays	Musical groups established in 1980, 1980 establishments in England, Musical groups disestablished in 1993, 1993 disestablishments in England, Musical groups established in 1999, 1999 establishments in England, Musical groups disestablished in 2000, 2000 disestablishments in Europe, 2000s disestablishments in England, Musical groups established in 2004, 2004 establishments in England, Musical groups disestablished in 2010, 2010 disestablishments in Europe, 2010s disestablishments in Europe, Musical groups established in 2012, 2012 establishments in Europe, 2010s establishments in England, Musical groups disestablished in 2012, 2012 disestablishments in Europe, 21st century disestablishments in England, 1980s British music groups, 1990s British music groups, 2000s British music groups, 2010s British music groups, English rock bands, Musical groups from Greater Manchester
Adidas	1920s establishments in Germany, 1924 establishments in Europe, Companies of Germany, Clothing companies, Companies listed on the DAX, Bavaria
Joy Division	1976 establishments in the United Kingdom, 1970s British music groups, 1980s British music groups, 1980s disestablishments in the United Kingdom, English punk bands, Musical groups disestablished in 1980, Musical groups established in 1976, Musical groups from Greater Manchester
New Order	Musical groups established in 1980, 1980 establishments in England, Musical groups disestablished in 1993, 1993 disestablishments in England, Musical groups established in 1998, 1998 establishments in England, Musical groups disestablished in 2007, 2007 disestablishments in the United Kingdom, 2000s disestablishments in England, Musical groups established in 2011, 2011 establishments in England, 1980s British music groups, 1990s British music groups, 2000s British music groups, 2010s British music groups, Brit Award winners, English rock bands, Musical groups from Greater Manchester
Peter Hook	1956 births, Living people, English guitarists
Bernard Sumner	1956 births, Living people, English singers
Chorlton-on-Medlock	Districts of Manchester
Ultimate Fighting Championship	Mixed martial arts organizations, Ultimate Fighting Championship
Chorlton-cum-Hardy	Districts of Manchester
Acropolis	Fortification
Wokingham	Towns in Berkshire
California wildfires of October 2007	2007 in California, 2000s disasters in North America, Natural disasters in the United States, Fires in the United States
Parasaurolophus	Hadrosauridae
Thai boxing	Martial arts
Carrefour	Companies of France, 1957 establishments in France
Never Say Never	1998 albums, Brandy albums
Soviet occupation zone	East Germany, 1940s establishments in the Soviet Union, 1945 establishments in Germany, 1949 disestablishments, 1940s disestablishments in Germany
Iron Man (song)	1970 songs
Death in Venice (opera)	Compositions by Benjamin Britten, 1970s operas, 1973
Territory of the Saar Basin	States and territories established in the 20th century, 1920 establishments in Europe, 1920s establishments in Germany, League of Nations mandates, Saarland, States and territories disestablished in the 20th century, 1930s disestablishments in Germany, 1935 disestablishments in Europe
William Walton	1902 births, 1983 deaths, 20th century composers, English composers, Order of Merit, People from Oldham, Greater Manchester, Knights Bachelor
List of Romanian composers	Lists of people, Romanian composers
Free City of Danzig	1930s disestablishments in Germany, 1920 establishments in Europe, 1920s establishments in Germany, Former city-states, Gdańsk, League of Nations mandates, States and territories disestablished in the 20th century, States and territories established in the 20th century
Surf's Up (movie)	2007 animated movies, American animated movies, Movies about animals, English-language movies, Movies directed by Chris Buck
Baby Boy	Beyoncé songs, 2003 songs
List of heads of state of the Free City of Danzig	League of Nations, Lists of heads of state
Main-Franconian dialects	German dialects, Languages of Germany
Port Arthur, Texas	Cities in Texas
Moisture	Water
Marta Colvin	Chilean sculptors, People from Bío Bío Region, 1907 births, 1995 deaths
Bárbara of Portugal	House of Braganza, 1711 births, 1758 deaths, People from Lisbon, Princes and Princesses of Asturias, Spanish House of Bourbon, Kings and Queens consort of Spain
List of Arizona hurricanes	Arizona-related lists, Weather lists, Hurricanes in the United States
Mallard	Ducks
Naughty Girl	Beyoncé songs, 2004 songs
Yankee Stadium (1923)	Former Major League Baseball venues, Former National Football League venues, Sports buildings in New York City, New York Yankees, The Bronx, 1923 establishments in the United States, 1920s establishments in New York (state), 2009 disestablishments in the United States, 2000s disestablishments in New York (state)
British occupation zone	West Germany, 1945 establishments in Germany, 1940s establishments in the United Kingdom, 1949 disestablishments, 1940s disestablishments in Germany, 1940s disestablishments in the United Kingdom
Greater Hesse	Hesse, 1945 establishments in Germany, 1946 disestablishments in Europe, World War II, Former states in Germany, 1940s disestablishments in Germany
Mioriţa	Songs, Romania
Muzio Clementi	1752 births, 1832 deaths, Disease-related deaths in England, Italian composers, Musicians from Rome
Chromatography	Laboratory techniques, Analytical chemistry
IPhone	Messaging, IPhone
Concert hall	Concert halls
Madrigal	Musical forms
Saxe-Coburg-Saalfeld	House of Wettin, States of the Confederation of the Rhine, States of the German Confederation, States of the Holy Roman Empire, Thuringia
Sonora	Sonora, States of Mexico
Monsoon	Severe weather, Winds
Baja California (state)	Baja California (state), States of Mexico
Verizon Ladies First Tour	2004 in the United States, Alicia Keys, Beyoncé concert tours
Dangerously in Love World Tour	Beyoncé concert tours, 2003 in Europe, 2000s in Manchester, 21st century in London, History of Dublin, History of Amsterdam, November events
Déjà Vu (song)	Beyoncé songs, Jay-Z songs, 2006 songs
If (Beyoncé song)	2007 songs, 2000s ballads, R&B songs, Beyoncé songs
Number 1's	Destiny's Child albums, Beyoncé albums, 2005 albums, Compilation albums
Ciara	Ciara, 1985 births, Living people, Actors from Austin, Texas, African American actors, African-American singers, American dancers, American movie actors, American record producers, Grammy Award winners, Singer-songwriters from Texas
Mykolaiv	Cities in Ukraine, 1789 establishments, Establishments in Ukraine, 1780s establishments in Europe
Akkad	Mesopotamia, Empires
Faisal Mosque	Buildings and structures in Islamabad, Mosques in Asia, National symbols of Pakistan, Religion in Pakistan, 1986 establishments in Asia, 20th century establishments in Pakistan
Song cycle	Song forms
Quetta	Capital cities in Pakistan, Cities in Pakistan, Quetta
Gilgit	Hill Stations in Pakistan, Capital cities in Pakistan
Frottola	Song forms
Bartolomeo Tromboncino	1470s births, 16th century deaths, Italian composers, Renaissance composers, People from Verona
De jure	Latin phrases, Legal terms
Boy George	1961 births, Living people, British autobiographers, British people convicted of assault, English LGBT people, Gay men, LGBT singers, Musicians from Kent, New wave musicians, Singers from London
Bon Jovi	American hard rock bands, Glam metal bands, Musical groups from New Jersey, Musical groups established in 1983, 1983 establishments in the United States, 1980s establishments in New Jersey
Anastasia (1956 movie)	1956 drama movies, American drama movies, Movies set in Russia, 20th Century Fox movies, Multilingual movies, Movies directed by Anatole Litvak
Valdivia	Cities in Chile
Sir Seewoosagur Ramgoolam International Airport	Mauritius, Airports in Africa
Pervez Musharraf	1943 births, Living people, Generals, Pakistani military people, People from Delhi, Pakistani Muslims, Presidents of Pakistan
Bas-relief	Sculpture
Dogfights	2006 television series debuts, English-language television programs
Dogfight	Aircraft, Military aviation
M1911 pistol	Pistols
Artaxiad dynasty of Iberia	History of Georgia (country), Royal dynasties
Stocking	Clothing
Robe	Clothing
Geri Halliwell	1972 births, Living people, English pop singers, Musicians from Hertfordshire, People from Watford, Spice Girls
The Crucible	Plays, Salem Witch Trials, 1950s works
Rush Limbaugh	1951 births, 2021 deaths, Actors from Missouri, American conservatives, American journalists, American political activists, American political writers, American radio personalities, American voice actors, Cancer deaths in Florida, Deaths from lung cancer, Writers from Missouri, Deaf people
Second Life	Online games, 2003 establishments
Ford Falcon	1960s automobiles, 1970s automobiles, 1980s automobiles, 1990s automobiles, 2000s automobiles, 2010s automobiles, Ford automobiles
Hoboken	Antwerp
Bottlenose dolphin	Oceanic dolphins
Franz Josef Strauß	1915 births, 1988 deaths, Cardiovascular disease deaths in Germany, Deaths from heart failure, Former members of the German Bundestag, German military personnel of World War II, Government ministers of Germany, Ministers-President of Bavaria, Order of Merit of the Federal Republic of Germany, People from Munich, Politicians from Bavaria, Politicians of the Christian Social Union of Bavaria
President of the German Bundesrat	Presidents of the German Bundesrat
German TV	German television networks
List of presidents of the German Bundesrat	Presidents of the German Bundesrat, Politics of Germany, Germany-related lists, Lists of legislative speakers
Maximilien de Robespierre	1758 births, 1794 deaths, French politicians, People of the French Revolution
Declaration of the Rights of Man and of the Citizen	French Revolution, 1789 works
The Simpsons Halloween episodes	The Simpsons, Treehouse of Horror
Bonerath	Municipalities in Rhineland-Palatinate, Trier-Saarburg
Gusterath	Municipalities in Rhineland-Palatinate, Trier-Saarburg
Gutweiler	Municipalities in Rhineland-Palatinate, Trier-Saarburg
Hinzenburg	Municipalities in Rhineland-Palatinate, Trier-Saarburg
Holzerath	Municipalities in Rhineland-Palatinate, Trier-Saarburg
Kasel	Municipalities in Rhineland-Palatinate, Trier-Saarburg
Korlingen	Municipalities in Rhineland-Palatinate, Trier-Saarburg
Mertesdorf	Municipalities in Rhineland-Palatinate, Trier-Saarburg
Morscheid	Municipalities in Rhineland-Palatinate, Trier-Saarburg
Ollmuth	Municipalities in Rhineland-Palatinate, Trier-Saarburg
Pluwig	Municipalities in Rhineland-Palatinate, Trier-Saarburg
Riveris	Municipalities in Rhineland-Palatinate, Trier-Saarburg
Sommerau	Municipalities in Rhineland-Palatinate, Trier-Saarburg
Waldrach	Municipalities in Rhineland-Palatinate, Trier-Saarburg
Perfect Stranger (movie)	2006 movies, English-language movies
American bison	Bovines, Symbols of the United States, Symbols of Oklahoma, Symbols of Kansas, Mammals of North America
Jiroft civilization	History of Iran
Tigranakert	Settlements in Armenia, 1st-century BC establishments, Establishments in Armenia
Combat sport	Martial arts
Ground fighting	Martial art techniques
Anderson Silva	Brazilian sportspeople, Mixed martial artists, 1975 births, Living people
Karo Parisyan	1982 births, Living people, Armenian sportspeople, American mixed martial artists
Diego Sanchez	American mixed martial artists, Sportspeople from Albuquerque, New Mexico, 1981 births, Living people
Elías Piña Province	Provinces of the Dominican Republic, 1942 establishments in North America, 1940s establishments in the Dominican Republic
Mila Kunis	1983 births, Living people, Actors from Los Angeles, California, American movie actors, American television actors, American voice actors, Jewish American actors, Jewish models, Models from Los Angeles, California, Naturalized citizens of the United States, Soviet Jews, Ukrainian Jews
Crazy in Love	Beyoncé songs, Jay-Z songs, 2003 songs, Debut singles, Funk songs, Hip hop songs, R&B songs
Check on It	Destiny's Child songs, Beyoncé songs, 2005 songs
Irreplaceable	2006 songs, Beyoncé songs, Songs about infidelity, Songs with feminist themes
Amor Gitano	Beyoncé songs, 2007 songs
Work It Out	Beyoncé songs, 2002 songs
Get Me Bodied	Beyoncé songs, 2007 songs
Beyoncé	Beyoncé, 1981 births, Living people, Actors from Houston, Texas, American feminists, Singer-songwriters from Texas, African American musicians, Brit Award winners, Grammy Award winners, Singers from Houston, Texas, Destiny's Child, American voice actors, American R&B singers
Listen (song)	Beyoncé songs, 2007 songs
Lose My Breath	Destiny's Child songs, 2004 songs
Destiny's Child discography	Discographies, Destiny's Child
1983 Pacific hurricane season	Pacific hurricane seasons, 1983
1972 Pacific hurricane season	Pacific hurricane seasons, 1972 in North America
1970 Pacific hurricane season	Pacific hurricane seasons, 1970 in North America
1977 Pacific hurricane season	Pacific hurricane seasons, 1977
2003 Pacific hurricane season	Pacific hurricane seasons, 2003 in weather
1989 Pacific hurricane season	Pacific hurricane seasons, 1989
1995 Pacific hurricane season	1995 Pacific hurricane season, Natural disasters in North America, Pacific hurricane seasons
1992 Pacific hurricane season	Pacific hurricane seasons, 1992
Santa Cruz River	Rivers of Mexico, Rivers of Arizona, Sonora
Artibonite River	Rivers of the Dominican Republic, Geography of Haiti
Jens Pulver	American mixed martial artists, 1974 births, Living people
Video CD	Compact Disc, Video Discs
Boston Red Sox	Boston Red Sox, 1901 establishments in the United States, 1900s establishments in Massachusetts
Irreemplazable	Beyoncé albums, 2007 albums, Latin pop albums, Hip hop albums, R&B albums
Ring the Alarm	Beyoncé songs, 2006 songs
'03 Bonnie & Clyde	2002 songs, Beyoncé songs, Jay-Z songs, Rap songs
One Night Only	Beyoncé songs, 2006 songs
Dangerously in Love 2	Beyoncé songs, 2003 songs
Green Light	Beyoncé songs, 2007 songs
Suga Mama	2007 songs, Beyoncé songs, Funk songs, R&B songs
I Got That	Beyoncé songs, 2000 songs
Jumpin' Jumpin'	Destiny's Child songs, 2000 songs
Beyoncé The Ultimate Performer	Beyoncé albums
Fighting Temptation	Beyoncé songs, 2003 songs
Slaithwaite	Villages in West Yorkshire
Bundesverfassungsgericht	Karlsruhe
Kaaba	Buildings and structures in Saudi Arabia, Mecca, Mosques, Religion in Saudi Arabia
Five Pillars of Islam	Islam, Religious ethics
EUX.TV	Television stations
Awadhi language	Indo-Aryan languages, Languages of India
Westdeutscher Rundfunk	German broadcasting companies, Cologne
ARD (broadcaster)	German broadcasting companies, 1950 establishments in Europe, 1950s establishments in Germany
Deutsche Welle	German television networks, 1953 establishments in Europe, 1950s establishments in Germany
Guildford Dudley	1536 births, 1554 deaths, English people
Medical papyri	Manuscripts, Ancient Egypt
Tibetan Book of the Dead	Afterlife, Tibet, Buddhist texts
ChalkZone	Animated television series, Nickelodeon television series, 2002 American television series debuts, 2004 American television series endings, English-language television programs
Lockheed Martin F-22 Raptor	United States Air Force aircraft, Lockheed & Lockheed-Martin aircraft
Edom	Ancient history
Hollywood (song)	Jay-Z songs, Beyoncé songs, 2007 songs
Summertime (song)	Beyoncé songs, 2003 songs, Hip hop songs, Hip hop soul songs, R&B songs
Fabaceae	Fabaceae
List of political parties in Germany	Germany-related lists, Lists of political parties, Political parties in Germany
Federal Convention (Germany)	German Bundestag, Government of Germany, President of Germany
Friedrich Ebert	1871 births, 1925 deaths, Chancellors of the Weimar Republic, German people of World War I, Members of the Reichstag (German Empire), Members of the Reichstag (Weimar Republic), People from Heidelberg, Politicians from Baden-Württemberg, Politicians of the Social Democratic Party of Germany, Presidents of the Weimar Republic, Presidents of Germany, Chancellors of Germany, Prussian politicians
Walter Simons	1861 births, 1937 deaths, Chief justices, German academics, German judges, Government ministers of the Weimar Republic, Politicians from North Rhine-Westphalia, Presidents of the Weimar Republic
Full Moon (album)	2002 albums, Brandy albums
U Don't Know Me (Like U Used To)	1999 albums, Brandy albums
The Boy Is Mine	1998 songs, Brandy songs
ETA (separatist group)	1959 establishments in Europe, Crime in France, Crime in Spain, National liberation movements, Nationalist organizations in Europe, Politics of Spain, Rebel militia groups, Terrorism
Petr Eben	1929 births, 2007 deaths, Czech composers, Organists, 20th century composers
Totalitarianism	Forms of government
Gothic metal	Gothic metal
Paul von Hindenburg	1847 births, 1934 deaths, Cancer deaths in Germany, German generals, German military personnel of World War I, People from former German territories, People from Poznań, Presidents of Nazi Germany, Presidents of the Weimar Republic
Sharon Osbourne	British autobiographers, Cancer survivors, Television personalities from London, 1952 births, Living people
Cy Young	1867 births, 1955 deaths, Boston Red Sox players, St. Louis Cardinals players, American baseball players, National Baseball Hall of Fame members, Sportspeople from Ohio
Arabic alphabet	Alphabets, Arabic language
Brandenburg Gate	Buildings and structures in Berlin, Monuments and memorials in Germany, Landmarks in Germany, Berlin Wall, Gates, 1790s establishments in Europe, 18th century establishments in Germany
Languages of the Caucasus	Caucasian languages
Lake Urmia	Geography of Iran, Lakes of Asia, Biosphere reserves
Giuseppe Piazzi	Italian astronomers, 1746 births, 1826 deaths
Vesta (mythology)	Roman gods and goddesses
Heinrich Wilhelm Olbers	1758 births, 1840 deaths, German astronomers, German physicists
Minstrel	Medieval composers
Gnathostomata	Fish
Niger River	Rivers of Africa, Guinea, Mali, Geography of Niger, Geography of Benin, Rivers of Nigeria
Flag of Mali	National flags, Mali
Coat of arms of Mali	Mali, National coats of arms
Pour l'Afrique et pour toi, Mali	National anthems, Mali
List of heads of state of Mali	Lists of heads of state, Heads of state, Presidents of Mali, History of Mali
List of prime ministers of Mali	Prime Ministers of Mali, History of Mali, Heads of government
French Sudan	History of Mali
Cunnilingus	Sexual acts
Agnatha	Agnatha
Henry Cavendish	1731 births, 1810 deaths, English physicists, English chemists
Ornamentation (music)	Musical notation, Musical performance techniques
Endocrine system	Endocrine system, Hormones, Glands
Sponge (tool)	Cleaning tools
Tyne and Wear	1974 establishments in England, Tyne and Wear, Ceremonial counties of England
Osteichthyes	Bony fish
Aquarium (group)	Russian musical groups, Rock bands, Reggae bands, Musical groups established in 1972, 20th century establishments in the Soviet Union
Chondrichthyes	Cartilaginous fish
Alexey Ekimyan	1927 births, 1982 deaths, Armenian composers, Soviet people, People from Baku
Mikael Tariverdiev	Armenian composers, 1931 births, 1996 deaths, People from Tbilisi
Bergen	Bergen, Port cities and towns of the North Sea
1456	1456
Winchester	County towns in England, Settlements in Hampshire, Winchester
Axial tilt	Celestial mechanics
Dollhouse (TV series)	American drama television series, American science fiction television series, Whedonverse, Fox television series, Television series created by Joss Whedon, English-language television programs
Hydrostatic equilibrium	Astrophysics
Right ascension	Astronomy
Declination	Astronomy
Retrograde and direct motion	Astrology, Orbits
Planetesimal	Minor planets, Planets
Achondrite	Meteorites
Basalt	Minerals, Igneous rocks
Aswan	Cities in Egypt
Carl Barks	1901 births, 2000 deaths, Deaths from leukemia, People from Grants Pass, Oregon, American animators, Disney animators, Writers from Oregon, American comics artists
Jay-Z	1969 births, Living people, African American musicians, Grammy Award winners, Businesspeople from New York City, American rap musicians from New York, Singers from New York City, Jay Z
Ripon	Settlements in North Yorkshire, Cities in England
What's It Gonna Be	Beyoncé songs, 2003 songs
Senegal River	Senegal, Mauritania, Rivers of Africa
Diprotodont	Diprotodonts, Marsupials of Australia
Live in Atlanta	Destiny's Child albums, Atlanta, Georgia
Bambara language	Niger-Congo languages, Mali
Proboscidea	Elephants
Adrar des Ifoghas	Mali
Kokoreç	Meat dishes
Ub Iwerks	1901 births, 1971 deaths, Disney animators
Endocrine gland	Endocrine system, Glands
Thyroid	Glands, Endocrine system
Never Mind the Bollocks, Here's the Sex Pistols	1977 albums, Sex Pistols, Punk albums
Johann Christian Bach	1735 births, 1782 deaths, Bach family, Classical era composers, German composers, People from Leipzig
Pelycosaur	Pelycosaurs, Fossils
Therapsid	Synapsids, Therapsids
Toccata	Musical forms
Taylor Swift	1989 births, American country singers, American feminists, American pop singers, American singer-songwriters, Living people, Singers from Pennsylvania, Taylor Swift
Internal medicine	Medical specialties
City status in the United Kingdom	Local government in the United Kingdom, Lists of cities in Europe, United Kingdom-related lists, Cities in the United Kingdom, Lists of cities by country
Lockheed P-38 Lightning	United States Army aircraft, Lockheed & Lockheed-Martin aircraft, World War II American aircraft
Messerschmitt Bf 109	World War II German aircraft
Messerschmitt Me 262	World War II German aircraft
Osmosis	Cell biology, Thermodynamics
Mikoyan-Gurevich MiG-17	Soviet military aircraft, Military of China, Vietnamese military aircraft, Polish military aircraft, Vietnam War aircraft
Mikoyan	Companies of Russia, Aircraft companies, 1939 establishments, 1930s establishments in Europe, Transport in Russia
Neptune (mythology)	Roman gods and goddesses
Sol Invictus	Roman gods and goddesses
Optical printer	Printers
Lares	Roman gods and goddesses
Charter Trustees	Local government in the United Kingdom
Quirinus	Roman gods and goddesses
Kreisfreie stadt	Political systems, Politics of Germany
Jet aircraft	Aircraft
Egypt–Israel Peace Treaty	1979, 20th century in Egypt, 1970s in Israel, 1970s treaties
Downtown	Cities
IEEE 802.11	Computer protocols, Computer networking
Wireless LAN	Computer networking
Bluetooth	Computer protocols, Computer networking
Noraduz	History of Armenia
1921 New York Yankees season	1921 in the United States, New York Yankees, Sports in New York City, 1920s in New York (state), 20th century in New York City
Hominidae	Hominids
Acropolis of Athens	Buildings and structures in Athens, Ancient Athens
Toki Pona	Constructed languages
Canadian Hurricane Centre	Canada
V-type asteroid	Asteroids
Vulcan (Star Trek)	Fictional races, Star Trek
Keck Observatory	Observatories in the United States, Buildings and structures in Hawaii
HED meteorite	Meteorites
Metamorphic rock	Rocks
Extrusion	Geology
Intrusion	Geology, Igneous rocks
Radiation pressure	electromagnetism
Kirkwood gap	Asteroids, Jupiter
Ca-Al-rich inclusions	Meteorites
Eucrite	Meteorites
81P/Wild	Comets
Barrel (weapons)	Firearm components
Shell (projectile)	Artillery
Ion thruster	Ion propulsion, Rockets
Pistol	Pistols
Submachine gun	Submachine guns
Elena V. Pitjeva	Russian astronomers, Living people, Year of birth missing (living people)
Socialist Reich Party	Former political parties in Germany, Neo-Nazism, West Germany, 1949 establishments in Germany, 1950s disestablishments in Germany
International Fight League	Mixed martial arts, 2006 establishments in the United States, 2008 disestablishments in the United States
Anton Chekhov	1860 births, 1904 deaths, Deaths from tuberculosis, Disease-related deaths in Germany, Russian writers
Labour and Social Justice – The Electoral Alternative	2005 establishments in Europe, 2007 disestablishments in Europe, Former political parties in Germany, The Left (Germany), 2000s establishments in Germany, 2000s disestablishments in Germany
Deutsche Reichspartei	Former political parties in Germany, Neo-Nazism, West Germany, 1964 disestablishments
Fukuoka Prefecture	Fukuoka Prefecture, Prefectures of Japan
Evening Prayer (Anglican)	Anglicanism, Christian music
Regierender Bürgermeister	Government of Germany, Mayors of Berlin
Alice in Chains	1980s American music groups, 1990s American music groups, 2000s American music groups, 2010s American music groups, American heavy metal bands, Grunge bands, American hard rock bands, Alternative metal bands, Musical groups from Seattle, Washington, Musical groups established in 1987, 1987 establishments in the United States, 1980s establishments in Washington (state), Musical groups disestablished in 2002, 2002 disestablishments in the United States, 2006 establishments in the United States, Musical groups established in 2006, 2000s establishments in Washington (state), 2000s disestablishments in Washington (state)
Lutz Graf Schwerin von Krosigk	1887 births, 1977 deaths, Chancellors of Nazi Germany, German military personnel of World War I, Government ministers of Nazi Germany, Government ministers of the Weimar Republic, Politicians from Saxony, Politicians of the Nazi Party, Rhodes scholars
Cockney Rejects	English punk bands
East End of London	Areas of London
Suidae	Pigs
Trdat of Iberia	History of Georgia (country)
The Nutcracker	Compositions by Pyotr Ilyich Tchaikovsky, Ballets by Marius Petipa, Ballets by Lev Ivanov, Ballets first performed by the St. Petersburg Imperial Ballet
Kingdom of Sophene	History of Armenia, 3rd-century BC establishments, 1st-century BC disestablishments, Establishments in Armenia
Lady Katherine Grey	1539 births, 1568 deaths, English nobility
Elongation	Celestial mechanics
Conjunction (astronomy and astrology)	Astrology, Astronomical phenomena
Opposition (astronomy and astrology)	Astrology, Astronomical phenomena
Ophiuchus	Constellations, Constellations listed by Ptolemy
George Boleyn	1500s births, 1536 deaths, People from Norfolk
Tsitsernakaberd	Armenian Genocide, Monuments and memorials
Mary Boleyn	1499 births, 1543 deaths, People from Kent
Cubic centimetre	Units of volume
Geometric albedo	Astrophysics
Welcome to the Black Parade	2006 songs, My Chemical Romance
Remembrance Day	Holidays, Australia, Canada, Anniversary days in the United Kingdom
Division (botany)	Plant taxonomy
Leona Lewis	Leona Lewis, 1985 births, Black British musicians, British R&B musicians, English pop singers, Singer-songwriters from London, The X Factor winners
Trinny Woodall	1965 births, Living people, English television presenters, English journalists
Susannah Constantine	1962 births, Living people, English television presenters
Anna Wintour	1949 births, Living people, Journalists from London
Kingdom of Saxony	1800s establishments in Germany, 1918 disestablishments in Germany, Former states in Germany, Saxony, 1806 establishments in Europe
Saxe-Meiningen	States of the Confederation of the Rhine, States of the German Confederation, States of the German Empire, States of the Holy Roman Empire, States of the North German Confederation, States of the Weimar Republic, Thuringia, 1675 establishments, 1670s establishments in Europe, 17th century establishments in Germany, 1920 disestablishments in Europe, 20th century disestablishments in Germany
Eilenburg	Nordsachsen Rural District
The Misfits	1970s American music groups, 1980s American music groups, 1990s American music groups, 2000s American music groups, 2010s American music groups, American punk bands, American heavy metal bands, American hard rock bands, Musical groups from New Jersey, Musical groups established in 1977, Musical groups disestablished in 1983, Musical groups established in 1995, 1977 establishments in the United States, 1970s establishments in New Jersey, 1983 disestablishments in the United States, 1980s disestablishments in New Jersey, 1995 establishments in the United States, 1990s establishments in New Jersey
Vistula	Rivers of Poland
Sunnah	Islam, Arabic words and phrases, Religious terminology
Al-Aqsa Mosque	Buildings and structures in Jerusalem, Mosques, Religion in Israel
Balkh Province	Provinces of Afghanistan
Dwight Hicks	Indianapolis Colts players, San Francisco 49ers players, American movie actors, Actors from New Jersey, Sportspeople from New Jersey, American television actors, 1956 births, Living people
Surface gravity	Astrophysics
Rotation period	Celestial mechanics
Angular size	Measurement
Albedo	Optics
Robin Olds	1922 births, 2007 deaths, American military people, Military people from Hawaii, American aviators
Lady Mary Grey	1545 births, 1578 deaths, House of Tudor, English nobility
German-speaking Community of Belgium	Regions of Belgium, Wallonia
County Durham	County Durham, Ceremonial counties of England
Balkan Mountains	Balkan Mountains
Carpathian Mountains	Mountain ranges of the Carpathians, Carpathians
Squamata	Scaled reptiles
Pingu	Animated characters, 1990 television series debuts, 1990s television series, 2000s television series, 2006 television series endings, Fictional birds, Swiss culture
Tatra mountains	Mountain ranges of the Carpathians, Geography of Poland, Geography of Slovakia
Frank G. Wells	1932 births, 1994 deaths, Aviation deaths, Businesspeople from California, Disney people
Bodhi Tree	Trees, Buddhism, Moraceae
Bob Hope	Academy Award Honorary Award winners, Actors from California, Actors from Cleveland, Ohio, American centenarians, American comedians, American movie actors, American television actors, Comedians from London, Comedians from Ohio, Deaths from pneumonia, Infectious disease deaths in the United States, Kennedy Center honorees, Naturalized citizens of the United States, Congressional Gold Medal recipients, Screen Actors Guild Award winners, 1903 births, 2003 deaths, Honorary Knights Commander of the Order of the British Empire
Dawn French	English comedians, English movie actors, English stage actors, English television actors, 1957 births, Living people
Port-au-Prince	1749 establishments, Port-au-Prince, Establishments in the French colonial empire, 1740s establishments in North America
Mikoyan-Gurevich MiG-25	Soviet military aircraft, Indian military aircraft
Semi-major and semi-minor axes	Orbits
Apsis	Orbits
Orbital eccentricity	Orbits
Astronomical unit	Astronomical distances
Degree (angle)	Angles
Epoch (astronomy)	Celestial mechanics
Julian day	Days
Meatball	Meat dishes
Mandé people	Ethnic groups in Africa, History of Mali
Amadou Toumani Touré	Presidents of Mali, 1948 births, 2020 deaths
Ghana Empire	History of Mali, 750 establishments, 1076 disestablishments, 8th-century establishments in Africa, Disestablishments in Africa
Mali Empire	History of Mali, Former countries in Africa, 1235 establishments, 1645 disestablishments, 1230s establishments in Africa, Disestablishments in Africa
Timbuktu	Cities in Mali
Jeanne Demessieux	1921 births, 1968 deaths, 20th century composers, Disease-related deaths in France, French composers, French musicians, French organists, People from Montpellier, Women composers
House mouse	Old World rats and mice, Model organisms
Scientology	Scientology
Mike Gravel	1930 births, 2021 deaths, Deaths from multiple myeloma, People from Springfield, Massachusetts, 2020 United States presidential candidates, 2008 United States presidential candidates, United States senators from Alaska, Politicians from Massachusetts, US Democratic Party politicians, Legislative speakers, US Libertarian Party politicians, Cancer deaths in California, American political activists, American political commentators, American political writers, Writers from Massachusetts, Writers from Alaska, Businesspeople from Massachusetts, Businesspeople from Alaska, People from Anchorage, Alaska
Iva Zanicchi	1940 births, Living people, Former MEPs, Italian singers, MEPs for Italy, Musicians from Emilia-Romagna, Politicians from Emilia-Romagna, Pop singers
North German Confederation	19th century in Germany, Former German countries, Postage stamps, 1866 establishments in Europe, 1860s establishments in Germany, 1870 disestablishments, 1870s disestablishments in Europe, 19th century disestablishments in Germany
MiG Alley	Korean War, United States Air Force, Military aviation
NetBackup	Software
Argument of periapsis	Orbits
Longitude of the ascending node	Orbits
Mean anomaly	Orbits
Orbital period	Orbits
Orbital speed	Orbits
101	101
Continental drift	Plate tectonics
Saxe-Altenburg	Ernestine duchies, States of the German Confederation, States of the German Empire, States of the Holy Roman Empire, States of the North German Confederation, States of the Weimar Republic, Thuringia
Porcupine	Rodents
The Silvia Night Show	2007 television series debuts
Jakten på Billie Jo	2000 television series debuts, Reality television series
Ernestine duchies	Thuringia, Ernestine duchies
Sri Maha Bodhi	Buddhism, World Heritage Sites
List of children of the Presidents of the United States	Children of Presidents of the United States, Lists of American people
Dolores Hope	American centenarians, American musicians, Singers from New York City, 1909 births, 2011 deaths
Miranda (state)	States of Venezuela
Miranda (novel)	1924 books, Novels
Capybara	Rodents, Mammals of South America
Martha Jefferson	1748 births, 1782 deaths, Thomas Jefferson, People from Virginia
Great Awakening	History of the United States
Lycopene	Chemicals
Housefly	Flies
Chemical engineering	Chemistry, Engineering
House of Windsor	House of Windsor
Jocelyne Saab	1948 births, 2019 deaths, Deaths from endometrial cancer, Cancer deaths in France, Journalists, Movie directors, People from Beirut
Ulva	Argyll and Bute, Inner and Outer Hebrides
Sugar Ray Robinson	1921 births, 1989 deaths, African-American boxers, Deaths from Alzheimer's disease, Deaths from diabetes, Disease-related deaths in the United States, Sportspeople from Georgia (U.S. state), Sportspeople from New York City
Randolph Turpin	1928 births, 1966 deaths, Black British sportspeople, British boxers, British criminals, Criminals who committed suicide, Sportspeople from Warwickshire, Sportspeople who committed suicide, Suicides by firearm, Suicides in the United Kingdom
Maple	Trees, Sapindaceae
Tilde Fröling	1980 births, Living people, Swedish actors, Swedish singers, Swedish television presenters, Reality television participants
Marie Picasso	1979 births, Big Brother contestants, Living people, Reality show winners, Swedish models, Swedish singers
Eulipotyphla	Eulipotyphla
Bad Kissingen	Spa towns in Germany
Hostel	Accommodations, Travel
Reuters	Media in the United Kingdom
Associated Press	Media in the United States, Companies based in New York City, Manhattan
BBC News (TV channel)	1997 establishments in the United Kingdom, BBC Online, BBC television channels
Saxe-Jena	States of the Holy Roman Empire, Thuringia
Saxe-Weimar-Eisenach	1809 establishments, 1918 disestablishments in Germany, House of Wettin, States of the Confederation of the Rhine, States of the German Confederation, States of the German Empire, States of the Holy Roman Empire, States of the North German Confederation, States of the Weimar Republic, Thuringia, Weimar, 1800s establishments in Germany
Alligatoridae	Crocodilia
Gaza	Cities in Palestine, Gaza Strip
Grand duchy	Forms of government, Royalty and nobility
António de Oliveira Salazar	1889 births, 1970 deaths, Former dictators, Prime Ministers of Portugal
Princess Nikki	2006 British television series debuts, 2006 British television series endings, 2000s British television series, Channel 4 reality television programmes
James Van Der Beek	1977 births, Living people, Actors from Connecticut, American movie actors, American television actors
Dawson's Creek	1998 American television series debuts, 2003 American television series endings, 1990s American drama television series, 1990s teen television series, 2000s American drama television series, 2000s teen television series, American teen drama television series, Television series set in Massachusetts, WB network shows, English-language television programs, The WB original programming
General Hospital	1960s American television series, 1960s drama television series, 1970s American television series, 1970s drama television series, 1970s American workplace television series, 1980s American drama television series, 1980s American workplace television series, 1980s soap operas, 1980s workplace drama television series, 1990s American drama television series, 1990s American workplace television series, 1990s soap operas, 1990s workplace drama television series, 2000s American drama television series, 2000s American workplace television series, 2000s soap operas, 2000s workplace drama television series, 2010s American drama television series, 2010s American workplace television series, 2010s soap operas, 2010s workplace drama television series, ABC network shows, American medical television series, American soap operas, American workplace drama television series, Television series set in New York, English-language television programs
Popstars	Reality television series
Nicole Scherzinger	1978 births, Living people, American adoptees, Pussycat Dolls, Writers from Louisville, Kentucky, Writers from Hawaii, Musicians from Hawaii, Musicians from Louisville, Kentucky, American pianists, People from Honolulu, Singers from Hawaii, Singers from Louisville, Kentucky, Television personalities from Kentucky
Girls Aloud	2002 establishments in England, 2000s British music groups, 2010s British music groups, 2013 disestablishments in the United Kingdom, British girl groups, British pop music groups, Girls Aloud, Musical groups established in 2002, Musical groups disestablished in 2013, Musical groups from London, Musical quintets
Wulfila Bible	Bible versions
Plague of Athens	Infectious diseases, Ancient Greece
430 BC	430 BC
Peloponnesian War	Wars, Ancient Greece
429 BC	429 BC
Saxe-Gotha-Altenburg	House of Wettin, States of the Confederation of the Rhine, States of the German Confederation, States of the Holy Roman Empire, Thuringia
Thucydides	460 BC births, 395 BC deaths, Ancient Greek historians
Piraeus	Settlements in Greece
Rhône	Rivers of France, Rivers of Switzerland, Occitanie, Provence-Alpes-Côte d'Azur, Auvergne-Rhône-Alpes
Luis Egidio Meléndez	1716 births, 1780 deaths, Spanish painters, People from Naples
Saxe-Hildburghausen	House of Wettin, States of the Confederation of the Rhine, States of the German Confederation, States of the Holy Roman Empire, Thuringia
Augustine of Hippo	354 births, 430 deaths, Ancient Roman writers, Christian mystics, Christian saints, Christian theologians, Converts to Christianity, Philosophers, Berber people
House of Wettin	House of Wettin, Ernestine duchies, Holy Roman Empire
Durham	Durham
Angelic Upstarts	English punk bands
Anti-fascism	Discrimination, Political movements, Fascism
History of the Peloponnesian War	Wars, Ancient Greece
Historiography	History
Historical method	History
Primary source	History
Secondary source	History, Science
Breinigerberg	Villages in North Rhine-Westphalia
Document	Documents
International Standard Book Number	Publishing, Book terminology, ISO standards
Recording	Engineering
Pedro Santana, Elías Piña	Settlements in Dominican Republic, 1952 establishments in the Dominican Republic
Visual system	Vision
Microform	Photography, Storage devices
Analog signal	Physics, Electronics
Microphone	Sound, Engineering, Data input, Audio technology
Digital signal	Engineering, Telecommunications
Pneumatics	Mechanics
Duchy of Saxe-Gotha	1572 disestablishments, 1640 establishments, House of Wettin, States of the Holy Roman Empire, Thuringia, 1640s establishments in Europe
Seafloor spreading	Oceanography, Plate tectonics
Comendador, Elías Piña	Settlements in Dominican Republic, 1868 establishments, 1860s establishments in the Dominican Republic
Emily Greene Balch	1867 births, 1961 deaths, Writers from Massachusetts, American Nobel Prize winners
Chiara Zanni	1978 births, Living people, Canadian movie actors, Canadian voice actors, Canadian television actors, People from Vancouver
Antoni Lange	1863 births, 1929 deaths, Jewish writers, Polish novelists, Philosophers, Polish playwrights, Polish poets, Polish Jews, Translators, Writers from Warsaw
Curie (unit)	Old units of measurement
Fjord	Gulfs
Raccoon	Procyonids, Mammals of North America, Omnivores
Eliza Dushku	1980 births, Living people, American movie actors, Actors from Massachusetts, American television actors, Whedonverse
Sandy Robson	1973 births, Canadian television actors, Living people, People from Ontario, Canadian television presenters
Lord's Prayer	Christian prayers
Service (music)	Musical forms, Christian music
Space station	Space stations
Van de Graaff Generator	Machines, Electricity
Time server	computers, internet
Laura Prepon	1980 births, Living people, American movie actors, American television actors, American voice actors, Actors from New Jersey, Scientologists
Ashley Massaro	1979 births, 2019 deaths, Sportspeople who committed suicide, Suicides by hanging in the United States, American professional wrestlers, Female professional wrestlers, Sportspeople from New York
Melina Perez	1979 births, Living people, American professional wrestlers, Former WWE wrestlers, Female professional wrestlers, Sportspeople from Los Angeles, California
Amy Dumas	1975 births, American punk musicians, American professional wrestlers, Female professional wrestlers, Former WWE wrestlers, Living people, People from Fort Lauderdale, Florida, Singers from Florida, Sportspeople from Atlanta, Georgia, Sportspeople from Florida, WWE Hall of Fame
Mafic	Rocks
Specific gravity	Physics
Rosetta Stone	Ancient Egypt, British Museum
Curtain	Cloth
Criminal record	Criminal justice
Visitor	Social sciences
Espresso	Coffee, Italian food
Damson	Plums
Half-time	Sports words
Fluid mechanics	Fluid mechanics
Fluid statics	Fluid mechanics
Meroë	History of Africa, Cities in Sudan
Saxe-Eisenach	1596 establishments, 1590s establishments in Europe, 16th century establishments in Germany, 1638 disestablishments, 1640 establishments, 1640s establishments in Europe, 17th century establishments in Germany, 1644 disestablishments, 1640s disestablishments in Europe, 1662 establishments, 1660s establishments in Europe, 1809 disestablishments, 1800s disestablishments in Germany, House of Wettin, States of the Confederation of the Rhine, States of the Holy Roman Empire
Laxative	Drugs, Digestive system
Jebel Barkal	Mountains of Africa, Sudan
Dassault Mirage III	French military aircraft, Dassault Aviation
Herbaceous plant	Types of plants
Trophy	Awards
Nickel Creek	Bluegrass bands, Musical groups from California, Grammy Award winners
Six-Day War	1967 in Asia, 20th century in Egypt, Arab–Israeli conflict, 20th century in Jordan, Wars involving Egypt, Wars involving Israel, Wars involving Syria, 1960s in Israel, June events
Australopithecus afarensis	Australopithecines
Nakalipithecus	Fossils, Hominids
Defoliant	Poisons, Chemical compounds
Phoenix lights	1990s in Arizona, 1997 in the United States, March events
272	272
909	909
Testing English as a foreign language	English language
Eumetazoa	Groups of phyla
Bilateria	Groups of phyla
Lyre	Plucked string instruments, Early musical instruments
Oceanic crust	Geology
Continental crust	Geology
List of cities in the United Kingdom	Cities in the United Kingdom, Lists of cities in Europe, United Kingdom-related lists, Lists of cities by country
Shift work	Employment
Étang Saumâtre	Lakes of North America, Geography of Haiti
Grumman F6F Hellcat	United States Navy aircraft, United States Marine Corps aircraft, British military aircraft, French military aircraft, World War II American aircraft, Grumman aircraft
Grumman F4F Wildcat	United States Navy aircraft, United States Marine Corps aircraft, British military aircraft, World War II American aircraft, Grumman aircraft
Mitsubishi A6M Zero	Military of Japan, World War II Japanese aircraft, Mitsubishi
CONCACAF Champions League	Football competitions
Confederation of North, Central American and Caribbean Association Football	Football organizations
Mali Federation	History of Mali, History of Senegal, Former countries in Africa, 1959 establishments, 1960 disestablishments, 1960s disestablishments in Africa
Value Added Tax	Government, Taxation
Saxe-Coburg	1596 establishments, 1590s establishments in Europe, 16th century establishments in Germany, 1633 disestablishments, Disestablishments in Germany, 1681 establishments, 1680s establishments in Europe, 17th century establishments in Germany, 1699 disestablishments, House of Wettin, States of the Holy Roman Empire
Deuterostome	Groups of phyla
Saxe-Coburg-Eisenach	House of Wettin
Dennis Rader	1945 births, Living people, American prisoners, American serial killers, People from Kansas
Tom and Jerry Kids	1990 television series debuts, Children's television series, Animated television series, Cartoon Network series, Spacetoon shows, English-language television programs, Tom and Jerry
Hannelore Kohl	1933 births, 2001 deaths, Drug-related suicides, German writers, Order of Merit of the Federal Republic of Germany, People from Berlin, Suicides in Germany, Writers who committed suicide
Amber Benson	1977 births, Living people, Actors from Birmingham, Alabama, American Jews, American movie actors, American movie directors, American screenwriters, American television actors, Whedonverse, Writers from Alabama
Walter Scheel	1919 births, 2016 deaths, Chancellors of Germany, Former members of the German Bundestag, German military personnel of World War II, Government ministers of Germany, Nazis, Order of Merit of the Federal Republic of Germany, People from Solingen, Politicians from North Rhine-Westphalia, Politicians of the Free Democratic Party of Germany, Presidents of Germany, Vice Chancellors of Germany
Norman Mailer	1923 births, 2007 deaths, American novelists, Deaths from renal failure, Disease-related deaths in New York City, Journalists from New Jersey, Journalists from New York, Movie directors from New Jersey, Movie directors from New York, Movie producers from New Jersey, Movie producers from New York, Pulitzer Prize winners, Screenwriters from New Jersey, Screenwriters from New York
The Lion King	1994 movies, 1990s animated movies, 2010s 3D movies, American epic movies, American family movies, American musical movies, Disney animated movies, Disney Renaissance, English-language movies, Golden Globe Award winning movies, Movies about animals, Movies about lions, Movies based on plays by William Shakespeare, Movies composed by Hans Zimmer, Movies composed by John Powell, Movies set in Africa, Movies that won the Best Original Song Academy Award, IMAX movies, The Lion King, 3D re-releases
Kelly Osbourne	1984 births, Living people, English singers, English movie actors, English television actors, Participants in American reality television series
Marie-Antoine Carême	1784 births, 1833 deaths, Burials at Montmartre Cemetery, Paris, French chefs, Writers from Paris
X Window System	Software
Mammaliaformes	Theriodonts
Pineal gland	Sleep, Glands, Hormones
Gamma-Hydroxybutyric acid	Drugs
Reichsmark	Former currencies of Europe, Economy of Germany, History of Germany
Co-operative Party	Political parties in the United Kingdom, Co-operative movement
Bánica	Settlements in Dominican Republic, 1504 establishments in the Spanish Empire
Quillaja saponaria	Rosaceae
Clarence E. Anderson	1922 births, Living people, American military people, United States Air Force, People from Oakland, California
Wild Weasel	United States Air Force, Vietnam War aircraft, United States military aircraft
Republic F-105 Thunderchief	United States Air Force aircraft, Vietnam War aircraft
Labour Co-operative	Labour Party (UK), Co-operative movement
Heraldic badge	Heraldry
Postal code	Postal service
Bethlehem Housing Authority	Pennsylvania, Accommodations, 1939 establishments in the United States, 1930s establishments in Pennsylvania
Les Six	French composers
Georges Auric	1899 births, 1983 deaths, 20th century composers, French composers, People from Montpellier
The Left (Germany)	2007 establishments in Germany, Berlin, Socialism, The Left (Germany)
Louis Durey	1888 births, 1979 deaths, French composers, 20th century composers
Arthur Honegger	1892 births, 1955 deaths, 20th century composers, Cardiovascular disease deaths in France, Deaths from myocardial infarction, People from Le Havre, Swiss composers
Darius Milhaud	1892 births, 1974 deaths, 20th century composers, French composers, Autobiographers, Aix-en-Provence
Saône	Rivers of France, Grand Est, Bourgogne-Franche-Comté, Auvergne-Rhône-Alpes
Hereford	County towns in England, Hereford
The finger	Profanity, Non-verbal communication
Ariel (moon)	Uranus' moons
Trondheim	Trondheim
Trondheim Region	Trondheim
Electric potential	Electricity
Christine Teipel	1621 births, 1630 deaths, Executed German people, People executed for witchcraft, People from North Rhine-Westphalia
Ajax (programming)	Internet, JavaScript
City of Bradford	Bradford, 1847 establishments in Europe, 1840s establishments in England
Lithuanian litas	Former currencies of Europe, Lithuania
Maria Holl	1549 births, 1634 deaths, German people
Duduk	Woodwind instruments, Masterpieces of the Oral and Intangible Heritage of Humanity
Droopy Dog	Animated characters, Fictional dogs
Iraqi Kurdistan	Kurdistan, Iraq
Biohazzard Records	Independent record labels, Companies of Germany, Entertainment in Germany
Arbil, Iraq	Cities in Iraq, Kurdistan, Round cities
Ruhr Area	Geography of North Rhine-Westphalia, Regions of Germany
Iraqi dinar	Currency of Asia, Iraq
Massoud Barzani	1946 births, Living people, Iraqi politicians, Kurdish politicians, Presidents (government)
Nechervan Idris Barzani	1966 births, Living people, Iraqi politicians, Kurdish politicians, Prime ministers
Credit card	Money
Lebanese Civil War	1970s in Asia, 1980s in Asia, 1990s in Asia, Civil wars, Wars involving Israel, Wars involving Lebanon, Wars involving Syria, 20th century in Israel, 20th century in Lebanon, 20th century in Syria
Mosul	Cities in Iraq
Mayonnaise	Condiments
Francis Poulenc	1899 births, 1963 deaths, 20th century composers, French composers
Germaine Tailleferre	1892 births, 1983 deaths, 20th century composers, French composers, Women composers
Cladistics	Cladistics
Kimbo Slice	1974 births, 2016 deaths, Deaths from heart failure, Bahamian people, American mixed martial artists
Pangaea	Supercontinents
Fatah	Nationalist organizations in Palestine, Political parties in Asia, Politics of Palestine, Socialist International, West Bank
Balkh	Cities in Afghanistan
Hessischer Rundfunk	German broadcasting companies, Frankfurt
As Sulaymaniyah Province	Provinces of Iraq
Arbil Province	Provinces of Iraq
Dahuk Province	Kurdistan, Provinces of Iraq
Coruscant	Star Wars planets
Digital Video Broadcasting	Television technology
Linguine	Pasta
Egg (food)	Breakfast foods, Egg
List of egg dishes	Egg dishes, Food-related lists
Leitmotif	Musical forms, Opera terminology
Pointe shoes	Footwear, Ballet
Provinces of Iraq	Provinces of Iraq
Brussels-Capital Region	Brussels-Capital Region
Vaishali	Cities in India, History of India, Settlements in Bihar
Licchavi	History of India, Nepal, Bihar
Republicanism	Politics
Tabriz	Cities in Iran, East Azarbaijan Province
Saber–toothed cat	Fossils, Sabretooth cats
Prosper Mérimée	1803 births, 1870 deaths, French writers
Jerry Hsu	1981 births, Living people, American skateboarders, Sportspeople from California, People from San Jose, California
Barnes & Noble	Companies based in New York City, Books, 1873 establishments in the United States, 1870s establishments in New York (state)
Birth defect	Terminology, Medicine stubs, Medicine, Genetics, Health problems, Genetic disorders
Scrambled eggs	Egg dishes, Breakfast foods
Elizabeth of Bohemia	1596 births, 1662 deaths, House of Stuart, Kings and Queens consort, Electors and Electresses, Bohemia
TAM Airlines	1961 establishments in South America, Star Alliance, Airlines of South America, Economy of Brazil, 1960s establishments in Brazil
Limb	Limbs and extremities
Natalee Holloway	1986 births, Aruba, Missing American people, People declared dead in absentia, People from Alabama, Year of death unknown
Australosphenida	Monotremes
Steropodontidae	Monotremes
Steropodon	Monotremes
Kollikodon	Monotremes
Teinolophos	Monotremes
Obdurodon	Monotremes
Curtiss P-40 Warhawk	United States Army aircraft, Royal Air Force aircraft, Australian military aircraft, World War II American aircraft
Flying Tigers	World War II, United States military aircraft, United States Army, United States Navy, United States Marine Corps
Shusha	Caucasus, Cities in Azerbaijan, Districts of Azerbaijan, Settlements in Azerbaijan, Nagorno-Karabakh Republic, 1750s establishments, Establishments in Azerbaijan
Doritos	Snack foods
Mount Silverthrone	Volcanoes of British Columbia, Mountains of British Columbia
AIM-9 Sidewinder	Missiles, Air force, Military aviation
X-intercept	Mathematics
Liberty	Human issues, Philosophy, Freedom, Politics
Dignity	Human issues, Virtues
Voluntary association	Organizations
Helen Keller	1880 births, 1968 deaths, Blind people, Industrial Workers of the World, Nonviolence advocates, People from Tuscumbia, Alabama, Writers from Alabama, Deaf people
Pausanias (geographer)	Ancient Greece, Greek geographers
Dignitas	Ancient Rome
Tacitus	110s deaths, Ancient Roman historians, 50s births
Connotation	Logic
Margrave	History of Germany, Royalty and nobility
Meppel	Cities in the Netherlands, Settlements in Drenthe, Municipalities of Drenthe
Diego Velázquez de Cuéllar	1465 births, 1524 deaths, History of Cuba, History of Spain, Spanish military people
Denotation	Philosophy, Logic
Victoria Silvstedt	1974 births, Living people, Swedish models
Doner kebab	Middle Eastern foods
Murder of Meredith Kercher	2007 in Europe, 2000s in Italy, 2000s murders in Europe, British people murdered abroad, English murder victims, Murder in 2007, Murders by blade weapons, People murdered in Italy
Meredith Monroe	1968 births, Living people, American movie actors, American television actors
Michelle Williams (actress)	Golden Globe Award winning actors, Emmy Award winning actors, American child actors, American movie actors, American television actors, American stage actors, American voice actors, Actors from Montana, 1980 births, Living people, People from Kalispell, Montana
Pernilla Wiberg	Swedish skiers, 1970 births, Living people
Ebba von Sydow	1981 births, Living people, People from Gothenburg, Swedish journalists
Lulu (opera)	1930s operas, Compositions by Alban Berg, 1937
Howard University	Atlantic Soccer Conference, Colleges and universities in the District of Columbia, Oak Ridge Associated Universities, United Soccer Conference, 19th-century establishments in Washington, D.C., 1867 establishments in the United States
Seth MacFarlane	Biography with signature, 1973 births, Living people, American atheists, Webby Award winners, American movie actors, American television actors, American voice actors, Television producers, Television writers, Comedians from Connecticut, Democrats (United States), Actors from Connecticut
Tanuki	Japanese folklore
Megalibgwilia	Monotremes
Ajax the Great	People in Greek mythology
Phoenicia	Phoenicia
Seattle Seahawks	1974 establishments in the United States, 1970s establishments in Washington (state), Seattle Seahawks
Salisbury	Salisbury
Jan Ullrich	1973 births, Doping cases in cycling, German cyclists, Living people, People from Rostock, Sportspeople from Mecklenburg-Vorpommern, Tour de France winners, Vuelta a España winners
Lincoln, England	Settlements in Lincolnshire, County towns in England, Cities in England
Burj el-Barajneh	Beirut, 1948 establishments in Asia
Coelacanth	Lobe-finned fish, Living fossils
Tent city	Buildings and structures
Norwegian Refugee Council	Norway, Human rights organizations in Europe, 1946 establishments in Europe, 20th century establishments in Norway
Euphemism	Figures of speech
List of German Presidents and Chancellors by age	Germany-related lists, Lists of heads of state
Boscobel House	Buildings and structures in England
Wismar	Former urban districts of Mecklenburg-Vorpommern
Dysphemism	Figures of speech
Christian worship	Christian theology
Prose	Prose
Caper story	Genres
14 BC	14 BC
Death of Tina Watson	2003 crimes, 2003 deaths, American manslaughter victims, Crime in Australia, Deaths by drowning, People from Alabama, Queensland, 2000s in Australia
City of Wakefield	Wakefield
Io (moon)	Jupiter's moons
Cormorant	Cormorants, Pelecaniformes
2006 Tour de France	2006 in sports, 2000s in France, Sport in Belgium, Sport in France, Tour de France
Beth Phoenix	1980 births, Living people, American professional wrestlers, WWE wrestlers, Female professional wrestlers, Sportspeople from New York
Cartridge (firearms)	Ammunition
Hong Kong Island	Geography of Hong Kong, Islands of China
Communist Party of China	Politics of the People's Republic of China, Communist parties
Tatar language	Turkic languages, Languages of Russia
House of Medici	House of Medici, Papal families, Grand Duchy of Tuscany
Giordano Bruno	1548 births, 1600 deaths, 16th century philosophers, Italian astronomers, Italian mathematicians, Italian philosophers, Italian Roman Catholics, Italian writers, People executed by burning
Wheel of Fortune (US game show)	Television game shows, First run syndicated television programs, English-language television programs, 1975 television series debuts
Shalom	Judaism, Words
Villa Gordiani	Parks, Rome
Massachusetts Bay Colony	17th century in Massachusetts, Former British colonies
About a Girl (TV series)	2007 television series debuts, 2008 television series endings, 2000s Canadian television series, Sitcoms, Teen television series, English-language television programs
Number line	Mathematics, Numbers
Tunicate	Chordates
Zheng He	1371 births, 1433 deaths, Admirals, Chinese military people, Chinese diplomats, Asian explorers, Sailors
List of elements	Chemical elements, Chemistry lists
Georg Büchner Prize	Literary awards, Darmstadt
Brigham Young University Hawaii	Colleges and universities in Hawaii, Mormonism, 1955 establishments in the United States, 20th-century establishments in Hawaii
Australopithecus africanus	Australopithecines
Australopithecus	Australopithecines
Homo	Hominins
Poverty in India	Economy of India, History of India, Poverty
The Christian Community	Protestant denominations
List of Melbourne railway stations	Railway stations in Melbourne, Rail transport lists
Flag of Kurdistan	Kurdistan, Flags of Asia, Flags of country subdivisions
Vector graphics	Computer graphics, Vector graphics
Silence (band)	German rock bands, German heavy metal bands
Georg Büchner	1813 births, 1837 deaths, Deaths from typhus, Disease-related deaths in Switzerland, Playwrights, Writers from Hesse
Ludwig Büchner	1824 births, 1899 deaths, German philosophers, People from Darmstadt, Writers from Hesse
Goitre	Diseases
Cincinnati Reds	Cincinnati Reds, Sports in Cincinnati, Ohio, 1869 establishments in the United States, 19th-century establishments in Ohio
Josh Beckett	1980 births, Living people, American baseball players, Boston Red Sox players, Sportspeople from Texas, Los Angeles Dodgers players
Curt Schilling	1966 births, Living people, People with cancer, People from Anchorage, Alaska, American baseball players, Boston Red Sox players, Arizona Diamondbacks players, Sportspeople from Alaska, National League All-Stars
Adam Dunn	1979 births, American baseball players, American football quarterbacks, American League All-Stars, Arizona Diamondbacks players, Chicago White Sox players, Cincinnati Reds players, Living people, National League All-Stars, Oakland Athletics players, Sportspeople from Houston, Texas, Washington Nationals players
Stroke	Stroke
The Wheel of Fortune	Mythology, Middle Ages
Raster graphics	Computer graphics
Postscript	Programming languages
Horse chestnut	Trees, Sapindaceae
Francisco Pizarro	1471 births, 1541 deaths, Spanish explorers, History of Central America, People from Extremadura, Lima
Bingo	Games
9 (number)	Square numbers, Integers
5 (number)	Integers, Prime numbers
Hurling	Team sports, Sport in Ireland
6 (number)	Integers
4 (number)	Square numbers, Integers, Mathematics
7 (number)	Integers, Prime numbers
8 (number)	Integers
Donatello	Italian sculptors, People from Florence, 1466 deaths, 1386 births
Sarah Bernhardt	1844 births, 1923 deaths, Deaths from uremia, Actors from Paris, Burials at Père Lachaise Cemetery, Deaths from renal failure, Disease-related deaths in France, French autobiographers, French stage actors
Kevin Rudd	1957 births, Living people, Australian Anglicans, Australian Labor Party politicians, Australian ministers for Foreign Affairs, Commonwealth Chairpersons-in-Office, Leaders of the Opposition (Australia), People from the Sunshine Coast, Queensland, Politicians from Queensland, Prime Ministers of Australia, Republicans
Hurley (stick)	Sports equipment
Sliotar	Sports equipment
Camogie	Sport in Ireland
Rounders	Team sports
Cricket (insect)	Gryllidae, Orthoptera
Rounders (movie)	1998 drama movies, Buddy movies, American drama movies, Miramax movies, Multilingual movies, American independent movies
Gaelic Athletic Association	Sport in Ireland
Gaelic Games	Sports competitions, Sport in Ireland, Sport in Northern Ireland
Gaelic handball	Handball, Sport in Ireland
American handball	Handball
Fives	Handball
Miami Heat	National Basketball Association teams, Sports in Miami, Florida, 1988 establishments in the United States, 1980s establishments in Florida
Buttress	Architectural elements, Walls
Real tennis	Tennis
Jeu de paume	Handball, Sport in France
Palace of Versailles	Palace of Versailles, Former royal residences
Château	Houses
Positron	Elementary particles, Antimatter
Basque pelota	Sports
Pump-jet	Engineering
Propulsor	Engineering
Valencian language	Valencià, Romance languages, Valencia (autonomous community)
Valencian pilota	Handball, Sport in Spain
Trapezoid	Polygons
Frisian handball	Handball, Frisian culture
Gaelic football	Football, Sport in Ireland
Caid (sport)	Sport in Ireland
Longue paume	Handball
Pallone	Sport in Italy
Palla	Sport in Italy
Storm history of Hurricane Katrina	Hurricane Katrina, Storm histories of tropical cyclones
Troposphere	Layers of Earth's atmosphere
Rapid deepening	Meteorology, Tropical cyclones
Doppler radar	Technology
Horseshoe crab	Chelicerata, Living fossils
Atlantic hurricane	Atlantic Ocean, Hurricanes
Buras-Triumph, Louisiana	Unincorporated communities in Louisiana
Dry Tortugas	Florida Keys, National parks in the United States, Biosphere reserves
Aventura, Florida	Cities in Florida
Florida Keys	Islands of Florida
Climatology	Climate
Harder, Better, Faster, Stronger	2001 songs
Fiona Apple	1977 births, Living people, American pianists, Singer-songwriters from New York, American rock singers, Grammy Award winners, Singers from New York City
Pastor	Christian religious occupations
Egyptology	Egypt, Archaeology, Ancient Egypt
Lichfield	Towns in Staffordshire, Cities in England, Civil parishes in Staffordshire
New France	Historical territories of Canada, 1534 establishments, 1760s disestablishments, 1530s establishments in North America, Establishments in Canada, 16th century establishments in France
El Llano, Elías Piña	Settlements in Dominican Republic, 1974 establishments in North America, 1970s establishments in the Dominican Republic
Hondo Valle, Elías Piña	Settlements in Dominican Republic, 1978 establishments in North America, 1970s establishments in the Dominican Republic
Juan Santiago, Elías Piña	Settlements in Dominican Republic, 2005 establishments in North America, 21st-century establishments in the Dominican Republic
Río Limpio, Elías Piña	Settlements in Dominican Republic, 1992 establishments in North America, 1990s establishments in the Dominican Republic
Sabana Cruz, Elías Piña	Settlements in Dominican Republic
Sabana Larga, Elías Piña	Settlements in Dominican Republic, 2004 establishments, 21st-century establishments in the Dominican Republic
Destiny Fulfilled	Destiny's Child albums
Kanal 5	Television networks
Decadence	Culture, Ethics, Literature, Painting, Pop music
Kanye West	1977 births, Living people, African American musicians, American rap musicians from Georgia, Grammy Award winners, 2020 United States presidential candidates, Businesspeople from Atlanta, Georgia, Singers from Atlanta, Georgia, Businesspeople from Chicago, Singers from Chicago, Kanye West, Kardashian family, Businesspeople from Wyoming, Singers from Wyoming, People with bipolar disorder, American Christians
Giro Manoyan	Armenian politicians, Living people, Year of birth missing (living people)
Castleton, Derbyshire	Villages in Derbyshire
Los Angeles Lakers	National Basketball Association teams, Sports in Los Angeles, 1947 establishments in the United States, 1940s establishments in Minnesota
Asterix	Comic books
Hurdy gurdy	String instruments
List of magicians	Lists of entertainers, Magicians
Magician	Magicians, Entertainment occupations
Republic P-47 Thunderbolt	United States Army aircraft, World War II American aircraft
Judo	Judo, Sport in Japan
Humus	Agriculture, Soil
Soil science	Earth sciences, Soil
Queen's Counsel	Queen's Counsel
Pedogenesis	Geology
11 (number)	Integers, Prime numbers
12 (number)	Integers
Sedimentary rock	Sedimentary rocks, Sedimentology, Stratigraphy
14 (number)	Integers
Rock (geology)	Rocks
15 (number)	Integers
16 (number)	Integers, Square numbers
Weathering	Chemistry, Erosion
Recrystallisation	Chemistry, Laboratory techniques, Geology
Wildlife and Countryside Act 1981	1981 in the United Kingdom, Acts of the Parliament of the United Kingdom, United Kingdom-related lists
Soil classification	Geology, Engineering, Soil
Manor house	Houses
English country house	Houses
Larynx	Anatomy of the respiratory system
Endangered species	IUCN Red List endangered species, Endangered species
Archosaur	Archosaurs
MS Explorer	Cruise ships
Calcite	Minerals, Geochemistry
Stalagmite	Caves
Deposition (geology)	Geology
Calcium carbonate	Minerals, Geochemistry, Calcium compounds, Carbonates
Hard water	Water
Soft water	Water
Moorland	Habitats
Neotropic	Ecozones
Nearctic	Ecozones
Nearctic (horse)	1954 births, 1973 deaths, Thoroughbred racehorses
Lockerbie	Towns in Scotland
Circadian rhythm	Physiology
Stud (animal)	Animals
Castration	Reproductive system, Anaphrodisiacs
Bureaucracy	Sociology
Anzère	Ski areas and resorts in Switzerland, Villages in Valais
Sion, Switzerland	Sion, Switzerland
Brig (district)	Districts of Valais
Monthey, Switzerland	Municipalities of Valais, Cities in Switzerland
Sierre	Cities in Switzerland, Municipalities of Valais
Brig, Switzerland	Municipalities of Valais, Cities in Switzerland
Pennine Alps	Europe-related lists, Mountain ranges of the Alps, Mountains of Italy, Mountains of Switzerland, Geography of Valais, Piedmont, Valle d'Aosta
Bernese Alps	Europe-related lists, Mountain ranges of the Alps, Mountains of Switzerland
Armenian National Committee of America	Armenian diaspora, Political organizations based in the United States
Valais	Valais, Wine regions
Conthey (district)	Districts of Valais
Martigny, Switzerland	Municipalities of Valais, Cities in Switzerland
Mattertal	Geography of Valais, Valleys of Switzerland
Zermatt	Municipalities of Valais, Ski areas and resorts in Switzerland
Ajax the Lesser	People in Greek mythology
Post-nominal letters	Titles
Corvidae	Corvids
Visp	Municipalities of Valais, Cities in Switzerland
Saint-Maurice, Switzerland	Municipalities of Valais, Cities in Switzerland
Conthey	Municipalities of Valais, Cities in Switzerland
Entremont (district)	Districts of Valais
Santeri Palin	1983 births, Living people, Finnish people
Sembrancher	Municipalities of Valais, Cities in Switzerland
Münster-Geschinen	Former municipalities of Valais
Microbiotheria	Marsupials of Australia, Chile
Dasyuromorphia	Dasyuromorphia, Marsupials of Australia
Goat Rock Beach	Beaches of California, Sonoma County, California
Sea lion	Pinnipeds
Greywacke	Sandstones
Madeleine McCann	2003 births
Carmina Burana	Medieval literature, Latin language
Vex, Switzerland	Municipalities of Valais
Dasyuridae	Dasyuromorphia
Mohammed Zahir Shah	Monarchs of Afghanistan, Pashtun people, 1914 births, 2007 deaths, People from Kabul
Thurgau	Thurgau
Graubünden	Graubünden
Nidwalden	Nidwalden
Schaffhausen	Schaffhausen, Imperial free cities
Obwalden	Obwalden
Canton of Jura	Canton of Jura
French Community	International organizations, France
Usury	Types of crime, Property crimes
John Bates	US Republican Party politicians, Governors of Massachusetts, 1859 births, 1946 deaths, Lieutenant Governors of Massachusetts
Acoustic music	Music
Mandolin	Plucked string instruments
Bluegrass music	Bluegrass music
Billboard charts	Billboard charts
Leuk	Municipalities of Valais, Cities in Switzerland
Raron	Municipalities of Valais
Goms (district)	Districts of Valais
Shavo Odadjian	1974 births, Living people, Bassists, Armenian diaspora, DJs
Aspartame	Sweeteners
Saccharin	Sweeteners
Isomalt	Sweeteners
Sloth	Xenarthrans
Oberon (moon)	Uranus' moons
Delémont (district)	Districts of Jura
Xavier Rudd	1978 births, Living people, Australian singers, Musicians from Victoria (Australia), Australian guitarists, Didgeridoo players, Banjo players, Blues guitarists, Australian folk musicians
Banjo	Folk instruments, Bluegrass music, Plucked string instruments
Nicolás de Ovando	1460 births, 1511 deaths, History of the Dominican Republic, 16th century in Spain, People from Extremadura, Spanish military people, History of Haiti
Abelsonite	Minerals
Abenakiite-(Ce)	Minerals
Abernathyite	Minerals
Abhurite	Minerals
Animal Liberation Orchestra	Musical groups from California, American rock bands
Leftover Salmon	Musical groups from Colorado, American rock bands, Bluegrass bands, Boulder, Colorado, Musical groups established in 1989, 1989 establishments in the United States, 1980s establishments in Colorado, Musical groups disestablished in 2005, 2005 disestablishments in the United States
Internet meme	Internet memes
Morris Gleitzman	1953 births, Living people, Australian children's writers, Australian screenwriters, British children's writers, English screenwriters, Writers from Lincolnshire
Coaxial cable	Signalling
Abswurmbachite	Minerals
Acanthite	Minerals
Seven Lucky Gods	Japanese folklore, Japanese deities
Acetamide	Minerals
17 (number)	Integers, Prime numbers
Pectin	Food supplements
Pectobacterium carotovorum	Gram-negative bacteria
Jesus with erection	Controversies, 2006 in the United States, 21st century in Oregon
Giovanni Guaita	Italian writers, Italian historians, 1962 births, Living people
Cockatoo	Cockatoos
Bell P-39 Airacobra	United States Army aircraft, Bell aircraft, Soviet military aircraft, Royal Air Force aircraft, World War II American aircraft
Air Canada	1965 establishments in North America, 1960s establishments in Canada, Airlines of Canada, Companies listed on the Toronto Stock Exchange, Star Alliance, IATA members
Actinolite	Minerals
Buoy	Water transport, Navigation
Gulf Coast of the United States	Regions of the United States
Florida Panhandle	Geography of Florida
Loop Current	Oceans, Tropical cyclones, Ocean currents
National Weather Service bulletin for New Orleans region	Hurricane Katrina
Cesc Fàbregas	1987 births, Living people, Spanish footballers, Arsenal F.C. players, Chelsea F.C. players
Misery Guts	1998 books, Children's books
Brett Lee	Australian cricketers, Sportspeople from New South Wales, 1976 births, Living people, Wollongong
Otter	Mustelids, Mammals of North America, Mammals of Europe, Mammals of Asia
Medal of Honor	Military honors, Orders, decorations, and medals of the United States, 1863 establishments in the United States
Asynchronous Transfer Mode	Computer science
Blood type	Biochemistry, Blood
Trance music	Trance music
Acuminite	Minerals
Warthog	Pigs, Mammals of Africa
Moraine	Landforms
Silt	Geology
Catalytic converter	Machines
Adamite	Minerals
Six Flags Great Adventure	Six Flags Great Adventure, 1974 establishments in the United States, Theme parks in the United States, 1970s establishments in New Jersey
Adamsite-(Y)	Minerals
18 (number)	Integers
19 (number)	Integers, Prime numbers
21 (number)	Integers
Samuel Pepys	1633 births, 1703 deaths, Diarists, English writers, Fellows of the Royal Society, Presidents of the Royal Society
Jorge Guillén	1893 births, 1984 deaths, Spanish poets, People from Valladolid
Albatross	Procellariiformes, Seabirds
Proxima Centauri	Red dwarfs
San Jacinto fault	Geography of California, Faults
Dhammapada	Buddhist texts
Chant	Musical forms
Habenaria mossii	Orchids
22 (number)	Integers
23 (number)	Integers, Prime numbers
Adelite	Minerals
The Naked Brothers Band	Nickelodeon television series, 2006 television series debuts, English-language television programs
Matterhorn	Alps, Mountains of Italy, Mountains of Switzerland, Geography of Valais
Jura (department)	Wine regions of France, Departments in Bourgogne-Franche-Comté
Fray	Whedonverse, Comic books
Erik Satie	1866 births, 1925 deaths, 20th century composers, French composers, Deaths from cirrhosis
Arachniodes	Pteridophyta
Dryopteridaceae	Plant families, Pteridophyta
Particle size (grain size)	Geology
Rock flour	Agriculture
Virginia opossum	Marsupials
Motor ship	Ship types
24 (number)	Integers
25 (number)	Integers, Square numbers
Passo de Camaragibe	Cities in Alagoas
Radlin	Towns in Poland
Particle size (general)	Chemistry
Chichester	Settlements in West Sussex, Cities in England
Admontite	Minerals
Hydrology	Water, Earth sciences
Semicircle	Shapes
Hurricane Camille	1969 Atlantic hurricane season, Category 5 Atlantic hurricanes, Retired tropical cyclone names, Deadly storms, Hurricanes in the United States, 1960s in Cuba, 1969 in the United States, 20th century in Alabama, 20th century in Mississippi, 1960s in Louisiana
1935 Labor Day Hurricane	1935 in the United States, Category 5 Atlantic hurricanes, Hurricanes in the United States, 20th century in the Bahamas, 20th century in Florida, 20th century in Georgia (U.S. state), 20th century in South Carolina, 1930s in North Carolina, 20th century in Virginia
Vahan Totovents	Armenian writers, Armenian poets, 1893 births, 1938 deaths
Leonid Azkaldian	1942 births, 1992 deaths, Armenian military people, Physicists, People from Tbilisi
Central United States	Regions of the United States
International Committee of the Red Cross	Red Cross, Charities, 1863 establishments
Meridian, Mississippi	County seats in Mississippi, Cities in Mississippi, 1854 establishments in the United States, 19th-century establishments in Mississippi
Hydrometeorological Prediction Center	Meteorology
Côte-Nord	Regions of Quebec
Saguenay-Lac-Saint-Jean	Regions of Quebec
Plaquemines Parish, Louisiana	1807 establishments in the Territory of Orleans
Naiad (moon)	Neptune's moons
Tamsui	Settlements in Taiwan
Lovisa Aarberg	1803 births, 1860s deaths, Swedish scientists, People from Uppsala
Kisamor	1788 births, 1842 deaths, Swedish scientists
Amalia Lindegren	1814 births, 1891 deaths, Swedish painters
Thalassa (moon)	Neptune's moons
Bayerischer Rundfunk	German broadcasting companies, Munich
Circadian rhythm sleep disorder	Sleep disorders, Disability
Asian elephant	Elephants, Mammals of Asia
Karolina Bock	1792 births, 1872 deaths, Swedish actors, Swedish singers, Dancers
Lea Ahlborn	1826 births, 1897 deaths, Swedish artists, Printmakers
Hedda Hjortsberg	Swedish entertainers, Ballet dancers, Ballerinas, 1777 births, 1867 deaths
Despina (moon)	Neptune's moons
Chef	Chefs, Food-related occupations
St. Bernard Parish, Louisiana	Louisiana parishes, 1807 establishments in the Territory of Orleans
Slidell, Louisiana	Cities in Louisiana
St. Tammany Parish, Louisiana	1810 establishments in the United States, 19th-century establishments in Louisiana
Chewing gum	Candy
Herat	Cities in Afghanistan
Mobile, Alabama	County seats in Alabama, Cities in Alabama, 1700s establishments in the Thirteen Colonies, 1702 establishments
Relay race	Running
Bayou La Batre, Alabama	Cities in Alabama
Bay St. Louis, Mississippi	County seats in Mississippi, Cities in Mississippi
Waveland, Mississippi	Cities in Mississippi
Pass Christian, Mississippi	Cities in Mississippi
Long Beach, Mississippi	Cities in Mississippi, 1905 establishments in the United States
Gulfport, Mississippi	County seats in Mississippi, Cities in Mississippi
Gulfport-Biloxi-Pascagoula, Mississippi Combined Statistical Area	Mississippi
Gulfport-Biloxi metropolitan area	Mississippi
Biloxi, Mississippi	County seats in Mississippi, Cities in Mississippi, 1830s establishments in Mississippi, 1838 establishments in the United States
El Toro (roller coaster)	Six Flags Great Adventure, Roller coasters in New Jersey, Roller coasters by name, 2006 establishments in the United States, 2000s establishments in New Jersey
Galatea (moon)	Neptune's moons
Nguyen Hue	1753 births, 1792 deaths, Vietnamese people, Emperors and empresses
Mikoyan MiG-29	Soviet military aircraft, Indian military aircraft, Cold War
Emmy Rossum	1986 births, Living people, American movie actors, Actors from New York City
Bedouin	Ethnic groups in the Middle East, Ethnic groups in Africa
26 (number)	Integers
27 (number)	Integers
28 (number)	Integers
29 (number)	Integers, Prime numbers
31 (number)	Integers, Prime numbers
32 (number)	Integers
33 (number)	Integers
34 (number)	Integers
35 (number)	Integers
36 (number)	Integers, Square numbers
37 (number)	Integers, Prime numbers
Jewitchery	Paganism
Larissa (moon)	Neptune's moons
Borat Sagdiyev	Fictional characters introduced in 1996, Kazakhstani people, Comedy movie characters, Television characters
Dermatology	Dermatology
Maria Röhl	1801 births, 1875 deaths, Swedish artists, People from Stockholm
Basil Hume	1923 births, 1999 deaths, Benedictines, Cancer deaths in England, Cardinals of the Roman Catholic Church, English Roman Catholics, Monks, Order of Merit, People from Newcastle upon Tyne, Roman Catholic archbishops
Proteus (moon)	Neptune's moons
Nereid (moon)	Neptune's moons
38 (number)	Integers
39 (number)	Integers
41 (number)	Integers, Prime numbers
Ocean Springs, Mississippi	Cities in Mississippi
42 (number)	Integers
Gautier, Mississippi	Cities in Mississippi
Pascagoula, Mississippi	County seats in Mississippi, Cities in Mississippi
43 (number)	Integers, Prime numbers
44 (number)	Integers
Sonoma County, California	Sonoma County, California, 1850 establishments in California
45 (number)	Integers
46 (number)	Integers
Russian River	Rivers of California, Mendocino County, California, Sonoma County, California
47 (number)	Integers, Prime numbers
Halimede (moon)	Neptune's moons
Hurricane Katrina tornado outbreak	2005 in Florida, Hurricane Katrina, Tornado outbreaks, Tornadoes in the United States, 2005 in weather, August events, 2005 in Mississippi, 2005 in Alabama, 2000s in Georgia (U.S. state), 2000s in Virginia, 2005 in Pennsylvania
Square number	Square numbers, Number theory, Integer sequences
Miami-Dade County, Florida	Florida counties, 1836 establishments in the United States, 1830s establishments in Florida Territory
Broward County, Florida	Florida counties, 1915 establishments in the United States, 1910s establishments in Florida
Max Mayfield	American meteorologists, Scientists from Oklahoma City, 1948 births, Living people
Levee	Landforms
River delta	River deltas
Lockheed C-5 Galaxy	United States Air Force aircraft, Lockheed & Lockheed-Martin aircraft
Template (word processing)	Word processors
Hurricane Betsy	1965 in the United States, 1965 Atlantic hurricane season, Retired tropical cyclone names, Category 4 Atlantic hurricanes, Hurricanes, Hurricanes in the United States, 20th century in the Bahamas, 1960s in Florida, 1960s in Louisiana, Hurricanes in Louisiana
Houston Chronicle	Newspapers in the United States, Houston, Texas
Delta wing	Military aviation
Popular Mechanics	Science and technology magazines
Scientific American	Science and technology magazines, Monthly magazines
The Times-Picayune	Newspapers in the United States, New Orleans, Louisiana
Poultry	Poultry
Gas station	Transport, Fuel
Warehouse	Manufacturing buildings
Nursery (horticulture)	Agriculture, Plants
Credit union	Money
Tettigoniidae	Orthoptera
Bills, Bills, Bills	Destiny's Child songs, 1999 songs
Anna Maria Thelott	1683 births, 1710 deaths, Swedish artists, Engravers, People from Uppsala, Illustrators
Justina Casagli	Swedish singers, Swedish actors, 1794 births, 1841 deaths
48 (number)	Integers
49 (number)	Integers, Square numbers
Cynthia Lennon	1939 births, 2015 deaths, Cancer deaths in Spain, John Lennon, People from Blackpool, People from Cheshire, The Beatles
51 (number)	Integers
53 (number)	Integers, Prime numbers
52 (number)	Integers
54 (number)	Integers
55 (number)	Integers
Mandrill	Old World monkeys, Mammals of Africa
Carburization	Metallurgy, Metals
56 (number)	Integers
Sao (moon)	Neptune's moons
Dresden University of Technology	1828 establishments in Europe, 19th century establishments in Germany, Dresden, Technical colleges and universities in Germany
57 (number)	Integers
58 (number)	Integers
59 (number)	Integers, Prime numbers
Laomedeia (moon)	Neptune's moons
Tropical Storm Jerry (2007)	Atlantic tropical storms
Jenner, California	Settlements in Sonoma County, California, Cities in California
Tropical Storm Ingrid (2007)	Atlantic tropical storms
61 (number)	Integers, Prime numbers
67 (number)	Integers, Prime numbers
Psamathe (moon)	Neptune's moons
62 (number)	Integers
63 (number)	Integers
64 (number)	Integers, Square numbers
65 (number)	Integers
66 (number)	Integers
Tropical Upper Tropospheric Trough	Tropical cyclones, Meteorology
Leeward Islands	Caribbean islands
68 (number)	Integers
69 (number)	Integers
Saint Martin	Saint Martin
Antigua	Caribbean islands, Geography of Antigua and Barbuda
Tropical Storm Melissa (2007)	2007 Atlantic hurricane season, Atlantic tropical storms, September events
71 (number)	Integers, Prime numbers
Neso (moon)	Neptune's moons
Weather front	Meteorology
Subtropical ridge	Meteorology, Tropical cyclones
Vorticity	Fluid mechanics
Barbuda	Caribbean islands, Geography of Antigua and Barbuda
Émile Durkheim	1858 births, 1917 deaths, 19th century philosophers, 20th century philosophers, Agnostics, European anthropologists, French atheists, French philosophers, French socialists, French sociologists, Jewish atheists, Jewish French academics, Jewish French scientists, Jewish French writers, Jewish philosophers, People from Grand Est
Popcorn	Snack foods
Douglas SBD Dauntless	United States Navy aircraft, Douglas aircraft, United States Marine Corps aircraft, French military aircraft, World War II American aircraft
John Bardeen	1908 births, 1991 deaths, American engineers, American Nobel Prize winners, American physicists, People from Madison, Wisconsin, Scientists from Wisconsin, Theoretical physicists
Reconnaissance	Military
Cape Verde-type hurricane	Tropical cyclones
Windward Islands	Caribbean islands
List of professional wrestlers	Lists of professional wrestlers
Birth certificate	Identification documents
Vital record	Documents
Tzitzernavank Monastery	Monasteries, Armenian Apostolic Churches, Nagorno-Karabakh Republic
Hérens (district)	Districts of Valais
Leuk (district)	Districts of Valais
Martigny (district)	Districts of Valais
Mariner 10	Mariner program, Venus (planet)
Fender	American music companies, Musical instrument companies
Myra	Ancient history
Metis (moon)	Jupiter's moons
Goblin Valley State Park, Utah	Goblin Valley State Park, Utah, State parks in the United States
European Article Number	Everyday life, Barcodes
Carrefour, Haiti	Haiti
Mochi (food)	Rice
Donkey Kong (video game)	1981 video games, Nintendo Entertainment System games, Mario platform games, Atari 2600 games, Apple II games, Commodore 64 games, Famicom Disk System games, Game Boy Advance games, Donkey Kong
Léogâne	Cities in Haiti
Atlantic Beach, Florida	Cities in Florida, 1926 establishments in the United States, 1920s establishments in Florida
Pity	Emotions
First ascent	Rock climbing
ZIP code	Postal codes, United States Postal Service
Eastern European Time	Time zones
Tom Clancy	1947 births, 2013 deaths, American screenwriters, Deaths from heart failure, Disease-related deaths in the United States, Republicans (United States), Writers from Baltimore, Maryland
Mount Thor	Mountains of Canada, Nunavut
Waluigi	Fictional characters introduced in 2000, Mario series characters
Alexander von Humboldt	1769 births, 1859 deaths, People from Berlin, Explorers, European geographers, Naturalists
Nike, Inc.	1964 establishments in the United States, American clothing companies, Footwear, Oregon
Pound sterling	British currency
Vestfold	Former counties of Norway
Buskerud	Former counties of Norway
Telemark	Former counties of Norway
Akershus	Former counties of Norway
West Highland White Terrier	Terriers
Soldier (song)	Destiny's Child songs, 2004 songs
Abrasion	Medical signs
Wear (erosion)	Materials science
Compacted oxide layer glaze	Materials
Wound	Medical emergencies
Chick Corea	American composers, American pianists, American jazz musicians, Grammy Award winners, Musicians from Massachusetts, 1941 births, 2021 deaths, Cancer deaths in Florida
Monthey (district)	Districts of Valais
Raron (district)	Former districts of Switzerland, Districts of Valais
Street children	Human issues, Children
Saint-Maurice (district)	Districts of Valais
Sierre (district)	Districts of Valais
Sion (district)	Districts of Valais
Visp (district)	Districts of Valais
Steckborn (district)	Former districts of Thurgau

