Death of Mario Gonzalez	2021 in California, Deaths by person in the United States, Filmed killings by law enforcement, People killed by law enforcement officers in the United States
Charuplaya tree frog	Frogs, Animals of South America
2032 Summer Olympics	2032, 21st century in sports, Summer Olympic Games, 21st century in Australia, Brisbane
The Gabba	1890s establishments in Australia, 1895 establishments, Brisbane, Sports buildings in Australia, Stadiums
Doctor Strange in the Multiverse of Madness	2022 movies, English-language movies, Marvel Cinematic Universe movies, 2020s superhero movies
William Carlos Williams	American poets
Castellammare di Stabia	Cities in Campania
Afragola	Cities in Campania
Alpine musk deer	Deer, Mammals of Asia
Redneck (movie)	1973 crime movies, 1973 thriller movies, British crime movies, British thriller movies, Italian thriller movies, Movies directed by Silvio Narizzano
Dane Boedigheimer	1979 births, Living people, Actors from Minnesota, Singers from Minnesota
Morehead City, North Carolina	Towns in North Carolina, Carteret County, North Carolina
Bento Rodrigues dam disaster	Disasters, Brazil
Detroit Symphony Orchestra	American culture, 1887 establishments, Musical groups from Detroit, Michigan, 1914 establishments in the United States, American orchestras
Bikini contest	Swimwear, Beauty pageants
Kernersville, North Carolina	Towns in North Carolina
Hakama	Japanese clothing
Holbeck	Leeds
Barco	1934 establishments in Europe, Technology companies of Europe
Matthews, North Carolina	Towns in North Carolina
Monkey on My Back (movie)	1957 movies, American biographical movies, Movies directed by Andre DeToth
Ahvaz	Cities in Iran
The Patriot (wrestler)	1961 births, 2021 deaths, Deaths from myocardial infarction, American professional wrestlers, American football players, Sportspeople from South Carolina, People from Columbia, South Carolina
Desmond O'Malley	1939 births, 2021 deaths, Irish politicians, Irish writers, People from Limerick
Peanut oil	Peanuts, Cooking oils
Boniface Alexandre	Presidents of Haiti, 1936 births, Living people
Corn oil	Maize, Cooking oils
Juan Vital Sourrouille	1940 births, 2021 deaths, Deaths from colorectal cancer, Argentine politicians, Argentine economists, People from Buenos Aires
Bobby Jennings	1975 births, Living people, American YouTubers, American voice actors, American writers, American producers
The Disputed Vote of Mr. Cayo	1986 movies, Spanish movies, Movies directed by Antonio Giménez-Rico
A Year of the Quiet Sun	1984 drama movies, 1984 romance movies, 1980s romantic drama movies, 1980s war movies, Polish movies, Italian romance movies, Italian drama movies, German romance movies, German drama movies, World War II movies, Movies directed by Krzysztof Zanussi
Ash Wednesday (1973 movie)	1973 drama movies, 1970s mystery movies, American mystery movies, American drama movies, Movies directed by Larry Peerce
Stealing Heaven	1988 drama movies, 1988 romance movies, 1980s romantic drama movies, British romantic drama movies, Serbian movies, Movies based on books, Movies directed by Clive Donner
IJustine	1984 births, Living people, American YouTubers, Actors from Pittsburgh, Pennsylvania
Blackmail (1939 movie)	1939 movies, 1930s crime movies, 1930s drama movies, American crime drama movies, Movies directed by H. C. Potter
Kevin Brueck	1978 births, Living people, American YouTubers, American voice actors
Biggles (movie)	1986 science fiction movies, 1980s adventure movies, 1980s family movies, 1980s war movies, British science fiction movies, British adventure movies, British war movies, American science fiction movies, American war movies, American adventure movies, Movies based on books, Movies directed by John Hough, World War I movies
Big business	Controversies, Business
Dragon Spyware	Hacking in the 2021s, Malware toolkits, IOS malware, Espionage scandals and incidents, Spyware
Boana curupi	Frogs, Animals of South America
Netsuke	Japanese culture
Kintsugi	Japanese culture, Ceramics
Free Britney movement	Internet culture, Controversies, Britney Spears, 2008 establishments in the United States
Skytech	Aircraft companies, Companies of Europe, 1989 establishments in Europe
Janssen Pharmaceuticals	Companies of Europe
Conservatorship	Legal terms
Chink (slur)	Pejoratives, English profanity, Slurs
Dick (slang)	Sexual slang, English profanity, Profanity
Willy (slang)	Slang
Paki	Pejoratives, English profanity, Slurs
Bloody hell	English profanity
Texaco	Companies based in Texas, Companies based in California, American technology companies, 1902 establishments in the United States, 20th-century establishments in Texas
List of slang words referring to the penis	Slang, Language-related lists
Ho	English profanity, Profanity, Pejoratives, Prostitution
Humping	Sexual slang
The Haunted Mansion (movie)	1999 comedy movies, 1990s fantasy-comedy movies, 1990s ghost movies, American horror movies, Disney movies, English-language movies, Movies about dysfunctional families, Movies set in Louisiana, American black comedy movies, American children's comedy movies, American fantasy-comedy movies, Zombie movies
Balinese language	Languages of Asia, Bali
Grog	Slang
My nigga	English profanity, Profanity, Slang
Fugly	English profanity, Profanity, Slang
Intonation (speech)	Linguistics, Pronunciation
Fudge (expression)	Slang, Slang words meaning fuck
Frig	Slang words meaning fuck
Fiddlesticks	Slang words meaning fuck
Fiddle sticks	Slang words meaning fuck
Puppet theatre	Puppets, Theatres
Ruski	English profanity, Slurs
Wigga	English profanity, Pejoratives
The War of the Roses (movie)	1980s black comedy movies, American movies, American black comedy movies, English-language movies, Movies directed by Danny DeVito, 20th Century Fox movies, Movies about divorce, 1989 comedy movies
Frankenstein 90	1984 comedy movies, French comedy movies, Movies directed by Alain Jessua
Savage Steve Holland	1958 births, American screenwriters, American animators, American television directors, American television producers, American television writers, American voice actors, Living people, American cartoonists
Beach volleyball	Volleyball, Team sports
Alexander Williams (cartoonist)	Animators, 1967 births, Artists from London, Living people, People educated at Westminster School, London, Cartoonists, Comics artists
Honey Bunny In Crazy Crazy Chase	Action comedy movies
Google Docs Editors	Google
André Silva (footballer, born 1995)	1995 births, Living people, Portuguese footballers, Association football forwards, A.C. Milan players, 2018 FIFA World Cup players
Indian Trail, North Carolina	Towns in North Carolina
Post-punk	Music genres
Maile Flanagan	1965 births, LGBT people, American voice actors, American actor stubs
Hikimayu	Japanese culture
Bunraku	Japanese culture, Puppets, Theatres
Midland, North Carolina	Towns in North Carolina
Ousmane Dembélé	1997 births, French footballers, Association football forwards, 2018 FIFA World Cup players, Living people
Vernon, Eure	Communes in Eure
Alonsotegi	Municipalities in the Basque Country
IParty with Victorious	2011 television episodes, Nickelodeon
Bernardo Silva	1994 births, Portuguese footballers, Association football midfielders, Manchester City F.C. players, Premier League players, 2018 FIFA World Cup players, Sportspeople from Lisbon, Living people
Political corruption	Politics, Economic systems, Controversies
Oviraptoridae	Dinosaurs
Presnel Kimpembe	1995 births, French footballers, People from the Democratic Republic of the Congo, Association football defenders, 2018 FIFA World Cup players, Living people
Beaumont-sur-Oise	Communes in Val-d'Oise
Mating system	Biology
Central Asian red deer	Deer, Mammals of Asia
Arenysaur	Dinosaurs
Ajnabia	Dinosaurs
Akainacephalus	Dinosaurs
Guard mounting	Military, Ceremonies
Plaza de Oriente	Madrid, Town squares
Kīlauea, Hawaii	Census-designated places in Kauai County, Hawaii
Shipwrecking	Shipwrecks, Nautical terminology
Lil Rel Howery	1979 births, Living people, American comedians, American actors
Michael Yarmush	1982 births, Living people, Actors from Miami, Florida
Rotten Ralph	1976 books, Children's books, 1998 British television series debuts, 1998 American television series debuts, 2001 American television series endings, 1990s animated television series, 2000s animated television series
Red Sorghum	1987 romance movies, 1987 drama movies, 1980s romantic drama movies, Chinese movies, Movies based on books, Movies directed by Zhang Yimou
Sagging (fashion)	Trousers and shorts, Clothing controversies
Lahmacun	Turkish food, Middle Eastern foods
Zōri	Japanese clothing
Daniel Kelley (hacktivist)	1997 births, Living people, British people
Roxanne Ducharme	Living people, People from Los Angeles, California, 1964 births
Lamezia Terme	Cities in Calabria
Legnano	Cities in Lombardy
Cerignola	Cities in Apulia
Molfetta	Cities in Apulia
Velletri	Cities in Lazio
Days of Youth	1929 movies, 1920s comedy movies, Silent movies, Japanese movies, Movies directed by Yasujirō Ozu
La Traviata (1983 movie)	1983 movies, 1980s musical movies, Italian movies, Dutch movies, Universal Pictures movies, Movies directed by Franco Zeffirelli
COVID-19 pandemic in Andorra	COVID-19 pandemic by country, Andorra
Bucharest Non Stop	2015 comedy-drama movies, Romanian movies, Movies directed by Dan Chișu
Pak Watan	National symbols of Pakistan, National personifications
Hajji	Muslims
Prime Minister of South Ossetia	Prime Ministers of South Ossetia
Gennady Bekoyev	1981 births, Living people, Prime Ministers of South Ossetia
Aleksandr Shavlokhov	1939 births, Living people, Prime Ministers of South Ossetia
Boris Chochiev	1957 births, 2021 deaths, Prime Ministers of South Ossetia, Deaths from the COVID-19 pandemic
Hamzanama	Poems, National symbols of Pakistan, Pakistani culture
President of South Ossetia	Presidents of South Ossetia
Eduard Kokoity	1964 births, Living people, Presidents of South Ossetia
Vadim Brovtsev	1969 births, Living people, Presidents of South Ossetia, Prime Ministers of South Ossetia
Leonid Tibilov	1951 births, Living people, Presidents of South Ossetia
Yi Yi	2000 drama movies, Taiwanese movies, Japanese movies, Movies directed by Edward Yang
Anatoly Bibilov	1970 births, Living people, Presidents of South Ossetia, Current national leaders
John Cornell	Australian movie producers, Australian movie directors, Australian television actors, Deaths from Parkinson's disease, Australian screenwriters, 1941 births, 2021 deaths, Australian businesspeople, Actors from Western Australia
Alfred Biolek	1934 births, 2021 deaths, German entertainers, Television producers, German academics, German businesspeople
COVID-19 pandemic in Samoa	COVID-19 pandemic by country, Samoa
Mike Smith (football manager)	1937 births, 2021 deaths, English footballers, English football managers
Caril Ann Fugate	People from Lincoln, Nebraska, American people convicted of murder, 1943 births, Living people
212 Warrior	2018 comedy movies, 2010s action movies, 2010s fantasy movies, Indonesian movies, Movies based on books, 20th Century Fox movies, Movies directed by Angga Dwimas Sasongko
Greg Knapp	1963 births, 2021 deaths, Road accident deaths in California, American football coaches, Sportspeople from Louisiana, People from Baton Rouge, Louisiana
Jean-Pierre Jaussaud	1937 births, 2021 deaths, 24 Hours of Le Mans drivers, Deaths from myocardial infarction, Cardiovascular disease deaths in France, People from Caen
Los Bracitos tree frog	Frogs, Animals of South America
Rahul Gupta	1970s births, Living people, American physicians, Politicians from Washington, D.C., Politicians from West Virginia, US Democratic Party politicians
Summerville, South Carolina	Towns in South Carolina
St. George, South Carolina	Towns in South Carolina, County seats in South Carolina
Malagasy cuisine	Madagascar
Papilio polyctor	Butterflies, National symbols of Pakistan
Dropping out	Society, Human behavior, Education
Daniel Brochu	1980 births, Living people, Actors from Montreal
Mint Hill, North Carolina	Towns in North Carolina
Thinhorn sheep	Caprids, Mammals of North America
Shallotte, North Carolina	Towns in North Carolina
Newport, North Carolina	Towns in North Carolina, Carteret County, North Carolina
Single parent	Social sciences, Personal life, Family, Controversies, Children
Dall sheep	Caprids, Mammals of North America
Elisabeth Falkhaven	Living people, 1955 births, Swedish politicians
Waiting for the Sea	2012 drama movies, Russian movies, Ukrainian movies, Belgian movies, French drama movies, Kazakhstani movies, German drama movies, Tajik movies, Movies directed by Bakhtyar Khudojnazarov
Sherwood Schwartz	1916 births, 2011 deaths, Television producers, People from Passaic, New Jersey
The Family Jewels (movie)	1965 comedy movies, American comedy movies, Movies directed by Jerry Lewis, Paramount movies
Lock Haven, Pennsylvania	County seats in Pennsylvania, Cities in Pennsylvania, 1833 establishments in the United States
Morrisville, North Carolina	Towns in North Carolina, Durham County, North Carolina, Wake County, North Carolina
Mount Pleasant, North Carolina	Towns in North Carolina
Smithfield, North Carolina	Towns in North Carolina, County seats in North Carolina
Winterville, North Carolina	Towns in North Carolina
Papilio bianor	Butterflies, Asia
Taylorsville, North Carolina	Towns in North Carolina, County seats in North Carolina
Thilo Kehrer	1996 births, German footballers, Association football defenders, Sportspeople from Baden-Württemberg, Living people
Life Is a Miracle	2004 comedy-drama movies, 2000s musical movies, 2000s war movies, Serbian movies, Montenegrin movies, French comedy movies, French drama movies, Italian comedy movies, Italian drama movies, Movies directed by Emir Kusturica
Mayor of Tower Hamlets	Mayors
Vanquish (movie)	2021 movies
Yungas tree frog	Frogs, Animals of South America
Vanquish (video game)	2010 video games, Action video games, PlayStation 3 games, PlayStation 4 games, Sega video games, Video games developed in Japan, Windows games, Xbox 360 games, Xbox One games
Snow sheep	Caprids, Mammals of Asia
The Kansan (movie)	1943 movies, 1940s western movies, American western movies, Movies directed by George Archainbaud
She's the One (1996 movie)	1996 comedy movies, 1996 romance movies, 1990s romantic comedy movies, American romantic comedy movies, 20th Century Fox movies, Movies directed by Edward Burns
Jack of Diamonds (1967 movie)	1967 crime movies, 1967 drama movies, American crime drama movies, German drama movies, MGM movies, Movies directed by Don Taylor
Skite (album)	1978 albums
Taothingmang	History of Manipur, Kings of Ancient Manipur
Mickey Levy	1951 births, Living people, Israeli businesspeople, Israeli Jews, Jewish Israeli politicians, Yesh Atid politicians
Vice Squad (1953 movie)	1953 movies, 1950s crime movies, American crime movies, Movies based on books, Movies directed by Arnold Laven
Brannigan (movie)	1975 movies, 1970s action movies, 1970s thriller movies, British action movies, British thriller movies, American action movies, American thriller movies, Movies directed by Douglas Hickox
Blind Date (1984 movie)	1984 movies, 1980s erotic movies, 1980s thriller movies, Greek movies, Liechtenstein movies, American thriller movies, British thriller movies, Movies directed by Nico Mastorakis‏‎
List of national mottos	Mottos, Lists, Phrases, Lists of countries
Cairo International Stadium	20th-century establishments in Egypt, 1960 establishments, Football stadiums in Egypt, Buildings and structures in Cairo
30 June Stadium	Football stadiums in Egypt, Buildings and structures in Cairo
Borg El Arab Stadium	Football stadiums in Egypt
Organic acid	Organic compounds
Femen	Activism
Klaybow Films	1981 establishments in the United Kingdom, 1991 disestablishments, British animation studios
Rashid Rauf	1981 births, 2008 deaths
2021 Henan floods	2021 disasters, 2021 in Asia, 2020s disasters in Asia, 2020s floods, 2020s in China, Floods in Asia, July 2021 events
Tuomo Ylipulli	1965 births, 2021 deaths, Finnish Olympians, Olympic gold medalists, Skiers
Marshall Applewhite	1931 births, 1997 deaths, Drug-related deaths in the United States, American teachers, Writers from Texas
Jeremy Gelbwaks	1961 births, Living people, Actors from Los Angeles, California
Rancho Santa Fe, California	Census-designated places in California, Settlements in San Diego County, California
David Reimer	1965 births, 2004 deaths, Suicides by firearm, American activists, Twin people from Canada, Transgender and transsexual people, People from Winnipeg, Suicides in Canada
John and Lorena Bobbitt	1967 births, 1969 births, Living people, Couples, People acquitted of rape, American crime victims, American pornographic actors, Actors from Las Vegas, Nevada, Actors from Virginia, Ecuadorian people, Actors from Buffalo, New York
National personification	National personifications, Symbols
Idris of Libya	Heads of state of Libya, 1890 births, 1980 deaths
Sheldon Lee Glashow	1932 births, Living people, American physicists, American academics, Scientists from New York City, Writers from New York City
Steven Weinberg	1933 births, 2021 deaths, American atheists, American physicists, Columbia University faculty, Cornell University alumni, Democrats (United States), Harvard University faculty, Jewish American academics, Jewish American scientists, Jewish American writers, Jewish atheists, Jewish Nobel Prize winners, Massachusetts Institute of Technology faculty, Princeton University alumni, Scientists from New York City, Scientists from Texas, Theoretical physicists, University of California, Berkeley faculty, Writers from Austin, Texas, Writers from New York City, Zionists
Louise Weinberg	1932 births, Living people, American academics, American lawyers, Writers from New York City, American critics, Writers from Austin, Texas
Jerome Isaac Friedman	1930 births, Living people, American physicists, American academics, American atheists, Jewish American scientists, Jewish American academics, Jewish American writers, Scientists from Chicago, Writers from Chicago
Henry Way Kendall	1926 births, 1999 deaths, Deaths by drowning, American physicists, American academics, Scientists from Boston, Massachusetts, Writers from Boston, Massachusetts
Amherst College	Colleges and universities in Massachusetts
Creedmoor, Texas	Cities in Texas
Jonestown, Texas	Cities in Texas
Lakeway, Texas	Cities in Texas
Alfred Loewenstein	1877 births, 1928 deaths, Deaths from falls, Belgian businesspeople, Bankers, People from Brussels, Deaths by drowning
Leonard, Texas	Cities in Texas
Tsung-Dao Lee	1926 births, Living people, Naturalized citizens of the United States, Chinese scientists, Chinese academics, American academics, American physicists, People from Shanghai
COVID-19 pandemic in Vanuatu	COVID-19 pandemic by country, Vanuatu
Shin'ichirō Tomonaga	1906 births, 1979 deaths, Deaths from throat cancer, Japanese physicists, Scientists from Tokyo
Samuel C. C. Ting	1936 births, Living people, Chinese scientists, American physicists, Scientists from Michigan, People from Ann Arbor, Michigan
Arno Allan Penzias	1933 births, Living people, German physicists, Naturalized citizens of the United States, American physicists, German astronomers, American astronomers, Scientists from New York City, People from Munich
Pyotr Kapitsa	1894 births, 1984 deaths, Russian physicists, Russian engineers, People from Moscow
William Alfred Fowler	1911 births, 1995 deaths, Deaths from renal failure, American astronomers, American physicists, Scientists from Pittsburgh, Pennsylvania
Manor, Texas	Cities in Texas
Carlo Rubbia	1934 births, Living people, Italian physicists, Italian academics, Inventors
Klaus von Klitzing	1943 births, Living people, German physicists, German academics
Ernst Ruska	1906 births, 1988 deaths, German physicists
Gerd Binnig	1947 births, Living people, German physicists, People from Frankfurt
Georg Bednorz	1950 births, Living people, German physicists
Russell Alan Hulse	1950 births, Living people, American physicists, American academics, Scientists from New York City, Scientists from Dallas, Texas
Joseph Hooton Taylor Jr.	1941 births, Living people, American astronomers, American physicists, American academics, Scientists from Philadelphia, Pennsylvania
Frederick Reines	1918 births, 1998 deaths, American physicists, Scientists from New Jersey, People from Paterson, New Jersey
Clyde Cowan	1919 births, 1974 deaths, Deaths from myocardial infarction, American physicists, Scientists from Detroit, Michigan
David Lee (physicist)	1931 births, Living people, American physicists, American academics, Scientists from New York City
Robert Coleman Richardson	1937 births, 2013 deaths, American physicists, Scientists from Washington, D.C.
Douglas Osheroff	1945 births, Living people, American physicists, Scientists from Washington, People from Aberdeen, Washington
Claude Cohen-Tannoudji	1933 births, Living people, Algerian people, French physicists
William Daniel Phillips	1948 births, Living people, American physicists, American academics, Scientists from Pennsylvania, People from Wilkes-Barre, Pennsylvania
Robert B. Laughlin	1950 births, Living people, American physicists, American academics, Scientists from Berkeley, California
Hijackers in the September 11 attacks	September 11 attacks
Horst Ludwig Störmer	1949 births, Living people, German physicists, American physicists, Naturalized citizens of the United States, Scientists from New York City, People from Frankfurt
Daniel C. Tsui	1939 births, Living people, Chinese scientists, American physicists, Scientists from New Jersey, People from Princeton, New Jersey, Chinese academics, American academics
John E. Walker	1941 births, Living people, British chemists, People from West Yorkshire
Bertram Brockhouse	1918 births, 2003 deaths, Canadian physicists, People from Alberta
Clifford Shull	1915 births, 2001 deaths, American physicists, American academics, Scientists from Pittsburgh, Pennsylvania
John Hasbrouck Van Vleck	1899 births, 1980 deaths, American physicists, American academics, Scientists from Connecticut
Nevill Francis Mott	1905 births, 1996 deaths, British academics, British physicists, People from Leeds
Brian Forster	1960 births, Living people, American child actors
Crónicas	2004 movies, 2000s thriller movies, Ecuadorian movies, Mexican movies
Favria	Settlements in Piedmont
Intelligence and Security Committee	Government of the United Kingdom, National security, 1994 establishments in the United Kingdom
No Exit (1930 movie)	1930 movies, 1930s comedy movies, 1930s romance movies, British romantic comedy movies, Warner Bros. movies, Movies directed by Charles Saunders
Quart, Aosta Valley	Settlements in Valle d'Aosta
Boana bandeirantes	Frogs, Animals of South America
Senate of Virginia	Politics of Virginia, State upper houses in the United States
Jacobin pigeon	National symbols of India, Doves, Columbiformes, Indian culture
Virginia House of Delegates	Politics of Virginia, State lower houses in the United States
Pamela Adlon	1966 births, Living people, Actors from New York City, Naturalised citizens of the United Kingdom
Blacula	1972 horror movies, 1970s fantasy movies, American fantasy movies, American horror movies, Blaxploitation movies
United Airlines Flight 328	2021 in the United States
Avianca Flight 203	Aviation disasters in the 1980s
George Abbott	1887 births, 1995 deaths, Deaths from stroke, American centenarians, American theatre directors, Theatre producers, American playwrights, Movie directors from New York City, Movie producers from New York City, Screenwriters from New Jersey, Tony Award winners, Drama Desk Award winners, Pulitzer Prize winners
Orlando Drummond	1919 births, 2021 deaths, Brazilian comedians, Brazilian movie actors, Brazilian television actors, Brazilian stage actors, People from Rio de Janeiro, Voice actors, Centenarians
West Springfield, Virginia	Census-designated places in Virginia
Henry Danton	1919 births, Living people, British centenarians, British dancers, British teachers, People from Bedford, British stage actors
Yuriko (dancer)	1920 births, Living people, American dancers, American choreographers, Actors from California, People from San Jose, California, American centenarians
Herbert Köfer	1921 births, 2021 deaths, German centenarians, German comedians, German television presenters, German movie actors, German television actors, German stage actors, Actors from Berlin
Goochland, Virginia	County seats in Virginia, Census-designated places in Virginia
Glenn Youngkin	1966 births, Living people, Politicians from Virginia, Harvard University alumni
2019 Virginia House of Delegates election	2019 in the United States, Elections in the United States, Politics of Virginia
Transair Flight 810	2021 in the United States
John Byner	1938 births, Living people, American movie actors, American television actors, American stage actors, American voice actors, Comedians from New York City, Actors from New York City
Villeparisis	Communes in Seine-et-Marne
Ridgecrest, California	Cities in California, Settlements in Kern County, California
Corbeil-Essonnes	Communes in Essonne
Franconville, Val-d'Oise	Communes in Val-d'Oise
Le Tampon	Communes in Réunion
Saint-André, Réunion	Communes in Réunion
Gulf of Kutch	Geography of India
Maria Full of Grace	2004 drama movies, Colombian movies, Ecuadorian movies, American drama movies, Movies directed by Joshua Marston
In the Name of the Girl	2011 comedy-drama movies, Ecuadorian movies
Rhêmes-Notre-Dame	Settlements in Valle d'Aosta
Rhêmes-Saint-Georges	Settlements in Valle d'Aosta
Roisan	Settlements in Valle d'Aosta
Wyoming Mail	1950 movies, 1950s western movies, American western movies, Movies directed by Reginald Le Borg
Saint Piran	400s births, 5th century deaths, British priests, British Roman Catholics, Christian saints, Roman Catholic bishops, Roman Catholic priests
Muslim saints	Saints, Muslims, Religion-related lists
Transgender Persons (Protection of Rights) Act, 2018	Politics of Pakistan, 2010s in Pakistan, 2018 in Asia
Américo Tomás	1894 births, 1987 deaths, Deaths from surgical complications, Presidents of Portugal, Portuguese military people, Generals
Lake Biwa	Lakes of Japan, Shiga Prefecture
Francisco Craveiro Lopes	1894 births, 1964 deaths, People from Lisbon, Portuguese military people, Presidents of Portugal, Generals
List of presidents of Portugal	Presidents of Portugal
Francisco da Costa Gomes	1914 births, 2001 deaths, Presidents of Portugal
Óscar Carmona	1869 births, 1951 deaths, People from Lisbon, Portuguese military people, Presidents of Portugal, Prime Ministers of Portugal
List of prime ministers of Portugal	Prime Ministers of Portugal
COVID-19 pandemic in Belize	COVID-19 pandemic by country, 21st century in Belize
COVID-19 pandemic in Saint Lucia	COVID-19 pandemic by country, Saint Lucia
Augusto Santos Silva	1956 births, Living people, Portuguese politicians, Portuguese scientists, Sociologists, Academics
Khui Ningomba	Kings of Ancient Manipur
2021 Virginia House of Delegates election	2021 in the United States, Elections in the United States, Politics of Virginia
Ornate tree frog	Frogs, Animals of South America
Ningthou Kangbalon	Puya
Nexus 7 (2013)	Google Nexus
Tingo International Holdings	Technology companies
Nexus 6	Mobile phones released in 2010s, Nexus mobile phones
Nexus 9	Google Nexus
Democratic Party of Virginia	Virginia
Senneville, Quebec	Settlements in Quebec
Saint-Christophe, Aosta Valley	Settlements in Valle d'Aosta
Nueve (Mexican TV network)	Television networks, 1960s establishments in Mexico
High School of Montreal	Schools in Canada
Saint-Denis, Aosta Valley	Settlements in Valle d'Aosta
Elaine Taylor (actress)	1943 births, Living people, English movie actors, English television actors, English stage actors, Actors from Hertfordshire
Saint-Marcel, Aosta Valley	Settlements in Valle d'Aosta
Amanda Plummer	Tony Award winning actors, 1957 births, Living people, American movie actors, American television actors, American stage actors, American voice actors, Actors from New York City, Emmy Award winning actors, Drama Desk Award winners, Saturn Award winners
Saint-Nicolas, Aosta Valley	Settlements in Valle d'Aosta
Cyrano (musical)	Musicals
Iago	Fictional criminals
Saint-Oyen, Aosta Valley	Settlements in Valle d'Aosta
Hamlet at Elsinore	1964 movies
Barrymore (play)	Plays
Triple Crown of Acting	Awards
Saint-Pierre, Aosta Valley	Settlements in Valle d'Aosta
Stage Struck (1958 movie)	1958 drama movies, American drama movies, Movies directed by Sidney Lumet
Wind Across the Everglades	1958 drama movies, American drama movies, Movies directed by Nicholas Ray
Newland, North Carolina	Towns in North Carolina, County seats in North Carolina
Georg von Trapp	1880 births, 1947 deaths, Military personnel of World War I
Elaine Luria	Virginia
Waterloo (1970 movie)	Epic movies, War movies
The Exception	2016 romance movies, 2016 drama movies, 2010s romantic drama movies, 2010s war movies, British romantic drama movies, British war movies, American romantic drama movies, American war movies
The Insider (movie)	1999 drama movies, American drama movies, Movies directed by Michael Mann
J.B. (play)	Pulitzer Prize winners, Plays
No Man's Land (play)	Plays
Inherit the Wind (play)	Plays
The Thorn Birds (miniseries)	1983 television series debuts, Miniseries
Scott Taylor (politician)	Republicans (United States), Politicians from Virginia, Living people, 1979 births, United States Navy, Harvard University alumni
Madeline (TV series)	1993 television series debuts, 2001 television series endings
Our Fathers (movie)	2005 movies
Queen Elizabeth II Silver Jubilee Medal	Awards
125th Anniversary of the Confederation of Canada Medal	Awards
Queen Elizabeth II Golden Jubilee Medal	Awards
Queen Elizabeth II Diamond Jubilee Medal	Awards
Transcendental idealism	Philosophy
Departure (TV series)	Canadian television series, 2019 television series debuts
Christopher Plummer filmography	Filmographies
Subtle body	Esotericism, Hinduism, Spirituality
The Last Full Measure (2019 movie)	2019 drama movies, 2010s war movies, American drama movies, American war movies
Kangjeirol	Puya
Mike Wallace	People from Brookline, Massachusetts, American journalists, American television actors, 1918 births, 2012 deaths, American television personalities, American game show hosts, actors from Massachusetts
Al dente	Cooking
Eka Tkeshelashvili	1977 births, Living people, United National Movement (Georgia) politicians, Government ministers of Georgia (country), Jurists
Koushik Das	1998 births, Living people, Indian businesspeople
Emakimono	Japanese culture
Princess Victoria of Hesse and by Rhine	1863 births, 1950 deaths, Princes and princesses
Northwest Airlines Flight 5 (1990)	1990 in the United States
Member states of the Commonwealth of Nations	Commonwealth of Nations
Minneapolis−Saint Paul International Airport	Airports in Minnesota
Montevideo–Chippewa County Airport	Airports in Minnesota
Red Scorpion	1988 action movies, American action movies, South African movies, Namibian movies, Movies directed by Joseph Zito
Lake Kasumigaura	Lakes of Japan, Ibaraki Prefecture
Saint-Rhémy-en-Bosses	Settlements in Valle d'Aosta
Baudette International Airport	Airports in Minnesota
Soft Metal Music	Music, Pages created with the Article Wizard from 2021
Montville, Connecticut	Towns in Connecticut
Flag of the Faroe Islands	National flags, Faroe Islands
Forensic evidence	Forensics
Shinano River	Rivers of Japan, Niigata Prefecture, Nagano Prefecture
Oswald Spengler	German philosophers, 1880 births, 1936 deaths
Dongo, Lombardy	Settlements in Lombardy
Tone River	Rivers of Japan
Barkhamsted, Connecticut	Towns in Connecticut
Abdullah el-Faisal	Living people, 1963 births, People from London
Bethany, Connecticut	Towns in Connecticut
Bolton, Connecticut	Towns in Connecticut
Bozrah, Connecticut	Towns in Connecticut
Vienna International Airport	Airports in Europe, Transport in Austria, Buildings and structures in Austria, Vienna
JP Karliak	1981 births, Living people, Actors from Pennsylvania, American voice actors, American comedians
Doug Lennox	1948 births, 2015 deaths, Canadian movie actors, Canadian television actors, Canadian radio personalities, Canadian writers, Actors from Toronto, Writers from Toronto
Stiff Records	British record labels, 1976 establishments in the United Kingdom
List of geek rock artists	Rock musicians
Thomas Müntzer	German theologians, 1489 births, 1525 deaths
Maricopa, California	Cities in California, Settlements in Kern County, California
Ishikari River	Rivers of Japan, Hokkaido Prefecture
Phil Jupitus	1954 births, Living people, English comedians, English radio personalities, English television presenters, People from Birmingham, People from West Midlands (county), British DJs
Osaka Bay	Bays, Bodies of water of Japan
Suruga Bay	Bays, Bodies of water of Japan
Iturup	Islands of Asia
Kunashir Island	Islands of Asia
Catharsis	Culture, Art, Emotions, Psychology
Teatro Massimo	Opera houses in Italy, Palermo, 1897 establishments in Europe, 1890s establishments in Italy
Rta	Hinduism
Institut polytechnique de Paris	Technical colleges and universities in Paris, 2019 establishments in Europe, 2010s establishments in France
Eleni (movie)	English-language movies, American war movies, American drama movies, Movies set in Greece, Movies set in the United States, Warner Bros. movies, 1980s war movies, 1985 drama movies, Movies directed by Peter Yates
Russell Square tube station	Rail transport stations in London fare zone 1, Grade II listed railway stations, 1906 establishments in the United Kingdom, Tube stations in Camden, Piccadilly Line stations
Fictosexuality	Human sexuality
Leo De Lyon	1926 births, Living people, Actors from New Jersey
André Roussin	1911 births, 1987 deaths, French playwrights, People from Marseille
Night of the Auk	Plays
Archibald MacLeish	1892 births, 1982 deaths, Pulitzer Prize winners, American poets, American essayists, Writers from Illinois, Politicians from Illinois, US Democratic Party politicians
Robinson Jeffers	1887 births, 1962 deaths, American poets, American environmentalists, Writers from Pennsylvania
Delta Air Lines Flight 89	Aviation disasters in the United States, 2020 in the United States, January 2020 events
Medea (play)	Plays
American Shakespeare Theatre	Theatres in the United States
Royal Shakespeare Theatre	Theatres in the United Kingdom
Maurice Gosfield	1913 births, 1964 deaths, People from New York City
Jean Anouilh	1910 births, 1987 deaths, French screenwriters, French playwrights, People from Bordeaux
Becket	Plays
Evening Standard Theatre Awards	Awards
The Resistible Rise of Arturo Ui	Plays
The Royal Hunt of the Sun	Plays
Jean Giraudoux	1882 births, 1944 deaths, French playwrights, French novelists, French essayists, French diplomats
Amphitryon 38	Plays
Danton's Death	Plays
Adrian Mitchell	1932 births, 2008 deaths, British poets, British novelists, British playwrights, Writers from London
Long Day's Journey into Night	Plays
The Good Doctor (play)	Plays
After the Fall (play)	Plays
Caesar and Cleopatra (play)	Plays
Prospero	Characters in Shakespeare's plays
Anthony Mann	1906 births, 1967 deaths, Deaths from myocardial infarction, Movie directors from California, American stage actors, Actors from San Diego, California
Inside Daisy Clover	1965 drama movies, American drama movies, Movies based on books, Movies directed by Robert Mulligan
Eddie Chapman	1914 births, 1997 deaths, English criminals, Spies
The Night of the Generals	1967 movies, 1960s mystery movies, 1960s war movies, British mystery movies, British war movies, French movies, American mystery movies, American war movies, World War II movies, Movies based on books, Movies directed by Anatole Litvak
Doctor Dolittle (1967 movie)	1967 comedy movies, 1960s musical movies, American musical comedy movies, Movies directed by Richard Fleischer
Oedipus the King (1968 movie)	1967 movies
Nobody Runs Forever	Australian movies, 1960s spy movies, 1968 thriller movies, Movies based on books, Movies directed by Ralph Thomas
Battle of Britain (movie)	1969 movies, 1960s war movies, British war movies, World War II movies, Movies directed by Guy Hamilton
Jennifer Carroll Foy	1981 births, Living people, Politicians from Virginia, American lawyers
Lock Up Your Daughters (1969 movie)	1969 comedy movies, British comedy movies
The Royal Hunt of the Sun (movie)	1969 drama movies, British drama movies, American drama movies, American epic movies, Movies based on plays
The Silent Partner (1978 movie)	1978 movies, Canadian movies, Heist movies, Movies based on books
Aces High (movie)	1976 movies, 1970s war movies, British war movies, Movies based on plays
Starcrash	1978 movies, American movies
International Velvet (movie)	1978 drama movies, 1970s war movies, British drama movies, British war movies, American sports drama movies, American war movies
Murder by Decree	1979 movies, 1970s mystery movies, 1970s thriller movies, British mystery movies, British thriller movies, Canadian thriller movies, Movies directed by Bob Clark
Somewhere in Time (movie)	1980 drama movies, 1980s romantic drama movies, 1980s fantasy movies, American romantic drama movies, American fantasy movies
Christopher Reeve	1952 births, 2004 deaths, Deaths from cardiac arrest, American movie actors, American television actors, American stage actors, American voice actors, Movie directors from New York City, American activists, American philanthropists, Actors from New York City, Writers from New York City, BAFTA Award winning actors, Grammy Award winners, Screen Actors Guild Award winners
Dragnet (1987 movie)	1987 comedy movies, 1980s buddy movies, American buddy movies, American comedy movies
Wolf (1994 movie)	1994 romance movies, 1994 comedy movies, 1990s romantic comedy movies, 1994 horror movies, American romantic comedy movies, American horror movies, Movies directed by Mike Nichols, Movies composed by Ennio Morricone
Taylor Hackford	1944 births, Living people, Movie directors from California, People from Santa Barbara, California
12 Monkeys	1995 movies, 1990s science fiction movies, American science fiction movies, Movies directed by Terry Gilliam
Nicholas Nickleby (2002 movie)	2002 comedy-drama movies, British comedy-drama movies, American comedy-drama movies, Movies based on books by Charles Dickens
Nicholas Nickleby	Books by Charles Dickens
Joyce Vincent	1965 births, 2003 deaths, Missing people, People from London, Unexplained deaths
Vampire in Venice	1988 horror movies, Italian horror movies
Stephen Gaghan	1965 births, Living people, Academy Award winning writers, BAFTA Award winning writers, Emmy Award winners, Golden Globe Award winning writers, American movie directors, American screenwriters, Writers from Louisville, Kentucky
Must Love Dogs	2005 romance movies, 2005 comedy movies, 2000s romantic comedy movies, American romantic comedy movies, Movies based on books, Warner Bros. movies
The New World (2005 movie)	2005 romance movies, 2005 drama movies, 2000s romantic drama movies, American romantic drama movies
Inside Man	2006 movies, 2000s thriller movies, American heist movies, American thriller movies, Movies directed by Spike Lee
The Lake House (movie)	2006 romance movies, 2006 drama movies, 2000s romantic drama movies, 2000s fantasy movies, American fantasy movies, American romantic drama movies, Movies shot in Chicago, Illinois, Movies set in Chicago, Illinois
Mike Mills (director)	1966 births, Living people, Movie directors from California, Writers from Berkeley, California, Screenwriters from California
The Girl with the Dragon Tattoo (2011 movie)	2011 movies, 2010s thriller movies, American thriller movies, Swedish movies, British thriller movies, German movies, Norwegian movies, Movies based on books, Movies directed by David Fincher
Boana beckeri	Frogs, Animals of South America
The Man Who Invented Christmas (movie)	2017 comedy-drama movies, Irish movies, Canadian comedy movies, Canadian drama movies, Christmas movies, Movies based on books
2005 Major League Baseball All-Star Game	Major League Baseball, 2005 in sports, 2005 in the United States
Studio One (American TV series)	CBS network shows
The Alcoa Hour	NBC network shows, 1950s television series
Kraft Television Theatre	1950s American television series
Omnibus (American TV program)	CBS network shows, ABC network shows, NBC network shows, 1950s American television series, 1960s American television series
A Doll's House (1959 movie)	1959 movies, American television movies, Movies directed by George Schaefer
A Doll's House	Plays
The Philadelphia Story (play)	Plays
Herod Antipas	20 BC births, 30s deaths
Jesus of Nazareth (TV series)	British movies, Italian movies, 1977 movies, Movies directed by Franco Zeffirelli
Robert Powell	1944 births, Living people, English movie actors, English television actors, English stage actors, English voice actors, Actors from Lancashire
Herbert Kappler	1907 births, 1978 deaths, German military personnel of World War II
Stone sheep	Caprids, Mammals of North America
The Scarlet and the Black	1983 drama movies, 1980s war movies, American television movies, American war movies, American drama movies
The World of David the Gnome	1985 television series debuts, 1986 television series endings, Animated television series
David Maxwell Fyfe, 1st Earl of Kilmuir	1900 births, 1967 deaths, UK MPs 1935–1945, UK MPs 1945–1950, UK MPs 1950–1951, UK MPs 1951–1955, Former Conservative MPs (UK), British lawyers, British judges, Politicians from Edinburgh
Nuremberg (miniseries)	2000 movies, American television movies
American Tragedy (movie)	American television movies
Miracle Planet	2005 television series endings, 2005 television series debuts, Canadian television series
Ric Burns	Living people, 1955 births, Writers from Baltimore, Maryland, Movie directors from Maryland
On Golden Pond (play)	Plays
On Golden Pond (2001 movie)	2001 movies, American television movies, Movies based on plays
The Gospel of John (2003 movie)	2003 movies, American television movies, American epic movies
The Captains (movie)	2011 movies, Canadian movies, Documentary movies
An Inn in Tokyo	1935 movies, 1930s drama movies, Silent movies, Japanese movies, Movies directed by Yasujirō Ozu
New shekel	Currency of Asia, Economy of Israel
TriStar Pictures	Movie studios
Vincent Cannistraro	2019 deaths
La plus que lente	Compositions by Claude Debussy
Burgoberbach	Ansbach (district)
Bob Moses (activist)	1935 births, 2021 deaths, American educators, American civil rights activists, Writers from New York City, Politicians from New York City, Writers from Mississippi, Politicians from Mississippi, US Democratic Party politicians
Ivan Toplak	1931 births, 2021 deaths, Serbian footballers, Serbian football managers, Yugoslavian sportspeople
Hoops & Yoyo	Fictional characters introduced in 2003
Man of Steel (movie)	2013 action movies, 2010s superhero movies, DC Extended Universe movies, Superman movies, Movies set on fictional planets, Warner Bros. movies, Movies shot in Chicago, Illinois, Movies directed by Zack Snyder
Japanese flying squid	Cephalopods, Animals of Japan
Firefly squid	Cephalopods, Animals of Japan, Bioluminescent animals
State of Franklin	Tennessee, United States
SANSA Flight 32	1990s in North America, Aviation disasters in the 1990s
They Might Be Giants discography	Discographies
Avianca Flight 52	1990 in the United States, Aviation disasters in the United States, Aviation disasters in the 1990s
Ezekiel	Bible
Rough Draft Korea	1992 establishments in Asia, Animation studios in Asia
Cleavage	Breasts, Clothing
Tōdai-ji	Buddhist temples in Japan, World Heritage Sites in Japan
Kōtoku-in	Buddhist temples in Japan
Terrorism in the United Kingdom	Terrorist incidents in the United Kingdom
Jerónimos Monastery	World Heritage Sites in Portugal
Belém Tower	World Heritage Sites in Portugal
Robert Levin	American pianists, Classical musicians, 1947 births, Living people
Byōdō-in	World Heritage Sites in Japan, Buddhist temples in Japan
Jason Njoku	1980 births, Living people, Businesspeople from London
Paulius Stankevicius	1992 births, Living people, Lithuanian people
Rinki Sethi	Living people
Capella University	1993 establishments in the United States, Colleges and universities in Minnesota
Uji	Cities in Japan, Settlements in Kyoto Prefecture
Kinkaku-ji	World Heritage Sites in Japan, Buddhist temples in Japan, Kyoto
Malcolm Bilson	American pianists, Classical musicians, 1935 births, Living people
Deep dish pizza	Pizza
Kiyomizu-dera	World Heritage Sites in Japan, Buddhist temples in Japan, Kyoto
Ronald Brautigam	Dutch pianists, Classical musicians, 1954 births, Living people
Nexus 4	Android smartphones
Alexei Lubimov	Russian pianists, Classical musicians, 1944 births, Living people
Nexus 5	Android smartphones
Fugazza con queso	Argentine food, Pizza
Kristian Bezuidenhout	Australian pianists, Classical musicians, 1979 births, Living people
Girl with a Pearl Earring	 Johannes Vermeer
Andy Rubin	1963 births, Living people, Businesspeople from New York
Mandla Lamba	1985 births, Living people, South American people
COVID-19 pandemic in Mauritius	COVID-19 pandemic by country, Mauritius
Nexus 10	Google Nexus
Pengsiba	Kings of Ancient Manipur
LineageOS	Operating systems, Free software
Burk, Bavaria	Ansbach (district)
Rojales	Municipalities in Valencia (autonomous community), Alicante Province
Duluth International Airport	Airports in Minnesota
Cessnock, New South Wales	Towns in New South Wales
Boana palaestes	Frogs, Animals of South America
Amphibian Species of the World	Science websites, Databases, Taxonomy
Australian brushturkey	Birds of Australia, Phasianidae
Tino Fariña	1994 deaths, Spanish painters, 1951 births
List of national dishes	National symbols, Foods, Food-related lists
Mariano Comense	Cities in Lombardy
Blevio	Settlements in Lombardy
Cucciago	Settlements in Lombardy
Torno, Lombardy	Settlements in Lombardy
Tavernerio	Settlements in Lombardy
Lipomo	Settlements in Lombardy
Luisago	Settlements in Lombardy
Fino Mornasco	Settlements in Lombardy
Grandate	Settlements in Lombardy
Senna Comasco	Settlements in Lombardy
Splitgate	2019 video games, Windows games, PlayStation 4 games, Xbox One games
List of national drinks	National symbols, Foods, Food-related lists
Maslianico	Settlements in Lombardy
Moltrasio	Settlements in Lombardy
Schignano	Settlements in Lombardy
Capiago Intimiano	Settlements in Lombardy
Montorfano	Settlements in Lombardy
San Fermo della Battaglia	Settlements in Lombardy
Edgware Road tube station (Circle, District and Hammersmith & City lines)	Circle Line stations, District Line stations, Hammersmith & City Line stations, Tube stations in the City of Westminster, 1863 establishments in England, Railway stations opened in 1863
Cavallasca	Former municipalities of Lombardy
Montano Lucino	Settlements in Lombardy
Villa Guardia	Settlements in Lombardy
Lurate Caccivio	Settlements in Lombardy
Arosio, Lombardy	Settlements in Lombardy
Colmberg	Ansbach (district)
Vaccinium angustifolium	Blueberries
National colours	National symbols, Nationalism, Culture, Lists of countries
Hazlehurst, Mississippi	Cities in Mississippi, County seats in Mississippi
Vaccinium myrtilloides	Blueberries
Crystal Springs, Mississippi	Cities in Mississippi
Quitman, Mississippi	Cities in Mississippi, County seats in Mississippi
Allen Jenkins	1900 births, 1974 deaths, People from Staten Island
Hernando, Mississippi	Cities in Mississippi, County seats in Mississippi
Horn Lake, Mississippi	Cities in Mississippi
Olive Branch, Mississippi	Cities in Mississippi
Fanny by Gaslight (movie)	1944 drama movies, British drama movies, Movies based on books, Movies directed by Anthony Asquith
Meadville, Mississippi	Towns in Mississippi, County seats in Mississippi
Leakesville, Mississippi	Cities in Mississippi, County seats in Mississippi
McLain, Mississippi	Cities in Mississippi
Lexington, Mississippi	Cities in Mississippi, County seats in Mississippi
Durant, Mississippi	Cities in Mississippi
Moss Point, Mississippi	Cities in Mississippi
Bay Springs, Mississippi	Cities in Mississippi, County seats in Mississippi
Paulding, Mississippi	Unincorporated communities in Mississippi, County seats in Mississippi
False Colors	1943 movies, 1940s western movies, American western movies, Movies directed by George Archainbaud
Prentiss, Mississippi	Towns in Mississippi, County seats in Mississippi
De Kalb, Mississippi	Towns in Mississippi, County seats in Mississippi
Indian Airlines Flight 605	1990s in India, Aviation disasters in Asia, Aviation disasters in the 1990s
Virginia's 41st House of Delegates district	Politics of Virginia
Transverse myelitis	Autoimmune diseases
Frank McRae	1941 births, 2021 deaths, Deaths from myocardial infarction, Chicago Bears players, American football defensive tackles, American movie actors, American television actors, American stage actors, American voice actors, Sportspeople from Memphis, Tennessee, Actors from Memphis, Tennessee
2021 Tunisian political crisis	2021 in Africa, 21st century in Tunisia, July 2021 events, Politics of Tunisia, August 2021 events
Rached Ghannouchi	1941 births, Living people, Speakers of the Assembly of the Representatives of the People, Philosophers
Speaker of the Assembly of the Representatives of the People	Speakers of the Assembly of the Representatives of the People
Mustapha Ben Jafar	1940 births, Living people, Speakers of the Assembly of the Representatives of the People, People from Tunis
Datschiburger Kickers	1960s establishments in Germany, 1965 establishments in Europe, German football clubs, Augsburg
Kathy Hilton	Businesspeople from Los Angeles, California, American television actors, American movie actors, American child actors, American fashion designers, Actors from Los Angeles, California, 1959 births, Living people
Kaokhangba	Kings of Ancient Manipur
Marty Makary	Living people, Harvard University alumni
Saulos Chilima	1973 births, Living people, Vice presidents, Malawian people
List of countries in 1960	1960, Lists of sovereign states by year in the 1960s
List of countries in 1961	1961, Lists of sovereign states by year in the 1960s
List of countries in 1962	1962, Lists of sovereign states by year in the 1960s
List of countries in 1963	1963, Lists of sovereign states by year in the 1960s
List of countries in 1964	1964, Lists of sovereign states by year in the 1960s
List of countries in 1965	1965, Lists of sovereign states by year in the 1960s
List of countries in 1966	1966, Lists of sovereign states by year in the 1960s
List of countries in 1967	1967, Lists of sovereign states by year in the 1960s
Naokhamba	Kings of Ancient Manipur
List of countries in 1968	1968, Lists of sovereign states by year in the 1960s
List of countries in 1969	1969, Lists of sovereign states by year in the 1960s
A House Divided (board game)	Board games
Chengleiron	Puya, Meitei literature, History of Manipur
List of countries in 1970	1970, Lists of sovereign states by year
List of countries in 1971	1971, Lists of sovereign states by year
List of countries in 1972	1972, Lists of sovereign states by year
List of countries in 1973	1973, Lists of sovereign states by year
List of countries in 1974	1974, Lists of sovereign states by year
Ligurian Wikipedia	Wikipedias, 2008 establishments, Liguria
List of countries in 1975	1975, Lists of sovereign states by year
List of countries in 1976	1976, Lists of sovereign states by year
List of countries in 1979	1979, Lists of sovereign states by year
List of countries in 1977	1977, Lists of sovereign states by year
List of countries in 1978	1978, Lists of sovereign states by year
List of countries in 1980	1980, Lists of sovereign states by year
List of countries in 1981	1981, Lists of sovereign states by year
List of countries in 1982	1982, Lists of sovereign states by year
List of countries in 1983	1983, Lists of sovereign states by year
List of countries in 1984	1984, Lists of sovereign states by year
List of countries in 1985	1985, Lists of sovereign states by year
List of countries in 1986	1986, Lists of sovereign states by year
List of countries in 1987	1987, Lists of sovereign states by year
List of countries in 1988	1988, Lists of sovereign states by year
List of countries in 1989	1989, Lists of sovereign states by year
List of national slogans	Political slogans, Nationalism
Ligurian language	Romance languages, Liguria
Jean-François Stévenin	1944 births, 2021 deaths, French movie actors, French television actors, French stage actors, French voice actors, French movie directors, French movie producers, French screenwriters
Satsuki Eda	1941 births, 2021 deaths, Deaths from pneumonia, Japanese politicians
Dean Winters	1964 births, Living people, American movie actors, American television actors, American voice actors, American stage actors, Actors from New York City
Storey	Building materials
Webster's Dictionary	Dictionaries
Willis Group	Companies of the United Kingdom
Flag of Liguria	Flags of country subdivisions, Liguria, 1997 establishments, Flags of Europe
Mark Gitenstein	1946 births, Living people, Ambassadors of the United States, American lawyers, Politicians from Alabama, People from Montgomery, Alabama, US Democratic Party politicians, Businesspeople from Alabama
Jake Ellzey	1970 births, Living people, State legislators of the United States, US Republican Party politicians, People from Amarillo, Texas, Military people from Texas, American aviators, People from Waxahachie, Texas, United States representatives from Texas
Tony Warren	 1936 births, 2016 deaths, British novelists, British television writers
Michael Nouri	1945 births, Living people, American movie actors, American television actors, American stage actors, American voice actors, Actors from Washington, D.C.
2021 CAF Women's Champions League	2021 in Africa, 2021 in association football
Dentlein	Ansbach (district)
Diebach	Ansbach (district)
Dietenhofen	Ansbach (district)
Ligurian Republic	Liguria, History of Italy, Former republics, Puppet states, Former countries in Europe, 1797 establishments, 1800s disestablishments in Europe, States and territories disestablished in the 19th century, 18th century establishments in Italy, 19th century disestablishments in Italy
Pizza marinara	Pizza
Kai Tak Airport	1925 establishments in Asia, 1988 disestablishments, Airports in Asia
Dassault Aviation	1929 establishments in Europe, 1920s establishments in France, Companies of France, Dassault Aviation
Harland Williams	1962 births, Living people, Canadian movie actors, Canadian television actors, Canadian voice actors, Canadian stand-up comedians, Comedians from Toronto, Actors from Toronto
Naophangba	Kings of Ancient Manipur
Crowded House (album)	Albums
Cardiff Airport	20th century establishments in Wales, 1950s establishments in the United Kingdom, 1954 establishments in Europe, Airports in the United Kingdom, Buildings and structures in Wales, Transport in Wales
Campo Grande tree frog	Frogs, Animals of South America
Kashmir markhor	Caprids, Mammals of Asia
Viktor Johansson	1998 births, Living people, Swedish footballers, Aston Villa F.C. players, Association football goalkeepers
Dombühl	Ansbach (district)
Yomiuri Shimbun	1870s establishments in Japan, 1874 establishments, Newspapers in Asia
2009 L'Aquila earthquake	2009 disasters, 2000s in Italy, 2009 in Europe, Disasters in Europe, Earthquakes in the 2000s, April 2009 events, Abruzzo
Dürrwangen	Ansbach (district)
Ehingen, Middle Franconia	Ansbach (district)
Hesselberg	Mountains of Germany, Bavaria
Hajipur	Settlements in Bihar, Cities in India
National epic	Poems, Symbols
Purvis, Mississippi	Cities in Mississippi, County seats in Mississippi
List of countries in 1990	1990
List of countries in 1991	1991
List of countries in 1994	1994
List of countries in 1992	1992
List of countries in 1993	1993
Monticello, Mississippi	Towns in Mississippi, County seats in Mississippi
Carthage, Mississippi	Cities in Mississippi, County seats in Mississippi
List of countries in 1995	1995
List of countries in 1996	1996
List of countries in 1999	1999
List of countries in 1997	1997
List of countries in 1998	1998
Flachslanden	Ansbach (district)
Dr. Dimensionpants	Television series
Gebsattel	Ansbach (district)
Gerolfingen	Ansbach (district)
SheZow	Television series
Geslau	Ansbach (district)
Insingen	Ansbach (district)
Langfurth	Ansbach (district)
Lehrberg	Ansbach (district)
Ballstädt	Municipalities in Thuringia, Gotha Rural District
Berndorf, Rhineland-Palatinate	Municipalities in Rhineland-Palatinate
Birkach	Districts of Stuttgart
Botnang	Districts of Stuttgart
Stuttgart-North	Districts of Stuttgart
Kühndorf	Schmalkalden-Meiningen Rural District
Lichtenau, Bavaria	Ansbach (district)
James A. Andersen	1924 births, Living people, American judges, American lawyers, American military personnel of World War II, Politicians from Washington, US Republican Party politicians
Dick Long	1924 births, 2021 deaths, Australian lawyers, Australian military people, Liberal Party of Australia politicians, Military personnel of World War II, Politicians from Victoria (Australia)
Mac Tonight	1980s
Mitteleschenbach	Ansbach (district)
Mönchsroth	Ansbach (district)
World economy	Economics
Neuendettelsau	Ansbach (district)
Neusitz	Ansbach (district)
Oberdachstetten	Ansbach (district)
Northeast blackout of 2003	2003 in Canada, 2003 in the United States, Disasters in the United States, Disasters in Canada
Rye bread	Breads
Rice bread	Rice dishes, Breads
Red-naped trogon	Birds of Asia
Hackney Wick	Areas of London, London Borough of Hackney
List of countries in 1950	1950, Lists of sovereign states by year
List of countries in 1951	1951, Lists of sovereign states by year
List of countries in 1952	1952, Lists of sovereign states by year
List of countries in 1953	1953, Lists of sovereign states by year
List of countries in 1954	1954, Lists of sovereign states by year
List of countries in 1955	1955, Lists of sovereign states by year
List of countries in 1956	1956, Lists of sovereign states by year
List of countries in 1957	1957, Lists of sovereign states by year
List of countries in 1959	1959, Lists of sovereign states by year
List of countries in 1958	1958, Lists of sovereign states by year
The Downfall (movie)	1961 drama movies, Greek movies, Movies directed by Giannis Dalianidis
Esther (1986 movie)	1986 drama movies, Israeli movies, Dutch drama movies, Austrian movies, British drama movies, Movies directed by Amos Gitai
Extrasolar moon	Moons
Philip Pierre	Living people, Prime Ministers of Saint Lucia, Current national leaders
Kenneth Tencio	Living people, 1993 births, Cyclists, Costa Rican sportspeople
YouTube Kids	YouTube
Zoom, Zoom, Superman!	1973 comedy movies, 1970s fantasy movies, Filipino movies, Movies directed by Ishmael Bernal, Movies directed by Joey Gosiengfiao
Only by the Night (2008)	2008 albums
List of prime ministers of Saint Lucia	Prime Ministers of Saint Lucia
Vaughan Lewis	1940 births, Living people, Prime Ministers of Saint Lucia
Governor-General of Saint Lucia	Governors-General of Saint Lucia
Pearlette Louisy	1946 births, Living people, Governors-General of Saint Lucia
Neville Cenac	1939 births, Living people, Governors-General of Saint Lucia
Oleg Baklanov	1932 births, 2021 deaths, Russian politicians
Porfirio Armando Betancourt	1957 births, 2021 deaths, Honduran footballers, Deaths from the COVID-19 pandemic
Kate Nelligan	1950 births, Living people, BAFTA Award winning actors, Canadian movie actors, Canadian television actors, Canadian stage actors, Canadian voice actors, Actors from London (Ontario)
Dina Boluarte	1962 births, Living people, Vice Presidents of Peru
2021 Maharashtra floods	2021 disasters, 2021 in Asia, 2020s disasters in Asia, 2020s in India, Floods in India, July 2021 events, Maharashtra, August 2021 events
The Hound of the Baskervilles (1983 movie)	1983 mystery movies, 1983 thriller movies, Television movies, British mystery movies, British thriller movies, Movies based on books, Movies directed by Douglas Hickox
2020-21 UEFA U-20 Europa League	2020 in sports, UEFA
Fanny (1961 movie)	1961 drama movies, 1960s romantic drama movies, American romantic drama movies, Warner Bros. movies, Movies based on plays, Movies directed by Joshua Logan
Salon (meeting)	Art
Sameirang	Kings of Ancient Manipur
List of countries in 2000	2000
List of countries in 2001	2001
List of countries in 2002	2002
List of countries in 2003	2003
List of countries in 2004	2004
List of countries in 2005	2005
List of countries in 2006	2006
List of countries in 2009	2009
List of countries in 2007	2007
List of countries in 2008	2008
Yorktown class aircraft carrier	Military of the United States
Bend of the River	1952 movies, 1950s western movies, American western movies, Movies based on books, Movies directed by Anthony Mann
Roberto Calasso	1941 births, 2021 deaths, Italian writers, Italian businesspeople, Publishers, People from Florence
István Csom	1940 births, 2021 deaths, Hungarian chess players
Linguine Carbonara	Pasta
Axel Olrik	1864 births, 1917 deaths, Danish writers
2021 COSAFA Women’s Champions League	2021 in Africa, 2021 in association football
Kaireima	History of Manipur
Financial market	Finance
St. Louis-style pizza	American food, Pizza, St. Louis, Missouri
Thamanglang	History of Manipur
Detroit-style pizza	American food, Pizza, Detroit, Michigan
Mustang Ridge, Texas	Cities in Texas
Ise Bay	Bodies of water of Japan
Yanceyville, North Carolina	Towns in North Carolina, County seats in North Carolina
Amory, Mississippi	Cities in Mississippi
Mo Hayder	1962 births, 2021 deaths, Deaths from motor neurone disease, British novelists, Writers from Essex
Johnny Ventura	1940 births, 2021 deaths, Deaths from myocardial infarction, Dominican Republic politicians, Bandleaders, Singers, Mayors, Dominican Republic musicians
Aimee Carrero	1988 births, Living people, Dominican Republic actors, Dominican Republic musicians, Naturalized citizens of the United States, American movie actors, American television actors, American voice actors, Actors from Miami, Florida, Singers from Miami, Florida
Marsala	Cities in Sicily
Jackie Cruz	1986 births, Living people, Dominican Republic actors, Dominican Republic musicians, Naturalized citizens of the United States, American pop singers, American movie actors, American television actors, American voice actors, Actors from Los Angeles, California, Singers from Los Angeles, California
Garbagnate Milanese	Cities in Lombardy
Saint-Vincent, Aosta Valley	Settlements in Valle d'Aosta
Sarre, Aosta Valley	Settlements in Valle d'Aosta
Allen Chastanet	1961 births, Living people, Business people, Opposition leaders, Prime Ministers of Saint Lucia
Torgnon	Settlements in Valle d'Aosta
Kenny Anthony	1951 births, Living people, Prime Ministers of Saint Lucia, Opposition leaders
Boana phaeopleura	Frogs, Animals of South America
Suzzara	Cities in Lombardy
Viadana, Lombardy	Cities in Lombardy
Bukharan markhor	Caprids, Mammals of Asia
2015 Africa Cup of Nations	2015 in association football, 2015 in Africa
Arnold Stang	1918 births, 2009 deaths, American comedians
Valgrisenche	Settlements in Valle d'Aosta
Kumbaya	Folk music, Christian hymns, 19th century American songs, African-American history
Stay (The Kid Laroi and Justin Bieber song)	Synth-pop songs, 2021 songs, Justin Bieber
Richard A. Baker (historian)	1940 births, Living people, Historians of the United States Senate, Writers from Massachusetts
Historian of the United States Senate	Historians of the United States Senate
Donald A. Ritchie	1945 births, Living people, Historians of the United States Senate, Writers from New York City
Parliamentarian of the United States Senate	Parliamentarians of the United States Senate
Elizabeth MacDonough	1960s births, Living people, Parliamentarians of the United States Senate, Businesspeople from Washington, D.C., American lawyers
Alan Frumin	1946 births, Living people, Parliamentarians of the United States Senate, American lawyers, Businesspeople from New York City
Robert Dove	1938 births, 2021 deaths, American academics, American political scientists, Parliamentarians of the United States Senate, Writers from Washington, D.C., Politicians from Washington, D.C.
Gesta Danorum	History books, Norse mythology, 12th century in Europe, Danish culture
Milica Mandić	1987 births, Living people, Serbian sportspeople, Olympic gold medalists, Taekwondo practitioners
Saxo Grammaticus	1150s births, 1220s deaths, Danish historians
Albert Bandura	1925 births, 2021 deaths, Naturalized citizens of the United States, Canadian psychologists, American psychologists, American academics, Canadian academics, Scientists from California, Writers from California, People from Alberta, Deaths from congestive heart failure, Cardiovascular disease deaths in California
Brooklyn Nine-Nine	2010s American comedy television series, 2020s American comedy television series
Bargème	Communes in Var
Bargemon	Communes in Var
Barjols	Communes in Var
Food of the Central African Republic	Central African Republic, African culture
Hot Rod	2007 comedy movies, American comedy movies, Paramount movies
Buffer zone	Diplomacy
Michael Weist	American actors, American producers
Short rib	Cuts of beef
Bone marrow (food)	Offal
Unity Technologies	Companies based in San Francisco, Video game companies
Heather Hallett, Baroness Hallett	Living people, 1949 births, United Kingdom Life Peers, People from Hampshire
Jeff McCarthy	1954 births, Living people, Actors from California
Sulaiman markhor	Caprids, Mammals of Asia
Dialects in Tyrol	Austrian culture, Tyrol (state), German dialects, Italian culture
Ohrenbach	Ansbach (district)
Petersaurach	Ansbach (district)
Röckingen	Ansbach (district)
Psittaculidae	Birds
Rügland	Ansbach (district)
Sachsen bei Ansbach	Ansbach (district)
Schnelldorf	Ansbach (district)
Schopfloch, Bavaria	Ansbach (district)
La Escalera tree frog	Frogs, Animals of South America
Goral	Ungulates
Ura Konthouba	Kings of Ancient Manipur
List of Azerbaijani flags	Azerbaijan-related lists, Flags of Azerbaijan
Quick on the Trigger	1948 movies, 1940s western movies, American western movies, Movies directed by Ray Nazarro
Anne B. Newman	Health care, 1995 births, Living people, People from Pennsylvania, Female scientists
Who Was That Lady?	1960 comedy movies, 1960s spy movies, American comedy movies, American spy movies, Movies based on plays, Movies directed by George Sidney, Columbia Pictures movies
Johnny Stool Pigeon	1949 movies, 1940s crime movies, 1940s drama movies, American crime drama movies, Movies directed by William Castle, Universal Pictures movies
Randi J. Hagerman	Living people, Health care, Stanford University alumni
Aquarium Barcelona	Aquariums, Buildings and structures in Barcelona
Man'yōshū	Japanese literature
Palau de la Música Catalana	Buildings and structures in Barcelona, Concert halls
Paella	Spanish food, Rice dishes
2022 Copa America Feminina	2022 in sports, 2020s in South America
Tamara Alpeyeva	1949 births, Living people, Belarusian people
List of national libraries	National libraries, National symbols
Seattle Kraken	National Hockey League teams, Seattle, Washington, 2021 establishments
Climate Pledge Arena	Football stadiums in the United States, Buildings and structures in Washington, Seattle, Washington
Saginaw Grant	1936 births, 2021 deaths, Native American people, American movie actors, American television actors, American stage actors, American voice actors, American dancers, Actors from Oklahoma
Vito Fossella	1965 births, Living people, United States representatives from New York, US Republican Party politicians, Politicians from New York City, People from Staten Island
Mark Levine (New York politician)	1969 births, Living people, Politicians from New York City, American educators, US Democratic Party politicians
Antonio Reynoso	1983 births, Living people, US Democratic Party politicians, Politicians from New York City
Vanessa Gibson	1979 births, Living people, US Democratic Party politicians, Politicians from New York City
Guido Bellido	1979 births, Living people, Prime Ministers of Peru
Héctor Béjar	1935 births, Living people, Peruvian politicians, Peruvian writers, Academics, Artists
Tawny Newsome	1983 births, Living people, American movie actors, American television actors, American voice actors, Comedians from California, Actors from California, Podcasters, Musicians from California
Hobbs' tree frog	Frogs, Animals of South America
New Lenox, Illinois	Villages in Illinois, Suburbs of Chicago, Illinois
Frank Beard (musician)	1949 births, American rock drummers, Living people, American blues musicians, American songwriters, Musicians from Texas, Writers from Texas
Frank Beard (golfer)	1939 births, Living people, American golfers, Sportspeople from Dallas, Texas, Sportspeople from Louisville, Kentucky, American sports commentators
National Museum of Nature and Science	National museums in Japan, Museums in Tokyo
International Style (architecture)	Architectural styles
National Museum of Western Art	World Heritage Sites in Japan, National museums in Japan, Museums in Tokyo
Schindler Group	19th century establishments in Switzerland, 1874 establishments in Europe, Companies of Switzerland
Emporis	Companies of Germany, Hamburg
Ikebukuro Station	Railway stations in Tokyo
Schiff Hardin	1860s establishments in Illinois, 1864 establishments in the United States, Companies based in Chicago, Illinois
Seyfarth Shaw	1940s establishments in Illinois, 1945 establishments in the United States, Companies based in Chicago, Illinois
Setagaya	Wards of Tokyo
Tube (structure)	Architectural elements
Toshima	Wards of Tokyo
Supertall building	Buildings and structures
Ping An Finance Center	Skyscrapers in China, Guangdong
Setback (architecture)	Architectural elements
Truss	Architectural elements
WMAQ-TV	American television stations, Chicago, Illinois
MetLife	Companies based in New York City
Trizec Properties	Companies based in Chicago, Illinois
Laminated glass	Glass
Liberty City Seven	People from Miami, Florida, Cults
Ernst & Young	Companies of the United Kingdom
Chicago (magazine)	Magazines published in Chicago, Illinois
Chicago Review	1940s establishments in Illinois, 1946 establishments in the United States, Magazines published in Chicago, Illinois
Dan Goodwin	Living people, 1955 births, Writers from Maine
Suction cup	Tools
Trespass	Legal terms
Alain Robert	1962 births, Living people
SARS-CoV-2 Delta variant	COVID-19 pandemic
Fajer Al-Kaisi	1979 births, Living people, People from Iraq
Sirmaan Ramachandra Raja	Living people, 1999 births, Indian activists
McFarland, California	Cities in California, Settlements in Kern County, California
Clinton, Connecticut	Towns in Connecticut
Colchester, Connecticut	Towns in Connecticut
Colebrook, Connecticut	Towns in Connecticut
Columbia, Connecticut	Towns in Connecticut
Cornwall, Connecticut	Towns in Connecticut
Valpelline, Aosta Valley	Settlements in Valle d'Aosta
Valsavarenche	Settlements in Valle d'Aosta
Valtournenche	Settlements in Valle d'Aosta
Verrayes	Settlements in Valle d'Aosta
Verrès	Settlements in Valle d'Aosta
Villeneuve, Aosta Valley	Settlements in Valle d'Aosta
Cantù	Cities in Lombardy
Gary Dubin	1959 births, 2016 deaths, Actors from Los Angeles, California
Vito Scotti	1918 births, 1996 deaths, American movie actors, Actors from San Francisco
List of national airlines	Airlines, Air travel, Transport companies, Aviation, National symbols
Steinsfeld	Ansbach (district)
Unterschwaningen	Ansbach (district)
Weidenbach, Bavaria	Ansbach (district)
Weihenzell	Ansbach (district)
Weiltingen	Ansbach (district)
Wettringen, Bavaria	Ansbach (district)
Wieseth	Ansbach (district)
Wilburgstetten	Ansbach (district)
Windelsbach	Ansbach (district)
Wittelshofen	Ansbach (district)
Wörnitz	Ansbach (district)
Alzenau	Aschaffenburg (district)
Blankenbach	Aschaffenburg (district)
Dammbach	Aschaffenburg (district)
Cristo Rey (movie)	2013 drama movies, 2013 romance movies, 2010s romantic drama movies, Dominican Republic movies, Haitian movies, French romance movies, French drama movies, Movies directed by Leticia Tonos
Downhill Domination	2003 video games, PlayStation 2 games, PlayStation 2-only games, Racing video games, Sony Interactive Entertainment games
Groundbreaking	Ceremonies, Construction
Geiselbach	Aschaffenburg (district)
One Way Ticket (1988 movie)	1988 drama movies, Dominican Republic movies
Glattbach	Aschaffenburg (district)
Pat Buttram	1915 births, 1994 deaths, Actors from Alabama
The Battle of the Three Kings (movie)	1990 drama movies, 1990s adventure movies, Russian movies, Italian drama movies, Spanish movies, Moroccan movies, Movies directed by Souheil Ben-Barka
United Airlines Flight 811	1989 in the United States, Aviation disasters in the United States, Aviation disasters in the 1980s
Siren (video game)	2003 video games, PlayStation 2 games, PlayStation 2-only games, Sony Interactive Entertainment games, Video games developed in Japan
GSM	1991 establishments in Europe
Jaffa orange	History of Palestine, Pages with unreviewed translations
Flag of Åland	National flags, Åland Islands
Liar Wanted	1961 comedy movies, Greek movies, Movies directed by Giannis Dalianidis
Feletto	Settlements in Piedmont
Liaodong Peninsula	Peninsulas, Geography of China
Altopascio	Settlements in Tuscany
Saint-Gilles, Gard	Communes in Gard
Capharnaüm	2018 drama movies, Lebanese movies, American drama movies, Cypriot movies, French drama movies, Qatari movies, British drama movies, Movies directed by Nadine Labaki
Shell shock	History of medicine, Anxiety disorders
Barro Branco tree frog	Frogs, Animals of South America
None, Piedmont	Settlements in Piedmont
Fenestrelle	Settlements in Piedmont
Antdorf	Weilheim-Schongau
Bernbeuren	Weilheim-Schongau
Meitei currency	History of Manipur
Beating retreat	Military of India, Military of Pakistan
Front, Piedmont	Settlements in Piedmont
Fiano, Piedmont	Settlements in Piedmont
Fiorano Canavese	Settlements in Piedmont
Foglizzo	Settlements in Piedmont
Bill Thompson (voice actor)	1913 births, 1971 deaths, People from Terre Haute, Indiana
Pete George	1929 births, 2021 deaths, American Olympic gold medalists, American Olympic silver medalists, Weightlifters, American academics, Sportspeople from Akron, Ohio
Cabinet of Japan	Government of Japan
List of national mosques	Mosques, National symbols
Robie Lester	1925 births, 2005 deaths, People from Texas
Pointing devices	Computer hardware, Data input
Goldbach, Bavaria	Aschaffenburg (district)
Großostheim	Aschaffenburg (district)
Haibach, Lower Franconia	Aschaffenburg (district)
Garzigliana	Settlements in Piedmont
Germagnano	Settlements in Piedmont
Giaglione	Settlements in Piedmont
Bramans	Former communes in France, Communes in Savoie
Bulgarograsso	Settlements in Lombardy
Guanzate	Settlements in Lombardy
2023 AFC Asian Cup	2023 AFC Asian Cup, AFC Asian Cup tournaments, 2023 in Asian football, 2023 in Chinese football, International association football competitions hosted by China, June 2023 sports events in Asia, July 2023 sports events in Asia, Scheduled association football competitions
Cadorago	Settlements in Lombardy
Bregnano	Settlements in Lombardy
Givoletto	Settlements in Piedmont
Gravere	Settlements in Piedmont
Susa, Piedmont	Cities in Piedmont
Euston bus station	Bus transport
Candy Candido	1913 births, 1999 deaths, People from New Orleans, Louisiana
Grosso	Settlements in Piedmont
Nole	Settlements in Piedmont
Made in U.S.A (1966 movie)	1966 comedy movies, 1960s crime movies, French comedy movies, French crime movies, Movies based on books, Movies directed by Jean-Luc Godard
Bruce Reitherman	1955 births, Living people, People from Burbank, California
2016 United States presidential election in Pennsylvania	2016 United States presidential election
Oleg Konovalov	1964 births
National monument	Monuments and memorials, National symbols
National stadium	Stadiums, Nationality, National symbols
Karan Singh Grover	1982 births, Living people, Indian models, Indian actors
Corpse Party (movie)	2015 movies, 2015 horror movies
Cagua tree frog	Frogs, Animals of South America
Mayank Anand	1979 births, Living people, Indian actors
Titus Livius	Ancient Roman historians
Kii Peninsula	Peninsulas, Geography of Japan
Saulxures-sur-Moselotte	Communes in Vosges
Gigantophis	Snakes, Eocene
Saint-Aubin-de-Scellon	Communes in Eure
Cloak & Dagger (1984 movie)	1984 movies, 1980s adventure movies, 1980s family movies, 1980s spy movies, American adventure movies, American family movies, American spy movies, Movies based on short stories, Movies directed by Richard Franklin
Santa Maria Maggiore	Churches in Rome
List of buffalo breeds	Bovines, Domesticated animals
Nadia Boulanger	French Roman Catholics, Burials at Montmartre Cemetery, Paris, Musicians from Paris, 1979 deaths, 1887 births, Articles with hAudio microformats
Boana icamiaba	Frogs, Animals of South America
National hero	Titles, National symbols, Folklore
The Morning (Boccioni)	20th century paintings, Paintings by Umberto Boccioni,  Paintings at Porta Romana
Mater (Boccioni)	 Paintings at Porta Romana, 20th century paintings, Paintings by Umberto Boccioni
Naothingkhong	Kings of Ancient Manipur
Porta Romana (Boccioni)	 Paintings at Porta Romana, 20th century paintings, Paintings by Umberto Boccioni
The Street Enters the House (Boccioni)	 Paintings at Porta Romana, Paintings by Umberto Boccioni
The City Rises in Viale Isonzo (Boccioni)	Paintings by Umberto Boccioni,  Paintings at Porta Romana
Polsat Box	Television
Chūshingura	Japanese culture
Yakusha-e	Japanese culture
Terry Cooper (footballer, born 1944)	1944 births, 2021 deaths, English footballers, English football managers, Sportspeople from Yorkshire
Parliament of Morocco	Morocco
House of Representatives (Morocco)	Morocco
House of Councillors (Morocco)	Morocco
Omar Jazouli	1940s births, 2021 deaths, Mayors, Moroccan politicians, People from Marrakesh, Deaths from the COVID-19 pandemic
Tōshūsai Sharaku	Japanese artists
Agon fishing in Lierna Lake Como (Grubicy)	20th century paintings
Tooth Fairy (2010 movie)	2010 comedy movies, 2010s fantasy movies, American fantasy-comedy movies, Canadian comedy movies, Movies directed by Michael Lembeck, 20th Century Fox movies
Junior Eurovision Song Contest 2018	2018 in Europe, 2018 in music, Junior Eurovision Song Contest
Ugo Natoli	Italian judges, 1915 births, 1992 deaths
Yulimar Rojas	1995 births, Living people, Competitors in athletics, Olympic gold medalists, Olympic silver medalists, People from Caracas
2021 Turkish wildfires	2021 disasters, 2021 in Asia, 2020s disasters in Asia, 2020s fires, 2020s in Turkey, August 2021 events, Fires in Asia, July 2021 events
Ivan Graanoogst	Living people, Presidents of Suriname
Basilica major	Roman Catholic churches
Grugliasco	Settlements in Piedmont
Ingria, Piedmont	Settlements in Piedmont
Hero Elementary	PBS Kids shows, 2020 television series debuts
Laundresses in Lierna Lake Como (Grubicy)	20th century paintings
Isolabella	Settlements in Piedmont
La Cassa	Settlements in Piedmont
Twilight at Porta Romana (Boccioni)	 Paintings at Porta Romana, 20th century paintings, Paintings by Umberto Boccioni
La Loggia	Settlements in Piedmont
Basilica minor	Roman Catholic churches
Megan Dahle	Living people, State legislators of the United States, US Republican Party politicians
Woodblock printing	Printing, Textile arts
July 2021 Gulf of Oman incident	2021 in Asia, 21st century in Iran, July 2021 events, Oman
Lanzo Torinese	Settlements in Piedmont
Lauriano	Settlements in Piedmont
Pavone Canavese	Settlements in Piedmont
Pachyrhizus erosus	Fabaceae, Vegetables
Romano Canavese	Settlements in Piedmont
Oulx	Settlements in Piedmont
Leini	Settlements in Piedmont
Noasca	Settlements in Piedmont
Locana	Settlements in Piedmont
Glicine of Leonardo da Vinci (Via Verro, Milano)"	Oldest trees
The Drinker of Via Ripamonti (Boccioni)	 Paintings at Porta Romana, 20th century paintings, Paintings by Umberto Boccioni
Terry Kiser	1939 births, Living people, American movie actors, American television actors, American stage actors, American voice actors, Actors from Illinois
50/50 (2011 movie)	2011 comedy-drama movies, 2010s black comedy movies, American black comedy movies, American comedy-drama movies, English-language movies, Movies about death
Dorado	Constellations
List of countries in 2010	2010
List of countries in 2011	2011
List of countries in 2012	2012
List of countries in 2013	2013
List of countries in 2014	2014
List of countries in 2015	2015
List of countries in 2016	2016
List of countries in 2017	2017
List of countries in 2018	2018
List of countries in 2019	2019
Bavarian Alps	Regions of Bavaria, Mountain ranges of Germany, Mountain ranges of the Alps
Boana cambui	Frogs, Animals of South America
SCP 004-89	Stars
JB 668-991	Stars
The True Story of Eskimo Nell	1975 comedy movies, 1970s western movies, Australian comedy movies, Movies directed by Richard Franklin
Roger Browne	1930 births, Living people, American movie actors, American television actors, American YouTubers, American voice actors, Actors from Cincinnati, Ohio
Paul Westhead	1939 births, Living people, Chicago Bulls head coaches, Sportspeople from Philadelphia, Pennsylvania, Sportspeople from Los Angeles, California, Sportspeople from Oregon
California Victor University	2010 establishments in the United States, Colleges and universities in California
Voxel art	Art
Lakeview Terrace	2000s crime thriller movies, 2008 drama movies, 2008 crime movies, American crime thriller movies
Polygyny in animals	Ethology, Sexuality
Mike McShane	1955 births, Living people, American comedians, American movie actors, American stage actors, American television actors, American voice actors, Actors from Boston, Massachusetts
Polyandry in animals	Sexuality, Ethology
La Bastide, Var	Communes in Var
Baudinard-sur-Verdon	Communes in Var
Paul McNulty	1953 births, Living people, Musical instrument makers
The 1st International Chopin Competition on Period Instruments	Music competitions, 2018 in Europe
Thiès	Cities in Senegal
Benitez's tree frog	Frogs, Animals of South America
Puremba	Meitei folklore, Meitei literature
Kabui Salang Maiba	Meitei folklore
Sfax	Cities in Tunisia
Le Beausset	Communes in Var
Callas Forever	2002 drama movies, 2000s biographical movies, Italian drama movies, French drama movies, Spanish movies, British biographical movies, British drama movies, Romanian movies, Movies directed by Franco Zeffirelli
Plainfield, Illinois	Villages in Illinois, Suburbs of Chicago, Illinois
Body horror	Horror, Horror and fiction
Encyclopedia of Life	Science websites, Databases, Taxonomy
Jeopardy! (1998 video game)	1998 video games, 1999 video games, 2003 video games, PlayStation games, PlayStation 2 games, Windows games, Video games based on television shows
National weapon	Weapons, Politics
Aliaksei Mzhachyk	1996 births, 2021 deaths, Belarusian sportspeople, Olympians, Weightlifters, Road accident deaths
Francisco Weffort	1937 births, 2021 deaths, Deaths from surgical complications, Brazilian politicians, Brazilian educators, Academics, Political scientists, Brazilian writers, People from São Paulo
Kryvyi Rih	Cities in Ukraine
Azerbaijani Sign Language	Sign languages, Azerbaijani culture
Kamianske	Cities in Ukraine
Gino Renni	1943 births, 2021 deaths, Deaths from the COVID-19 pandemic in Argentina, Argentine movie actors, Argentine television actors, Argentine stage actors, Italian movie actors, Italian voice actors, Italian stage actors, Italian television actors, Argentine comedians, Argentine singers, Italian singers, Argentine politicians, Italian politicians, Actors from Buenos Aires
Jack Soo	1917 births, 1979 deaths, Deaths from esophageal cancer, American movie actors, American television actors, American stage actors, Actors from Oakland, California, Singers from Oakland, California, Comedians from California
Pat Suzuki	1930 births, Living people, American pop singers, American movie actors, American television actors, American stage actors, American voice actors, Actors from California, Singers from California
Cressey, California	Census-designated places in California, Settlements in Merced County, California
Atwater, California	Cities in California, Merced County, California
Angela Bailey	1962 births, 2021 deaths, Competitors in athletics, English sportspeople, Canadian Olympic silver medalists, Naturalized citizens of Canada, Sprinters
National shrine	Religion-related lists
Antonio de la Torre Villalpando	1951 births, 2021 deaths, Mexican footballers, Sportspeople from Mexico City
Guy Herbulot	1925 births, 2021 deaths, French Roman Catholics, Roman Catholic bishops
Renae Jacobs	1957 births, Living people, People from Lansing, Michigan
Saint-Menges	Communes in Ardennes
Besse-sur-Issole	Communes in Var
Jennifer Darling	1946 births, Living people, People from Pittsburgh, Pennsylvania
Nickelodeon movie theater	Theater
Abdalqadir as-Sufi	1930 births, 2021 deaths, Academics, British Muslims, Converts to Islam, Scottish writers
Heigenbrücken	Aschaffenburg (district)
Heimbuchenthal	Aschaffenburg (district)
Bart Has Two Mommies	The Simpsons (season 17) episodes, 2006 television episodes
Gerd Andersson	1932 births, Living people, Swedish movie actors, Swedish stage actors, Swedish television actors, Dancers, Actors from Stockholm
Ursula Kraus	1930 births, 2021 deaths, German mayors, Politicians from North Rhine-Westphalia, Politicians from Saarland
Lucy Punch	1977 births, Living people, English movie actors, English television actors, English stage actors, English voice actors, Actors from London
The Spiderwick Chronicles (movie)	2008 movies, 2000s fantasy movies, American fantasy movies
Condola Rashād	1986 births, Living people, American voice actors, American stage actors, American television actors, American movie actors, Actors from New York City
Přílepy (Kroměříž District)	Villages in the Czech Republic
Ahmad Rashād	1949 births, Living people, American football running backs, American football wide receivers, Arizona Cardinals players, Buffalo Bills players, Minnesota Vikings players, Sportspeople from Portland, Oregon, American sports commentators, Writers from Portland, Oregon
Venezuelan food	Venezuelan food
Cassina Rizzardi	Settlements in Lombardy
Lemie	Settlements in Piedmont
Viù	Settlements in Piedmont
Usseglio	Settlements in Piedmont
Mezzenile	Settlements in Piedmont
Traves, Piedmont	Settlements in Piedmont
Christiana Visentin Gajoni	Artists from Paris, French painters, Italian painters, 1974 births, Italian artists, People from Paris, Living people
Abstract photography	Photography, Art
Vernalization	Plant physiology
DB Station&Service	DB Station&Service, Rail transport in Europe, Companies of Germany, 1999 establishments in Germany
Thornhill, West Yorkshire	Villages in West Yorkshire
Transgender rights in the United Kingdom	LGBT rights in the United Kingdom, LGBT politics in the United Kingdom
Sex Discrimination Act 1975	Acts of the Parliament of the United Kingdom
Gender Recognition Panel	LGBT politics in the United Kingdom
Gender Recognition Act 2004	Acts of the Parliament of the United Kingdom, LGBT politics in the United Kingdom, 2004 in the United Kingdom
2021 United Kingdom census	Politics of the United Kingdom, 2021 in the United Kingdom
Equality Act 2006	Acts of the Parliament of the United Kingdom, 2006 in the United Kingdom
Christopher Scarver	1969 births, American criminals
Bischoff's tree frog	Frogs, Animals of South America
Kath Soucie	1967 births, Living people, Actors from Cleveland, Ohio, American movie actors, American television actors, American video game actors, American voice actors
Football at the 2020 Summer Olympics – Men's tournament	Olympic football tournaments, 2020 in association football, 2021 in association football
Kosciuszko National Park	National parks in Australia, Geography of New South Wales
Dorian Harewood	1950 births, Living people, Actors from Dayton, Ohio
Krystsina Tsimanouskaya	1996 births, Living people, 2020 Summer Olympics, Belarusian sportspeople, Female athletes, Refugees, Sprinters
EmailSanta.com	Christmas, Websites
Obama Foundation	Non-profit organizations of the United States, 2014 establishments in the United States, Barack Obama
All About Trans	LGBT in the United Kingdom
Trans Media Watch	LGBT organisations in the United Kingdom, 2009 establishments in the United Kingdom
Press for Change	LGBT in the United Kingdom
Mermaids (charity)	LGBT organisations in the United Kingdom
The Gender Trust	LGBT organisations in the United Kingdom
Labour Campaign for Trans Rights	Politics of the United Kingdom
LGBT+ Labour	LGBT organisations in the United Kingdom
Komi Republic	Republics of Russia
List of years in South Africa	South Africa
Karyn Dwyer	People from Newfoundland and Labrador, Canadian television actors, Canadian stage actors, Canadian movie actors, Canadian child actors, Suicide in 2018, 1975 births, 2018 deaths
Boana pombali	Frogs, Animals of South America
Alison Bechdel	1960 births, Living people, American cartoonists
Lucky the Dinosaur	Robots
Joey Camen	1957 births, Living people, Actors from Detroit, Michigan, Writers from Detroit, Michigan
Controlled explosion	Law enforcement techniques, Explosions
Public park	Parks
Lessolo	Settlements in Piedmont
Montalto Dora	Settlements in Piedmont
T. K. Carter	1956 births, Living people, People from New York City
Bay, Haute-Saône	Communes in Haute-Saône
Saint-Aubin-des-Bois, Eure-et-Loir	Communes in Eure-et-Loir
Green Liberal Party of Switzerland	2000s establishments in Switzerland, 2007 establishments in Europe, Political parties in Europe, Green political parties, Liberal parties, Politics of Switzerland
Rebati Tripura	Living people, 1976 births, Indian politicians
Zodiac (movie)	2007 movies, 2000s thriller movies, American thriller movies, Movies directed by David Fincher, Movies based on books
Catherine Reitman	1981 births, Living people, People from Los Angeles, California, Canadian voice actors, American voice actors
Tostones	Panamanian culture, Puerto Rico, Guatemala, Dominican Republic, Honduran culture, Costa Rica, Venezuelan food, Cuban culture, Ecuador, Peruvian culture, Colombian food
Godfred Yeboah	1980 births, 2021 deaths, Ghanaian footballers
Aloys Wobben	1952 births, 2021 deaths, German businesspeople, German engineers, People from Lower Saxony
Soerjadi Soedirdja	1938 births, 2021 deaths, Indonesian politicians
Cathy Moriarty	Singers from New York City, Award winning actors, American voice actors, American television actors, American movie actors, Actors from New York City, 1960 births, Living people
Gholam Hosein Shiri Aliabad	1961 births, 2021 deaths, Deaths from the COVID-19 pandemic in Iran, Iranian politicians
Peter Smith, Baron Smith of Leigh	1945 births, 2021 deaths, Labour Party (UK) people, Politicians from Lancashire
Antonio Pennacchi	1950 births, 2021 deaths, Deaths from myocardial infarction, Italian writers
Jerry Carter	1950s births, 2021 deaths, State legislators of the United States, Politicians from North Carolina, US Republican Party politicians
Young and Beautiful (Lana Del Rey song)	2013 songs
Saggaf bin Muhammad Aljufri	1937 births, 2021 deaths, Indonesian educators
Elias John Kwandikwa	1966 births, 2021 deaths, Tanzanian people, African politicians
Lilia Aragón	1936 births, 2021 deaths, Mexican politicians, Mexican movie actors, Mexican television actors, Mexican stage actors
Peter F. Schabarum	1929 births, 2021 deaths, San Francisco 49ers players, State legislators of the United States, Politicians from Los Angeles, California, US Republican Party politicians, Sportspeople from Los Angeles, California
Paul Cotton	1943 births, 2021 deaths, American rock guitarists, American country guitarists, American rock singers, American country singers, American singer-songwriters, Writers from Alabama, Singers from Alabama
Natalie Zea	Soap opera actors, American television actors, American stage actors, American movie actors, Actors from Houston, Texas, 1975 births, Living people
Erik Larson	1954 births, Living people, American novelists, Journalists from New York City
Gulf of Oman incident	Oman
Too Short	Musicians from Oakland, California, Gangsta rappers, American rap musicians from California, African-American rappers, 1966 births, Living people
Chan Zuckerberg Initiative	Taxation, American financial companies, 2015 establishments in California
Samuel Ajiboyede	Living people, Business people
Biohub	Non-profit organizations of California, Research organizations in the United States, 2016 establishments in the United States
Tax avoidance	Taxation
Corrine Brown	US Democratic Party politicians, United States representatives from Florida, Politicians from Jacksonville, Florida, American fraudsters, African American politicians, 1946 births, Living people
Zhou Xuan	Chinese movie actors, Chinese singers
Dried fruit	Dried foods, Snack foods, Fruits
National memorial	Monuments and memorials, Architecture, National symbols
Lynne Spears	Writers from Louisiana, Britney Spears, American Baptists, 1955 births, Living people
Tapas	Snack foods, Appetizers, Spanish food
2021 FIFA Club World Cup	2021 in association football, 2021 in Asia, Scheduled association football competitions
List of Ugandans by net worth	Lists of people, Ugandan people, Economy of Africa
Hoogmoed's tree frog	Frogs, Animals of South America
List of countries in 2020	2020
List of countries in 2021	2021
Tanzeem Ittehad-I-Ummat	Politics of Pakistan, Political parties in Pakistan
Toshiba satellite CL10-B-100	Laptops
Shafter, California	Cities in California, Settlements in Kern County, California
Tehachapi, California	Cities in California, Settlements in Kern County, California
August 2021 Gulf of Oman incident	2021 in Asia, 21st century in Iran, August 2021 events, Oman
Gholam-Ali Haddad-Adel	1945 births, Living people, Speakers of the Islamic Consultative Assembly
Mohammad Bagher Ghalibaf	1961 births, Living people, Speakers of the Islamic Consultative Assembly, Mayors, People from Tehran
Gholam-Hossein Mohseni-Eje'i	1956 births, Chief Justices of Iran, Living people
Vice President of Iran	Vice Presidents of Iran
Hassan Habibi	1937 births, 2013 deaths, Vice Presidents of Iran, People from Tehran
Mohammad Reza Aref	1951 births, Living people, Vice Presidents of Iran
Parviz Davoodi	1952 births, Living people, Vice Presidents of Iran, People from Tehran
Esfandiar Rahim Mashaei	1960 births, Living people, Vice Presidents of Iran
Mohammad Reza Rahimi	1949 births, Living people, Vice Presidents of Iran
Padma Sachdev	1940 births, 2021 deaths, Indian poets, Indian novelists
Graham McRae	1940 births, 2021 deaths, New Zealand sportspeople, Formula One drivers, People from Wellington
Miroslav Lazanski	1950 births, 2021 deaths, Deaths from myocardial infarction, Serbian politicians, Ambassadors to Russia, Journalists, Military people
National Assembly (Serbia)	Serbia
Kazimierz Kowalski	1951 births, 2021 deaths, Polish singers, People from Łódź
Kleenex	Paper
Hubert Ingraham	1947 births, Living people, Prime Ministers of the Bahamas
Jody Hamilton	1938 births, 2021 deaths, American professional wrestlers, Sportspeople from Kansas City, Missouri
The Tale of the Bamboo Cutter	Japanese folklore
Pan de jamón	Venezuelan food, Breads
Wasakaka	Venezuelan food, Sauces
Mocha, Yemen	Cities in Yemen
Byram, Mississippi	Cities in Mississippi
Indo-Persianate architecture	Architectural styles, Islamic architecture, Architecture of Pakistan
Beauregard, Mississippi	Villages in Mississippi
Big Creek, Mississippi	Villages in Mississippi
Slate Springs, Mississippi	Villages in Mississippi
Sardis, Mississippi	Towns in Mississippi, County seats in Mississippi
United States congressional delegations from Idaho	Politicians from Idaho, Lists of politicians from the United States
List of lieutenant governors of Idaho	Lieutenant Governors of Idaho, Lists of politicians
Milavče train crash	2021 disasters, 2021 in Europe, 2020s disasters in Europe, August 2021 events, History of the Czech Republic, Railway accidents in Europe
Boana caiapo	Frogs, Animals of South America
Dave Severance	1919 births, 2021 deaths, American centenarians, American military personnel of World War II, American military personnel of the Korean War, American military personnel of the Vietnam War, People from Milwaukee, Wisconsin
Brian Henderson (television presenter)	1931 births, 2021 deaths, Deaths from kidney cancer, Australian television presenters, Australian radio personalities, Television news anchors, Naturalised citizens of Australia, New Zealand entertainers
Max Park	Living people
Shazam! Fury of the Gods	2020s movies, American superhero movies, DC Extended Universe movies
Aquaman and the Lost Kingdom	2022 movies, American superhero movies, DC Extended Universe movies
Superman III	1983 movies, Superman movies, Movies directed by Richard Lester
David F. Sandberg	1981 births, Living people, Swedish movie directors, Swedish movie producers, Swedish screenwriters
Asher Angel	2002 births, Living people, American child actors, American movie actors, American television actors, American voice actors, Actors from Phoenix, Arizona
Brishaketu Debbarma	Living people, Year of birth missing (living people)
Cuban Olympic Committee	1920s establishments in North America, Sports organizations
Abbas Edalat	Living people, Computer scientists
University of Warwick	Colleges and universities in the United Kingdom, 1965 establishments in the United Kingdom
Mexican Olympic Committee	1920s establishments in North America, Sports organizations
Chigasaki, Kanagawa	Cities in Kanagawa Prefecture
Suita	Cities in Osaka Prefecture
Supernature (Goldfrapp album)	2005 albums, Goldfrapp albums
Toyohashi	Cities in Japan, Settlements in Aichi Prefecture
Kawagoe, Saitama	Cities in Japan, Settlements in Saitama Prefecture
Iwaki, Fukushima	Cities in Fukushima Prefecture
Tokorozawa, Saitama	Cities in Japan, Settlements in Saitama Prefecture
Ebina, Kanagawa	Cities in Kanagawa Prefecture
Koshigaya	Cities in Japan, Settlements in Saitama Prefecture
Aioi, Hyōgo	Cities in Japan, Settlements in Hyōgo Prefecture
Kōriyama	Cities in Fukushima Prefecture
Kasugai, Aichi	Cities in Japan, Settlements in Aichi Prefecture
There Will Be Blood	2007 drama movies, American drama movies, Movies based on books, Movies directed by Paul Thomas Anderson
Akashi, Hyōgo	Cities in Japan
Nagaoka, Niigata	Cities in Japan, Settlements in Niigata Prefecture
Bormes-les-Mimosas	Communes in Var
Yao, Osaka	Cities in Osaka Prefecture
Le Bourguet	Communes in Var
Upwelling	Oceanography
Kakogawa, Hyōgo	Cities in Japan, Settlements in Hyōgo Prefecture
Chaozhou	Cities in China, Guangdong
Hegang	Cities in China
Xining	Cities in China
Guiyang	Cities in China
Haikou	Cities in China
List of governments of Israel	Israeli governments, Israel-related lists, Politics-related lists
Tomaszów Lubelski	Towns in Poland
Sopot	Cities in Poland
Boana freicanecae	Frogs, Animals of South America
Fuchū, Tokyo	Cities in Japan
Zakopane	Towns in Poland
Sōka	Cities in Japan, Settlements in Saitama Prefecture
Neyagawa, Osaka	Cities in Osaka Prefecture
Kasukabe, Saitama	Cities in Japan, Settlements in Saitama Prefecture
Metallicity	Astrophysics, Stars
Amagasaki	Cities in Japan, Settlements in Hyōgo Prefecture
Fukuyama, Hiroshima	Cities in Japan
Funabashi, Chiba	Cities in Chiba Prefecture
2021 Welsh Conservatives leadership election	2021 elections, Conservative Party (UK), 2021 in the United Kingdom
Higashiōsaka	Cities in Osaka Prefecture
Toyonaka	Cities in Osaka Prefecture
Toyota, Aichi	Cities in Japan, Settlements in Aichi Prefecture
Atsugi	Cities in Japan, Settlements in Kanagawa Prefecture
Jōetsu, Niigata	Cities in Japan, Settlements in Niigata Prefecture
Kawaguchi, Saitama	Cities in Japan, Settlements in Saitama Prefecture
Kishiwada, Osaka	Cities in Osaka Prefecture
Kanan, Osaka	Towns in Japan, Settlements in Osaka Prefecture
Ōta, Gunma	Cities in Japan, Settlements in Gunma Prefecture
Takarazuka, Hyōgo	Cities in Japan, Settlements in Hyōgo Prefecture
Nose, Osaka	Towns in Japan, Settlements in Osaka Prefecture
University of Geneva	1550s establishments in Europe, 1559, Colleges and universities in Switzerland, Geneva
Fukuzawa Yukichi	1835 births, 1901 deaths, Japanese writers, Japanese journalists
Ajicero criollo	Venezuelan food, Sauces
Richard Trumka	1949 births, 2021 deaths, Deaths from myocardial infarction, American lawyers, American political activists, Businesspeople from Pittsburgh, Pennsylvania, Cardiovascular disease deaths in Washington, D.C.
Matsudo	Cities in Chiba Prefecture
Nemacolin, Pennsylvania	Census-designated places in Pennsylvania
Thomas R. Donahue	1928 births, Living people, American lawyers, American political activists, Businesspeople from New York City
Yevhen Marchuk	1941 births, 2021 deaths, Deaths from respiratory failure, Deaths from heart failure, Deaths from the COVID-19 pandemic, Prime Ministers of Ukraine
Hassaballah El Kafrawy	1930 births, 2021 deaths, Egyptian politicians, Engineers
Tachi Yamada	1945 births, 2021 deaths, Deaths from myocardial infarction, Japanese scientists, Naturalized citizens of the United States, American physicians, Businesspeople from Tokyo, Businesspeople from Seattle, Washington
Jaco Van Dormael	1957 births, Movie directors, Belgian movie directors
Åke Lundqvist	1936 births, 2021 deaths, Swedish movie actors, Swedish television actors, Swedish stage actors, Swedish voice actors
Yu Ying-shih	1930 births, 2021 deaths, Naturalized citizens of the United States, Chinese historians, Chinese academics, American historians, American academics, Writers from New Jersey, People from Princeton, New Jersey
Bogliasco	Settlements in Liguria
Ventimiglia	Cities in Liguria
Erchie	Settlements in Apulia
Kessler Twins	Living people, 1936 births, Twin people, Sibling musical duos, German musical entertainers, German pop singers, Child singers, German movie actors, Child actors, German models, People from Saxony
2021 British Isles heat wave	2021 in Europe, 2021 disasters, 2021 in the United Kingdom
Microsoft Bug Bounty Program	Microsoft
Khamaj	Indian culture
The Whole Year is Christmas	1960 movies, 1960s fantasy movies, Argentine movies, Christmas movies, Movies directed by Román Viñoly Barreto
Voodoo Island	1957 horror movies, 1950s thriller movies, American horror movies, American thriller movies, Movies directed by Reginald Le Borg
Jamake Highwater	1931 births, 2001 deaths, People with HIV/AIDS, American writers, Fraudsters
Gil Stauffer	1905 establishments in Europe, Companies of Spain
Monster Hunter (movie)	2020 movies, Monster Hunter series
A Gathering of Eagles	1963 drama movies, 1960s romantic drama movies, American romantic drama movies, Movies directed by Delbert Mann
DNA methyltransferase	DNA, Enzymes, Epigenetics
Dog Soldiers	2002 horror movies, British horror movies, American horror movies, Luxembourgian movies, Movies directed by Neil Marshall
The Wastrel	1961 drama movies, Italian drama movies, Cypriot movies, Movies directed by Michael Cacoyannis
Jit (movie)	1990 romance movies, 1990 comedy movies, 1990s romantic comedy movies, Zimbabwean movies
LGBT conservatism	LGBT, Conservatism
LGBT+ Conservatives	LGBT organisations in the United Kingdom
LGBT+ Liberal Democrats	LGBT organisations in the United Kingdom
Equality before the law	Political philosophy
Campaign for Homosexual Equality	LGBT organisations in the United Kingdom
Coalition for Equal Marriage	LGBT in the United Kingdom
Gay Liberation Front	LGBT
Anna Kostivna Lypkivska	Ukrainian writers, Ukrainian journalists, 1967 births, 2021 deaths, Deaths from the COVID-19 pandemic
Organisation Intersex International	LGBT organisations in the United Kingdom
Intersex UK	LGBT organisations in the United Kingdom
Minorities Research Group	LGBT organisations in the United Kingdom, 1963 establishments in the United Kingdom
Sexual Offences Act 1967	Acts of the Parliament of the United Kingdom
Tory Campaign for Homosexual Equality	LGBT organisations in the United Kingdom
Naz and Matt Foundation	LGBT organisations in the United Kingdom, 2014 establishments in Europe
Bras, Var	Communes in Var
Brenon	Communes in Var
Brue-Auriac	Communes in Var
Cabasse	Communes in Var
La Cadière-d'Azur	Communes in Var
Callas, Var	Communes in Var
Callian, Var	Communes in Var
Calliano, Piedmont	Settlements in Piedmont
Calliano, Trentino	Settlements in Trentino-Alto Adige/Südtirol
A Town Like Alice (movie)	1956 drama movies, 1950s war movies, British war movies, British drama movies, Australian drama movies, Movies based on books, Movies directed by Jack Lee
Burbot	Freshwater fish
Junior Eurovision Song Contest 2020	2020 in Europe, Junior Eurovision Song Contest
Rusty tree frog	Frogs, Animals of South America
Junior Eurovision Song Contest 2021	2021 in Europe, 2021 in music, Junior Eurovision Song Contest
Command prompt	Microsoft Windows software
Hanna, Louisiana	Unincorporated communities in Red River Parish, Louisiana
Shotgun (1955 movie)	1955 movies, 1950s western movies, American western movies, Movies directed by Lesley Selander
Los Angeles County Board of Supervisors	Los Angeles County, California
Sheila Kuehl	1941 births, Living people, State legislators of the United States, American lawyers, American movie actors, American television actors, American stage actors, LGBT actors, LGBT politicians, LGBT lawyers, Politicians from Tulsa, Oklahoma, Actors from Tulsa, Oklahoma, Politicians from Los Angeles County, California, Actors from Santa Monica, California, LGBT people from Oklahoma, LGBT people from California, US Democratic Party politicians, Lesbians
Michael D. Antonovich	1939 births, Living people, State legislators of the United States, Politicians from Los Angeles, California, US Republican Party politicians
Holly Mitchell	1964 births, Living people, State legislators of the United States, Politicians from Los Angeles, California, US Democratic Party politicians
Janice Hahn	1952 births, Living people, United States representatives from California, State legislators of the United States, Politicians from Los Angeles, California, US Democratic Party politicians
Kathryn Barger	Living people, State legislators of the United States, Politicians from Los Angeles County, California, US Republican Party politicians
Emilio Bianchi Di Cárcano	1930 births, 2021 deaths, Roman Catholic priests, Roman Catholic bishops, People from Buenos Aires
Yūsuke Kinoshita	1993 births, 2021 deaths, Japanese baseball players, Deaths from cardiopulmonary arrest, People from Osaka
Razzy Bailey	1939 births, 2021 deaths, American country musicians, American country singers, American singer-songwriters, Singers from Alabama, Singers from Tennessee, Writers from Alabama, Writers from Tennessee
Goodlettsville, Tennessee	Cities in Tennessee
Maurice Brun	1925 births, 2021 deaths, French mayors
The Texican	1966 movies, 1960s western movies, American western movies, Spanish movies, Movies directed by Lesley Selander, Columbia Pictures movies
Reg Gorman	1938 births, 2021 deaths, Australian movie actors, Australian television actors, Australian stage actors, Actors from Sydney, Australian comedians, Cancer deaths in Australia
Yuri Trutnev (scientist)	1927 births, 2021 deaths, Russian physicists, Russian academics, People from Moscow
Sarov	Towns in Russia
Lalibela	World Heritage Sites in Africa, Towns in Africa, Ethiopia
Gabriel Boric	1986 births, Living people, Chilean politicians, Chilean lawyers
Milavče	Villages in the Czech Republic
Camps-la-Source	Communes in Var
Le Cannet-des-Maures	Communes in Var
Caribbean philosophy	Philosophy
The Suit (2003 movie)	2003 comedy-drama movies, Tajik movies, Russian movies, German comedy movies, German drama movies, French comedy movies, French drama movies, Italian comedy movies, Italian drama movies, Ukrainian movies, Movies based on short stories, Movies directed by Bakhtyar Khudojnazarov
Jaffa Cakes	British food, Baked foods
Bombs Over Burma	1942 movies, 1940s war movies, 1940s drama movies, American war movies, American drama movies, World War II movies, Movies directed by Joseph H. Lewis
The Future of Emily	1984 drama movies, German drama movies, French drama movies, Movies directed by Helma Sanders-Brahms
Google Hangouts	Google
Meir Kahane	Jewish politicians, 1932 births, 1990 deaths, American Jews by occupation, Assassinated people
Marty	1955 drama movies, 1950s romantic drama movies, American romantic drama movies, Movies based on plays, Movies directed by Delbert Mann, Best Picture Oscar
Torii	Japanese culture, Shinto
Roy, Louisiana	Unincorporated communities in Louisiana, Settlements in Bienville Parish, Louisiana
Belmont, Louisiana	Settlements in Sabine Parish, Louisiana, Census-designated places in Louisiana
Present simple tense	Grammar
Marieve Herington	1988 births, American video game actors, American voice actors, Canadian movie actors, Canadian voice actors, Living people
Ed Emery (politician)	1950 births, 2021 deaths, Deaths from myocardial infarction, State legislators of the United States, Politicians from Missouri, US Republican Party politicians, Businesspeople from Missouri
Julio César Anderson	1947 births, 2021 deaths, Guatemalan footballers
Take My Breath	2021 songs, The Weeknd, Disco songs
Carlos Ruiz	1979 births, Living people, Guatemalan footballers, People from Guatemala City
Brad Allan	1973 births, 2021 deaths, Martial artists, Choreographers, Australian movie actors, Australian television actors, Stuntmen, Actors from Melbourne, Deaths from myocardial infarction
Rolf Erling Andersen	Norwegian politicians, 1947 births, 2021 deaths
Alireza Azizi	1949 births, 2021 deaths, Iranian footballers
Robbie Cooke	1957 births, 2021 deaths, English football managers, English footballers, Sportspeople from Yorkshire
Patrick Kilpatrick	1949 births, Living people, American movie actors, American television actors, American stage actors, American teachers, Movie directors from Los Angeles, California, Movie producers from Los Angeles, California, Screenwriters from Los Angeles, California, Journalists from California, American television directors, American television producers, Actors from Virginia, Writers from Virginia, Politicians from Virginia, Politicians from Los Angeles, California, US Democratic Party politicians
Chris Bell (director)	Living people, 1972 births
Angelyne	1950 births, Living people, Polish movie actors, Polish television actors, Polish singers, Polish politicians, Naturalized citizens of the United States, American movie actors, American television actors, Singers from Los Angeles, California, Actors from Los Angeles, California, Models from Los Angeles, California, Polish artists, Polish businesspeople, Businesspeople from Los Angeles, California, American artists
Amando Samo	1948 births, 2021 deaths, Roman Catholic bishops
Katie Lowes	1982 births, Living people, American movie actors, American stage actors, American television actors, American voice actors, American theatre directors, Actors from Queens
Aryeh Gamliel	1951 births, 2021 deaths, Israeli rabbis, Israeli politicians
Daniela Melchior	1996 births, Living people, Portuguese movie actors, Portuguese television actors, Portuguese voice actors, Models
London Underground D78 Stock	Transport in London
Effervescence	Chemical processes
Martine Wright	Living people, 1972 births, Sportspeople from London, Members of the Order of the British Empire, Sitting volleyball players
The Girl Code	The Simpsons episodes, 2010s television episodes
Iceland (movie)	1942 movies, 1940s musical movies, 1940s romance movies, American musical movies, American romance movies, 20th Century Fox movies, Movies directed by H. Bruce Humberstone
Erica Nlewedim	1994 births, Living people, Nigerian actors
Separate Tables	1958 drama movies, 1950s romantic drama movies, American romantic drama movies, Movies based on plays, Movies directed by Delbert Mann
Santpedor	Municipalities in Catalonia
Boana exastis	Frogs, Animals of South America
The King of Fighters (movie)	2010 movies
No Way to Treat a Lady	1968 comedy movies, 1960s crime movies, 1968 thriller movies, American black comedy movies, American crime thriller movies, American serial killer movies, Movies based on books, Movies directed by Jack Smight, Paramount movies
Trevor Moore (comedian)	1980 births, 2021 deaths, Accidental deaths in California, American movie actors, American television actors, American stage actors, American television writers, American television producers, American television directors, Musicians from New Jersey, Screenwriters from New Jersey, Movie directors from New Jersey, Movie producers from New Jersey, Actors from New Jersey, People from Montclair, New Jersey, Comedians from New Jersey, Musicians from New York City, Screenwriters from New York City, Movie directors from New York City, Movie producers from New York City, Actors from New York City, Comedians from New York City
Markie Post	1950 births, 2021 deaths, American movie actors, American television actors, American stage actors, American voice actors, Deaths from cancer, People from Palo Alto, California, Actors from Santa Clara County, California
Oleksandr Rojtburd	1961 births, 2021 deaths, People from Odessa, Painters
Najma Chowdhury	1942 births, 2021 deaths, Deaths from the COVID-19 pandemic in Bangladesh, Bangladeshi writers, Bangladeshi politicians, Bangladeshi Muslims, Academics, Feminist writers
Trinity test	Nuclear weapons
Artesia, New Mexico	Cities in New Mexico
Jennifer Winget	1985 births, Living people, Actors from Mumbai
Michael Patrick Mulroy	Living people, United States Department of Defense officials
Cheddar, Somerset	Villages in Somerset, Civil parishes in Somerset
Murphy, North Carolina	Towns in North Carolina, County seats in North Carolina
VT-AXH	Boeing 737
Half Moon (movie)	2006 comedy-drama movies, Iranian movies, Austrian movies, French comedy movies, French drama movies, Iraqi movies, Movies directed by Bahman Ghobadi
Lurcher	Dog breeds
2019, After the Fall of New York	1983 science fiction movies, Italian science fiction movies, French science fiction movies, Movies directed by Sergio Martino
Carcès	Communes in Var
Carnoules	Communes in Var
Carqueiranne	Communes in Var
Le Castellet, Var	Communes in Var
Cavalaire-sur-Mer	Communes in Var
La Celle, Var	Communes in Var
Châteaudouble, Var	Communes in Var
Saint-Aubin-des-Landes	Communes in Ille-et-Vilaine
Christopher Barrios, Jr.	2001 births, 2007 deaths, 2007 crimes, Missing people, Missing American people
War widow	Social issues
Eferding	Cities and towns in Upper Austria
Roter Berg, Vienna	Hills, Vienna
Châteauvert	Communes in Var
Surtsey	Islands of Oceania
Sarthe (river)	Rivers of France, Normandy, Pays de la Loire
Aire-sur-l'Adour	Communes in Landes
Tarnos	Communes in Landes
Châteauvieux, Var	Communes in Var
Claviers	Communes in Var
Cogolin	Communes in Var
Canal Zone tree frog	Frogs, Animals of South America
Sirod	Communes in Jura
Saint-Georges-de-Didonne	Communes in Charente-Maritime
Iron Eyes Cody	1907 births, 1999 deaths, American actors
Brazil nut	Ericales, Edible nuts and seeds
Six-Fours-les-Plages	Communes in Var
Zagarolo	Settlements in Lazio
Whitewashing in movies	Movies, Racism
Present continuous	Grammar, English language
Bride Flight	2008 romance movies, 2008 drama movies, 2000s romantic drama movies, Dutch romance movies, Dutch drama movies, Luxembourgian movies, New Zealand movies, Movies directed by Ben Sombogaart
Pistachio	Anacardiaceae, Edible nuts and seeds
The Ancient Roman Mosaic of Lierna on Lake Como	Cultural anthropology, Archaeological artifacts, Archaeology of Italy, Archaeological discoveries in Lake Como, 1876 archaeological discoveries, Augustan building projects
No Good Read Goes Unpunished	The Simpsons episodes, 2018 television episodes
Othello syndrome	Mental illnesses
La Valette-du-Var	Communes in Var
Collobrières	Communes in Var
Martha Mitchell effect	Mental illnesses, Watergate scandal
The Mothman Prophecies (film)	2002 movies, 2002 horror movies, Movies based on books
Mothman	Legendary creatures, American folklore
The Siberian Times	Siberia, News media
Anupam Shyam	1957 births, 2021 deaths, Deaths from multiple organ failure, Indian movie actors, Indian television actors, Indian stage actors
Yves de Wasseige	1926 births, 2021 deaths, Belgian politicians, Belgian economists
Guillermo González (politician)	1941 births, 2021 deaths, Colombian politicians, Engineers
Popayán	Cities in Colombia
Moisés Torres (politician)	1949 births, 2021 deaths, Bolivian politicians, Academics, Journalists, Deaths from the COVID-19 pandemic
Oleg Shapovalov	1963 births, 2021 deaths, Ukrainian politicians
2021 Belarus–European Union border crisis	2021 in Europe, August 2021 events, History of Belarus, History of international relations, History of Lithuania, Immigration, July 2021 events
2021 Taliban offensive	2021 in Asia, 21st century in Afghanistan, May 2021 events, June 2021 events, July 2021 events, August 2021 events, Taliban, Terrorist incidents in 2021
List of prime ministers of Saint Vincent and the Grenadines	Prime Ministers of Saint Vincent and the Grenadines
Adonal Foyle	1975 births, Living people, Saint Vincent and the Grenadines people, Naturalized citizens of the United States, Orlando Magic players, Golden State Warriors players, Memphis Grizzlies players, Sportspeople from Pennsylvania
Hamilton, New York	Towns in New York
Hamilton (village), New York	Villages in New York
Olean (town), New York	Towns in New York
Little Valley (village), New York	Villages in New York, County seats in New York
Little Valley, New York	Towns in New York
Great Valley, New York	Towns in New York
Salamanca (city), New York	Cities in New York
Salamanca (town), New York	Towns in New York
Ischua, New York	Towns in New York
Milton Cato	1915 births, 1997 deaths, Prime Ministers of Saint Vincent and the Grenadines
Arnhim Eustace	Living people, Prime Ministers of Saint Vincent and the Grenadines, 1944 births
Synthetic radioisotope	Isotopes
Vincent Barabba	1934 births, Living people, Researchers, Writers from Chicago, Politicians from Chicago
Generation Alpha	Demographics, Cultural anthropology
Bruce Chapman	1940 births, Living people, Ambassadors of the United States, Politicians from Illinois, Writers from Illinois, Businesspeople from Illinois, American conservatives, US Republican Party politicians, People from Evanston, Illinois
Synthetic element	Chemical elements
Barbara Everitt Bryant	1926 births, Living people, Researchers, Politicians from Michigan, People from Ann Arbor, Michigan, US Republican Party politicians
Martha Farnsworth Riche	1939 births, Living people, People from Ann Arbor, Michigan, American economists, Politicians from Michigan, US Democratic Party politicians
Kenneth Prewitt	1936 births, Living people, American academics, Politicians from Illinois, US Democratic Party politicians
Death on the Nile (2022 movie)	2022 movies, 2020s mystery movies, 2020s thriller movies, Sequel movies, British mystery movies, British thriller movies, American mystery movies, American thriller movies, Movies based on books
Eyeshine	Vision, Animal anatomy
Sophie Okonedo	1968 births, Living people, English movie actors, English stage actors, English television actors, English voice actors, Actors from London, Tony Award winning actors
Murder on the Orient Express (2017 movie)	2017 movies, American thriller movies, American mystery movies, British thriller movies, British mystery movies, Movies set in Turkey, Movies set in Europe, Movies based on books
Tom Bateman (actor)	1989 births, Living people, British movie actors, British television actors, British stage actors, Actors from Oxfordshire, People from Oxford
Danny Antonucci	1957 births, Living people, Writers from Toronto, Canadian animators
Daniel Wu	1974 births, Living people, Actors from Hong Kong, American television actors, American stage actors, American voice actors, Movie directors from California, Movie producers from California, Screenwriters from California, Actors from Berkeley, California
In My Father's Garden	2016 drama movies, Dutch drama movies, Belgian movies, Movies based on books, Movies directed by Ben Sombogaart
Stable element	Isotopes
Shraddha Nigam	1979 births, Living people, Indian actors
Sackboy (LittleBigPlanet)	Video game characters
Turning	technology
LittleBigPlanet 2	2011 video games, LittleBigPlanet, PlayStation 3 games, PlayStation 3-only games, Sony Interactive Entertainment games, Video game sequels
Divisions of Seraikistan Province	Divisions of Pakistan
Districts of Seraikistan Province	Districts of Pakistan
Liu Kang (Mortal Kombat)	Mortal Kombat characters
Wrestling Ernest Hemingway	1993 drama movies, 1993 romance movies, 1990s romantic drama movies, American romantic drama movies, Warner Bros. movies, Movies directed by Randa Haines
Doom (franchise)	Doom series, Video game series
My Name Is Nobody	1973 comedy movies, 1970s western movies, Italian comedy movies, German comedy movies, French comedy movies, Movies directed by Tonino Valerii
WWE 2K Battlegrounds	2020 video games, Nintendo Switch games, PlayStation 4 games, Windows games, Xbox One games
Hypervisor	Software
Night sky	Astronomy
Boana cipoensis	Frogs, Animals of South America
Steve Smallman	1959 births, Living people, British children's writers, British illustrators, People from Cambridge
Jono Howard	Canadian television writers, Living people, Year of birth missing (living people)
Manipur in Olympics	Sport in India
One City, Nine Towns	2001 in Asia
Seoraksan	Geography of Korea, Mountains of Asia
Gomoku Narabe Renju	Famicom Disk System games, Nintendo Entertainment System games, 1983 video games, Board games, Japan exclusive video games, Virtual Console games, 2006 video games, Video games developed in Japan
Tom and Jerry in New York	American animated television series, 2020s American comedy television series, American children's television series, English-language television programs, Tom and Jerry, Sitcoms, HBO Max
Crying Indian public service announcement	Advertising, Environment, Waste management
Pili	Edible nuts and seeds
Mike Kubat	Year of birth missing (living people), Living people, Canadian television writers
Cock (slang)	English profanity
2021 Hartlepool by-election	2021 elections, 2021 in the United Kingdom, Hartlepool, Elections in the United Kingdom
Fag (slang)	English profanity, Gay slang, Homophobia, Slurs
Poofter	Homophobia, Slurs
The Doctor (movie)	1991 drama movies, American drama movies, Movies based on books, Movies directed by Randa Haines
Night Crossing	1982 drama movies, 1980s war movies, American drama movies, American war movies, German drama movies, British drama movies, British war movies, Movies directed by Delbert Mann
Happy Anniversary (1959 movie)	1959 comedy movies, American comedy movies, Movies directed by David Miller
Framed (1947 movie)	1947 movies, 1940s crime movies, American crime movies, Columbia Pictures movies, Movies directed by Richard Wallace
Isshiki	Naruto characters
Anger of the Gods	2003 drama movies, Burkinabé movies, French drama movies, Movies directed by Idrissa Ouedraogo
Myken	Norway
George Herbert Walker Jr.	1905 births, 1977 deaths, American businesspeople
Siem Reap	Settlements in Cambodia
Fuente's Powakka tree frog	Frogs, Animals of South America
2017 Copeland by-election	2017 elections, 2017 in England, Copeland, Elections in the United Kingdom
Raa Raa the Noisy Lion	2011 British television series debuts, 2018 television series endings, Animated television series, British children's television series, BBC Television programmes, CBeebies, Fictional animals
Matt Hill	1968 births, Living people, People from Vancouver, Canadian voice actors
Sam Vincent (voice actor)	1971 births, Living people, People from Vancouver, Canadian voice actors
Tony Sampson	1977 births, Living people, People from Vancouver, Canadian voice actors
Saint Kitts and Nevis–United Kingdom relations	International relations, Government of the United Kingdom, Saint Kitts and Nevis
Flashpoint (TV series)	2008 Canadian television series debuts
Flora of Azerbaijan	Biology, Geography of Azerbaijan, Azerbaijan-related lists
Dodo bird verdict	Psychiatry
Gloster, Louisiana	Census-designated places in Louisiana, Settlements in DeSoto Parish, Louisiana
Simon Rieber	1994 births, Living people, Tanzanian people
Southeastern Louisiana University	Colleges and universities in Louisiana, 1925 establishments in the United States, 20th-century establishments in Louisiana
Dick Beals	1927 births, 2012 deaths, American voice actors, American radio actors, Actors from Detroit, Michigan
Bad Boy Records	American record labels
Tatuí	Cities in São Paulo (state)
Mequinenza	Cities in Aragon, Municipalities in Aragon
Mthokozisi Nxumalo	1989 births, 2021 deaths, Road accident deaths, South African politicians
Julian Beale	1934 births, 2021 deaths, Liberal Party of Australia politicians, Politicians from Sydney
Lev Pidlisetskyi	1977 births, 2021 deaths, Ukrainian politicians, Ukrainian businesspeople
Stefan Kapłaniak	1933 births, 2021 deaths, Polish Olympic medalists, Olympic bronze medalists
Walter Yetnikoff	1933 births, 2021 deaths, Businesspeople from New York City, Deaths from bladder cancer
Cesare Salvadori	1941 births, 2021 deaths, Italian Olympic silver medalists, Olympic gold medalists, Fencers, People from Turin
Jaan Kaplinski	1941 births, 2021 deaths, Deaths from motor neurone disease, Estonian politicians, Estonian writers, Poets, Philosophers, Translators, Critics
María Elena Chapa	1944 births, 2021 deaths, Mexican politicians, Mexican activists, Cancer deaths in Mexico
Carlton H. Colwell	1926 births, 2021 deaths, State legislators of the United States, Businesspeople from Georgia (U.S. state), Politicians from Georgia (U.S. state), US Democratic Party politicians
Black-flanked tree frog	Frogs, Animals of South America
Fork (chess)	Chess
Olivia Podmore	Sportswomen, People who committed suicide, People from Christchurch, 1997 births, 2021 deaths, New Zealand sportspeople, Olympians, Cyclists
Second inauguration of Richard Nixon	1970s in the United States, Richard Nixon, United States presidential inaugurations, January events
Alex Cord	1933 births, 2021 deaths, American movie actors, American television actors, American stage actors, American voice actors, Actors from New York, Actors from Texas
Floral Park, New York	Villages in New York
Ryszard Jarzembowski	1945 births, 2021 deaths, Polish journalists, Polish politicians
Bob Jenkins	1947 births, 2021 deaths, American sports commentators, People from Richmond, Indiana, Deaths from brain cancer
Sergei Kovalev	1930 births, 2021 deaths, Russian politicians, Russian writers, Human rights activists
Viktor Likhonosov	1936 births, 2021 deaths, Deaths from the COVID-19 pandemic in Russia, Russian novelists, Soviet writers, Editors
Ingrid Remmers	1965 births, 2021 deaths, German politicians of the Left Party, Politicians from North Rhine-Westphalia
Nadir Tedeschi	1930 births, 2021 deaths, Italian politicians
Badia Polesine	Settlements in Veneto
Trezzano sul Naviglio	Settlements in Lombardy
Neal Conan	1949 births, 2021 deaths, Deaths from glioblastoma, American radio personalities, American editors, American war correspondents, American journalists, People from Beirut
Kyaikmakaw Pagoda	Buildings and structures in Asia
Cameron Burrell	1994 births, 2021 deaths, American track and field athletes, Sprinters, Sportspeople from Houston, Texas, Suicides by firearm in the United States
Leroy Burrell	1967 births, Living people, American track and field athletes, American Olympic gold medalists, Sportspeople from Philadelphia, Pennsylvania, Sportspeople from Houston, Texas
Michelle Finn-Burrell	1965 births, Living people, American track and field athletes, Sportspeople from Orlando, Florida
Jean "Binta" Breeze	1956 births, 2021 deaths, Deaths from COPD, Jamaican people, Poets, Theatre directors
Walter Wangerin Jr.	1944 births, 2021 deaths, American theologians, American educators, Writers from Portland, Oregon, American Christians
Sistine Stallone	1998 births, Living people, American movie actors, Models from Los Angeles, California, Actors from Los Angeles, California
Chi McBride	1961 births, Living people, American movie actors, American television actors, American stage actors, American voice actors, Actors from Chicago
Hassium tetroxide	Chemical compounds
Del Irani	Living people, People from Mumbai, Australian journalists
Pericardium	Heart
Girls Just Want to Have Fun (movie)	1985 comedy movies, 1985 romance movies, 1980s musical movies, 1980s teen romance movies, 1980s romantic comedy movies, American romantic comedy movies, American musical movies, Movies directed by Alan Matter
Howard Hughes Medical Institute	Medical and health organizations in the United States, Research organizations in the United States, 1953 establishments in the United States
Point Pleasant, West Virginia	Cities in West Virginia, County seats in West Virginia
Boana rhythmica	Frogs, Animals of South America
Zygarde	Pokémon monsters
Nestea	1948 establishments in the United States, Soft drinks, Nestlé
1875 Kilkenny City by-election	1870s in the United Kingdom, 1870s in Europe, Elections in the United Kingdom, County Kilkenny
Animated sitcom	Television genres
Second inauguration of George W. Bush	2005 in the United States, United States presidential inaugurations, George W. Bush
Göran Zachrisson	1938 births, 2021 deaths, Swedish journalists, Swedish television personalities, Sports commentators, Writers from Stockholm, Editors
Gianluigi Gelmetti	1945 births, 2021 deaths, Italian composers, Italian conductors, Monegasque people, Writers from Rome, Musicians from Rome
Marco Borradori	1959 births, 2021 deaths, Deaths from cardiac arrest, Deaths from multiple organ failure, Swiss lawyers, Swiss politicians, Mayors
Sabina Ajrula	1945 births, 2021 deaths, North Macedonia, Turkish movie actors, Turkish television actors, Turkish stage actors, Deaths from stroke, Deaths from brain cancer
Donald Kagan	1932 births, 2021 deaths, American historians, American political writers, American conservatives, Naturalized citizens of the United States, American academics, Lithuanian writers, Writers from New York City, Writers from Washington, D.C.
Kumar Pallana	1918 births, 2013 deaths, Indian movie actors, Indian television actors, Indian stage actors, Indian voice actors, Indian comedians, American movie actors, American television actors, American stage actors, American voice actors, Vaudeville performers, Comedians from California, Actors from Oakland, California, Naturalized citizens of the United States
Kevin Farrell	1947 births, Living people, Cardinals of the Roman Catholic Church, Roman Catholic bishops, American Roman Catholics, Naturalized citizens of the United States, People from Dublin, People from Dallas, Texas
Teatro dell'Opera di Roma	Theatres, Buildings and structures in Rome, Buildings and structures completed in the 19th century
Hayden, Indiana	Unincorporated communities in Indiana, Census-designated places
Rome, Indiana	Unincorporated communities in Indiana
Paulo José	1937 births, 2021 deaths, Deaths from pneumonia, Deaths from Parkinson's disease, Brazilian movie actors, Brazilian television actors, Brazilian stage actors, Voice actors, Brazilian movie directors, Brazilian screenwriters, People from Rio Grande do Sul
Glauber Rocha	1939 births, 1981 deaths, Deaths from bronchopneumonia, Deaths from sepsis, Brazilian movie directors, Brazilian movie producers, Brazilian screenwriters, Brazilian movie actors, Brazilian stage actors
Amapa tree frog	Frogs, Animals of South America
Cast a Giant Shadow	1966 movies, 1960s action movies, American action movies, American biographical movies, Movies based on books, Movies directed by Melville Shavelson
Yours, Mine and Ours (1968 movie)	1968 comedy movies, American comedy movies, American family movies, Movies based on books, Movies directed by Melville Shavelson
Pulmonary atresia	Medical emergencies
Rockdale	Towns in Illinois
2021 Greece wildfires	August 2021 events
Natalia Gavrilița	Living people, 1977 births, Prime Ministers of Moldova, Economists
Bob Hewitt	1940 births, Living people, Australian tennis players, South African sportspeople, Australian criminals, People convicted of assault, Rapists, Sportspeople from New South Wales
Kew, Victoria	Victoria, Australia
Elizabeth Prelogar	1980 births, Living people, American lawyers, United States Solicitors General, People from Boise, Idaho, Politicians from Idaho, US Democratic Party politicians
Donald B. Verrilli Jr.	1957 births, Living people, United States Solicitors General, American lawyers, Politicians from New York, Politicians from Connecticut, People from New Rochelle, New York, People from Wilton, Connecticut, US Democratic Party politicians
Adela Forestello	1923 births, 2021 deaths, Human rights activists, People from Santa Fe, Argentina
Ary Ribeiro Valadão	1918 births, 2021 deaths, Brazilian politicians, Centenarians, Brazilian lawyers
Love Happy	1949 movies, 1940s musical movies, 1940s comedy movies, American musical comedy movies, Movies directed by David Miller
Gareth Ward	Living people, 1974 births, British diplomats, Ambassadors of the United Kingdom
Alexander Gesmundo	1956 births, Living people, Chief Justices of the Supreme Court of the Philippines
Majority Floor Leader of the House of Representatives of the Philippines	Majority leaders of the House of Representatives of the Philippines
Martin Romualdez	1963 births, Living people, Majority leaders of the House of Representatives of the Philippines
Arthur Defensor Sr.	1941 births, Living people, Majority leaders of the House of Representatives of the Philippines
Sergio Apostol	1935 births, Living people, Majority leaders of the House of Representatives of the Philippines
Bella Angara	Living people, 1939 births, Majority leaders of the House of Representatives of the Philippines
Eduardo Gullas	1930 births, Living people, Majority leaders of the House of Representatives of the Philippines
Mar Roxas	1957 births, Living people, Majority leaders of the House of Representatives of the Philippines
Minority Floor Leader of the House of Representatives of the Philippines	Minority leaders of the House of Representatives of the Philippines
Danilo Suarez	1942 births, Living people, Minority leaders of the House of Representatives of the Philippines
Ronaldo Zamora	1944 births, Living people, Minority leaders of the House of Representatives of the Philippines
Joseph Stephen Paduano	1965 births, Living people, Minority leaders of the House of Representatives of the Philippines
Henry Cabot Lodge	1850 births, 1924 deaths, Deaths from stroke, Deaths from surgical complications, United States senators from Massachusetts, Majority leaders of the United States Senate, United States representatives from Massachusetts, US Republican Party politicians, Presidents pro tempore of the United States Senate
Augustus Octavius Bacon	1839 births, 1914 deaths, Presidents pro tempore of the United States Senate, United States senators from Georgia, State legislators of the United States, US Democratic Party politicians
Charles L. McNary	1874 births, 1944 deaths, Minority leaders of the United States House of Representatives, United States senators from Oregon, People from Salem, Oregon, US Republican Party politicians
Wendell Willkie	1892 births, 1944 deaths, Deaths from myocardial infarction, American lawyers, Businesspeople from New York City, Businesspeople from Indiana, Politicians from Indiana, Politicians from New York City, US Republican Party politicians
Jose Perez (judge)	1946 births, 2021 deaths, Filipino lawyers, Filipino judges
Batangas City	Cities in the Philippines
Robert Wisdom	1953 births, Living people, American movie actors, American television actors, American stage actors, American voice actors, Actors from Washington, D.C.
Analytical engine	Computers
Arthur Aguiar	1989 births, Living people, Brazilian actors
2013 South Shields by-election	2013 in England, Tyne and Wear, Elections in the United Kingdom
Wright StreetLite	Buses
Liber Abaci	Mathematics literature
Golden spiral	Mathematics
Plymouth shooting	2021 crimes in Europe, 2021 in the United Kingdom, 2020s mass shootings in Europe, 2020s murders in Europe, August 2021 events, Mass murder in 2021, Mass murder in England, Murder-suicides in Europe, Murders by firearm in England, Plymouth, Devon, Suicide in the 2020s, Suicides in the United Kingdom
Worzel Gummidge (TV series)	1979 television series debuts, 1980s British television series, 1970s British television series
Una Stubbs	1937 births, 2021 deaths, Disease-related deaths in Scotland, English movie actors, English television actors, English stage actors, English voice actors, English television personalities, English dancers, Actors from Hertfordshire
Igael Tumarkin	1933 births, 2021 deaths, German sculptors, German painters, Naturalized citizens of Israel, Israeli sculptors, Israeli painters, People from Dresden
João Lyra	1931 births, 2021 deaths, Brazilian businesspeople, Brazilian politicians, Deaths from bronchopneumonia
Tommy Curtis	1952 births, 2021 deaths, American basketball players, Sportspeople from Michigan, Sportspeople from Los Angeles, California
Albion, Michigan	Cities in Michigan
Marshall, Michigan	Cities in Michigan, County seats in Michigan
John A. Rizzo	1947 births, 2021 deaths, American lawyers, Businesspeople from Boston, Massachusetts, Businesspeople from Washington, D.C., Deaths from myocardial infarction
Peter Fleischmann	1937 births, 2021 deaths, German movie directors, German screenwriters, German movie producers, Accidental deaths from falls
Cherilyn Mackrory	1976 births, Living people, UK MPs 2019–, Conservative MPs (UK)
Gil Cisneros	1971 births, Living people, United States representatives from California, American philanthropists, Businesspeople from California, US Democratic Party politicians
Without Pity (1948 movie)	1948 movies, 1940s drama movies, 1940s crime movies, Italian drama movies, Movies directed by Alberto Lattuada
1 Mile North	Musical groups from New York, Musical duos
Leon Litwack	1929 births, 2021 deaths, Deaths from bladder cancer, American historians, Writers from Berkeley, California, People from Santa Barbara, California, Pulitzer Prize winners
Dominic DeNucci	1932 births, 2021 deaths, Deaths from heart failure, American professional wrestlers, Naturalized citizens of the United States, Sportspeople from Veneto, Sportspeople from Philadelphia, Pennsylvania, People from Venice
Freedom, Pennsylvania	Boroughs in Pennsylvania
Helen B. Taussig	1898 births, 1986 deaths, Road accident deaths in the United States, American physicians, Cardiology, Scientists from Massachusetts, People from Cambridge, Massachusetts, Presidential Medal of Freedom recipients
Jane Somerville	1933 births, Living people, British physicians, British academics, Researchers
Tommy Dorsey	1905 births, 1956 deaths, Deaths from choking, American jazz musicians, American bandleaders, American trombonists, American conductors, Musicians from Pennsylvania
Shenandoah, Pennsylvania	Boroughs in Pennsylvania
Pottsville, Pennsylvania	Cities in Pennsylvania, County seats in Pennsylvania
Indian Achievers Awards	Awards
Tsutomu Miyazaki	1962 births, 2008 deaths, People with personality disorders, People with schizophrenia, Murderers
Mr. President (title)	Presidents
Catherine Colonna	Ambassadors of France, Living people, 1956 births, Alumni of the Institut d'études politiques de Paris
Mark Woerde	Living people, 1973 births, Dutch writers
Tsukudani	Japanese food
Speed Walking	2014 drama movies, 2010s LGBT movies, Danish movies, Movies based on books, Movies directed by Niels Arden Oplev
Valle tree frog	Frogs, Animals of South America
Garðabær	Cities in Iceland, Municipalities of Iceland
Kjósarhreppur	Municipalities of Iceland
Mosfellsbær	Towns in Iceland, Municipalities of Iceland
Satoshi Uematsu	1990 births, 2016 in Asia, July 2016 events, Hate crimes, Kanagawa Prefecture, Murderers, Living people, Prisoners sentenced to death
Seltjarnarnes	Towns in Iceland, Municipalities of Iceland
1957 African Cup of Nations	Africa Cup of Nations
Comps-sur-Artuby	Communes in Var
Correns	Communes in Var
Cotignac	Communes in Var
La Crau	Communes in Var
La Croix-Valmer	Communes in Var
Nowy Sącz	Cities in Poland
Julie London	Singers from Los Angeles, California, Golden Globe Award winning actors, Deaths from cardiac arrest, Disease-related deaths in Los Angeles, American television actors, American stage actors, American radio actors, American pop singers, American musical theatre actors, American movie actors, American jazz singers, Actors from Los Angeles, California, 1926 births, 2000 deaths
Second Syrian Republic	Former countries in the Middle East, Former republics, Former polities of the Cold War, States and territories disestablished in the 20th century, Establishments in Syria, 1960s disestablishments in Asia, 1963 disestablishments
First Syrian Republic	Former countries in the Middle East, Former republics, Former polities of the Cold War, Establishments in Syria, States and territories established in the 20th century, States and territories disestablished in the 20th century, 1930s establishments in Asia, 1930 establishments, 1940s disestablishments in Asia, 1946 disestablishments
State of Syria (1925–1930)	Former countries in the Middle East, 1925 establishments in Asia
Don Benito	Cities in Extremadura, Municipalities in Extremadura
Maine (river)	Rivers of France, Pays de la Loire
Pérols-sur-Vézère	Communes in Corrèze
Corrèze, Corrèze	Communes in Corrèze
Cuers	Communes in Var
Entrecasteaux	Communes in Var
Esparron, Var	Communes in Var
Esparron, Haute-Garonne	Communes in Haute-Garonne
Gino Strada	1948 births, 2021 deaths, Italian physicians, Italian activists, Human rights activists, Surgeons, People from Lombardy
Haydée Coloso-Espino	1937 births, 2021 deaths, Deaths from respiratory tract infection, Filipino sportspeople, Swimmers, Olympians
Les Vandyke	1931 births, 2021 deaths, English pop singers, Singer-songwriters from London
Nanci Griffith	1953 births, 2021 deaths, Grammy Award winners, American folk singers, American country guitarists, American country singers, American folk musicians, Singer-songwriters from Texas, Musicians from Nashville, Tennessee, Singers from Nashville, Tennessee, Writers from Nashville, Tennessee, Musicians from Austin, Texas, Singers from Austin, Texas
Gábor Novák	1934 births, 2021 deaths, Hungarian sportspeople, Olympic silver medalists
Robert H. Burnside	1933 births, 2021 deaths, State legislators of the United States, Politicians from South Carolina, People from Columbia, South Carolina, American lawyers, Businesspeople from South Carolina, US Democratic Party politicians
Devizes (UK Parliament constituency)	Constituencies in the United Kingdom, Wiltshire

