Book of Enoch	Books of the Bible
Anton LaVey	1930 births, 1997 deaths, American esotericists, Deaths from pulmonary edema, Jewish American writers, Religious leaders, Satanists, Writers from Chicago, American atheists, Deaths from lung disease, Disease-related deaths in California, People from San Francisco, American musicians
Hurricane Ike	2008 Atlantic hurricane season, 2008 in the United States, 2008 in Canada, 2000s in Cuba, Category 4 Atlantic hurricanes, 2000s in the Dominican Republic, 2000s in Haiti, Hurricanes in the United States, 2000s in the Bahamas, Turks and Caicos Islands, Natural disasters in Canada, Hurricanes in Texas, Hurricanes in Louisiana
Rafflesia	Plants of Asia, Parasitic plants, Flowers, Rafflesiaceae
Northern Fury FC	Australian football clubs
Edward Said National Conservatory of Music	Music schools, Buildings and structures in Palestine, Bethlehem, Jerusalem
SafetySuit	American rock bands, Post-grunge bands, Musical groups from Oklahoma
Life Left to Go	2008 albums
Someone like You (SafetySuit song)	2008 songs
Stay (SafetySuit song)	2008 songs
Vrilissia	Cities in Greece, Attica
Squall	Severe weather
Oxford English Dictionary	Dictionaries
Thomas Beecham	British conductors, 1879 births, 1961 deaths, Grammy Award winners
Teatro Colón	Opera houses, Buildings and structures in Argentina, Buenos Aires, 19th-century establishments in Argentina
Bim Bum Bam	1982 television series debuts, Italian television
Puyi	1906 births, 1967 deaths, Deaths from cardiovascular disease, Emperors and Empresses of China
Lithium (song)	Nirvana songs, 1992 songs
Endocrinology	Endocrinology
Adipose tissue	Animal tissues, Lipids
Flying Spaghetti Monster	Gods and goddesses, Internet
Campeonato Brasileiro Série A	Campeonato Brasileiro Série A, 1959 establishments, 1950s establishments in Brazil
Sand plantain	Plantaginaceae
The Real Ghostbusters	Animated television series, English-language television programs
Messianic Judaism	New religious movements, Jewish denominations, Christian movements and denominational families
Malcolm Sargent	1895 births, 1967 deaths, British conductors, Gilbert and Sullivan
Playoffs	Sports words
Lars	Given names
Boyce and Hart	American boy bands, Musical groups from Virginia
Janesville, Wisconsin	Cities in Wisconsin, County seats in Wisconsin, 1835 establishments in the United States, 1830s establishments in Michigan Territory
Malcolm Gladwell	1963 births, Living people, Canadian journalists, Writers from Hampshire, Writers from Ontario
Rosoideae	Roses
First Leicester	British transport companies
Dappy	1987 births, Living people, British people convicted of assault, English rap musicians, Celebrity Big Brother contestants, People from Camden (London borough), Singers from London, British R&B musicians, Grime music artists
Sepal	Botany
Cotyledon	Botany
Arriva Fox County	British transport companies, 1981 establishments in England, Bus transport
Sede do BankBoston	Skyscrapers in Brazil, São Paulo, 2002 establishments in South America, 2000s establishments in Brazil
Amygdaloideae	Rosaceae
Centrebus	British transport companies
Vasily Chuikov	1900 births, 1982 deaths, Soviet generals, Soviet military personnel of World War II
Power Purchasing Agreement	Electricity distribution
Pioneer plaque	Pioneer program
Clube Atlético Mineiro	Brazilian football clubs, Belo Horizonte, 1908 establishments in South America, 1900s establishments in Brazil
Sport Club Internacional	Brazilian football clubs, Porto Alegre, 1909 establishments in Brazil
Guarani FC	Football clubs in São Paulo (state), 1911 establishments, 1910s establishments in Brazil
C.R. Flamengo	Brazilian football clubs
Grêmio Foot-Ball Porto Alegrense	Brazilian football clubs, Porto Alegre, 1903 establishments in South America, 1900s establishments in Brazil
Coritiba Foot Ball Club	Paraná State, Coritiba Foot Ball Club, 1909 establishments in Brazil
Sport Club do Recife	Brazilian football clubs, Recife, 1905 establishments in South America, 1900s establishments in Brazil
Esporte Clube Bahia	Brazilian football clubs, Salvador, Bahia, 1931 establishments in Brazil
Botafogo de Futebol e Regatas	Football clubs in Rio de Janeiro, 1904 establishments in South America, 1900s establishments in Brazil
Clube Atlético Paranaense	Brazilian football clubs, Curitiba, 1924 establishments in South America, 1920s establishments in Brazil
Santos FC	Football clubs in São Paulo (state), 1912 establishments in Brazil
Joseph Karl Stieler	1781 births, 1858 deaths, German painters, People from Mainz
List of The Real Ghostbusters episodes	Lists of animated television series episodes
New Mills	Towns in Derbyshire
Guido Westerwelle	1961 births, 2016 deaths, Cancer deaths in Germany, Deaths from leukemia, Disease-related deaths in North Rhine-Westphalia, Gay men, German lawyers, German LGBT people, Government ministers of Germany, LGBT lawyers, LGBT politicians, Politicians from North Rhine-Westphalia, Politicians of the Free Democratic Party of Germany, Vice Chancellors of Germany
Vancouver, Washington	Cities in Washington (U.S. state), County seats in Washington
Radiant heating	Construction, Heat
74 (number)	Integers
Top Gear	2002 television series debuts, 2000s British television series, 2010s British television series, BBC Television programmes, English-language television programs
Backpacking (wilderness)	Leisure, Camping
Châlons-en-Champagne	Communes in Marne, Departmental capitals in France
Nicolas Appert	1749 births, 1841 deaths, French inventors
Schulze method	Voting systems, Debian
The Man from Earth	2007 movies, American science fiction movies, American independent movies
Shaolin Monastery	Buildings and structures in China, Buddhist buildings, 5th century establishments in Asia, Establishments in China
Egyptian vulture	Accipitriformes, Birds of Africa, Birds of Europe, Birds of Asia, Vultures
Henan	Provinces of China
Pulp Fiction	1994 crime movies, 1994 drama movies, 1990s crime drama movies, Academy Award winning movies, American crime drama movies, BAFTA Award winning movies, English-language movies, Film noir, Golden Globe Award winning movies, Movies about drugs, Movies about murderers, Movies directed by Quentin Tarantino, Movies set in Los Angeles, California, Rape in movies, American independent movies
Soju	Alcoholic drink, Korean food
Goguryeo	History of Korea, Royal dynasties, 30s BC establishments
Wilhelm Pieck	1876 births, 1960 deaths, German atheists, Members of the Reichstag (Weimar Republic), Members of the Volkskammer, People from former German territories, Presidents of East Germany
Beth Elamen Cemetery	Beirut, Cemeteries, Buildings and structures in Lebanon
Broxbourne railway station	Railway stations opened in 1840, Railway stations served by National Express East Anglia, 1840 establishments in England
Daemon (computer software)	Servers
Overcharge	Business
Rye House railway station	Railway stations served by National Express East Anglia, 1843 establishments in Europe, 1840s establishments in England
List of London Underground stations	London Underground stations, London-related lists, Lists of railway stations in the United Kingdom
Ratatat	American rock bands, Electronic music bands, Musical groups from New York City
Binary form	Music theory
Bubble tea	Tea, Asian foods
An Jung-sik	1861 births, 1919 deaths, Korean people, Artists
Korean International School of Hong Kong	Schools in South Korea, 1988 establishments in Asia, 1980s establishments in South Korea
Cyon	Companies of South Korea, Technology companies of Asia, 1997 establishments in Asia, 1990s establishments in South Korea
Battle of the year	Dance
Takahiro Matsumoto	Living people, 1961 births, Japanese guitarists, People from Osaka Prefecture
Foot binding	Feet, History of China, Women
Udenhout	Settlements in North Brabant, Former municipalities of North Brabant, Tilburg
HY	Japanese rock bands, 2000 establishments in Japan
Mount Kisco	Villages in New York
Maslak USO Center	Buildings and structures in Turkey
Kinki Kids	J-pop bands, 1992 establishments in Japan
Scott Young (writer)	1918 births, 2005 deaths, Autobiographers, People from Manitoba, Canadian journalists, Canadian novelists, Elmer Ferguson Award winners
Scott Young (ice hockey b. 1967)	1967 births, American ice hockey players, American Olympic silver medalists, Colorado Avalanche players, Dallas Stars players, Hartford Whalers players, Living people, Mighty Ducks of Anaheim players, Pittsburgh Penguins players, Quebec Nordiques players, Sportspeople from Massachusetts, St. Louis Blues players, Stanley Cup champions
Scott Young (ice hockey b. 1965)	1965 births, American Hockey League players, Canadian ice hockey defencemen, Ice hockey people from Ontario, Living people
Pico da Neblina	Geography of Brazil, Mountains of South America, Amazonas (Brazil)
Amazonas (Brazilian state)	Amazonas (Brazil), States of Brazil
Jurua River	Rivers of Brazil, Rivers of Peru
Japurá River	Rivers of Brazil, Rivers of Colombia
Woolwich Arsenal station	Docklands Light Railway stations, Transport in Greenwich, London Travelcard zone 4, 1849 establishments in England
King George V DLR station	Docklands Light Railway stations, Transport in Newham, London Travelcard zone 3
London City Airport DLR station	Docklands Light Railway stations, Transport in Newham, London Travelcard zone 3
Pontoon Dock DLR station	London Travelcard zone 3, Docklands Light Railway stations
West Silvertown DLR station	Docklands Light Railway stations, Transport in Newham, London Travelcard zone 3
Canning Town station	London Travelcard zone 3, Docklands Light Railway stations
Critical thinking	Critical thinking
East India DLR station	Docklands Light Railway stations, Transport in Tower Hamlets, London Travelcard zone 2, London Travelcard zone 3
Blackwall DLR station	London Travelcard zone 2, Docklands Light Railway stations
Amazonas Region	Regions of Peru
Wayuu	Ethnic groups in South America, Colombia, Venezuela
Waxing	Care
Vinoba Bhave	1895 births, 1982 deaths, Indian revolutionaries, Nonviolence advocates
Cheongsam	Chinese culture, Dresses
Kikuyu	Kenyan people, Ethnic groups in Africa
Incheon International Airport	Airports in Asia, Buildings and structures in South Korea, Incheon, Transport in South Korea, 2001 establishments in Asia, 2000s establishments in South Korea
Lao language	Languages of Asia
Sukiyaki	Japanese food
Poplar DLR station	Docklands Light Railway stations, London Travelcard zone 2
Shawm	Early musical instruments, Woodwind instruments
Westferry DLR station	Docklands Light Railway stations, London Travelcard zone 2
Limehouse station	London Travelcard zone 2, Railway stations opened in 1840, Docklands Light Railway stations, 1840 establishments in England
Ripley, Derbyshire	Towns in Derbyshire
Shadwell DLR station	London Travelcard zone 2, Docklands Light Railway stations
Wide receiver	American football positions
Offensive linemen	American football positions
Purus River	Rivers of Brazil, Rivers of Peru, Rivers of Bolivia
Madeira River	Rivers of Brazil, Rivers of Bolivia
Putumayo River	Rivers of Colombia, Rivers of Ecuador, Rivers of Peru, Rivers of Brazil
Albert Jacka	1893 births, 1932 deaths, Victoria Cross winners, Australian military people, Politicians from Victoria (Australia), Mayors
Vaupés River	Rivers of Colombia
Yoruba people	Ethnic groups in Africa, Ethnic groups in Nigeria
Pennsylvania Cyber Charter School	Schools in Pennsylvania, 2000 establishments in the United States, 2000s establishments in Pennsylvania
International Union for the Conservation of Nature	International Union for the Conservation of Nature, 1948 establishments
Street dance	Dance types, Hip hop
Red-collared lorikeet	Birds of Australia, Lorikeets
Lee Yunjeong	Living people, 1976 births, South Korean singers, People from Seoul
Vacaville, California	Cities in California, Cities in the San Francisco Bay Area, Settlements in Solano County, California
Hearts of Iron	Real-time strategy video games, Video games developed in Sweden
20th Century Fox Games	Video game companies, Fox, Defunct companies
Cell biology	Cell biology
Lee Min Ho	Living people, 1987 births, South Korean movie actors, South Korean television actors, People from Seoul
Pentaport Rock Festival	Rock festivals, South Korean culture, Festivals in Asia, Incheon, 2006 establishments in Asia, 2000s establishments in South Korea
WJAC-TV	American television stations, Pennsylvania, 1949 establishments in the United States, 20th-century establishments in Pennsylvania
WPXI	American television stations, Pittsburgh, Pennsylvania, 1957 establishments in the United States, 1950s establishments in Pennsylvania
WIIC-TV	1957 establishments in the United States, 1950s establishments in Pennsylvania, 1981 disestablishments in the United States
Jacques-Louis David	1748 births, 1825 deaths, French politicians, People of the French Revolution
Popsicle	Desserts
WGAL	American television channels, NBC
Silvio Barbato	1959 births, 2009 deaths, Aviation deaths, Brazilian people, Italian conductors, Minas Gerais
Travelcard Zone 4	London Underground
Sexual fetishism	Human sexuality
Mark Martin	1959 births, Living people, NASCAR drivers, American racecar drivers
Hendrick Motorsports	NASCAR
Earnhardt Ganassi Racing	NASCAR
Roush Fenway Racing	NASCAR
Jack Roush	1942 births, Living people, NASCAR, Sportspeople from Kentucky
John W. Henry	1949 births, Living people, Businesspeople from Illinois
Photo booth	Photography, Commerce
Busan International Film Festival	Movie festivals, Busan, Festivals in Asia, 1996 establishments in Asia, 1990s establishments in South Korea
Oscar Peterson	1925 births, 2007 deaths, Canadian musicians, Deaths from renal failure, Jazz pianists, People from Montreal
Wonder Girls	South Korean musical groups, K-pop music groups, 2007 establishments in South Korea
All About Lily Chou-Chou	Japanese movies, 2001 movies
John Barbirolli	1899 births, 1970 deaths, British conductors, Companions of Honour, Knights Bachelor
John Galliano	1960 births, Living people, British fashion designers, British LGBT people, Gibraltar, LGBT fashion designers
Sasuke Uchiha	Naruto characters
Exclusive economic zone	Economic policy, International law, Oceans
Amar Shonar Bangla	Bangladesh, National anthems
Shin Seung-hun	South Korean singers, Living people, Year of birth missing (living people)
Munhwa Broadcasting Corporation	Television networks, Korean media
Travelcard Zone 1	London Underground, London Travelcard zone 1
Acton Town tube station	District Line stations, Piccadilly Line stations, London Travelcard zone 3
Aldgate tube station	Circle Line stations, Metropolitan Line stations, Tube stations in the City of London
Travelcard Zone 2	London Underground, London Travelcard zone 2
Aldgate East tube station	District Line stations, Hammersmith & City Line stations, Transport in Tower Hamlets, London Travelcard zone 1
All Saints DLR station	London Travelcard zone 2, Docklands Light Railway stations
Travelcard Zone 3	London Underground, London Travelcard zone 3
Alperton tube station	Piccadilly Line stations, Transport in Brent, London Travelcard zone 4
Angel tube station	Northern Line stations, London Travelcard zone 1, Tube stations in Islington
Amersham station	Metropolitan Line stations, Buckinghamshire, 1892 establishments in England
Travelcard Zone 5	London Underground, London Travelcard zone 5
Teddy boy	British culture, Fashion, 1950s
Shinee	K-pop music groups, R&B bands, South Korean boy bands, 2008 establishments in South Korea
Baskin-Robbins	American food companies, 1953 establishments
Kurt Busch	1978 births, Living people, NASCAR drivers, American racecar drivers, Sportspeople from Las Vegas, Nevada
Strike zone	Baseball rules
Team Penske	NASCAR, Formula One constructors, 1968 establishments, 2009 disestablishments, IndyCar Series
Chupa Chups	Companies of Spain, Food companies of Europe
Big Bang (band)	South Korean boy bands, K-pop music groups, 2006 establishments in Asia, 2000s establishments in South Korea
Hélio Castroneves	1975 births, Living people, Brazilian racecar drivers
Changdeokgung	Palaces, Buildings and structures in Seoul, World Heritage Sites in South Korea
Korea University	Schools in South Korea, 1905 establishments, 20th century establishments in South Korea, 1900s establishments in Asia
Joseph-Armand Bombardier	1907 births, 1964 deaths, Canadian inventors, People from Quebec
Earthship	Houses
Matt Kenseth	NASCAR drivers, 1972 births, Living people, American racecar drivers, Daytona 500 winners, Sportspeople from Wisconsin
Kittanning, Pennsylvania	County seats in Pennsylvania, 1724 establishments, Boroughs in Pennsylvania, Settlements established in the 18th century, 1720s establishments in the Thirteen Colonies, 18th-century establishments in Pennsylvania
Gastric dumping syndrome	Diseases and disorders of the digestive system
Richard Peddie	1947 births, Living people, Canadian sportspeople, Ice hockey people from Ontario
Webmail	Internet, E-mail
Club Penguin	Online games, Disney video games, Massively multiplayer online role-playing games
Crush syndrome	Syndromes
Culture shock	Anthropology
Modern dance	Dance types
Epik High	South Korean musical groups, 2003 establishments in South Korea
Ben Foster (footballer)	1983 births, Living people, English association football goalkeepers, Sportspeople from Warwickshire, Premier League players
Yonsei University	Schools in South Korea, 1885 establishments, 1880s establishments in Asia, Establishments in South Korea
Hankuk Academy of Foreign Studies	Schools in South Korea, 2004 establishments in Asia
El Clásico	Football in Spain
American Embassy School	Schools in India, New Delhi
Bungee jumping	Leisure, Sports
Blast fishing	Fishing
Nam June Paik	American artists, 1932 births, 2006 deaths
Arirang (2011 movie)	2011 movies, Korea
Osechi	Japanese food
Enma	Buddhist gods and goddesses, Japanese deities
Futon	Japanese culture, Furniture
Johnny & Associates	Companies of Japan, Entertainment companies, 1963 establishments in Japan
Archway tube station	Northern Line stations, Tube stations in Islington, London Travelcard zone 2, London Travelcard zone 3
Arnos Grove tube station	Piccadilly Line stations, Tube stations in Enfield, Grade II listed buildings in London, Grade II listed railway stations, Art Deco buildings, Railway stations opened in 1932, Charles Holden buildings
Cuba libre	Alcoholic drink
Nanta	South Korean music
Boeing 777	Boeing aircraft
Seo Tai-ji	South Korean singers, 1972 births, Living people
Cyworld	Social networking
Yoo Young Chul	Burglars, Fraudsters, Prisoners, Robbers, Serial killers, South Korean criminals, Thieves, Living people, 1970 births
Men at Work	1970s music groups, 1980s music groups, 1990s music groups, 2000s music groups, 2010s music groups, Australian pop music groups, Australian rock bands, New wave bands, Musical groups from Melbourne, Musical groups established in 1979, 1979 establishments in Australia, Musical groups disestablished in 1986, 1980s disestablishments in Australia, Musical groups established in 1996, 1990s establishments in Australia
Ji Kang Hun	South Korean criminals
Valya Balkanska	1942 births, Living people, Bulgarian singers
Commercial Act of South Korea	Economy of South Korea, Commerce, Legislation, History of South Korea
Dilation and curettage	Surgery, Female reproductive system
Bhagwan Shree Rajneesh	Philosophers, Autobiographers, 1931 births, 1990 deaths, Deaths from heart failure, Religious people, Spiritual teachers
Ashkenazi Jews	Jewish ethnic groups, European Jews
Dilation and evacuation	Abortion
Visual kei	Rock music, Japanese culture
Dwarf hamster	Hamsters
Damien Rice	1973 births, Living people, Irish guitarists, Irish rock musicians, Irish singer-songwriters, European pianists, Record producers, Rock guitarists
Entrena	Municipalities in La Rioja (Spain)
Brahui people	Dravidian peoples, Ethnic groups in Balochistan (Pakistan)
Chittagonian peoples	Ethnic groups in Bangladesh, Tripura, Chittagong Hill Tracts
International Year of Astronomy	Astronomy
Shan people	Ethnic groups in China, Myanmar, Thailand
Marketing mix	Marketing
Infiltration tactics	World War I
Clarity Act	Canada, 1999 in Canada, 1990s in law
Nell	South Korean musical groups, Rock bands, 1999 establishments in Asia, 1990s establishments in South Korea
Mongolian hamster	Hamsters
Tibetan dwarf hamster	Hamsters
Lee Chang-dong	Living people, 1954 births, South Korean movie directors
The Hallé	British orchestras, Manchester, 1858 establishments in the United Kingdom, 1850s establishments in England
Turkish hamster	Hamsters
Romanian hamster	Hamsters
Kam dwarf hamster	Hamsters
Samaritans	Abrahamic religions, Ethnic groups in Israel, Ethnic groups in the Middle East, Palestine, Religion in Israel
Indian religions	Indian religions
The Red Queen	Biology books, Coevolution, Metaphors referring to nature
Lembit Oll	1966 births, 1999 deaths, Chess grandmasters, Estonian sportspeople, Suicides by jumping
Matryoshka	Dolls
Novak Djokovic	1987 births, Living people, Australian Open champions, Male tennis players, Olympic bronze medalists, Serbian tennis players, US Open (tennis) champions, Wimbledon champions, World No. 1 tennis players
On the 6	Jennifer Lopez albums, 1999 albums, Debut albums, Pop albums, Latin music albums, R&B albums
J.Lo	Jennifer Lopez albums, 2001 albums, Dance pop albums, Latin music albums, R&B albums
FIDE	1924 establishments in Europe, 1920s establishments in France, Chess
Chess master titles	Chess
Pungmul	Korean music
Afro	Hairstyles
Unconscious mind	Cognition, Consciousness
Andrew Rivkin	Canadian businesspeople, Living people, People from Toronto, 1969 births
Roborovski hamster	Hamsters
Palmengarten	Botanical gardens in Europe, Frankfurt
Jeju-do	Islands of South Korea, Provinces of South Korea
Las Cruces, New Mexico	Cities in New Mexico, County seats in New Mexico, 1840s establishments in North America
Rio Rancho, New Mexico	Cities in New Mexico
Watford tube station	Railway stations in Hertfordshire, Metropolitan Line stations, Watford, 1925 establishments in Europe, 1920s establishments in England
Ha Seung-Jin	1985 births, Living people, South Korean sportspeople, Basketball players, Portland Trail Blazers players, People from Seoul
This Is Me... Then	Jennifer Lopez albums, 2002 albums, Hip hop albums, Soul albums, R&B albums
Rebirth (Jennifer Lopez album)	Jennifer Lopez albums, 2005 albums, Dance albums, Hip hop albums, R&B albums
Como Ama una Mujer	Jennifer Lopez albums, 2007 albums, Latin music albums, R&B albums, Spanish-language albums
El Cantante (soundtrack)	2007 albums, Jennifer Lopez albums, Latin music albums, Latin pop albums, R&B albums, Latin Grammy Award-winning albums
Brave (Jennifer Lopez album)	Jennifer Lopez albums, 2007 albums, Pop albums, Funk albums, R&B albums, Dance albums
Feelin' So Good (DVD)	Jennifer Lopez albums, 2000 albums, Compilation albums, Latin music albums, Hip hop albums, R&B albums
Let's Get Loud (DVD)	Jennifer Lopez DVDs
The Reel Me	2003 albums, Jennifer Lopez albums, Jennifer Lopez DVDs
Como Ama una Mujer (miniseries)	Jennifer Lopez DVDs
Gravitational lensing	Astrophysics, Relativity, Basic physics ideas, Galaxies, Gravitation
Lasse Lindh	Pop musicians, 1974 births, Living people, Swedish musicians
Glen Hansard	Guitarists, Irish singers, Songwriters, 1970 births, Living people, Best Original Song Academy Award-winning songwriters
Ciscaucasian hamster	Hamsters
MacBook Pro	Apple hardware, Laptops
Joan Bennett	American movie actors, American television actors, Actors from New Jersey, 1910 births, 1990 deaths, American silent movie actors
Rice Riots of 1918	1918, 20th century in Japan, 20th century riots
Judith Chapman	1952 births, Living people, American television actors, American movie actors, Actors from South Carolina, People from Greenville, South Carolina
Hinduism in Bangladesh	Bangladeshi culture, Hinduism by country, Hinduism in South Asia
Bhutan–India relations	Foreign relations of India, Bhutan
India–Ireland relations	Republic of Ireland, Foreign relations of India
Cornish people	Ethnic groups in the United Kingdom, Celtic peoples, People from Cornwall
Argentina-India relations	Government of Argentina, Foreign relations of India
Yaqui River	Rivers of Mexico, Sonora
Kacchu	Armour, History of Japan, Japanese clothing, Samurai
Calligraphy	Writing
Mad cow disease	Infectious diseases
Galen	Greek physicians, Philosophers
Ibn Battuta	1360s deaths, 1304 births, Explorers, Moroccan people
Kyshtym disaster	1957, 1950s in the Soviet Union, Disasters in the Soviet Union, Nuclear accidents, September events
Oldboy	2003 movies, Korean-language movies
Cheese on toast	Cheese dishes
Deoksugung	Buildings and structures in South Korea, Palaces
Infinite Challenge	Reality television series, South Korean television series, 2005 television series debuts, 2005 establishments in Asia, 2000s establishments in South Korea
Bean Pole International	Companies of South Korea, Clothing companies, 1989 establishments in Asia, 1980s establishments in South Korea
Nakseongdae	Buildings and structures in Seoul
Hwaseong Fortress	Buildings and structures in South Korea, Fortification, World Heritage Sites in South Korea
Yi Sang-jae	1850 births, 1927 deaths, History of Korea, Religious leaders, Korean people
YB	South Korean musical groups, Rock bands, 1990s establishments in South Korea, Musical groups established in 1994, 1994 establishments in Asia
Brown Eyed Soul (band)	South Korean musical groups, K-pop music groups, R&B bands, 2003 establishments in South Korea
Tteokguk	Korean food, Soups
Nail art	Body art, Cosmetics
Gyeongju	Cities in South Korea, Capital of Korea, Former national capitals
Samsung	Samsung, Companies of South Korea, 1938 establishments in Asia, 20th century establishments in South Korea
Ko Young-Min	1984 births, Living people, South Korean baseball players
Insadong	Seoul, Subdivisions of South Korea
Mexican peso	Currency of North America, Economy of Mexico
Olive ridley sea turtle	Reptiles of Australia, Turtles
System requirements	Software, Computer science
George Clooney	1961 births, Living people, Actors from Kentucky, Actors who played Batman, American movie actors, American movie directors, American movie producers, American screenwriters, American television actors, American television directors, American television producers, American voice actors, Extras, People from Lexington, Kentucky, Writers from Kentucky
Canon EOS	Cameras
Coco Chanel	1883 births, 1971 deaths, French fashion designers, French people of World War II, People from Pays de la Loire
Itaewon	Seoul, Subdivisions of South Korea
J. M. G. Le Clézio	1941 births, Living people, French essayists, French Nobel Prize winners, French novelists, People from Nice, Writers from Provence-Alpes-Cote d'Azur
Sejong the Great	1397 births, 1450 deaths, Kings of Joseon
Kabuki	Entertainment in Japan, Dance types, Drama
Karl Böhm	1894 births, 1981 deaths, Austrian conductors, Grammy Award winners, People from Graz
Leipzig Gewandhaus	Buildings and structures in Saxony, Concert halls, Leipzig
Rebab	String instruments, Early musical instruments
Sackbut	Trombones, Early musical instruments
Boeing 727	Boeing aircraft
PowerBook	Apple hardware, Laptops
IBook	Apple hardware, Laptops
Scrapbook	Stationery, Hobbies
Agios Nikolaos	Cities in Greece, Crete
Rethymno	Cities in Greece
Chios (city)	cities in Greece
Ron Clark	Living people, People from New York City, 1972 births
Rhodes (city)	cities in Greece
Daniel Harding	1975 births, Living people, British conductors
Mytilene	Cities in Greece
Zakynthos (city)	Cities in Greece
Mitsuko Uchida	Japanese pianists, 1948 births, Living people
Ekaltadeta	Marsupials of Australia, Fossils
Aad de Mos	1947 births, Living people, Dutch football managers, Eredivisie managers, Sportspeople from The Hague
Britain's Got Talent	2007 British television series debuts, 2000s British television series, 2010s British television series, ITV reality television programmes, Reality television competitions, English-language television programs
Syco	British record labels
Neil Diamond	American country musicians, American folk musicians, American pop musicians, American rock musicians, People with Parkinson's disease, Singer-songwriters from New York, Folk singers, Jewish American musicians, Kennedy Center honorees, Musicians from New York City, Singers from New York City, 1945 births, Living people
Got Talent series	Reality television competitions
István Kertész	1929 births, 1973 deaths, Accidental deaths by drowning, Entertainers from Budapest, German conductors, Hungarian conductors
PGA Tour	Golf, Sports organizations
Phil Mickelson	American golfers, Sportspeople from San Diego, California, 1970 births, Living people
Fall of Constantinople	History of Turkey, 1453
List of libertarian parties	Lists of political parties, Libertarian parties
Council areas of Scotland	Scottish Council Areas
Forks, Washington	Cities in Washington (U.S. state)
Doyle Brunson	1933 births, Living people, People from Texas, Poker players
Tim Pawlenty	1960 births, Living people, US Republican Party politicians, Governors of Minnesota
Grand Forks, North Dakota	Grand Forks, North Dakota, County seats in North Dakota, 1870 establishments in the United States, 1870s establishments in Dakota Territory
Kent Conrad	1948 births, Living people, US Democratic Party politicians, United States senators from North Dakota, People from Bismarck, North Dakota
Didí Torrico	1988 births, Living people, Bolivian footballers
Internet fraud	Crime
Mimar Sinan	Architects, 1489 births, 1588 deaths
The Ashes	Cricket
Travelcard Zone 6	London Underground, London Travelcard zone 6
Gerresheim	Düsseldorf-Gerresheim, Boroughs of Germany, Düsseldorf
Independent Spirit Awards 2005	Movie awards
Argostoli	Cities in Greece
Lefkada (city)	cities in Greece
Komotini	Cities in Greece
Raval	Video game characters, Online games
Apple Worldwide Developers Conference	Apple Inc., San Francisco, June events, 1987 establishments in California
Strum, Wisconsin	Trempealeau County, Wisconsin, Villages in Wisconsin
Dard people	Ethnic groups in Kashmir
Tony Mowbray	1963 births, Living people, English football managers, English footballers, People from North Yorkshire, Sportspeople from Yorkshire
Primary cell	Batteries
Liam Finn	1983 births, Living people, Rock musicians, New Zealand singers
Twilight (2008 movie)	2008 drama movies, 2008 romance movies, 2000s fantasy movies, 2000s romantic drama movies, 2000s teen drama movies, 2000s teen romance movies, American fantasy movies, American romantic drama movies, American teen drama movies, American teen romance movies, English-language movies, Movies based on books, Movies set in Washington (U.S. state), Phoenix, Arizona in fiction, Vampires in movies
Cyclone Tracy	1974, Tropical cyclones in Oceania, 20th century in Australia, Northern Territory
Kristen Stewart	Actors from Los Angeles, California, American child actors, American movie actors, BAFTA Award winners, 1990 births, Living people, LGBT entertainers, Bisexual people
Catch That Kid	2004 comedy movies, 2000s criminal comedy movies, 2000s movie remakes, 20th Century Fox movies, American criminal comedy movies, American family movies, American heist movies, American movie remakes, English-language movies, Movies about families
Catherine Hardwicke	Living people, 1955 births, American movie directors
Art museum	Art museums
Bavarian State Opera	Munich, Opera companies, 1653 establishments, 1650s establishments in Europe, 17th century establishments in Germany
Police Academy	Police Academy, Warner Bros. movies, Animated television series
Tacloban	Cities in the Philippines
Indian National Congress	1885 establishments, Social democratic parties, Political parties in India, 1880s establishments in India
Pentium	Computer processors
His Dark Materials	Fantasy books, Series of books
Spearman's rank correlation coefficient	Statistics, Mathematics
Killzone 2	2009 video games, PlayStation 3 games
Velafrons	Cretaceous dinosaurs
Manzai	Comedy, Japanese culture, Entertainment in Japan
Arsenal tube station	Piccadilly Line stations, Tube stations in Islington, Arsenal F.C., London Travelcard zone 2, Railway stations opened in 1906, 1906 establishments in England
Leadbeater's possum	Marsupials of Australia, Endangered species, Victoria, Australia
Vostok 1	Soviet spacecraft
Glazed tile	Ceramics
Enola Gay	World War II, Hiroshima
Paul Tibbets	1915 births, 2007 deaths, Deaths from heart failure, Deaths from stroke, American aviators, American people of World War II, Military people from Illinois
Phil Jackson	1945 births, Living people, Chicago Bulls head coaches, New Jersey Nets players, New York Knicks players, Sportspeople from Montana
Kennel cough	Dogs, Animal diseases
Pierre Schaeffer	1910 births, 1995 deaths, Deaths from Alzheimer's disease, Disease-related deaths in France, French musicians, People from Nancy
Area 51	Buildings and structures in Nevada, United States Air Force, Conspiracy theories, 1942 establishments in the United States, UFOs, 20th-century establishments in Nevada
Ding Liren	Chinese chess players, 1992 births, Living people, Chess grandmasters
Oliver Twist	1830s books, Books by Charles Dickens, Books first published in serial form, English novels, English-language novels
Danish Kaneria	Pakistani people, Pakistani cricketers, Living people, 1980 births, People from Karachi
Sachin Tendulkar	1973 births, Living people, People from Mumbai, Indian cricketers
Ethelbert Nevin	1862 births, 1901 deaths, American composers, American pianists
Eucalyptus regnans	Trees of Australia, Eucalyptus
Bahía Lomas	Conservation
Destroy All Humans! Path of the Furon	2008 video games, Destroy All Humans!, Xbox 360 games, PlayStation 3 games, THQ games
Brandy	Alcoholic spirits
NASDAQ	1971 establishments in the United States, Companies based in New York City, Companies listed on NASDAQ, Stock exchanges
Internet Engineering Task Force	1986 establishments in the United States, Internet standards, Internet-related organizations
Iranian Arabs	Arab people, Iran, Ethnic groups in Asia
Blowjob	Sexual slang
Tibetan Muslims	Tibet, Ethnic groups in China, Islam
Lure, Haute-Saône	Cities in France, Communes in Haute-Saône, Subprefectures in France
Burnout Paradise	2008 video games, Xbox 360 games, PlayStation 3 games, Windows games
The Wave 96.4 FM	Radio stations in the United Kingdom, Welsh culture, 1995 establishments in the United Kingdom, 1990s establishments in Wales
The Big Top 40 Show	British music, Record charts
Hurricane Boris (1996)	Hurricanes in Mexico, East Pacific hurricanes, 1996 in North America, 1990s in Mexico
Henryk Szeryng	Mexican musicians, Polish musicians, 1918 births, 1988 deaths
Elin Nordegren	1980 births, Living people, Swedish models
Ivana Trump	1949 births, Living people, Czech businesspeople, Celebrity Big Brother contestants, Czech sportspeople, Trump family
Elasmotherium	Rhinoceroses
Master of Science	Academic degrees
Natural sciences	Natural sciences
Concentric zone model	Urban planning, Urban geography
Equilibrium	Analytical chemistry, Physical chemistry, Physics
Packet (computing)	Computers
Errors and residuals in statistics	Statistics
Quartet	Music
Bank and Monument stations	Tube stations in the City of London, Central Line stations, Northern Line stations, Circle Line stations, District Line stations, Docklands Light Railway stations
Barbican tube station	Circle Line stations, Hammersmith & City Line stations, Metropolitan Line stations, Tube stations in the City of London, 1865 establishments in the United Kingdom, Railway stations served by First Capital Connect
Barking station	Barking, District Line stations, Hammersmith & City Line stations, London Overground stations, Transport in Barking & Dagenham
Barkingside tube station	London Travelcard zone 4
Barons Court tube station	District Line stations, Piccadilly Line stations, Grade II listed buildings in London, Grade II listed railway stations
Bayswater tube station	Circle Line stations, District Line stations, London Travelcard zone 1, Tube stations in the City of Westminster
Beckton DLR station	Docklands Light Railway stations, Transport in Newham, London Travelcard zone 3
Beckton Park DLR station	Docklands Light Railway stations, Transport in Newham, London Travelcard zone 3
Becontree tube station	District Line stations, London Travelcard zone 5, Transport in Barking & Dagenham
Balham station	Northern Line stations, Transport in Wandsworth, Railway stations opened in 1863
Methadone	Opioids, Addiction
Red Dragon FM	Radio stations in the United Kingdom, Welsh culture
Soapy Smith	1860 births, 1898 deaths, American gangsters, Deaths by firearm in the United States, People from Georgia (U.S. state)
Paul Williams (songwriter)	1940 births, Living people, Actors from Omaha, Nebraska, American folk musicians, American movie actors, American pop singers, American rock musicians, American songwriters, American television actors, Best Original Song Academy Award-winning songwriters, Musicians from Omaha, Nebraska, Singers from Omaha, Nebraska
Injection	Medical procedures
Western Desert cultural bloc	Indigenous Australian culture, Regions of Australia
The Lonely Island	American comedy bands, Hip hop bands, Musicians from Berkeley, California, 2011 establishments in the United States
Portal (video game)	Puzzle video games, Shooter video games, 2007 video games, Platform games
Valve Corporation	Video game companies
Sistan and Baluchestan Province	Provinces of Iran
Balochistan (region)	Regions of Pakistan
Naked mole rat	Mammals of Africa
Capsaicin	Chemical compounds, Organic compounds, Analgesics
Football team	Football
West Ham station	District Line stations, Hammersmith & City Line stations, Transport in Newham, Jubilee Line stations, Docklands Light Railway stations, West Ham
Wimbledon station	London Travelcard zone 3
Tube map	Rail transport in London
Waterloo & City line	London Underground lines, 1898 establishments in England, Transport in Lambeth, Transport in the City of London, Tunnels underneath the River Thames
London Underground 1967 Stock	London Underground electric multiple units
Victoria, London	City of Westminster
Walthamstow	London Borough of Waltham Forest
Traffic congestion	Traffic
Private bill	Law
British Transport Commission	Organisations based in the United Kingdom, Transport in the United Kingdom
Uherské Hradiště	Cities in the Czech Republic
Ice skate	Skating
Boing	Television networks, Italian television
Mir-Hossein Mousavi	1941 births, Living people, Prime Ministers of Iran
René Lévesque	1922 births, 1987 deaths, Cardiovascular disease deaths in Quebec, Deaths from myocardial infarction, Disease-related deaths in Quebec, People from New Brunswick, Politicians from Quebec
Dead Space	2008 video games, PlayStation 3 games, Windows games, Xbox 360 games
Ty Cobb	1886 births, 1961 deaths, American baseball players, Sportspeople from Georgia (U.S. state), Detroit Tigers managers, Detroit Tigers players
Fulham Broadway tube station	London Borough of Hammersmith and Fulham
Tottenham	Tottenham
Manor House, London	Areas of London
Barbara Castle	1910 births, 2002 deaths, Alumni of the University of Oxford, Former Labour MPs (UK), Former members of the British House of Commons for English constituencies, People from Bradford, People from Derbyshire, Politicians from Yorkshire
Richard Marsh, Baron Marsh	1928 births, 2011 deaths, English politicians, British businesspeople
Weak interaction	Nuclear physics
Cognition	Psychology
Russki	English profanity, Slurs
Medic Droid	American pop music groups, Electronic music bands, Musical groups from Arizona, Musical groups established in 2007, 2007 establishments in the United States, 2000s establishments in Arizona, Musical groups disestablished in 2008, 2008 disestablishments in the United States, 2000s disestablishments in Arizona
Wood Street railway station	Railway stations in Waltham Forest, London Travelcard zone 4, 1873 establishments in England, Railway stations served by National Express East Anglia
Chuck Yeager	American people of World War II, American military people, People from West Virginia, 1923 births, 2020 deaths, American aviators
Deep-level tube lines	London Underground
Bolsover	Towns in Derbyshire
Sympathetic nervous system	Nervous system
Pierre Monteux	1875 births, 1964 deaths, French conductors, American conductors
Milhaud	Communes in Gard
Willem Mengelberg	1871 births, 1951 deaths, Dutch conductors, People from Utrecht (city)
Willem Kes	1856 births, 1943 deaths, Dutch conductors, People from Dordrecht
Cathay Dragon	Airlines of Asia, Transport in Hong Kong
Hong Kong International Airport	Buildings and structures in Hong Kong, Transport in Hong Kong
Parasympathetic nervous system	Nervous system
Heart rate	Heart
Airbus A321	Airbus aircraft
Vasoactive intestinal peptide	Hormones
Pan European Game Information	2003 establishments in Europe, Cultural organizations, Video game ratings
Psychiatrist	Psychiatry, Healthcare occupations
Monifieth	Towns in Scotland, Angus
Eugen Jochum	1902 births, 1987 deaths, German conductors
Big O notation	Mathematics, Computer science, Algorithms
QI	2003 British television series debuts, 2000s British television series, 2010s British television series, British comedy television series, British television game shows, Panel games
21st Century Breakdown	2009 albums, Green Day albums, Reprise Records albums, Punk albums
Glossop North End A.F.C.	English football clubs, 1886 establishments in England
Bradford (Park Avenue) A.F.C.	English football clubs, 1907 establishments in England
Nelson F.C.	English football clubs, 1881 establishments in England
Darlington F.C.	English football clubs, 1883 establishments in the United Kingdom
Newport County A.F.C.	English football clubs, 1912 establishments in the United Kingdom, 20th century establishments in Wales
Rotherham United F.C.	English football clubs, 1877 establishments in England
Bristol Rovers F.C.	English football clubs, 1883 establishments in the United Kingdom
Scunthorpe United F.C.	English football clubs, 1899 establishments in England
Oxford United F.C.	English football clubs, Oxford, Bakrie Group, 1893 establishments in England
Hereford United F.C.	English football clubs, Hereford, 1924 establishments in Europe, 1920s establishments in England
Mansfield Town F.C.	1897 establishments in the United Kingdom, English football clubs, Mansfield
Wrexham A.F.C.	English football clubs, 1873 establishments in the United Kingdom, 19th century establishments in Wales
Shrewsbury Town F.C.	English football clubs, 1886 establishments in England
Cambridge United F.C.	Cambridge, English football clubs, 1912 establishments in the United Kingdom, 1910s establishments in England
Rushden & Diamonds F.C.	English football clubs, 1992 establishments in England
Yeovil Town F.C.	English football clubs, 1895 establishments in England
Peterborough United F.C.	English football clubs, 1930s establishments in England, 1934 establishments in Europe
Robinson Sucroe	Animated television series
National Health Service	Public services in the United Kingdom, Health care
Christiaan Eijkman	1858 births, 1930 deaths, Dutch academics, Dutch Nobel Prize winners, Dutch physicians
Frederick Hopkins	1861 births, 1947 deaths, English chemists, Order of Merit, Knights Bachelor, Fellows of the Royal Society, Presidents of the Royal Society, Alumni of University College London, British Nobel Prize winners
Windows CE	Microsoft operating systems
Simon Cowell (presenter)	Living people, 1952 births, British television personalities
2015	2015
2016	2016
2017	2017
Yasunari Kawabata	1899 births, 1972 deaths, Japanese writers, People from Osaka, Japanese Nobel Prize winners, University of Tokyo alumni
2018	2018
2019	2019
2021	Demons, 2021
2022	2022, Years in the future
2024	2024, Years in the future
2025	2025, Years in the future
Acid Survivors Foundation	Organisations based in Bangladesh, 1999 establishments in Asia, 20th century establishments in Bangladesh
Shmuel Yosef Agnon	1887 births, 1970 deaths, Israeli Nobel Prize winners, Jewish Israeli writers, Jewish Nobel Prize winners, Naturalized citizens of Israel, Poets, Short story writers, Ukrainian Jews, Ukrainian writers
Acid throwing	Domestic violence, Human rights, Hate crimes
Nelly Sachs	1891 births, 1970 deaths, German Nobel Prize winners, German poets, Jewish German writers, Jewish Nobel Prize winners, Nobel Prize in Literature winners, Swedish playwrights, Swedish poets
1594	1594
2008 in science	2008, Years in science
Tikrit	Cities in Iraq
2007 in science	2007, Years in science
White nose syndrome	Bats, Fungal diseases
2006 in science	2006, Years in science
Missy Peregrym	Living people, 1982 births
Ken Follett	1949 births, Living people, Welsh novelists, Writers from Cardiff
British National Party	1982 establishments in the United Kingdom, Nationalist organisations in the United Kingdom, Political parties in the United Kingdom
FC Utrecht	1970 establishments in Europe, 1970s establishments in the Netherlands, Dutch football clubs, Utrecht (city)
Sparta Rotterdam	Dutch football clubs, Rotterdam
Road number	Roads
AFC Door Wilskracht Sterk	Dutch football clubs, Amsterdam, 1907 establishments in Europe, 1900s establishments in the Netherlands
2005 in science	2005, Years in science
2004 in science	2004, Years in science
Midwest Irish Radio	Radio stations in Europe, County Mayo
Russian Social Democratic Labour Party	Communist parties, Social democratic parties, Political parties in Russia, 1898 establishments in Europe, 19th century establishments in Russia, 1898 establishments in Asia
Signed number representations	Computer science, Mathematics
Kingpin	Fictional characters introduced in the 1960s, Marvel Comics characters, Spider-Man
Centre Pompidou-Metz	Art museums in France, Grand Est
Floating point	Computer science, Mathematics
South Petherton	Towns in Somerset
Markup language	Markup languages
Alan Davies	1966 births, Living people, Actors from Essex, Actors from London, Alumni of the University of Kent, Comedians from Essex, Comedians from London, English movie actors, English television actors, People from Chingford, Television personalities from Essex, Television personalities from London
Ponzi scheme	Types of crime, Commercial crime
Baní	Settlements in Dominican Republic, 1764 establishments, 18th-century establishments in the Spanish Empire
Morgan Freeman	1937 births, Living people, Academy Award winning actors, Actors from Memphis, Tennessee, African American actors, African American movie directors, African American movie producers, American movie actors, American stage actors, American television actors, American television producers, American voice actors, Beekeepers, Democrats (United States), Golden Globe Award winning actors, Kennedy Center honorees, Screen Actors Guild Award winners
Mikhail Sholokhov	1905 births, 1984 deaths, Novelists, Russian Nobel Prize winners, Russian writers, Soviet writers
Dire Straits	1977 establishments in the United Kingdom, 1995 disestablishments in the United Kingdom, 1970s British music groups, 1980s British music groups, 1990s British music groups, Brit Award winners, English rock bands, Grammy Award winners, Music groups from Newcastle upon Tyne, Musical groups disestablished in 1995, Musical groups established in 1977, Warner Bros. Records artists
Kathryn Janeway	Star Trek: Voyager characters
Tikhon Khrennikov	1913 births, 2007 deaths, Music critics, Russian composers, Soviet musicians
Seven of Nine	Star Trek: Voyager characters
Doctor (Star Trek)	Star Trek: Voyager characters
Jim Gannon	1968 births, Living people, English footballers, Sportspeople from London
Lisa Marie Presley	1968 births, Living people, American singer-songwriters, Elvis Presley, Singers from Memphis, Tennessee
Dialysis	Medical procedures, Organ failure
Kinkajou	Procyonids, Omnivores
The Barber of Seville	Compositions by Gioachino Rossini, Operas set in Spain
Veroia	Cities in Greece
Katerini	cities in Greece
Drama, Greece	Cities in Greece
Kavala	Cities in Greece
Alexandroupoli	Cities in Greece
Marten	Mustelids
Karl Landsteiner	1868 births, 1943 deaths, Austrian scientists, Austrian Nobel Prize winners, Austrian physicians
Otto Heinrich Warburg	1883 births, 1970 deaths, German chemists, German Nobel Prize winners
Charles Scott Sherrington	1857 births, 1952 deaths, Alumni of the University of Cambridge, English physicians, British Nobel Prize winners
Ruhla	Urban Districts of Thuringia
Eddie May	1943 births, Living people, Scottish footballers, Scottish football managers
Chakotay	Star Trek: Voyager characters
Tuvok	Star Trek: Voyager characters
Suprachiasmatic nucleus	Anatomy of the brain, Sleep
Mollie Sugden	1922 births, 2009 deaths, Actors from Yorkshire, English movie actors, English stage actors, English television actors
London Underground 1938 Stock	London Underground electric multiple units, Metropolitan Cammell multiple units
Mayday Parade	American rock bands, American punk bands, emo bands, Musical groups from Florida, People from Tallahassee, Florida, 2000s American music groups
Brantford, Ontario	Cities in Ontario
Historical geology	Geology
Fats Domino	African American musicians, American pianists, American R&B singers, American R&B musicians, American rock musicians, American rock singers, American singer-songwriters, Musicians from New Orleans, Louisiana, Singers from New Orleans, Louisiana, Writers from New Orleans, Louisiana, 1928 births, 2017 deaths, Warner Bros. Records artists
The Swell Season	Musical duos, Academy Award winners
Ted Stevens	1923 births, 2010 deaths, American lawyers, American military personnel of World War II, Aviation deaths in the United States, Burials at Arlington National Cemetery, Episcopalians, Minority leaders of the United States Senate, Harvard University alumni, People from Fairbanks, Alaska, Politicians from Indianapolis, Indiana, Businesspeople from Indianapolis, Indiana, Businesspeople from Alaska, Presidents pro tempore of the United States Senate, United States senators from Alaska
Joy of Giving Week	Charity events, India
Aloch	Settlements in Shangla District, Towns in Pakistan
Chakesar	Settlements in Shangla District, Towns in Pakistan
Besham	Settlements in Shangla District, Towns in Pakistan
Alpuri Tehsil	Tehsils of Shangla District
Bhag	Cities in Pakistan
Atlanta Chiefs	American soccer teams, 1967 establishments in the United States, 20th-century establishments in Georgia (U.S. state), 1972 disestablishments in the United States, 1979 establishments in the United States, 1981 disestablishments in the United States, Sports in Atlanta, Georgia, 20th-century disestablishments in Georgia (U.S. state), 1960s establishments in Georgia (U.S. state)
Kansas City Spurs	American soccer teams, 1968 establishments in the United States, 1970 disestablishments in the United States, Sports in Kansas City, Missouri, 1960s establishments in Missouri, 20th-century disestablishments in Missouri
Rochester Lancers	American soccer teams, Rochester, New York, 1967 establishments in New York (state), 1980 disestablishments, 1980s disestablishments in the United States, 20th-century disestablishments in New York (state)
Dallas Tornado	American soccer teams, Sports in Dallas, Texas, 1967 establishments in Texas, 1981 disestablishments in the United States
New York Cosmos	American soccer teams, 1971 establishments in New York (state), 1985 disestablishments in the United States, 20th-century disestablishments in New York (state)
Philadelphia Atoms	American soccer teams, Sports in Philadelphia, 1973 establishments in the United States, 1970s establishments in Pennsylvania, 1976 disestablishments in the United States, 20th-century disestablishments in Pennsylvania
Los Angeles Aztecs	1974 establishments in California, American soccer teams, 1981 disestablishments in the United States, 1980s disestablishments in California
Tampa Bay Rowdies	American soccer teams, 1975 establishments in the United States, 1993 disestablishments in the United States, 2008 establishments in the United States
Toronto Blizzard	American soccer teams
Chicago Sting	American soccer teams, Sports in Chicago, Illinois, 1975 establishments in the United States, 1970s establishments in Illinois
Tulsa Roughnecks	American soccer teams
Racing Club de Santander	Spanish football clubs, Cantabria
Sporting de Gijón	Spanish football clubs
U.D. Las Palmas	Spanish football clubs, Las Palmas de Gran Canaria
Villarreal CF	Spanish football clubs
The Veronicas	2004 establishments in Australia, 2000s Australian music groups, 2010s Australian music groups, Australian pop music groups, Australian rock bands, Girl groups, Musical duos, Musical groups from Queensland, Pop punk bands
Thirst (2009 movie)	2009 movies, 2000s romance movies
Thirst	health
List of awards and nominations received by 30 Seconds to Mars	30 Seconds to Mars, Music-related lists, Lists of awards and nominations
Lake Washington	Lakes of the United States, Seattle, Washington
University of Balochistan	Colleges and universities in Pakistan, 1974 establishments
Hinglaj Mata	Buildings and structures in Pakistan, Hindu temples
Akihabara	Tokyo, Japanese culture
Debito Arudou	Living people, People from New York, American activists, 1965 births
All Time Low	2000s music groups, American punk bands, Pop punk bands, Musicians from Baltimore, Maryland, Musical groups from Maryland, Musical groups established in 2003, 2003 establishments in the United States, 21st-century establishments in Maryland
Hannah Montana	2006 American television series debuts, 2011 American television series endings, 2000s American television series, 2010s American television series, American teen television series, Television series by Disney, English-language television programs
Internet Relay Chat operator	Internet Relay Chat
Sălcuța	Communes in Dolj County
Australovenator	Dinosaurs of Australia, Carnosaurs
F.C. Shakhtar Donetsk	Ukrainian football clubs, 1936 establishments in Europe, 20th century establishments in Ukraine
Hiroshi Nanami	1972 births, Living people, Footballers from Shizuoka Prefecture, Japan international footballers, Japanese football managers, J1 League players, J2 League players, Júbilo Iwata players, Cerezo Osaka players, Tokyo Verdy players, 1998 FIFA World Cup players, 1996 AFC Asian Cup players, 2000 AFC Asian Cup players, AFC Asian Cup-winning players
Takuya Yamada	1974 births, Living people, Footballers from Tokyo Prefecture, Japan international footballers, J1 League players, J2 League players, Tokyo Verdy players, Cerezo Osaka players, Yokohama FC players, Sagan Tosu players, FC Imabari players
Katsumi Oenoki	1965 births, Living people, Footballers from Shizuoka Prefecture, Japan international footballers, Japanese football managers, J1 League players, Japan Soccer League players, Júbilo Iwata players, Shimizu S-Pulse players, 1988 AFC Asian Cup players
Yasuyuki Moriyama	1969 births, Living people, Footballers from Gifu Prefecture, Japan international footballers, J1 League players, J2 League players, Nagoya Grampus players, Shonan Bellmare players, Sanfrecce Hiroshima players, Kawasaki Frontale players, Hokkaido Consadole Sapporo players, FC Gifu players
José Antônio Martins Galvão	1982 births, Living people, Brazilian footballers
Tetsuya Asano	1967 births, Living people, Footballers from Ibaraki Prefecture, Japan international footballers, Japanese football managers, J1 League players, J2 League players, Japan Soccer League players, Nagoya Grampus players, Urawa Red Diamonds players, FC Tokyo players, Kawasaki Frontale players
Ivan Hašek	1963 births, Living people, Czech footballers, Czech football managers
Yoshinobu Ishii	1939 births, 2018 deaths, Footballers from Hiroshima Prefecture, Japan international footballers, Japanese football managers, Japan Soccer League players, Sanfrecce Hiroshima players, Shonan Bellmare players, Japan national football team managers
Atsuhiro Miura	1974 births, Living people, Footballers from Oita Prefecture, Japan international footballers, Japanese football managers, J1 League players, J2 League players, Yokohama Flügels players, Yokohama F. Marinos players, Tokyo Verdy players, Vissel Kobe players, Yokohama FC players, 2001 FIFA Confederations Cup players, 2005 FIFA Confederations Cup players, Footballers at the 2000 Summer Olympics, 2000 AFC Asian Cup players, AFC Asian Cup-winning players
Atsushi Nagai	1974 births, Living people, Footballers from Kagoshima Prefecture
Akihiro Nishimura	1958 births, Living people, Footballers from Osaka Prefecture, Japan international footballers, Japanese football managers, Japan Soccer League players, Cerezo Osaka players
Kenji Takahashi	1970 births, Living people, Footballers from Yamagata Prefecture
Masakatsu Miyamoto	1938 births, 2002 deaths, Footballers from Ibaraki Prefecture, Japan international footballers, Japanese football managers, Japan Soccer League players, JEF United Chiba players, Footballers at the 1964 Summer Olympics, Footballers at the 1968 Summer Olympics, Olympic medalists in football, Japanese Olympic bronze medalists, Medalists at the 1968 Summer Olympics
Valery Karpin	1969 births, Living people, Russian footballers
Fumitake Miura	1970 births, Living people, Footballers from Shizuoka Prefecture
Toshihide Saito	1973 births, Living people, Footballers from Shizuoka Prefecture, Japan international footballers, J1 League players, J2 League players, Shimizu S-Pulse players, Shonan Bellmare players, Fujieda MYFC players, 1998 FIFA World Cup players, 1996 AFC Asian Cup players
Akira Oba	1976 births, Living people, Footballers from Fukuoka Prefecture
Mitsuru Chiyotanda	1980 births, Living people, Footballers from Fukuoka Prefecture
Seiji Kaneko	1980 births, Living people, Footballers from Fukuoka Prefecture
Lawful interception	Espionage, Telecommunications, Law enforcement techniques
Steve McNair	1973 births, 2009 deaths, African American players of American football, American football quarterbacks, American murder victims, Baltimore Ravens players, Murdered African-American people, Murdered sportspeople, Murder-suicides in the United States, Murders by firearm in the United States, Sportspeople from Mississippi
Elizabeth Cross	Orders, decorations, and medals of the United Kingdom, Elizabeth II
Corrosive substance	Chemical processes, Metallurgy
Malus	Trees, Apples
Operation Ichi-Go	1944 in Asia, 1940s in Japan, 20th century in China, Battles involving Japan, Battles involving the United States, World War II
Jawaharlal Nehru	1889 births, 1964 deaths, Deaths from myocardial infarction, Indian National Congress politicians, Prime Ministers of India, Politicians from Uttar Pradesh
Black Sea	Seas of the Atlantic Ocean, Bodies of water of Asia, Bodies of water of Europe
Hey Monday	Pop punk bands
The Shins	Indie rock bands, American rock bands, People from Albuquerque, New Mexico, Musicians from Portland, Oregon, Musicians from New Mexico, Musical groups from Oregon, Musical groups established in 1997, 1997 establishments in the United States, 20th-century establishments in New Mexico
PC bang	South Korean culture, Internet
The Jackson 5	1964 establishments in the United States, 1960s American music groups, 1970s American music groups, 1980s American music groups, African-American musical groups, American boy bands, American pop music groups, People from Indiana, Musical groups established in 1964, Musical groups disestablished in 1989, 1989 disestablishments in the United States
Gabriela Mistral	1889 births, 1957 deaths, Chilean poets, Diplomats, Feminists
Vasily Vereshchagin	1842 births, 1904 deaths
Star Trek (movie)	2009 science fiction movies, Movies about revenge, Movies set in the future, Paramount movies, Reboot movies, Star Trek movies, Movies directed by J. J. Abrams
WWF Fully Loaded	History of Fresno, California, World Wrestling Entertainment pay-per-view events, Sports in Buffalo, New York, 20th century in Dallas, Texas, 1998 in California, 1999 in the United States, 1990s in New York (state), 2000 in the United States, 20th century in Buffalo, New York, July events
Young Poland	History of Poland, Art movements
Hurricane Felix	Hurricanes, 2007 Atlantic hurricane season, History of Venezuela, 2000s in Nicaragua, 2000s in Honduras, 21st century in El Salvador, History of Guatemala
Hurricane Cesar-Douglas	1996, Category 4 Atlantic hurricanes
Georg Solti	1912 births, 1997 deaths, British conductors, Cardiovascular disease deaths in France, Deaths from myocardial infarction, Entertainers from Budapest, Grammy Award winners, Hungarian conductors, Hungarian Jews, Jewish British musicians, Naturalised citizens of the United Kingdom, Refugees from Nazism
Leopold Stokowski	1882 births, 1977 deaths, American conductors, British conductors
Kenzaburō Ōe	Japanese writers, 1935 births, Living people, People from Ehime Prefecture, Japanese Nobel Prize winners, University of Tokyo alumni
Get Heavy	Lordi albums, Debut albums, 2002 albums, Heavy metal albums
The Monsterican Dream	Lordi albums, 2004 albums
The Monster Show	Lordi albums, 2005 albums
The Arockalypse	Lordi albums, 2006 albums
Deadache	Lordi albums, 2008 albums
Yuji Miyahara	1980 births, Living people, Footballers from Fukuoka Prefecture
Lee Dong-gook	1979 births, Living people, South Korean footballers
Yuhei Tokunaga	1983 births, Living people, Footballers from Nagasaki Prefecture, Japan international footballers, J1 League players, J2 League players, FC Tokyo players, V-Varen Nagasaki players, Footballers at the 2004 Summer Olympics, Footballers at the 2012 Summer Olympics
Communist Party of the Soviet Union	Political parties in Russia, Communist parties, 1912 establishments, 1991 disestablishments in the Soviet Union, 1910s establishments in the Soviet Union
Toroidal inductors and transformers	Transformers (electrical), Magnetism
V-2	Military, Rockets, Wernher von Braun
The Guardian Legend	1988 video games
Vengeance (2006)	2006 in professional wrestling, Sports in Charlotte, North Carolina, WWE Vengeance
First aid kit	Health
Sarah Aaronsohn	1890 births, 1917 deaths, Asian Jews, History of Palestine, Spies, Suicides by firearm, World War I people, Zionists
Frank Abbandando	1910 births, 1942 deaths, American murderers, Executed American people, Mobsters, People executed by electric chair, People from New York City
Zombilation – The Greatest Cuts	Lordi albums, 2009 albums
Firmin Abauzit	1679 births, 1767 deaths
Wyrzysk	Towns in Poland
Prussian House of Lords	1918 disestablishments in Germany, Buildings and structures in Berlin, Politics of Germany, Legislatures, 1850 establishments in Europe, 19th century establishments in Germany
Anime convention	Animation, Anime
Spiekeroog	Islands of Germany
Eshtehard	Cities in Iran
Bebo	2005 establishments, Social networking
Hurricane Andres (2009)	Hurricanes in Mexico, 2009 in North America, 2000s in Mexico
Sarah Sutton	Actors from Hampshire, English television actors, People from Basingstoke, 1961 births, Living people
Chuck Lorre	People from New York, American composers, American television directors, American television producers, American television writers, Writers from New York, 1952 births, Living people
Technical University of Berlin	Buildings and structures in Berlin, Education in Berlin, Technical colleges and universities in Germany
Leeds Rhinos	Leeds, Rugby
Screwdriver	Tools
ETH Zurich	Colleges and universities in Switzerland, Zürich
Peenemünde	Villages in Germany
Hollyfield School	Royal Borough of Kingston upon Thames, Schools in London
Alice in Wonderland (1951 movie)	American animated movies, American family movies, American musical movies, Disney animated movies, English-language movies, Movies composed by Oliver Wallace, 1951 comedy movies, 1950s adventure movies, American coming-of-age movies, American drama movies, American fantasy-comedy movies, American musical fantasy movies, Movies based on books, 1950s musical movies, 1951 drama movies, Movies about dreams
Cable modem	Computer hardware, Internet
Nobuhiro Ishizaki	1958 births, Living people, Footballers from Hiroshima Prefecture, People from Hiroshima
Frank de Boer	1970 births, Living people, Dutch football managers, Dutch footballers, Sportspeople from North Holland, Twin people, Eredivisie managers
Ronald de Boer	1970 births, Living people, Dutch footballers, Sportspeople from North Holland, Twin people
Ichi the Killer	Japanese movies, 2001 movies
Wallisian	Austronesian languages, Languages of Oceania, Wallis and Futuna
Google Chrome OS	Google
Skew lines	Geometry
Saudi riyal	Saudi Arabia, Currency of Asia
Pathology	Medical specialties, Biology
Cardiology	Cardiology
Annual Tree Mallow	Malvaceae
Lionel of Antwerp, 1st Duke of Clarence	1338 births, 1368 deaths, English Dukes, House of Plantagenet, People from Antwerp
Ottmar Hitzfeld	1949 births, Living people, German football managers, German footballers, Sportspeople from Baden-Württemberg
Ikuo Matsumoto	1941 births, Living people, Footballers from Tochigi Prefecture, Japan international footballers, Japanese football managers, Japan Soccer League players, Sanfrecce Hiroshima players, Footballers at the 1968 Summer Olympics, Olympic medalists in football, Japanese Olympic bronze medalists, Medalists at the 1968 Summer Olympics
Ligue 2	Football leagues, 1933 establishments, 1930s establishments in France
Gilberto Carlos Nascimento	1966 births, Living people, Brazilian footballers
Hideki Nagai	1971 births, Living people, Footballers from Oita Prefecture
Cross-platform interchange	Rail transport
Northern line	London Underground lines, London Borough of Barnet, London Borough of Merton, Transport in the City of London, Transport in the City of Westminster, Transport in Camden, Transport in Haringey, Transport in Islington, Transport in Lambeth, Transport in Southwark, Transport in Wandsworth, Tunnels underneath the River Thames, 1890 establishments in the United Kingdom, 1890s establishments in England
Circle line (London Underground)	London Underground lines, Transport in the City of London, Transport in the City of Westminster, Royal Borough of Kensington and Chelsea, Transport in Camden, Transport in Islington, Transport in Tower Hamlets, 1949 establishments in Europe, 1940s establishments in England
Hammersmith & City line	London Underground lines, London Borough of Hammersmith and Fulham, Royal Borough of Kensington and Chelsea, Transport in the City of London, Transport in the City of Westminster, Transport in Barking & Dagenham, Transport in Camden, Transport in Islington, Transport in Newham, Transport in Tower Hamlets, 1990 establishments in England
Metropolitan line	Transport in Camden, Transport in the City of London, Transport in the City of Westminster, Transport in Islington, London Underground lines, 1863 establishments in the United Kingdom
Statute of Kilkenny	History of Ireland, Law, 1367, 14th century in England
Tramlink	London Borough of Croydon, Electric railways, Tramlink, 2000 establishments in England, London Travelcard zone 3, London Travelcard zone 4, London Travelcard zone 5, London Travelcard zone 6
Docklands Light Railway	Docklands Light Railway, 1987 establishments in England
London Overground	London Overground, 2007 establishments in England, Railway operators in London, Train operating companies
First Capital Connect	Defunct railway companies of the United Kingdom, 2006 establishments in England, 2014 disestablishments, 2010s disestablishments in the United Kingdom
Northern City Line	Transport in the City of London, Transport in Islington, Railway lines of London
Princess Alexandra, The Honourable Lady Ogilvy	1936 births, Living people, House of Windsor, Knights of the Garter, Knights Grand Cross of the Royal Victorian Order
Ask.com	Search engines
Katsushika Hokusai	Japanese printmakers, 1760 births, 1849 deaths, Artists from Tokyo
Sun Yat-sen	Presidents of the Republic of China, 1866 births, 1925 deaths
Pierluigi Collina	1960 births, Living people, Italian footballers, Referees, Sportspeople from Emilia-Romagna, People from Bologna
TSV 1860 Munich	1860 establishments in Europe, 1860s establishments in Germany, German football clubs, Sport in Munich
Eintracht Braunschweig	German football clubs, Sport in Lower Saxony, 1895 establishments in Europe, 1890s establishments in Germany
Borussia Mönchengladbach	German football clubs, Mönchengladbach, Sport in North Rhine-Westphalia, 1900 establishments in Germany
1. FC Kaiserslautern	German football clubs, Kaiserslautern, Sport in Rhineland-Palatinate, 1900 establishments in Germany
VfL Wolfsburg	German football clubs, Sport in Lower Saxony, Wolfsburg, 1945 establishments in Germany
Choi Sung-yong	1975 births, Living people, South Korean footballers
Yoo Sang-chul	1971 births, 2021 deaths, Deaths from pancreatic cancer, South Korean footballers, South Korean football managers, People from Seoul
Choi Yong-soo	1973 births, Living people, South Korean footballers, South Korean football managers, People from Busan
Takeshi Aoki	1982 births, Living people, Footballers from Gunma Prefecture, Japan international footballers, J1 League players, J2 League players, Kashima Antlers players, Sagan Tosu players, Roasso Kumamoto players
Sylvain Wiltord	1974 births, Living people, French footballers
Automatic train operation	Rail technologies
Upper Austria	Upper Austria
Lambach	Cities and towns in Upper Austria
Tracheotomy	Medical emergencies
Leonding	Cities and towns in Upper Austria
Gefreiter	Military, 16th century establishments in Europe
Plasma display	Display technology, Television technology
Southern Ontario	Regions of Ontario
Surrender (military)	Military
David Toms	Living people, 1967 births, American golfers, Sportspeople from Louisiana
Keisuke Tsuboi	1979 births, Living people, Footballers from Tokyo Prefecture, Japan international footballers, J1 League players, J2 League players, Urawa Red Diamonds players, Shonan Bellmare players, Renofa Yamaguchi FC players, 2006 FIFA World Cup players, 2003 FIFA Confederations Cup players, 2005 FIFA Confederations Cup players
Hiromitsu Isogai	1969 births, Living people, Footballers from Kumamoto Prefecture, Japan international footballers, J1 League players, Gamba Osaka players, Urawa Red Diamonds players, 1995 King Fahd Cup players
Christophe Dugarry	1972 births, Living people, French footballers
Teruyoshi Ito	1974 births, Living people, Footballers from Shizuoka Prefecture, Japan international footballers, J1 League players, J2 League players, J3 League players, Shimizu S-Pulse players, Ventforet Kofu players, AC Nagano Parceiro players, Blaublitz Akita players, Azul Claro Numazu players, 1998 FIFA World Cup players, 2001 FIFA Confederations Cup players, Footballers at the 1996 Summer Olympics
Daisuke Ichikawa	1980 births, Living people, Footballers from Shizuoka Prefecture, Japan international footballers, J1 League players, J2 League players, J3 League players, Shimizu S-Pulse players, Ventforet Kofu players, Mito HollyHock players, Fujieda MYFC players, FC Imabari players, Vanraure Hachinohe players, 2002 FIFA World Cup players
Jorge Dely Valdés	1967 births, Living people, Central American footballers, Panamanian sportspeople
Ko Jong-soo	1978 births, Living people, South Korean footballers, South Korean football managers
Choi Tae-uk	1981 births, Living people, South Korean footballers, People from Incheon
Cho Jae-jin	1981 births, Living people, South Korean footballers
Kim Do-hoon	1970 births, Living people, South Korean footballers, South Korean football managers
Kim Yong-dae	1979 births, Living people, South Korean association football goalkeepers
One World Trade Center	2013 establishments in New York (state), Buildings and structures completed in the 21st century, September 11 attacks, Skyscrapers in New York City, Buildings and structures in Manhattan
Song Chong-gug	1979 births, Living people, South Korean footballers, People from Busan
Yuichiro Nagai	1979 births, Living people, Footballers from Tokyo Prefecture, Japan international footballers, J1 League players, J2 League players, Urawa Red Diamonds players, Shimizu S-Pulse players, Yokohama FC players, Thespakusatsu Gunma players, 2003 FIFA Confederations Cup players
Boudewijn Zenden	1976 births, Living people, Dutch footballers, People from Maastricht, Sportspeople from Limburg (Netherlands)
Alpay Özalan	1973 births, Living people, Turkish footballers, People from İzmir
Oleg Salenko	1969 births, Living people, Ukrainian footballers, Russian footballers, People from Saint Petersburg
Fábio Nunes Fernandes	1980 births, Living people, Brazilian footballers, People from Porto Alegre
Masahiro Ando	1972 births, Living people, Footballers from Saitama Prefecture, Japan international footballers, J1 League players, J2 League players, Shimizu S-Pulse players, Júbilo Iwata players, Yokohama F. Marinos players, Omiya Ardija players, Gamba Osaka players, Vegalta Sendai players, Kyoto Sanga FC players
Fashion design	Fashion, Design
Bombardier Transportation	Companies of Germany, Rail vehicles manufacturers, Companies listed on the Toronto Stock Exchange
Waldorf-Astoria Hotel	Hotels, Skyscrapers in New York City, Art Deco buildings, 1890s establishments in New York (state), Buildings and structures in Manhattan, New York City Designated Landmarks
Farrah Fawcett	Actors from Corpus Christi, Texas, American crime victims, American movie actors, American stage actors, American television actors, Cancer deaths in California, 1947 births, 2009 deaths, Deaths from anal cancer
Illyrian language	Languages of Europe
Beverly Hills, California	Beverly Hills, California
Pyrrhus	4th century BC births, 3rd century BC deaths, Ancient Greek military people, Generals, Battles of the Ancient World
Ali Pasha	1741 births, 1822 deaths, Albanian politicians
Service mark	Business, Marketing, Intellectual property law
Kurt Eisner	1867 births, 1919 deaths, Assassinated people, German journalists, German murder victims, Jewish German politicians, Jewish German writers, Ministers-President of Bavaria, Murders by firearm in Germany, Politicians from Berlin, Weimar Republic politicians, Writers from Berlin
Santa Ana, California	County seats in California, 1869 establishments in California, Santa Ana, California
Riverside, California	Riverside, California, County seats in California, Cities in California
Columbiformes	Columbiformes
Word search	Puzzles
The Secret Life of the American Teenager	2008 American television series debuts, 2013 American television series endings, 2000s American drama television series, 2000s teen television series, 2010s American drama television series, 2010s teen television series, ABC Family series, American teen drama television series, Television series about families, Works about divorce, English-language television programs
Ástor Piazzolla	Composers, 1992 deaths, 1921 births
Volksschule	Education
Ares V	NASA, Rockets
ScienceWorld	Science websites
Cuba Gooding, Sr.	1944 births, 2017 deaths, Actors from New York City, African American actors, African American musicians, American R&B singers, American soul musicians, Singers from New York City, American movie actors
Alexander Pope	1688 births, 1744 deaths, English poets, English writers
Alfred, Lord Tennyson	1809 births, 1892 deaths, English poets, United Kingdom Barons, People from Lincolnshire, People buried in Westminster Abbey, British poets laureate
Rheumatic fever	Diseases caused by bacteria
The Main Ingredient	1964 establishments in the United States, 1960s American music groups, 1970s American music groups, 1980s American music groups, 1990s American music groups, 2000s American music groups, 2010s American music groups, African-American musical groups, American R&B bands, Musical groups established in 1964, Musical groups from New York City, Soul bands
Secondhand Serenade	American rock bands, Emo bands, Indie rock bands, Musical groups from California, Menlo Park, California
Edward Downes	1924 births, 2009 deaths, British conductors, Deaths by euthanasia, Drug-related suicides, Musicians from Birmingham, Musicians who committed suicide
Assisted suicide	Suicide, Euthanasia
Dignitas (euthanasia group)	Euthanasia, Switzerland
Euthanasia	Euthanasia
Terminal illness	Diseases, Death
Now (magazine)	Magazines of Canada, Newspapers published in Canada
Ralph Downes	1904 births, 1993 deaths, English organists, People from Derby
Symmetry (biology)	Animal anatomy, Developmental biology
William Morris	1834 births, 1896 deaths, English architects, English writers, English poets, Designers, Socialists, Textile artists
Cliveden	Buckinghamshire, Hotels
Sears Tower	1973 establishments in Illinois, 2009 disestablishments in the United States, 2000s disestablishments in Illinois
Josef Krips	1902 births, 1974 deaths, Austrian conductors, Musicians from Vienna
Répétiteur	Opera terminology, Ballet terminology
Hamilton Harty	1879 births, 1941 deaths, Irish composers, Romantic composers, 20th century composers, Knights Bachelor
Albert Coates	1882 births, 1953 deaths, English composers
Creed (band)	1994 establishments in the United States, 1990s American music groups, 1990s establishments in Florida, 2000s American music groups, 2010s American music groups, 2012 disestablishments in the United States, American rock bands, Musical groups established in 1994, Musical groups disestablished in 2012, Musical groups from Florida, People from Tallahassee, Florida, Post-grunge bands, American Music Awards
.pf	French Polynesia
.sg	Top-level domains, Singapore
.va	1995 establishments, Top-level domains, Vatican City
.ws	Samoa
Zango	Advertising, Malware
Tropical Storm Alma	2008 Pacific hurricane season, East Pacific tropical storms, Retired tropical cyclone names, Hurricanes, History of Costa Rica, 2000s in Nicaragua, 2008 in North America
Herne Hill railway station	Railway stations in London
Sparkling wine	Wine
Crémant d'Alsace	French wines, Alsace, 1900 establishments in France
Clairette de Die	French wines
Shinkichi Kikuchi	1967 births, Living people, Footballers from Iwate Prefecture, Japan international footballers, J1 League players, Japan Soccer League players, Tokyo Verdy players, Kawasaki Frontale players, 1995 King Fahd Cup players
Blanquette de Limoux	French wines
List of Premier League clubs	Premier League, Lists of football teams, Lists about England
Debby Ryan	1993 births, Living people, American movie actors, American television actors, American voice actors, American child actors, Singers from Huntsville, Alabama, American guitarists, Disney actors, Disney singers, Writers from Huntsville, Alabama, Musicians from Huntsville, Alabama, Actors from Huntsville, Alabama
Albert Goldfield	Geography of New South Wales, 19th century in Australia
Edward Bawden	1903 births, 1989 deaths
Cross-City Line	Rail transport in England, West Midlands (region)
Book cover	Books
Lawn mower	Cutting tools, Gardening tools, Agricultural machinery
Golf course	Golf
Tom Eckersley	1914 births, 1997 deaths, English artists, People from Lancashire
Leaf blower	Gardening tools
Hose	Gardening tools
Watering can	containers, Gardening tools
Irrigation sprinkler	Gardening tools
Skagit River	Rivers of Washington (U.S. state)
North Cascades National Park	National parks in the United States, Washington (U.S. state), 1968 establishments in the United States, 1960s establishments in Washington (state)
Green River	Rivers of Utah
Mono Lake	Lakes of the United States, Bodies of water of California, Mono County, California
Thelyphonida	Arachnids
Mount Shasta	Volcanoes of the United States, Mountains of California, Siskiyou County, California
List of rivers of Washington	Rivers of Washington (U.S. state), Lists of rivers of the United States
Zhu Xi	Chinese scholars, Chinese philosophers, 1130 births, 1200 deaths
Plym Valley Railway	Heritage railways in England
Swanage Railway	Heritage railways in England
Mangapps Railway Museum	Heritage railways in England
West Somerset Railway	Heritage railways in England
Vale of Glamorgan Railway	Rail transport in Wales
Northampton & Lamport Railway	Heritage railways in England
Epping Ongar Railway	Heritage railways in England, Transport in Epping Forest, Epping Ongar Railway
Ecclesbourne Valley Railway	Train operating companies, Derbyshire, Heritage railways in England, 1867 establishments in England
Crossrail 2	Rail transport in London
River Lee	Rivers of England
Naval mine	Explosives
Alan Fletcher (graphic designer)	1931 births, 2006 deaths
The Edge Chronicles	Fantasy books
Rake	Gardening tools
Scythe	Cutting tools, Gardening tools, Farming tools
Neil Finn	Rock musicians, 1958 births, New Zealand singers, Living people
Francisco Correa de Arauxo	1584 births, 1654 deaths, Spanish organists, Renaissance composers, Spanish composers, Baroque composers
Collaboration	Social sciences, Human communication
Apollo 14	Apollo program
Yoshio Kikugawa	1944 births, Living people, Footballers from Shizuoka Prefecture, Japan international footballers, Japanese football managers, Japan Soccer League players, Urawa Red Diamonds players
Libyan Premier League	Football leagues, 1963 establishments in Africa, 20th-century establishments in Libya
Giuseppe Meazza	1910 births, 1979 deaths, Italian footballers, Italian football managers
Sérgio Conceição	1974 births, Living people, Portuguese footballers, Portuguese football managers
Yutaka Akita	1970 births, Living people, Footballers from Aichi Prefecture, Japan international footballers, Japanese football managers, J1 League players, J2 League players, Kashima Antlers players, Nagoya Grampus players, Kyoto Sanga FC players, 1998 FIFA World Cup players, 2002 FIFA World Cup players, 2003 FIFA Confederations Cup players, 1996 AFC Asian Cup players
Takahiro Futagawa	1980 births, Living people, Footballers from Kagoshima Prefecture, Japan international footballers, J1 League players, J2 League players, J3 League players, Gamba Osaka players, Gamba Osaka U-23 players, Tokyo Verdy players, Tochigi SC players
Éldis Fernando Damasio	1981 births, Living people, Brazilian footballers
Clemerson de Araújo Soares	1977 births, Living people, Brazilian footballers
Sidiclei de Souza	1972 births, Living people, Brazilian footballers
Naoshi Nakamura	1979 births, Living people, Footballers from Chiba Prefecture, Japan international footballers, J1 League players, Nagoya Grampus players
Ryoichi Maeda	1981 births, Living people, Footballers from Hyōgo Prefecture, Japan international footballers, J1 League players, J2 League players, J3 League players, Júbilo Iwata players, FC Tokyo players, FC Tokyo U-23 players, FC Gifu players, 2013 FIFA Confederations Cup players
Akira Narahashi	1971 births, Living people, Footballers from Chiba Prefecture, Japan international footballers, J1 League players, J2 League players, Japan Soccer League players, Shonan Bellmare players, Kashima Antlers players, 1998 FIFA World Cup players, 2003 FIFA Confederations Cup players
Joubert Araújo Martins	1975 births, Living people, Brazilian footballers, Mato Grosso
Kozo Tashima	1957 births, Living people, Footballers from Kumamoto Prefecture, Japan international footballers, Japan Soccer League players, JEF United Chiba players
Daisuke Sakata	1983 births, Living people, Footballers from Kanagawa Prefecture, Japan international footballers, J1 League players, J2 League players, Yokohama F. Marinos players, FC Tokyo players, Avispa Fukuoka players
Plantain	Fruits, Musaceae
Staple food	Foods
Zhengzhou	Cities in China, Capital cities in Asia
Braidwood, New South Wales	Towns in New South Wales
Hunan	Provinces of China
Guangxi	Autonomous regions of China
Season structure of the NHL	National Hockey League seasons
2009 Formula One World Championship	Formula One seasons, 2009 in sports
Bucegi Mountains	Mountain ranges of the Carpathians, Mountains of Romania
Private First Class	Military ranks
Lance Corporal	Military ranks
Ned Kelly (1970 movie)	1970 movies, Australian biographical movies, Australian crime movies, 1970s western movies, Movies set in Australia, Movies directed by Tony Richardson
Spring Offensive	1918 in Europe, 1910s in France, Battles of the Western Front (World War I)
Tang Enbo	1898 births, 1959 deaths, Chinese generals
Xue Yue	1896 births, 1998 deaths
Shunroku Hata	1879 births, 1962 deaths, Criminals, Japanese military people, Military personnel of World War II, People from Fukushima Prefecture
Bai Chongxi	1893 births, 1966 deaths
Letter of Jeremiah	Old Testament books, Septuagint
AllMovie	Entertainment websites, 2011 establishments
Revelation	Theology
Sebastián Aguilera de Heredia	Renaissance composers, Spanish composers, Baroque composers, Spanish organists, 1561 births, 1627 deaths
Shahnameh	Persian literature
Papal conclave	Popes
Seminary	Types of educational institutions, Seminaries
Hunger	Hunger
Chanakya	Indian people, Jainism
Trowel	Gardening tools, Tools
Juniper	Cupressaceae
Juniper berry	Cupressaceae, Spices
Henry Kissinger	1923 births, Living people, American autobiographers, American military personnel of World War II, American Nobel Prize winners, American political scientists, Chancellors of the College of William & Mary, German Jews, Harvard University alumni, Jewish American politicians, Jewish American writers, Jewish Nobel Prize winners, Naturalized citizens of the United States, Nobel Peace Prize winners, People of the Vietnam War, Politicians from Bavaria, Time People of the Year, United States Secretaries of State, German Nobel Prize winners
Akihiro Endō	1975 births, Living people, Footballers from Kagoshima Prefecture, J1 League players, J2 League players, Yokohama F. Marinos players, Vissel Kobe players, Footballers at the 1996 Summer Olympics
Fernando Moner	1967 births, Living people, Argentine footballers, Sportspeople from Buenos Aires
Toshiaki Imai	1954 births, Living people, Footballers from Saitama Prefecture
Vanderlei Luxemburgo	1952 births, Living people, Brazilian footballers, Brazilian football managers
Shinya Aikawa	1983 births, Living people, Footballers from Saitama Prefecture
Takuto Hayashi	1982 births, Living people, Footballers from Osaka Prefecture, People from Osaka
Norihiro Yamagishi	1978 births, Living people, Footballers from Saitama Prefecture
Ryota Tsuzuki	1978 births, Living people, Footballers from Nara Prefecture, Japan international footballers, J1 League players, Gamba Osaka players, Urawa Red Diamonds players, Shonan Bellmare players, 2001 FIFA Confederations Cup players, Footballers at the 2000 Summer Olympics
Robson Ponte	1976 births, Living people, Brazilian footballers
Tomislav Marić	1973 births, Living people, Croatian footballers
Ichiei Muroi	1974 births, Living people, Footballers from Saitama Prefecture
Boeremusiek	Folk music
Military Merit Cross (Austria–Hungary)	Military honors, Orders, decorations, and medals, Austria-Hungary
Ray Gordy	1979 births, American professional wrestlers, Living people, Sportspeople from Tennessee, People from Chattanooga, Tennessee, Former WWE wrestlers
Bing	2009 establishments in the United States, Microsoft websites, Websites, Search engines
Boy Scouts of America	Scouting
Counterfeit	Organized crime
Limoux	Communes in Aude, Subprefectures in France
Tamaddun Majlish	Organisations based in Bangladesh, Islamic organizations
Sindh Valley	Mountain passes of Pakistan, Valleys
Paktia Province	Provinces of Afghanistan
Sun Microsystems	Computers, 1982 establishments in California, Sun Microsystems, Santa Clara, California, Companies based in the San Francisco Bay Area, American technology companies
Water strider	Hemiptera
Bowler	Cricket
Wicket	Cricket
Dynamic and formal equivalence	Linguistics
The Undertones	1975 establishments in the United Kingdom, 1970s British music groups, 1980s British music groups, 1990s British music groups, 2000s British music groups, 2010s British music groups, British pop rock bands, British punk bands, Entertainers from Northern Ireland, Irish rock bands, Musical groups established in 1975
Luftfahrtgesellschaft Walter	Aviation
3G	Telecommunications, Mobile phones
Kin selection	Evolutionary biology, Genetics
Sterile	Words
Foraging	Zoology, Hunting
Pacific Northwest	Regions of Canada, Regions of the United States
Adaptation	Evolutionary biology, Ecology
Cobra Starship	2000s American music groups, 2010s American music groups, American punk bands, Musical groups from New York City, 2005 establishments in New York (state), Musical groups established in 2005, Musical groups disestablished in 2015, 2015 disestablishments in the United States, 2010s disestablishments in New York (state)
San Felipe de Puerto Plata	Settlements in Dominican Republic, 1500s establishments in the Spanish Empire
North Cascades	Mountains of Canada
The Point!	1971 movies, American animated movies, English-language movies
Darwinius	Fossils, Primates
Redmond Barry	Australian judges, Ned Kelly, People from County Cork, 1813 births, 1880 deaths
Transport network	Networks, Transport infrastructure
Buxton	Spa towns in the United Kingdom, Towns in Derbyshire
Alice's Adventures in Wonderland	English novels, Books by Lewis Carroll, Fantasy books, Children's books, English-language novels, 1860s books
Penny sterling	British currency
Montreal Wanderers	1900s establishments in Canada, 1903 establishments in North America, 1918 disestablishments, 20th century disestablishments in Canada, Defunct National Hockey League teams, National Hockey Association
£sd	British currency
Quebec Bulldogs	1888 establishments in Canada, Ice hockey teams in Quebec, Sport in Quebec City
Three-body problem	Physics, Astronomy
Yossi Benayoun	1980 births, Living people, Israeli footballers, Jewish Israeli sportspeople
Plum Warner	English cricketers
Douglas Jardine	1900 births, 1958 deaths, British Army officers, British military personnel of World War II, English cricketers, Majors, People of British India
The Oval	Cricket
Trophallaxis	Ecology
Oval tube station	Northern Line stations, Transport in Lambeth, London Travelcard zone 2
Nikolaus Harnoncourt	1929 births, 2016 deaths, Austrian conductors, Grammy Award winners, Musicians from Berlin, People from Graz, Performers of early music
Roger Norrington	British conductors, Performers of early music, 1934 births, Living people, Grammy Award winners, Officers of the Order of the British Empire, Knights Bachelor
Surrey County Cricket Club	Cricket clubs
Gustav Leonhardt	1928 births, 2012 deaths, Dutch Calvinists, Dutch conductors, Dutch educators, Harpsichordists, Organists, People from North Holland, Performers of early music
Vienna Symphony	Orchestras, Vienna
Liber Linteus	Etruscan civilization, Zagreb
Eel River	Rivers of California, Mendocino County, California, Humboldt County, California, Lake County, California, Trinity County, California
Cultivar	Botany
Plant propagation	Plant physiology
Cardamom	Zingiberales, Spices, Middle Eastern foods
Hayden Foxe	1977 births, Living people, Australian footballers, Sportspeople from Sydney
Sergio Escudero (footballer, born 1988)	1988 births, Living people, Spanish footballers, People from Granada
Sergio Escudero (footballer, born 1964)	1964 births, Living people, Argentine footballers
Osvaldo Escudero	1960 births, Living people, Argentine footballers
Giorgio Chiellini	1984 births, Living people, 2010 FIFA World Cup players, 2014 FIFA World Cup players, Italian footballers, People from Pisa, Sportspeople from Tuscany
Jonathan Zebina	1978 births, Living people, French footballers, Sportspeople from Paris
Alessio Tacchinardi	1975 births, Living people, Italian footballers
Dininho	1975 births, Living people, Brazilian footballers
Júlio Baptista	1981 births, Living people, Brazilian footballers
Dido Havenaar	1957 births, Living people, Association football goalkeepers, Dutch footballers, Sportspeople from South Holland
Miguel Ángel Angulo	1977 births, Living people, Spanish footballers, People from Oviedo
Manuele Blasi	1980 births, Living people, Italian footballers
Stephen Appiah	1980 births, Living people, Ghanaian footballers, People from Accra
Ancyloxypha	Hesperiidae
Developed country	Countries, Country classifications, Development, Economic geography
Market town	Law, Towns, Retail markets
Moped	Land vehicles
Hagerstown, Maryland	Cities in Maryland, County seats in Maryland, 1762 establishments in the Thirteen Colonies, 18th-century establishments in Maryland
Matteo Brighi	1981 births, Living people, Italian footballers
Tomokazu Myojin	1978 births, Living people, Footballers from Hyōgo Prefecture, Japan international footballers, J1 League players, J2 League players, J3 League players, Kashiwa Reysol players, Gamba Osaka players, Nagoya Grampus players, AC Nagano Parceiro players, 2002 FIFA World Cup players, 2001 FIFA Confederations Cup players, 2003 FIFA Confederations Cup players, Footballers at the 2000 Summer Olympics, 2000 AFC Asian Cup players, AFC Asian Cup-winning players
Seiichiro Maki	1980 births, Living people, Footballers from Kumamoto Prefecture, Japan international footballers, J1 League players, J2 League players, JEF United Chiba players, Tokyo Verdy players, Roasso Kumamoto players, 2006 FIFA World Cup players
Eiji Kawashima	1983 births, Living people, Footballers from Saitama Prefecture, Japan international footballers, J1 League players, J2 League players, Omiya Ardija players, Nagoya Grampus players, Kawasaki Frontale players, 2010 FIFA World Cup players, 2014 FIFA World Cup players, 2018 FIFA World Cup players, 2013 FIFA Confederations Cup players
Tomoyuki Sakai	1979 births, Living people, Footballers from Saitama Prefecture, Japan international footballers, J1 League players, JEF United Chiba players, Nagoya Grampus players, Urawa Red Diamonds players, Vissel Kobe players, Fujieda MYFC players, Footballers at the 2000 Summer Olympics
Vladimir Jugović	1969 births, Living people, Serbian footballers
Algorithmic information theory	Mathematics
Tawhīd	Islam
Nobuhisa Yamada	1975 births, Living people, Footballers from Shizuoka Prefecture, Japan international footballers, J1 League players, J2 League players, Urawa Red Diamonds players, 2003 FIFA Confederations Cup players
Keita Suzuki	1981 births, Living people, Footballers from Shizuoka Prefecture, Japan international footballers, J1 League players, J2 League players, Urawa Red Diamonds players
Sidmar Antônio Martins	1962 births, Living people, Brazilian footballers
Tadaaki Hirakawa	1979 births, Living people, Footballers from Shizuoka Prefecture
Toru Chishima	1981 births, Living people, Footballers from Saitama Prefecture
Satoshi Horinouchi	1979 births, Living people, Footballers from Saitama Prefecture
Fábio Camilo de Brito	1975 births, Living people, Brazilian footballers
Apennine Mountains	Mountains of Italy
Supercheap Auto	Automobile companies, Companies of Australia
Takuya Yokoyama	1985 births, Living people, Footballers from Shizuoka Prefecture, Fujieda MYFC players
Cristiano Lucarelli	1975 births, Living people, Italian footballers, People from Livorno
Yuriy Nikiforov	1970 births, Living people, Ukrainian footballers, Russian footballers
Lake Iseo	Lakes of Italy
International Year of Natural Fibres	Fibers, United Nations, 2009
Constanța	County capitals of Romania, Municipalities of Romania
Mureş River	Rivers of Hungary, Rivers of Romania
Olt River	Rivers of Romania
Siret River	Rivers of Ukraine, Rivers of Romania, Tributaries of the Danube
Prut	Rivers of Ukraine, Rivers of Moldova, Tributaries of the Danube
Asperger syndrome	Autism, Pervasive developmental disorders
Dig Dug	Arcade games, Namco video games
Virtual Kasparov	Chess, Game Boy Advance games, PlayStation games, 2001 video games
Portland Sea Dogs	Portland, Maine, Baseball teams
Moby	American DJs, Musicians from Connecticut, American rock musicians, Electronic musicians, Punk musicians, American songwriters, 1965 births, Living people
Röyksopp	Tromsø, Musical groups from Bergen, Musical groups established in 1998, 1998 establishments in Europe, 1990s establishments in Norway
Deportivo Alavés	Spanish football clubs
Hércules C.F.	Spanish football clubs, Alicante
RC Celta de Vigo	1920s establishments in Spain, 1923 establishments in Europe, Spanish football clubs
Real Murcia	Spanish football clubs, Murcia
Granada C.F.	Spanish football clubs, Granada, 1931 establishments in Europe, 1930s establishments in Spain
CE Sabadell F.C.	Spanish football clubs
C.D. Alcoyano	Spanish football clubs
Real Valladolid C.F.	Spanish football clubs, Valladolid
Maghreb Athletic Tétouan	Football clubs, 1922 establishments in Africa, 20th-century establishments in Morocco
Málaga C.F.	Spanish football clubs, Malaga
C.A. Osasuna	Spanish football clubs, Pamplona
Real Jaén C.F.	Spanish football clubs
Cultural Leonesa	Spanish football clubs
Elche C.F.	Spanish football clubs
R.C.D. Mallorca	Spanish football clubs
CD Tenerife	Spanish football clubs, Santa Cruz de Tenerife
Córdoba CF	Spanish football clubs
Pontevedra C.F.	Spanish football clubs, Galicia, 1941 establishments in Europe, 1940s establishments in Spain
Mini	Automobiles
Burgos C.F.	Spanish football clubs, Castile and León, 1994 establishments in Europe, 1990s establishments in Spain
A.D. Almería	Spanish football clubs, 1971 establishments in Europe, 1970s establishments in Spain
C.D. Castellón	Spanish football clubs
Albacete Balompié	Spanish football clubs, 1940 establishments in Europe, 1940s establishments in Spain
U.E. Lleida	Spanish football clubs
Toshiba	Computers, Electronics companies, 1939 establishments
R.C.D. Espanyol	Spanish football clubs
Mérida U.D.	Spanish football clubs, Extremadura
Levante U.D.	Spanish football clubs, Valencia
Cádiz CF	Spanish football clubs, Cadiz
C.D. Numancia de Soria	Spanish football clubs, Castile and León, 1945 establishments in Europe, 1940s establishments in Spain
Xerez C.D.	Spanish football clubs, Jerez de la Frontera, 1947 establishments in Europe, 1940s establishments in Spain
Edgar Adrian, 1st Baron Adrian	1889 births, 1977 deaths, Alumni of the University of Cambridge, English physicians, Order of Merit, British Nobel Prize winners, Neuroscientists
Hydrogen deuteride	Hydrogen compounds
Bond albedo	Astrophysics
Geographical pole	Physical geography
Spheroid	Three-dimensional shapes, Geodesy
Invariable plane	Celestial mechanics
G-Force	Physics
Sidereal time	Celestial mechanics, Measurement
Scale height	Atmosphere, Meteorology
Jupiter impact	Jupiter
Ja zuster, nee zuster	Dutch television programmes
Tom Gordon	1967 births, Living people, Boston Red Sox players, New York Yankees players, National League All-Stars
Paul Kalas	1967 births, Living people, American astronomers
Stewart Cink	1973 births, Living people, American golfers, Sportspeople from Huntsville, Alabama, People from Florence, Alabama
Crocs	2002 establishments in the United States, Colorado, Footwear
Buxton, Maine	Towns in Maine, 1772 establishments in the Thirteen Colonies, 18th-century establishments in Maine
Searsport, Maine	Towns in Maine
Brock Lesnar	1977 births, Living people, WWE wrestlers, Sportspeople from South Dakota, American professional wrestlers, American mixed martial artists
Dover-Foxcroft, Maine	Towns in Maine, County seats in Maine
The Border	1982 drama movies, 1980s crime drama movies, American crime drama movies, English-language movies, Movies set in Texas, Movies directed by Tony Richardson
Hide and Seek (2005 movie)	2005 movies, 20th Century Fox movies, English-language movies
ATP synthase	Biochemistry, Enzymes
Bayreuth Festival	Music festivals, Festivals in Europe, Bayreuth, 1876 establishments, Classical music festivals
Repertoire	Music, Theater
Working class	Socialism, Social groups
Ludwig II of Bavaria	1845 births, 1886 deaths, Kings and Queens in Germany
Real Burgos C.F.	Spanish football clubs, Castile and León
Folio	Literature
Ivan Regen	1868 births, 1947 deaths, Biologists, Slovenian scientists
Mole cricket	Orthoptera
Hisashi Tsuchida	1967 births, Living people, Footballers from Okayama Prefecture, J1 League players, J2 League players, Japan Soccer League players, Urawa Red Diamonds players, 1988 AFC Asian Cup players
Yuki Takita	1967 births, Living people, Footballers from Saitama Prefecture
Diego Forlán	1979 births, Living people, Uruguayan footballers, Sportspeople from Montevideo
Augusto Pedro de Souza	1968 births, Living people, Brazilian footballers, People from Brasília
Ned Zelić	1971 births, Living people, Australian footballers, Sportspeople from Sydney
Baccarat, Meurthe-et-Moselle	Communes in Meurthe-et-Moselle
Gun dog	Working dogs
Alaskan Klee Kai	Dog breeds
Alaskan Malamute	Dog breeds
Aidi	Dog breeds, Working dogs
Airedale Terrier	Terriers
Xinjiang	Xinjiang
Caspian Airlines Flight 7908	2009 aviation disasters, 2009 in Asia, 21st century in Iran, Aviation disasters in Asia, July events
Ancyloxypha numitor	Hesperiidae
Timothy Geithner	1961 births, United States Secretaries of the Treasury, Living people, American Christians, American economists, Politicians from New York City
Janet Napolitano	1957 births, Living people, Governors of Arizona, People with cancer, Politicians from New York City, United States Secretaries of Homeland Security
Wakhan	Geography of Afghanistan
Factor VIII	Genetic disorders, Blood disorders
X chromosome	Biological reproduction, Chromosomes
Edmonton tornado	Alberta, Tornadoes in Canada, 1987, 1980s in Canada
Vale of White Horse	Oxfordshire
Slipper	Footwear
Masaki Tsuchihashi	1972 births, Living people, Footballers from Kanagawa Prefecture, Japan international footballers, J1 League players, J2 League players, Urawa Red Diamonds players
Osamu Hirose	1965 births, Living people, Footballers from Saitama Prefecture
Alen Bokšić	1970 births, Living people, Croatian footballers
Harison da Silva Nery	1980 births, Living people, Brazilian footballers, People from Belém
Tomohiro Katanosaka	1971 births, Living people, Footballers from Kagoshima Prefecture
Tomohiro Hasumi	1972 births, Living people, Footballers from Tokyo Prefecture
Celso Vieira	1974 births, Living people, Brazilian footballers
Kazuaki Tasaka	1971 births, Living people, Footballers from Hiroshima Prefecture, Japan international footballers, Japanese football managers, J1 League players, J2 League players, Shonan Bellmare players, Shimizu S-Pulse players, Cerezo Osaka players
Luxembourg (Belgium)	Luxembourg (Belgium)
Bus	buses, Buses
Alyaksandr Hleb	1981 births, Living people, Belarusian footballers, People from Minsk
Chang Woe-Ryong	1959 births, Living people, South Korean footballers, South Korean football managers
John Hartson	Welsh footballers, People from Swansea, 1975 births, Living people
Ricardo Carvalho	1978 births, Living people, Portuguese footballers
Robbie Savage	1974 births, Living people, British radio personalities, Strictly Come Dancing participants, Welsh footballers
Danny Gabbidon	1979 births, Living people, Welsh footballers
Takeshi Oki	1961 births, Living people, Footballers from Shizuoka Prefecture
França	1976 births, Living people, Brazilian footballers
Dimitar Berbatov	1981 births, Living people, Bulgarian footballers
Santiago Bernabéu Yeste	1895 births, 1978 deaths, Spanish footballers
Simone Inzaghi	1976 births, Living people, Italian footballers
Akira Matsunaga (footballer, born 1948)	1948 births, Living people, Footballers from Shizuoka Prefecture, Japan international footballers, Japan Soccer League players, Kashiwa Reysol players
Shingo Kumabayashi	1981 births, Living people, Footballers from Akita Prefecture, Blaublitz Akita players
Paulo Futre	1966 births, Living people, Portuguese footballers
Makoto Atsuta	1976 births, Living people, Footballers from Tokyo Prefecture
Paolo Di Canio	1968 births, Living people, Italian footballers, Sportspeople from Rome
Cymbidium	Orchids
Pierre van Hooijdonk	1969 births, Living people, Dutch footballers, Sportspeople from North Brabant
Gerald Vanenburg	1964 births, Living people, Dutch footballers, Dutch football managers, Sportspeople from Utrecht (city)
Takehito Suzuki	1971 births, Living people, Footballers from Tokyo Prefecture
Tomokazu Hirama	1977 births, Living people, Footballers from Miyagi Prefecture
Kazushi Isoyama	1975 births, Living people, Footballers from Ibaraki Prefecture
Frank Ordenewitz	1965 births, Living people, German footballers, Sportspeople from Lower Saxony
Rafael van der Vaart	1983 births, Living people, Dutch footballers, Sportspeople from North Holland
Al-Ahly Tripoli	Football clubs in Tripoli, 1950s establishments in Libya
Al-Ittihad Tripoli	Football clubs in Tripoli, 20th-century establishments in Libya, 1944 establishments
Al-Tahaddy Benghazi	Football clubs in Benghazi, 1950s establishments in Libya
Al-Ahly Benghazi	Football clubs in Benghazi, 1947 establishments in Libya
Al-Madina Tripoli	Football clubs in Tripoli, 1950s establishments in Libya, 1953 establishments
Al-Dhahra Tripoli	Football clubs in Tripoli, 1947 establishments in Libya
Al-Nasr Benghazi	Football clubs in Benghazi, 1950s establishments in Libya
Al-Shat Tripoli	Football clubs in Tripoli, 20th-century establishments in Libya, 1982 establishments in Africa
Al-Mahalah Tripoli	Football clubs in Tripoli, 20th-century establishments in Libya, 1977 establishments in Africa
Al-Olympic Az-Zwiyah	Libyan football clubs, 1947 establishments in Libya
Washington (footballer)	1975 births, Living people, Brazilian footballers, People from Brasília
Marc Overmars	1973 births, Living people, Dutch footballers, Sportspeople from Gelderland
Satoru Suzuki	1975 births, Living people, Footballers from Shizuoka Prefecture
Salou	Cities in Catalonia, Municipalities in Catalonia
PortAventura World	Catalonia, 2002 establishments in Europe
Sakis Rouvas	Pop musicians, Greek singers, Greek actors, Choreographers, 1972 births, Living people
Life vest	Protective clothing, Sailing
Pocket watch	Clocks
Adam Brody	1979 births, Living people, American movie actors, American television actors, Actors from San Diego, California
The O.C.	2003 American television series debuts, 2007 American television series endings, 2000s American drama television series, 2000s soap operas, 2000s teen television series, American soap operas, American teen television series, Television series set in California, English-language television programs
Ouanaminthe	Cities in Haiti
Developing country	Country classifications
Malden Island	Pacific islands, Kiribati, Uninhabited islands
Scandinavian Airlines	1946 establishments in Europe, Airlines of Europe, Star Alliance, 20th century establishments in Denmark, 20th century establishments in Norway, 1940s establishments in Sweden, IATA members
York Minster	Buildings and structures in England, Anglican Cathedrals, York
High School Musical 2	2007 comedy-drama movies, 2000s musical movies, 2000s teen comedy movies, 2000s teen drama movies, 2007 television movies, American musical movies, American comedy-drama movies, American sequel movies, American teen comedy movies, American teen drama movies, American television movies, High School Musical, Movies directed by Kenny Ortega, Movies set in New Mexico
Delikanlım	1994 albums
Yıldız Tilbe	1966 births, Living people, People from İzmir, Turkish singers
Bijou Phillips	1980 births, Living people, American movie actors, American voice actors, Actors from Greenwich, Connecticut, Models from Connecticut
The Mamas & the Papas	1965 establishments in New York (state), 1960s American music groups, 1970s American music groups, Folk music groups, Musical groups disestablished in the 1970s, Musical groups established in 1965, Musical groups from New York City, 1971 disestablishments in the United States, 1960s disestablishments in New York (state)
Chocobo	Final Fantasy, Fictional birds
Sephiroth (Final Fantasy)	Fictional characters introduced in 1997, Final Fantasy, Kingdom Hearts characters, Video game antagonists, Video game bosses
Helicopter carrier	Ship types
Panzerfaust	Nazi Germany, Rifles
Ambush	Military, Military terminology
Grapeshot	Ammunition
Banzai charge	World War II, Military of Japan, 1940s in Japan
Paratrooper	Military
Daisuke Nakaharai	1977 births, Living people, Footballers from Shizuoka Prefecture
Andy van der Meyde	1979 births, Living people, Dutch footballers, People from Arnhem, Sportspeople from Gelderland
Shunsuke Maeda	1986 births, Living people, Footballers from Nara Prefecture
Víctor Valdés	1982 births, Living people, Spanish association football goalkeepers, Manchester United F.C. players
Marcus Vinicius de Morais	1974 births, Living people, Brazilian footballers
Toulouse FC	French football clubs, Toulouse, 1970 establishments in France
Stade Rennais F.C.	French football clubs, 1901 establishments in Europe, 1900s establishments in France
F.C. Lorient	French football clubs, 1926 establishments in Europe, 1920s establishments in France
Valenciennes F.C.	French football clubs, 1913 establishments in Europe, 1910s establishments in France
Grenoble Foot 38	French football clubs, Grenoble, 1892 establishments in Europe, 1890s establishments in France
A.S. Nancy-Lorraine	1960s establishments in France, 1967 establishments in Europe, French football clubs, Nancy
Le Mans FC	1980s establishments in France, 1985 establishments in Europe, French football clubs, Le Mans
S.M. Caen	1910s establishments in France, 1913 establishments in Europe, French football clubs, Caen
Le Havre AC	19th century establishments in France, 1870s establishments in Europe, 1872 establishments, French football clubs, Le Havre
FC Metz	1930s establishments in France, 1932 establishments in Europe, French football clubs
Tours F.C.	French football clubs, 1919 establishments in France
Angers SCO	1919 establishments in France, French football clubs
C.S. Sedan Ardennes	1919 establishments in France, French football clubs
SC Bastia	French football clubs, 1905 establishments in France
En Avant de Guingamp	French football clubs, 1912 establishments in France
Stade Brestois 29	1900s establishments in France, 1903 establishments in Europe, French football clubs, Brest, France
LB Châteauroux	1880s establishments in France, 1883 establishments in Europe, French football clubs
AC Ajaccio	French football clubs, 1910 establishments in Europe, 1910s establishments in France
Nîmes Olympique	French football clubs, 1937 establishments in Europe, 1930s establishments in France
R.C. France	French football clubs, 1882 establishments in France, 1932 disestablishments, 1930s disestablishments in France, 1967 establishments in Europe, 1960s establishments in France, 1983 disestablishments in Europe, 1980s disestablishments in France, 2006 establishments in France, 2007 disestablishments in Europe, 2000s disestablishments in France
S.C.O. Roubaix	French football clubs, Roubaix
Olympique Alès	French football clubs, 1923 establishments in Europe, 1920s establishments in France
F.C. Mulhouse	1890s establishments in France, 1893 establishments in Europe, French football clubs, Mulhouse
A.S. Cannes Football	French football clubs, Cannes, 1902 establishments in France
Red Star F.C. 93	French football clubs, 1897 establishments in Europe, 1890s establishments in France
F.C. Antibes Juan-les-Pins	French football clubs, 1912 establishments in France
F.C. Rouen 1899	French football clubs, Rouen, 1899 establishments in France
F.C. Nancy	French football clubs, Nancy
Stade Français	French football clubs, 1888 establishments in Europe, 1880s establishments in France
S.R. Colmar	French football clubs, 1920 establishments in France
E.S. Troyes A.C.	French football clubs, 1900 establishments in France
A.S. Béziers	French football clubs
Sporting Toulon Var	1940s establishments in France, 1944 establishments in Europe, French football clubs, Toulon
Angoulême C.F.C.	1920 establishments in France, French football clubs
Paris F.C.	French football clubs, Paris, 1969 establishments in Europe, 1960s establishments in France
Chamois Niortais F.C.	1920s establishments in France, 1925 establishments in Europe, French football clubs
Pikachu	Fictional characters introduced in 1996, Pokémon monsters
Gina McKee	1964 births, Living people, Actors from County Durham, English movie actors, English television actors
Florida State Road 540	Roads in Florida
Mr. Bean	1990 British television series debuts, 1995 British television series endings, 1990s British sitcoms, ITV comedy, Television series set in London, English-language television programs
Rowan Atkinson	1955 births, Living people, Actors from County Durham, Actors who played in James Bond movies, Alumni of the University of Oxford, British stand-up comedians, Commanders of the Order of the British Empire, English christians, English people of Armenian descent, English comedians, English movie actors, English radio actors, English stage actors, English television actors, English television writers, English voice actors
Cypress Gardens	Theme parks in Florida, Botanical gardens in the United States
WEKG	Radio stations in the United States, Kentucky
Valea Voenilor River	Rivers of Romania
South Portland, Maine	Cities in Maine
WJBQ	Radio stations in the United States, Portland, Maine
Daisy Duke	Fictional American people, Movie characters, Television characters
Sonata for Two Pianos and Percussion	Compositions by Béla Bartók, Sonatas
Concerto for Orchestra (Bartók)	Compositions by Béla Bartók, Orchestral works
Bluebird K7	Boats
TM 65 77	Explosives
Well, Hampshire	Villages in Hampshire
Where Sleeplessness Is Rest from Nightmares	2001 albums, Rock albums
Arma Angelus	1998 establishments in the United States, 2002 disestablishments in the United States, 1990s American music groups, 1990s establishments in Illinois, 2000s American music groups, Post-hardcore bands, Metalcore bands, Musical groups disestablished in 2002, Musical groups established in 1998, Musical groups from Chicago
51 Pegasi	Stars
Gumbasia	1954 movies, Short movies, Clay animation movies, English-language movies
University of Southern Maine	Colleges and universities in Maine, Portland, Maine, 1878 establishments in the United States, 19th-century establishments in Maine
Belmont, New Hampshire	Cities in New Hampshire, 1869 establishments in the United States, 19th-century establishments in New Hampshire
Joker (comics)	DC Comics supervillains, DC Comics adapted into movies, Batman characters, Fictional characters introduced in 1940, Fictional mass murderers, Mortal Kombat guest characters, The Joker
Iceman (Marvel Comics)	Characters created by Stan Lee, Fictional characters introduced in 1963, Fictional characters with ice or cold abilities, Fictional gay males, Marvel Comics characters, Marvel Comics mutants, Marvel Comics superheroes, Marvel vs. Capcom fighters
70 Virginis	Stars
Terry Gerin	American professional wrestlers, Former WWE wrestlers, Total Nonstop Action Wrestling alumni, Sportspeople from Michigan, 1975 births, Living people
70 Virginis b	Exoplanets
Peaks Island	Islands of the United States, Geography of Maine, Portland, Maine
Float On	2004 songs
Blue Hill, Maine	Cities in Maine
15385 Dallolmo	Asteroids
Operation Downfall	Invasions of World War II
F.C. Martigues	1920s establishments in France, 1921 establishments in Europe, French football clubs
F.C. Gueugnon	French football clubs, 1940 establishments in France
Blade (movie)	1998 horror movies, 1990s superhero movies, African-American superhero movies, American action movies, American horror movies, Blade movies, English-language movies, Film noir, Movies about revenge, Movies based on comics, New Line Cinema movies, Superhero horror movies, Vampires in movies, American superhero movies
The Bravery	2003 establishments in the United States, 2000s American music groups, 2000s establishments in New York (state), 2010s American music groups, 2011 disestablishments in the United States, American punk bands, Musical groups disestablished in 2011, Musical groups established in 2003, Musical groups from New York City
Cascada	2000s German music groups, 2010s German music groups, German pop music groups, Musical groups established in 2004, North Rhine-Westphalia
Scholasticism	Philosophical movements and positions, Theology
916 America	Asteroids
Donald	Given names
Johnstone	Towns in Scotland
Diamond Dallas Page	1956 births, American professional wrestlers, Former WWE wrestlers, Living people, Sportspeople from New Jersey, Total Nonstop Action Wrestling alumni
Sunapee, New Hampshire	Cities in New Hampshire
Scarborough, Maine	Towns in Maine
Luna (given name)	Given names
Susan Boyle	1961 births, Living people, British Roman Catholics, Scottish Christians, Scottish singers
Beat It	Michael Jackson songs, 1983 songs
Seiko	Technology companies of Japan
Gambit (Marvel Comics)	Marvel Comics superheroes
Coblentz (lunar crater)	Surface features of the Moon, Impact craters
Max Rockatansky	Movie characters
Tony Montana	Fictional murderers, Fictional people with antisocial personality disorder, Movie characters, Narcissism in fiction, Fictional mass murderers
Diomede Islands	Pacific islands, Islands of Alaska, Islands of Russia, Siberia
Clay animation	Animation
Carlos Alberto Carvalho dos Anjos Junior	1977 births, Living people, Brazilian footballers, People from Salvador, Bahia
Space Race	Spaceflight, 1950s in the United States, 1960s in the United States, 1950s in the Soviet Union
Oligotroph	Biology, Extremophiles
Supersaturation	Chemistry, Thermodynamics
Dyspnea	Health problems
Epiglottitis	Inflammation, Diseases and disorders of the digestive system
Lyme disease	Diseases caused by bacteria, Diseases spread by insects
Travis Childers	1958 births, Living people, United States representatives from Mississippi, US Democratic Party politicians
Carbonated water	Drinks
Eastern European Summer Time	Time zones
African Sanctus	Choral compositions, World music
David Fanshawe	1942 births, 2010 deaths, English composers, World music
Haley Barbour	1947 births, Living people, Businesspeople from Mississippi, US Republican Party politicians, People from Yazoo City, Mississippi, Governors of Mississippi, 21st-century American politicians
Moose Jaw, Saskatchewan	Cities in Saskatchewan
Playpen	Children, Furniture
The Planets	Compositions by Gustav Holst, Orchestral works
It's A Big Big World	American children's television series, PBS Kids shows, 2006 television series debuts, 2010 television series endings
Kota Kinabalu	Cities in Malaysia, Capital cities in Asia
Milang, South Australia	Towns in South Australia
Gilbert's potoroo	Marsupials of Australia, Critically endangered species
Bentinho	1971 births, Living people, Brazilian footballers
Yoshinobu Minowa	1976 births, Living people, Footballers from Kanagawa Prefecture, Japan international footballers, J1 League players, J2 League players, Júbilo Iwata players, Kawasaki Frontale players, Hokkaido Consadole Sapporo players
Shusaku Nishikawa	1986 births, Living people, Footballers from Oita Prefecture, Japan international footballers, J1 League players, Oita Trinita players, Sanfrecce Hiroshima players, Urawa Red Diamonds players, 2014 FIFA World Cup players, 2013 FIFA Confederations Cup players, Footballers at the 2008 Summer Olympics
G-type main-sequence star	Types of stars
Championnat National	Football leagues, 1993 establishments in France
Kōji Nakata	1979 births, Living people, Footballers from Shiga Prefecture, Japan international footballers, J1 League players, Kashima Antlers players, 2002 FIFA World Cup players, 2006 FIFA World Cup players, 2001 FIFA Confederations Cup players, 2003 FIFA Confederations Cup players, 2005 FIFA Confederations Cup players, Footballers at the 2000 Summer Olympics
Hayato Okanaka	1968 births, Living people, Footballers from Hyōgo Prefecture
Antonio Chimenti	1970 births, Living people, Italian association football goalkeepers, People from Bari
Vítor Baía	1969 births, Living people, Portuguese footballers
Alain Giresse	1952 births, Living people, French footballers, French football managers, People from Nouvelle-Aquitaine
Jean Tigana	1955 births, Living people, French footballers, French football managers, People from Bamako
Johan Neeskens	1951 births, Living people, Dutch footballers, Dutch football managers, Sportspeople from North Holland
Dirk Kuyt	1980 births, Living people, Dutch Calvinists, Dutch footballers, People from Katwijk, Sportspeople from South Holland
Ronald Koeman	1963 births, Living people, Dutch football managers, Dutch footballers, Eredivisie managers, People from Zaanstad, Sportspeople from North Holland
Michael Reiziger	1973 births, Living people, Dutch football managers, Dutch footballers, Eredivisie managers, Sportspeople from North Holland
Gheorghe Popescu	1967 births, Living people, Romanian footballers
Louis van Gaal	1951 births, Living people, Dutch football managers, Dutch footballers, Sportspeople from Amsterdam, Eredivisie managers
Dick Advocaat	1947 births, Living people, Dutch football managers, Dutch footballers, Sportspeople from The Hague, Eredivisie managers
Choi Soon-ho	1962 births, Living people, South Korean footballers, South Korean football managers
Masayuki Yanagisawa	1979 births, Living people, Footballers from Kanagawa Prefecture
Takahito Soma	1981 births, Living people, Footballers from Kanagawa Prefecture
Yoshinari Takagi	1979 births, Living people, Footballers from Tokyo Prefecture
Atsushi Yoneyama	1976 births, Living people, Footballers from Tochigi Prefecture, Japan international footballers, J1 League players, J2 League players, Tokyo Verdy players, Kawasaki Frontale players, Nagoya Grampus players, Tochigi SC players
Lee Gang-Jin	1986 births, Living people, South Korean footballers
Kenta Togawa	1981 births, Living people, Footballers from Tokyo Prefecture
Motif	Art
Hung (TV series)	2009 American television series debuts, 2011 American television series endings, 2000s American television series, 2010s American television series, American comedy-drama television series, Detroit, Michigan, Works about prostitution, English-language television programs
Daigo Kobayashi	1983 births, Living people, Footballers from Shizuoka Prefecture, Japan international footballers, J1 League players, Tokyo Verdy players, Omiya Ardija players, Shimizu S-Pulse players
Yoshiyuki Kobayashi	1978 births, Living people, Footballers from Saitama Prefecture, Albirex Niigata players
Martin Petrov	1979 births, Living people, Bulgarian footballers
Mateja Kežman	1979 births, Living people, Serbian footballers
Florent Sinama Pongolle	1984 births, Living people, French footballers, People from Réunion
Two Peoples Bay Nature Reserve	Western Australia
Microsoft OneNote	Microsoft Office
Tim McGraw	1967 births, Living people, American country musicians, Singers from Louisiana, American movie actors, Actors from Louisiana, People's Choice Award winners, Grammy Award winners
Confederation	Politics
Little Boots	1984 births, Living people, English pop singers, English singer-songwriters, People from Blackpool, Singers from Lancashire
Les noces	Compositions by Igor Stravinsky, Ballets Russes productions
Freenet	Free software, Networks
Fort-Liberté	Cities in Haiti, 1578 establishments, 1570s establishments in North America, Establishments in the French colonial empire
Montrichard	Communes in Loir-et-Cher, Former communes in France
Dan Tyminski	Banjo players, Singers from Vermont, Musicians from Vermont, American country musicians, Bluegrass musicians, 1967 births, Living people
Deepdale	1875 establishments in England, City of Preston, Lancashire, Football stadiums in England, Sport in Lancashire
Convolvulaceae	Convolvulaceae
John Gilbert (naturalist)	1845 deaths, English biologists, English naturalists, English explorers, 1810s births, Exploration of Australia
LimeWire	Software, File sharing
Yusuke Gondo	1982 births, Living people, Footballers from Tokyo Prefecture
Paulo Sousa	1970 births, Living people, Portuguese footballers, Portuguese football managers
Yuki Ishida	1980 births, Living people, Footballers from Hokkaidō Prefecture
Tsutomu Kitade	1978 births, Living people, Footballers from Hokkaidō Prefecture
Predrag Mijatović	1969 births, Living people, Montenegrin footballers
Javier Portillo	1982 births, Living people, Spanish footballers
Vicente Rodríguez	1981 births, Living people, Spanish footballers, People from Valencia
Ismael Urzaiz	1971 births, Living people, Spanish footballers
Will Robson Emilio Andrade	1973 births, Living people, Brazilian footballers
Vannes O.C.	French football clubs, 1998 establishments in Europe, 1990s establishments in France
Clermont Foot Auvergne	1910s establishments in France, 1911 establishments in Europe, French football clubs, Clermont-Ferrand
F.C. Istres Ouest Provence	French football clubs, 1920 establishments in France
Heitor Villa-Lobos	1887 births, 1959 deaths, 20th century composers
A.S. Beauvais Oise	French football clubs, 1945 establishments in France
C.S. Louhans-Cuiseaux	French football clubs, 1970 establishments in France
S.A.S. Épinal	French football clubs, 1940s establishments in France, 1941 establishments in Europe
Besançon R.C.	1905 establishments in France, French football clubs, Besançon
Stade Briochin	1904 establishments in France, French football clubs
E.S. Wasquehal	French football clubs, 1924 establishments in Europe, 1920s establishments in France
George Antheil	1900 births, 1959 deaths, 20th century composers, American composers, American pianists, American inventors, Writers from New Jersey
Wynton Rufer	1962 births, Living people, Football managers, Oceanic footballers, People from Wellington, Sportspeople from North Island
Turbojet	Aviation, Propulsion, Motors
Insomniac Games	Video game companies, Companies based in California, 1994 establishments in California, Burbank, California
Mitro Bahini	History of Bangladesh, 1970s in India, Bangladesh Liberation War
2001 Indian-Bangladesh border conflict	2001 in Asia, 2000s in India, 21st century in Bangladesh
Minicoy Island	Geography of the Maldives, Territorial disputes, Occupied territories
I2P	Messaging
Caryophyllaceae	Caryophyllaceae
LG KM900 (Arena)	LG mobile phones
2005 Pakistan earthquake	2000s in Pakistan, Disasters in Pakistan, Earthquakes in Asia, Earthquakes in the 2000s, October 2005 events
Keiichi Zaizen	1968 births, Living people, Footballers from Hokkaidō Prefecture
Yoshikazu Nonomura	1972 births, Living people, Footballers from Shizuoka Prefecture
Jean-Pierre Papin	1963 births, Living people, French footballers, French football managers
Patrik Andersson	1971 births, Living people, Swedish footballers
Kennet Andersson	1967 births, Living people, Swedish footballers
Masataka Sakamoto	1978 births, Living people, Footballers from Saitama Prefecture
Hasan Salihamidžić	1977 births, Living people, Bosnia and Herzegovina footballers
Sean Parnell	1962 births, Living people, Governors of Alaska, US Republican Party politicians, Politicians from California, People from Fairbanks, Alaska, Lieutenant Governors of Alaska
Walnut	Fagales, Edible nuts and seeds
Vasopressin	Hormones
Daniel Merriweather	1982 births, Australian singers, Living people, Musicians from Melbourne, R&B musicians
Jason Schwartzman	American movie actors, actors from Los Angeles, California, Musicians from Los Angeles, California, 1980 births, Living people
Epicenter	Earth
Eric Burdon	British rock musicians, English singers, English songwriters, People from Newcastle upon Tyne, 1941 births, Living people
Hanif Mohammad	Pakistani cricketers, 1934 births, 2016 deaths
Caucasus Emirate	Asian countries, European countries, Caucasus, Chechnya, Islamic terrorism, Occupied territories, Unrecognized countries
Moosehead Lake	Lakes of the United States
Rochdale A.F.C.	1907 establishments in England, English football clubs, Rochdale, Sport in Greater Manchester
Razakars (Pakistan)	1971 in Bangladesh, 1971 in Pakistan, Nationalist organizations in Asia, Bangladesh Liberation War
Qasim Razvi	Pakistani people, 1902 births, 1970 deaths
Razakars (Hyderabad)	History of India, History of Pakistan, Rebel militia groups in Asia, Hyderabad, India
Al-Shams (East Pakistan)	1971 in Bangladesh, 1971 in Pakistan, Bangladesh Liberation War
Al-Badr (East Pakistan)	1971 in Bangladesh, 1971 in Pakistan, Bangladesh Liberation War
All Jammu and Kashmir Muslim Conference	Political parties in Kashmir
Pinworm	Parasites
Cornish nationalism	Nationalism, Political movements, Politics of Cornwall
Orthogonal frequency-division multiplexing	Radio technology
Calculator	Mathematical tools
Yorkshire Television	ITV
Racibórz	Cities in Poland
2 World Trade Center	Skyscrapers in New York City, September 11 attacks, Buildings and structures in Manhattan
Beekeeper	Agricultural occupations, Beekeeping
Microsoft Bob	Microsoft
Torquay United F.C.	1899 establishments in England, English football clubs, Torquay
Punk blues	Rock music
Hangzhou	Hangzhou
West Lake	Lakes of China, Hangzhou
Huron River (Michigan)	Rivers of the United States, Geography of Michigan
Academic Ranking of World Universities	Colleges and universities
College and university rankings	Colleges and universities
Cow tipping	Cattle
Sojourner Truth	1797 births, 1883 deaths, African-American people, American abolitionists, American feminists, People from New York, Slaves
Quinkana	Extinct species, Crocodilia
Amaranth	Amaranthaceae, Grains
Instant Runoff Voting	Voting systems
Harrier Jump Jet	Royal Air Force aircraft
Valentina Matviyenko	Russian politicians, Women politicians, 1949 births, Living people
Dejan Savićević	1966 births, Living people, Montenegrin footballers
Dejan Stanković	1978 births, Living people, Serbian footballers, People from Belgrade
Koki Mizuno	1985 births, Living people, Footballers from Shizuoka Prefecture, Japan international footballers, J1 League players, J2 League players, J3 League players, JEF United Chiba players, Kashiwa Reysol players, Ventforet Kofu players, Vegalta Sendai players, Sagan Tosu players, Roasso Kumamoto players, SC Sagamihara players
Hiroki Mizumoto	1985 births, Living people, Footballers from Mie Prefecture, Japan international footballers, J1 League players, J2 League players, JEF United Chiba players, Gamba Osaka players, Kyoto Sanga FC players, Sanfrecce Hiroshima players, Matsumoto Yamaga FC players, FC Machida Zelvia players, Footballers at the 2008 Summer Olympics
Handley Page Victor	Royal Air Force aircraft
Vickers Valiant	Royal Air Force aircraft
Nuclear deterrent	Nuclear weapons
Avro Vulcan	Royal Air Force aircraft
Tony Gwynn	1960 births, 2014 deaths, African-American baseball players, African-American basketball players, Baseball players from California, Basketball players from California, Cancer deaths in the United States, Deaths from salivary gland cancer, Major League Baseball broadcasters, National League All-Stars, National Baseball Hall of Fame members, San Diego Padres players, Sportspeople from Los Angeles, California, American basketball players
Barthold Fles	1902 births, 1989 deaths, Businesspeople from New York City, Jewish American writers, Translators, Writers from Amsterdam, Writers from Manhattan
Jon Lester	American baseball players, Sportspeople from Washington, Boston Red Sox players, Chicago Cubs players, Oakland Athletics players, Cancer survivors, Living people, 1984 births, People from Tacoma, Washington
Purple Haze (marijuana)	Illegal drugs, Cannabis
Lon Chaney Jr.	1906 births, 1973 deaths, Deaths from heart failure, American television actors, American movie actors, Actors from Oklahoma
Raja Bell	1976 births, Living people, Basketball players, Charlotte Bobcats players, Dallas Mavericks players, Golden State Warriors players, Philadelphia 76ers players, Phoenix Suns players, Utah Jazz players
Steve Nash	1974 births, Canadian basketball players, Dallas Mavericks players, Living people, Los Angeles Lakers players, Phoenix Suns players, South African sportspeople, Sportspeople from British Columbia, People from Johannesburg, People from Victoria, British Columbia, National Basketball Association players with retired numbers
Folder (computing)	Software
Computer icon	Computers
Portulacaceae	Caryophyllales
Peter Grimes	Compositions by Benjamin Britten, 20th century operas, 1945 works
Tomonori Tateishi	1974 births, Living people, Footballers from Chiba Prefecture
Ilian Stoyanov	1977 births, Living people, Bulgarian footballers
Mario Haas	1974 births, Living people, Austrian footballers, Players of the Austrian national football team
Yohei Kajiyama	1985 births, Living people, Footballers from Tokyo Prefecture, J1 League players, J2 League players, J3 League players, FC Tokyo players, FC Tokyo U-23 players, Oita Trinita players, Albirex Niigata players, Footballers at the 2008 Summer Olympics
Aron Winter	1967 births, Living people, Dutch footballers, People from Paramaribo
Ryo Kushino	1979 births, Living people, Footballers from Kumamoto Prefecture
Gabriel Popescu	1973 births, Living people, Romanian footballers
Steve McManaman	1972 births, Living people, English footballers, Sportspeople from Liverpool, Premier League players
Péricles Chamusca	1965 births, Living people, Brazilian football managers, People from Salvador, Bahia
Atsuhiko Ejiri	1967 births, Living people, Footballers from Shizuoka Prefecture
Tanggula Railway Station	Tibet
Kazimierz Fajans	American chemists, 1887 births, 1975 deaths
Kitee Zoo	Zoos, Finland
Scots pine	Conifers
Mesenteric ischemia	Diseases
Trix (cereal)	Breakfast cereals
Francisco Martínez de la Rosa	1787 births, 1862 deaths, Spanish politicians, People from Granada
Marcelino Menéndez Pelayo	Spanish writers, 1856 births, 1912 deaths
Harry Patch	1898 births, 2009 deaths, British military personnel of World War I, British supercentenarians, Firefighters, People from Somerset, Plumbers
Tommy Atkins	British Army, Slang, 19th century in the United Kingdom
Mo Vaughn	1976 births, African-American baseball players, American League All-Stars, Boston Red Sox players, Living people, Los Angeles Angels of Anaheim players, New York Mets players, Sportspeople from Connecticut, People from Norwalk, Connecticut
Eiffel 65	1990s music groups, 2000s music groups, 2010s music groups, Italian musical groups, Musical groups established in 1998, Pop music groups, Turin, 1998 establishments in Europe, 1990s establishments in Italy, Musical groups disestablished in 2005, 2005 disestablishments in Italy, 2010 establishments in Europe, Musical groups established in 2010, 2010s establishments in Italy
Henry Allingham	1896 births, 2009 deaths, British military personnel of World War I, British supercentenarians, Deaths from natural causes, People from London, World record holders
Milgram experiment	Psychology, Experiments
Page-boy	Feudalism
Gambit	Chess openings
Carlos Clos Gómez	Spanish sportspeople, Association football, Referees, People from Zaragoza
Free fall	Physics
Essjay controversy	Hoaxes, Controversies, Wikimedia
Cernunnos	Celtic peoples, Paganism, Gods and goddesses
Gameplay of Pokémon	Pokémon
Rodolfo Oroz	Chilean people, 1895 births, 1997 deaths, People from Santiago
Fernando de Herrera	Spanish writers, 1530s births, 1597 deaths
Juan Ruiz de Alarcón	Spanish writers, 1580s births, 1639 deaths, Guerrero (state)
Candan Erçetin	1964 births, Living people
Shogo Nishikawa	1983 births, Living people, Footballers from Hiroshima Prefecture
Tomoyuki Hirase	1977 births, Living people, Footballers from Kagoshima Prefecture, Japan international footballers, J1 League players, J2 League players, Kashima Antlers players, Yokohama F. Marinos players, Vissel Kobe players, Vegalta Sendai players, Footballers at the 2000 Summer Olympics
Liberian Premier League	Football leagues
Mark van Bommel	1977 births, Living people, Dutch footballers, Sportspeople from Limburg (Netherlands)
Kohei Kudo	1984 births, Living people, Footballers from Chiba Prefecture
C.A. San Lorenzo de Almagro	Argentine football clubs, 1908 establishments in South America, 1900s establishments in Argentina
Club Estudiantes de La Plata	Argentine football clubs, 1905 establishments in Argentina
Racing Club	Argentine football clubs, 1903 establishments in South America, 1900s establishments in Argentina
Club Atlético Independiente	Argentine football clubs, 1904 establishments in Argentina
C.A. Chacarita Juniors	Argentine football clubs, 1906 establishments, 1900s establishments in Argentina
C.A. Huracán	Argentine football clubs, 1908 establishments in South America, 1900s establishments in Argentina
C.A. Vélez Sársfield	Argentine football clubs, 1910 establishments in South America, 1910s establishments in Argentina
Club Ferro Carril Oeste	Argentine football clubs, 1904 establishments in Argentina, Football clubs in Buenos Aires
Argentinos Juniors	Argentine football clubs, 1904 establishments in Argentina
Quilmes A.C.	Argentine football clubs, 1887 establishments, 1880s establishments in Argentina
C.A. Lanús	Argentine football clubs, 1915 establishments, 1910s establishments in Argentina
MTN Elite One	Football leagues, Sport in Cameroon
Daisuke Saito (born in 1974)	1974 births, Living people, Footballers from Aichi Prefecture
Ryuji Fujiyama	1973 births, Living people, Footballers from Kagoshima Prefecture
Norio Suzuki	1984 births, Living people, Footballers from Chiba Prefecture
Tarik Oulida	1974 births, Living people, Dutch footballers, Sportspeople from Amsterdam
Hayuma Tanaka	1982 births, Living people, Footballers from Nagano Prefecture, Japan international footballers, J1 League players, J2 League players, Yokohama F. Marinos players, Tokyo Verdy players, Nagoya Grampus players, Matsumoto Yamaga FC players
Manabu Wakabayashi	1979 births, Living people, Footballers from Tochigi Prefecture
Tomi Shimomura	1980 births, Living people, Footballers from Hokkaidō Prefecture
Robin van Persie	1983 births, Living people, 2006 FIFA World Cup players, 2010 FIFA World Cup players, 2014 FIFA World Cup players, Arsenal F.C. players, Dutch footballers, Manchester United F.C. players, Sportspeople from Rotterdam
Albert Jorquera	1979 births, Living people, Spanish association football goalkeepers
Korkeasaari	Islands of Europe, Geography of Finland, Helsinki
Swadlincote	Towns in Derbyshire
Aqua (skyscraper)	2009 establishments in Illinois, Skyscrapers in Chicago
The Legacy at Millennium Park	Skyscrapers in Chicago, 2009 establishments in Illinois
Gresham's law	Money
Benjamin Netanyahu	Benjamin Netanyahu, 1949 births, Living people, Ambassadors of Israel, Ambassadors to the United Nations, Deputy government ministers of Israel, Government ministers of Israel, Israeli military people, Israeli opposition leaders, Israeli political leaders, Jewish Israeli politicians, Jewish Israeli writers, Jewish military people, Likud politicians, Massachusetts Institute of Technology alumni, Members of Knesset, People from Tel Aviv, Israeli political scientists, Prime Ministers of Israel
Nagqu Prefecture	Tibet
Bobby Bonilla	1963 births, Atlanta Braves players, Baltimore Orioles players, Chicago White Sox players, Florida Marlins players, Living people, Los Angeles Dodgers players, National League All-Stars, New York Mets players, Pittsburgh Pirates players, St. Louis Cardinals players
Charing Cross	Areas of London, Buildings and structures in London
Kappa, Illinois	Villages in Illinois
Colitis	Diseases
Dearborn, Michigan	Cities in Michigan, 1886 establishments in the United States, 1880s establishments in Michigan
Cameron, Wood County, Wisconsin	Towns in Wisconsin, Wood County, Wisconsin
Iacobeni, Suceava	Communes in Suceava County
Marginea	Communes in Suceava County
Maglavit	Communes in Dolj County
Malu Mare	Communes in Dolj County
Brașov County	Counties of Romania, Transylvania
Berchişeşti	Communes in Suceava County
Vâlcea County	Counties of Romania
Olt County	Counties of Romania
Maramureș County	Counties of Romania
Sibiu County	Counties of Romania, Transylvania
Quickie (sex)	Sexual acts
Deep-throating	Sexual acts
Fisting	Sexual acts
Andreas Isaksson	1981 births, Living people, Swedish footballers, Association football goalkeepers
Olof Mellberg	1977 births, Living people, Swedish footballers
Michael Essien	1982 births, Living people, Ghanaian footballers, People from Accra
Invincible Eleven & Majestic S.A.	Football clubs in Monrovia
Mighty Barolle S.A.	Liberian football clubs
Oryx Douala	Cameroonian football clubs
Caïman de Douala	Cameroonian football clubs
Samuel Kuffour	1976 births, Living people, Ghanaian footballers
Thiago Motta	1982 births, Living people, Brazilian footballers
Diamant Yaoundé	Cameroonian football clubs
Rafael Márquez	1979 births, Living people, Mexican footballers
Sylvinho	1974 births, Living people, Brazilian footballers
Park Kang-Jo	1980 births, Living people, South Korean footballers
Dudu Cearense	1983 births, Living people, Brazilian footballers, People from Fortaleza
Yukio Tsuchiya	1974 births, Living people, Footballers from Tokyo Prefecture
Rosario Central	Argentine football clubs, 1889 establishments, 1880s establishments in Argentina
Saint Joseph Warriors	Liberian football clubs
Chalcedonian Creed	Ancient Christianity, Christian creeds
Mount Fraser	Volcanoes of Australia, Volcanic craters, Mountains of Victoria (Australia)
Lucario	Fictional characters introduced in 2005, Pokémon monsters
Cacabelos	Municipalities in Castile and León, Settlements in León
Cabrillanes	Municipalities in Castile and León, Settlements in León
Camponaraya	Municipalities in Castile and León, Settlements in León
Villamañán	Municipalities in Castile and León, Settlements in León
La Bañeza	Municipalities in Castile and León, Settlements in León
Cármenes	Settlements in León, Municipalities in Castile and León
Villablino	Municipalities in Castile and León, Settlements in León
Castrotierra de Valmadrigal	Municipalities in Castile and León, Settlements in León
El Burgo Ranero	Municipalities in Castile and León, Settlements in León
Villamanín	Municipalities in Castile and León, Settlements in León
Carucedo	Municipalities in Castile and León, Settlements in León
Luyego	Municipalities in Castile and León, Settlements in León
Destriana	Municipalities in Castile and León, Settlements in León
Igüeña	Municipalities in Castile and León, Settlements in León
Hertzsprung–Russell diagram	Astrophysics, Diagrams
Seabird	Seabirds
Tropical Depression One (2009)	Tropical depressions, Hurricanes in the United States, May events, 2009 Atlantic hurricane season, 2000s in North Carolina, 2009 in the United States
Orange, Wisconsin	Juneau County, Wisconsin, Towns in Wisconsin
Hatteras, North Carolina	Unincorporated communities in North Carolina
Rolex	Companies of Switzerland
Cecil Fielder	1963 births, African-American baseball players, American League All-Stars, Baseball players from California, California Angels players, Cleveland Indians players, Detroit Tigers players, Living people, New York Yankees players, Sportspeople from Los Angeles, California, Toronto Blue Jays players
Makoto Tanaka	1975 births, Living people, Footballers from Shizuoka Prefecture, Japan international footballers, J1 League players, J2 League players, Júbilo Iwata players, Avispa Fukuoka players, 2005 FIFA Confederations Cup players, Footballers at the 1996 Summer Olympics
Oleguer Presas	1980 births, Living people, Spanish footballers
Union Sportive Douala	Cameroonian football clubs
Ludovic Giuly	1976 births, Living people, French footballers, Sportspeople from Lyon
Maxi López	1984 births, Living people, Argentine footballers, Sportspeople from Buenos Aires
Gabri García	1979 births, Living people, Spanish footballers
Canon Sportif de Yaoundé	Cameroonian football clubs
Santiago Ezquerro	1976 births, Living people, Spanish footballers
Rubén Iván Martínez	1984 births, Living people, Spanish association football goalkeepers
Damià Abella	1982 births, Living people, Spanish footballers
Aigle Nkongsamba	Cameroonian football clubs
Jo Kanazawa	1976 births, Living people, Footballers from Saitama Prefecture
Shigeri Sada	1954 births, Living people, Footballers from Nagasaki Prefecture
Yasunobu Matsuoka	1986 births, Living people, Footballers from Osaka Prefecture, People from Osaka
Léopards Douala	Cameroonian football clubs
Nikola Žigić	1980 births, Living people, Serbian footballers
Santiago Salcedo	1981 births, Living people, Paraguayan footballers, People from Asunción
Jean Carlo Witte	1977 births, Living people, Brazilian footballers
Yuzuru Nozu	1899 births, 1983 deaths, Footballers from Hiroshima Prefecture, People from Hiroshima
Yoshiro Abe	1980 births, Living people, Footballers from Ehime Prefecture
Lucas Severino	1979 births, Living people, Brazilian footballers
Yuta Baba	1984 births, Living people, Footballers from Tokyo Prefecture
Kazuya Maeda	1982 births, Living people, Footballers from Wakayama Prefecture
Takashi Kitano	1982 births, Living people, Footballers from Hokkaidō Prefecture
Yasuhiro Kamata	1980 births, Living people, Footballers from Shizuoka Prefecture
Koichi Kidera	1972 births, Living people, Footballers from Saitama Prefecture
Kenji Honnami	1964 births, Living people, Footballers from Osaka Prefecture, Japan international footballers, J1 League players, Japan Soccer League players, Gamba Osaka players, Tokyo Verdy players
Hugo Maradona	1969 births, Living people, Argentine footballers, Argentine football managers
Ryoichi Kurisawa	1982 births, Living people, Footballers from Chiba Prefecture
Masashi Miyazawa	1978 births, Living people, Footballers from Yamanashi Prefecture
L.P.R.C. Oilers	Football clubs in Monrovia
N.P.A. Anchors	Football clubs in Monrovia
Monrovia Black Star F.C.	Football clubs in Monrovia
Hitoshi Shiota	1981 births, Living people, Footballers from Ibaraki Prefecture
Mitsuhiro Toda	1977 births, Living people, Footballers from Miyazaki Prefecture
Satoru Asari	1974 births, Living people, Footballers from Saitama Prefecture
Masamitsu Kobayashi	1978 births, Living people, Footballers from Tochigi Prefecture
Taisei Fujita	1982 births, Living people, Footballers from Kōchi Prefecture
Niko Kranjčar	1984 births, Living people, Croatian footballers, Sportspeople from Zagreb
Hiroyuki Omata	1983 births, Living people, Footballers from Tokyo Prefecture
Luís Fabiano	1980 births, Living people, Brazilian footballers
Jader Volnei Spindler	1982 births, Living people, Brazilian footballers
Takaji Mori	1943 births, 2011 deaths, Footballers from Hiroshima Prefecture, Japan international footballers, Japanese football managers, Japan Soccer League players, Urawa Red Diamonds players, Japan national football team managers, Footballers at the 1964 Summer Olympics, Footballers at the 1968 Summer Olympics, Olympic medalists in football, Japanese Olympic bronze medalists, Medalists at the 1968 Summer Olympics
Naoki Soma	1971 births, Living people, Footballers from Shizuoka Prefecture, Japan international footballers, Japanese football managers, J1 League players, J2 League players, Kashima Antlers players, Tokyo Verdy players, Kawasaki Frontale players, 1998 FIFA World Cup players, 1995 King Fahd Cup players, 1996 AFC Asian Cup players
Tonnerre Kalara Club de Yaoundé	Cameroonian football clubs
Kenzo Yokoyama	1943 births, Living people, Footballers from Saitama Prefecture, Japan international footballers, Japanese football managers, Japan Soccer League players, Urawa Red Diamonds players, Japan national football team managers, Footballers at the 1964 Summer Olympics, Footballers at the 1968 Summer Olympics, Olympic medalists in football, Japanese Olympic bronze medalists, Medalists at the 1968 Summer Olympics
Tetsuya Totsuka	1961 births, Living people, Footballers from Tokyo Prefecture, Japan international footballers, J1 League players, Japan Soccer League players, Tokyo Verdy players, Kashiwa Reysol players
Pavel Řehák	1963 births, Living people, Czech footballers, Czech football managers
Holger Osieck	1948 births, Living people, German football managers, German footballers, People from Duisburg, Sportspeople from North Rhine-Westphalia
Fabão	1976 births, Living people, Brazilian footballers
Unisport de Bafang	Cameroonian football clubs
Kazuo Saito	1951 births, Living people, Footballers from Saitama Prefecture, Japan international footballers, Japanese football managers, Japan Soccer League players, Urawa Red Diamonds players
Toshimi Kikuchi	1973 births, Living people, Footballers from Iwate Prefecture
Absolute temperature	Temperature
King of Saudi Arabia	Kings of Saudi Arabia
Monas	Jakarta, Monuments and memorials, 1975 establishments in Asia, 20th century establishments in Indonesia, Buildings and structures in Indonesia
Rush hour	Traffic
Pita (footballer)	1958 births, Living people, Footballers from Rio de Janeiro, Brazilian football managers
Takashi Sekizuka	1960 births, Living people, Footballers from Chiba Prefecture, Japanese football managers, Japan Soccer League players, Honda FC players
Yusuke Kondo	1984 births, Living people, Footballers from Tokyo Prefecture
Shinji Kobayashi	1960 births, Living people, Footballers from Nagasaki Prefecture
Hidemi Kotani	1963 births, Living people, Footballers from Okayama Prefecture, Japanese football managers
Racing F.C. Bafoussam	Cameroonian football clubs
Shigeo Yaegashi	1933 births, 2011 deaths, Footballers from Iwate Prefecture, Japan international footballers, Japan Soccer League players, JEF United Chiba players, Footballers at the 1956 Summer Olympics, Footballers at the 1964 Summer Olympics, Footballers at the 1968 Summer Olympics, Olympic medalists in football, Japanese Olympic bronze medalists, Medalists at the 1968 Summer Olympics
Naoto Nakamura	1979 births, Living people, Footballers from Chiba Prefecture
Yasushi Yoshida	1960 births, Living people, Footballers from Tokyo Prefecture
Yoshiharu Horii	1953 births, Living people, Footballers from Shizuoka Prefecture, Japanese football managers
Hiroshi Kobayashi	1959 births, Living people, Footballers from Ibaraki Prefecture
Kelly	1975 births, Living people, Brazilian footballers
Yoshika Matsubara	1974 births, Living people, Footballers from Shizuoka Prefecture, Japanese football managers, J1 League players, J2 League players, Júbilo Iwata players, Shimizu S-Pulse players, JEF United Chiba players, Shonan Bellmare players, Avispa Fukuoka players, Footballers at the 1996 Summer Olympics
Yuta Minami	1979 births, Living people, Footballers from Kanagawa Prefecture
Shinji Otsuka	1975 births, Living people, Footballers from Chiba Prefecture
Daiki Takamatsu	1981 births, Living people, Footballers from Yamaguchi Prefecture, Japan international footballers, J1 League players, J2 League players, J3 League players, Oita Trinita players, FC Tokyo players, Footballers at the 2004 Summer Olympics
Gert Engels	1957 births, Living people, German football managers, German footballers, Sportspeople from North Rhine-Westphalia
Wesley Sneijder	1984 births, Living people, Dutch footballers, Sportspeople from Utrecht (city)
Kenichi Kondo	1983 births, Living people, Footballers from Nagasaki Prefecture
Kazuya Maeda (born in 1984)	1984 births, Living people, Footballers from Tochigi Prefecture
Darlington	Towns in County Durham
Kirby & the Amazing Mirror	2004 video games, Game Boy Advance games, Platform games, Kirby
Juan Donoso Cortés	1809 births, 1853 deaths, Philosophers, Spanish politicians, Spanish writers, People from Extremadura
Trust (social science)	Virtues
Agrippa I	10 BC births, 44 deaths, New Testament people, Kings of ancient Judah
Hinche	Cities in Haiti, 1700s establishments in North America, 18th-century establishments in the Spanish Empire, 1704 establishments
Cloverleaf quasar	Galaxies
Juneau County, Wisconsin	Juneau County, Wisconsin, 1858 establishments in Wisconsin
Diponegoro	Indonesian people
Bam Margera	1979 births, Living people, American television personalities, Skateboarders, Actors from Pennsylvania, American comedians, American movie actors, American skateboarders, American television actors, American television presenters, Reality television participants, Sportspeople from Pennsylvania
Video game content rating system	Video game ratings
Union territory	Government of India, Territories of India
Nestor Omar Piccoli	1965 births, Living people, Argentine footballers, Argentine football managers, Sportspeople from Buenos Aires
Masaaki Kanno	1960 births, Living people, Footballers from Kanagawa Prefecture
Ľubomír Moravčík	1965 births, Living people, Slovak footballers
Tiko United F.C.	Cameroonian football clubs
Masakazu Suzuki	1955 births, Living people, Footballers from Yamanashi Prefecture
Takashi Kuwahara	1948 births, Living people, Footballers from Shizuoka Prefecture
Yoshikazu Goto	1964 births, Living people, Footballers from Shizuoka Prefecture
Cotonsport F.C. Garoua	Cameroonian football clubs
Fovu Baham	Cameroonian football clubs
Lancaster Barnstormers	Sports in Pennsylvania, Baseball teams
Yasuhiro Higuchi	1961 births, Living people, Footballers from Mie Prefecture
Francisco Javier Peral	1983 births, Living people, Spanish footballers
UAE Pro League	Football leagues
Stephen Tataw	1963 births, 2020 deaths, Cameroonian footballers
Carlos González Peña	1983 births, Living people, Spanish footballers, People from Salamanca
Hideya Okamoto	1987 births, Living people, Footballers from Osaka Prefecture, People from Osaka, Avispa Fukuoka players
Philadelphia Union	American soccer teams, Major League Soccer teams, 2008 establishments in the United States, 2000s establishments in Pennsylvania
Sammy Adjei	1980 births, Living people, Ghanaian footballers, Association football goalkeepers, People from Accra
Sulley Muntari	1984 births, Living people, Ghanaian footballers
Emmanuel Pappoe	1981 births, Living people, Ghanaian footballers, People from Accra
Projectile	Mechanics, Ballistics
Mathematical physics	Mathematics
2003 Atlantic hurricane season	2003 Atlantic hurricane season
Hurricane Paloma	2008 Atlantic hurricane season, Category 4 Atlantic hurricanes, November 2008 events, 2008 in the United States, 2000s in Florida, History of the Cayman Islands, 2000s in Jamaica, 2000s in Cuba, 2000s in Honduras, 2000s in Nicaragua, 2000s in the Bahamas
The Craig Machine	2005 albums
John Paintsil	1981 births, Living people, Ghanaian footballers
Sable F.C.	Cameroonian football clubs
Sharjah FC	United Arab Emirati football clubs
Al-Ahli Dubai	United Arab Emirati football clubs, Sport in Dubai
Ryan Babel	1986 births, Living people, Dutch footballers, Sportspeople from Amsterdam
Al-Nasr SC (Dubai)	United Arab Emirati football clubs, Sport in Dubai
Al Wasl F.C.	United Arab Emirati football clubs, Sport in Dubai
Al-Wahda Abu Dhabi	United Arab Emirati football clubs
Djimi Traoré	1980 births, Living people, Malian footballers
Josemi	1979 births, Living people, Spanish footballers
Robert Cullen	1985 births, Living people, Footballers from Ibaraki Prefecture
Superhero (Stephen Lynch album)	2003 albums, Comedy
A Little Bit Special	2000 albums
Melbourne, Derbyshire	Towns in Derbyshire, Market towns in England
Pokémon Adventures	Pokémon
Pragmatics	Linguistics
Inattentional blindness	Cognition, Perception
Melky Cabrera	1984 births, Living people, Dominican Republic sportspeople, Atlanta Braves players, Chicago White Sox players, Kansas City Royals players, New York Yankees players, San Francisco Giants players, Toronto Blue Jays players
Ludacris	1977 births, Living people, African American musicians, Singers from Illinois, American movie actors, American television actors, American rap musicians from Illinois, Actors from Illinois, Grammy Award winners, People from Champaign, Illinois
Millionaires (group)	Musical groups from Huntington Beach, California, 2007 establishments in California, Musical groups established in 2007
Heckler & Koch MP series	Submachine guns
Meishi Street	2006 movies, Documentary movies, Chinese movies
Brentwood College School	Schools in Canada, 1923 establishments in North America, 1920s establishments in Canada
Cutscene	Video game design
Thirteenth Amendment to the United States Constitution	Amendments to the United States Constitution, 1865 in the United States
Hurricane Jeanne	2004 Atlantic hurricane season, 2004 in Florida, Deadly storms, Disasters in the 2000s, Hurricanes in the United States, 2000s in Haiti, 2000s in Puerto Rico, 2000s in the Bahamas, September events
Jun Muramatsu	1982 births, Living people, Footballers from Shizuoka Prefecture
Mohamed Sissoko	1985 births, Living people, Malian footballers
Al-Ain FC	United Arab Emirati football clubs
Stephen Warnock	1981 births, Living people, English footballers, Liverpool F.C. players, People from Lancashire, Premier League players
Redevelopment	Urban planning
Articulated vehicle	Vehicles
Balloon loop	Railway track layouts
Lund University	Colleges and universities in Sweden, Lund, 17th century establishments in Europe
Lope de Rueda	1510s births, 1565 deaths, People from Seville, Spanish writers
Guillén de Castro	Spanish writers
Sic	Latin phrases
Warm front	Meteorology
Groundwater	Water
Palm Beach County, Florida	Florida counties, Palm Beach County, Florida, 1900s establishments in Florida, 1909 establishments in the United States
Lake Okeechobee	Geography of Florida, Lakes of the United States, Palm Beach County, Florida
All I Ever Wanted (album)	2009 albums, Kelly Clarkson albums
Bernard Herrmann	1911 births, 1975 deaths, Academy Award winning composers, American movie score composers, Deaths from heart failure, Entertainers from New York City
Félix María Samaniego	1745 births, 1801 deaths, Spanish writers
Vermilion (song)	Slipknot songs, 2004 songs
Before I Forget (song)	Slipknot songs, 2004 songs
Mate. Feed. Kill. Repeat.	1997 albums, Debut albums, Slipknot albums, Heavy metal albums
Turntablism	Hip hop
Nadezhda von Meck	Russian people, 1831 births, 1894 deaths
Clapper (musical instrument)	Percussion instruments
Giza Necropolis	Buildings and structures in Ancient Egypt, Seven Wonders of the World, Pyramids, Archaeological sites in Egypt, World Heritage Sites in Egypt
Yury Luzhkov	1936 births, 2019 deaths, Deaths from surgical complications, Mayors of Moscow
Gary Twigg	Living people, 1984 births, Scottish footballers
University of Delaware	Colleges and universities in Delaware, Newark, Delaware, 1740s establishments in the Thirteen Colonies
Halifax, West Yorkshire	Towns in West Yorkshire
Power Rangers	American television series
Sophoreae	Faboideae
Calzone	Italian food
Bisexual pornography	Pornography, Human sexuality
Soap made from human corpses	The Holocaust
Adiel de Oliveira Amorim	1980 births, Living people, Brazilian footballers
Darren Potter	1984 births, Living people, Irish footballers, People from Liverpool
Johann Vogel	1977 births, Living people, Swiss footballers, People from Geneva
Željko Kalac	1972 births, Living people, Australian footballers, Association football goalkeepers, Sportspeople from Sydney
Quincy Owusu-Abeyie	1986 births, Living people, Ghanaian footballers
Monroe Doctrine	1823, 1820s in the United States, James Monroe
Cynthia Wade	American cinematographers, American movie directors, American movie producers, Entertainers from New York City, Living people, Year of birth missing (living people)
Ángel de Saavedra, Duke of Rivas	1791 births, 1865 deaths, Dukes and duchesses, People from Córdoba, Andalusia, Playwrights, Spanish poets, Spanish politicians
Eastern religion	Religions, East Asian religions, Indian religions
Les Paul	1915 births, 2009 deaths, American guitarists, Deaths from pneumonia, Musicians from Wisconsin
WarGames	1983 thriller movies, 1983 science fiction movies, 1980s teen movies, American science fiction movies, American teen movies, American thriller movies, Cult movies, English-language movies, Movies directed by John Badham
Disquisitiones Arithmeticae	Mathematics books
IMSAI 8080	Computers
2009 Romanian bus-train collision	2009 in Europe, 21st century in Romania, Road transport, Transport disasters in Europe
Tropical Storm Claudette (2009)	2009 Atlantic hurricane season, Atlantic tropical storms, Hurricanes in the United States, August events, 2009 in Florida, 2000s in Georgia (U.S. state), 2000s in Alabama, 2000s in North Carolina
Suwannee River	Rivers of Florida
Virtua Fighter (arcade game)	Fighting games, Sega arcade games, Sega Saturn games, Windows games, 1993 video games, Sega 32X games, Sega video games, 1994 video games, 1995 video games
Florida State Road A1A	Roads in Florida
Emmett Till	1941 births, 1955 deaths, African-American people, American murder victims, Murders by firearm in the United States, People from Chicago, Murdered African-American people
Enjoy the Silence	1990 songs
Drew Bledsoe	1972 births, Living people, American football quarterbacks, Buffalo Bills players, Dallas Cowboys players, New England Patriots players, Sportspeople from Washington
Takeo Spikes	1976 births, Living people, American football linebackers, Buffalo Bills players, Cincinnati Bengals players, Philadelphia Eagles players, San Diego Chargers players, San Francisco 49ers players, Sportspeople from Georgia (U.S. state)
Silent Hill	Horror video games, Video game series
Penrith	Towns in Cumbria
Vijay Singh	1963 births, Living people, Golfers
Little Miss Sunshine	2006 comedy-drama movies, 2000s LGBT movies, 2000s road movies, Academy Award winning movies, American comedy-drama movies, American LGBT movies, American road movies, BAFTA Award winning movies, English-language movies, LGBT comedy-drama movies, Movies set in Arizona, Movies set in California, Movies set in New Mexico, Screen Actors Guild Award winners, American independent movies
Chris Crocker	Gay men, Internet celebrities, LGBT people from Tennessee, LGBT singers, Singers from Tennessee, 1987 births, Living people, American bloggers
Andrea Fortunato	1971 births, 1995 deaths, Italian footballers
Neil Mellor	1982 births, Living people, English footballers, People from South Yorkshire, Premier League players
Sebastian Deisler	1980 births, German footballers, Living people, Sportspeople from Baden-Württemberg, UEFA Euro 2000 players
Adriano Correia Claro	1984 births, Living people, Brazilian footballers, People from Curitiba, Coritiba Foot Ball Club players
Yoshinori Sembiki	1964 births, Living people, Footballers from Fukuoka Prefecture
Hiroshi Soejima	1959 births, Living people, Footballers from Saga Prefecture, Japan international footballers, Japanese football managers, Japan Soccer League players, Cerezo Osaka players, Kashima Antlers players
Lactic acid	Acids
Asylum seeker	International relations
Convention Relating to the Status of Refugees	1950s treaties, Human rights, History of the United Nations, Migration laws, 20th century in Geneva, 1951, 1967, 1960s treaties
List of Mexican flags	Lists of flags, Mexico-related lists, Flags of North America
Hurricane Iwa	Hurricanes in the United States, Retired tropical cyclone names, East Pacific hurricanes, 20th century in Hawaii, 1982 in the United States
Vinalhaven, Maine	Towns in Maine
Vassalboro, Maine	Towns in Maine
Jay, Maine	Towns in Maine, 1785 establishments in the United States, 18th-century establishments in Maine
Diablada	Ritual dances
Kazuhiro Koso	1959 births, Living people, Footballers from Saga Prefecture
Hideki Matsunaga	1963 births, Living people, Footballers from Shizuoka Prefecture
Al-Shabab Dubai	United Arab Emirati football clubs, Sport in Dubai
Qatar Stars League	Football leagues, Football in Qatar
Shinichi Morishita	1960 births, Living people, Footballers from Shizuoka Prefecture, Japan international footballers, J1 League players, Japan Soccer League players, Júbilo Iwata players, Kyoto Sanga FC players
Yasuyuki Kishino	1958 births, Living people, Footballers from Wakayama Prefecture
Hiroshi Matsuda	1960 births, Living people, Footballers from Nagasaki Prefecture
Joaquín Costa	1846 births, 1911 deaths, Spanish politicians
Mug shot	Photography, Law enforcement techniques
Antonio de Ulloa	Spanish writers, 1716 births, 1795 deaths
Derwent Valley Mills	Buildings and structures in England, World Heritage Sites in the United Kingdom, Derbyshire, 1721 establishments, 1720s establishments in Europe, 18th century establishments in England
Très Riches Heures du duc de Berry	French culture, Illuminated manuscripts
Human Development Index	Development
Shigekazu Nakamura	1958 births, Living people, Footballers from Nagasaki Prefecture
Grégory Coupet	1972 births, Living people, French footballers, Association football goalkeepers
Tatsuya Mochizuki	1963 births, Living people, Footballers from Shizuoka Prefecture
Caligula (movie)	1979 drama movies, American biographical movies, American drama movies, American epic movies, English-language movies, Historical movies, Italian movies, Movies set in Ancient Rome, American independent movies, Political movies
Anton Ferdinand	1985 births, Living people, English footballers, Sportspeople from London, Premier League players
Masataka Imai	1959 births, Living people, Footballers from Shizuoka Prefecture
Musashi Mizushima	1964 births, Living people, Footballers from Tokyo Prefecture
Raúl Bravo	1981 births, Living people, Spanish footballers
Tomoo Kudaka	1963 births, 1999 deaths, Footballers from Osaka Prefecture, People from Osaka
Al-Maref	Qatari football clubs
USL First Division	Football leagues, 2005 establishments in North America, 2010 disestablishments in North America
Jacques Santini	1952 births, Living people, French footballers, French football managers
Pablo Gabriel García	1977 births, Living people, Uruguayan footballers
Bradley Wright-Phillips	1985 births, Living people, Sportspeople from London, Black British sportspeople, English footballers, Premier League players
Iwao Yamane	1976 births, Living people, Footballers from Hiroshima Prefecture, People from Hiroshima, Zweigen Kanazawa players
Takumi Watanabe	1982 births, Living people, Footballers from Fukushima Prefecture
Makoto Kimura	1982 births, Living people, Footballers from Fukui Prefecture
Keisuke Hada	1978 births, Living people, Footballers from Ehime Prefecture
Kiyotaka Ishimaru	1973 births, Living people, Footballers from Osaka Prefecture, People from Osaka
Qatar S.C.	Qatari football clubs
California Jaguars	American soccer teams, 1995 establishments in California, 1999 disestablishments, 1990s disestablishments in California
Masakazu Koda	1969 births, Living people, Footballers from Ehime Prefecture
Ryosuke Okuno	1968 births, Living people, Footballers from Kyoto
Milwaukee Rampage	American soccer teams, Sports in Milwaukee, Wisconsin, 1994 establishments in the United States, 2002 disestablishments in the United States, 20th-century establishments in Wisconsin
Shigeharu Ueki	1954 births, Living people, Footballers from Kanagawa Prefecture, Japan international footballers, Japanese football managers, Japan Soccer League players, Shonan Bellmare players
Takamichi Seki	1981 births, Living people, Footballers from Chiba Prefecture
Rochester Rhinos	American soccer teams, Rochester, New York, 1996 establishments in New York (state)
Montreal Impact F.C.	American soccer teams, Canadian soccer teams, 1992 establishments in Canada, 2011 disestablishments in Canada
Charleston Battery	American soccer teams, Charleston, South Carolina, 1993 establishments in the United States
Minnesota Thunder	American soccer teams, 1990 establishments in the United States
Seattle Sounders (1994)	American soccer teams, 1994 establishments in Washington (state), 2008 disestablishments in the United States
Vancouver Whitecaps FC	2000s establishments in Canada, 2009 establishments, Canadian soccer teams, Major League Soccer teams, Sport in Vancouver
Koji Homma	1977 births, Living people, Footballers from Ibaraki Prefecture
Kosuke Suda	1980 births, Living people, Footballers from Ibaraki Prefecture
Yuji Tsukada	1957 births, Living people, Footballers from Yamanashi Prefecture
Enzo Francescoli	1961 births, Living people, Uruguayan footballers, Sportspeople from Montevideo
Yohei Nishibe	1980 births, Living people, Footballers from Hyōgo Prefecture
Naoya Umeda	1978 births, Living people, Footballers from Hiroshima Prefecture, People from Hiroshima
Women's voting rights in the United States	History of the United States, Women's suffrage
Minot, North Dakota	Cities in North Dakota, County seats in North Dakota
Ed Schafer	1947 births, Living people, Governors of North Dakota, United States Secretaries of Agriculture, US Republican Party politicians
Azua, Dominican Republic	Settlements in Dominican Republic, 1504 establishments in the Spanish Empire
Imogen Heap	1977 births, Living people, English singer-songwriters, Singers from London
John Stockton	1962 births, Living people, American basketball players, Utah Jazz players, Sportspeople from Washington, National Basketball Association players with retired numbers
Tropical Storm Ana (2009)	2009 Atlantic hurricane season, Atlantic tropical storms, August events, 2000s in Puerto Rico, 2000s in the Dominican Republic, 2000s in Haiti, 2000s in Cuba, 2000s in the Bahamas
Whelk	Gastropods
Luke Young	1979 births, Living people, English footballers, Sportspeople from Essex
Al-Sadd S.C.	Qatari football clubs
Ueslei	1972 births, Living people, Brazilian footballers, People from Salvador, Bahia
Taku Harada	1982 births, Living people, Footballers from Kumamoto Prefecture
Yusuke Igawa	1982 births, Living people, Footballers from Chiba Prefecture
Daisuke Tonoike	1975 births, Living people, Footballers from Kanagawa Prefecture
Kenji Hada	1981 births, Living people, Footballers from Hiroshima Prefecture, People from Hiroshima
Shōhei Ogura	1985 births, Living people, Footballers from Chiba Prefecture
Consecration	Sacraments, Roman Catholicism
Ginza Station	Railway stations in Tokyo
Ōtemachi Station (Tokyo)	Railway stations in Tokyo
Kokkai-gijidō-mae Station	Railway stations in Tokyo
Roppongi Station	Railway stations in Tokyo
Hurricane Stan	Category 1 Atlantic hurricanes, 2005 Atlantic hurricane season
Rachel Bilson	1981 births, Living people, American television actors, Actors from Los Angeles, California
Johnny Chan	Living people, 1957 births, Poker players, Guangzhou
Naf River	Rivers of Myanmar, Rivers of Bangladesh
Suppressor	Firearms, Sound
Night vision	Vision
Yoshio Kitajima	1975 births, Living people, Footballers from Ibaraki Prefecture
Paul Konchesky	1981 births, Living people, English footballers, Sportspeople from London, Premier League players
Al-Rayyan S.C.	Qatari football clubs
Shunta Nagai	1982 births, Living people, Footballers from Tokyo Prefecture
Tokyo Metro Ginza Line	Japanese railways, Tokyo, 20th century establishments in Japan
Tokyo Teleport Station	Railway stations in Tokyo
MissingNo.	Pokémon

