ImJayStation	1990 births, Living people
Music censorship	Music history, Controversies, Censorship
Doom (movie)	2005 movies, Doom series
A Night in Casablanca	1946 movies, 1940s comedy movies, American comedy movies, Movies directed by Archie Mayo
Movie rights	Movie terminology
Army Men (series)	Video game series
Rhino Season	2012 movies, Documentary movies, Iranian movies, Turkish movies, Iraqi movies, Movies directed by Bahman Ghobadi
Boana ericae	Frogs, Animals of South America
Helen Parr (The Incredibles)	Superheroes, Movie characters
Too Young to Love	1959 drama movies, British drama movies, Movies based on plays, Movies directed by Muriel Box
Dreams (2006 movie)	2006 drama movies, Iraqi movies, Movies directed by Mohamed Al-Daradji
Queensland Kanaka English	English-based pidgins, Queensland
The Undercover Man	1949 movies, 1940s crime movies, 1940s thriller movies, American crime thriller movies, Movies based on books, Movies directed by Joseph H. Lewis
Muyinga	Cities in Burundi
Shadows and Fog	1991 comedy movies, 1990s mystery movies, American comedy movies, American mystery movies, Movies based on plays, Movies directed by Woody Allen
Domino (2019 movie)	2019 movies, 2010s crime thriller movies, Danish movies, Belgian movies, Dutch movies, French crime movies, French thriller movies, Luxembourgian movies, British crime movies, British thriller movies, American crime thriller movies, Italian thriller movies, Movies directed by Brian De Palma
Veins of the World	2020 drama movies, Mongolian movies, German drama movies, Movies directed by Byambasuren Davaa
The Cave of the Yellow Dog	2005 drama movies, Mongolian movies, German drama movies, Movies directed by Byambasuren Davaa
College of Aeronautical Engineering, Guwahati	Colleges and universities in Asia
Athis-Mons	Communes in Essonne
Bezons	Communes in Val-d'Oise
Brunoy	Communes in Essonne
Bussy-Saint-Georges	Communes in Seine-et-Marne
2021–22 Premier League	2021 in association football, Premier League
Chatichai Choonhavan	1920 births, 1998 deaths, Thai military people, Prime Ministers of Thailand
Levone	Settlements in Piedmont
Pil Trafa	1959 births, 2021 deaths, Deaths from cardiopulmonary arrest, Argentine singers, Punk musicians, Rock singers, Composers, People from Buenos Aires
Rivara	Settlements in Piedmont
Henryk Hoser	1942 births, 2021 deaths, Roman Catholic bishops, Polish Roman Catholics, People from Warsaw
Dilys Watling	1943 births, 2021 deaths, English movie actors, English television actors, English stage actors, Actors from Buckinghamshire
Andrzej Borodzik	1930 births, 2021 deaths, Polish politicians, Polish military people, Polish scientists, Chemists
Sulejówek	Towns in Poland
Bitonto	Cities in Apulia
Sidhharrth S Kumaar	1990 births, Astrologers, People from Bihar
San Giuliano Milanese	Cities in Lombardy
Formigine	Cities in Emilia-Romagna
Chatou	Communes in Yvelines
Draveil	Communes in Essonne
Élancourt	Communes in Yvelines
Vimartin-sur-Orthe	21st century establishments in France, 2020s establishments in Europe, 2021 establishments, Communes in Mayenne
Saint-Aubin-des-Préaux	Communes in Manche
Saint-Aubin-de-Terregatte	Communes in Manche
Évenos	Communes in Var
La Farlède	Communes in Var
Rastatt	Towns in Baden-Württemberg
Boana atlantica	Frogs, Animals of South America
Michaux-Perreaux steam velocipede	Motorcycles
Mojgan Azimi	1985 births, Living people, Afghan people
Blue space	Lakes, Bodies of water, Rivers, Public health, Urban design
Qualcomm	American technology companies, Companies based in California, 1985 establishments in California
Upper class district	Real estate
Pater familias	Ancient Roman law
Twelve Tables	Ancient Roman law
The Truth About Women	1957 comedy movies, British comedy movies, Movies directed by Muriel Box
Hemp milk	Plant milks
Amateur astronomy	Astronomy
Lee Pace	Actors from Oklahoma, 1979 births, Living people, LGBT people from Oklahoma
Tugboats	Children's television series, ITV children's television shows
2021 Haiti earthquake	2021 disasters, 2021 in North America, 2020s disasters in North America, 21st century in Haiti, August 2021 events, Earthquakes in the 2020s, Earthquakes in Haiti
Arrecife	Cities in the Canary Islands, Municipalities in the Canary Islands
Gianfranco D'Angelo	1936 births, 2021 deaths, Italian movie actors, Italian stage actors, Italian voice actors, Italian television actors, Comedians, Actors from Rome
Francis Mossman	1988 births, 2021 deaths, New Zealand movie actors, New Zealand television actors, New Zealand stage actors, Naturalised citizens of Australia, Australian models, Australian movie actors, Australian television actors, Australian stage actors, Actors from Sydney, People from Auckland
Liam McIntyre	1982 births, Living people, Australian movie actors, Australian television actors, Australian stage actors, Australian voice actors, Actors from Adelaide
Piera Degli Esposti	1939 births, 2021 deaths, Deaths from respiratory failure, Italian movie actors, Italian voice actors, Italian television actors, Italian stage actors, People from Bologna
Fez Whatley	1964 births, 2021 deaths, Deaths from heart failure, American radio personalities, Comedians from Florida, LGBT people from Florida, LGBT comedians
Peter Whittle (mathematician)	1927 births, 2021 deaths, New Zealand scientists, New Zealand academics, Mathematicians, People from Wellington
Johnny Groth	1926 births, 2021 deaths, Detroit Tigers players, St. Louis Browns, Baltimore Orioles players, Chicago White Sox players, Texas Rangers players, Kansas City Athletics players, Sportspeople from Chicago
Spring Hill, Florida	Census-designated places in Florida
Jørgen Langhelle	1965 births, 2021 deaths, Deaths from cardiac arrest, Norwegian movie actors, Norwegian television actors, Norwegian stage actors, Norwegian voice actors, Actors from Oslo
Nesodden	Municipalities of Norway
Sandnes	Cities in Norway, Municipalities of Norway
Humaid bin Rashid Al Nuaimi III	1931 births, Living people, United Arab Emirates, Current national leaders
Rubén Darío Paredes	1933 births, Living people, People from Panama City, North American politicians, North American military people
Anatoly Malofeyev	1933 births, Living people, Belarusian politicians
House of Representatives (Belarus)	Politics of Belarus, National lower houses
Council of the Republic (Belarus)	Politics of Belarus, 1996 establishments in Europe, National upper houses
2 Sins	Musical groups established in 1993
Sandie Shaw	Singer-songwriters from London, Members of the Order of the British Empire, English singer-songwriters, English pop singers, 1947 births, Living people
Hutchins' tree frog	Frogs, Animals of South America
Deno (software)	Free software, Linux software, Microsoft Windows software, JavaScript
TypeScript	JavaScript, Programming languages
Biscuit (bread)	Breads
Lingua Franca Nova	Lingua Franca Nova
Ja-Ela	Settlements in Sri Lanka
Bus toilet	Bus transport, types of toilets
Wasco, California	Cities in California, Settlements in Kern County, California
Bear Valley Springs, California	Census-designated places in California, Settlements in Kern County, California
Gary Medel	1987 births, Chilean footballers
Blackland, Texas	Cities in Texas
Galena Park, Texas	Cities in Texas
Hilshire Village, Texas	Cities in Texas
Hunters Creek Village, Texas	Cities in Texas
Jacinto City, Texas	Cities in Texas
Jersey Village, Texas	Cities in Texas
La Porte, Texas	Cities in Texas
Nassau Bay, Texas	Cities in Texas
Piney Point Village, Texas	Cities in Texas
South Houston, Texas	Cities in Texas
Fall of Kabul (2021)	2021 in Asia, 2020s in Afghanistan, 21st century in Kabul, August 2021 events, Taliban
Southside Place, Texas	Cities in Texas
Spring Valley Village, Texas	Cities in Texas
Liberty Stadium	Stadiums in Europe
Adam Johnson	1987 births, Living people, Manchester City F.C. players, Premier League players, English footballers
2010 FIFA World Cup qualification (CONMEBOL)	Sport in South America
St. Kitts	Saint Kitts and Nevis
Simon Kjær	1989 births, Living people, Danish footballers, Association football defenders, 2010 FIFA World Cup players, UEFA Euro 2012 players, 2018 FIFA World Cup players
Choirul Huda	2017 deaths, Indonesian people
Persela Lamongan	Football clubs, Football in Indonesia
Kamil Grabara	1999 births, Polish footballers, Association football goalkeepers, Living people
Estadio Nacional de Lima	Football stadiums, Sport in Peru
Casemiro	1992 births, Living people, Brazilian footballers, Association football midfielders, 2018 FIFA World Cup players
Robin Koch	1996 births, Living people, German footballers, Association football defenders, Sportspeople from Rhineland-Palatinate, People from Kaiserslautern
Ambassador of the United Kingdom to the Netherlands	Ambassadors of the United Kingdom
2019 Piper PA-46 Malibu crash	Aviation disasters in the 2010s
Fatal insomnia	Diseases
Asphalt (1929 movie)	1929 movies, 1920s drama movies, German drama movies, German silent movies, Movies directed by Joe May
This Is My Country (movie)	1984 drama movies, Filipino movies, French drama movies, Movies directed by Lino Brocka
Fairytales Gone Wrong	Children's books, Children's literature, Children's picture books, English-language picture books, Fantasy books
Dickhead	English profanity
Sambuca di Sicilia	Settlements in Sicily
Hibatullah Akhundzada	1961 births, Living people, Taliban, Afghan military people, Heads of the Islamic Emirate of Afghanistan
20th Century Animation	American animation studios
Mathematical Applications Group	1966 establishments in the United States, American technology companies
Clyde Evans	1938 births, 2021 deaths, State legislators of the United States, Politicians from Ohio, US Republican Party politicians
Rio Grande, Ohio	Villages in Ohio
Benoît Genecand	1964 births, 2021 deaths, Cancer deaths in Switzerland, Swiss politicians
Miroslav Tetter	1938 births, 2021 deaths, Czech politicians, Czech academics
Georg Gallus	1927 births, 2021 deaths, Politicians from Baden-Württemberg
Karl-Heinz Funke	1946 births, Living people, Politicians from Lower Saxony
Jacques Fournier	1929 births, 2021 deaths, French politicians, French businesspeople
Algirdas Pocius	1930 births, 2021 deaths, Lithuanian politicians, Lithuanian writers
Mickey Stephens	1944 births, 2021 deaths, Politicians from Georgia (U.S. state), People from Savannah, Georgia, US Democratic Party politicians, State legislators of the United States
Giuseppe Montalbano	1925 births, 2021 deaths, Italian politicians, Mayors
Sciacca	Towns in Italy, Settlements in Sicily
Joe Walton	1935 births, 2021 deaths, American football coaches, Washington Redskins players, New York Giants players, American football defensive ends, Sportspeople from Pittsburgh, Pennsylvania
R. Murray Schafer	1933 births, 2021 deaths, Canadian composers, Canadian educators, Environmentalists, Canadian activists, Writers from Ontario, Canadian pianists, Musicians from Ontario, Deaths from Alzheimer's disease
The Warrens of Virginia (1924 movie)	1924 movies, 1920s drama movies, American silent movies, American war movies, American drama movies, 20th Century Fox movies, Movies based on plays, Movies directed by Elmer Clifton
Carmen Morales	1939 births, 2021 deaths, Deaths from Alzheimer's disease, Argentine movie actors, Argentine television actors, Argentine stage actors, Argentine comedians, Actors from Buenos Aires
Hipólito Reyes Larios	1946 births, 2021 deaths, Roman Catholic bishops, Roman Catholic priests, Roman Catholic archbishops, People from Veracruz, Deaths from gastrointestinal hemorrhage
Mutale Nalumango	1955 births, Living people, Vice-Presidents of Zambia
Movement for Multi-Party Democracy	Zambia
2021 Zambian general election	August 2021 events
National Assembly of Zambia	Zambia
Forum for Democracy and Development	Zambia
Speaker of the National Assembly of Zambia	Speakers of the National Assembly (Zambia)
Patrick Matibini	1959 births, Living people, Speakers of the National Assembly (Zambia), Judges
Amusaa Mwanamwambwa	1940 births, Living people, Speakers of the National Assembly (Zambia)
Fine-lined tree frog	Frogs, Animals of South America
Chomikuj.pl	Companies of Europe
Abdelhamid Brahimi	1936 births, 2021 deaths, Prime Ministers of Algeria
Aymen Benabderrahmane	1966 births, Living people, Prime Ministers of Algeria
List of heads of state of Algeria	Presidents of Algeria
Houari Boumédiène	1932 births, 1978 deaths, Presidents of Algeria
Ali Kafi	1928 births, 2013 deaths, Presidents of Algeria
Mohamed Boudiaf	1919 births, 1992 deaths, Presidents of Algeria, Assassinated people
Rabah Bitat	1925 births, 2000 deaths, Presidents of Algeria
Chadli Bendjedid	1929 births, 2012 deaths, Presidents of Algeria, Cancer deaths in France
Ferhat Abbas	1899 births, 1985 deaths, Prime Ministers of Algeria, Presidents of Algeria
Abderrahmane Farès	1911 births, 1991 deaths, Presidents of Algeria
Benyoucef Benkhedda	1920 births, 2003 deaths, Presidents of Algeria
List of heads of government of Algeria	Prime Ministers of Algeria
Mohamed Ben Ahmed Abdelghani	1927 births, 1996 deaths, Prime Ministers of Algeria
Kasdi Merbah	1938 births, 1993 deaths, Assassinated people, Prime Ministers of Algeria
Mouloud Hamrouche	1943 births, Living people, Prime Ministers of Algeria
Sid Ahmed Ghozali	1937 births, Living people, Ambassadors, Prime Ministers of Algeria
Sabri Boukadoum	1958 births, Living people, Prime Ministers of Algeria
Abdelaziz Belkhadem	1945 births, Living people, Prime Ministers of Algeria
Mokdad Sifi	1940 births, Living people, Prime Ministers of Algeria
Ahmed Benbitour	1946 births, Living people, Prime Ministers of Algeria
Ali Benflis	1944 births, Living people, Prime Ministers of Algeria
Annamie Paul	1972 births, Living people, Politicians from Toronto, Canadian lawyers
Abdulla Shahid	1962 births, Living people, Maldivian people, Asian politicians, Presidents of the United Nations General Assembly
UK Holocaust Memorial	Buildings and structures in London, Monuments and memorials in England
Cabinet of Afghanistan	Politics of Afghanistan
Katie Findlay	1990 births, Living people, Canadian movie actors, Canadian television actors, Canadian voice actors, Actors from Ontario
Vác	Cities in Hungary
Volodymyr Holubnychy	1936 births, 2021 deaths, Ukrainian sportspeople, Soviet sportspeople, Soviet Olympic gold medalists, Soviet Olympic silver medalists, Olympic bronze medalists
Paul Mitchell (politician)	1956 births, 2021 deaths, Deaths from kidney cancer, United States representatives from Michigan, Businesspeople from Boston, Massachusetts, Businesspeople from Michigan, Politicians from Boston, Massachusetts, Independent politicians in the United States, US Republican Party politicians, Cancer deaths in Michigan
Dryden Township, Michigan	Townships in Michigan
Dryden, Michigan	Villages in Michigan
Thomas Township, Michigan	Townships in Michigan
Dimple Kapadia	1957 births, Living people, Indian movie actors, Indian television actors, Indian stage actors, People from Bombay
Twinkle Khanna	1973 births, Living people, Indian movie actors, Indian television actors, Indian movie producers, Indian journalists, Indian novelists, People from Bombay, Columnists
Zarifa Ghafari	Living people, 1992 births, Business people, Afghan activists, Mayors, Feminists, Women who received the International Women of Courage Award
Engjell Berisha	1998 births, Living people
Free Guy	2021 movies, 2020s action movies, 2020s comedy movies, 2020s science fiction movies, American action comedy movies, American science fiction movies, Movies directed by Shawn Levy
Christophe Beck	1972 births, Living people, Canadian composers, Canadian pianists, Canadian drummers, Saxophonists, Conductors, Musicians from Montreal, Emmy Award winners
Emma Corrin	1995 births, Living people, English movie actors, English television actors, English stage actors, English LGBT people, LGBT actors, Actors from Kent, Queer people
Trainwreck (movie)	2015 romance movies, 2015 comedy movies, 2010s romantic comedy movies, Universal Pictures movies, American romantic comedy movies, Movies directed by Judd Apatow
Fantastic Beasts and Where to Find Them (movie)	British fantasy movies, American fantasy movies, Warner Bros. movies, Movies directed by David Yates, Harry Potter movies, Movies composed by James Newton Howard
Untitled third Fantastic Beasts movie	Warner Bros. movies, British fantasy movies, American fantasy movies, Movies directed by David Yates, Movies composed by James Newton Howard, Harry Potter movies
Carmen Ejogo	1973 births, Living people, English movie actors, English television actors, English voice actors, English stage actors, Actors from London, Singers from London, People from Kensington and Chelsea (London borough)
Steven Weber	1961 births, Living people, American movie actors, American television actors, American stage actors, American voice actors, Actors from New York City, Comedians from New York City
Alison Sudol	1984 births, Living people, American pianists, American guitarists, Singer-songwriters from California, Musicians from Seattle, Washington, Musicians from Los Angeles, California, Singers from Los Angeles, California, Writers from Los Angeles, California, Writers from Seattle, Washington, Singers from Seattle, Washington, Actors from Los Angeles, California, Actors from Seattle, Washington, American movie actors, American television actors, American voice actors
McCandless, Pennsylvania	Townships in Pennsylvania
Bokundara	Settlements in Sri Lanka
Frosolone	Settlements in Molise
Keep America Beautiful	1953 establishments in the United States, Recycling, Environment, Organizations based in the United States
Charles Boyer	1899 births, 1978 deaths, Naturalized citizens of the United States, American actors
Southwest Louisiana	Regions of Louisiana
New Orleans metropolitan area	New Orleans, Louisiana, Metropolitan areas of the United States
Charles Garrett (diplomat)	Ambassadors of the United Kingdom, 1963 births, Living people
Hemp oil	Cooking oils
Men I Trust	Pop rock bands, Musicians from Montreal, Musical groups established in the 2010s, Indie bands, Electronic music bands, Canadian rock bands, 2010s establishments in Canada, 2010s Canadian music groups, 2014 establishments
Adam Cole	American wrestlers, Living people
The Patrick Star Show	Nickelodeon television series, American children's television series, 2020s American comedy television series, Animated television series, English-language television programs, Mockumentaries, SpongeBob SquarePants
Kannada script	Languages of India
Orange Julius	Companies based in Los Angeles, American fast food restaurants, 1926 establishments in the United States, 1920s establishments in California
Rabin, the Last Day	2015 movies, 2010s thriller movies, Israeli movies, French thriller movies, Movies directed by Amos Gitai
Ceddo	1977 drama movies, Senegalese movies, French drama movies, Movies directed by Ousmane Sembène
La notte	1961 drama movies, Italian drama movies, French drama movies, Movies directed by Michelangelo Antonioni
My Younger Brother	1962 drama movies, Russian movies, Latvian movies, Movies directed by Aleksandr Zarkhi
Sony Imagine	Television channels
Anderson Mazoka	1943 births, 2006 deaths, Deaths from renal failure, Zambian politicians
Heléne Björklund	Living people, 1972 births, Swedish politicians
Werner Enterprises	American transport companies
Striped tree frog	Frogs, Animals of South America
Ari Fleischer	White House Press Secretaries, 1960 births, People from New York City
Gasket	Hardware (mechanical)
Treatment of women by the Taliban	Taliban
BBC v HarperCollins Publishers Ltd	2010 in television, 2010 in the United Kingdom, BBC
Allosexuality	Human sexuality
Virgin cleansing myth	Child sexual abuse, Rape
Jaguar XJ	1960s automobiles, Full-size vehicles, Sedans, 1970s automobiles, 1980s automobiles, 1990s automobiles, 2000s automobiles, 2010s automobiles
Hamid Karzai International Airport	Airports in Asia, Kabul
National Assembly (Afghanistan)	Politics of Afghanistan
Amrullah Saleh	Living people, 1972 births, Presidents of Afghanistan, Vice Presidents of Afghanistan, Current national leaders
Microsoft Teams	Microsoft Windows software, Messaging
C.D. Huachipato	Chilean football clubs
Fereshteh Taerpour	1953 births, 2021 deaths, Iranian movie producers, Iranian writers, People from Tehran, Deaths from the COVID-19 pandemic in Iran
Paulão (footballer, born 1969)	1969 births, 2021 deaths, Angolan people, African footballers
Basil Mramba	1940 births, 2021 deaths, Deaths from the COVID-19 pandemic, Tanzanian people, African politicians
Nikolai Kuimov	1957 births, 2021 deaths, Russian military people, Aviators, Aviation deaths
William R. Haine	1944 births, 2021 deaths, State legislators of the United States, Politicians from Illinois, US Democratic Party politicians, People from Alton, Illinois
Hormoz Farhat	1928 births, 2021 deaths, Iranian musicians, American academics, American composers, Naturalized citizens of the United States, People from Tehran
Rafael Romero	1938 births, 2021 deaths, Competitors in athletics, Olympians, Venezuelan sportspeople
Dick Schafrath	1937 births, 2021 deaths, American football offensive tackles, Cleveland Browns players, State legislators of the United States, Politicians from Ohio, US Republican Party politicians
Wooster, Ohio	Cities in Ohio, County seats in Ohio
Vladimir Mendelssohn	1949 births, 2021 deaths, Romanian composers, Violinists, Academics, People from Bucharest
Charlie Johnson (defensive tackle)	1952 births, 2021 deaths, American football defensive tackles, Philadelphia Eagles players, Minnesota Vikings players, Sportspeople from Texas
West Columbia, Texas	Cities in Texas
Rich Milot	1957 births, 2021 deaths, Washington Redskins players, American football linebackers, Sportspeople from Pennsylvania
Karl-Friedrich Haas	1931 births, 2021 deaths, German Olympic bronze medalists, German Olympic silver medalists, Sportspeople from Berlin, Competitors in athletics
Alfonso Sepúlveda	1939 births, 2021 deaths, Chilean footballers, People from Santiago, Deaths from heart failure
Pyotr Pimashkov	1948 births, 2021 deaths, Russian politicians, Mayors, Deaths from cardiac arrest
Claudio Ventura	1953 births, 2021 deaths, Italian artists, Editors
Maki Kaji	1951 births, 2021 deaths, Deaths from cholangiocarcinoma, Japanese businesspeople
Victoria Paris	1960 births, 2021 deaths, Deaths from breast cancer, American pornographic actors, American models, Actors from Montana, People from Great Falls, Montana
The Longest Day (movie)	1962 movies, 1960s war movies, 20th Century Fox movies, American epic movies, American war movies, Movies based on books, Movies directed by Ken Annakin, Movies directed by Andrew Marton, Movies directed by Bernhard Wicki
Kenneth More	1914 births, 1982 deaths, Deaths from multiple system atrophy, English movie actors, English television actors, English stage actors, Actors from Buckinghamshire, BAFTA Award winning actors
Gert Fröbe	1913 births, 1988 deaths, Deaths from myocardial infarction, German movie actors, German television actors, German stage actors, People from Saxony
Irina Demick	1936 births, 2004 deaths, French movie actors, French television actors, French stage actors
Pommeuse	Communes in Seine-et-Marne
Richard Todd	1919 births, 2009 deaths, Irish movie actors, Irish television actors, Irish stage actors, British movie actors, British stage actors, British television actors, Actors from Dublin, Golden Globe Award winning actors
Curd Jürgens	1915 births, 1982 deaths, Deaths from myocardial infarction, German movie actors, German television actors, German stage actors, Austrian movie actors, Austrian television actors, Austrian stage actors, Actors from Vienna
Cornelius Ryan	1920 births, 1974 deaths, Deaths from prostate cancer, Irish novelists, American novelists, Journalists from New York City, Writers from Dublin, American historians
Maurice Jarre	1924 births, 2009 deaths, Cancer deaths in Los Angeles, French composers, French conductors, People from Lyon, Academy Award winning composers, Golden Globe Award winning composers, BAFTA Award winners, Grammy Award winners
Ken Annakin	1914 births, 2009 deaths, Movie directors from London, People from Yorkshire
Andrew Marton	1904 births, 1992 deaths, American movie directors, Hungarian movie directors, People from Budapest, Naturalized citizens of the United States
Bernhard Wicki	1919 births, 2000 deaths, Austrian movie directors, Austrian movie actors, Austrian television actors, Austrian stage actors
Jeffrey Hunter	1926 births, 1969 deaths, Deaths from intracranial hemorrhage, American movie actors, American television actors, American stage actors, Actors from New Orleans, Louisiana
Tom Tryon	1926 births, 1991 deaths, Deaths from stomach cancer, American novelists, American movie actors, American television actors, American stage actors, American voice actors, Actors from Hartford, Connecticut, Writers from Hartford, Connecticut
Leo Genn	1905 births, 1978 deaths, British lawyers, British movie actors, British television actors, British stage actors, Actors from London, Deaths from myocardial infarction, Deaths from pneumonia
Salò, or the 120 Days of Sodom	World War II movies, Rape in movies, Political movies, Obscenity controversies, Nudity, Movies based on books, Movies about prostitution, Movies about pedophilia, LGBT drama movies, Italian-language movies, Italian drama movies, Incest in movies, French-language movies, French drama movies, Cross-dressing in movies, 1975 horror movies, 1975 drama movies, 1970s war movies, Movies about child sexual abuse
2004 Chūetsu earthquake	2004, Earthquakes in Japan, Earthquakes in the 2000s
Ágnes Hankiss	1950 births, 2021 deaths, Former MEPs, Politicians from Budapest
Typhoon Durian	Natural disasters in Asia, 2006 in weather
Anwar Hossain (industrialist)	1938 births, 2021 deaths, Bangladeshi politicians, Bangladeshi Muslims, Bangladeshi businesspeople, People from Dhaka
Kazenambo Kazenambo	1963 births, 2021 deaths, Deaths from the COVID-19 pandemic, Botswana politicians, Namibian politicians
Maun	Cities in Botswana
Rodrigo Paz	1933 births, 2021 deaths, Deaths from gastrointestinal hemorrhage, Mayors of Quito, Ecuadorian businesspeople
Embassy (movie)	1972 thriller movies, 1970s spy movies, British thriller movies, British action movies, Movies based on books, Movies directed by Gordon Hessler
Jorge Yunda	1965 births, Living people, Mayors of Quito, Physicians, Radio personalities
Tulcán	Cities in Ecuador
Loja, Ecuador	Cities in Ecuador
Sean Lock	1963 births, 2021 deaths, Actors from Surrey, British stand-up comedians, Cancer deaths in England, Deaths from lung cancer, English comedians, English television actors, English television personalities
Go West, Young Lady	1941 movies, 1940s western movies, 1940s comedy movies, American western movies, American comedy movies, Movies directed by Frank R. Strayer
Austin Mitchell	1934 births, 2021 deaths, UK MPs 1974–1979, UK MPs 1979–1983, UK MPs 1983–1987, UK MPs 1987–1992, UK MPs 1992–1997, UK MPs 1997–2001, UK MPs 2001–2005, UK MPs 2005–2010, UK MPs 2010–2015, Former Labour MPs (UK), Politicians from Yorkshire, British journalists, Writers from Yorkshire
Evgeny Sveshnikov	1950 births, 2021 deaths, Russian chess players, Russian writers, Deaths from the COVID-19 pandemic in Russia
So Ends Our Night	1941 movies, 1940s war movies, 1940s drama movies, American war movies, American drama movies, Movies based on books, Movies directed by John Cromwell
Jan David Simon, 3rd Viscount Simon	1940 births, 2021 deaths, Labour Party (UK) people, Members of the House of Lords
Rock Demers	1933 births, 2021 deaths, Deaths from heart failure, Canadian movie producers, People from Montreal
Betsy Russell	1963 births, Living people, American movie actors, American television actors, American voice actors, American stage actors, American video game actors, Actors from San Diego, California, Movie producers from California, Actors from Santa Monica, California
Van Morrison	1945 births, Living people, British singer-songwriters, British rock singers, British R&B musicians, British folk musicians, British soul musicians, British jazz musicians, British rock guitarists, British saxophonists, British rock drummers, People from Belfast, British activists, Grammy Award winners
Grief	Emotions
Siege of Sarajevo	1992 in Europe
Republic of Bosnia and Herzegovina	Bosnia and Herzegovina
Human bonding	Emotions
Affection	Emotions
Acceptance	Emotions
Amusement	Emotions
Annoyance	Emotions
Irritability	Emotions
Distraction	Human behavior
Attention	Human behavior
Anticipation	Emotions
Awe	Emotions
Wonder (emotion)	Emotions
Confidence	Emotions
Contentment	Emotions
Cruelty	Emotions
Desire	Emotions
Distrust	Emotions
Enthusiasm	Emotions
Sorrow (emotion)	Emotions
Social connection	Emotions
Shyness	Emotions
Acute stress disorder	Emotions
Saudade	Emotions
Resentment	Emotions
Remorse	Emotions
Apology (act)	Human behavior
Wrongdoing	Human behavior
Boana gladiator	Frogs, Animals of South America
Social rejection	Emotions
Social relation	Human behavior
Regret	Emotions
Gratification	Emotions
Gratitude	Emotions
Please	Human behavior
Politeness	Human behavior
Rudeness	Human behavior
Respect	Human behavior
Outrage (emotion)	Emotions
Injustice	Human behavior
Status quo	Latin phrases
Kindness	Emotions
Interest (emotion)	Emotions
Humiliation	Emotions
Hostility	Emotions
International Islamic University Malaysia	Colleges and universities in Asia, Malaysia
Cranberry juice	Fruit juices
Aker Solutions	Companies of Norway, 2008 establishments in Europe
1943 Ashford by-election	1943 in Europe, Kent, Elections in the United Kingdom
Salmon burger	Seafood dishes, Sandwiches
Guilded	Software, Websites
Pacific swift	Birds, Animals of Asia, Animals of Oceania
The Cassandra Crossing	1976 drama movies, Disaster movies, Italian drama movies, British drama movies, German drama movies, Italian thriller movies, British thriller movies, German thriller movies, English-language movies, Movies set in Europe, Movies composed by Jerry Goldsmith, Movies about terrorism, Movies about diseases
Mechanical seal	Hardware (mechanical)
Bob Boyle	American animators, American television directors, American television producers, 1971 births, The Powerpuff Girls, Cartoon Network, American television writers, Living people
Verbosity	Grammar, Writing, Rhetoric
Abhay Kumar	1980 births, Living people, Indian poets
Pablo P. Garcia	1925 births, 2021 deaths, Filipino politicians
Olav Akselsen	1965 births, 2021 deaths, Norwegian politicians
Stord	Municipalities of Norway
Simão Sessim	1935 births, 2021 deaths, Brazilian politicians, Brazilian lawyers, People from Rio de Janeiro, Deaths from the COVID-19 pandemic in Brazil
Nilópolis	Cities in Rio de Janeiro (state)
Nilo Peçanha	1867 births, 1924 deaths, Vice Presidents of Brazil, Presidents of Brazil
Afonso Pena	1847 births, 1909 deaths, Deaths from pneumonia, Vice Presidents of Brazil, Presidents of Brazil
Brian P. Burns	1936 births, 2021 deaths, American lawyers, American philanthropists, Businesspeople from Boston, Massachusetts, Businesspeople from San Francisco, Politicians from San Francisco, Politicians from Boston, Massachusetts, US Republican Party politicians
Ham Enterprises	2000s establishments in Africa, Real estate
Texas (1941 movie)	1941 movies, 1940s western movies, American western movies, Movies directed by George Marshall
Töregene Khatun	Mongol Empire, Kings and queens
MacOS Monterey	MacOS
Flight dynamics	Physics
Lema tree frog	Frogs, Animals of South America
Welsh exonyms	Languages of Europe
Marco the Magnificent	1965 movies, 1960s adventure movies, French movies, Italian movies, Egyptian movies, Afghan movies, Serbian movies, Movies directed by Denys de la Patellière
Ann Zhang	Women, 1957 births, Chinese people, Australian people
List of countries in 1940	1940
List of countries in 1941	1941
List of countries in 1942	1942
List of countries in 1943	1943
2014 Newark by-election	2014 elections, 2014 in England, Nottinghamshire, Elections in the United Kingdom
List of countries in 1944	1944
Junaid Babunagari	1953 births, 2021 deaths, Bangladeshi educators, Bangladeshi writers, Researchers, Islamic religious leaders, Deaths from stroke, Deaths from diabetes
Ludwig Ahgren	1995 births, Living people, American YouTubers, American sports commentators, People from New Hampshire, Twitch (service) streamers
List of countries in 1945	1945
List of countries in 1946	1946
List of countries in 1947	1947
List of countries in 1948	1948
List of countries in 1949	1949
Kimitsu	Cities in Chiba Prefecture
Shinjirō Ehara	Living people, 1936 births, Japanese movie actors, Japanese television actors, Japanese stage actors, People from Kyoto Prefecture
List of countries in 1930	1930
List of countries in 1931	1931
List of countries in 1932	1932
List of countries in 1933	1933
List of countries in 1934	1934
List of countries in 1935	1935
List of countries in 1936	1936
List of countries in 1937	1937
List of countries in 1939	1939
List of countries in 1938	1938
Pam Dawber	1951 births, American movie actors, American television actors, American stage actors, American voice actors, Singers from Detroit, Michigan, Actors from Detroit, Michigan
Lubyanka Building	Buildings and structures in Moscow
Walloon Lake, Michigan	Unincorporated communities in Michigan, Census-designated places in Michigan
Charlevoix, Michigan	County seats in Michigan, Cities in Michigan
Munising, Michigan	Cities in Michigan, County seats in Michigan
West Caldwell, New Jersey	Townships in New Jersey
Bellaire, Michigan	Villages in Michigan, County seats in Michigan
Monosexism	Discrimination
Panphobia	Discrimination
Monkfruit	Cucurbitaceae, Fruits
Ethan Cutkosky	1999 births, American television actors, Living people
Susan Wojcicki	YouTube, People from Palo Alto, California, Businesspeople from California, American Jews, 1968 births, Living people
Cissexism	Discrimination
The Doctor and the Girl	1949 movies, 1940s drama movies, American drama movies, Movies based on books, Movies directed by Curtis Bernhardt
Microsoft family features	Microsoft
Abhishek Nigam	1997 births, Living people, Indian actors
Women School of Entrepreneurship	Non-profit organizations, Organizations established in 2020, Non-profit organisations based in India, Non-profit organisations based in Bihar
A Time for Drunken Horses	2000 movies, Iranian movies, Movies directed by Bahman Ghobadi
Alice Cornelia Thaw	1880 births, 1955 deaths, American philanthropists, People from Pittsburgh, Pennsylvania
Oceanside, New York	Census-designated places in New York (state), Hamlets in New York
Monroe, Washington	Cities in Washington (U.S. state)
Li Hsing	1930 births, 2021 deaths, Deaths from heart failure, Movie directors, People from Shanghai, Taiwanese people
International Baseball Federation	Baseball
Solly Drake	1930 births, 2021 deaths, Chicago Cubs players, Los Angeles Dodgers players, Philadelphia Phillies players, Sportspeople from Arkansas, People from Little Rock, Arkansas
Sammy Drake	1934 births, 2010 deaths, Chicago Cubs players, New York Mets players, Sportspeople from Arkansas, People from Little Rock, Arkansas, Cancer deaths in Los Angeles
Marek Minda	1950 births, 2021 deaths, Polish politicians, Polish physicians
Łomża	Cities in Poland
Aimé Halbeher	1936 births, 2021 deaths, Political activists, Communists, Politicians from Paris
Raoul Cauvin	1938 births, 2021 deaths, Belgian writers, Comics writers, Deaths from stomach cancer
Innerspace	1987 comedy movies, 1980s science fiction movies, American science fiction movies, American comedy movies, Portuguese movies, Warner Bros. movies, Movies directed by Joe Dante
Ismail Sabri Yaakob	1960 births, Living people, Prime Ministers of Malaysia, Deputy Prime Ministers of Malaysia, Current national leaders
Deputy Prime Minister of Malaysia	Deputy Prime Ministers of Malaysia
Ahmad Zahid Hamidi	1953 births, Living people, Deputy Prime Ministers of Malaysia
Ismail Abdul Rahman	1915 births, 1973 deaths, Deaths from myocardial infarction, Deputy Prime Ministers of Malaysia
Abdul Ghafar Baba	1925 births, 2006 deaths, Deaths from heart failure, Deaths from respiratory failure, Deputy Prime Ministers of Malaysia
Ardhanarishvara	Hindu gods and goddesses
Smallskin tree frog	Frogs, Animals of South America
The Rose Tattoo	1955 comedy movies, 1955 drama movies, American comedy-drama movies, Movies based on plays, Movies directed by Daniel Mann
List of countries in 1920	1920
List of countries in 1921	1921
List of countries in 1922	1922
List of countries in 1923	1923
List of countries in 1924	1924
Stein Erik Hagen	Living people, Norwegian businesspeople
List of countries in 1925	1925
List of countries in 1926	1926
List of countries in 1927	1927
List of countries in 1929	1929
List of countries in 1928	1928
Saint-Jean-Baptiste Day	Quebec, National Days
List of conglomerates in Uganda	Conglomerate companies, Uganda
Conglomerate (company)	Conglomerate companies
Barruelo de Santullán	Municipalities in Castile and León
Alejandro Lamalfa	1947 births, 2021 deaths, Spanish politicians, Spanish physicians
Camargo, Cantabria	Municipalities in Cantabria
Santoña	Towns in Spain, Municipalities in Cantabria
Paolo Saviane	1962 births, 2021 deaths, Deaths from surgical complications, Italian politicians, People from Veneto, Italian businesspeople
Ponte nelle Alpi	Settlements in Veneto
Gaia Servadio	1938 births, 2021 deaths, Italian writers, Writers from London
Brent Yonts	1949 births, 2021 deaths, State legislators of the United States, Politicians from Kentucky, US Democratic Party politicians, Deaths from the COVID-19 pandemic in the United States
Bone Tomahawk	2015 movies, American horror movies, American western movies, English-language movies, Movies set in the United States, Movies set in deserts, Movies set in the 1890s, Cannibalism
Jill Murphy	1949 births, 2021 deaths, British children's writers, British illustrators, Writers from London, Deaths from cancer
Sweet Anita	1990 births, Living people, English entertainers, British YouTubers, Twitch (service) streamers
Overwatch (video game)	2019 video games, Shooter video games
Friend Like Me	1992 songs
Let It Go	2013 songs, Grammy Award winning songs, Academy Award winners
Be Our Guest	1991 songs
Friends on the Other Side	2009 songs
Hafu (gamer)	1991 births, Living people, American YouTubers, Entertainers from Massachusetts, Twitch (service) streamers
Dream (YouTuber)	1991 births, Living people, American YouTubers, Twitch (service) streamers
Forsen	Living people, 1990 births, Twitch (service) streamers
David Dobrik	1996 births, Living people, American YouTubers, Podcasters, Twitch (service) streamers, Entertainers from Los Angeles, California
LilyPichu	1991 births, Living people, American YouTubers, Twitch (service) streamers, Musicians from New Jersey, American voice actors, Actors from New Jersey
Michael Reeves (Internet personality)	1997 births, Living people, American YouTubers, Twitch (service) streamers, Entertainers from Hawaii
Cr1TiKaL	1994 births, Living people, Musicians from Tampa, Florida, American YouTubers, Twitch (service) streamers
XChocoBars	1994 births, Living people, Twitch (service) streamers, Entertainers from Toronto
Scarra	1989 births, Living people, American YouTubers, Twitch (service) streamers, Entertainers from Texas
CouRageJD	1994 births, Living people, American YouTubers, Twitch (service) streamers, Entertainers from New Jersey, Businesspeople from New Jersey
Bretman Rock	1998 births, Living people, American YouTubers, American TikTokers, Twitch (service) streamers, LGBT models, LGBT entertainers, Entertainers from Hawaii, People from Honolulu, American television personalities
Rytro	Villages in Poland
Saint-Aubin-du-Cormier	Communes in Ille-et-Vilaine
The Iron Superman	Taiwanese movies, Monster movies, 1975 movies, Robot movies
Michel Le Flochmoan	1951 births, 2021 deaths, Cancer deaths in France, French football managers, French footballers
Blagny	Communes in Ardennes
Fayence	Communes in Var
2001–02 Arsenal F.C. season	2000s in England, 2001 in the United Kingdom, Arsenal F.C., Football seasons
Languages of New Zealand	Languages by country
10 (movie)	1979 comedy movies, 1970s romance movies, American romantic comedy movies, Warner Bros. movies, Movies directed by Blake Edwards
Hurricane Grace	Hurricanes in the Dominican Republic, Hurricanes in Mexico, Hurricanes in Jamaica, Hurricanes in Haiti, Category 3 Atlantic hurricanes, August 2021 events, 2021 disasters
Mary Sibbet Copley	1843 births, 1929 deaths, American philanthropists
Puromycin	Antibiotics
State of Sindh	Sindh, History, Islam
Self-ownership	Liberalism, Anarchism
Boana diabolica	Frogs, Animals of South America
Southern brown kiwi	Birds of New Zealand, Flightless birds
Phyllomedusa	Animals of South America, Frogs
Tom Tugendhat	1973 births, Living people, British Army officers, British military people, Conservative MPs (UK), UK MPs 2019–, UK MPs 2015–2017, UK MPs 2017–2019, Members of the Order of the British Empire
Coltan	Minerals, Republic of the Congo
Damon Atabay	Living people, Models, Competitors in athletics
Speaking Moistly	2020 songs, COVID-19 pandemic, Internet culture
Bitz & Bob	English-language television programs
Hurricane Henri (2021)	Natural disasters in the United States, Hurricanes in New York, Hurricanes in New England, August 2021 events, 2021 in the United States, 21st century in New York
Bukayo Saka	2001 births, Living people, English footballers, Watford F.C. players, Arsenal F.C. players, Premier League players
The Song of Names	2019 drama movies, 2010s mystery movies, Canadian drama movies, German drama movies, Hungarian movies, British drama movies, British mystery movies, Movies based on books, Movies directed by François Girard
Brooklyn Center, Minnesota	Cities in Minnesota
Corcoran, Minnesota	Cities in Minnesota
Crystal, Minnesota	Cities in Minnesota
Edina, Minnesota	Cities in Minnesota
Excelsior, Minnesota	Cities in Minnesota
Golden Valley, Minnesota	Cities in Minnesota
Greenwood, Minnesota	Cities in Minnesota
Independence, Minnesota	Cities in Minnesota
Long Lake, Minnesota	Cities in Minnesota
Loretto, Minnesota	Cities in Minnesota
Maple Grove, Minnesota	Cities in Minnesota
Maple Plain, Minnesota	Cities in Minnesota
Medicine Lake, Minnesota	Cities in Minnesota
Medina, Minnesota	Cities in Minnesota
Newton, Mississippi	Cities in Mississippi
The Unlimited Dream Company	1979 books
Linda Riley	British LGBT people, Activists, LGBT feminists, Publishers, People with non-binary gender identities
Branimals	2009 movies, 2009 animated movies, 2000s adventure movies, Brazilian movies, Movies about animals
Impact Pictures	Companies of Canada, Movie studios
Death Race (2008 movie)	2008 movies, American movies, Prequel movies, German movies
Marie, Princess of Liechtenstein	1940 births, 2021 deaths, Deaths from stroke, Princes and princesses, Liechtenstein people
Johann II, Prince of Liechtenstein	1840 births, 1929 deaths, Princes of Liechtenstein
Daniel Risch	1978 births, Prime Ministers of Liechtenstein, Living people
Middlemost Post	2021 American television series debuts, 2020s American animated television series, 2020s American children's comedy television series, 2020s Nickelodeon original programming, English-language television programs, 2020s American animated comedy television series, American children's animated comedy television series, Nicktoons
Kostas Triantafyllopoulos	1956 births, 2021 deaths, Greek actors
Guy Sansaricq	1934 births, 2021 deaths, Haitian people, American Roman Catholics, Roman Catholic bishops, Naturalized citizens of the United States
Nicoletta Orsomando	1929 births, 2021 deaths, Italian radio personalities, Italian television personalities
Casapulla	Settlements in Campania
Thad McClammy	1942 births, 2021 deaths, State legislators of the United States, Politicians from Alabama, US Democratic Party politicians
Karolina Kaczorowska	1930 births, 2021 deaths, First Ladies, Polish academics
Frances Shand Kydd	Scottish people, English people, Deaths from Parkinson's disease, Deaths from brain cancer, Cancer deaths in Scotland, 1936 births, 2004 deaths
Rudolf Edlinger	1940 births, 2021 deaths, People from Vienna, Austrian politicians, Austrian businesspeople
Paul Muegge	1936 births, 2021 deaths, State legislators of the United States, Politicians from Oklahoma, US Democratic Party politicians
James W. Loewen	1942 births, 2021 deaths, American sociologists, American historians, Writers from Illinois, Deaths from bladder cancer
Istriot language	Romance languages
Blondie Plays Cupid	1940 movies, 1940s comedy movies, 1940s crime movies, American criminal comedy movies, Movies directed by Frank R. Strayer
Tom T. Hall	1936 births, 2021 deaths, American singer-songwriters, American country guitarists, American country singers, American folk musicians, American folk singers, American bluegrass musicians, American pianists, American saxophonists, Singers from Kentucky, Writers from Kentucky, Musicians from Kentucky
Daryl Dixon	Television characters, Fictional characters introduced in the 2010s
Igor Vovkovinskiy	1982 births, 2021 deaths, Naturalized citizens of the United States, Ukrainian actors, Actors from Minnesota, People from Rochester, Minnesota
Adams, Massachusetts	Towns in Massachusetts
Michael Morgan (conductor)	1957 births, 2021 deaths, LGBT African Americans, American conductors, LGBT musicians, Musicians from Washington, D.C., Gay men
Standish, Michigan	Cities in Michigan, County seats in Michigan
Over the Garden Wall	2014 American television series debuts, 2014 American television series endings, American animated television series, Cartoon Network series
L'Anse, Michigan	Cities in Michigan, County seats in Michigan
L'Anse Township, Michigan	Townships in Michigan
Beulah, Michigan	Villages in Michigan, County seats in Michigan
Benzonia Township, Michigan	Townships in Michigan
Benzonia, Michigan	Villages in Michigan
Cruella (movie)	2021 movies, 2020s comedy movies, 2020s crime movies, Disney+ movies, American comedy movies, American crime movies
Coldwater, Michigan	Cities in Michigan, County seats in Michigan
Coldwater Township, Branch County, Michigan	Townships in Michigan
Cheboygan, Michigan	Cities in Michigan, County seats in Michigan
Grayling, Michigan	Cities in Michigan, County seats in Michigan
Grayling Charter Township, Michigan	Townships in Michigan
Alex Ferns	1968 births, Living people, Scottish movie actors, Scottish stage actors, Scottish voice actors, Scottish television actors, Scottish television personalities
Lennoxtown	Villages in Scotland
Stirlingshire	Counties of Scotland
Lauren Shuler Donner	1949 births, Living people, Movie producers from Ohio, Businesspeople from Cleveland, Ohio
Prince Joseph Wenzel of Liechtenstein	1995 births, Living people, Princes of Liechtenstein, People from London
Sophie, Hereditary Princess of Liechtenstein	1967 births, Living people, Princes and princesses, Liechtenstein people, People from Munich
Tropical Storm Fred (2021)	August 2021 events
Ian Carey	1974 births, 2021 deaths, American DJs, American record producers, Musicians from Baltimore, Maryland, Musicians from Miami, Florida
Hancock, Maryland	Towns in Maryland
Fort Hancock, Texas	Unincorporated communities in Texas, Census-designated places in Texas
Terri Sewell	1965 births, Living people, American lawyers, United States representatives from Alabama, US Democratic Party politicians, People from Huntsville, Alabama
Raymond Leo Burke	1948 births, Living people, Cardinals of the Roman Catholic Church, Roman Catholic bishops, American lawyers, People from Richland Center, Wisconsin, People from St. Louis, Missouri
Svetlana Alliluyeva	1926 births, Living people, Naturalized citizens of the United States, People from Richland Center, Wisconsin, Writers from Wisconsin, Joseph Stalin, Writers from Moscow, Deaths from colorectal cancer, Cancer deaths in the United States
Repparfjorden	Norway
COVID-19 pandemic in Hong Kong	COVID-19 pandemic in China, History of Hong Kong
COVID-19 pandemic in Macau	COVID-19 pandemic in China, Macau
Quilmes	Cities in Argentina, Buenos Aires Province
Venafro	Cities in Molise
Boana buriti	Frogs, Animals of South America
Stewart Island kiwi	Birds, Animals of Oceania
Lumberton, Mississippi	Cities in Mississippi
Picayune, Mississippi	Cities in Mississippi
Donald III of Scotland	Kings and Queens of Scotland, 11th century births, 1099 deaths
Edgar, King of Scotland	Kings and Queens of Scotland, 11th century births, 1107 deaths
Puppet History	Television series, 2020 television series debuts
Hava, Maryam, Ayesha	2019 drama movies, Afghan movies, Iranian movies, French drama movies, Movies set in Afghanistan, Movies set in Iran
The Blue Veil (1951 movie)	1951 drama movies, American drama movies, Movie remakes, Movies directed by Curtis Bernhardt
Marie of Romania	1875 births, 1938 deaths, Deaths from pancreatic cancer, Deaths from cirrhosis, English Anglicans, People from Ashford, Kent, Recipients of the Order of the White Eagle (Poland)
Peter Harding (RAF officer, born 1933)	1933 births, 2021 deaths, British aviators, British military people, People from London
Alberto Bica	1958 births, 2021 deaths, Deaths from leukemia, Uruguayan footballers, Sportspeople from Montevideo
Micki Grant	1941 births, 2021 deaths, American stage actors, American television actors, American radio actors, American movie actors, American composers, American playwrights, Actors from Chicago, Singers from Chicago, Writers from Chicago
Sheikh Shahidur Rahman	1950s births, 2021 deaths, Pakistani politicians, Bangladeshi politicians, Bangladeshi Muslims, Deaths from myocardial infarction
Andrzej Schinzel	1937 births, 2021 deaths, Polish mathematicians, Polish academics, Polish writers
Sandomierz	Towns in Poland
High Wall	1947 movies, 1940s crime movies, 1940s drama movies, American crime drama movies, Movies based on plays, MGM movies, Movies directed by Curtis Bernhardt
1966 United Kingdom general election	1966, 1960s in the United Kingdom, United Kingdom general elections
List of Yo Gabba Gabba! episodes	Lists of television series episodes
Blue duck	Birds of New Zealand
Hardhead	Ducks, Birds of Oceania
Aythya	Ducks
Diving duck	Ducks
Lulach	Kings and Queens of Scotland, 11th century births, 1058 deaths
List of number-one singles of 2021 (Finland)	Music, Finnish culture
Aphasia	Neurology, Language
Rajkummar Rao	1984 births, Living people, Indian actors, Indian movie actors
New Zealand quail	Birds of New Zealand
Raj Kapoor filmography	Filmographies
Boana leucocheila	Frogs, Animals of South America
Sun–Joffe Manifesto	1923
Viktor Orbán and Santiago Abascal meeting	2021 in Europe
Killing of Samuel Luiz	Deaths by beating, Galicia, Spain, Spanish LGBT people, Victims of anti-LGBT hate crimes
Sheyene Gerardi	Articles with hCards, Humanitarians, Venezuelan people, Billionaires, People from Palo Alto, California, Businesspeople from New York, Stanford University alumni, Year of birth missing (living people), Living people
2021 Tennessee floods	2021 disasters, 2021 in the United States, 2020s disasters in North America, 2020s floods, 21st century in Tennessee, August 2021 events
Waverly, Tennessee	Cities in Tennessee, County seats in Tennessee
Abdullah Mokoginta	Indonesian politicians, 1935 births, 2021 deaths
Kotamobagu	Cities in Indonesia
Percha Leanpuri	1986 births, 2021 deaths, Indonesian politicians, Deaths in childbirth
South Sumatra	Provinces of Indonesia
Jean Orchampt	1923 births, 2021 deaths, French Roman Catholics, Roman Catholic bishops, Roman Catholic priests
Rod Gilbert	1941 births, 2021 deaths, New York Rangers players, Canadian ice hockey forwards, Sportspeople from Montreal
Jack Hirschman	1933 births, 2021 deaths, American poets, American essayists, American political activists, Marxism, Writers from New York City, Writers from San Francisco
Edin Šaranović	1976 births, 2021 deaths, Bosnia and Herzegovina footballers, Bosnia and Herzegovina football managers
Tešanj	Towns in Europe, Settlements in Bosnia and Herzegovina
Eric Wagner	1959 births, 2021 deaths, Deaths from pneumonia, Deaths from the COVID-19 pandemic in the United States, American heavy metal singers, American singer-songwriters, American rock singers
José Yudica	1936 births, 2021 deaths, Argentine football managers, Argentine footballers, People from Santa Fe, Argentina
Newell's Old Boys	Argentine football clubs, 1903 establishments in South America, 1900s establishments in Argentina
Johnson Aguiyi-Ironsi	1924 births, 1966 deaths, Presidents of Nigeria, Dictators, Assassinated people, Nigerian military people
Jane Wenham-Jones	1960s births, 2021 deaths, British journalists, British television presenters, British columnists, British educators, Writers from Kent
Rosita Quintana	1925 births, 2021 deaths, Argentine movie actors, Argentine stage actors, Argentine television actors, Mexican movie actors, Mexican stage actors, Mexican television actors, Actors from Buenos Aires, Actors from Mexico City, Argentine singers, Mexican singer-songwriters, Singers from Mexico City, Writers from Mexico City, Writers from Buenos Aires, Deaths from surgical complications, People with cancer
Jimmy Hayes (ice hockey)	1989 births, 2021 deaths, Chicago Blackhawks players, Florida Panthers players, Boston Bruins players, New Jersey Devils players, Sportspeople from Boston, Massachusetts
Irma Dorantes	1934 births, Living people, Equestrians, Mexican movie actors, Mexican television actors, Mexican stage actors, Mexican singers
Pedro Infante	1917 births, 1957 deaths, Aviation deaths, Mexican movie actors, Mexican television actors, Mexican stage actors, Mexican singers
Bangladesh Islami Chhatra Shibir	Political parties in Bangladesh
Shafiqur Rahman	Living people, Bangladesh Jamaat-e-Islami politicians, Bangladeshi Muslims, 1958 births
Tannehill, Louisiana	Unincorporated communities in Louisiana, Settlements in Winn Parish, Louisiana
The Salmon of Doubt	2002 books, English novels
Fiordland tokoeka	Birds, Animals of Oceania
Love Child (2011 film)	2011 drama movies, Dominican Republic movies, Puerto Rican movies, Movies directed by Leticia Tonos
Black Beauty (1946 movie)	1946 movies, 1940s drama movies, American family movies, American drama movies, Movies based on books, 20th Century Fox movies, Movies directed by Max Nosseck
Pat and Mike	1952 comedy movies, 1950s romantic comedy movies, American romantic comedy movies, MGM movies, Movies directed by George Cukor
Fitness Boxing	2018 video games, Nintendo Switch games, Nintendo Switch-only games, Video games developed in Japan
LittleBigPlanet (PSP)	2009 video games, LittleBigPlanet, PlayStation Portable games, PlayStation Portable-only games, Sony Interactive Entertainment games
Spotted dove	Birds of China, Birds of Asia
Kelly Price	Singer-songwriters from New York City, Singers from Georgia (U.S. state), People from Queens, Award winners, American soul singers, American gospel singers, American dance musicians, American contemporary R&B singers, African-American singers, 1973 births, Living people
Columbinae	Columbinae, Columbidae
Heavenly Sword	2007 video games, PlayStation 3 games, PlayStation 3-only games, Sony Interactive Entertainment games, Video games developed in Japan
Second inauguration of Dwight D. Eisenhower	1957 in the United States, United States presidential inaugurations, Dwight D. Eisenhower
Chinese Australians	Overseas Chinese, Chinese people
Chinese Malaysians	Overseas Chinese, Chinese people
Malaysian English	English language, Dialects of English
South African English	Languages of South Africa, Dialects of English
Diabetes in dogs	Pets, Diabetes mellitus, Controversies
Hammett (movie)	1982 movies, 1980s mystery movies, American mystery movies, Movies based on books, Warner Bros. movies, Movies directed by Wim Wenders
Utopia (2015 movie)	2015 drama movies, Afghan movies, Indian movies, British drama movies, Iranian movies
Andrea Stewart-Cousins	Women politicians, US Democratic Party politicians, State legislators of the United States, Politicians from New York City, Lieutenant Governors of New York (state), African American politicians, 21st-century American politicians, 1950 births, Living people
Diane Allen	US Republican Party politicians, Television personalities from New Jersey, Politicians from Newark, New Jersey, Emmy Award winners, American television news anchors, 1948 births, Living people
Boana poaju	Frogs, Animals of South America
Prince Gabriel, Duke of Dalarna	2017 births, Living people
Flag of Herefordshire	Flags of the United Kingdom, Herefordshire
Cities of Malaysia	Lists of cities by country, Cities in Malaysia
States and federal territories of Malaysia	States and federal territories of Malaysia, Subdivisions of Malaysia, Lists of subdivisions of Malaysia, Administrative divisions in Asia, First-level administrative divisions by country, Malaysia geography-related lists
Grossglockner	Mountains of Austria, Carinthia (state), Tyrol (state)
Mark Hyman (doctor)	1959 births, Living people, American physicians
Dating the Bible	Bible, Ancient history, Religion
Quarraisha Abdool Karim	Physicians, Living people
National University of La Matanza	1989 establishments in South America, Colleges and universities in South America
Red Brigades	Italy,  1970 establishments,  1984 disestablishments, Terrorism
Mario Moretti	1946 births, Living people, Italian communists
Human Shield (political party)	Political parties in Europe
List of countries in 1910	1910
List of countries in 1911	1911
List of countries in 1912	1912
List of countries in 1913	1913
List of countries in 1914	1914
Bad Habits (Ed Sheeran song)	2021 songs, Dance-pop songs
Lake Itasca	Geography of Minnesota, Lakes of the United States
List of countries in 1916	1916
List of countries in 1915	1915
List of countries in 1917	1917
List of countries in 1918	1918
List of countries in 1919	1919
Wyoming (1947 movie)	1947 movies, 1940s western movies, American western movies
South Georgia and the South Sandwich Islands national football team	National football teams
Stankevicius MGM	2014 establishments in Asia
List of countries in 1900	1900
List of countries in 1901	1901
List of countries in 1902	1902
List of countries in 1903	1903
List of countries in 1904	1904
List of countries in 1905	1905
List of countries in 1906	1906
List of countries in 1907	1907
List of countries in 1908	1908
List of countries in 1909	1909
Keithville, Louisiana	Unincorporated communities in Louisiana, Settlements in Caddo Parish, Louisiana
The Mummy Returns (video game)	2001 video games, PlayStation 2 games, Game Boy Color games, Action video games, Platform games
Sunset Valley, Texas	Cities in Texas
Rollingwood, Texas	Cities in Texas
West Lake Hills, Texas	Cities in Texas
Hiro Matsushita	1961 births, Living people, 24 Hours of Le Mans drivers, Japanese businesspeople
Castle Hills, Texas	Cities in Texas
Converse, Texas	Cities in Texas
Hill Country Village, Texas	Cities in Texas
Kirby, Texas	Cities in Texas
Olmos Park, Texas	Cities in Texas
Sandy Oaks, Texas	Cities in Texas
Shavano Park, Texas	Cities in Texas
Somerset, Texas	Cities in Texas
Terrell Hills, Texas	Cities in Texas
Universal City, Texas	Cities in Texas
Windcrest, Texas	Cities in Texas
Kōnosuke Matsushita	1894 births, 1989 deaths, Japanese businesspeople, Deaths from natural causes, Japanese centenarians
Hirata Tosuke	1849 births, 1925 deaths, People from Yamagata Prefecture
William J. Boarman	1946 births, 2021 deaths, Businesspeople from Maryland, Politicians from Maryland, US Democratic Party politicians
Severna Park, Maryland	Census-designated places in Maryland
Charlie Watts	1941 births, 2021 deaths, English rock drummers, English composers, Musicians from London, Writers from London, The Rolling Stones members, Musicians from Middlesex, Record producers
Said al-Harumi	1972 births, 2021 deaths, Deaths from myocardial infarction, Israeli politicians
2020 Summer Paralympics	August 2021 events, September 2021 events
Mahamat Déby	Living people, 1984 births, Heads of state of Chad, Generals
Gail Omvedt	1941 births, 2021 deaths, American academics, Indian academics, American sociologists, American feminist writers, American human rights activists, Indian activists, Indian scientists, Scientists from Minneapolis, Minnesota, Writers from Minneapolis, Minnesota
Wilfried Van Moer	1945 births, 2021 deaths, Deaths from stroke, Belgian football managers, Belgian footballers
K.S.K. Beveren	Belgian football clubs, East Flanders
Jan Suchý	1944 births, 2021 deaths, Czech ice hockey players, Olympic silver medalists
Ghazali Mohd Seth	1929 births, 2021 deaths, Malaysian politicians, Military people, Deaths from heart failure
Mangala Samaraweera	1956 births, 2021 deaths, Sri Lankan politicians, LGBT politicians, Gay men, Deaths from the COVID-19 pandemic
Simply Red	Musical groups established in 1984, Musical groups disestablished in 2010, British pop music groups
Congress of People's Deputies of the Soviet Union	Soviet Union
Jerry Harkness	1940 births, 2021 deaths, New York Knicks players, Indiana Pacers players, Sportspeople from New York City, Sportspeople from Chicago, American civil rights activists
Country Joe and the Fish	Musical groups established in 1965, Musical groups disestablished in 1970, Musical groups from California, American rock bands, Musicians from Berkeley, California
Olabiyi Durojaiye	1933 births, 2021 deaths, Nigerian politicians, Deaths from the COVID-19 pandemic in Nigeria
Anatoliy Chizhov	1934 births, 2021 deaths, Soviet politicians, Russian politicians, Russian engineers
1964 United Kingdom general election	1960s in the United Kingdom, 1964, United Kingdom general elections
O. Chandrashekar	1936 births, 2021 deaths, Indian footballers, Olympians
Volodymyr Bondarenko (politician)	1952 births, 2021 deaths, Ukrainian politicians
Jean-Luc Nancy	1940 births, 2021 deaths, French philosophers, French academics, French writers, People from Bordeaux
Tom Flynn (author)	1955 births, 2021 deaths, American editors, American novelists, People from Erie, Pennsylvania, Writers from Pennsylvania
Brick Bronsky	1964 births, 2021 deaths, American professional wrestlers, American movie actors, American sports commentators, American television actors, Sportspeople from Pennsylvania, Actors from Pennsylvania, Movie producers from Pennsylvania, Deaths from the COVID-19 pandemic in the United States, People from Harrisburg, Pennsylvania
Jaafar Jaafar	1978 births, Living people, Nigerian writers
Rabiu Kwankwaso	1956 births, Living people, Nigerian politicians
Elizabeth Blackadder	1931 births, 2021 deaths, Scottish painters, People from Edinburgh
Juan Carlos Blanco Estradé	1934 births, 2021 deaths, Uruguayan lawyers, Uruguayan politicians, Criminals, People from Montevideo
Nick Volpe	1926 births, 2021 deaths, Sportspeople from Toronto
Andreas Norland	1935 births, 2021 deaths, Norwegian journalists, Editors
Boutros Gemayel	1932 births, 2021 deaths, Lebanese people
Osório Bebber	1929 births, 2021 deaths, Roman Catholic bishops, Deaths from sepsis, Deaths from surgical complications, People from Rio Grande do Sul
Caxias do Sul	Cities in Rio Grande do Sul
Flores da Cunha	Municipalities in Brazil, Rio Grande do Sul
Ileana Gyulai-Drîmbă-Jenei	1946 births, 2021 deaths, Romanian sportspeople, Fencers, Olympic bronze medalists
Ion Drîmbă	1942 births, 2021 deaths, Romanian sportspeople, Fencers, Olympic gold medalists
Emerich Jenei	1937 births, Living people, Romanian football managers, Romanian footballers
Lukas Haas	1976 births, Living people, American child actors, American movie actors, American television actors, American stage actors, American voice actors, American rock musicians, Musicians from Los Angeles, California, Actors from Los Angeles, California
Gene Kranz	1933 births, Living people, NASA, American engineers, American aviators, Scientists from Ohio, People from Toledo, Ohio, Presidential Medal of Freedom recipients
Seymour Liebergot	1936 births, Living people, NASA, American engineers, Scientists from New Jersey, People from Camden, New Jersey
Glynn Lunney	1936 births, 2021 deaths, Presidential Medal of Freedom recipients, American engineers, NASA, Scientists from Pennsylvania, Scientists from Houston, Texas, Deaths from leukemia, Cancer deaths in Texas
Janet Malcolm	1934 births, 2021 deaths, Czech journalists, Naturalized citizens of the United States, Journalists from New York City, Deaths from lung cancer, Cancer deaths in New York City
Bob Walkup	1936 births, 2021 deaths, American mayors, Politicians from Arizona, Politicians from Iowa, People from Tucson, Arizona, US Republican Party politicians, Deaths from idiopathic pulmonary fibrosis
Ombretta Fumagalli Carulli	1944 births, 2021 deaths, Italian politicians, Italian academics, Italian judges
Karin Strenz	1967 births, 2021 deaths, Politicians from Mecklenburg-Vorpommern
Susana Canales	1933 births, 2021 deaths, Spanish movie actors, Spanish stage actors, Spanish television actors, Actors from Madrid
Hamdan bin Rashid Al Maktoum	1945 births, 2021 deaths, Emirati people, Asian politicians, Business people
Howard Schnellenberger	1934 births, 2021 deaths, American football coaches, College football coaches, Sportspeople from Indiana
Saint Meinrad, Indiana	Census-designated places in Indiana
Bibian Mentel	1972 births, 2021 deaths, Dutch Paralympic gold medalists, Deaths from brain cancer
Joye Hummel	1924 births, 2021 deaths, American comics writers, Writers from New York City
Bobby Schilling	1964 births, 2021 deaths, Cancer deaths in the United States, United States representatives from Illinois, US Republican Party politicians, Politicians from Iowa
Bobby Leonard	1932 births, 2021 deaths, American basketball players, National Basketball Association coaches, Sportspeople from Indianapolis, Indiana, American sports commentators, People from Terre Haute, Indiana
Du Jinfang	1932 births, 2021 deaths, Chinese stage actors, Chinese movie actors, Chinese singers
The Unholy Garden	1931 movies, 1930s romance movies, 1930s drama movies, American romantic drama movies, Movies directed by George Fitzmaurice
Frank Judd, Baron Judd	1935 births, 2021 deaths, UK MPs 1966–1970, UK MPs 1970–1974, UK MPs 1974, UK MPs 1974–1979, Former Labour MPs (UK), British businesspeople, People from Surrey
Vivek (actor)	1961 births, 2021 deaths, Deaths from cardiac arrest, Indian movie actors, Indian television actors, Indian comedians, Indian activists, Indian singers, People from Tamil Nadu
Elizabeth Furse	1936 births, 2021 deaths, Naturalized citizens of the United States, People from Nairobi, United States representatives from Oregon, African businesspeople, Businesspeople from Oregon, US Democratic Party politicians
Kenya Colony	Kenya
Boana paranaiba	Frogs, Animals of South America
Boulevard Nights	1979 movies, 1970s crime movies, American crime movies, Warner Bros. movies, Movies directed by Michael Pressman
Naomi Biden	1941 births, 1972 deaths, Road accident deaths in the United States, Joe Biden, People from Wilmington, Delaware
East Slavs	Slavic peoples
Froyla Tzalam	Year of birth missing (living people), Living people, Governors-General of Belize
Giorgi Mshvenieradze	1960 births, Living people, Medalists at the 1988 Summer Olympics, Medalists at the 1980 Summer Olympics
Celso Amorim	1942 births, Living people, Brazilian politicians, Ambassadors, People from São Paulo
Seminole High School (Seminole County, Florida)	Schools in the United States
Udemy	American technology companies, 2010 establishments in the United States
Võle	Settlements in Estonia
Herschel Walker	1962 births, Living people, American track and field athletes, Dallas Cowboys players, Minnesota Vikings players, Philadelphia Eagles players, New York Giants players, American football running backs, Sprinters, Sportspeople from Georgia (U.S. state), People from Augusta, Georgia, Politicians from Georgia (U.S. state), US Republican Party politicians
Josh Green (politician)	1970 births, Living people, Lieutenant Governors of Hawaii, Politicians from New York, State legislators of the United States, US Democratic Party politicians, American physicians
Janice McGeachin	1963 births, Living people, Lieutenant Governors of Idaho, Politicians from New Mexico, US Republican Party politicians, Businesspeople from New Mexico, Businesspeople from Idaho, People from Las Cruces, New Mexico
Rushern Baker	1958 births, Living people, American lawyers, Politicians from Georgia (U.S. state), Businesspeople from Georgia (U.S. state), Politicians from Maryland, Businesspeople from Maryland, US Democratic Party politicians
List of current United States lieutenant governors	State lieutenant governors of the United States
Lieutenant governor (United States)	State lieutenant governors of the United States
Robin Miller (journalist)	1949 births, 2021 deaths, Deaths from leukemia, American sports commentators, American journalists, Writers from Indianapolis, Indiana
Ithaca, Michigan	Cities in Michigan, County seats in Michigan
Alma, Michigan	Cities in Michigan
Lance Robertson	Living people, African American actors, American actors, American DJs, American musicians, Year of birth missing (living people)
List of lieutenant governors of Ohio	Lieutenant Governors of Ohio
Lieutenant Governor of Hawaii	Lieutenant Governors of Hawaii
Doug Chin	1966 births, Living people, Lieutenant Governors of Hawaii, American lawyers, Politicians from Honolulu, Politicians from Seattle, Washington, US Democratic Party politicians
Shan Tsutsui	1971 births, Lieutenant Governors of Hawaii, Living people, US Democratic Party politicians
Lieutenant Governor of Delaware	Lieutenant Governors of Delaware
Matthew Denn	1966 births, Living people, Lieutenant Governors of Delaware, American lawyers, Politicians from Wilmington, Delaware, Businesspeople from Wilmington, Delaware, US Democratic Party politicians
S. B. Woo	1937 births, Living people, Lieutenant Governors of Delaware, Naturalized citizens of the United States, Chinese academics, Chinese politicians, American academics, US Democratic Party politicians
Secretary of State of Arizona	Politicians from Arizona
Linda Larkin	Living people, 1970 births, American movie actors, American television actors, American stage actors, American voice actors, Actors from Los Angeles, California
Jonathan Freeman (actor)	1950 births, Living people, American movie actors, American stage actors, American voice actors, American television actors, Puppeteers, Actors from Cleveland, Ohio, Singers from Cleveland, Ohio
Jodi Benson	1961 births, Living people, American movie actors, American voice actors, American television actors, American stage actors, Actors from Illinois, Singers from Illinois, People from Rockford, Illinois, Singers from Georgia (U.S. state), Actors from Georgia (U.S. state)
Alrabiaa Network Television	Television channels, 2012 establishments in Asia, Iraq
Daikon	Leaf vegetables, Root vegetables
Autoregressive model	Statistics
Zoe Sugg	People from Wiltshire, People from Brighton, 1990 births, Living people, Pages which use embedded infobox templates with the title parameter, British YouTubers, English businesspeople, English writers, Bloggers
Krugerville, Texas	Cities in Texas
Lakewood Village, Texas	Cities in Texas
Oak Point, Texas	Cities in Texas
Pilot Point, Texas	Cities in Texas
Sanger, Texas	Cities in Texas
Farmersville, Texas	Cities in Texas
Lucas, Texas	Cities in Texas
Princeton, Texas	Cities in Texas
Weston, Texas	Cities in Texas
Campus Varta	Companies, Indian academics, Technology companies of Asia
Wharton School of the University of Pennsylvania	Colleges and universities in Pennsylvania, 1881 establishments, Philadelphia, Pennsylvania
Saleh Mamman	Nigerian politicians, African American politicians
Babatunde Fashola	1963 births, Living people, Nigerian politicians, People from Lagos
Srisailam	Coordinates on Wikidata, Towns in India, Settlements in Andhra Pradesh
Shoebill	Birds of Africa, Pelecaniformes
Vel' d'Hiv Roundup	The Holocaust
Tom Larkin (diplomat)	1917 births, 2021 deaths, Ambassadors, New Zealand politicians, People from Wellington
Eddie Paskey	1939 births, 2021 deaths, American movie actors, American television actors, American stage actors, American voice actors, Actors from California, Actors from Delaware
Jean-Pierre Fragnière	1944 births, 2021 deaths, Academics, Swiss writers, Political scientists
Michael Nader	1945 births, 2021 deaths, American movie actors, American television actors, American stage actors, Actors from St. Louis, Missouri, Cancer deaths in California
Dale Derby	1948 births, 2021 deaths, Deaths by drowning, State legislators of the United States, American physicians, Politicians from Oklahoma, US Republican Party politicians
Patrick Verbeke	1949 births, 2021 deaths, People from Caen, French musicians, French composers, French singers, French television presenters, Guitarists
Milan Gutović	1946 births, 2021 deaths, Deaths from the COVID-19 pandemic in Serbia, Serbian actors, Comedians
Ted Dexter	1935 births, 2021 deaths, English cricketers, Sportspeople from Milan
Metin Çekmez	1945 births, 2021 deaths, Deaths from cancer, Turkish movie actors, Turkish television actors, Turkish stage actors, Actors from Istanbul
Safran	Companies of France, 2000s establishments in France, 2005 establishments in Europe
Eduardo Brizuela del Moral	1944 births, 2021 deaths, Deaths from pneumonia, Deaths from stroke, Argentine politicians
Gunilla Bergström	1942 births, 2021 deaths, Swedish novelists, Swedish journalists, Swedish illustrators, People from Gothenburg
Elia Hernández Núñez	1962 births, 2021 deaths, Mexican politicians
List of lieutenant governors of Alabama	Lieutenant Governors of Alabama
Bill Baxley	1941 births, Living people, Lieutenant Governors of Alabama, American lawyers, US Democratic Party politicians
Don Siegelman	1946 births, Living people, Governors of Alabama, Lieutenant Governors of Alabama, American lawyers, American criminals, People from Mobile, Alabama, US Democratic Party politicians
Will Ainsworth	1981 births, Lieutenant Governors of Alabama, Living people, US Republican Party politicians
List of lieutenant governors of Alaska	Lieutenant Governors of Alaska
Kevin Meyer (politician)	1956 births, Living people, Lieutenant Governors of Alaska, Politicians from Nebraska, Businesspeople from Nebraska, Businesspeople from Alaska, US Republican Party politicians
Lieutenant Governor of Arkansas	Lieutenant Governors of Arkansas
Giovanna Fletcher	1985 births, Living people, British YouTubers, British novelists
Winston Bryant	1938 births, Living people, Lieutenant Governors of Arkansas, American lawyers, US Democratic Party politicians
Tim Griffin	1968 births, Living people, Lieutenant Governors of Arkansas, United States representatives from Arkansas, People from Charlotte, North Carolina, Politicians from North Carolina, US Republican Party politicians
Trade name	Commerce, Intellectual property law, Marketing, United States law
Dianne Primavera	1950 births, Lieutenant Governors of Colorado, Living people, Politicians from Denver, Colorado, US Democratic Party politicians
List of lieutenant governors of Colorado	Lieutenant Governors of Colorado
Nancy E. Dick	1930 births, Lieutenant Governors of Colorado, Living people, Politicians from Detroit, Michigan, US Democratic Party politicians
Bill Ratliff	1936 births, Living people, Lieutenant Governors of Texas, American engineers, US Republican Party politicians
Ben Barnes (politician)	1938 births, Living people, Politicians from Austin, Texas, Lieutenant Governors of Texas, Businesspeople from Texas, US Democratic Party politicians, Real estate developers
Gorman, Texas	Cities in Texas
List of lieutenant governors of Connecticut	Lieutenant Governors of Connecticut
Peter L. Cashman	Lieutenant Governors of Connecticut, Living people, 1936 births, Politicians from Cleveland, Ohio, US Republican Party politicians
Nancy Wyman	1946 births, Lieutenant Governors of Connecticut, Living people, Politicians from New York City, US Democratic Party politicians
Susan Bysiewicz	1961 births, Lieutenant Governors of Connecticut, Living people, US Democratic Party politicians, Politicians from New Haven, Connecticut
Jacqueline Coleman	1982 births, Living people, American educators, Lieutenant Governors of Kentucky, US Democratic Party politicians
Lieutenant Governor of Kentucky	Lieutenant Governors of Kentucky
Boana caipora	Frogs, Animals of South America
Lieutenant Governor of Louisiana	Lieutenant Governors of Louisiana
Billy Nungesser	1959 births, Lieutenant Governors of Louisiana, Living people, Politicians from New Orleans, Louisiana, Businesspeople from New Orleans, Louisiana, US Republican Party politicians
Dance Into Happiness	1930 movies, 1930s musical movies, German movies, Movies directed by Max Nosseck
Boyd Rutherford	1957 births, Lieutenant Governors of Maryland, Living people, Businesspeople from Washington, D.C., Politicians from Washington, D.C., Businesspeople from Maryland, American lawyers, US Republican Party politicians
Anthony G. Brown	1961 births, Living people, Lieutenant Governors of Maryland, United States representatives from Maryland, Politicians from New York, American lawyers, US Democratic Party politicians
Michael Steele	1958 births, Living people, American political commentators, American conservatives, Lieutenant Governors of Maryland, American lawyers, Businesspeople from Maryland, US Republican Party politicians
Lieutenant Governor of Maryland	Lieutenant Governors of Maryland
Melvin Steinberg	1933 births, Lieutenant Governors of Maryland, Living people, American lawyers, US Democratic Party politicians
Battambang	Cities in Asia, Settlements in Cambodia
Delbert Hosemann	1947 births, Living people, Lieutenant Governors of Mississippi, US Republican Party politicians
Lieutenant Governor of Mississippi	Lieutenant Governors of Mississippi
Mike Kehoe	1962 births, Lieutenant Governors of Missouri, Living people, Politicians from St. Louis, Missouri, US Republican Party politicians
List of lieutenant governors of Missouri	Lieutenant Governors of Missouri
Kristen Juras	Lieutenant Governors of Montana, Living people, 1955 births, American academics, American lawyers, Businesspeople from Montana, US Republican Party politicians
List of lieutenant governors of Montana	Lieutenant Governors of Montana
John Bohlinger	1936 births, Lieutenant Governors of Montana, Living people, US Republican Party politicians, US Democratic Party politicians, People from Bozeman, Montana
John Walsh (Montana politician)	1960 births, Living people, Lieutenant Governors of Montana, United States senators from Montana, People from Butte, Montana, US Democratic Party politicians
Angela McLean	1970 births, Living people, American educators, Lieutenant Governors of Montana, US Democratic Party politicians
Mike Foley (Nebraska politician)	1954 births, Lieutenant Governors of Nebraska, Living people, Politicians from New York, People from Lincoln, Nebraska, People from Rochester, New York, US Republican Party politicians
List of lieutenant governors of Nebraska	Lieutenant Governors of Nebraska
John E. Nelson (Nebraska politician)	1935 births, Living people, American lawyers, Lieutenant Governors of Nebraska, US Republican Party politicians
Kate Marshall	1959 births, Lieutenant Governors of Nevada, Living people, Politicians from San Francisco, US Democratic Party politicians, American lawyers
Lieutenant Governor of Nevada	Lieutenant Governors of Nevada
Lorraine Hunt	1939 births, Living people, Lieutenant Governors of Nevada, Politicians from Las Vegas, Nevada, Businesspeople from Las Vegas, Nevada, Businesspeople from New York, Politicians from New York, US Republican Party politicians
Sue Wagner	1940 births, Living people, Lieutenant Governors of Nevada, Politicians from Maine, Politicians from Arizona, People from Portland, Maine, People from Tucson, Arizona, People from Reno, Nevada, US Republican Party politicians, Independent politicians in the United States
Robert E. Rose	Living people, Lieutenant Governors of Nevada, American judges, 1939 births, People from Orange, New Jersey, Politicians from New Jersey, US Democratic Party politicians
Howie Morales	1973 births, Living people, Lieutenant Governors of New Mexico, US Democratic Party politicians
Lieutenant Governor of New Mexico	Lieutenant Governors of New Mexico
Casey Luna	Living people, 1931 births, Businesspeople from New Mexico, Lieutenant Governors of New Mexico, US Democratic Party politicians, American racecar drivers, Sportspeople from New Mexico
Roberto Mondragón	1940 births, Lieutenant Governors of New Mexico, Living people, American political activists, US Democratic Party politicians, Green Party of the United States politicians, Musicians from New Mexico, Writers from New Mexico
Mark Robinson (American politician)	1968 births, Living people, Lieutenant Governors of North Carolina, US Republican Party politicians, People from Greensboro, North Carolina
Lieutenant Governor of North Carolina	Lieutenant Governors of North Carolina
Brent Sanford	1971 births, Businesspeople from North Dakota, Lieutenant Governors of North Dakota, American mayors, US Republican Party politicians
Lieutenant Governor of North Dakota	Lieutenant Governors of North Dakota
Richard F. Larsen	Lieutenant Governors of North Dakota, Living people, 1936 births, People from Grand Forks, North Dakota, US Republican Party politicians
Wayne Sanstead	1935 births, Living people, Lieutenant Governors of North Dakota, US Democratic Party politicians, Politicians from Arkansas
Lloyd Omdahl	Lieutenant Governors of North Dakota, US Democratic Party politicians, 1931 births, Living people
Rosemarie Myrdal	Lieutenant Governors of North Dakota, 1929 births, Living people, People from Minot, North Dakota, US Republican Party politicians
Matt Pinnell	1979 births, Lieutenant Governors of Oklahoma, Living people, Politicians from Dallas, Texas, US Republican Party politicians, People from Enid, Oklahoma
Lieutenant Governor of Oklahoma	Lieutenant Governors of Oklahoma
Todd Lamb (politician)	1971 births, Lieutenant Governors of Oklahoma, Living people, American lawyers, People from Enid, Oklahoma, US Republican Party politicians
Angom Gopi	Meitei people
Sabina Matos	1974 births, Living people, Naturalized citizens of the United States, Lieutenant Governors of Rhode Island, Dominican Republic politicians, People from Providence, Rhode Island, US Democratic Party politicians
List of lieutenant governors of Rhode Island	Lieutenant Governors of Rhode Island
Thomas R. DiLuglio	1931 births, Living people, Lieutenant Governors of Rhode Island, People from Providence, Rhode Island, US Democratic Party politicians
Pamela Evette	1967 births, Businesspeople from South Carolina, Lieutenant Governors of South Carolina, Living people, US Republican Party politicians
Lieutenant Governor of South Carolina	Lieutenant Governors of South Carolina
Kevin L. Bryant	1967 births, Lieutenant Governors of South Carolina, Living people, US Republican Party politicians
Larry Rhoden	1959 births, Lieutenant Governors of South Dakota, Living people, Businesspeople from South Carolina, US Republican Party politicians
Lieutenant Governor of South Dakota	Lieutenant Governors of South Dakota
Matt Michels	1960 births, Lieutenant Governors of South Dakota, Living people, US Republican Party politicians
Deidre Henderson	1974 births, Living people, US Republican Party politicians, Lieutenant Governors of Utah
Lieutenant Governor of Utah	Lieutenant Governors of Utah
Greg Bell (politician)	1948 births, Living people, Lieutenant Governors of Utah, Real estate developers, People from Ogden, Utah, Businesspeople from Utah, US Republican Party politicians
Molly Gray	1984 births, Lieutenant Governors of Vermont, Living people, American lawyers, US Democratic Party politicians
List of lieutenant governors of Vermont	Lieutenant Governors of Vermont
Brian Dubie	1959 births, Lieutenant Governors of Vermont, Living people, US Republican Party politicians, American aviators, People from Burlington, Vermont
Jim Douglas	1951 births, American academics, Governors of Vermont, Living people, US Republican Party politicians, People from Springfield, Massachusetts, Politicians from Massachusetts
Craig Blair	1959 births, Living people, Presidents of the West Virginia State Senate, US Republican Party politicians
President of the West Virginia Senate	Presidents of the West Virginia State Senate
Eleasalo Ale	Year of birth missing (living people), Lieutenant Governors of American Samoa, Living people, US Democratic Party politicians
Lieutenant Governor of American Samoa	Lieutenant Governors of American Samoa
Josh Tenorio	Lieutenant Governors of Guam, Living people, Year of birth missing (living people), LGBT politicians, Gay men
Lieutenant Governor of Guam	Lieutenant Governors of Guam
Kurt Moylan	Living people, Lieutenant Governors of Guam, US Republican Party politicians, 1939 births, Politicians from Honolulu
Madeleine Bordallo	1933 births, Living people, Lieutenant Governors of Guam, United States representatives, Politicians from Minnesota, US Democratic Party politicians
Graceville, Minnesota	Cities in Minnesota
Ricardo Bordallo	1927 births, 1990 deaths, Governors of Guam, Suicides by firearm in the United States, Businesspeople from San Francisco, Politicians from San Francisco, US Democratic Party politicians
Arnold Palacios	1955 births, Lieutenant Governors of the Northern Mariana Islands, Living people, US Republican Party politicians
Lieutenant Governor of the Northern Mariana Islands	Lieutenant Governors of the Northern Mariana Islands
Pedro Agulto Tenorio	1941 births, Lieutenant Governors of the Northern Mariana Islands, Living people, US Republican Party politicians
Tregenza Roach	1959 births, US Democratic Party politicians, Lieutenant Governors of the United States Virgin Islands, Living people, Saint Kitts and Nevis people
Lieutenant Governor of the United States Virgin Islands	Lieutenant Governors of the United States Virgin Islands
Troy Jackson (politician)	1968 births, 21st-century American politicians, Living people, State legislators of the United States, Politicians from Maine, US Democratic Party politicians
Chuck Morse	1960 births, Living people, US Republican Party politicians, Governors of New Hampshire
Salem, New Hampshire	Towns in New Hampshire
Council of the District of Columbia	Washington, D.C.
Phil Mendelson	1952 births, Living people, Politicians from Washington, D.C., Politicians from Cleveland, Ohio, US Democratic Party politicians
Larry Seilhamer Rodríguez	1954 births, Living people, Puerto Rican people, Basketball players
Shemia Fagan	1981 births, Living people, American lawyers, Politicians from Portland, Oregon, US Democratic Party politicians, State legislators of the United States
Edward Buchanan	1967 births, American Protestants, Living people, American lawyers, American military people, Politicians from Wyoming, State legislators of the United States, US Republican Party politicians, Politicians from Florida, People from Fort Lauderdale, Florida
2021 Kabul airport attacks	2021 in Asia, 2021 mass shootings, 2020s explosions, 2020s in Afghanistan, 2020s murders in Asia, 21st century in Kabul, Attacks on buildings and structures in 2021, Attacks on buildings and structures in Asia, August 2021 events, Crime in Afghanistan, Islamic State, Mass murder in 2021, Mass murder in Asia, Mass shootings in Asia, Suicide bombings in Asia, Suicide bombings in the 2020s, Terrorist incidents in 2021, Terrorist incidents in Asia in the 2020s, War in Afghanistan (since 1978)
Vladimir Shadrin	1948 births, 2021 deaths, Soviet Olympic gold medalists, Russian ice hockey players, Sportspeople from Moscow, Ice hockey coaches
Minnetonka Beach, Minnesota	Cities in Minnesota
Minnetrista, Minnesota	Cities in Minnesota
New Hope, Minnesota	Cities in Minnesota
Osseo, Minnesota	Cities in Minnesota
Richfield, Minnesota	Cities in Minnesota
Shorewood, Minnesota	Cities in Minnesota
Spring Park, Minnesota	Cities in Minnesota
St. Bonifacius, Minnesota	Cities in Minnesota
Tonka Bay, Minnesota	Cities in Minnesota
Woodland, Minnesota	Cities in Minnesota
Table tennis at the 2016 Summer Paralympics	Summer Paralympic Games, Table tennis, 2016 in sports
A Dead Man Among the Living	1947 movies, 1940s thriller movies, Czech movies, Movies based on books, Movies directed by Bořivoj Zeman
The Elementary School	1991 comedy-drama movies, Czech movies, Slovakian movies, Movies directed by Jan Svěrák
Philippine English	Dialects of English, Languages of the Philippines
Angel and the Badman	1947 movies, 1940s western movies, American western movies
Haast tokoeka	Birds, Animals of Oceania
Bubble Guppies	2010s American television series, 2011 American television series debuts, 2011 television series debuts, 2016 television series endings, American animated television series, American children's television series, American fantasy television series, American television series, American television series revived after cancellation, Canadian children's television series, English-language television programs, Nickelodeon television series, Television series about friendship
The Secret Heart	1946 movies, 1940s romance movies, 1940s drama movies, American romantic drama movies, MGM movies, Movies directed by Robert Z. Leonard
Okarito brown kiwi	Birds of New Zealand, Flightless birds
Gypsy food	Food and drink
Ameena Begum	Living people, Bangladesh Jamaat-e-Islami politicians, Bangladeshi Muslims, Year of birth missing (living people)
Maqbul Ahmed	Bangladesh Jamaat-e-Islami politicians, Bangladeshi Muslims, 1939 births, 2021 deaths
Fakir Alamgir	1950 births, 2021 deaths, Bangladeshi singers
Nadira Begum	Living people, Bangladeshi singers, Bangladeshi female singers, Year of birth missing (living people)
1959 United Kingdom general election	1950s in the United Kingdom, 1959, United Kingdom general elections
The Science of Sleep	2006 comedy movies, 2000s fantasy movies, French comedy movies, Italian comedy movies, American fantasy movies, American comedy movies, Movies directed by Michel Gondry
Salahuddin Ahmed	Living people, Bangladeshi politicians, Bangladeshi Muslims
Akhi Alamgir	Bangladeshi female singers, 1975 births, Living people
2016 Conservative Party leadership election	Elections in the United Kingdom, 2016 in the United Kingdom, 2016 elections, Conservative Party (UK)
Joban Uddin Ahmad	Bangladesh Jamaat-e-Islami politicians, Bangladeshi Muslims, Living people
Everybody Hates Chris	2000s American sitcoms
Abdus Sattar Akon	Bangladesh Jamaat-e-Islami politicians, Bangladeshi Muslims, 1929 births, 2012 deaths
England at the 2018 Commonwealth Games	Nations at multi-sport events, Commonwealth Games, 2018 in sports, 2010s in England
Rajneesh Kumar Saxena	People from Uttar Pradesh, 1987 births
Table tennis at the 2016 Summer Paralympics – Men's individual – Class 1	Table tennis, 2016 in sports, Summer Paralympic Games
Bukola Sawyerr Izeogu	1974 births, Living people
Kamrieng District	Articles containing Khmer-language text
2014 Peshawar school massacre	2014 in Asia, 2010s murders in Asia, 21st century in Pakistan, Attacks on buildings and structures in Asia, Attacks on buildings and structures in the 2010s, December events, Mass shootings in Asia, Massacres in Asia, Murder in 2014, Peshawar, School shootings, Terrorist incidents in Asia in the 2010s
Gogglebox	BAFTA Award winning programmes, British reality television series, 2013 television series debuts
Cappella (band)	1980s establishments in Italy, 1987 establishments in Europe, Italian musical groups, Musical groups established in 1987, Brescia
USA Rugby	Rugby union
Fair Lawn, New Jersey	Boroughs in New Jersey
Mastaba	Ancient Egypt
Akis Tsochatzopoulos	1939 births, 2021 deaths, Deaths from myocardial infarction, Greek politicians, Criminals
2020–21 Burnley F.C. season	2020-21 association football seasons, 2021 in association football, 2020 in association football
Marco Hausiku	1953 births, 2021 deaths, Namibian politicians
Zdenka Procházková	1926 births, 2021 deaths, Czech movie actors, Czech stage actors, People from Prague
Mario Guilloti	1946 births, 2021 deaths, Argentine sportspeople, Olympic bronze medalists, Boxers
Nicholas Felice	1927 births, 2021 deaths, American mayors, Politicians from New Jersey, State legislators of the United States, US Republican Party politicians, People from Passaic, New Jersey
Daniel Farhi	1941 births, 2021 deaths, Rabbis, French Jews, People from Paris
Boana botumirim	Frogs, Animals of South America
Sally Tanner	1926 births, 2021 deaths, State legislators of the United States, Politicians from Indiana, Politicians from California, US Democratic Party politicians, People from East Chicago, Indiana
Ferndale, California	Cities in California, Settlements in Humboldt County, California
Albert Ndele	Living people, 1930 births, Democratic Republic of the Congo politicians, Bankers, African businesspeople
Yefrem Sokolov	1926 births, Living people, Communists, Soviet politicians
Abdurrahman Vazirov	1930 births, Living people, Azerbaijani politicians
Vaino Väljas	1931 births, Living people, Estonian politicians, Communists
Queen Kesang Choden	1930 births, Living people, Bhutanese people, Kings and queens
Gerry Ashmore	1936 births, 2021 deaths, Formula One drivers, English racecar drivers, Sportspeople from Staffordshire, Deaths from cancer
Great spotted kiwi	Birds of New Zealand, Flightless birds
North Island brown kiwi	Animals of New Zealand, Birds of Oceania, Flightless birds
Gallant Bess	1946 movies, 1940s war movies, 1940s drama movies, American war movies, American drama movies, World War II movies, Movies directed by Andrew Marton
Victor/Victoria	1982 comedy movies, 1980s romantic comedy movies, 1980s sex comedy movies, 1980s musical movies, 1980s LGBT movies, British romantic comedy movies, British musical movies, British LGBT movies, American romantic comedy movies, American musical movies, American LGBT movies, Movies directed by Blake Edwards
Metrovalencia	Metrovalencia, Rail transport in the Valencian Community, Underground rapid transit in Spain
Electric Dreams (movie)	1984 comedy movies, 1984 romance movies, 1980s romantic comedy movies, 1980s science fiction movies, British science fiction movies, British romantic comedy movies, American science fiction movies, American romantic comedy movies, MGM movies, Movies directed by Steve Barron
The Chase (1946 movie)	1946 movies, 1940s thriller movies, American thriller movies, Movies based on books
James Cameroon's Dark Angel	2002 video games, Beat 'em ups, PlayStation 2 games, Video games based on television shows, Xbox games
A Guy Named Joe	1943 movies, 1940s war movies, 1940s romance movies, 1940s fantasy movies, American fantasy movies, American romance movies, American war movies, World War II movies, MGM movies, Movies directed by Victor Fleming
Trevor McMahon	1929 births, Living people, New Zealand cricketers, Sportspeople from North Island
Passage to Marseille	1944 movies, 1940s war movies, 1940s adventure movies, American war movies, American adventure movies, World War II movies, Warner Bros. movies, Movies based on books, Movies directed by Michael Curtiz
Densha de Go! (series)	Arcade games, Japan exclusive video games, Nintendo Switch games, PlayStation 2 games, PlayStation 4 games, Video game series, Video games developed in Japan, Mass media franchises introduced in 1996, Wii games, Windows games
Reliquary	Religious objects
Lifebuoy	Protective clothing, Sailing
Table tennis at the 2016 Summer Paralympics – Men's individual – Class 6	Table tennis, 2016 in sports, Summer Paralympic Games
Operation Allies Refuge	Military of the United States, 21st century in Afghanistan, July 2021 events, August 2021 events, 2021 in Asia
Operation Pitting	2021 in Asia, August 2021 events, British Army, 2021 in the United Kingdom
Josephine, Texas	Cities in Texas
Van Alstyne, Texas	Cities in Texas
Tignes	Communes in Savoie, Ski areas and resorts
Hurricane Ida (2021)	2021 disasters, 2021 in the United States, 2020s disasters in North America, 21st century in Cuba, 21st century in Louisiana, August 2021 events, Hurricanes in Louisiana, September 2021 events
Bojano	Cities in Molise
Marquette County, Wisconsin	1848 establishments in Wisconsin, Wisconsin counties
Pinar del Río	Establishments in the Caribbean, 18th-century establishments in North America, Cities in Cuba
Adapter	Electronics, Electrical connectors
Danial Hajibarat	Iranian movie directors, 1983 births, Living people, People from Tehran, Iranian screenwriters
Pillager, Minnesota	Cities in Minnesota
Nancy Hollister	US Republican Party politicians, United States representatives from Ohio, Lieutenant Governors of Ohio, Governors of Ohio, American mayors, 1949 births, Living people
Boana maculateralis	Frogs, Animals of South America
Police, Adjective	2009 drama movies, Romanian movies, Movies directed by Corneliu Porumboiu
Little spotted kiwi	Birds of New Zealand, Flightless birds
Figanières	Communes in Var
Flassans-sur-Issole	Communes in Var
Flayosc	Communes in Var
Forcalqueiret	Communes in Var
Fox-Amphoux	Communes in Var
Titisee-Neustadt	Spa towns in Germany, Ski areas and resorts
La Garde-Freinet	Communes in Var
Garéoult	Communes in Var
Campomarino	Settlements in Molise
Ginasservis	Communes in Var
Alegrete	Cities in Rio Grande do Sul
Linhares	Cities in Brazil, Espírito Santo
Paul Gondjout	1912 births, 1990 deaths, Gabonese people, African politicians
Jaboatão dos Guararapes	Cities in Brazil, Pernambuco
Sucy-en-Brie	Communes in Val-de-Marne
Martha Ankomah	 Living people
West Sumatra	Provinces of Indonesia
Nasrul Abit	1954 births, 2021 deaths, Deaths from the COVID-19 pandemic in Indonesia, Indonesian politicians
Čechomor	Czech musical groups
2021 Madagascar food crisis	2021 disasters, 2021 in Africa, 2020s disasters in Africa, August 2021 events, July 2021 events, June 2021 events, Madagascar
Aldo Eminente	1931 births, 2021 deaths, French Olympians, Swimmers, Olympic bronze medalists
Brazilian Democratic Movement	Political parties in South America, Politics of Brazil
Sam Oji	1985 births, 2021 deaths, English footballers, Sportspeople from London
Jin Renqing	1944 births, 2021 deaths, Chinese politicians, Deaths from fire, Communists
Priscilla Baltazar-Padilla	1958 births, 2021 deaths, Filipino politicians, Filipino lawyers, People from Manila
Stjepan Babić	1925 births, 2021 deaths, Croatian writers, Croatian politicians, Linguists, Academics, People from Zagreb
Rodolfo Aínsa	1944 births, 2021 deaths, Spanish politicians
Sabiñánigo	Municipalities in Aragon
Calogero Lo Giudice	1930s births, 2021 deaths, MEPs for Italy, People from Sicily
Harry Kent (cyclist)	1947 births, 2021 deaths, New Zealand sportspeople, Cyclists, Deaths from stroke
Pakistan Science Club	Science stubs
Catch It, Bin It, Kill It	2009 in the United Kingdom, 2020s in the United Kingdom, Healthy lifestyle, COVID-19 pandemic
Teresa Żylis-Gara	1930 births, 2021 deaths, Polish stage actors, Polish singers, Opera singers
Our Idiot Brother	2011 comedy-drama movies, American comedy-drama movies
Science and Star Wars	Star Wars, Science
Saint-Aubin-le-Guichard	Former communes in France, Communes in Eure
Upland moa	Birds of New Zealand, Flightless birds
Eastern moa	Birds of New Zealand, Flightless birds
Eye of the Needle (movie)	1981 movies, British movies, Spy movies, Thriller movies, English-language movies, Movies based on books, World War II movies, Movies set in the 1940s, Movies set in London, Movies set in England, Movies set in Scotland, Movies set in islands, Movies directed by Richard Marquand
Crested moa	Birds of New Zealand, Flightless birds
Green Fire	1954 drama movies, 1950s adventure movies, American adventure movies, American drama movies, Movies based on books, MGM movies, Movies directed by Andrew Marton
Kundun	1997 drama movies, 1990s biographical movies, American biographical movies, American drama movies, Moroccan movies, Monégasque movies, Movies set in Asia, Movies set in China, Movies directed by Martin Scorsese
Shuki Levy	American composers, Anime composers, Saban Entertainment
Saban Entertainment	Saban Entertainment, 1980 establishments, 2002 disestablishments, Defunct companies
Saban Capital Group	Anime companies, Saban Entertainment
Tehrik-i-Taliban Pakistan	Terrorism, Pakistan
Panjshir resistance	War in Afghanistan (since 1978)
Ratchet Deadlocked	2002 video games, PlayStation 2 games, PlayStation 3 games, MacOS games
List of Chinese painters	Chinese painters, Lists of people
2017 Battlefords—Lloydminster federal by-election	Elections in Canada, 2010s in Canada, 2017 in North America, Saskatchewan, 2017 elections
The Second Game	2014 movies, Romanian movies, Documentary movies, Movies directed by Corneliu Porumboiu
Star 80	1983 drama movies, 1980s biographical movies, American biographical movies, American drama movies, Movies directed by Bob Fosse
Turanid race	Anthropology, Racism, Colonialism, Siberia
Christopher Barrios	2001 births, 2015 deaths, 2015 crimes, Missing people, Missing American people
Expo 2020	2020 in Asia
Salta tree frog	Frogs, Animals of South America
Afghan Civil War (1989–1992)	War in Afghanistan (since 1978)
Iajuddin Ahmed	1931 births, 2012 deaths, Presidents of Bangladesh, Recipients of the Ekushey Padak, Bangladeshi Muslims
Coloring book	Children's books, Painting
2007-08 UEFA Champions League	2007 in association football
Uthiyur	Tiruppur District, Temples in India, Hindu temples
Haosi Namoinu	Meitei folklore, Meitei literature, Meitei mythology
Great Molasses Flood	Disasters in the 20th century, History of Boston, Massachusetts
Dharapuram	Tiruppur District, Tamil Nadu
Heavy-footed moa	Flightless birds, Birds of New Zealand
North Island giant moa	Flightless birds, Birds of New Zealand
Havana syndrome	Medical emergencies, Conspiracy theories
South Island giant moa	Flightless birds, Birds of New Zealand
Gentrification	Urban design, Controversies in the United States
Gentrification of Chicago	History of Chicago
Cabrini–Green Homes	Chicago, Illinois
Lajim Ukin	1955 births, 2021 deaths, Deaths from the COVID-19 pandemic in Malaysia, Malaysian politicians
Yuri Pudyshev	1954 births, 2021 deaths, Soviet sportspeople, Belarusian footballers, Football managers
Mikhail Nenashev	1960 births, 2021 deaths, Russian politicians, Deaths from cardiac arrest
Kolë Berisha	1947 births, 2021 deaths, Kosovan people, European politicians
Stephen Vizinczey	1933 births, 2021 deaths, Hungarian writers, Canadian writers
Francesc Burrull	1934 births, 2021 deaths, Spanish pianists, Spanish composers, Jazz musicians, Deaths from kidney disease
Jiang Chunyun	1930 births, 2021 deaths, Chinese politicians
Sompote Sands	1941 births, 2021 deaths, Thai people, Movie directors, Movie producers
Lucille Whipper	1928 births, 2021 deaths, State legislators of the United States, Politicians from South Carolina, People from Charleston, South Carolina, US Democratic Party politicians
Vanita Gupta	1974 births, Living people, American lawyers, Politicians from Philadelphia, Pennsylvania, US Democratic Party politicians
The Upsetter (movie)	Reggae music, American documentary movies
Afghan Civil War (1928–1929)	Afghanistan, Civil wars
OceanHero	Search engines
Natasha Heschélle	Canadian actors, Living people, Year of birth missing (living people)
Lawrence Rosario Abavana	1920 births, 2004 deaths, Ghanaian politicians
The Magic Bow	1946 movies, 1940s musical movies, British musical movies, Movies directed by Bernard Knowles
Spaceflight IC-1	1965 movies, 1960s science fiction movies, British science fiction movies, 20th Century Fox movies, Movies directed by Bernard Knowles
Sahabi Alhaji Yaú	1956 births, Living people, Nigerian politicians
Wikimedia UK	Wikimedia Foundation, Charities
Nura M Inuwa	1989 births, Living people, Nigerian singers
Richard Clarida	1957 births, American economists, Columbia University faculty, Harvard University alumni, Living people
Afghan Civil War (1992–1996)	War in Afghanistan (since 1978)
Hugh Fearnley-Whittingstall	1965 births, Living people, British chefs
London Protocol (1830)	19th century in Greece
Mominul Haque	Bangladeshi cricketers, Bangladeshi Muslims, Living people, 1991 births
Shoriful Islam	Bangladeshi cricketers, Bangladeshi Muslims, Living people, 2001 births
Boana aguilari	Frogs, Animals of South America
South Island oystercatcher	Birds of New Zealand
Baitul Aman Mosque	Mosques in Bangladesh
Taslima Memorial Academy	Schools in Bangladesh
Trousers as women's clothing	Trousers and shorts, Women's rights, Feminism, Everyday life, Clothing controversies
Reproductive rights	Women's rights, Controversies, Biological reproduction, Abortion
Ferreries	Municipalities in the Balearic Islands
Beja, Portugal	Cities in Portugal, Municipalities of Portugal
Béja	Cities in Tunisia
Ron Bushy	1941 births, 2021 deaths, American rock drummers, American artists, Musicians from Washington, D.C., Deaths from esophageal cancer
Wang Kuang-hui	1964 births, 2021 deaths, Deaths from liver cancer, Asian sportspeople, Baseball coaches, Baseball players, Taiwanese people
Latif Nassif Jassim	1941 births, 2021 deaths, People from Baghdad, Murderers, Iraqi politicians
Claude Guichard	1928 births, 2021 deaths, French politicians, French academics
Muhammad Hamza	1929 births, 2021 deaths, Pakistani politicians, Deaths from the COVID-19 pandemic in Pakistan
Daniel Clarence Quinn	American novelists
Tudor Gunasekara	1935 births, 2021 deaths, Deaths from the COVID-19 pandemic, Sri Lankan politicians
Whigga	English profanity, Slurs
Alex Gallacher	1954 births, 2021 deaths, Deaths from lung cancer, Australian Labor Party politicians, Members of the Australian Senate, Scottish politicians, Naturalised citizens of Australia
Whigger	English profanity, Slurs
Alioune Badara Cissé	1958 births, 2021 deaths, Deaths from the COVID-19 pandemic, Senegalese politicians
Siegfried Matthus	1934 births, 2021 deaths, German composers, German conductors
Vivian Caver	1928 births, 2021 deaths, State legislators of the United States, Politicians from Tennessee, Politicians from Seattle, Washington, American human rights activists, People from Jackson, Tennessee, US Democratic Party politicians
José Carreira Marques	1943 births, 2021 deaths, Portuguese politicians, Mayors
Retard (word)	English profanity, Slurs, Pejoratives
Júlio Chaves	1944 births, 2021 deaths, Deaths from the COVID-19 pandemic in Brazil, Brazilian actors, Voice actors
Joe Chasteen	1925 births, 2021 deaths, State legislators of the United States, Politicians from Wyoming, US Republican Party politicians, Businesspeople from Wyoming
Max Willis	1935 births, 2021 deaths, Politicians from New South Wales
Robert D. Springer	1933 births, 2021 deaths, American generals, People from Pennsylvania
Millheim, Pennsylvania	Boroughs in Pennsylvania
Self-Portrait with a Friend	16th century paintings
Grapeseed oil	Cooking oils
Library and Archives Canada	National libraries, National archives, Government agencies of Canada, 2004 establishments in Canada, Buildings and structures in Ottawa
List of Bangladeshi musicians	Lists of musicians by nationality, Bangladeshi musicians
List of Bangladeshi business people	Bangladeshi businesspeople, Economy of Bangladesh-related lists, Lists of businesspeople, Lists of Bangladeshi people by occupation
List of state leaders in 2020	2020
List of state leaders in 2021	2021
List of Bangladeshi films of 1994	1994 in Bangladesh, Lists of 1994 films by country or language, Lists of Bangladeshi films by year
List of state leaders in 2010	2010
List of state leaders in 2011	2011
List of state leaders in 2013	2013
List of state leaders in 2012	2012
List of state leaders in 2014	2014
List of state leaders in 2015	2015
List of state leaders in 2016	2016
List of state leaders in 2017	2017
List of state leaders in 2018	2018
List of state leaders in 2019	2019
List of state leaders in 2000	2000
List of state leaders in 2001	2001
List of state leaders in 2004	2004
List of state leaders in 2002	2002
List of state leaders in 2003	2003
Apple Music	Apple Inc., Music stubs
List of state leaders in 2005	2005
List of state leaders in 2008	2008
List of state leaders in 2006	2006
List of state leaders in 2009	2009
List of state leaders in 2007	2007
Bachelor of Engineering	Bachelor's degrees, Engineering education
Fansipan	Mountains of Asia, Geography of Vietnam
Phoenix Netts	1991 births, 2020 deaths
The Ask	2010 books
Boana almendarizae	Frogs, Animals of South America
Super Mario Party	Nintendo Switch-only games, 2018 video games
Misty Das	Living people
Tetraethyllead	Chemical compounds
Forte dei Marmi	Towns in Tuscany
San Giuliano Terme	Towns in Tuscany
Auterive, Haute-Garonne	Communes in Haute-Garonne
Richard Benjamin	1938 births, Living people, American movie actors, American television actors, American stage actors, Movie directors from New York City, Movie producers from New York City, Actors from New York City
Judy Davis	1955 births, Living people, Australian movie actors, Australian television actors, Australian stage actors, Australian voice actors, Actors from Perth, Western Australia, Emmy Award winning actors, BAFTA Award winning actors, Golden Globe Award winning actors
Pithecopus azureus	Frogs, Animals of South America
Marcel Henry	1926 births, 2021 deaths, French politicians
List of state leaders in 1950	1950
Pithecopus	Frogs, Animals of South America
Ferhan Şensoy	1951 births, 2021 deaths, Turkish movie actors, Turkish stage actors, Turkish television actors, Turkish writers, Theatre directors, Playwrights
Kazimieras Motieka	1929 births, 2021 deaths, Lithuanian politicians, Lawyers, People from Vilnius
Geronimo (alpaca)	2013 births, 2021 deaths, Deaths by euthanasia, Individual animals
Dimitri Kitsikis	1935 births, 2021 deaths, Greek writers, Academics, Historians
Jean-Pierre Bastiani	1950 births, 2021 deaths, People from Toulouse, French mayors
Vasile Belous	1988 births, 2021 deaths, Moldovan people, European sportspeople, Road accident deaths, Olympians
Graham Greene (actor)	1952 births, Living people, Canadian movie actors, Canadian voice actors, Canadian television actors, Canadian stage actors, Actors from Hamilton, Grammy Award winners
Chamo	Hotels, hotels in Guria, Georgia (country)
List of state leaders in 1951	1951
List of state leaders in 1952	1952
List of state leaders in 1953	1953
List of state leaders in 1954	1954
List of state leaders in 1955	1955
List of state leaders in 1956	1956
List of state leaders in 1957	1957
List of state leaders in 1958	1958
List of state leaders in 1959	1959
Chatham oystercatcher	Birds of New Zealand
Junior Coffey	1942 births, 2021 deaths, Green Bay Packers players, Atlanta Falcons players, New York Giants players, Deaths from heart failure, American football running backs, Sportspeople from Texas
José María Libório Camino Saracho	1931 births, 2021 deaths, Roman Catholic bishops, Spanish Roman Catholics, People from São Paulo, Deaths from stroke
Santurtzi	Cities in the Basque Country, Municipalities in the Basque Country
Jacques Drouin	1943 births, 2021 deaths, Canadian animators, Canadian movie directors, People from Quebec
Léopold K. Fakambi	1942 births, 2021 deaths, Beninese people, African scientists, Engineers, Academics
Only Murders in the Building	2021 television series debuts, American comedy television series, American crime television series, American mystery television series, Television series set in New York City
Street Corner (1948 film)	1948 movies, 1940s drama movies, American drama movies, Movies directed by Albert H. Kelley
New Augusta, Mississippi	Towns in Mississippi, County seats in Mississippi
Magnolia, Mississippi	Cities in Mississippi, County seats in Mississippi
Flowood, Mississippi	Cities in Mississippi
Richland, Mississippi	Cities in Mississippi
Forest, Mississippi	Cities in Mississippi, County seats in Mississippi
Morton, Mississippi	Cities in Mississippi
Rolling Fork, Mississippi	Cities in Mississippi, County seats in Mississippi
Mendenhall, Mississippi	Cities in Mississippi, County seats in Mississippi
Magee, Mississippi	Cities in Mississippi
Telefe Santa Fe	Television stations in Argentina, Television channels and stations established in 1966, Telefe
List of Bangladeshi people	Lists of Bangladeshi people
Bloody Roar (series)	Video game series
List of Bangladeshi actors	Bangladeshi actors, Lists of actors by nationality, Lists of Bangladeshi people by occupation
Clock Tower 3	2002 video games, PlayStation 2-only games, Video game sequels, Video games developed in Japan
All-Star Baseball	Video game series
All Star Baseball	Board games, Baseball
The Man from Colorado	1948 movies, 1940s western movies, American western movies, Movies directed by Henry Levin
Kaun Banega Crorepati	Hindi-language television series, Indian television series
Excellent Cadaver	Movie studios
A Bill of Divorcement (1932 movie)	1932 movies, 1930s drama movies, American drama movies, Movies based on plays, Movies directed by George Cukor
Chessington World of Adventures	Theme parks, 1987 establishments in England, Buildings and structures in London, Tourism, Royal Borough of Kingston upon Thames
Phyllomedusa burmeisteri	Frogs, Animals of South America
Kachin State	States of Myanmar
Tapta	Meitei folklore, Meitei literature
Annamalai Kuppusamy	Bharatiya Janata Party politicians, Indian politicians, Tamil Nadu politicians, Police officers, Civil servants, Indian Hindus, 1984 births, Indian activists, Living people
Imre Festetics	1764 births, 1847 deaths, Hungarian scientists, Genetics
Shibari	BDSM, Sexuality, Japanese culture
2021 evacuation from Afghanistan	August 2021 events
Thompson Usiyan	1956 births, 2021 deaths, Nigerian footballers
Roman Malinowski	1935 births, 2021 deaths, Polish economists, Marshals of the Sejm
Léon Aimé	1924 births, 2021 deaths, French politicians
The Amboy Dukes	Musical groups from Chicago
Michael Gage (politician)	1945 births, 2021 deaths, Cancer deaths in the United States, State legislators of the United States, Politicians from California, People from Glendale, California, US Democratic Party politicians
Stephen Wiesner	American physicists, Israeli scientists, 1942 births, 2021 deaths, American academics, Israeli academics, Naturalized citizens of Israel
Leopoldo Serantes	1962 births, 2021 deaths, Filipino sportspeople, Olympic bronze medalists, Boxers, Deaths from COPD
José Gonçalves Heleno	1927 births, 2021 deaths, Deaths from stroke, Brazilian people, Roman Catholic bishops
Caratinga	Cities in Minas Gerais
Syed Ali Shah Geelani	1929 births, 2021 deaths, Indian politicians, Indian activists, Deaths from kidney cancer, Deaths from pneumonia
Caldor Fire	August 2021 events, September 2021 events
Nia DaCosta	1989 births, Living people, American television directors, Movie directors from New York City, Screenwriters from New York City, African American movie directors, African-American screenwriters
1002 (number)	Numbers
TIE fighter	Star Wars vehicles
Primary production	Ecology, Plants, Photosynthesis
Adam and Eve (1923 movie)	1923 movies, 1920s drama movies, German silent movies, German drama movies, Movies directed by Reinhold Schünzel
Jay McGraw	1979 births, Living people, American television talk show hosts, American chief executives, American aviators
Fabio Raffaeli	Italian businesspeople, Living people, 1986 births
Central Airport (movie)	1933 movies, 1930s adventure movies, 1930s drama movies, American adventure movies, American drama movies, Warner Bros. movies, Movies directed by Alfred E. Green, Movies directed by William A. Wellman
Tropical Storm Washi	2011 disasters
Phyllomedusa sauvagii	Frogs, Animals of South America
Mandobass	Plucked string instruments
Peridontitis	Dentistry
Kali Linux	Linux distributions
Anna Cataldi	1939 births, 2021 deaths, Italian journalists, Italian movie producers, Humanitarians, People from Turin, Deaths from the COVID-19 pandemic in Italy
Carol Fran	1933 births, 2021 deaths, Deaths from the COVID-19 pandemic in the United States, American blues singers, American blues musicians, American pop singers, American pop musicians, American soul singers, American soul musicians, American pianists, American singer-songwriters, Musicians from Louisiana, Singers from Louisiana, Writers from Louisiana, People from Lafayette, Louisiana
Doug Green (Ohio politician)	1950s births, 2021 deaths, State legislators of the United States, Politicians from Ohio, US Republican Party politicians, Deaths from the COVID-19 pandemic in the United States
Mount Orab, Ohio	Villages in Ohio
Norbert Klein (politician)	1956 births, 2021 deaths, Members of the House of Representatives of the Netherlands
Hoevelaken	Settlements in Gelderland, Former municipalities of Gelderland
Norberto Mario Oyarbide	Argentine judges, 1951 births, 2021 deaths, Argentine lawyers, Argentine politicians, Judges, Deaths from the COVID-19 pandemic in Argentina
Concepción del Uruguay	Cities in Argentina
Juan Rodríguez Vega	1944 births, 2021 deaths, Chilean footballers, People from Santiago
Daffney	1975 births, 2021 deaths, People who committed suicide, American professional wrestlers, American movie actors, Sportspeople from Georgia (U.S. state), Actors from Georgia (U.S. state), Sportspeople from Alaska, Actors from Alaska, Suicides by firearm in the United States
Keith McCants	1968 births, 2021 deaths, American football linebackers, Tampa Bay Buccaneers players, Tennessee Titans players, Arizona Cardinals players, Sportspeople from Alabama, People from Mobile, Alabama, American radio personalities, American sports commentators, Drug-related deaths in the United States
Josephine Medina	1970 births, 2021 deaths, Filipino sportspeople, Paralympic bronze medalists, Tennis players
2016 Summer Paralympics	September 2016 events
Ataullah Mengal	1929 births, 2021 deaths, Deaths from cardiac arrest, Pakistani politicians
Chandan Mitra	1955 births, 2021 deaths, Indian journalists, Indian politicians
Sidharth Shukla	1980 births, 2021 deaths, Deaths from myocardial infarction, Indian movie actors, Indian television actors, Indian voice actors, Indian models, Actors from Mumbai
Hashibur Rahman Swapon	1954 births, 2021 deaths, Deaths from the COVID-19 pandemic in Turkey, Pakistani politicians, Bangladeshi politicians
Ken Rosewall	1934 births, Living people, Australian tennis players, Sportspeople from Sydney
Satch Sanders	1938 births, Living people, Boston Celtics players, National Basketball Association coaches, Sportspeople from New York City
Richard Serra	1938 births, Living people, American artists, People from San Francisco
Kenny Moore	1943 births, Living people, American track and field athletes, Sportspeople from Portland, Oregon, American Olympians
Cliff Hagan	1931 births, Living people, San Antonio Spurs players, Atlanta Hawks players, People from Owensboro, Kentucky, Sportspeople from Kentucky
Arthur Scargill	1938 births, Living people, British activists, Trade unionists, People from Yorkshire
Cesare Maniago	1939 births, Living people, Canadian ice hockey goaltenders, Toronto Maple Leafs players, Montreal Canadiens players, New York Rangers players, Minnesota North Stars players, Vancouver Canucks players, Ice hockey people from British Columbia
Bobby Goldsboro	1941 births, Living people, American pop singers, American country guitarists, American pop musicians, American painters, American television producers, Singers from Florida, Writers from Florida, Musicians from Florida
Nick Holonyak	1928 births, Living people, American engineers, American educators, American inventors, Scientists from Illinois, Writers from Illinois
Max Morath	1926 births, Living people, American pianists, American composers, American movie actors, Writers from Colorado, Actors from Colorado, Musicians from Colorado, People from Colorado Springs, Colorado
Carl Erskine	1926 births, Living people, Brooklyn Dodgers players, Los Angeles Dodgers players, Sportspeople from Indiana
George Wein	1925 births, 2021 deaths, American jazz musicians, American jazz singers, Musicians from Boston, Massachusetts, Singers from Boston, Massachusetts
William P. Murphy Jr.	1923 births, Living people, American physicians, American inventors, Scientists from Boston, Massachusetts, Businesspeople from Boston, Massachusetts
Louis Danziger	1923 births, Living people, American teachers, Artists from New York City
Rudolph Pariser	1923 births, Living people, Chinese scientists, American physicists, American chemists, Naturalized citizens of the United States
Dave Bolen	1923 births, Living people, Ambassadors of the United States, American track and field athletes, American Olympians, Politicians from Louisiana, Businesspeople from Louisiana, Sportspeople from Louisiana
Earl P. Yates	1923 births, Living people, People from Winston-Salem, North Carolina, American military personnel of World War II
The Doctor's Dilemma (movie)	1958 drama movies, British drama movies, Movies based on plays, MGM movies, Movies directed by Anthony Asquith
Justin Chatwin	1982 births, Living people, Canadian movie actors, Canadian television actors, Canadian voice actors, Canadian stage actors, Actors from British Columbia
Ryan Newman (actress)	1998 births, Living people, American movie actors, American television actors, American stage actors, American voice actors, Actors from California, Models from California
Nick Searcy	1959 births, Living people, American movie actors, American television actors, American stage actors, American voice actors, Actors from North Carolina
Cullowhee, North Carolina	Census-designated places in North Carolina
Bryson City, North Carolina	Towns in North Carolina, County seats in North Carolina
Sylva, North Carolina	Towns in North Carolina, County seats in North Carolina
Webster, North Carolina	Towns in North Carolina
Argentinian Mastiff	Dog breeds
Fila Brasileiro	Dog breeds
Pyrenean Mastiff	Dog breeds
Spanish Mastiff	Dog breeds
American Bulldog	Dog breeds
Milpitas Unified School District	Santa Clara County, California
Destroyer (1943 movie)	1943 movies, 1940s war movies, 1940s adventure movies, American war movies, American adventure movies, World War II movies, Movies directed by William A. Seiter
Dennis Frederiksen	1951 births, 2014 deaths, Deaths from liver cancer, American rock singers, American pop singers, American singer-songwriters, Singers from Grand Rapids, Michigan, Musicians from Grand Rapids, Michigan, Writers from Grand Rapids, Michigan
Julie Ditty	1979 births, 2021 deaths, Cancer deaths in the United States, American tennis players, Sportspeople from Atlanta, Georgia
Aferim!	2015 drama movies, 2010s western movies, Romanian movies, Czech movies, Bulgarian movies, French drama movies, Movies directed by Radu Jude
Cahill U.S. Marshal	1970s western movies, 1976 movies, American western movies, Movies directed by Andrew V. McLaglen
Louise Sauvage	Australian Paralympic gold medalists
2021 Liberal Democratic Party (Japan) leadership election	September 2021 events
Sanae Takaichi	1961 births, Living people, Japanese politicians
2021 Auckland Countdown stabbing	21st century in Oceania, Attacks on shops, Auckland, History of New Zealand, Islamic State, Islamic terrorist incidents in the 2020s, Mass stabbings, September 2021 events, Terrorist incidents in 2021
Radio Caroline	1964 establishments in the United Kingdom
2021 Norwegian parliamentary election	21st century in Norway, 2021 in Europe, 2021 elections, September 2021 events
Alexandria Again and Forever	1989 comedy movies, Egyptian movies, French comedy movies, Movies directed by Youssef Chahine
2021 Icelandic parliamentary election	21st century in Iceland, 2021 in Europe, 2021 elections, September 2021 events
Basij	Iran
Hassan Firouzabadi	1951 births, 2021 deaths, Iranian military people, Generals
Executive Office of the President of the United States	United States Executive Cabinet
John C. Inglis	1954 births, Living people, American generals, Politicians from Baltimore, Maryland, US Democratic Party politicians
Toshimitsu Motegi	1955 births, Living people, Japanese politicians
François-Philippe Champagne	1970 births, Living people, Politicians from Quebec
Marc Garneau	1949 births, Living people, Canadian astronauts, Politicians from Quebec
Mohamed al-Menfi	1976 births, Living people, Heads of state of Libya, Ambassadors, Current national leaders
Abdul Hamid Dbeibeh	1958 births, Living people, Prime Ministers of Libya
Abdul Ati al-Obeidi	1939 births, Living people, Prime Ministers of Libya, Heads of state of Libya, Ambassadors
Muhammad az-Zaruq Rajab	Prime Ministers of Libya, 1940 births, Living people, Heads of state of Libya
Mohammed Ali Salim	1935 births, Heads of state of Libya, Living people
Mohammed Magariaf	1940 births, Living people, Heads of state of Libya, Ambassadors, Economists
James Badge Dale	1978 births, Living people, American child actors, American movie actors, American television actors, American stage actors, American voice actors, Actors from Manhattan
Grover Dale	1935 births, Living people, American dancers, American choreographers, American theatre directors, American movie actors, American stage actors, American television actors, LGBT directors, LGBT dancers, LGBT actors, Bisexual people, LGBT people from Pennsylvania, Actors from Pennsylvania, People from Harrisburg, Pennsylvania
Aydin Ibrahimov	1938 births, 2021 deaths, Soviet Olympic medalists, Azerbaijani sportspeople, Wrestlers, Deaths from the COVID-19 pandemic
Paul Chillan	2021 deaths, 1935 births, French footballers
La Trinité, Martinique	Communes in Martinique
AC Arlésien	1910s establishments in France, 1913 establishments in Europe, French football clubs, Arles
Alemayehu Eshete	1941 births, 2021 deaths, Jazz singers, Ethiopian people, African entertainers, Deaths from myocardial infarction
The Forgiveness of Blood	2011 drama movies, Albanian movies, American drama movies, Italian drama movies, Danish movies, British drama movies, Movies directed by Joshua Marston
Enrique Molina (actor)	1944 births, 2021 deaths, Deaths from the COVID-19 pandemic, Cuban actors
Britt McHenry	1986 births, Living people, Cancer survivors, American sports commentators, Journalists from New Jersey, American television presenters, Writers from Washington, D.C.
Rosario Murillo	1951 births, Living people, Vice Presidents of Nicaragua, First Ladies
Jaime Morales Carazo	Living people, 1936 births, Vice Presidents of Nicaragua
National Assembly (Nicaragua)	Nicaragua
Vice President of Nicaragua	Vice Presidents of Nicaragua
Moises Omar Halleslevens Acevedo	1949 births, Living people, Vice Presidents of Nicaragua
Jeanne Wakatsuki Houston	1934 births, Living people, American autobiographers, Writers from Los Angeles County, California, People from Inglewood, California
Benjamin Wallfisch	1979 births, Living people, British composers, British conductors, British pianists, British guitarists, British drummers, Musicians from London, Writers from London
Takako Shimazu	1939 births, Living people, Princes and princesses, People from Tokyo
Empress Kōjun	1903 births, 2000 deaths, People from Tokyo, Deaths from respiratory failure, Princes and princesses
U-Force	Video game controllers
Abdus Sattar	Bangladeshi politicians, 1st Jatiya Sangsad members, Possibly living people
Jatiya Samajtantrik Dal	Political parties in Bangladesh
Dawn of Chromatica	2021 albums, Lady Gaga albums, Remix albums
Taslima Abed	Bangladeshi politicians, Possibly living people
Turbotronic	Joysticks, Video game controllers
2021 International Mathematical Olympiad	Russia, COVID-19 pandemic
Foot per second squared	Units of measurement
Moonlet	Moons
List of adjectivals and demonyms of astronomical bodies	Astronomy-related lists
Agrana	1988 establishments, Companies of Austria
1897 International Congress of Mathematicians	1897, Switzerland, Zürich
The Astrophysical Journal	Journals
1900 International Congress of Mathematicians	1900, Paris
Synodic day	Units of time
Semantic Scholar	Search engines
Bibcode	Reference works
Phyllomedusa tarsius	Frogs, Animals of South America
Mithridates VI Eupator	History of Greece
Michel Corboz	1934 births, 2021 deaths, Swiss people, Conductors
David Patten	1974 births, 2021 deaths, Road accident deaths in the United States, American football wide receivers, Washington Redskins players, New Orleans Saints players, Cleveland Browns players, New England Patriots players, Sportspeople from South Carolina
West Coast Railways	Post-privatisation British railway companies, 1998 establishments in England
Muhammad Saeed al-Hakim	1936 births, 2021 deaths, Deaths from myocardial infarction, Iraqi people, Crime victims, Religious leaders
Sérgio Mamberti	1939 births, 2021 deaths, Deaths from multiple organ failure, Brazilian movie actors, Brazilian television actors, Brazilian stage actors, Brazilian movie directors, Brazilian movie producers, Brazilian writers, Brazilian politicians, Playwrights, People from São Paulo
Tim McCarver	1941 births, Living people, St. Louis Cardinals players, Philadelphia Phillies players, Montreal Expos players, Boston Red Sox players, Sportspeople from Memphis, Tennessee, American sports commentators
Donna McKechnie	Tony Award winning actors, Drama Desk Award winners, 1942 births, Living people, American movie actors, American television actors, American stage actors, American dancers, American choreographers, Singers from Detroit, Michigan, Actors from Detroit, Michigan, Writers from Detroit, Michigan, People from Pontiac, Michigan
Paul Cameron	1939 births, Living people, American psychologists, American political activists, American conservatives, Scientists from Pittsburgh, Pennsylvania, Scientists from Nebraska
Robert Foxworth	1941 births, Living people, American movie actors, American television actors, American stage actors, American voice actors, Actors from Houston, Texas
Shinjirō Koizumi	1981 births, Living people, Japanese politicians
Hoensbroek	Settlements in Limburg (Netherlands), Former municipalities of Limburg (Netherlands)
Albert B. Lewis	1925 births, 2021 deaths, Deaths from Alzheimer's disease, State legislators of the United States, Politicians from New York City, Businesspeople from New York City, American lawyers, US Democratic Party politicians
Fair Oaks, California	Census-designated places in California, Settlements in Sacramento County, California
Phyllomedusa venusta	Frogs, Animals of South America
Variable oystercatcher	Birds of New Zealand
The Harder They Fall	1956 drama movies, 1950s crime movies, American crime drama movies, Movies directed by Mark Robson, Movies based on books
Undertow (1949 movie)	1949 movies, 1940s crime movies, 1940s thriller movies, American crime thriller movies, Movies directed by William Castle
Investireadubai.com	Websites, Dubai
Just Before Dawn (1946 movie)	1946 movies, 1940s crime movies, 1940s mystery movies, American crime movies, American mystery movies, Movies directed by William Castle
Perodua Kancil	Automobiles
Phyllomedusa camba	Frogs, Animals of South America
Henriette Valium	1959 births, 2021 deaths, Cartoonists, Comics artists, Comics writers, Writers from Montreal
Naja	Elapidae
Brolga	Birds of Australia
6 (New York City Subway service)	New York City Subway
Superstore (TV series)	English-language television programs, 2015 American television series debuts, 2020s disestablishments, LGBT comedy television series
TALENs	Genetic engineering
Rape culture	Rape, Cultural studies
Najibullah	Arabic-language surnames, Arabic masculine given names
Spring Ridge, Louisiana	Unincorporated communities in Louisiana, Settlements in Caddo Parish, Louisiana
Sexual fantasy	Fantasy
Women in prison movie	Movie genres
The Night Manager (miniseries)	Amazon (company)
J.I the Prince of N.Y	Living people, American rap musicians
Naked Childhood	1968 drama movies, French drama movies, Movies directed by Maurice Pialat
The Mouth Agape	1974 drama movies, French drama movies, Movies directed by Maurice Pialat
Eastern Region, Venezuela	Venezuela
1995 Algarve Cup	1995 in association football
Sam Hill (euphemism)	Language
1996 Algarve Cup	1996 in association football
Betty Archdale	1907 births, 2000 deaths, Australian educators, English cricketers
Yenakha Paodabi	Meitei folklore, Meitei literature, Meitei mythology, Meitei religion
Lani Misalucha	Soul musicians, Rock singers, R&B musicians, People from Manila, Pop singers, Filipino singers, Asian opera singers, 1969 births, Living people
Jos Verstappen	24 Hours of Le Mans drivers, 1972 births, Living people, Formula One drivers
White-lined leaf frog	Frogs, Animals of South America
Bihari Hindus	Hindus, Hinduism in South Asia
Live Nation Entertainment	2010 establishments in the United States
Delaplane, Virginia	Unincorporated communities in Virginia
Manuel Soares Costa	1933 births, 2021 deaths, Portuguese politicians, Academics
Rune Gerhardsen	1946 births, 2021 deaths, Politicians from Oslo, Mayors
Tunch Ilkin	1957 births, 2021 deaths, Pittsburgh Pirates players, Green Bay Packers players, American sports commentators, American football offensive tackles, Turkish sportspeople, People from Istanbul, Naturalized citizens of the United States, Deaths from motor neurone disease
Ion Caramitru	1942 births, 2021 deaths, Romanian movie actors, Romanian politicians, Theatre directors, Romanian stage actors, People from Bucharest
Ivan Patzaichin	1949 births, 2021 deaths, Deaths from lung cancer, Sportspeople from Bucharest, Olympic gold medalists, Olympic silver medalists
Phạm Minh Chính	Living people, 1959 births, Prime Ministers of Vietnam
Phạm Hùng	1912 births, 1988 deaths, Prime Ministers of Vietnam
Võ Chí Công	1912 births, 2011 deaths, Presidents of Vietnam
Trường Chinh	1907 births, 1988 deaths, Presidents of Vietnam, General Secretaries of the Central Committee of the Communist Party of Vietnam
Nguyễn Hữu Thọ	1910 births, 1996 deaths, Presidents of Vietnam, Vice Presidents of Vietnam
Vice President of Vietnam	Vice Presidents of Vietnam
Võ Thị Ánh Xuân	Vice Presidents of Vietnam, 1970 births, Living people
Tôn Đức Thắng	1888 births, 1980 deaths, Presidents of Vietnam, Vice Presidents of Vietnam
Mamady Doumbouya	1980 births, Living people, Presidents of Guinea, Military people, Current national leaders
Sékouba Konaté	1964 births, Living people, Presidents of Guinea
Moussa Dadis Camara	1964 births, Presidents of Guinea, Living people
Lansana Conté	1934 births, 2008 deaths, Presidents of Guinea
Ahmed Sékou Touré	1922 births, 1984 deaths, Presidents of Guinea, Prime Ministers of Guinea, Dictators
2021 Guinean coup d'état	2021 in Africa, Coups d'état, Guinea, September 2021 events
Christy Dignam	1960 births, Living people, People with cancer, Irish rock musicians, Irish singer-songwriters, Musicians from Dublin, Singers from Dublin, Writers from Dublin
Panorama Tower	Buildings and structures in Miami, Florida
One Bayfront Plaza	Buildings and structures in Miami, Florida, Proposed skyscrapers in the United States
Consanguinamory	Relationships, Human sexuality, Incest
Movie Star Inc.	Companies based in New York City, Clothing companies
Movie Stars	1990s American sitcoms, 2000s American sitcoms, English-language television programs, The WB original programming
Lai Khutsangbi	Meitei folklore, Meitei literature, Meitei mythology
João Sayad	1945 births, 2021 deaths, Brazilian economists, Academics, People from São Paulo, Deaths from blood cancer
Billy Apple	1935 births, 2021 deaths, New Zealand artists, People from Auckland
Assembly of Vojvodina	Serbia
Sándor Egeresi	1964 births, 2021 deaths, Serbian politicians, Hungarian politicians, Legislative speakers
The Sea of Grass	1947 movies, 1940s western movies, 1940s drama movies, American western movies, American drama movies, MGM movies, Movies based on books, Movies directed by Elia Kazan
Zanele kaMagwaza-Msibi	Mayors, South African politicians, 2021 deaths, 1962 births, Deaths from the COVID-19 pandemic in South Africa
Iván Vitányi	1925 births, 2021 deaths, Hungarian politicians, Hungarian writers, Philosophers, Essayists, Hungarian scientists, Sociologists
György Faludy	1910 births, 2006 deaths, Bisexual Jews, Hungarian Jews, Hungarian writers, LGBT writers, People from Budapest, Hungarian poets, LGBT poets
Imre Mécs	1933 births, Living people, Hungarian politicians, People from Budapest
Kayin State	Pages using infobox settlement with possible demonym list, Coordinates on Wikidata, Articles containing Burmese-language text, States of Myanmar
Klára Dobrev	1972 births, Living people, Hungarian politicians, Members of the European Parliament
Lee Jae-myung	1964 births, Living people, South Korean politicians, Mayors
Salaam Bombay!	1988 crime movies, 1988 drama movies, Indian movies, British crime drama movies, French crime movies, French drama movies, Canadian drama movies, Movies directed by Mira Nair
Domodedovo (town)	Towns in Russia
Skoda Lupo	1990s automobiles, 2000s automobiles, Volkswagen automobiles
Škoda Lupo	1990s automobiles, 2000s automobiles, Volkswagen automobiles
Beware of Pity	1946 movies, 1940s romance movies, 1940s drama movies, British romantic drama movies, Movies based on books, Movies directed by Maurice Elvey
Rom Houben	1963 births, Living people, Belgian people
Adonis Stevenson	Living people, 1977 births, Haitian people, Canadian boxers, Criminals, Sportspeople from Montreal
Nurul Huda Abdullah	1972 births, Living people, Malaysian sportspeople, Swimmers
Phyllomedusa trinitatis	Frogs, Animals of South America
James Hemings	1765 births, 1801 deaths, History, People from Virginia, Slaves
Maury Laws	1911 births, 2002 deaths, American movie score composers, Musicians from North Carolina, Musicians from Wisconsin, People from Appleton, Wisconsin, American songwriters
Tony Selby	1938 births, 2021 deaths, English movie actors, English television actors, English stage actors, Actors from London
Jan Hecker	1967 births, 2021 deaths, Ambassadors of Germany, German judges, German lawyers, People from Kiel, German academics
Trove	2009 establishments in Australia, Databases,  Wikipedia identifier articles
Bal Ganesh	2007 animated movies, Indian movies
If—	Poems
Greenwashing	Environmental issues, Green politics
Hindu deities	Hindu mythology
Flyby (spaceflight)	Astronomy, Pages with unreviewed translations
List of ongoing armed conflicts	Conflicts, History-related lists
Kira Girard	American television personalities, Living people
Nella Linhas Aéreas	Airlines of South America
South Kingstown, Rhode Island	Towns in Rhode Island, County seats in Rhode Island
Burke, Texas	Cities in Texas
Diboll, Texas	Cities in Texas
Hudson, Texas	Cities in Texas
Huntington, Texas	Cities in Texas
Zavalla, Texas	Cities in Texas
Animal Diversity Web	Biological databases, Wikipedia identifier articles
ARKive	Biological databases, Wikipedia identifier articles
Barcode of Life Data Systems	Biological databases, Wikipedia identifier articles
Xenosaga Freaks	2004 video games, Puzzle video games, Adventure games, PlayStation 2 games, PlayStation 2-only games, Video games developed in Japan, Japan exclusive video games, Compilation video games
Fossilworks	Biological databases, Wikipedia identifier articles
Interim Register of Marine and Nonmarine Genera	Biological databases, Wikipedia identifier articles
Matej Marin	1980 births, 2021 deaths, Slovenian sportspeople, Cyclists
Dan Swecker	1947 births, 2021 deaths, Deaths from the COVID-19 pandemic in the United States, Deaths from pneumonia, State legislators of the United States, Politicians from Montana, Politicians from Washington, US Republican Party politicians, People from Bozeman, Montana
Léonard Groguhet	1939 births, 2021 deaths, Ivorian people, African actors, Comedians
Jörg Schlaich	1934 births, 2021 deaths, German engineers, People from Baden-Württemberg
Olympiastadion (Munich)	Buildings and structures in Munich, Football stadiums in Germany, Sport in Munich
Mercedes-Benz Arena (Stuttgart)	Football stadiums in Germany, Buildings and structures in Baden-Württemberg, Stuttgart
Albert Giger	1946 births, 2021 deaths, Swiss Olympic medalists, Olympic bronze medalists, Skiers
Penne-d'Agenais	Communes in Lot-et-Garonne
Marcel Garrouste	1921 births, 2021 deaths, French mayors, French centenarians
Claude Azéma	1943 births, 2021 deaths, French Roman Catholics, Roman Catholic bishops
Vailhauquès	Communes in Hérault
In the Line of Fire	1993 action movies, 1993 thriller movies, 1990s action thriller movies, American action thriller movies, Movies set in Washington, D.C., Movies set in Los Angeles, California, Movies set in Chicago, Illinois, Columbia Pictures movies, Movies directed by Wolfgang Petersen, English-language movies
Carlos Vila Nova	1959 births, Living people, African politicians
Ernie Watts	1945 births, Living people, American jazz musicians, American R&B musicians, American saxophonists, Musicians from Virginia, People from Norfolk, Virginia
Jack Rule Jr.	1938 births, Living people, American golfers, Sportspeople from Iowa, People from Waterloo, Iowa
William Taubman	1941 births, Living people, American political scientists, Pulitzer Prize winners, Writers from New York City
Gilbert Strang	1934 births, Living people, American mathematicians, American academics, Writers from Chicago
Dave Giusti	1939 births, Living people, Houston Astros players, St. Louis Cardinals players, Pittsburgh Pirates players, Oakland Athletics players, Chicago Cubs players, Sportspeople from New York
Seneca Falls (CDP), New York	Census-designated places in New York (state)
Seneca Falls, New York	Towns in New York
Nicole Brossard	1943 births, Living people, French poets, French novelists, Writers from Montreal, Feminist writers
Randy Brecker	1945 births, Living people, Grammy Award winners, American jazz musicians, American funk musicians, American R&B musicians, American rock musicians, Musicians from Pennsylvania
Cheltenham Township, Montgomery County, Pennsylvania	Townships in Pennsylvania
Elkins Park, Pennsylvania	Census-designated places in Pennsylvania, Unincorporated communities in Pennsylvania
Joe Pepitone	1940 births, Living people, New York Yankees players, Houston Astros players, Chicago Cubs players, Atlanta Braves players, Sportspeople from Brooklyn
Acute coronary syndrome	Syndromes
Chest pain	Medical emergencies
Coronary arteries	Blood vessels
Keshav Desiraju	1955 births, 2021 deaths, Deaths from coronary artery disease, Indian activists, Indian politicians, People from Bombay
E. William Henry	1929 births, Living people, Chairmen of the Federal Communications Commission, US Democratic Party politicians
Charles D. Ferris	Living people, 1933 births, American lawyers, Chairmen of the Federal Communications Commission, Politicians from Boston, Massachusetts, US Democratic Party politicians
Michael Copps	1940 births, Living people, Chairmen of the Federal Communications Commission, Politicians from Milwaukee, Wisconsin, US Democratic Party politicians
List of chairmen of the Federal Communications Commission	Chairmen of the Federal Communications Commission
Street Fighter IV	2008 video games, Arcade games, Android (operating system) games, Capcom games, Fighting games, PlayStation 3 games, Street Fighter video games, Video game sequels, Video games developed in Japan, Windows games, Xbox 360 games
Frank Plumpton Ramsey	1903 births, 1930 deaths, British mathematicians, English writers, English philosophers, English mathematicians, Essayists, Analytic philosophers, British economists, English atheists, People from Cambridge
After Love (1948 movie)	1948 movies, 1940s drama movies, French drama movies, Movies based on plays, Movies directed by Maurice Tourneur
Hanuba Hanubi Paan Thaaba	Meitei folklore, Meitei literature, Meitei mythology
File inclusion vulnerability	Internet security
Trémons	Communes in Lot-et-Garonne
Eugene N. Borza	1935 births, 2021 deaths, American historians, American academics, Writers from Cleveland, Ohio, Writers from Pennsylvania
Enrique González Pedrero	1930 births, 2021 deaths, Mexican politicians, Mexican writers, Political writers, Ambassadors of Mexico
Villahermosa	Capital cities in Mexico, Tabasco (state)
Pflugerville, Texas	Cities in Texas
Only God Forgives	2013 action movies, 2013 crime movies, 2013 drama movies, Danish movies, French action movies, French crime movies, French drama movies, American action movies, American crime drama movies, Swedish movies, Belgian movies, Thai movies, Movies directed by Nicolas Winding Refn
Phyllomedusa bahiana	Frogs, Animals of South America
Asiatic Society of Bangladesh	1952 establishments in Asia
Zahra Rahnavard	1945 births, Living people, Iranian Muslims, Iranian politicians
Edgar de Wahl	1867 births, 1948 deaths, Interlingue, Linguists, Mathematicians
Interlingue-Union	Interlingue
Ameer Zaman	1956 births, 2021 deaths, Pakistani politicians
Sam Cunningham	1950 births, 2021 deaths, American football fullbacks, New England Patriots players, Sportspeople from California, People from Santa Barbara, California
Jahangir Butt	1943 births, 2021 deaths, Pakistani people, Olympic gold medalists, Olympic silver medalists, Ice hockey players
Black Oak Arkansas	Musicians from Arkansas, American rock bands, 1963 establishments
Severian Yakymyshyn	1930 births, 2021 deaths, Bishops, People from Alberta, People from Vancouver
Adam Baumann	1948 births, 2021 deaths, Polish movie actors, Polish television actors, Polish stage actors
Grudziądz	Cities in Poland
Nino Castelnuovo	1936 births, 2021 deaths, Italian movie actors, Italian television actors, Italian stage actors, Italian voice actors, Disease-related deaths in Rome
Doug Ose	1955 births, Living people, United States representatives from California, Businesspeople from California, Politicians from Sacramento, California, US Republican Party politicians
Carmine Infantino	1925 births, 2013 deaths, American comics artists, American editors, Artists from New York City
Rescue Union School District	El Dorado County, California
Paul Belmondo	1963 births, Living people, Formula One drivers, French sportspeople, People from Hauts-de-France
Pascale Petit (actress)	1938 births, Living people, French movie actors, French television actors, French stage actors, Actors from Paris
Fabio Testi	1941 births, Living people, Italian movie actors, Italian stage actors, Stuntmen
Peschiera del Garda	Settlements in Veneto
Tony Maudsley	1968 births, Living people, English television actors, English movie actors, Actors from Liverpool
Paula Wilcox	1949 births, Living people, English television actors, English stage actors, Actors from Manchester
Nash, Texas	Cities in Texas
Red Lick, Texas	Cities in Texas
Redwater, Texas	Cities in Texas
Phyllomedusa chaparroi	Frogs, Animals of South America
United Nations Parliamentary Assembly	United Nations
Carole Bouquet	1957 births, Living people, French movie actors, French television actors, French stage actors, French models
Sebastian Roché	1964 births, Living people, French movie actors, French television actors, French stage actors, French voice actors, Actors from Paris
Céline Sallette	1980 births, Living people, French movie actors, French television actors, French stage actors, French voice actors, People from Bordeaux
Olivier Martinez	1966 births, Living people, French movie actors, French television actors, French stage actors, French voice actors, Actors from Paris
Asia Kate Dillon	1984 births, Living people, American movie actors, American television actors, American voice actors, LGBT actors, LGBT people from New York City, Actors from New York City, People from Ithaca, New York, Pansexual people, People with non-binary gender identities
Amber Ruffin	1979 births, Living people, American television presenters, American television writers, American playwrights, American movie actors, American television actors, Comedians from Nebraska, Writers from Omaha, Nebraska, Actors from Omaha, Nebraska
Peacock (streaming service)	NBC
Raymond Hood	1881 births, 1934 deaths, American architects, People from Pawtucket, Rhode Island
Khamen Chatpa	Meitei culture, Meitei clothing, Meitei religion
American Radiator Building	Buildings and structures in New York City
J. André Fouilhoux	1879 births, 1945 deaths, Accidental deaths from falls in the United States, French architects, American architects, Naturalized citizens of the United States, People from Paris
Daily News Building	Skyscrapers in New York City, Buildings and structures in Manhattan
Arkhangelsk	Capital cities in Russia
Ufology	UFOs, Pseudoscience
Kajenglei	Meitei culture, Meitei clothing, Meitei religion
Hasan Akhund	Living people, 1940s births, 1950s births, Taliban, Prime Ministers of Afghanistan
Paolo Salvati	1939 births, 2014 deaths, Italian painters, Rome
Symbolic anthropology	Culture, Anthropology
Tolyatti	Cities in Russia
Antonio Roulet	Living people, Swiss musicians, British musicians
V(D)J recombination	Immunology, Blood cells
Phyllomedusa distincta	Frogs, Animals of South America
Mute R. Kelly	Sexual abuse, Feminism, Controversies, Companies based in Atlanta, Georgia, 2017 establishments in the United States
Black-winged stilt	Birds
Pheichom	Meitei culture, Meitei clothing
2016 Witney by-election	Elections in the United Kingdom, 2016 in the United Kingdom, Oxfordshire
Muhammad ibn al-Uthaymeen	1925 births, 2001 deaths, Saudi Arabian people, Imams

