Ichinobe-no Oshiwa	5th century births, 5th century deaths, Japanese imperial family, Accidental deaths
Dinosaur Ridge	Colorado, Dinosaurs of North America, Museums in the United States
Galaxy Nexus	Nexus mobile phones, Android smartphones, Mobile phones released in 2011
The Social Network	2010 drama movies, 2010s legal movies, Academy Award winning movies, American drama movies, American legal movies, English-language movies, Golden Globe Award winning movies, Movies directed by David Fincher, Movies set in California, Movies set in Massachusetts, Movies set in the 2000s, Movies set in 2004
Chaz Bono	American movie actors, American television actors, LGBT people from California, Actors from Los Angeles, California, Transgender and transsexual people, Participants in American reality television series, 1969 births, Living people
Last Friday Night (T.G.I.F.)	2011 songs, Katy Perry songs
Ying Yang Twins	American rap music groups, Musical groups from Atlanta, Georgia, Hip hop bands, Musical groups established in 1997, 1997 establishments in the United States, 1990s establishments in Georgia (U.S. state)
Dip slope	Geology
Mariner program	Mariner program
List of Harry Potter movie characters	Harry Potter characters, Lists of fictional characters
Paris-Charles de Gaulle Airport	Airports in France, Buildings and structures in Paris
Pouzolles	Communes in Hérault
Harima Province	Former provinces of Japan, Hyōgo Prefecture
Communauté de communes Coteaux et Châteaux	Communes in Hérault
Lord of the Flies	1954 books, English novels, English-language novels, William Golding
Child support	Family law
Emperor Ninmyō	Emperors of Japan, 810 births, 850 deaths
Natural deduction	Logic
John McCarthy	1927 births, 2011 deaths, American computer scientists, Scientists from Boston, Massachusetts
Hurricane Karl (2010)	Hurricanes in Mexico, 2010 in Mexico, 2010 in Belize, September 2010 events
Robert Pierpoint	American war correspondents, 1925 births, 2011 deaths, writers from Los Angeles, California
Emperor Montoku	Emperors of Japan, 827 births, 858 deaths
Xavier Tondo	1978 births, 2011 deaths, Accidental deaths in Spain, Spanish cyclists
Edmundo Ros	1910 births, 2011 deaths, Bandleaders
Liz Claiborne (fashion designer)	1929 births, 2007 deaths, American chief executives, American fashion designers, Cancer deaths in New York City, People from Brussels, Businesspeople from New Orleans, Louisiana
Liz Claiborne	Fashion houses, Companies based in New York City, 1976 establishments in New York (state)
Electrical outlet	Electrical wiring
Anemometer	Meteorology, Measuring tools
Nuclear magnetic resonance	Nuclear physics
Herbert A. Hauptman	1917 births, 2011 deaths, American atheists, American chemists, American mathematicians, American Nobel Prize winners, Columbia University alumni, Jewish American academics, Jewish American scientists, Jewish atheists, Jewish Nobel Prize winners, Scientists from New York City
Viking program	NASA programs, Mars
Piculet	Piciformes
Fallin' for You	2009 songs
Moulting	Developmental biology, Invertebrates
Detention (imprisonment)	Human rights, Torture, Imprisonment and detention
Charles III of Spain	1716 births, 1788 deaths, Kings and Queens of Spain, Bourbons of Naples and Sicily
Pope Paul V	Italian popes, People from Rome, 1552 births, 1621 deaths
Beavis and Butt-head	1993 American television series debuts, 2011 American television series endings, 1990s American sitcoms, 1990s animated television series, 1990s teen television series, 2010s American sitcoms, 2010s animated television series, 2010s teen television series, American animated television series, American teen television series, High school television series, Television series about friendship, Television series set in Texas, English-language television programs
1. Oberndorfer Sportklub 1920	Football clubs of Salzburg
Voynich manuscript	Manuscripts, Unreadable writing systems
Fixed point	Mathematics, Systems theory, Recursion
Emperor Seiwa	Emperors of Japan, 850 births, 880 deaths
Standard ML	Programming languages
Droste effect	Recursion
Already Gone	2009 songs, Kelly Clarkson songs
De Morgan's laws	Algebra, Logic gates
Tiberius Gracchus	Roman people, Roman Republic, 2nd century BC births, 2nd century BC deaths
Random walk	Mathematics
Constrictor knot	Binding knots
Waiting to Exhale	1995 movies, American romantic drama movies, English-language movies, Movies set in Arizona
Soho	City of Westminster, Red light districts
Herbert Art Gallery and Museum	Museums in England, Art museums in the United Kingdom
Zipf's law	Statistics, Linguistics
Steve Jones	1955 births, Living people, English rock guitarists, Musicians from London, Sex Pistols
Peter Tatsuo Doi	1892 births, 1970 deaths, Cardinals of the Roman Catholic Church, People from Sendai, Roman Catholic bishops
Stronger (Kelly Clarkson album)	Pop albums, 2011 albums
Henry Cooper	1934 births, 2011 deaths, British boxers, English Roman Catholics, Knights Bachelor, Officers of the Order of the British Empire, Sportspeople from London
Sierpinski triangle	Fractals
Morquio syndrome	Syndromes, Genetic disorders
My Life Would Suck Without You	2009 songs, Kelly Clarkson songs
Cyclops (character)	Marvel Comics superheroes
Because of You	2005 songs, Kelly Clarkson songs, 2000s ballads
Fast chess	Chess competitions
Tawny owl	Strigiformes
Wheeling, West Virginia	Cities in West Virginia, County seats in West Virginia, 1769 establishments in the Thirteen Colonies
Ocean acidification	Oceans, Environmental issues, Climate change
William Wallace Barron	1911 births, 2002 deaths
Turk Telekom Arena	Football stadiums in Turkey, Istanbul, 2011 establishments in Asia
Emperor Junnin	Emperors of Japan, 733 births, 765 deaths
Macaroni	Pasta
Fried chicken	Chicken as food
Jon Huntsman Jr.	1960 births, Living people, Ambassadors of the United States, Governors of Utah, Politicians from California, US Republican Party politicians, 2012 United States presidential candidates, People from Palo Alto, California, Politicians from Salt Lake City, Utah, People with cancer
Dame school	Schools
Marine (military)	Marines
Pope Paul I	700 births, 767 deaths, Italian popes
Rick Santorum	American lawyers, American political commentators, American Roman Catholics, Politicians from Virginia, United States representatives from Pennsylvania, United States senators from Pennsylvania, 2012 United States presidential candidates, 2016 United States presidential candidates, 1958 births, Living people
Pope Paul II	1417 births, 1471 deaths, Italian popes
Rechtsstaat	Law
Chatterbot	Software
Loebner prize	Science awards, Software
Tetration	Hyperoperations
Who Knew	2006 songs, Pink songs, Songs about drugs
Pope Paul IV	1476 births, 1559 deaths, Italian popes
Hyperoperation	Hyperoperations
Marry the Night	2011 songs
Joe Strummer	1952 births, 2002 deaths, British punk musicians, British rock musicians, Cardiovascular disease deaths in England, English guitarists, English singers, The Clash
Premise	Logic
Arturo Vidal	1987 births, Living people, Chilean footballers, People from Santiago
Simone Pepe	1983 births, Living people, Italian footballers
Quill	Writing tools
Flag of Kentucky	United States state flags, Kentucky
Illustrissimi	1978 books
Self-similarity	Fractals
Space Launch System	Artemis program, Orion program, Rockets
Knuth's up-arrow notation	Hyperoperations
Bernie Madoff	1938 births, 2021 deaths, American fraudsters, American prisoners, Businesspeople from New York City, Criminals from New York City, Deaths from kidney disease, Jewish American criminals, Jewish businesspeople, People from Queens, People with cancer, People who died in prison custody in the United States, Stockbrokers, Cardiovascular disease deaths in North Carolina, Deaths from hypertension
Duckboards	World War I
Twenty Questions	Games, English-language television programs
Bill Clements	1917 births, 2011 deaths, Deaths from natural causes, Governors of Texas, Politicians from Dallas, Texas
Jingle Bells	19th century American songs
I'll Be Home for Christmas	Christmas music
Jingle Bell Rock	Christmas music
Sam P. Chelladurai	Living people, Year of birth missing (living people), Indian people, Christian clergy
Rockin' Around the Christmas Tree	Christmas music
Seydou Keita	1980 births, Living people, Malian footballers, People from Bamako
Ibrahim Afellay	1986 births, Living people, Dutch footballers, Sportspeople from Utrecht (city)
Pope Paul	Papal names
Pope Pius	Papal names
Pope Pius II	1405 births, 1464 deaths, Italian popes
Peanut milk	Peanuts, Plant milks
Pope Pius III	Italian popes, People from Siena, 1439 births, 1503 deaths
Tidal stream power	Hydropower
Cliff-dwelling	Accommodations, Caves
Patty Smyth	Singers from New York City, 1957 births, Living people, American composers, American pop musicians, American rock musicians, American rock singers
Ohio County, West Virginia	West Virginia counties, 1776 establishments in the United States
U.S. Route 250	U.S. Highways
Pope Pius IV	Italian popes, House of Medici, 1499 births, 1565 deaths
Darlene Love	Actors from Los Angeles, California, African American actors, African-American singers, American movie actors, American television actors, Singers from Los Angeles, California, 1941 births, Living people
JSON	JavaScript
Baby, It's Cold Outside	Christmas music, Best Original Song Academy Award-winning songs, 1940s songs
Mesa, Colorado	Towns in Colorado
Mario Kart 7	2011 video games, Mario Kart games, Nintendo 3DS games, Racing video games, Vehicular combat games, Video games developed in Japan
I Saw Mommy Kissing Santa Claus	Christmas music
The Ronettes	1959 establishments in the United States, 1967 disestablishments, 1950s American music groups, 1960s American music groups, African-American musical groups, American pop music groups, Musical groups established in 1959, Musical groups from New York City, 1950s establishments in New York (state), 1960s disestablishments in New York (state)
Yahoo! Search	Websites, Search engines
Andretti Autosport	IndyCar Series
Royal Irish Constabulary	Law enforcement agencies of the United Kingdom, History of Ireland, Law enforcement in the United Kingdom, 1814 establishments, 1810s establishments in the United Kingdom, 1922 disestablishments in Europe, 1920s disestablishments in the United Kingdom
Sicel language	Indo-European languages, Sicily
The Closer I Get to You	Beyoncé songs, Rhythm and blues ballads, 1978 songs
Congo Free State	History of the Democratic Republic of the Congo, 1885 establishments, 1900s disestablishments in Africa
Flag of Ireland	National flags, Republic of Ireland
Gallipoli	Geography of Turkey
God Save the Queen (Sex Pistols song)	1977 songs, Sex Pistols
Wessex Sound Studios	Music industry
Dryosauridae	iguanodonts, Jurassic dinosaurs, Cretaceous dinosaurs
Pope Pius V	Italian popes, 1504 births, 1572 deaths
Poynings' Law	History of Ireland, 1495, 1490s in England
Zell Miller	1932 births, 2018 deaths, Governors of Georgia (U.S. state), United States senators from Georgia, US Democratic Party politicians, Deaths from Parkinson's disease
Jay Rockefeller	Living people, 1937 births, Governors of West Virginia, United States senators from West Virginia, Rockefeller family, People from New York City, US Democratic Party politicians
David Rockefeller	1915 births, 2017 deaths, Alumni of the London School of Economics, American billionaires, American centenarians, American philanthropists, Businesspeople from New York City, Deaths from congestive heart failure, Harvard University alumni, Rockefeller family, University of Chicago alumni
Pellegrino Ernetti	1925 births, 1994 deaths, Roman Catholic priests, Benedictines
Wilhelm Fliess	1858 births, 1928 deaths, German scientists
British South Africa Company	19th century in Africa, 1880s in the United Kingdom, Companies of the United Kingdom, 1889 establishments in the United Kingdom
Pope Pius VII	Italian popes, 1742 births, 1823 deaths, Benedictines
Paula Jones	People from Arkansas, 1966 births, Living people
Sexual harassment	Sexual abuse, Women's rights
Habitants	History of Canada
Natalie Cole	1950 births, 2015 deaths, Actors from Los Angeles, California, African American actors, African-American singers, American jazz musicians, American R&B singers, American soul musicians, American television actors, Cardiovascular disease deaths in Los Angeles, Deaths from congestive heart failure, Grammy Award winners, Singers from Los Angeles, California
The Christmas Song	Christmas music, Christina Aguilera songs
SV Wacker Burghausen	German football clubs, Sport in Bavaria
Irish Parliamentary Party	Nationalist organizations in Europe, Politics of Ireland, Political parties in Europe
Scotiabank Arena	1999 establishments in Canada, Indoor arenas, Music venues, Sports buildings in Canada, Sport in Toronto, Toronto Raptors, Buildings and structures in Toronto
Miloš Krasić	1987 births, Living people, Serbian footballers
Nassau Veterans Memorial Coliseum	Sports buildings in New York, WrestleMania host, 1972 establishments in New York (state)
Bell MTS Place	Indoor arenas, Sports buildings in Canada, Sport in Manitoba, 2004 establishments in Canada
Helena Blavatsky	1831 births, 1891 deaths, Russian writers, Occultists
PNC Arena	Sports buildings in the United States, Sports in North Carolina, Raleigh, North Carolina, Buildings and structures in North Carolina, 1999 establishments in the United States, 1990s establishments in North Carolina
Kris Kross	1990s American music groups, 1998 disestablishments in the United States, African-American musical groups, American rap music groups, Hip hop bands, Musical duos, Musical groups disestablished in 1998, Musical groups established in 1992, Musical groups from Atlanta, Georgia, 1992 establishments in Georgia (U.S. state), 20th-century disestablishments in Georgia (U.S. state)
Scotiabank Saddledome	1983 establishments in Canada, Indoor arenas, Music venues, Sports buildings in Canada, Sport in Calgary
Li (Confucian)	Confucianism
Stratovolcano	Volcanoes
StG 44	Assault rifles, 8 mm firearms, World War II, Weapons
Peter Soulsby	1948 births, Living people, British mayors
Picabo Street	Sportspeople from Idaho, American Olympic gold medalists, American skiers, 1971 births, Living people
Garageland	Punk rock, 1977 songs
Pope Pius X	1835 births, 1914 deaths, Italian popes, Deaths from myocardial infarction
Dancing Queen	Pop songs, ABBA songs, 1975 songs
Arlen Specter	United States senators from Pennsylvania, 1930 births, 2012 deaths, 1996 United States presidential candidates, Politicians from Wichita, Kansas, Deaths from non-Hodgkin lymphoma, US Democratic Party politicians
Rexall Place	Edmonton, Indoor arenas, Sports buildings in Canada, 1974 establishments in North America, 1970s establishments in Canada
Robert Fliess	Psychoanalysts, 1895 births, 1970 deaths
Carthage College	Colleges and universities in Wisconsin
Manly Hall	1901 births, 1990 deaths, Canadian writers, Occultists
Pope Adrian IV	12th century births, 1159 deaths, English priests, English Roman Catholics, People from Hertfordshire, Popes
Respiratory care	Health care, Pulmonology
Jim Jeffords	1934 births, 2014 deaths, Deaths from Alzheimer's disease, Congregationalists, Yale University alumni, Harvard University alumni, Attorneys general, State legislators of the United States, United States senators from Vermont, United States representatives from Vermont, US Republican Party politicians, Independent politicians in the United States
Ground state	Physics
Winter Wonderland	Christmas music
Pope Pius VIII	1761 births, 1830 deaths, Italian popes, Deaths from myocardial infarction
O Holy Night	Christmas music
Ray Conniff	American musical entertainers, Bandleaders, 1916 births, 2002 deaths
RMS Lusitania	Cruise ships, World War I
Pope Gregory	Papal names
Here Comes Santa Claus	Christmas music, Elvis Presley songs
Gene Autry	National Radio Hall of Fame inductees, Actors from Texas, American country musicians, American movie actors, American movie producers, American radio personalities, Singer-songwriters from Texas, American television actors, American television producers, Deaths from lymphoma, 1907 births, 1998 deaths
Frosty the Snowman	Christmas music
Chronic obstructive pulmonary disease	Pulmonology
Inhaler	Medicine
Hans Eysenck	1919 births, 1997 deaths, German psychiatrists
Crown of Ireland Act 1542	History of Ireland, 1542, 1540s in Europe
Dita von Teese	1972 births, Living people, Actors from Michigan, American adult models, American erotic dancers, American pornographic actors, American television actors, Models from Michigan, Singers from Michigan
Khedive	History of Egypt, Viceroys, 1867 establishments, 19th-century establishments in Egypt, 1914 disestablishments, 20th-century disestablishments in Africa
Rockefeller Republican	United States Republican Party
Prescott Bush	1895 births, 1972 deaths, Bush family, Deaths from lung cancer, United States senators from Connecticut, Politicians from Massachusetts, Politicians from Ohio, People from Milton, Massachusetts, George H. W. Bush
Irish Parliament	History of Ireland, Parliaments, 1297 establishments, 1800 disestablishments, 1290s establishments in Europe
Connie Francis	1938 births, Living people, Accordionists, Actors from Newark, New Jersey, Singers from Newark, New Jersey
Carlow	County towns in Ireland
Lamborghini Reventón	Lamborghini automobiles, 2000s automobiles, Sports cars
Church of Ireland	Anglicanism, Ireland
Michael O'Dwyer	British people, Punjab, 1864 births, 1940 deaths
Pope Benedict	Papal names
Convention on the Rights of All Migrant Workers	Migration laws, Human rights
Pope Benedict XI	1240 births, 1304 deaths, Italian popes
Bell Centre	1996 establishments in Canada, Indoor arenas, Montreal, Music venues, Sports buildings in Canada
Molson Centre	1996 establishments in Canada, 2002 disestablishments, 2000s disestablishments in Canada
Pope Adrian	Papal names
Santa Claus Is Coming to Town	Christmas music
America's Most Wanted	American reality television series, Law enforcement in the United States, English-language television programs
Kiva (organization)	Non-profit organizations
Waunfawr	Villages in Wales
Decompression chamber	Diving
Herbal	Books, Herbs
Lindsay Wagner	1949 births, Living people, American movie actors, American television actors, Actors from Los Angeles, California, Emmy Award winning actors
Willard Boyle	Canadian Nobel Prize winners, People from Nova Scotia, Canadian physicists, 1924 births, 2011 deaths
Baku Metro	Baku Metro, Rapid transit systems, Rail transport in Azerbaijan, 1967 establishments, Buildings and structures in Baku, 20th century establishments in Azerbaijan
Dennis Ritchie	Turing Award winners, American computer scientists, Scientists from New York, Harvard University alumni, 1941 births, 2011 deaths
Mayim Bialik	1975 births, Living people, Actors from San Diego, California, American child actors, American feminists, American movie actors, American television actors, American voice actors, Jewish American actors, Jewish American scientists, Neuroscientists, Scientists from San Diego, California, Writers from California
Blossom (TV series)	1990s television series, 1990 American television series debuts, 1995 American television series endings, American sitcoms, American teen television series, NBC network shows, English-language television programs
Mia Farrow	Actors from Los Angeles, California, American human rights activists, American movie actors, Golden Globe Award winning actors, Singers from Los Angeles, California, 1945 births, Living people, Frank Sinatra
So What (Pink song)	2008 songs, Pink songs
Cheetos	Snack foods
Frito-Lay	1961 establishments in the United States, 1960s establishments in Texas, American food companies, Companies based in Texas, Plano, Texas
Abbas II	1874 births, 1944 deaths, Egyptian Muslims, Egyptian politicians
Retarded	Pejoratives
Retardation	Pejoratives
Belgian Congo	1908 establishments, 1960 disestablishments, 1960s disestablishments in Africa, 1900s establishments in Africa, 20th century in Belgium, History of the Democratic Republic of the Congo, States and territories disestablished in the 20th century, States and territories established in the 20th century
Roger Casement	1864 births, 1916 deaths, British politicians, Criminals, Democratic Republic of the Congo, Irish politicians, People executed by hanging
Brenda Blethyn	1946 births, Living people, Actors from Kent, BAFTA Award winning actors, English movie actors, English stage actors, English television actors, English voice actors, Golden Globe Award winning actors, Ramsgate
Saving Grace (movie)	2000 movies, 2000s criminal comedy movies, British criminal comedy movies, Cornwall, English-language movies
Lukas Katnik	Austrian footballers, 1989 births, Living people, FC Red Bull Salzburg players
Pope Benedict IX	Italian popes, 1012 births, 1056 deaths
Shooting	Summer Olympic sports, War, Sport shooting
Tom McNeeley	1934 births, 2011 deaths, American boxers, Politicians‏ from Massachusetts, Sportspeople from Massachusetts
The Waitresses	American rock bands, New wave bands, Musical groups from Ohio, Musicians from Akron, Ohio
Pope John	Papal names
Deck the Halls	Christmas music
Silver Bells	Christmas music
Andy Williams	1927 births, 2012 deaths, American pop singers, Cancer deaths in Missouri, Deaths from bladder cancer, Singers from Iowa
Let It Snow! Let It Snow! Let It Snow!	Christmas music
Kung Fu (TV series)	1972 television series debuts, 1975 disestablishments, 1970s American television series, American drama television series, English-language television programs
Stoichiometry	Chemistry
Gustav Kirchhoff	1824 births, 1887 deaths, German inventors, German physicists, People from former German territories, People from Kaliningrad
Carol of the Bells	Christmas music
Valentín Paz-Andrade	Spanish poets, Spanish journalists, Spanish lawyers, Galician people, Spanish businesspeople, Spanish economists, 1898 births, 1997 deaths, People from Pontevedra
Pope Innocent	Papal names
Reactivity (chemistry)	Chemistry
All I Want for Christmas Is You	Christmas music, Mariah Carey songs, 1994 songs
AKUT Search and Rescue Association	Turkey
The Twelve Days of Christmas (song)	Christmas music
Orthacanthus	Extinct fish
Rod Piazza	Blues musicians, 1947 births, Blues harp players, Living people
Tim Cook	1960 births, Living people, American chief executives, Apple Inc., Gay men, Businesspeople from Alabama, LGBT businesspeople, LGBT people from Alabama, People from Mobile, Alabama
Azerbaijan Railways	Rail transport in Azerbaijan, Rail transport in Asia, Rail transport in Europe, Train operating companies, Transport in Azerbaijan, 1991 establishments, 1990s establishments in Azerbaijan
Persian language In India	Languages of India
Santa Baby	Christmas music
Blue Christmas	Christmas music, Elvis Presley songs
Pre-Raphaelite brotherhood	Art movements, British artists
Pretty Vacant	1977 songs, Sex Pistols
Piccadilly	City of Westminster, Roads in London
List of European countries	Lists of countries, European countries, Europe-related lists
Last Christmas	Christmas music, 1984 songs
Lock picking	Crime, Locks
List of Asian countries by population	Lists of countries, Asian countries
Romeo (Shakespeare)	Characters in Shakespeare's plays
Pope Benedict V	Italian popes, Year of birth unknown, 965 deaths
List of African countries by population	Lists of countries, African countries, Africa-related lists
Heidi Fleiss	1965 births, Living people, American columnists, American prisoners, American prostitutes, American sex industry businesspeople, Brothel owners and madams, Businesspeople from Los Angeles, California, Jewish American criminals, Jewish American entertainers, Jewish American writers, Jewish businesspeople, Jewish sex industry people, Television personalities from Los Angeles, California, Writers from Los Angeles, California
1906 San Francisco earthquake	1906, 1900s in the United States, Earthquakes in California, 20th century in San Francisco, Natural disasters in the San Francisco Bay Area, April events
Wonderful Christmastime	Christmas music, 1979 songs
Doug Ashton	1919 births, 2011 deaths, Australian entertainers, Order of Australia
Saline (medicine)	Medicine
Bobby Vinton	1935 births, Living people, Singers from Pennsylvania
Pope Leo	Papal names
Rodrigo y Gabriela	Mexican musicians, 2000s Mexican music groups, Musical groups established in 2000, 20th-century establishments in Mexico
Andy Rooney	1919 births, 2011 deaths, American atheists, American journalists, American television presenters, American television writers, Deaths from surgical complications, People from Albany, New York, Television personalities from New York, Writers from New York, Emmy Award winners
Angels We Have Heard on High	Christmas music
Pulmonology	Pulmonology
O Tannenbaum	Christmas music
Piccadilly Circus	Roads in London, City of Westminster
Dale–Chall formula	Written communication, Linguistics
Photogram	Photography
Park Lane	Roads in London, City of Westminster
Alghero	Communes of Sardinia
Triangulation station	Cartography, Trigonometry
Pope Leo XI	Italian popes, House of Medici, People from Florence, 1535 births, 1605 deaths
TSG 1899 Hoffenheim	German Bundesliga, German football clubs, Sport in Baden-Württemberg, 1899 establishments in Germany
Mimosa pudica	Mimosoideae, Rapid plant movement
Pope Leo XII	Italian popes, 1760 births, 1829 deaths
Jim Varney	1949 births, 2000 deaths, Actors from Kentucky, American movie actors, American television actors, American voice actors, Cancer deaths in Tennessee, Musicians from Kentucky, Deaths from lung cancer, People from Lexington, Kentucky
Pope Damasus II	German popes, 1048 deaths
Muhammad Ali Pasha	Ottoman people, 1769 births, 1849 deaths
Masazumi Soejima	1970 births, Living people, Japanese sportspeople
Bayesian probability	Philosophy of science
Dani Rodrik	1957 births, Living people, Asian Jews, Economists, European Jews, Harvard University alumni, Jewish academics, Jewish scientists, People from Istanbul, Princeton University alumni, Turkish scientists
Tiffani Thiessen	Actors from Long Beach, California, American television actors, 1974 births, Living people
Saved by the Bell	1989 American television series debuts, 1993 television series endings, 1980s American sitcoms, 1990s American sitcoms, 1990s teen television series, American teen comedy television series, High school television series, NBC network shows, Television series about friendship, Television series set in Los Angeles, California, English-language television programs
Pope Benedict VIII	Italian popes, 10th century births, 1024 deaths
Knights of St. Patrick	Orders of knighthood
George III	1738 births, 1820 deaths, Kings and Queens of the United Kingdom, Kings and Queens of Hanover, People Buried in St. George's Chapel at Windsor Castle, 18th century in the Kingdom of Great Britain
The Script	Musical groups established in 2001, 2000s Irish music groups, 2010s Irish music groups, Irish pop music groups, Irish rock bands, Musical groups from Dublin
Abercrombie River	Rivers of New South Wales
Pope Benedict XII	1280s births, 1342 deaths, French popes
La Toya Jackson	1956 births, Living people, Singers from Indiana, American television actors, Actors from Indiana, Jackson family, American models, Writers from Indiana, People from Gary, Indiana, American television personalities
Abercrombie River National Park	National parks in Australia, Protected areas of New South Wales, IUCN Category II
Rakali	Old World rats and mice, Mammals of Australia
Gila River Arena	Sports buildings in the United States, Arizona Coyotes, Buildings and structures in Arizona, 2003 establishments in Arizona
Stockholm Bloodbath	History of Stockholm, 1520, 1520s in Europe, November events
Rebbie Jackson	African American musicians, Singers from Indiana, 1950 births, Living people, Jackson family, People from Gary, Indiana
Battle of White Mountain	Czechoslovakia, Battles, Thirty Years' War, 1620, 1620s in Europe
Lana Turner	1921 births, 1995 deaths, Actors from Idaho, American movie actors, American television actors, Cancer deaths in the United States, Deaths from throat cancer
Gansus	Cretaceous birds, Gansu
Marumo no Okite	Japanese television series
This City	2011 songs
Ornithurae	Birds, Taxonomy
Herbert Kitchener, 1st Earl Kitchener	1850 births, 1916 deaths, British Army people, Deaths by drowning, People from the Republic of Ireland, Knights Grand Commander of the Order of the Indian Empire, Knights Grand Commander of the Order of the Star of India, Knights Grand Cross of the Order of the Bath, Knights Grand Cross of the Order of St Michael and St George, Knights of Justice of the Order of St John, Knights of the Garter, Order of Merit, Privy Councillors (UK)
Anglo-Egyptian Sudan	Former countries in Africa, 1899 establishments, 19th-century establishments in Africa
Condominium (international law)	Colonialism, International law, Dependent territories
Pope Urban	Papal names
Neornithes	Birds, Taxonomy
Antipope	Popes, Lists of popes
Neognathae	Birds
Pope Benedict XIII	Italian popes, 1649 births, 1730 deaths
Occupied territory	Occupied territories
Báthory family	Hungarian people, Families
Armenia at the Olympics	Nations at the Olympics, Sport in Armenia
Pope Benedict XIV	Italian popes, 1675 births, 1758 deaths
Treaty of Northampton	History of Scotland, Treaties, 1328, 14th century in England
Sudanese People's Liberation Army	Sudan, Political parties in Africa, Nationalist organizations in Africa
Nancy Grace	American lawyers, American television presenters, Journalists from Georgia (U.S. state), New York University alumni, Television personalities from Georgia (U.S. state), 1959 births, Living people
Shaheen falcon	National symbols of Pakistan, Birds of Asia, Falconiformes
Stephen Bathory	1533 births, 1586 deaths, Hungarian people, Kings and queens, Kings of Poland, Transylvania
Girl You Know It's True	Pop songs, 1988 songs, Milli Vanilli songs
Nanda Devi	Biosphere reserves, Himalayas, Mountains of India, Uttarakhand, National symbols of India
Pope Benedict XV	Italian popes, 1854 births, 1922 deaths, Deaths from pneumonia
Chak Haryam	Villages in Pakistan
The Cardigans	1990s Swedish music groups, 2000s Swedish music groups, 2010s Swedish music groups, Musical groups established in 1992, Swedish rock music groups
Les Invalides	Buildings and structures in Paris
Rakia	Alcoholic spirits
Swimming	Water sports, Swimming, Fitness
One Step at a Time	Pop songs, 2008 songs
John Chafee	1922 births, 1999 deaths, American military personnel of World War II, Deaths from congestive heart failure, Episcopalians, Governors of Rhode Island, Harvard University alumni, People from Providence, Rhode Island, People from Warwick, Rhode Island, United States Secretaries of the Navy, United States senators from Rhode Island, Yale University alumni
Heavy D	1967 births, 2011 deaths, Deaths from pulmonary embolism, Deaths from diabetes, African American actors, African American musicians, Jamaican singers, Singers from New York, American rap musicians from New York, actors from New York
Biological control	Agriculture, Ecology
Manuel Noriega	1938 births, 2017 deaths, Deaths from surgical complications, Drug traffickers, Former dictators, Generals, Heads of state, North American military people, North American politicians, Panamanian people, People convicted of drug offenses, Prisoners, Extradition
Sosigenes of Alexandria	Ancient Greek astronomers
Auld Alliance	History of Scotland, History of France, 13th century in Europe, 14th century in Europe, 15th century in Europe, 16th century in Europe
Aepyornis	Flightless birds, Ratites, Fossils, Megafauna
Sosigenes the Peripatetic	Ancient Greek astronomers
Lara Flynn Boyle	1970 births, Living people, American movie actors, American television actors, Actors from Davenport, Iowa
Harriet Arbuthnot	1793 births, 1834 deaths, English writers, Diarists
Jos Luhukay	1963 births, Living people, Dutch football managers, Dutch footballers, People from Venlo, Sportspeople from Limburg (Netherlands)
Pope Sixtus V	Italian popes, 1520 births, 1590 deaths, Franciscans
Lacewing	Neuroptera
Pope Sixtus	Papal names
Emma Thompson	1959 births, Living people, Academy Award winning actors, Academy Award winning writers, Actors from London, Alumni of the University of Cambridge, BAFTA Award winning actors, British screenwriters, British television writers, Emmy Award winning actors, English movie actors, English stage actors, English television actors, English voice actors, Golden Globe Award winning actors, Golden Globe Award winning writers, People from Hampstead, Screenwriters from London, Knights and Dames Commander of the Order of the British Empire
What's Love Got to Do with It	1984 songs, Grammy Award winning songs
Little Children (movie)	2006 drama movies, American drama movies, Movies based on books, English-language movies, American independent movies
Pierre Gamarra	1919 births, 2009 deaths, Children's writers, French novelists, French poets, People from Toulouse
Pre-frontal cortex	Anatomy of the brain
Pest (biology)	Biology, Pests
António Egas Moniz	1874 births, 1955 deaths, Portuguese scientists, Physicians, Neurologists
Puddle of Mudd	American hard rock bands, Grunge bands, Post-grunge bands, Musical groups from Missouri
Pope Julius III	People from Rome, Italian popes, 1487 births, 1555 deaths
Pope Julius	Papal names
Pope Celestine IV	Italian popes, 12th century births, 1241 deaths
Natalie Wood	Accidental deaths by drowning in the United States, Actors from San Francisco, American child actors, American movie actors, American television actors, Golden Globe Award winning actors, 1938 births, 1981 deaths
Khapra beetle	Polyphaga, Agricultural pests
Wyandot people	Native American
Occupy movement	Protests in the 2010s, 2011, Political movements
Multivalued function	Functions and mappings
Ball Arena	Sports buildings in the United States, Sports in Denver, Colorado, Buildings and structures in Colorado, 1999 establishments in the United States, 1990s establishments in Colorado
Tacit programming	Computer programming, Functions and mappings
BB&T Center (Sunrise)	Sports buildings in Florida, Buildings and structures in Miami, Florida, 1998 establishments in the United States, 1990s establishments in Florida
Da Nang International Airport	Airports in Vietnam, 1930s establishments in Asia, 20th century establishments in Vietnam
WSG Wattens	Austrian football clubs
Dylan and Cole Sprouse	1992 births, Living people, Actors from Long Beach, California, American television actors, Twin people from the United States
Jonathan Brandis	1976 births, 2003 deaths, Actors from Connecticut, Actors who committed suicide, American movie actors, American television actors, Suicides by hanging in the United States, Screenwriters from Connecticut
TOEIC	Tests, English language
Danielle Fishel	American movie actors, American television actors, American television personalities, People from Mesa, Arizona, Actors from Arizona, 1981 births, Living people
Pope Celestine	Papal names
Pope Celestine V	Italian popes, 1215 births, 1296 deaths, Benedictines
Pub rock (UK)	Rock music
Hurricane Lili (2002)	Hurricanes in the United States, 2002 Atlantic hurricane season, 2002 in the United States, 2000s in Louisiana, Hurricanes in Louisiana
Nord-Est (development region)	Development regions of Romania
Vest (development region)	Development regions of Romania
Hurricane Hanna	Deadly storms, 2008 Atlantic hurricane season, Hurricanes in Haiti, Hurricanes in New England, Hurricanes in North Carolina, Hurricanes in South Carolina, Hurricanes in Virginia, Hurricanes in New York
Nord-Vest (development region)	Development regions of Romania
Centru (development region)	Development regions of Romania
Sud-Est (development region)	Development regions of Romania
Sud (development region)	Development regions of Romania
Bucharest-Ilfov (development region)	Development regions of Romania
Sud-Vest (development region)	Development regions of Romania
The Doobie Brothers	1970 establishments in the United States, 1970s American music groups, 1980s American music groups, 1990s American music groups, 2000s American music groups, 2010s American music groups, American pop rock bands, Musical groups established in 1970, Musical groups from California, San Jose, California, Warner Bros. Records artists
Lady Macbeth	Characters in Shakespeare's plays
Pope Celestine III	Italian popes, 1106 births, 1198 deaths
Jacques Lacan	French people, Psychiatrists, 1901 births, 1981 deaths
Primo Levi	1919 births, 1987 deaths, Chemists‏, Holocaust survivors, Italian atheists, Italian Jews, Italian poets, Italian writers, Jewish atheists, Jewish scientists, Jewish writers, Jews who committed suicide, People from Turin, Suicides by jumping
Panic disorder	Anxiety disorders
Generalized anxiety disorder	Anxiety disorders
SVG Reichenau	Austrian football clubs
Italian Social Republic	Puppet states, Former dictatorships, Former republics, Nazi Germany, 1943 in Italy, 1944 in Italy, 1945 in Italy
Tanggu Truce	1933, 1930s in China, 1930s in Japan, Treaties involving China, May events
Mukden Incident	History of China, Second Sino-Japanese War
Alexei Ponikarovsky	1980 births, American Hockey League players, Carolina Hurricanes players, Living people, Los Angeles Kings players, Naturalized citizens of Canada, New Jersey Devils players, Pittsburgh Penguins players, Sportspeople from Kiev, Toronto Maple Leafs players, Ukrainian ice hockey players, Winnipeg Jets players
Hoobastank	1994 establishments in California, 1990s American music groups, 2000s American music groups, 2010s American music groups, American rock bands, Musical groups from Los Angeles, California, Post-grunge bands
Sensory receptor	Sensory system
Parietal lobe	Anatomy of the brain
Frontal lobe	Anatomy of the brain
Temporal lobe	Anatomy of the brain
The Little Drummer Boy	Christmas music
Ex nihilo	Christian theology, Philosophy, Creation myths, Christian terminology
Cochlea	Hearing
Limit (roller coaster)	Buildings and structures in Lower Saxony, Roller coasters by name, Roller coasters in Germany, Steel roller coasters
Survivor Series (2011)	2011 in American television, 2011 in professional wrestling, Sports in New York City, Survivor Series, 2011 in New York (state), 2010s in New York City, November events
Super Size Me	American documentary movies, English-language movies, American independent movies
Brussels Airport	1940 establishments in Europe, Airports in Belgium, Brussels, Flemish Brabant
Ray Kroc	1902 births, 1984 deaths, Businesspeople from Illinois, Chief executives, Deaths from heart failure, McDonald's, People from Oak Park, Illinois
Non-Newtonian fluid	Fluid mechanics
Newtonian fluid	Fluid mechanics
Airblue	Airlines of Asia, 2004 establishments in Asia, Transport in Pakistan, Islamabad
Schengen Area	European Union
Superstition	Superstitions, Magic (paranormal)
MC Ren	American rap musicians from California, Singers from California, 1969 births, Living people, People from Compton, California
Captain & Tennille	American pop music groups, Musical groups from California, Musical groups established in 1974, 1974 establishments in California
Hurricane Ernesto	Hurricanes, 2006 Atlantic hurricane season, Hurricanes in the United States, 2006 in the United States, 2000s in Haiti, 2000s in the Dominican Republic, 2000s in Florida, 2000s in North Carolina
Undergraduate education	Education
Burl Ives	Academy Award winning actors, Actors from Illinois, American movie actors, American radio actors, American stage actors, American television actors, Writers from Illinois, Autobiographers, Deaths from cancer, American folk musicians, Golden Globe Award winning actors, Grammy Award winners, Singers from Illinois, 1909 births, 1995 deaths
UPC Tirol Liga	Football leagues, Football in Austria
Thixotropy	Physics, Mechanics
Super Mario 3D Land	2011 video games, Mario platform games, Nintendo 3DS games, 3D platform games, Mario video games, Nintendo video games, Platform games, Video games developed in Japan
Coke (fuel)	Fuel
Pope Urban V	1310 births, 1370 deaths, Beatified people, Benedictines, French popes, People from Occitanie
Squad automatic weapon	Light machine guns
Sign (mathematics)	Numbers
Coordinate system	Coordinate systems, Mathematics
Bonnie Bedelia	1948 births, Living people, Actors from New York City, American movie actors, American television actors
Impetigo	Skin
Protopunk	Rock music, Punk rock
Jennifer Jason Leigh	1962 births, Living people, American movie actors, Actors from Hollywood
Locative case	Grammar
Exxon Valdez oil spill	1989 disasters, 1989 in the United States, 20th century in Alaska, Transport disasters in the United States
Pope Urban VI	Italian popes, 1310s births, 1389 deaths, People from Naples
Webster (TV series)	1980s television series, American sitcoms, ABC network shows, First run syndicated television programs, Television series set in Chicago, Illinois, English-language television programs
Rocca Petru	French poets, 1966 deaths, 1887 births, People from Corsica
Pope Urban VII	Italian popes, People from Rome, 1521 births, 1590 deaths
Eden Sher	American television actors, Actors from Los Angeles, California, 1991 births, Living people
Hal Bruno	1928 births, 2011 deaths, American journalists, American political commentators, American military personnel of the Korean War, Writers from Chicago, Deaths from cardiac arrhythmia
Atticus Shaffer	American child actors, American movie actors, American television actors, Actors from Los Angeles County, California, 1998 births, Living people
Gunning Bedford, Jr.	1747 births, 1812 deaths, Politicians from Philadelphia, Pennsylvania, Politicians from Wilmington, Delaware
FC Lustenau 07	Austrian football clubs, Football clubs of Vorarlberg
A. J. Foyt	NASCAR drivers, American racecar drivers, Sportspeople from Houston, Texas, 1935 births, Living people
Estée Lauder	Businesspeople from New York City, 1908 births, 2004 deaths
Evans Blue	Alternative rock bands, Canadian hard rock bands, Canadian rock bands, Canadian heavy metal bands, Musical groups established in 2005, 2005 establishments in Canada
In the Realm of the Senses	1976 movies, Japanese movies, French romance movies, Movies directed by Nagisa Oshima
Colloid	Physics, Materials, Physical chemistry
Five Finger Death Punch	American heavy metal bands, Nu metal bands, Alternative metal bands, Hard rock bands, Musical groups from Los Angeles, California
Sol (colloid)	Materials
One Direction	2010 establishments in England, 2010s British music groups, Brit Award winners, British boy bands, British pop music groups, One Direction, The X Factor contestants, Musical groups established in 2010, Musical groups from London, Musical quintets, Musical quartets
Lyme Regis	Towns in Dorset, West Dorset
Non-renewable resource	Ecology, Energy, Materials, Economics
Personal name	Names
Regnal name	Names, Monarchy
Wolfsberger AC	Austrian football clubs, Carinthia (state)
Kimmeridge clay	Jurassic, Sedimentary rocks, Geological formations
Walker Lake	Lakes of the United States, Geography of Nevada
Milton Wolff	1915 births, 2008 deaths, American military people, People from New York City
Rachel Hunter	New Zealand television actors, Models, 1969 births, Living people, Naturalized citizens of the United States
Yamasee War	Wars, 18th century in South Carolina, 1715, 1716, 1717
Orbital forcing	Climate, Earth
Milton Berle	Actors from New York City, American child actors, Comedians from New York City, American movie actors, American radio actors, American radio personalities, American stage actors, American television actors, American television personalities, American television writers, American voice actors, Deaths from colorectal cancer, Writers from New York City, 1908 births, 2002 deaths
Karl Barth	1886 births, 1968 deaths, Christian theologians, Swiss people
Janet Evans	1971 births, Living people, American Olympic gold medalists, American Olympic silver medalists, American swimmers, Sportspeople from California
Shame (movie)	2011 drama movies, American erotic movies, Borderline personality disorder in fiction, British drama movies, English-language movies, Manhattan in fiction, Movies about dysfunctional families, Movies about prostitution, Movies about siblings, Movies set in New York City, NC-17 rated movies
Sungai Lalang	Settlements in Kedah, Towns in Asia
Sungai Petani	Settlements in Kedah, Towns in Asia
States of Malaysia	States of Malaysia
Works of Rambhadracharya	Literature
Pope Clement	Papal names
Boboli's Garden	Botanical gardens in Europe, Buildings and structures in Florence
Academy maniacs	2010 crimes, Murder in 2011, Russian people, Serial killers
Fermi paradox	Extraterrestrial life, Paradoxes
Drake equation	Equations, Extraterrestrial life
Voyager Golden Record	Voyager program, Extraterrestrial life
Pargalı İbrahim Pasha	Ancient Greek cities
Pope Urban IV	French popes, 1190s births, 1264 deaths
Midget	Words, Growth disorders
Rudolph the Red-Nosed Reindeer	Christmas music, Christmas
Pain disorder	Pain
Ginger Rogers	Academy Award winning actors, Actors from Missouri, American dancers, American movie actors, American stage actors, American television actors, Cardiovascular disease deaths in California, Deaths from myocardial infarction, People from Independence, Missouri, Singers from Missouri, 1911 births, 1995 deaths
Independence, Missouri	Cities in Missouri, County seats in Missouri, Oregon Trail
10,000 Maniacs	American rock bands, Musical groups from New York
Seneca the Younger	0s BC births, 60s deaths, Ancient Roman writers, European politicians, Poets, Philosophers
Meredith Baxter	Actors from Pasadena, California, LGBT people from California, American movie actors, American television actors, American television producers, American voice actors, Breast cancer survivors, Lesbians, LGBT actors, 1947 births, Living people
Meredith Brooks	Musicians from Oregon, Singers from Oregon, Living people, 1958 births
Rohtas Fort	World Heritage Sites in Pakistan, Buildings and structures in Pakistan, Forts
FatRat	Free software
Pope Urban VIII	Italian popes, People from Florence, 1568 births, 1644 deaths
Hasekura Tsunenaga	1571 births, 1622 deaths, People from Sendai, Japanese diplomats
Maria Shriver	1955 births, Living people, American journalists, American writers, Kennedy family, Writers from Chicago, Emmy Award winners
Mexican Revolution	20th century in Mexico, 20th century rebellions, 1910s, 20th century conflicts, Civil wars, Revolutions
Estée Lauder Companies	1946 establishments in the United States, 1940s establishments in New York (state), Companies of the United States, Perfumery, Cosmetics companies
Tanning bed	Everyday life
Herman Wouk	1915 births, 2019 deaths, American centenarians, American novelists, Jewish American writers, Pulitzer Prize winners, Writers from New York City
Quirinal Palace	Buildings and structures in Rome, Palaces in Italy, 1583 establishments, 1580s establishments in Europe, Establishments in Italy
Killie pie	Football in Scotland, Meat dishes
Seneca the Elder	50s BC births, 30s deaths, Ancient Roman writers
Hearst, Ontario	Cities in Ontario
Cornwall, Ontario	Cities in Ontario
Barkly, Victoria	1859 establishments in Australia
Time After Time	Pop songs, 1984 songs
Peterborough, Ontario	Cities in Ontario
Danica Patrick	NASCAR drivers, American models, People from Wisconsin, American racecar drivers, 1982 births, Living people, IndyCar Series drivers
Ice sledge hockey	Sports for the disabled, Ice hockey, Winter sports, 1960s establishments in Sweden
Paleozoology	Branches of zoology
President of Azerbaijan	Lists of heads of state, Presidents of Azerbaijan, Government of Azerbaijan
Bullet-proof glass	Glass, Armour
Date Masamune	1567 births, 1636 deaths, Daimyo, People from Yamagata Prefecture
Laura Feiersinger	Austrian footballers, Women's football in Austria, Players of the Austrian national football team, 1990 births, Living people
Quadruped	Tetrapods
Pope Alexander	Papal names
Frank Drake	1930 births, Living people, American astronomers, Scientists from Chicago, Cornell University alumni, Astrophysicists
Pope Alexander III	Italian popes, People from Siena, 1100s births, 1181 deaths
Pope Clement VII	Italian popes, House of Medici, People from Florence, 1478 births, 1534 deaths
Suzanne Somers	Actors from San Mateo County, California, Businesspeople from California, American television actors, Breast cancer survivors, American movie actors, American voice actors, Singers from California, 1946 births, Living people
Cape Mendocino	Landforms of California, Capes of the United States, Humboldt County, California
Cavaquinho	Guitars
Gower	Geography of Wales, Peninsulas
David Heath	American professional wrestlers, Former WWE wrestlers, Sportspeople from Florida, People from Fort Lauderdale, Florida, 1969 births, Living people
Plucked string instrument	Plucked string instruments
Raven's Nest	Professional wrestlers, Total Nonstop Action Wrestling alumni
Circus (album)	2008 albums, Britney Spears albums
Fingerpicking	Plucked string instruments
Duluth, Minnesota	Duluth, Minnesota, County seats in Minnesota, 1857 establishments in the United States
The Partridge Family	1970s television series, American sitcoms, Fictional families, Television series about families, English-language television programs
List of national capitals	National capitals, Lists of settlements, Lists of cities
Testimonial	Marketing
Behind These Hazel Eyes	Pop songs, Kelly Clarkson songs, 2005 songs
Nightwing	Batman characters, DC Comics superheroes
Frustration	Psychology, Physics
Indo-Pakistani War of 1971	Wars involving India, 1971 in Pakistan, Wars involving Pakistan, 1971 in Bangladesh, 1970s in India
Long Buckby	Villages in Northamptonshire
Malay Wikipedia	Wikipedias
Atmel AVR	Computers
Vienna Circle	Philosophers
University of Vienna	Colleges and universities in Europe, Vienna, 1365 establishments, 14th century establishments in Europe, Establishments in Austria
National Memorial Day of the Exiles and Foibe	Italy, History of Italy
Pope Alexander IV	Italian popes, 1180s births, 1261 deaths
Keichō	Japanese eras, 1596 establishments, 16th century establishments in Japan, 1615 disestablishments, 17th century disestablishments in Japan
Senedd	Politics of Wales, 2006 establishments in the United Kingdom, 2000s establishments in Wales
June Christy	1925 births, 1990 deaths, American jazz singers, American jazz musicians, Deaths from renal failure, Singers from Illinois, Musicians from Springfield, Illinois
Pall Mall	Roads in London
119 (number)	Integers
Jo Stafford	1917 births, 2008 deaths, Actors from Fresno County, California, American television actors, Deaths from congestive heart failure, Singers from California
Hilaire Belloc	1870 births, 1953 deaths, English writers, English poets, French writers, French poets, British politicians
FC Dinamo Tbilisi	Football clubs, Sport in Georgia (country), Tbilisi, 1911 establishments
Boris Paichadze Stadium	Football stadiums, Sport in Georgia (country), Tbilisi, 1976 establishments in Europe
Alejandro García Casañas	Spanish football managers, Sportspeople from Barcelona, Spanish footballers, 1970 births, Living people
Wiki Conference India	Wikis, Wikimedia Foundation
Regionalliga West (Austria)	Football in Austria, Football leagues
Kate Smith	1907 births, 1986 deaths, Deaths from diabetes, Singers from Virginia
Harley-Davidson	1903 establishments in the United States, Companies of the United States, Milwaukee, Wisconsin
Eduard Kainberger	Austrian footballers, Association football goalkeepers, 1911 births, 1974 deaths, People from Salzburg
Hurricane Dolly	Hurricanes in Texas
Ultralight material	Materials
Venona project	20th century in the United States
Renaud	1952 births, French singers, French songwriters, Living people
Mars Science Laboratory	NASA spacecraft, Mars
Mayfair	Areas of London, City of Westminster
Walla Walla, Washington	Towns in Washington, County seats in Washington
Overpass	Bridge types
Folie à deux	Psychosis
SnRNP	RNA, Molecular biology
Google Nexus	Google Nexus
Joan Gamper Trophy	Football competitions, Barcelona, Camp Nou, 20th century establishments in Spain, 1966 establishments in Europe
Metalist Stadium	Football stadiums in Europe, Buildings and structures in Ukraine, 1926 establishments, 1920s establishments in Ukraine
Alfred Riedl	Austrian footballers, Players of the Austrian national football team, Austrian football managers, Austria national football team managers, 1949 births, 2020 deaths, Cancer deaths in Austria
Halkett boat	History of Canada, Boats
Tonight (Big Bang EP)	2011 albums
Second Single	2006 songs
Marshall Islands at the Olympics	Marshall Islands, Nations at the Olympics
Mackenzie Large Igneous Province	Geography of Canada, Proterozoic, Volcanoes of Canada, Flood basalts
Memory of the World Programme	UNESCO, Documents, Libraries
Nelson Aldrich	1841 births, 1915 deaths, American esotericists, Freemasons, United States senators from Rhode Island, US Republican Party politicians
Regent Street	Roads in London
Giorgio Orsini	Italian sculptors, Italian architects, 1410s births, 1475 deaths
Gabbro	Igneous rocks
Highway to Hell	1979 songs, AC/DC
List of regions of Japan	Geography of Japan, Japanese culture, Japan-related lists
Paroxetine	Drugs used in psychiatry
Brad Ralph	Canadian ice hockey left wingers, Ice hockey people from Ontario, Phoenix Coyotes players, 1980 births, Living people, American Hockey League players, ECHL players, Ontario Hockey League players
Black Veil Brides	American hard rock bands, Glam metal bands, Post-hardcore bands, Musical groups established in 2006, Musicians from Cincinnati, Ohio, Musical groups from Ohio, Musical groups from Los Angeles, California, 2006 establishments in the United States, 2000s establishments in Ohio
Ebola Syndrome	1996 horror movies, Chinese movies, Hong Kong movies
Modern Family	2009 American television series debuts, 2000s American sitcoms, 2000s LGBT television series, 2010s American sitcoms, 2010s LGBT television series, American LGBT television programs, Emmy Award winning programs, Fiction about suburbia, Golden Globe Award winning programs, LGBT comedy television series, Screen Actors Guild Award winners, Television series about marriage, Television series about siblings, Television series about suburbia, Television series set in Los Angeles, California, English-language television programs
2011–12 PFC CSKA Moscow season	2011 in association football, 2012 in association football, Football seasons, PFC CSKA Moscow, 21st century in Moscow, 2011 in Russia, 2012 in Russia
Keisuke Honda	1986 births, Living people, Footballers from Osaka Prefecture, Japan international footballers, J1 League players, Nagoya Grampus players, 2010 FIFA World Cup players, 2014 FIFA World Cup players, 2018 FIFA World Cup players, 2013 FIFA Confederations Cup players, Footballers at the 2008 Summer Olympics
FC HOCO Südburgenland	Austrian football clubs, Women's football in Austria, Burgenland
The Crystals	1961 establishments in New York (state), African-American musical groups, American girl groups, American pop music groups, American R&B bands, Musical groups established in 1961, Musical groups from New York City, 1967 disestablishments, 1960s disestablishments in New York (state), Musical groups established in 1971, 1971 establishments in the United States, 1970s establishments in New York (state)
Candace Cameron Bure	American television actors, Actors from Los Angeles, California, 1976 births, Living people
Bonzi Wells	1976 births, Living people, American basketball players, Portland Trail Blazers players, Memphis Grizzlies players, Sacramento Kings players, Houston Rockets players, Sportspeople from Indiana
Facies	Sedimentary rocks
Amanda Blank	American rap musicians from Pennsylvania, Living people, 1982 births, Singers from Philadelphia, Pennsylvania
Defense of the Ancients	Blizzard Entertainment, Real-time strategy video games
Greg Halman	1987 births, 2011 deaths, Dutch murder victims, Murders by blade weapons, People from Haarlem, People murdered in the Netherlands, Seattle Mariners players, Sportspeople from North Holland
Náchod	Towns in the Czech Republic
Michael Bublé	1975 births, Living people, Canadian pop musicians, Canadian singers, Jazz musicians, Jazz singers, Musicians from British Columbia, People from Burnaby
Ōita Prefecture	Ōita Prefecture, Prefectures of Japan
Ahmed Rushdi	1934 births, 1983 deaths, Pakistani singers
Floorball	Team sports
Prime Minister of Azerbaijan	Prime Ministers of Azerbaijan, Lists of prime ministers, Government of Azerbaijan, Azerbaijani politicians
Hallie Kate Eisenberg	American movie actors, American television actors, Actors from New Jersey, 1992 births, Living people
Gaslighting	Psychology
Chatham, Kent	Medway, Towns in Kent
Graphics tablet	Computer hardware
Patrick Murphy (giant)	1834 births, 1862 deaths, People from County Down, Deaths from smallpox
Gigantism	Growth disorders, Neuroendocrinology
Patrick Murphy (pilot)	Year of birth unknown, Year of death unknown, Arizona, Irish people, Aviators
Imperia Tower	Skyscrapers, Buildings and structures in Moscow
Xiangsheng	Comedy, Chinese culture
Oppidum	Latin words and phrases, Archaeological sites, Fortification, Places of Ancient Rome
Patrick Murphy (Irish Politician)	1889 births, 1968 deaths, Irish politicians
Visací zámek	punk bands, Czech musical groups
The Isley Brothers	American R&B bands, Musical groups from Ohio, Musicians from Cincinnati, Ohio
Venus as a Boy	Björk, 1993 songs
Mandarin orange	Citrus
Marco Simoncelli	Italian sportspeople, 2011 deaths, 1987 births
Rhys Ifans	1973 births, Living people, BAFTA Award winning actors, British rock musicians, Welsh movie actors, Welsh television actors, Welsh voice actors
Sandra Bernhard	1955 births, Living people, Actors from Arizona, Actors from Michigan, American autobiographers, American LGBT rights activists, American movie actors, American television actors, Bisexual people, Comedians from Arizona, Comedians from Michigan, LGBT actors, LGBT comedians, LGBT people from Arizona, LGBT singers, People from Flint, Michigan, People from Scottsdale, Arizona, Singers from Arizona, Singers from Michigan, Writers from Michigan, Musicians from Arizona, Musicians from Michigan
Symbian	Operating systems, Mobile phones
Victoria Jackson	Actors from Miami, Florida, American movie actors, American television actors, Comedians from Florida, 1959 births, Living people
Flint, Michigan	Flint, Michigan, County seats in Michigan
Thermal expansion	Thermodynamics
SG FC Bergheim/USK Hof	Austrian football clubs, Women's football in Austria, Football clubs of Salzburg
United Nations High Commissioner for Refugees	United Nations High Commissioners for Refugees
Nara period	Periods in Japanese history
Dialogue	Fiction, Rhetoric
Pyroxene	Minerals, Igneous rocks
China Central Television	Television, China
Naco, Arizona	Census-designated places in Arizona
Algal bloom	Algae
Smoky Hill Chalk	Lagerstätten, Cretaceous, Geography of Kansas, Geography of Nebraska
CCTV New Year's Gala	Television, China, Television lists
Army men	Toys
Samuel Morse	American inventors, 1791 births, 1872 deaths
Ehime Prefecture	Ehime Prefecture, Prefectures of Japan
Tokushima Prefecture	Tokushima Prefecture, Prefectures of Japan
Mount Vernon, New York	Cities in New York
Eva Marie Saint	Academy Award winning actors, Emmy Award winning actors, American movie actors, American stage actors, American television actors, Actors from Newark, New Jersey, 1924 births, Living people
Chicken nuggets	Chicken as food
Ryan Stiles	1959 births, Comedians from Washington, American movie actors, American television actors, Living people, actors from Seattle, Washington
Lake George	Lakes of the United States, Geography of New York
John Bryson	Commerce, US Democratic Party politicians, United States Secretaries of Commerce, Politicians from New York City, 1943 births, Living people
Pinetop Perkins	American pianists, Blues pianists, Grammy Award winners, 1913 births, 2011 deaths
Pope Innocent IV	Italian popes, 1190s births, 1254 deaths
Cancale	Communes in Ille-et-Vilaine
Red Norvo	American jazz musicians, American dancers, Musicians from Illinois, 1908 births, 1999 deaths, Vaudeville performers
Vanilla Ice	Actors from Dallas, Texas, American movie actors, American rap musicians from Texas, American songwriters, Dancing on Ice participants, Singers from Dallas, Texas, The Surreal Life participants, 1967 births, Living people
Wilson Phillips	1989 establishments in the United States, 1980s American music groups, 1990s American music groups, 2000s American music groups, 2010s American music groups, American girl groups, American pop music groups, Musical groups established in 1989, Musical groups from Los Angeles, California
Peter Yates	British television directors, English movie directors, English movie producers, People from Hampshire, 1929 births, 2011 deaths
Kingswood, South Gloucestershire	Bristol, Settlements in Gloucestershire
Robin Gibb	1949 births, 2012 deaths, English pop singers, English singer-songwriters, Cancer deaths in England, Deaths from colorectal cancer, Musicians from Manchester, Twin people from the United Kingdom
National Museum of Natural History	1910 establishments in the United States, 1910s establishments in Washington, D.C., Natural history museums, Smithsonian Institution
James Arness	1923 births, 2011 deaths, Actors from Minneapolis, Minnesota, American movie actors, American stage actors, American television actors, Deaths from natural causes
Rorathang	Villages in India, Sikkim
Raja Ravi Varma College of Fine Arts	Colleges and universities in India, 1915 establishments, 1910s establishments in India
Jason Aldean	1977 births, Living people, Singers from Georgia (U.S. state), American country musicians, People from Macon, Georgia
Uptown Girls	2003 comedy-drama movies, American comedy-drama movies, English-language movies
Let Me Hear Your Voice	2011 songs
Pope Innocent V	French popes, 1220s births, 1276 deaths, Beatified people
Okayama Prefecture	Okayama Prefecture, Prefectures of Japan
Crab rangoon	Seafood dishes
Stereo Love	2010 songs
Doris Roberts	American movie actors, American television actors, American stage actors, Emmy Award winners, Deaths from stroke, Actors from St. Louis, Missouri, 1925 births, 2016 deaths
Bechyně	Towns in the Czech Republic, 14th century establishments in Europe
Ratibořské Hory	Villages in the Czech Republic
Canoe racing	Water sports, Boat racing
Geocaching	Sports
Cardinal-nephew	Cardinals of the Roman Catholic Church, Religion-related lists
Chemical energy	Chemistry
El Cid	1043 births, 1099 deaths, Generals, Spanish military people
1981 Irish hunger strike	1981 in the United Kingdom, 20th century in Northern Ireland, Deaths from starvation, Irish Republican Army, Protests in the 20th century, Suicides in the United Kingdom
UEFA Euro 2012 qualifying Group B	UEFA Euro 2012 qualifying
List of social networking websites	Social networking, Computer-related lists
Uncanny valley	psychology, Robots
Pat Morita	1932 births, 2005 deaths, Actors from Sacramento County, California, American movie actors, American stand-up comedians, American television actors, American voice actors, Comedians from California, Deaths from renal failure, Disease-related deaths in Nevada
Dork Diaries	Series of books
Martin Landau	1928 births, 2017 deaths, Academy Award winning actors, Actors from Brooklyn, American movie actors, American television actors, American stage actors, American voice actors, American cartoonists, Cardiovascular disease deaths in Los Angeles, Golden Globe Award winning actors, Jewish American actors, Saturn Award winners, Screen Actors Guild Award winners, Deaths from sepsis, Deaths from gastrointestinal hemorrhage, Military personnel of the Korean War, Disease-related deaths in the United States, Deaths from atherosclerosis
Nina Aigner	Austrian footballers, Women's football in Austria, Players of the Austrian national football team, 1980 births, Living people
Mariel Hemingway	American television actors, American movie actors, Writers from California, Actors from Marin County, California, 1961 births, Living people
Tiffany Darwish	1971 births, Living people, American child singers, American pop musicians, Singer-songwriters from California, Singers from Los Angeles, California
Kanjanur	Villages in India
James Black	1924 births, 2010 deaths, British academics, British Nobel Prize winners, British physicians, Fellows of the Royal Society, Knights Bachelor, Pharmacologists, Scottish scientists, Wolf Prize winners
David Cassidy	1950 births, 2017 deaths, Actors from Beverly Hills, California, Actors from Manhattan, Actors from New Jersey, American guitarists, American movie actors, American pop musicians, American stage actors, American television actors, American television producers, Deaths from multiple organ failure, Disease-related deaths in Florida, Musicians from California, Musicians from Manhattan, Musicians from New Jersey, Singers from California, Singers from New Jersey, Singers from New York City
Tropical Storm Lee (2011)	Atlantic tropical storms, 2011 in weather, 2010s in Louisiana, 2010s in Texas, 2010s in Pennsylvania, 2011 in New York (state), Hurricanes in Louisiana
Digital electronics	Electronics
Dominique Dawes	1976 births, Living people, American Olympic gold medalists, American gymnasts, American Olympic bronze medalists, People from Silver Spring, Maryland
Semi-trailer truck	Trucks
Interstate 470 (Ohio – West Virginia)	Interstate Highways
Video camera	Cameras, Electronics, Data input
Pope Innocent VI	French popes, 1280s births, 1362 deaths
Broker	Occupations
In the Heat of the Night (TV series)	1988 American television series debuts, 1995 American television series endings, 1980s American television series, 1990s American television series, American crime drama television series, American police television series, CBS network shows, NBC network shows, English-language television programs
Stress analysis	Mechanics
University of Göttingen	University of Göttingen, Colleges and universities in Germany, Lower Saxony
Beloit, Wisconsin	Cities in Wisconsin
Outlaw (arcade game)	Arcade games
Rosetta (spacecraft)	ESA spacecraft
Kim Basinger	1953 births, Living people, Actors from Georgia (U.S. state), Actresses who played Bond girls, American models, American movie actors, American television actors
Azerbaijani Armed Forces	Military of Azerbaijan
Azerbaijani Land Force	Military of Azerbaijan
Azerbaijani Air Force	Military of Azerbaijan, Air forces
Azerbaijani Navy	Military of Azerbaijan, Navies
Capital of Japan	Capital of Japan, History of Japan, Japan-related lists
Jane (German band)	1970s establishments in Germany, 1970s German music groups, 1980s German music groups, 1990s German music groups, 2000s German music groups, German rock bands, Hanover, Musical groups established in 1970
Armed Forces of the Russian Federation	Military of Russia
St. Cloud, Minnesota	Cities in Minnesota, County seats in Minnesota
Shannon Miller	American gymnasts, American Olympic bronze medalists, American Olympic gold medalists, American Olympic silver medalists, Medalists at the 1992 Summer Olympics, Medalists at the 1996 Summer Olympics, Sportspeople from Oklahoma, Sportspeople from Missouri, 1977 births, Living people
Capital of Korea	Capital of Korea, History of Korea
Capital of Egypt	Capital of Egypt, History of Egypt
Jennifer Beals	1963 births, Living people, American movie actors, American television actors, Actors from Chicago
Red Wing, Minnesota	County seats in Minnesota, Cities in Minnesota
Naniwa-kyō	Former capitals of Japan
Aggression	Human behavior
Kuni-kyō	Former capitals of Japan
Nina Burger	Austrian footballers, Women's football in Austria, Players of the Austrian national football team, 1987 births, Living people
Focal length	Optics, Photography
Heijō-kyō	Former capitals of Japan, 8th century in Japan
First Spaceship on Venus	1959 movies, 1950s science fiction movies, German-language movies
Sribhargavaraghaviyam	Epic poems, Sanskrit
Capital of France	Capital of France, History of France
Protein Data Bank	Chemistry, Proteins
Dhok Padhal	Villages in Pakistan
Azerbaijan Soviet Socialist Republic	20th century in Azerbaijan, Political history of Azerbaijan, Republics of the Soviet Union, Azerbaijani republics, 1920 establishments in Azerbaijan, 1990 disestablishments, 1920 establishments in the Soviet Union, Disestablishments in the Soviet Union
Plitvice Lakes	Geography of Croatia, World Heritage Sites in Europe, National parks in Europe
Jaat	Ethnic groups in Pakistan, Ethnic groups in India
Sapote	Fruits
Hansel and Gretel	Grimms' Fairy Tales
Hurricane Hattie	Deadly storms, Hurricanes, 1961 in North America
Singapore at the Olympics	Sport in Singapore, Nations at the Olympics
Philip Showalter Hench	Nobel Prize in Physiology or Medicine winners, American Nobel Prize winners, American physicians, Scientists from Pittsburgh, Pennsylvania, 1896 births, 1965 deaths
DFC LUV Graz	Austrian football clubs, Women's football in Austria, Football clubs of Graz
Hurricane Ophelia (2005)	Hurricanes in the United States, 2005 in weather, September 2005 events, 2005 in Canada, 2005 in Florida, 2000s in North Carolina, 2000s in Massachusetts
Jo Dee Messina	1970 births, Living people, Singers from Massachusetts, American country singers, American singer-songwriters
Winnipeg General Strike	1919 in North America, 1910s in Canada, 20th century riots, Protests in the 1910s, Winnipeg
Shoeshine	1947 movies, 1940s drama movies, Multilingual movies, Italian drama movies, Movies set in Rome, Movies directed by Vittorio De Sica
Sejo of Joseon	1417 births, 1468 deaths, Kings of Joseon
Kaštanka	Forests of Europe, Geography of the Czech Republic
Patty Duke	1946 births, 2016 deaths, Actors from Queens, American activists, American autobiographers, American child actors, American movie actors, American television actors, Best Supporting Actress Academy Award winners, Deaths from sepsis, Disease-related deaths in Idaho, Emmy Award winning actors, Golden Globe Award winning actors, Infectious disease deaths in the United States, People with bipolar disorder, Presidents of the Screen Actors Guild
Prequel	Drama, Literature, Movie industry
Talking past each other	Idioms
Viveiro	Towns in Spain, Municipalities in Galicia
Blind men and an elephant	Idioms, Elephants, Fables, Parables, Epistemology, Oral tradition
Internal Troops of Azerbaijan	Special Forces, Military of Azerbaijan, Law enforcement agencies
Kaskaskia, Illinois	Villages in Illinois, Former United States state capitals, 1703 establishments, 18th-century establishments in the French colonial empire
Windsor, Vermont	Towns in Vermont, Former United States state capitals, 1764 establishments in the Thirteen Colonies, 18th-century establishments in Vermont
Avarua	Capital cities in Oceania, Cook Islands
Psychopathy	Personality disorders
Map projection	Map projections
Azerbaijani National Guard	Special Forces, Military of Azerbaijan
Woody Stephens	1913 births, 1998 deaths, Horse racing, Sportspeople from Kentucky
Road Town	National capitals in North America, British Virgin Islands
State Border Service of Azerbaijan	Special Forces, Military of Azerbaijan
Couvade	Culture
Elizabeth City, North Carolina	Cities in North Carolina, County seats in North Carolina
Hark the Herald Angels Sing	Christmas music
Asuka, Yamato	Former capitals of Japan
Fukuhara-kyō	Former capitals of Japan
Fujiwara-kyō	Former capitals of Japan
Corydon, Indiana	Towns in Indiana, County seats in Indiana, Former United States state capitals
2011–12 Russian Premier League	Russian Premier League, 2011 in Russia, 2012 in Russia
George Thorogood	1950 births, Living people, American guitarists, Blues guitarists, American blues musicians, American rock musicians, Musicians from Wilmington, Delaware, Singers from Delaware
Matsudaira Sadanobu	1759 births, 1829 deaths, Daimyo, Writers from Tokyo
Frank B. Kellogg	American lawyers, United States senators from New York, United States Secretaries of State, American Nobel Prize winners, Politicians from Saint Paul, Minnesota, 1856 births, 1937 deaths
Peter C. Doherty	Australian Nobel Prize winners, Nobel Prize in Physiology or Medicine winners, People from Brisbane, 1940 births, Living people, Australian medical doctors, Veterinarians, Australian of the Year Award winners
Havlíčkův Brod	Cities in the Czech Republic
Russian Space Forces	Military of Russia, Spaceflight
Contemporary art	Art movements
Russian Ground Forces	Military of Russia
Susa	Cities in Iran
Army ranks and insignia of the Russian Federation	Military of Russia
Timmins	Cities in Ontario
St. Charles, Missouri	Former United States state capitals, Cities in Missouri, County seats in Missouri
Lawrence Ferlinghetti	1919 births, 2021 deaths, American poets, Beat Generation, People from Yonkers, New York, Columbia University alumni, Writers from New York, Deaths from lung disease, Disease-related deaths in San Francisco, Writers from San Francisco, American essayists, American political activists, American painters, American centenarians
Ugo Nespolo	1941 births, Living people, Italian painters
Ecbatana	Former national capitals, History of Iran
Dynasties in Chinese history	Chinese dynasties, History-related lists
Ethernet hub	Computers
Heian-kyō	Kyoto, Former capitals of Japan
Nagaoka-kyō	Former capitals of Japan
Lancaster, Pennsylvania	Former capitals of the United States, Former United States state capitals, Cities in Pennsylvania, County seats in Pennsylvania, 1720s establishments in the Thirteen Colonies, 1729 establishments, 18th-century establishments in Pennsylvania
Eurasian Union	International organizations, Economics organizations, Political organizations based in Europe, Economy of Asia, Economy of Europe, Politics of Asia, Politics of Europe, Economy of Russia, Politics of Russia, Political organizations based in Asia
New Castle, Pennsylvania	Cities in Pennsylvania, County seats in Pennsylvania
Wilkes-Barre, Pennsylvania	Cities in Pennsylvania, County seats in Pennsylvania
Electronic gear shifting	Vehicles, Mechanics
Languages of Canada	Languages by country, Canada
Underground Railroad	19th century in the United States, African-American history, Slavery
Kagoshima, Kagoshima	Cities in Kyushu, Settlements in Kagoshima Prefecture
Kumamoto	Cities in Kyushu, Settlements in Kumamoto Prefecture
Bethlehem, Pennsylvania	Cities in Pennsylvania
Miyazaki, Miyazaki	Cities in Kyushu, Settlements in Miyazaki Prefecture
Ōita, Ōita	Cities in Kyushu, Settlements in Ōita Prefecture
Saga, Saga	Cities in Kyushu, Settlements in Saga Prefecture
George Thorogood and the Destroyers (album)	Blues albums, Blues rock albums, Debut albums
Lucky Star (song)	1984 songs, Madonna songs
Axel Zwingenberger	1955 births, Living people, Blues pianists, German pianists, Boogie Woogie pianists
Naha	Cities in Japan, Settlements in Okinawa Prefecture
Brick Lane	Roads in London, London Borough of Tower Hamlets, Grade II* listed buildings in London
Georgetown, South Carolina	Cities in South Carolina, County seats in South Carolina
Myrtle Beach, South Carolina	Cities in South Carolina
Valve Hammer Editor	Video game technology
Svitavy	Cities in the Czech Republic
Sunset Boulevard	Los Angeles, Roads in California
3D television	Television technology, Display technology
Martha Argerich	1941 births, Living people, Argentine Jews, Argentine pianists, Jewish musicians, People from Buenos Aires
The Black Cauldron	Fantasy books, 1965 books
Sloppy joe	Sandwiches
Nokia E7	Nokia mobile phones
Telecommuting	Transport, Employment
Terra Nova (TV series)	2011 American television series debuts, 2011 American television series endings, 2010s American television series, American drama television series, American science fiction television series, Television series about dinosaurs, Television series set in the future, Time travel television series, English-language television programs
Tokushima, Tokushima	Cities in Shikoku, Settlements in Tokushima Prefecture
Polka	Musical forms
Kōchi, Kōchi	Cities in Shikoku, Settlements in Kōchi Prefecture, 1889 establishments, 1880s establishments in Japan
Dream pop	Music genres
Takamatsu, Kagawa	Cities in Shikoku, Settlements in Kagawa Prefecture
Guilford County, North Carolina	1770s establishments in North Carolina, 1771 establishments, North Carolina counties
Fly fishing	Fishing
Matsuyama, Ehime	Cities in Shikoku, Settlements in Ehime Prefecture
Merkava	Tanks
Mining in Kutná Hora	Mining, Czech Republic
Ultima Online	Massively multiplayer online role-playing games, 1997 video games
Urdă	Romanian food, Cheeses
Rântaş	Romanian food, Sauces
Azerbaijan Democratic Republic	20th century in Azerbaijan, Political history of Azerbaijan, Azerbaijani republics, 1918 establishments, 1920 disestablishments
List of tallest buildings in Macon, Georgia	Lists of tallest buildings, Buildings and structures in Macon, Georgia, United States-related lists
Saint Joseph's Catholic Church (Macon, Georgia)	Roman Catholic churches, Churches in the United States, Buildings and structures in Macon, Georgia
Chroma key	Technology
Beach house	Houses
Dominatrix	BDSM, Human sexuality
Telemundo	Television channels
Knoxville, Georgia	Census-designated places in Georgia (U.S. state), Unincorporated communities in Georgia (U.S. state), County seats in Georgia
Hungry Eyes	1987 songs, Pop ballads, Torch songs
Eric Carmen	1949 births, Living people, Singers from Cleveland, Ohio
Thunderstorm	Severe weather, Precipitation
North Charleston, South Carolina	Cities in South Carolina
2012 Atlantic hurricane season	2012 Atlantic hurricane season
Poutine	Fast food, Canadian food, Cheese dishes
Bobby Pulido	1971 births, Living people, Singers from Texas, Tejano musicians
Aichi Prefecture	Aichi Prefecture, Prefectures of Japan
Dylan Sprouse	1992 births, Living people, American child actors, American movie actors, American television actors, American voice actors, Twin people from the United States, Actors from Long Beach, California, Businesspeople from California, Actors from New York City, Businesspeople from New York City
Cole Sprouse	1992 births, Living people, American child actors, American movie actors, American television actors, American voice actors, Twin people from the United States, Actors from Long Beach, California
Emilio Navaira	1962 births, 2016 deaths, American country guitarists, American country singers, Cardiovascular disease deaths in Texas, Deaths from myocardial infarction, Grammy Award winners, Musicians from San Antonio, Texas, Singers from San Antonio, Texas, Singer-songwriters from Texas, Tejano musicians
Graciela Beltran	1974 births, Living people, Mexican singers, People from Sinaloa
Box-set	Entertainment
Kenzō Tange	1913 births, 2005 deaths, Japanese architects, Pritzker Prize winners, People from Osaka, People from Ehime Prefecture
Ryan Braun	1983 births, Living people, Jewish American sportspeople, Milwaukee Brewers players, National League All-Stars
Jacksonville, North Carolina	Cities in North Carolina, County seats in North Carolina
West Des Moines, Iowa	Cities in Iowa
Los Tres Reyes	Mexican musical groups
Hlinsko	Cities in the Czech Republic
Sacagawea	Native American people, 1787 births, 1812 deaths, American explorers
Australasia at the Olympics	Former nations at the Olympics, Sport in Australia, Sport in New Zealand
Heroes of Might & Magic VI	2011 video games, MacOS games, Windows games, Ubisoft games
Generation kill	2004 books, War
Jawa Motors	Motorcycles
Frank Macfarlane Burnet	1899 births, 1985 deaths, Virologists, Scientists from Victoria (Australia), Australian medical researchers, Australian of the Year Award winners, Australian Nobel Prize winners
George Burns	1896 births, 1996 deaths, Actors from New York City, American centenarians, American movie actors, American television actors, Comedians from New York City, Deaths from cardiac arrest, Writers from New York City
Cathedral of the Holy Spirit (Czech Republic)	Roman Catholic Cathedrals, Buildings and structures in the Czech Republic
BIGBANG 2	2011 albums
Computer network	Computer networking
DFC Heidenreichstein	Women's football in Austria, Austrian football clubs, Football clubs of Lower Austria
Chuvash Wikipedia	Wikipedias, Websites established in 2004
ChuvashTet	Internet, Chuvash Republic
Alikovo, Alikovsky District, Chuvash Republic	Alikovsky District
Khirlepposi	Alikovsky District
Tautovskoye Rural Settlement	Alikovsky District, Rural settlements of the Chuvash Republic
Alikovskoye Rural Settlement	Alikovsky District, Rural settlements of the Chuvash Republic
Bolshevylskoye Rural Settlement	Alikovsky District, Rural settlements of the Chuvash Republic
Chuvashsko-Sorminskoye Rural Settlement	Alikovsky District, Rural settlements of the Chuvash Republic
Kilobit	Computing measurement
Krymzaraykinskoye Rural Settlement	Alikovsky District, Rural settlements of the Chuvash Republic
Pitishevskoye Rural Settlement	Alikovsky District, Rural settlements of the Chuvash Republic
Raskildinskoye Rural Settlement	Alikovsky District, Rural settlements of the Chuvash Republic
Shumshevashskoye Rural Settlement	Alikovsky District, Rural settlements of the Chuvash Republic
Teneyevskoye Rural Settlement	Alikovsky District, Rural settlements of the Chuvash Republic
Yandobinskoye Rural Settlement	Alikovsky District, Rural settlements of the Chuvash Republic
Yefremkasinskoye Rural Settlement	Alikovsky District, Rural settlements of the Chuvash Republic
Nikolay Yut	1898 births, 1967 deaths, Russian writers, Alikovsky District
Arcady Aris	1901 births, 1941 deaths, Russian writers, Alikovsky District
Robert Moresco	Living people, Year of birth missing (living people), American screenwriters, Academy Award winning writers, American movie producers
Jolbon	Capital of Korea, History of Korea, 30s BC establishments
Sequoia	Cupressaceae, Plants of North America
New Bern, North Carolina	Cities in North Carolina, County seats in North Carolina, Former United States state capitals
Ecological footprint	Environmental issues
Pope Innocent VII	Italian popes, 1336 births, 1406 deaths
Environmental impact of aviation	Environmental issues, Aviation
Happiness (Alexis Jordan song)	Alexis Jordan songs, 2010 songs
Alexis Jordan (album)	Alexis Jordan, 2011 albums, Debut albums, Pop albums, R&B albums
Alexis Jordan discography	Discographies, Alexis Jordan
Opening act	Entertainment
StarRoc/Roc Nation	American record labels
T4 on the Beach	2003 establishments in England, Channel 4 television programmes, Music festivals in England, Norfolk, Somerset
JLS	2013 disestablishments in the United Kingdom, 2000s British music groups, 2006 establishments in England, 2010s British music groups, Black British people, English boy bands, English R&B bands, English pop music groups, Musical groups disestablished in 2013, Musical groups established in 2006, Musical groups from London, The X Factor contestants
I Have Nothing	1993 songs, Whitney Houston songs, Michael Jackson songs
Hot Dance Club Songs	Billboard charts
Hush Hush (Alexis Jordan song)	Alexis Jordan songs, 2011 songs
Good Girl (Alexis Jordan song)	Alexis Jordan songs, 2011 songs
Mixed race	Race
Sonny Terry	Blues musicians, 1911 births, 1986 deaths, Blues harp players
Water footprint	Water
Pope Boniface IX	Italian popes, 1350 births, 1404 deaths
Pope Boniface	Papal names
Recursive algorithm	Recursion
Bang!	Card games
Aspen	Trees, Malpighiales
Iyyampalayam	Villages in India
Kenny G	1956 births, Living people, Musicians from Seattle, Washington, American jazz musicians, Jewish American musicians
Git (software)	Free software, Microsoft Windows software, Linux software
Škoda Auto	Automobile companies, 1895 establishments in Europe, Czech Republic
Masolino	1380s births, 1440s deaths, 15th century Italian painters
Got 2 Luv U	2011 songs, Alexis Jordan songs
Selena videography	Selena
Rohingya people	Ethnic groups in Bangladesh, Burmese people
Tanuma Okitsugu	1719 births, 1788 deaths, Daimyo, People from Tokyo
Arakan State	States of Myanmar
Arakanese people	Ethnic groups in Asia
Tenmei	Japanese eras, 1781 establishments, 18th century establishments in Japan, 1788 disestablishments, 18th century disestablishments in Japan, 1780s establishments in Asia
Waltari	Musical groups from Helsinki, Alternative metal bands, 1986 establishments in Europe, 20th century establishments in Finland
Capital of Brazil	Capital of Brazil
Multiple sclerosis	Health problems
Adabel Guerrero	1978 births, Living people, Argentine actors, Argentine models, Dancers
Walter Raleigh	1550s births, 1618 deaths, English writers, English explorers
Rings of Uranus	Uranus (planet)
Excision (musician)	1986 births, Living people, DJs, Electronic musicians, People from Kelowna
Populus	Trees, Malpighiales
Equilibrium constant	Physical chemistry, Analytical chemistry
Edward Durell Stone	1902 births, 1978 deaths, Harvard University alumni, Massachusetts Institute of Technology alumni, American architects, Businesspeople from Arkansas, People from Fayetteville, Arkansas
Bashar al-Assad	1965 births, Living people, Current national leaders, Dictators, People from Damascus, Presidents of Syria, Syrian military people
Overseas departments of France	Overseas Regions of France, Departments of France
Amy Poehler	1971 births, American feminists, Living people, Comedians from Massachusetts, American television actors, American movie actors, Actors from Boston, Massachusetts, People from Newton, Massachusetts
Pope Gregory XI	French popes, 1331 births, 1378 deaths
Cantinflas	Actors from Mexico City, Mexican stage actors, Mexican television actors, 1911 births, 1993 deaths
Carbon diet	Environment, Green politics
Pope Innocent IX	Italian popes, 1519 births, 1591 deaths
Pope Innocent X	Italian popes, People from Rome, 1574 births, 1655 deaths, House of Borgia
Yuko Kavaguti	1981 births, Living people, Japanese figure skaters, Russian sportspeople, People from Chiba Prefecture
Sugarland	Country bands, Musical duos
BIGBANG	2009 albums
List of blues harmonica players	Blues harp players, Music-related lists, Lists of entertainers
Boron carbide	Carbon compounds, Armour
Numerical control	Tools
Bolt cutter	Cutting tools
Crowbar	Tools
Mid-Atlantic Ridge	Atlantic Ocean, Plate tectonics, Geography of Iceland
Pope Innocent XI	Italian popes, 1611 births, 1689 deaths, Beatified people, People from Como
Surface area to volume ratio	Geometry
Honda Accord	Honda automobiles, 1970s automobiles, 1980s automobiles, 1990s automobiles, 2000s automobiles, 2010s automobiles
Punched card	Data input
Sri Lanka at the Olympics	Sport in Sri Lanka, Nations at the Olympics
Syria at the Olympics	Syria, Nations at the Olympics
Chinese Taipei at the Olympics	Nations at the Olympics
Tajikistan at the Olympics	Sport in Tajikistan, Nations at the Olympics
Timor-Leste at the Olympics	East Timor, Nations at the Olympics
Naypyidaw	Cities in Myanmar, Capital cities in Asia
Metabolism (architecture)	Architectural styles
Nakagin Capsule Tower	Towers in Japan, Buildings and structures in Tokyo, Buildings and structures completed in the 20th century
Gary Mason	1962 births, 2011 deaths, Black British sportspeople, British boxers, British rugby league players, Jamaican sportspeople, Road accident deaths
Australia at the Olympics	Nations at the Olympics, Sport in Australia
Citroën Saxo	Citroen automobiles, Front wheel drive vehicles, 1980s automobiles, 1990s automobiles
Arab Spring	2010s, History of the Middle East, Democracy movements
Guangzhou	Guangzhou, Capital cities in Asia
Adela Noriega	Mexican television actors, 1969 births, Living people, Actors from Mexico City
White rice	Rice
Gas discharge lamp	Lamps
Charged particle	Electromagnetism, Physics
Germicidal lamp	Lamps
Nineveh	Assyria, Archaeological sites in Iraq, Cities in Iraq, Mesopotamia
List of most visited art museums in the world	Art museums, Lists of museums
White asbestos	Asbestos
Pope Innocent XII	Italian popes, 1615 births, 1700 deaths
Pope Innocent XIII	Italian popes, 1655 births, 1724 deaths
M. H. de Young Memorial Museum	Art museums in the United States, Buildings and structures in San Francisco, 1895 establishments in the United States, 1890s establishments in California
Hurricane Roxanne	1995 Atlantic hurricane season, 1995 in Mexico, October events
Authors of the Bible	Bible
Big Mama Thornton	Blues harp players, American blues musicians, American blues singers, Singers from Alabama, Musicians from Alabama, 1926 births, 1984 deaths, People from Montgomery, Alabama
Martine Aubry	1950 births, Living people, French mayors, Politicians from Paris
Piano concerto	Musical forms, Piano
Ōei	Japanese eras, 1394 establishments, 14th century establishments in Japan, 1428 disestablishments, Disestablishments in Japan
Shōchō	Japanese eras
Eikyō	Japanese eras
Unilineal evolution	Anthropology, Sociology
Kakitsu	Japanese eras
Bun'an	Japanese eras
Shakin' Stevens	1948 births, Living people, Musicians from Cardiff, Welsh rock musicians, Welsh singer-songwriters
Kyōtoku	Japanese eras
Hōtoku	Japanese eras
Kōshō	Japanese eras
Chōroku	Japanese eras
Kanshō	Japanese eras
Bunshō	Japanese eras
Fashion Bug	Clothing companies, 1960 establishments in the United States
Ōnin	Japanese eras
Bunmei	Japanese eras
Chōkyō	Japanese eras
Honoré de Balzac	1799 births, 1850 deaths, Burials at Père Lachaise Cemetery, French novelists, French Roman Catholics
Leona Cavalli	1969 births, Living people, Brazilian movie actors, Brazilian television actors, People from Rio Grande do Sul
Entoku	Japanese eras
Hurricane Juan (1985)	Hurricanes in the United States
Meiō	Japanese eras
Hurricane Hortense	Hurricanes
Bunki	Japanese eras
Ballistic coefficient	Ballistics
Eishō (Muromachi period)	Japanese eras
Daiei (era)	Japanese eras
List of Russian weaponry	Military of Russia, Weapons, Russia-related lists
9A-91	Firearms
Mike Starr (musician)	1966 births, 2011 deaths, American rock musicians, Bassists, Drug-related deaths, Musicians from Hawaii, People from Honolulu
Dr. Dre	African American actors, African American musicians, American movie actors, American rap musicians from California, Singers from Los Angeles County, California, Actors from Compton, California, 1965 births, Living people
So Weird	Television series by Disney, English-language television programs, 1999 television series debuts, 2001 television series endings
Carmen Amaya	1913 births, 1963 deaths, Dancers, Musicians from Barcelona, Spanish singers
Antonio (dancer)	Spanish entertainers, Dancers, Choreographers, 1921 births, 1996 deaths
Sang Sapurba	Folklore, History of Malaysia
Selman Waksman	American biochemists, American Nobel Prize winners, Microbiologists, 1888 births, 1973 deaths
Foam	Mechanics
Iroquois Falls	Towns in Ontario
Marcel Koller	Swiss footballers, Swiss football managers, 1960 births, Austria national football team managers, Living people, Sportspeople from Zürich
Thailand at the Olympics	Sport in Thailand, Nations at the Olympics
Turkmenistan at the Olympics	Nations at the Olympics, Turkmenistan
United Arab Emirates at the Olympics	Nations at the Olympics, Sport in the United Arab Emirates
Uzbekistan at the Olympics	Nations at the Olympics, Sport in Uzbekistan
Vietnam at the Olympics	Nations at the Olympics, Sport in Vietnam
Yemen at the Olympics	Nations at the Olympics, Sport in Yemen
South Yemen at the 1988 Summer Olympics	Nations at the Olympics, Sport in Yemen
Cook Islands at the Olympics	Nations at the Olympics, Cook Islands
Fiji at the Olympics	Nations at the Olympics, Sport in Fiji
Guam at the Olympics	Nations at the Olympics, Guam
Kiribati at the Olympics	Nations at the Olympics, Kiribati
Hurricane Carmen	Hurricanes in the United States, 1974 in the United States, 20th century in Puerto Rico, 1970s in Mexico, 20th century in Louisiana, Hurricanes in Mexico
Federated States of Micronesia at the Olympics	Nations at the Olympics, Federated States of Micronesia
Nauru at the Olympics	Nations at the Olympics
Tong Dizhou	Chinese scientists, Developmental biologists, 1902 births, 1979 deaths, Zhejiang
Palau at the Olympics	Nations at the Olympics, Palau
Papua New Guinea at the Olympics	Nations at the Olympics, Sport in Papua New Guinea
Riebeckite	Asbestos
Samoa at the Olympics	Nations at the Olympics, Samoa
Solomon Islands at the Olympics	Nations at the Olympics, Solomon Islands
The Right Honourable	Styles (manners of address)
Kyōroku	Japanese eras
Waterfowl hunting	Leisure
Ambrosia	Greek mythology
National Assembly of Azerbaijan	National legislatures, Government of Azerbaijan
Sikhye	Drinks, Korean food
Play therapy	Psychology
Tropical Storm Claudette (1979)	1979 Atlantic hurricane season, Hurricanes in the United States, July events, 1979 in the United States, 20th century in Puerto Rico, 20th century in the Dominican Republic, 20th centuy in Haiti, 1970s in Cuba, 1970s in Texas, 20th century in Louisiana, 20th century in Missouri, 20th century in Kentucky, 1970s in Virginia
Tropical Storm Hermine (2010)	Tropical cyclones in North America, 2010 in weather, 2010 in Mexico, 2010 in the United States, 2010s in Texas, 2010s in Oklahoma
Vox (musical equipment)	Musical instrument companies, Companies of Japan
Cast member	Performing arts
Online shopping	Shops, Internet
Substrate (chemistry)	Chemical reactions
Ovipositor	insects, Animal anatomy
Chrudim	Towns in the Czech Republic
Tenbun	Japanese eras
Nuremberg Zoo	Buildings and structures in Bavaria, Nuremberg, Zoos in Germany
Kim Wilson	1951 births, Blues harp players, American blues singers, American blues musicians, Singers from Detroit, Michigan, Musicians from Detroit, Michigan, Living people
Letters to Juliet	2010 romance movies, 2010 comedy-drama movies, 2010s romantic comedy movies, 2010s romantic drama movies, American comedy-drama movies, American romantic comedy movies, American romantic drama movies, English-language movies, Italian-language movies, Movies about vacationing, Movies set in Italy, Multilingual movies, Verona
John Whitney Hall	1916 births, 1997 deaths, Japanologists, Harvard University alumni, American historians, Editors
Zork	Zork, Adventure games
Battles of Napoleon	1988 video games, Apple II games, Commodore 64 games, DOS games
Neusis construction	Geometry
Acute accent	Alphabetic diacritics
Sonitpur	Assam
Kōji (Muromachi period)	Japanese eras
Velvet Revolution	Czechoslovakia, Democracy movements
Infocom	Infocom, Companies based in Massachusetts, Cambridge, Massachusetts, 1970s establishments in Massachusetts, 1979 establishments in the United States, 20th-century disestablishments in Massachusetts, 1989 disestablishments in the United States
Gemology	Gemstones, Geology
Didcot power stations	1968 establishments in England, Power plants, South Oxfordshire
Eiroku	Japanese eras
Samgyetang	Korean food, Soups
Sesame oil	Condiments, Cooking oils
Gristmill	Grains, Technology
The Kiss (Klimt painting)	1900s paintings, 1907
Asbestosis	Diseases, Asbestos
Mesothelioma	Cancer, Asbestos
Annie Raines	Blues musicians, Blues harp players, 1969 births, Living people
Carey Bell	Chicago blues musicians, Blues harp players, 1936 births, 2007 deaths
Babi	Egyptian gods and goddesses
Khepri	Egyptian gods and goddesses
Appendage	Animal anatomy, Developmental biology
Ministry of Defence (UK)	Departments of the United Kingdom Government
Terraria	Role-playing video games, 2011 video games
List of political parties in Azerbaijan	Political parties in Azerbaijan, Politics of Azerbaijan, Lists of political parties, Azerbaijan-related lists
One-party dominant state	Political systems
Genki	Japanese eras
O. Henry	Writers from North Carolina, Deaths from diabetes, 1862 births, 1910 deaths, Pen names
Kenneth G. Wilson	1936 births, 2013 deaths, American academics, American Nobel Prize winners, American physicists, Deaths from lymphoma, Harvard University alumni, Scientists from Massachusetts, Theoretical physicists, Wolf Prize winners
Tenshō (Momoyama period)	Japanese eras, 1573 establishments, 16th century establishments in Japan, 1592 disestablishments, 16th century disestablishments in Japan
Bunroku	Japanese eras, 1592 establishments, 16th century establishments in Japan, 1596 disestablishments, 16th century disestablishments in Japan
Marcos de Niza	1490s births, 1558 deaths, Explorers, Franciscans, People from Nice, Religious workers
Apex (diacritic)	Alphabetic diacritics, Latin language
Differential geometry	Geometry
New Azerbaijan Party	Political parties in Azerbaijan, Nationalist organizations in Azerbaijan
Tonga at the Olympics	Nations at the Olympics, Tonga
Forgery	Types of crime
Crazyracing Kartrider	Online games
Hanok	Buildings and structures in Korea, Houses
A cappella	Singing
Boxer briefs	underwear
Genna	Japanese eras, 1615 establishments, 17th century establishments in Japan, 1624 disestablishments, 17th century disestablishments in Japan
Spanking	Punishments
Ragunan Zoo	Zoos
Green chemistry	Environmental chemistry
Toastmasters International	International organizations, Public speaking, Santa Ana, California
Memristor	Electronic components
Geostationary orbit	Satellites, Astrophysics
Weevil	Polyphaga
4D	Geometry, Physics
Profiling	Psychology, Criminal justice
Kula ring	Trade, Papua New Guinea
Fa’afafine	Gender, Samoa
Maslenitsa	Holidays, Russia
Lockheed Martin F-35 Lightning II	Military aircraft, Lockheed & Lockheed-Martin aircraft
The Blues Band	Blues bands
Acute (medicine)	medicine
Toxicity	Toxicology
Kan'ei	Japanese eras, 1624 establishments, 17th century establishments in Japan, 1643 disestablishments, 17th century disestablishments in Japan, 1640s disestablishments in Asia, 1620s establishments in Asia
Protostar	Types of stars
Fresca	Drinks
Bank of Japan	1882 establishments, 1880s establishments in Japan, Banks, Companies of Japan
Shōhō	Japanese eras, 1644 establishments, 17th century establishments in Japan, 1648 disestablishments, 17th century disestablishments in Japan, 1640s disestablishments in Asia
1938 New England hurricane	Hurricanes in the United States, 1938 in North America, September events, 20th century in the Bahamas, 1930s in the United States, 20th century in New Jersey, 1930s in New York (state), 20th century in Connecticut, 20th century in Rhode Island, 20th century in Massachusetts, History of Vermont, 20th century in New Hampshire, 20th century in Maine, 1930s in Canada
Darrell K. Sweet	1934 births, 2011 deaths, American painters, People from New Jersey
Reanimation	2002 albums, Linkin Park albums, Nu metal albums
Axum	Settlements in Ethiopia
Pygmalion	Plays
Elizabeth Perkins	1960 births, Living people, DePaul University alumni, American movie actors, American television actors, Actors from New York City
Virginia Cooperative Extension	Education in the United States‏, 1914 establishments in the United States, 20th-century establishments in Virginia
Jared Lee Loughner	1988 births, Living people, American murderers, American prisoners, People convicted of attempted murder, People from Tucson, Arizona, People with schizophrenia
Mosaic (genetics)	Classical genetics
Anti-fan	Fandom
Mountain pygmy possum	Marsupials of Australia, Diprotodonts
Movie censorship	Movie ratings, Censorship
Monsanto process	Organometallic chemistry, Chemical processes
Keian	Japanese eras, 1648 establishments, 17th century establishments in Japan, 1652 disestablishments, 1650s disestablishments in Japan
Communist Party of Pakistan	Political parties in Pakistan, Communist parties
Jōō (Edo period)	Japanese eras, 1652 establishments, 1650s establishments in Japan, 1655 disestablishments, 1650s disestablishments in Japan
Meireki	Japanese eras, 1655 establishments, 1650s establishments in Japan, 1658 disestablishments, 1650s disestablishments in Japan
Manji (era)	Japanese eras, 1658 establishments, 1650s establishments in Japan, 1661 disestablishments, 17th century disestablishments in Japan
Regionalliga Ost	Football in Austria, Football leagues
Heterochromia	Genetics, Eye
Osteopathy	Health, Alternative medicine
Endogamy	Marriage, Genetics
Exogamy	Marriage
Throw out the baby with the bath water	Idioms
The Lurking Horror	1987 video games, Infocom
Tuvalu at the Olympics	Nations at the Olympics, Tuvalu
Pope Gregory XII	Italian popes, 1320s births, 1417 deaths
Vanuatu at the Olympics	Nations at the Olympics, Vanuatu
New Zealand at the Olympics	Nations at the Olympics, Sport in New Zealand
Austria at the Olympics	Nations at the Olympics, Sport in Austria
Azerbaijan at the Olympics	Nations at the Olympics, Sport in Azerbaijan
Belarus at the Olympics	Nations at the Olympics, Sport in Belarus
Bearing (navigation)	Navigation
Kanbun (era)	Japanese eras, 1661 establishments, 17th century establishments in Japan, 1673 disestablishments, 17th century disestablishments in Japan
Belgium at the Olympics	Nations at the Olympics, Sport in Belgium
Bosnia and Herzegovina at the Olympics	Sport in Bosnia and Herzegovina, Nations at the Olympics
National Art Center, Tokyo	Art museums in Japan, National museums in Japan, Buildings and structures in Tokyo
Minoru Miki	Japanese musicians, 2011 deaths, 1930 births, People from Tokushima Prefecture
Treyarch	Companies based in California, Video game companies, Santa Monica, California, American technology companies, 1996 establishments in California
Enpō	Japanese eras, 1673 establishments, 17th century establishments in Japan, 1681 disestablishments, 1680s disestablishments in Japan
Roderick MacKinnon	1956 births, Living people, Scientists from Massachusetts, American Nobel Prize winners, American chemists, Neuroscientists
Luis Raymond Villafuerte	1968 births, Living people, Filipino politicians, People from Quezon City
High arch	Feet
Gamophobia	Phobias
Cluny Abbey	Benedictine abbeys, Buildings and structures in France, Bourgogne-Franche-Comté
Irish rebellion of 1798	History of Ireland, 1798, 1790s in Europe
Volcanic winter	Weather, Volcanoes, Climate
4Minute	South Korean girl groups, K-pop music groups, 2009 establishments in Asia, 2000s establishments in South Korea, Musical groups disestablished in 2016, 2010s disestablishments in Asia, Musical groups established in 2009, Disestablishments in South Korea
The Brady Bunch	1969 establishments in the United States, Fictional families, Television series about families, English-language television programs
Tristania	Death metal bands, Doom metal bands, Gothic metal bands, Norwegian heavy metal bands, Stavanger
Double acute accent	Alphabetic diacritics
Ken Park	Obscenity controversies, 2002 drama movies, American erotic movies, American drama movies, Dutch drama movies, French drama movies, English-language movies, American independent movies, Movies about child sexual abuse
Cosmic distance ladder	Astronomical distances
V-1 flying bomb	Explosives, Nazi Germany
Citrus Blast	Soft drinks
Young Dracula	Children's television series, BBC Television programmes, English-language television programs
Sagittarius Window Eclipsing Extrasolar Planet Search	Astronomy
Tenna	Japanese eras, 1681 establishments, 1680s establishments in Japan, 1684 disestablishments, 1680s disestablishments in Japan
Brown asbestos	Asbestos
Jōkyō	Japanese eras, 1684 establishments, 1680s establishments in Japan, 1688 disestablishments, 1680s disestablishments in Japan
Data Encryption Standard	Cryptography
Sha Tin Racecourse	Horse racing, Sports buildings, Buildings and structures in Hong Kong
1925 Geneva Protocol	Treaties and Conventions, 1925, 1920s in Europe, 20th century in Geneva, Chemical warfare, 1920s treaties
Fledge	Developmental biology, Birds
Rat snake	Colubrids
Inductively coupled plasma mass spectrometry	Mass spectrometry, Laboratory equipment, Analytical chemistry
The Birds of America	Biology books
Charles Wright (poet)	American poets, Writers from Tennessee, 1935 births, Living people
4-H	Agriculture, Education in the United States, Youth organizations
Emeishan Traps	Geography of China, Extinction events, Flood basalts
Hurricane Janet	Deadly storms, 1955 in North America, Hurricanes in Mexico, 1950s in Mexico, September events
RMS Carpathia	Ships, RMS Titanic
Pope Clement V	1264 births, 1314 deaths, French popes
Mucous membrane	Anatomy
Thimble	Needlework
Raymond Poincaré	1860 births, 1934 deaths, French Ministers of Finance, French people of World War I, Government ministers of France, Presidents of France
Knob and tube wiring	Electrical wiring, Construction
Post-postmodernism	Art movements, Philosophical movements and positions
Enzo Fortuny	Child actors, Mexican movie actors, Mexican voice actors, 1981 births, Living people, People from Veracruz
Exercise physiology	Physiology, Evolutionary biology, Sports
Short circuit	Electricity
Circuit breaker	Electrical wiring
The Merchant of Venice	Plays by William Shakespeare
Yoji Koda	1949 births, Living people, Admirals, Japanese academics, Japanese military people, Japanese writers, People from Tokushima Prefecture
Regionalliga Mitte	Football in Austria, Football leagues
Tawakel Karman	1979 births, Living people, Human rights activists, Journalists, Yemeni people
Porsche 911	Sports cars, Porsche automobiles
A Painful Case	British short stories, Works of James Joyce
Anthropometry	Anatomy, Measurement, Anthropology, Physical anthropology
Eyelid	Eye
Copenhagen Airport	1925 establishments in Europe, 20th century establishments in Denmark, Airports in Denmark, Copenhagen
Korean Americans	Ethnic groups in the United States
Gentlemen's agreement	Everyday life
Hovenia dulcis	Rhamnaceae
Dalit	Discrimination, Society
Mesosaurus	Fossils, Marine reptiles
Bokbunja ju	Wine
Hangwa	Korean food
Hōei	Japanese eras, 1704 establishments, 18th century establishments in Japan, 1711 disestablishments, 18th century disestablishments in Japan, 1700s establishments in Asia
Verdin	Birds of North America
Trans-Mexican Volcanic Belt	Volcanic landforms, Volcanoes of Mexico
Volcanic belt	Volcanoes
Sikhae	Korean food
Boltzmann constant	Thermodynamics, Physics
December Boys	2007 drama movies, 2007 romance movies, 2000s romantic drama movies, American romantic drama movies, Australian drama movies, Australian romance movies, English-language movies, Movies based on books, Movies set in the 1960s, Warner Bros. movies
Anapsid	Tetrapods
Bushtit	Birds of North America, Birds of Central America, Birds of the United States, IUCN Red List least concern species
Duck pond	Ponds, Ducks
Diapsid	Reptiles, Skeletal system
World of Tanks	2011 video games, Online games, Android (operating system) games, Freeware games, IOS games, Massively multiplayer online role-playing games, MacOS games, PlayStation 4 games, Simulator video games, Windows games, Xbox 360 games, Xbox One games
Multiplayer online game	Online games
NBA 2K11	Sports video games, PlayStation 2 games, PlayStation 3 games, PlayStation Portable games, Wii games, Xbox 360 games, 2010 video games, Windows games
Heydar Aliyev International Airport	Buildings and structures in Azerbaijan, Airports in Europe, Buildings and structures in Baku, Transport in Azerbaijan
Doug Hutchison	Actors from Delaware, American movie actors, American television actors, 1960 births, Living people, People from Dover, Delaware
Weapons of World War I	Firearms
Yume Nikki	2005 video games, Freeware games, Windows games, Adventure games
Eddie Rickenbacker	1895 births, 1973 deaths, American autobiographers, American aviators, American military personnel of World War I, Majors, People from Columbus, Ohio, United States Army Medal of Honor recipients
Suncheon	Cities in South Korea
Dean Edwards	African American actors, American stand-up comedians, American movie actors, American television actors, Actors from New York City, 1970 births, Living people, American Internet celebrities
Shōtoku (era)	Japanese eras, 1711 establishments, 18th century establishments in Japan, 1716 disestablishments, 18th century disestablishments in Japan, 1710s establishments in Asia
Ice storm	Severe weather
Miguel Cabrera	1983 births, Detroit Tigers players, Living people, National League All-Stars, American League All-Stars, Florida Marlins players, Venezuelan sportspeople
Fermilab	Fermilab, Buildings and structures in Chicago, Illinois
Heterojunction bipolar transistor	Electronic components
Wet chemistry	Chemistry
Korean Canadian	Ethnic groups in Canada, Korean people, Canadian people
Placodont	Sauropterygia, Marine reptiles
Becoming Jane	Jane Austen, 2007 movies, Movies based on books, English-language movies, People's Choice Award winners
Steven Chu	1948 births, Living people, American academics, American Nobel Prize winners, American physicists, Politicians from St. Louis, Missouri, Scientists from St. Louis, Missouri, United States Secretaries of Energy, University of Rochester alumni, US Democratic Party politicians, Stanford University faculty, University of California, Berkeley faculty
Pororo the Little Penguin	Animation, South Korean culture
Queen Seondeok of Silla	606 births, 647 deaths, Kings and queens, Korean monarchs
Styx Records	Blues labels, Record labels, Independent record labels
Disability Discrimination Act 1995	1995 in the United Kingdom, Disability, Discrimination, Education in the United Kingdom, Acts of the Parliament of the United Kingdom, Rights
Pachypleurosaur	Sauropterygia, Marine reptiles
Harrington Hump	Rail infrastructure, Railway stations
Seven Sisters Road	Roads in London
Indigo bunting	Passeriformes
The Railway Magazine	Rail transport in the United Kingdom, Monthly magazines, 1897 establishments in the United Kingdom
London Transport Board	1963 establishments in England, 1969 disestablishments in the United Kingdom, Transport in London, 1960s disestablishments in England
Northern shoveler	Ducks
Stiff-tailed duck	Ducks
Kyōhō	Japanese eras, 1716 establishments, 18th century establishments in Japan, 1735 disestablishments, 18th century disestablishments in Japan, 1710s establishments in Asia
Tteokbokki	Korean food, Rice dishes
Hōreki	Japanese eras, 1751 establishments, 18th century establishments in Japan, 1764 disestablishments, 18th century disestablishments in Japan
South African Republic	Former countries in Africa, History of South Africa, 1856 establishments, 1850s establishments in Africa, 1900s disestablishments in Africa
Inland sea	Seas
Daruma doll	Japanese folklore, Japanese culture, Luck
Viña del Mar	Cities in Chile, 1878 establishments, 19th-century establishments in Chile
Suzuki Choinori	2003 establishments in Japan, 2007 disestablishments, Motorcycles
Meiwa	Japanese eras, 1764 establishments, 18th century establishments in Japan, 1772 disestablishments, 18th century disestablishments in Japan
Mourning	Death customs
Independent record label	Record labels
An'ei	Japanese eras, 1772 establishments, 18th century establishments in Japan, 1781 disestablishments, 18th century disestablishments in Japan, 1770s establishments in Asia
Take	Terminology
Lizzy Pattinson	English songwriters, English singers, Living people, Year of birth missing (living people)
Kansei	Japanese eras, 1789 establishments, 18th century establishments in Japan, 1801 disestablishments, 19th century disestablishments in Japan, 1780s establishments in Asia, 1800s disestablishments in Asia
Pontoise	Communes in Val-d'Oise, Subprefectures in France
Fuse	Electrical wiring, Electronic components
Kyōwa	Japanese eras, 1801 establishments, 19th century establishments in Japan, 1804 disestablishments, 19th century disestablishments in Japan, 1800s establishments in Asia, 1800s disestablishments in Asia
Naengmyeon	Korean food
Mathieu de Costa	Explorers, Canadian people, African people, 16th century births, 17th century deaths, Translators
Bunka	Japanese eras, 1804 establishments, 19th century establishments in Japan, 1818 disestablishments, 19th century disestablishments in Japan, 1800s establishments in Asia
Bunsei	Japanese eras, 1818 establishments, 19th century establishments in Japan, 1830 disestablishments, 19th century disestablishments in Japan, 1810s establishments in Asia
Tadao Ando	Japanese architects, 1941 births, Living people, People from Osaka, Pritzker Prize winners
X rating	Controversies, Movie ratings
Sinhala script	Writing systems, Sinhala language
Arrondissement of Bayeux	Arrondissements of France
Abugida	Writing systems
Tyrrell Racing	Formula One constructors, British automobile companies
Copenhagen Metro	Transport in Denmark, Copenhagen, Rapid transit systems
Weston, Illinois (DuPage County)	Villages in Illinois, Fermilab, 1960s establishments in Illinois, Unknown disestablishments
Kim Ok-gyun	1851 births, 1894 deaths, Korean politicians, Korean educators, Murder victims, Autobiographers
Great Britain at the Olympics	Sport in the United Kingdom, Nations at the Olympics
Sundance Sea	Geography of North America, Jurassic, Seas of the Arctic Ocean
Western Interior Seaway	Geography of North America, Cretaceous, Seas
Common Poorwill	Birds of North America
Hooded pitohui	Birds of Oceania
2014 Atlantic hurricane season	2014 disasters, Hurricanes
Tenpō	Japanese eras, 1830 establishments, 19th century establishments in Japan, 1844 disestablishments, 19th century disestablishments in Japan, 1830s establishments in Asia
Direct proof	Mathematics, Logic
Death Valley Junction	National Register of Historic Places, Unincorporated communities in California, Settlements in Inyo County, California, 1923 establishments in the United States, 1920s establishments in California
Criticism of Christianity	Controversies
Kōka	Japanese eras, 1844 establishments, 19th century disestablishments in Japan, 1848 disestablishments, 1840s establishments in Japan
Hoxne treasure	Ancient Rome, Archaeological sites in Suffolk, Suffolk, Treasure troves, Coins
Tōhoku region	Geography of Japan, Honshu
Sri Lanka Railways S11	Locomotives, Sri Lanka
Communes of the Guadeloupe department	Communes in Guadeloupe, Lists of communes of France
Germany at the Olympics	Sport in Germany, Nations at the Olympics
Line Islands	Pacific islands
Kaei	Japanese eras, 1848 establishments, 1840s establishments in Japan, 1854 disestablishments, 19th century disestablishments in Japan
Fenius Farsaid	Mythology, Ireland, Kings and queens
Weston, Illinois (McLean County)	Unincorporated communities in Illinois, 1867 establishments in the United States, 1860s establishments in Illinois
Ansei	Japanese eras, 1854 establishments, 19th century establishments in Japan, 1860 disestablishments, 1860s disestablishments in Japan, 1850s establishments in Asia
Man'en	Japanese eras, 1860 establishments in Asia, 1860s establishments in Japan, 1861 disestablishments, 1860s disestablishments in Japan
Euro disco	Disco, Pop music, Dance music, Electronic dance music
Wilson's bird-of-paradise	Paradisaeidae
Woodpecker Finch	Finches, Galápagos Islands
Secretarybird	Accipitriformes
Nucleophile	Physical organic chemistry
Taishō period	Japanese eras, 1912 establishments in Asia, 1910s establishments in Japan, 1926 disestablishments, 20th century disestablishments in Japan, 1920s disestablishments in Asia
Lanarkshire derby	Football in Scotland
Camposaurus	Theropods, Triassic dinosaurs
Staurikosaurus	Triassic dinosaurs, Dinosaurs of South America, Theropods
Ostend manifesto	1854 in the United States, 19th century in Belgium, 19th century in Cuba, Slavery
Electronic Delay Storage Automatic Calculator	Computers
Voting age	Voting
Shrek the Halls	Christmas movies, 2007 television movies, Shrek
Mick Wingert	American voice actors, American stand-up comedians, American movie actors, American television actors, Actors from California, 1974 births, Living people, Comedians from California
Shōwa period	Japanese eras, 1926 establishments in Asia, 1920s establishments in Japan, 1989 disestablishments, 20th century disestablishments in Japan, 1980s disestablishments in Asia
2016 United States presidential election	2016 United States presidential election, November 2016 events
Lucy Liu	1968 births, Living people, Actors from Queens, American artists, American movie actors, American television actors, Movie producers from New York City, New York University alumni
Christina Crawford (wrestler)	1988 births, American dancers, African-American wrestlers, Female professional wrestlers, Former WWE wrestlers, Living people, Sportspeople from Tampa, Florida
Christian symbolism	Christian symbols
Bohemia at the Olympics	Former nations at the Olympics, Bohemia
American Vampire	Comic books, 2010 books, Books by Stephen King
Basal	Evolutionary biology, Taxonomy
Electronic dance music	Electronic dance music
Heisei period	Japanese eras, 1989 establishments in Asia, 1980s establishments in Japan
E pluribus unum	Latin phrases, Mottos of the United States
An Outcast of the Islands	1896 books, Novels, Works by Joseph Conrad
Scipionyx	Cretaceous dinosaurs, Dinosaurs of Europe, Coelurosaurs
Battle of Messines	1917 in Belgium, Battles involving Australia, Battles involving Germany, Battles involving New Zealand, Battles involving the United Kingdom, Battles of the Western Front (World War I), Flanders, West Flanders, June events
Döbereiner's lamp	Fire, Light
Shōwa (Kamakura period)	Japanese eras, 1311 establishments, 1310s establishments in Japan, 1317 disestablishments, 1310s disestablishments in Japan
Macron	Alphabetic diacritics
Bulgaria at the Olympics	Nations at the Olympics, Sport in Bulgaria
WYSIWYM	Web design, Acronyms
Phantom island	Phantom islands
Enkyō (Edo period)	Japanese eras, 1744 establishments, 1740s establishments in Japan, 1748 disestablishments, 1740s disestablishments in Japan
Aerogel	Materials, Insulation
Red Bull GmbH	Austrian food, Drink companies, Companies of Austria, 1984 establishments in Europe, 20th century establishments in Austria
Wakulla County, Florida	Florida counties, 1843 establishments in the United States, 1840s establishments in Florida Territory
Kan'en	Japanese eras, 1748 establishments, 1740s establishments in Japan, 1751 disestablishments, 18th century disestablishments in Japan
Kanpō	Japanese eras, 1741 establishments, 1740s establishments in Japan, 1744 disestablishments, 1740s disestablishments in Japan
Edward Weston (chemist)	1850 births, 1936 deaths, American engineers, English chemists, Scientists from New Jersey, People from Oswestry, British engineers, American chemists
Springfield, Missouri	Springfield, Missouri, County seats in Missouri, Ozarks
Crocker Land	Phantom islands
Bradley Land	Phantom islands
Genbun	Japanese eras, 1736 establishments, 18th century establishments in Japan, 1741 disestablishments, 1740s disestablishments in Japan, 1730s establishments in Asia
2015 Atlantic hurricane season	Atlantic hurricane seasons, 2015 in weather
Genroku	Japanese eras, 1688 establishments, 1680s establishments in Japan, 1704 disestablishments, 18th century disestablishments in Japan
Anthony Horowitz	1956 births, Living people, British children's writers, British Jews, English novelists, English screenwriters, English television producers, English television writers, Writers from London, Writers from Middlesex
Keiō	Japanese eras, 1865 establishments, 1860s establishments in Japan, 1868 disestablishments in Japan
Tulisa	Actors from London, British people convicted of assault, British R&B musicians, English movie actors, English singer-songwriters, People from Camden (London borough), Singers from London, Television personalities from London, 1988 births, Living people, Musicians from London, English R&B singers, English hip hop musicians, Grime music artists, English dance musicians, Tulisa
Alexandra Stan	Romanian singers, 1989 births, Living people
Thompson Island (South Atlantic)	Phantom islands
Daniel Carleton Gajdusek	1923 births, 2008 deaths, American Nobel Prize winners, American physicians, American sex offenders, Harvard University alumni, People from Yonkers, New York, Scientists from New York, University of Rochester alumni
GIS	Acronyms, Branches of geography
Mike Pelino (ice hockey)	Canadian ice hockey coaches, Ice hockey people from Ontario, 1959 births, Living people
Carl Sandburg	Writers from Illinois, American poets, Pulitzer Prize winners, 1878 births, 1967 deaths, Deaths from natural causes, Industrial Workers of the World
Hard Again	Blues albums
First Boer War	Wars involving the British Empire, 19th century in South Africa, Boer Wars
Lilly Ledbetter	Living people, 1938 births, Feminists
East Germany at the Olympics	Former nations at the Olympics, Sport in East Germany
Sonar	Machines, Wave physics
Rococo	Art, Architectural styles, French culture, 18th century in France
Azerbaijani food	Azerbaijani food, Foods by nationality, Azerbaijani culture
Genji	Japanese eras, 1864 establishments, 1860s establishments in Japan, 1860s disestablishments in Japan, 1865 disestablishments
Synchrotron	Physics
Brave (2012 movie)	2012 animated movies, 2012 comedy movies, 2010s adventure movies, 2010s fantasy movies, American adventure movies, American animated movies, American comedy movies, American fantasy movies, English-language movies, Fiction set in the past, Movies about animals, Movies set in Scotland, Movies that won the Best Animated Feature Academy Award, Pixar movies, 2010s feminist movies
Bunkyū	Japanese eras, 1861 establishments, 1860s establishments in Japan, 1860s disestablishments in Japan, 1864 disestablishments
France at the Olympics	Nations at the Olympics, Sport in France
Enryaku	Japanese eras, 8th century establishments in Japan, 9th century disestablishments in Japan, 782 establishments, 806 disestablishments
Jean-Honoré Fragonard	French painters, Writers from Provence-Alpes-Cote d'Azur, 1732 births, 1806 deaths
System of linear equations	Equations, Algebra, Computer science
François Boucher	French painters, 1703 births, 1770 deaths
Valdivia expedition	Exploration, Oceanography
Spain at the Olympics	Nations at the Olympics, Sport in Spain
Croatia at the Olympics	Sport in Croatia, Nations at the Olympics
Cyprus at the Olympics	Republic of Cyprus, Nations at the Olympics
Czech Republic at the Olympics	Nations at the Olympics, Sport in the Czech Republic
Ten'ō	Japanese eras, 8th century establishments in Japan, 8th century disestablishments in Japan, 782 disestablishments, 781 establishments
Scaphognathus	Pterosaurs
Czechoslovakia at the Olympics	Czechoslovakia, Former nations at the Olympics
Denmark at the Olympics	Sport in Denmark, Nations at the Olympics
Drug cartel	Illegal drugs
Estonia at the Olympics	Nations at the Olympics, Sport in Estonia
Neo-Keynesian economics	Economic theories
Pinetop Smith	1904 births, 1929 deaths, Musicians from Alabama, African American musicians, American pianists, Blues pianists
Sea wall	Engineering, Flood control
Unity Broadcasting Network	American television networks, Religious media
Jewish Life Television	Television stations
Rolla, Missouri	1858 establishments in the United States, Cities in Missouri, County seats in Missouri
Gerald Jatzek	Austrian musicians, Austrian writers, 1956 births, Living people
Polar night	Geography
Succession to the Japanese throne	Emperors of Japan, Lines of succession of monarchies, Japanese imperial family
Herbert F. Johnson Museum of Art	Museums in New York, Art museums in the United States, I. M. Pei buildings, 1973 establishments in New York (state)
Line of succession to the Danish throne	Danish royalty, Lines of succession of monarchies
Order of succession	Lines of succession of monarchies, Government
Synchrotron light source	Nuclear physics, Light, Electromagnetic radiation
Line of succession to the Swedish throne	Swedish royalty, Lines of succession of monarchies
Line of succession to the Dutch throne	Lines of succession of monarchies, Dutch royalty
Hawker	Occupations
Disc-detainer lock	Locks
Ecological succession	Ecology
Burrel, Albania	Cities in Albania
Black powder rocket motor	Rockets, Fuel
Line of succession to the Belgian throne	Belgian royalty, Lines of succession of monarchies
Line of succession to the Norwegian throne	Norwegian royalty, Lines of succession of monarchies
Bogan River	Rivers of New South Wales
Castlereagh River	Rivers of New South Wales
Switzerland at the Olympics	Nations at the Olympics, Sport in Switzerland
Legionary	Ancient Rome
Digital pet	Pets, Computers
Emperor Go-Toba	Emperors of Japan, 1180 births, 1239 deaths
Toys "R" Us	1948 establishments in the United States, 2010s disestablishments in the United States, 2018 disestablishments, Companies of the United States, New Jersey, Toys, Washington, D.C.
Succession to the Spanish throne	Spanish royalty, Lines of succession of monarchies
Lake Blanche	Lakes of South Australia
Finland at the Olympics	Nations at the Olympics, Sport in Finland
Georgia at the Olympics	Nations at the Olympics, Sport in Georgia (country)
Greece at the Olympics	Nations at the Olympics, Sport in Greece
Hungary at the Olympics	Nations at the Olympics, Sport in Hungary
Malta at the Olympics	Nations at the Olympics, Sport in Malta
Itraconazole	Drugs
Donkey Kong Land	Game Boy games, Virtual Console games, Donkey Kong, Platform games, 1995 video games
Moldova at the Olympics	Nations at the Olympics, Sport in Moldova
Bronchiolitis	Diseases caused by viruses, Respiratory system
Respiratory syncytial virus	Viruses, Respiratory system
Lake Alexandrina	Lakes of South Australia, Ramsar sites
Béla Guttmann	Austria national football team managers, Hungarian footballers, Hungarian football managers, 1899 births, 1981 deaths
Emperor Fushimi	Emperors of Japan, 1265 births, 1317 deaths
Rodney King	1965 births, 2012 deaths, Accidental deaths by drowning in the United States, Accidental deaths in California, African-American people, American robbers, Criminals from California, Drug-related accidental deaths in the United States, People from Los Angeles, California, People from Sacramento, California
Pyŏngyang metro system	Pyongyang, Rapid transit systems, Transport in Asia
Tung Chung Line (MTR)	MTR
Wiggler (synchrotron)	Synchrotron instrumentation
Gold coin	Currency, Gold
Bournville	Birmingham, Villages in England, Settlements in the West Midlands (county)
Matt Ryan (American football)	1985 births, Living people, Atlanta Falcons players, Sportspeople from Pennsylvania, American football quarterbacks
Tim Tebow	1987 births, Living people, Denver Broncos players, American football quarterbacks, New York Jets players
Adrian Peterson	1985 births, Living people, Minnesota Vikings players, American football running backs, Sportspeople from Texas
Iceland at the Olympics	Nations at the Olympics, Sport in Iceland
Auto-ethnography	Social sciences, Ethnography
Cape Girardeau, Missouri	Cities in Missouri
Homo sacer	Legal terms, Society
Ireland at the Olympics	Nations at the Olympics, Sport in Ireland
Rites of passage	Society
Israel at the Olympics	Nations at the Olympics, Sport in Israel
Totemism	Anthropology, Symbolism
Italy at the Olympics	Nations at the Olympics, Sport in Italy
Neocolonialism	Colonialism
Latvia at the Olympics	Nations at the Olympics, Sport in Latvia
Liechtenstein at the Olympics	Nations at the Olympics, Sport in Liechtenstein
Lithuania at the Olympics	Nations at the Olympics, Sport in Lithuania
Luxembourg at the Olympics	Nations at the Olympics, Sport in Luxembourg
North Macedonia at the Olympics	Sport in North Macedonia, Nations at the Olympics
Monaco at the Olympics	Nations at the Olympics, Monaco
San Marino at the Olympics	Nations at the Olympics, Sport in San Marino
Montenegro at the Olympics	Nations at the Olympics, Sport in Montenegro
Saar at the 1952 Summer Olympics	Former nations at the Olympics, Sport in Saarland
Netherlands at the Olympics	Nations at the Olympics, Sport in the Netherlands
Norway at the Olympics	Nations at the Olympics, Sport in Norway
Jorge Arvizu	Mexican movie actors, Mexican stage actors, Mexican television actors, Mexican voice actors, Mexican movie producers, Deaths from heart failure, 1932 births, 2014 deaths
Poland at the Olympics	Nations at the Olympics, Sport in Poland
Athletics (sport)	Athletics
Portugal at the Olympics	Sport in Portugal, Nations at the Olympics
List of airports in Azerbaijan	Buildings and structures in Azerbaijan, Airports in Europe, Lists of airports, Transport in Azerbaijan
Mediacorp Channel 5	Television channels, Singapore
London Buses	Transport in London
Bariatrics	Medical specialties, Obesity
Ismaili	Muslims
Zaidiyyah	Muslims
Jin dynasty (1115–1234)	Former empires, Chinese dynasties
Jurchen people	History of China, Ethnic groups in China
Hans Motz	Scientists from Vienna, Austrian physicists, 1909 births, 1987 deaths
Discrete mathematics	Mathematics
Louise Ellery	1977 births, Living people, Australian athletes, 2004 Summer Paralympics, 2012 Summer Paralympics, 2008 Summer Paralympics
Adrian Lowe	Australian athletes, Australian Paralympic silver medalists, Australian Paralympic gold medalists, Living people, Year of birth missing (living people), 1988 Summer Paralympics
Emperor Yōzei	Emperors of Japan, 869 births, 949 deaths
Rene Ahrens	Australian athletes, Australian Paralympic bronze medalists, Living people, Year of birth missing (living people), Wheelchair basketball players, 1980 Summer Paralympics, 1988 Summer Paralympics
Kieran Ault-Connell	Australian athletes, Australian Paralympic gold medalists, Australian Paralympic silver medalists, 1981 births, Living people, Sportspeople from Melbourne, 2000 Summer Paralympics, 2004 Summer Paralympics
Royal Rumble (2012)	2012 in professional wrestling, Sports in St. Louis, Missouri, Royal Rumble, 2012 in the United States, 2010s in St. Louis, Missouri
Angie Ballard	Australian athletes, Australian Paralympic bronze medalists, Australian Paralympic silver medalists, 1982 births, Living people, People from Canberra, 2000 Summer Paralympics, 2008 Summer Paralympics, 2004 Summer Paralympics
Paul Benz	Australian athletes, Australian Paralympic gold medalists, Living people, Year of birth missing (living people), 2004 Summer Paralympics
Robert Biancucci	Australian athletes, Australian Paralympic gold medalists, Australian Paralympic silver medalists, Australian Paralympic bronze medalists, Living people, Year of birth missing (living people), 1988 Summer Paralympics, 1992 Summer Paralympics
Fabian Blattman	Australian athletes, Australian Paralympic gold medalists, Australian Paralympic silver medalists, Australian Paralympic bronze medalists, 1958 births, Living people, Sportspeople from New South Wales, 1988 Summer Paralympics, 1992 Summer Paralympics, 1996 Summer Paralympics, 2000 Summer Paralympics
Joanne Bradshaw	Living people, Australian athletes, Australian Paralympic gold medalists, 1961 births, Sportspeople from Victoria (Australia), 2000 Summer Paralympics, 2004 Summer Paralympics
Damien Burroughs	Australian athletes, Sportspeople from Ohio, Australian Paralympic gold medalists, 1978 births, Living people, 1996 Summer Paralympics, 2000 Summer Paralympics, 2004 Summer Paralympics
Aaron Chatman	Australian athletes, Australian Paralympic bronze medalists, Australian Paralympic silver medalists, 1987 births, Living people, 2008 Summer Paralympics
Darren Collins	Australian athletes, Australian Paralympic bronze medalists, Living people, Year of birth missing (living people), 1992 Summer Paralympics
St. Joseph, Missouri	Cities in Missouri, County seats in Missouri
Richard Colman	Australian athletes, Australian Paralympic bronze medalists, Australian Paralympic silver medalists, Australian Paralympic gold medalists, Living people, 1984 births, 2004 Summer Paralympics, 2008 Summer Paralympics
2004 Summer Paralympics	2004 Summer Paralympics
Block (Internet)	Internet
FC Liefering	Austrian football clubs, Football clubs of Salzburg
Ocala, Florida	Cities in Florida, County seats in Florida
Islet	Islands
Grand Ole Opry	Country music, Nashville, Tennessee
Russia at the Olympics	Sport in Russia, Nations at the Olympics
Neil Lennon	1971 births, Living people, Northern Irish footballers, Northern Irish football managers
Advanced Light Source	Electromagnetic radiation, Berkeley, California
Undulator	Synchrotron instrumentation
Storytime	2011 songs
Imaginaerum	2011 albums
Anette Olzon	1971 births, Living people, Finnish singers
Romania at the Olympics	Nations at the Olympics, Sport in Romania
Serbia at the Olympics	Sport in Serbia, Nations at the Olympics
Slovakia at the Olympics	Nations at the Olympics, Sport in Slovakia
Slovenia at the Olympics	Nations at the Olympics, Sport in Slovenia
Sweden at the Olympics	Nations at the Olympics, Sport in Sweden
Scarlet fever	Diseases caused by bacteria
RTI Colombia	Entertainment companies
Irish House of Lords	History of Ireland, Parliaments, 13th century establishments in Europe, 1800s disestablishments in Europe
Henry Grattan	Irish politicians, 1746 births, 1820 deaths
Turkey at the Olympics	Nations at the Olympics, Sport in Turkey
Ukraine at the Olympics	Nations at the Olympics, Sport in Ukraine
Serbia and Montenegro at the Olympics	Former nations at the Olympics, Sport in Montenegro, Sport in Serbia
Magnetic flux	Magnetism
Emperor Tenji	626 births, 671 deaths, Emperors of Japan
Fess Parker	1924 births, 2010 deaths, Deaths from natural causes, American movie actors, American television actors, Actors from Fort Worth, Texas
Soviet Union at the Olympics	Former nations at the Olympics, Soviet Union
To Catch a Predator	2004 television series debuts
Jahbulon	Freemasonry
Yugoslavia at the Olympics	Former nations at the Olympics, Yugoslavia
Sex linkage	Chromosomes
Telenovela	Telenovelas
Arriva London	London bus operators
Harold Camping	1921 births, 2013 deaths, Accidental deaths from falls in the United States, American Christians, People from Boulder, Colorado
Santana Formation	Lagerstätten, Brazil
Coit Tower	National Register of Historic Places, Art Deco buildings, Towers, Buildings and structures in San Francisco, 20th century architecture, Landmarks in San Francisco, 1933 establishments in the United States, 1930s establishments in California, Buildings and structures completed in the 20th century
Fiat Tempra	Fiat automobiles, Front wheel drive vehicles, 1990s automobiles
Leonor Piuza	1978 births, Living people, Mozambican people, Competitors in athletics
Ōmi Code	7th century in Japan, Legislation, 660s, 670s
Lake Charles, Louisiana	Cities in Louisiana, Parish seats in Louisiana
Empress Jitō	645 births, 702 deaths, Emperors of Japan, Japanese poets
Emperor Go-Murakami	1328 births, 1368 deaths, Emperors of Japan
Almayer's Folly	1895 books, Indonesia, Works by Joseph Conrad, Novels
Surface integral	Calculus
Philae (spacecraft)	ESA spacecraft
Americana	American culture
FC Pinzgau Saalfelden	Austrian football clubs, Football clubs of Salzburg
Narrandera, New South Wales	Towns in New South Wales
List of countries by Human Development Index	Lists of countries
Electric flux	Electromagnetism
Enda Kenny	1951 births, Living people, County Mayo, Irish politicians, Members of Fine Gael, Taoisigh of Ireland
SC Hakoah Graz	Jewish history, Judaism in Austria, Austrian football clubs, Football clubs of Graz
Sugar Ray Leonard	1956 births, Living people, African-American boxers, American Olympic gold medalists, Sportspeople from North Carolina, People from Wilmington, North Carolina
Gastrolith	Zoology
Scute	Animal anatomy, Vertebrates
BepiColombo	ESA spacecraft
Sputnik 2	Soviet spacecraft, Satellites, 1950s in the Soviet Union
Michal Prokop	Rock musicians, 1946 births, Living people, Czech musicians
Megali Idea	History of Greece, Nationalism, Anti-Turkism
Paula Fernandes	1984 births, Living people, Brazilian singers
Nodosauridae	Ankylosauria
French grammar	Grammar, French language
Stem (linguistics)	Grammar
Qinhuangdao	Cities in China
Penghu	Islands of Taiwan
Yanshan University	Colleges and universities in the People's Republic of China
Insertion device	Synchrotron instrumentation
Beamline	Nuclear physics, Synchrotron instrumentation, Materials science
Conférence des directeurs des écoles françaises d'ingénieurs	Education in France
Fred Burton	Living people, Year of birth missing (living people), Intelligence
Collimated light	Optics, Astronomy
Hispanic	Spain
Muryeong of Baekje	History of Korea, 460s births, 520s deaths, Kings and queens
Lilly Ledbetter Fair Pay Act of 2009	American civil rights, Discrimination, 2009 in the United States
International Food Policy Research Institute	International organizations, Agriculture, Food and drink, Macroeconomics, Green politics
Arena rock	Rock music

