September 15	Days of the year
September 16	Days of the year
September 17	Days of the year
October 10	Days of the year
October 11	Days of the year
October 23	Days of the year
October 26	Days of the year
October 20	Days of the year
October 27	Days of the year
October 29	Days of the year
October 22	Days of the year
October 15	Days of the year
October 13	Days of the year
October 19	Days of the year
October 18	Days of the year
November 10	Days of the year
November 11	Days of the year
November 14	Days of the year
November 28	Days of the year
November 25	Days of the year
November 21	Days of the year
November 24	Days of the year
November 22	Days of the year
November 23	Days of the year
November 20	Days of the year
November 27	Days of the year
November 29	Days of the year
November 30	Days of the year
November 26	Days of the year
November 15	Days of the year
November 16	Days of the year
November 17	Days of the year
November 18	Days of the year
November 19	Days of the year
December 10	Days of the year
December 12	Days of the year
December 13	Days of the year
December 15	Days of the year
December 16	Days of the year
December 17	Days of the year
December 29	Days of the year
December 21	Days of the year
December 27	Days of the year
December 19	Days of the year
December 26	Days of the year
December 20	Days of the year
December 28	Days of the year
1724	1724
1914	1914
February 29	Days of the year
Torah	Judaism, Bible versions
2010s	2010s
Rainforest	Rainforests
Welsh language	Celtic languages, Languages of Europe
Hesse	Hesse
Schleswig-Holstein	Schleswig-Holstein
Lower Saxony	Lower Saxony
Mecklenburg-Vorpommern	Mecklenburg-Vorpommern
1536	1536
Thailand	Thailand, Current monarchies, 1932 establishments in Asia
2005 Hoboken mayoral election	2005 in the United States, 2005 elections, 2000s in New Jersey, Elections in the United States, May 2005 events
1519	1519
1475	1475
1564	1564
1483	1483
Hoboken, New Jersey	Cities in New Jersey, 1849 establishments in the United States
1919	1919
Caffeine	Organic compounds, Drugs, Former good articles
Chicago	Chicago, Illinois, 1830s establishments in Illinois, County seats in Illinois
Woodrow Wilson	1856 births, 1924 deaths, Woodrow Wilson, 20th-century American politicians, American academics, American Nobel Prize winners, American people of World War I, American Presbyterians, Deaths from stroke, Governors of New Jersey, Johns Hopkins University alumni, People from Princeton, New Jersey, Politicians from New Jersey, Politicians from Virginia, Princeton University alumni, Princeton University faculty, US Democratic Party politicians
Brown	Basic English 850 words
Yoda	Fictional characters introduced in 1980, Soulcalibur series guest characters, Star Wars characters
The Monkees	1960s American music groups, 1970s American music groups, 1980s American music groups, 1990s American music groups, 2000s American music groups, 2010s American music groups, American pop rock bands, Musical groups established in 1966, Musical groups from Los Angeles, California, 1966 establishments in California
Abu Dhabi	Cities in the United Arab Emirates, Capital cities in Asia, Abu Dhabi (emirate)
1927	1927
1944	1944
The Rolling Stones	1960s British music groups, 1962 establishments in England, 1970s British music groups, 1980s British music groups, 1990s British music groups, 2000s British music groups, 2010s British music groups, English rock bands, Musical groups established in 1962, Musical groups from London, The Rolling Stones
Black Sabbath	English heavy metal bands, Doom metal bands, Musical groups from Birmingham, West Midlands, English rock bands, 1968 establishments in the United Kingdom, 2017 disestablishments, 1960s music groups, 1970s music groups, 1980s music groups, 1990s music groups, 2000s music groups, 2010s music groups
Watt	Units of power
Koblenz	Koblenz
Delta	Greek alphabet
Elbe	Hamburg, Geography of Brandenburg, Geography of Lower Saxony, Geography of Mecklenburg-Vorpommern, Geography of Saxony, Geography of Saxony-Anhalt, Geography of Schleswig-Holstein, Rivers of the Czech Republic, Rivers of Germany
Danube	Geography of Baden-Württemberg, Geography of Bavaria, Geography of Bulgaria, Geography of Croatia, Rivers of Austria, Rivers of Germany, Rivers of Hungary, Rivers of Moldova, Rivers of Romania, Rivers of Serbia, Rivers of Slovakia, Rivers of Ukraine, Lower Austria, Upper Austria, Vienna
Main	Geography of Baden-Württemberg, Geography of Bavaria, Geography of Hesse, Rivers of Germany
Weser	Bremen (state)‎, Geography of Hesse, Geography of Lower Saxony, Geography of North Rhine-Westphalia, Geography of Thuringia, Rivers of Germany
Suicide	Law, Medical emergencies, Social sciences, Suicide
Balkans	Regions of Europe, Peninsulas
Bicentennial	Time
Shropshire	Shropshire, Ceremonial counties of England
Kermit the Frog	Fictional animals, Muppets, Sesame Street characters
Cotton	Basic English 850 words, Fibers, Arabic words and phrases
Windows 1.0	Microsoft operating systems
Hewlett-Packard	1939 establishments in the United States, American technology companies, Companies based in the San Francisco Bay Area, 1930s establishments in California
Eminem	1972 births, Living people, Actors from Detroit, Michigan, Actors from Missouri, American movie actors, American rap musicians from Missouri, American record producers, Eminem, People from St. Joseph, Missouri, Singers from Detroit, Michigan, Singers from Missouri, Best Original Song Academy Award-winning songwriters
Bratwurst	German food, Sausage
1909	1909
Guatemala	Guatemala, Spanish-speaking countries, 1821 establishments in North America
Tenochtitlan	Aztec, Cities in Mexico, History of North America, 1325 establishments, 14th-century establishments in Mexico, 1521 disestablishments, Disestablishments in Mexico
Eurovision Song Contest	Eurovision Song Contest, 1956 establishments in Europe
Malleability	Metals
Gay	LGBT variations
Potsdam	Potsdam
Bremen	Bremen (city), Port cities and towns of the North Sea, Ports and harbours of Germany, Imperial free cities
Wiesbaden	German state capitals
Hanover	Hanover
Düsseldorf	Düsseldorf
Mainz	Mainz
Kiel	Port cities and towns of the Baltic Sea, Ports and harbours of Germany, German state capitals
Fred Rogers	Presidential Medal of Freedom recipients, Peabody Award winners, Emmy Award winners, 1928 births, 2003 deaths, Fred Rogers, Vegetarians, Puppeteers, American Presbyterians, American television actors, American children's writers, American singer-songwriters, American composers, American educators, American pianists, American television presenters, American activists, American television writers, American television producers, American voice actors, Writers from Pittsburgh, Pennsylvania, Singers from Pittsburgh, Pennsylvania, Musicians from Pittsburgh, Pennsylvania, Actors from Pittsburgh, Pennsylvania, People from Latrobe, Pennsylvania, Cancer deaths in Pennsylvania, Deaths from stomach cancer
Sri Yukteswar Giri	1855 births, 1936 deaths, Indian people, Hindu gurus
Aleister Crowley	1875 births, 1947 deaths, Bisexual people, British esotericists, Deaths from bronchitis, English LGBT people, Infectious disease deaths in England, LGBT writers, Mystics, Occultists, Writers from Warwickshire
Karlheinz Stockhausen	1928 births, 2007 deaths, 20th century composers, Cardiovascular disease deaths in Germany, Deaths from heart failure, Disease-related deaths in North Rhine-Westphalia, German composers, Musicians from North Rhine-Westphalia
W. C. Fields	1880 births, 1946 deaths, American movie actors, Actors from Pennsylvania
Carl Jung	1875 births, 1961 deaths, Disease-related deaths in Switzerland, Psychiatrists, Psychoanalysts, Swiss psychologists, Swiss people
Edgar Allan Poe	1809 births, 1849 deaths, 19th-century American poets, Edgar Allan Poe, Short story writers, Unexplained deaths, Writers from Baltimore, Maryland, Writers from Virginia, People from the Bronx
Fred Astaire	1899 births, 1995 deaths, Academy Award Honorary Award winners, Actors from Omaha, Nebraska, American dancers, American movie actors, American stage actors, American television actors, BAFTA Award winning actors, Deaths from pneumonia, Emmy Award winning actors, Golden Globe Award winning actors, Infectious disease deaths in Los Angeles, Kennedy Center honorees, Singers from Nebraska
Game Boy Advance	Game Boy, Nintendo video game consoles
Amerie	1980 births, Living people, African American actors, African American musicians, American R&B singers, American singer-songwriters, Singers from Washington, D.C., Singers from Massachusetts, Musicians from Massachusetts, Musicians from Washington, D.C., Musicians from Alaska, Singers from Alaska, American movie actors, Actors from Washington, D.C., American bloggers
Ben Stein	1944 births, Living people, American movie actors, American television actors, American game show hosts, Actors from Washington, D.C., Writers from Washington, D.C.
Soft rock	Rock music
Angela Merkel	Angela Merkel, 1954 births, Living people, Chancellors of Germany, Current national leaders, East German people, German chemists, German Lutherans, Government ministers of Germany, Members of the German Bundestag, Order of Merit of the Federal Republic of Germany, Politicians from Hamburg, Politicians of the Christian Democratic Union of Germany, Presidential Medal of Freedom recipients, Time People of the Year, Women politicians
Chinese dragon	Legendary creatures, Chinese culture
Robert Duvall	Academy Award winning actors, Golden Globe Award winning actors, BAFTA Award winning actors, Emmy Award winning actors, Screen Actors Guild Award winners, Actors from San Diego, California, Actors from Virginia, Actors from Maryland, Actors from Illinois, Actors from St. Louis, Missouri, Movie directors from California, Movie directors from Illinois, Republicans (United States), American movie actors, American television actors, American stage actors, American voice actors, American activists, 1931 births, Living people
Stevie Wonder	1950 births, Living people, People from Saginaw, Michigan, African American musicians, American activists, American pianists, American R&B musicians, American R&B singers, American singer-songwriters, American soul musicians, Best Original Song Academy Award-winning songwriters, Blind people, Grammy Award winners, Multi-instrumentalists, Musicians from Michigan, Singers from Michigan
Littleton, Colorado	Cities in Colorado, County seats in Colorado
Motown	1959 establishments in the United States, American record labels, Detroit, Michigan, Music genres, 1950s establishments in Michigan
1893	1893
Mustelid	Mustelids
Vanilla Ninja	Vanilla Ninja, Estonian musical entertainers, 2000s music groups, Rock bands, Pop music groups
1835	1835
Haile Selassie I of Ethiopia	1892 births, 1975 deaths, Ethiopian people, Rastafari, Time People of the Year, Emperors and empresses, Recipients of the Decoration for Services to the Republic of Austria
Ethiopia	Ethiopia, Italian-speaking countries, Least developed countries, 1991 establishments in Africa
Utah	Utah, 1896 establishments in the United States
The Bahamas	Commonwealth realms, English-speaking countries, The Bahamas, Caribbean Community, 1973 establishments in North America
Vanuatu	Vanuatu, Commonwealth member states, Least developed countries, 1980 establishments in Oceania
Crayola	Art
Ringo Starr	Ringo Starr, 1940 births, Living people, Academy Award winners, Actors from Liverpool, English drummers, English movie actors, English movie producers, English voice actors, Grammy Award winners, Knights Bachelor, Members of the Order of the British Empire, Musicians from Liverpool, The Beatles members
Oslo	Olympic cities, Oslo, Port cities and towns of the North Sea, 11th century establishments in Europe, Establishments in Norway
Lincoln Thompson	1949 births, 1999 deaths, Jamaican entertainers, Reggae musicians, Rastafari, Songwriters
Tom Hanks	1956 births, Living people, Actors from Contra Costa County, California, American Christians, American movie actors, American stage actors, American television actors, American voice actors, Best Actor Academy Award winners, Emmy Award winning actors, Golden Globe Award winning actors, People from Concord, California, People's Choice Award winners, Saturn Award winners, Screen Actors Guild Award winners, Writers from California
Hook	Basic English 850 words
Sir Mix-A-Lot	Actors from Seattle, Washington, African American actors, American movie actors, American rap musicians, African-American rappers, American television actors, Grammy Award winners, Singers from Seattle, Washington, 1963 births, Living people
Dick York	1928 births, 1992 deaths, Deaths from emphysema, American movie actors, American stage actors, American television actors, Actors from Indiana, Actors from Chicago
James Earl Jones	1931 births, Living people, Actors from Mississippi, African American actors, American movie actors, American television actors, American voice actors, Emmy Award winning actors, Screen Actors Guild Award winners, Tony Award winning actors
Calvin and Hobbes	Comic strips
Tony Randall	American movie actors, American television actors, Emmy Award winners, Actors from Oklahoma, 1920 births, 2004 deaths, Deaths from pneumonia
Lesbian	LGBT variations, Lesbians
Maine	Maine, 1820 establishments in the United States
1884	1884
Niuatoputapu	Tonga
Samoa	Samoa
Davy Jones (musician)	Cardiovascular disease deaths in the United States, Deaths from myocardial infarction, English movie actors, English pop musicians, English singers, English television actors, Musical theater actors, Musicians from Manchester, 1945 births, 2012 deaths, Deaths from atherosclerosis
Michael Nesmith	Musicians from Texas, American songwriters, American television actors, Country musicians, American rock musicians, Grammy Award winners, Actors from Dallas, Texas, 1942 births, Living people, American philanthropists
Peter Tork	1942 births, 2019 deaths, Deaths from throat cancer, American movie actors, American television actors, Actors from Washington, D.C., American guitarists, American pop musicians
Micky Dolenz	1945 births, Living people, American movie actors, American television actors, American voice actors, musicians from Los Angeles, California, singers from Los Angeles, California
Goldstar beer	Goldstar, Beer
1797	1797
1851	1851
Dominique de Villepin	1953 births, Living people, Alumni of the Institut d'études politiques de Paris, French diplomats, French lawyers, Government ministers of France, Prime Ministers of France
Francis Drake	1540 births, 1596 deaths, Admirals, English businesspeople, English explorers, Sailors, Slavers, Deaths from dysentery
House of Commons of the United Kingdom	National lower houses, Government of the United Kingdom
Wank	Alps, Geography of Bavaria, Mountains of Germany
1685	1685
Hank Aaron	1934 births, African-American baseball players, Atlanta Braves players, 2021 deaths, Milwaukee Braves players, Milwaukee Brewers players, National League All-Stars, National Baseball Hall of Fame members, Presidential Citizens Medal recipients, Presidential Medal of Freedom recipients, Sportspeople from Alabama
Vishnu	Hindu gods and goddesses
Money laundering	Organized crime, Types of crime, Money
Zeus	Twelve Olympians
Evolutionary biology	Evolutionary biology
1488	1488
1695	1695
1767	1767
1848	1848
222 BC	222 BC
Mozilla Firefox	Mozilla Firefox, Web browsers
Lenny Kravitz	1964 births, Living people, Actors from Manhattan, African American actors, African American musicians, Jewish American actors, Jewish American musicians, American Christians, American drummers, American pianists, American R&B musicians, American rock guitarists, American soul musicians, Musicians from Manhattan, Singer-songwriters from New York City
1854	1854
1900	1900
Birdbox	Birds
Accent	Language
Louis Braille	1809 births, 1852 deaths, Deaths from tuberculosis, Disease-related deaths in Paris, French inventors
Marsupial	Marsupials
B. J. Thomas	1942 births, Singers from Oklahoma, Christian music singers, American country singers, Grammy Award winners, Deaths from lung cancer, 2021 deaths, American singer-songwriters, Writers from Oklahoma, American gospel singers, American pop singers
Laws of war	War, International law
Maharashtra	Maharashtra, States of India
Pete Best	1941 births, Living people, English drummers, Musicians from Liverpool, People from Chennai, The Beatles members
Dionne Quintuplets	1934 births, People from Ontario
All's Well That Ends Well	Plays by William Shakespeare
Christ (title)	Christology, Jesus Christ
Christian Bale	English movie actors, English television actors, English stage actors, English voice actors, Actors who played Batman, 1974 births, Living people, Academy Award winning actors, Golden Globe Award winning actors, Screen Actors Guild Award winners, Satellite Award winners, Saturn Award winners
Eric Clapton	1945 births, Living people, Blues guitarists, English rock composers, English rock guitarists, English rock singers, Musicians from Surrey, Singers from Surrey, Warner Bros. Records artists
Buenos Aires	Buenos Aires
Lyndon B. Johnson	1908 births, 1973 deaths, Cardiovascular disease deaths in Texas, Deaths from myocardial infarction, Lyndon B. Johnson, People of the Vietnam War, Presidents of the United States, Minority leaders of the United States Senate, Majority leaders of the United States Senate, Time People of the Year, 1960 United States presidential candidates, 1964 United States presidential candidates, United States representatives from Texas, United States senators from Texas, US Democratic Party politicians, Vice Presidents of the United States, 20th-century American politicians
Catholic Church	Roman Catholicism
Villeneuve-d'Ascq	Communes in Nord
Hillary Clinton	1947 births, Living people, Hillary Rodham Clinton, 2008 United States presidential candidates, 2016 United States presidential candidates, 21st-century American politicians, American lawyers, American Methodists, First Ladies of the United States, Politicians from Arkansas, Politicians from Chicago, United States Secretaries of State, United States senators from New York, US Democratic Party politicians, Yale University alumni
Andhra Pradesh	Andhra Pradesh, States of India
Alberto Vargas	Peruvian painters, 1896 births, 1982 deaths
George Lucas	1944 births, American cinematographers, American movie editors, American screenwriters, American television producers, American television writers, Living people, Movie directors from California, Movie producers from California, Writers from California
Telugu	Dravidian languages, Languages of India
PlayStation 3	Sony, PlayStation, Sony consoles, Seventh generation consoles
PlayStation 2	Sony, PlayStation, Sony consoles, 2000 establishments in the United States, 2013 disestablishments, Sixth generation consoles
Sony	1946 establishments in Asia, Sony, 1940s establishments in Japan
Xbox 360	Xbox, Seventh generation consoles
Xbox (console)	Xbox, Sixth generation consoles
GameCube	Nintendo video game consoles, Sixth generation consoles
Fangame	Types of video games
Wrocław	Wrocław
1906	1906
Lou Albano	1933 births, 2009 deaths, American professional wrestlers, Deaths from myocardial infarction, Former WWE wrestlers, Entertainers from Rome, WWE Hall of Fame
Lip synching	Music industry
Faith Evans	1973 births, Living people, Singers from Florida, Singers from Newark, New Jersey
Bacteria	Bacteria, Microbiology, Prokaryotes, Horizontal gene transfer
Barry Switzer	1937 births, Living people, American football coaches, American military people, Sportspeople from Arkansas, National Football League coaches, College football coaches
Constant	Mathematics, Computer science
Poker	Poker
El Salvador	El Salvador, Spanish-speaking countries, 1821 establishments in North America
Isabelle of Hainaut	1170 births, 1190 deaths, Kings and Queens consort of France, People from Lille
Fragaria	Strawberries
1859	1859
Paul Simon	1941 births, Living people, American pop singers, Jewish American musicians, Kennedy Center honorees
Shirley Jones	1934 births, Living people, American television actors, American movie actors, Actors from Pennsylvania, Singers from Pennsylvania, Warner Bros. Records artists
DeForest Kelley	1920 births, 1999 deaths, American movie actors, American television actors, Actors from Atlanta, Georgia, Deaths from stomach cancer
Scott Bakula	American television actors, Actors from St. Louis, Missouri, 1954 births, Living people
Forestry	Natural sciences, Forestry
List of United States soccer teams	American soccer teams, Lists of football teams, United States-related lists
800s BC	800s BC
Oregon	Oregon, 1859 establishments in the United States
Arkansas	Arkansas, 1836 establishments in the United States, Confederate States of America
Robert Englund	1949 births, Living people, American movie actors, A Nightmare on Elm Street, American television actors, American voice actors, Actors from Glendale, California
Henry IV of France	1553 births, 1610 deaths, Kings and Queens of France, House of Bourbon, French Roman Catholics, People with foods named after them, Princes of Andorra
Margaret of Valois	1553 births, 1615 deaths, House of Valois, French princesses
Queen Margot	1845 books
Henrietta Maria of France	1609 births, 1669 deaths, People from Paris, Kings and Queens consort of England, House of Stuart, House of Bourbon, Kings and Queens consort of Scotland, Burials at the Basilica of St Denis, French Roman Catholics
Madonna (entertainer)	Actors from Michigan, American movie actors, American movie directors, American pop singers, American dance musicians, American singer-songwriters, Grammy Award winners, Madonna (entertainer), Singers from Michigan, Writers from Michigan, 1958 births, Living people
Tortilla	Mexican food, Flatbreads
Bit	Basic English 850 words
EastEnders	1985 television series debuts, 1980s British drama television series, 1980s soap operas, 1990s British drama television series, 1990s soap operas, 2000s British drama television series, 2000s soap operas, 2010s British drama television series, 2010s soap operas, BBC television dramas, British soap operas, EastEnders, Television series set in London, English-language television programs
Philip II of Spain	1527 births, 1598 deaths, Kings and Queens of Spain, Kings and Queens consort of England, Counts and countesses of Flanders
William II of England	1056 births, 1100 deaths, House of Normandy, People buried in Winchester Cathedral
Mary I of England	1516 births, 1558 deaths, House of Tudor, Counts and countesses of Flanders, 1550s in England, Kings and Queens of England, Kings and Queens consort of Spain
Edward VI of England	1537 births, 1553 deaths, British children, House of Tudor, Kings and Queens of England, 1550s in England, 1540s in Europe
Richard I of England	1157 births, 1199 deaths, Deaths from gangrene, Dukes and Duchesses of Aquitaine, House of Plantagenet
Jane Seymour	1508 births, 1537 deaths, House of Tudor, Kings and Queens consort of England
Elizabeth of York	1466 births, 1503 deaths, House of Tudor, Kings and Queens consort of England, House of York
Catherine of Aragon	1485 births, 1536 deaths, House of Tudor, Kings and Queens consort of England, Princes and Princesses of Wales, Spanish royalty, Deaths from heart cancer
Gregory Peck	Actors from San Diego, California, American movie actors, American movie producers, Deaths from bronchopneumonia, Infectious disease deaths in the United States, 1916 births, 2003 deaths
Sin City	Comic books
Brittany Murphy	Actors from New Jersey, American movie actors, American television actors, Deaths from pneumonia, Singers from New Jersey, 1977 births, 2009 deaths
Evershot	Villages in Dorset, West Dorset
Copyleft	Copyright
Uruguay	Uruguay, Spanish-speaking countries, 1825 establishments in South America
Minnesota	Minnesota, 1858 establishments in the United States
Colorado	Colorado, 1876 establishments in the United States
Cairo	Capital of Egypt, Cairo
Aerospace engineering	Aircraft, Aerospace engineering
1805	1805
Karnataka	Karnataka, States of India
Norrland	Geography of Sweden
Calgary	Calgary, Olympic cities, 1875 establishments in North America, 1870s establishments in Canada
Nova Scotia	1867 establishments in Canada, Nova Scotia, Provinces and territories of Canada
Absolute zero	Temperature, Thermodynamics
Cylinder	Three-dimensional shapes
Vacuum	Matter
Catherine Howard	1520s births, 1542 deaths, Executed English people, People executed by decapitation, House of Tudor, Kings and Queens consort of England
Anne of Cleves	1515 births, 1557 deaths, House of Tudor, People buried in Westminster Abbey, Kings and Queens consort of England
Mary Tudor, Queen of France	Kings and Queens consort of France, 1495 births, 1533 deaths
Louis XII of France	1462 births, 1515 deaths, Kings and Queens of France, House of Valois
Louis XIII	1610 births, 1643 deaths, Kings and Queens of France, Princes of Andorra
Claude of France	1499 births, 1524 deaths, Kings and Queens consort of France, Dukes and Duchesses of Brittany
Lady Eleanor Brandon	1519 births, 1547 deaths, English nobility
Lady Frances Brandon	1517 births, 1559 deaths, Dukes and duchesses, People buried in Westminster Abbey, English nobility, House of Tudor
Henry II of France	1519 births, 1559 deaths, Kings and Queens of France, House of Valois
Francis I of France	1494 births, 1547 deaths, Kings and Queens of France, House of Valois
Madeleine of Valois	Deaths from tuberculosis, Infectious disease deaths in the United Kingdom, Kings and Queens consort of Scotland, 1520 births, 1537 deaths
Holyrood Abbey	Buildings and structures in Edinburgh, Abbeys, Churches in the United Kingdom
The Muppets	Muppets
Wilhelm II, German Emperor	1859 births, 1941 deaths, Crown Princes and Princesses of Prussia, German emperors, German people of World War I, House of Hohenzollern, Kings and Queens of Prussia, Knights of Justice of the Order of St John
Catherine de' Medici	Kings and Queens consort of France, People from Florence, 1519 births, 1589 deaths, House of Medici
Francis II of France	1544 births, 1560 deaths, House of Valois, Kings and Queens consort of Scotland, Kings and Queens of France, People from Ile-de-France
Adela of Normandy	1067 births, 1137 deaths, House of Normandy
Stephen of England	1096 births, 1154 deaths, People from Centre-Val de Loire
Eleanor of Aquitaine	1122 births, 1204 deaths, House of Plantagenet, Kings and Queens consort of England, Dukes and Duchesses of Aquitaine
John of England	1166 births, 1216 deaths, House of Plantagenet, 13th century in England, 12th century in Europe, Deaths from dysentery
13 (number)	Integers, Prime numbers, Superstitions
Weekend	Units of time
Alexandria	Capital of Egypt, Alexandria, 331 BC establishments
1908	1908
Celtic League	Celtic languages, Celtic peoples
Oprah Winfrey	Actors from Mississippi, African American television personalities, American movie actors, American television talk show hosts, Kennedy Center honorees, 1954 births, Living people, People of Tennessee State University
Colognian dialect	German dialects, Languages of Germany, Cologne
Past tense	Grammar
Freeview	British television
Mark Addy	1964 births, Living people, Actors from York, English movie actors, English television actors
Tuba	Brass instruments
Garden gnome	Gardening
Kentucky	Kentucky, 1792 establishments in the United States
Gary Busey	Actors from Oklahoma, Actors from Texas, American movie actors, American television actors, American voice actors, Big Brother winners, Celebrity Big Brother contestants, The Apprentice contestants, 1944 births, Living people
Montana	Montana, 1889 establishments in the United States
List of seas	Basic English 850 words, Seas, Geography-related lists
Wool	Fibers, Basic English 850 words, Cloth
Saw	Cutting tools, Woodworking tools
Tennessee	Tennessee, 1796 establishments in the United States
Connecticut	Connecticut, 1788 establishments in the United States
Wyoming	Wyoming, 1890 establishments in the United States
Mississippi	Mississippi, 1817 establishments in the United States
Delaware	Delaware, 1787 establishments in the United States
Idaho	Idaho, 1890 establishments in the United States
Manila	Manila, Metro Manila, Cities in the Philippines
DiC	Animation studios, 1971 establishments, 2008 disestablishments
The Hobbit	1937 books, Fantasy books, British novels, Children's books, English-language novels, Fantasy, Middle-earth, The Lord of the Rings
The Lord of the Rings	The Lord of the Rings, 1954 books, 1955 books, Fantasy books
Extinction	Evolutionary biology, Extinction
Minehead	Towns in Somerset, Civil parishes in Somerset
Hank Azaria	1964 births, American movie actors, American voice actors, American television actors, Comedians from New York City, Living people, Actors from New York City
Mexico City	World Heritage Sites in Mexico, Mexico City, Capital cities in Mexico, Olympic cities, 1520s establishments in Mexico, 1521 establishments
1821	1821
John Hinckley Jr.	1955 births, Living people, American prisoners, People acquitted of crimes, People from Dallas, Texas, People from Oklahoma, People with narcissistic personality disorder, People with schizophrenia
Tampico, Illinois	Tampico, Illinois, Villages in Illinois
Surface area	Mathematics
Al Hirschfeld	American animators, American cartoonists, 1918 births, 2018 deaths, American illustrators
Mobile Army Surgical Hospital	Medicine
Illinois	Illinois, 1818 establishments in the United States
Seattle	Seattle, Washington, County seats in Washington, 1869 establishments in the United States, 19th-century establishments in Washington (state)
Kiefer Sutherland	1966 births, Living people, Actors from London, Actors from Ontario, Canadian movie actors, Canadian movie directors, Canadian television actors, Canadian television producers, Canadian voice actors, Satellite Award winners, Emmy Award winning actors, Golden Globe Award winning actors, Twin people from Canada
Stirling	cities in Scotland
Tuvaluan language	Austronesian languages, Languages of Oceania, Tuvalu
Tokelau	Islands of Oceania, Commonwealth dependent states, Polynesia, Geography of New Zealand
Communist state	Countries, Communism
1792	1792
1873	1873
1849	1849
Solitaire	Card games
Optics	Optics
Václav Klaus	1941 births, Living people, Czech politicians, Presidents of the Czech Republic
Barbra Streisand	1942 births, Living people, Academy Award winning actors, Actors from Brooklyn, American movie actors, American television producers, Emmy Award winning actors, Golden Globe Award winning actors, Golden Globe Award winning directors, Grammy Award winners, Jewish American actors, Jewish American musicians, Jewish businesspeople, Movie directors from New York City, Movie producers from New York City, Musicians from Brooklyn, Singers from New York City
Jamaica	Jamaica, Commonwealth realms, English-speaking countries, Current monarchies, Caribbean Community, 1962 establishments in North America
Denver	Denver, Colorado, State capitals in the United States, 1858 establishments in the United States, 19th-century establishments in Colorado, County seats in Colorado
Carl Lewis	1961 births, Living people, African-American track and field athletes, American male athletes, American movie actors, American Olympic gold medalists, Sportspeople from Alabama, Actors from Birmingham, Alabama, Sprinters
Bleach	Chemicals
Polygon	Polygons
Kazakhstan	Kazakhstan, Members of the Organisation of Islamic Cooperation
Sign	Basic English 850 words, Human communication, Semiotics
Barley	Grains
Mount Vesuvius	Calderas, Volcanoes of Italy, Campania
1853	1853
1891	1891
1371	1371
Mineralogy	Geology
Supermarket	Buildings and structures, Food and drink, Retail markets
Ecuador	Ecuador, Spanish-speaking countries, 1809 establishments, 19th-century establishments in South America
1515	1515, 1510s, 16th century, Years
1495	1495
Orlando, Florida	County seats in Florida, Orlando, Florida, 1836 establishments in the United States, 1830s establishments in Florida Territory
1397	1397
Glossary	Words, Reference
1527	1527
1373	1373
Comedian	Comedians, Entertainment occupations
Turin	Regional capitals in Italy, Turin, Olympic cities
Hobart	1803 establishments, Hobart, 19th-century establishments in Australia
New Testament	New Testament
Gospel	Christian theology, Gospels
Palestine (region)	Palestine
Paul the Apostle	0s BC births, 67 deaths, Early Christian saints, Jews who converted to Christianity, New Testament people, People executed by decapitation
Old Testament	Old Testament
Painting	Painting
Horse	Horses, Domesticated animals, Animals used for transport, Basic English 850 words
Afterlife	Eschatology, Afterlife
Prayer	Theology, Worship
Book of Genesis	Old Testament books, Creation myths
Joseph (Hebrew Bible)	Old Testament people, Ancient Israeli people
Mary Magdalene	New Testament people, Ancient Israeli people
Witness	Trials, Legal terms
Corinth	Cities in Greece
Cross	Symbols
Peloponnese	Peninsulas, Peripheries of Greece
Isthmus of Corinth	Geography of Greece
Tripoli	Phoenician colonies, Tripoli
Argos	Cities in Greece
Sparta	Cities in Greece, Ancient Greek cities
Olympia	Olympia, Greece
Pyrgos	Cities in Greece
Thessaloniki	Thessaloniki
Florina	Cities in Greece
Argolis	Prefectures of Greece
Ilia	Prefectures of Greece
Achaea	Prefectures of Greece
Arcadia	Prefectures of Greece
Laconia	Prefectures of Greece
Pella	Prefectures of Greece
Attica	Attica
Kastoria	Cities in Greece
Kozani	Cities in Greece
Magnesia	Prefectures of Greece
Messenia	Prefectures of Greece
Chalkidiki	Prefectures of Greece
Euboea	Prefectures of Greece, Islands of Greece
Grevena	Prefectures of Greece
Arta	Cities in Greece
Trikala	Cities in Greece
Lesbos	Prefectures of Greece
Samos	Prefectures of Greece, Islands of Greece
Evros	Prefectures of Greece
Evritania	Prefectures of Greece
Cyclades	Prefectures of Greece
Serres	Cities in Greece
Kilkis	Cities in Greece
Chania	Cities in Greece
Xanthi	Cities in Greece
Batha	Prefectures of Chad
Biltine Prefecture	Prefectures of Chad
Bourkou-Ennedi-Tibesti	Prefectures of Chad
Faya-Largeau	Cities in Chad
Chari-Baguirmi	Prefectures of Chad
Guéra	Prefectures of Chad
Kanem	Prefectures of Chad
Lac	Prefectures of Chad
Logone Occidental (prefecture)	Prefectures of Chad
Logone Oriental (prefecture)	Prefectures of Chad
Mayo-Kébbi	Prefectures of Chad
Moyen-Chari (prefecture)	Prefectures of Chad
Ouaddaï (prefecture)	Prefectures of Chad
Salamat	Prefectures of Chad
Tandjilé	Prefectures of Chad
Abéché	Cities in Chad
Mongo	Cities in Chad
Ron Howard	Actors from Burbank, California, Actors from Oklahoma, American child actors, American movie actors, American movie directors, American movie producers, American screenwriters, American television actors, American television producers, American television writers, American voice actors, Movie directors from California, Movie producers from California, Writers from California, Writers from Oklahoma, 1954 births, Living people
Playboy	1953 establishments in the United States, American men's magazines, Nudity, Magazines published in Chicago, Illinois
1845	1845
1165	1165
1817	1817
Larry David	1947 births, Living people, Actors from Brooklyn, American movie actors, American television actors, American television producers, American television writers, Movie producers from New York City, Jewish American actors, Jewish American writers, Jewish businesspeople, Seinfeld, Writers from Brooklyn
Joint Base Pearl Harbor–Hickam	United States Navy, Hawaii, 1899 establishments in the United States, 19th-century establishments in Hawaii
Amsterdam	Amsterdam, Cities in the Netherlands, Settlements in North Holland, Olympic cities
Paraguay	Paraguay, Spanish-speaking countries, 1811 establishments, 1810s establishments in South America
Loch Ness	Geography of Scotland, Legends, Lochs, Lakes of the United Kingdom
Gary Burghoff	1943 births, Living people, American movie actors, American stage actors, American television actors, Actors from Connecticut
1847	1847
Fred Gwynne	American movie actors, American stage actors, American television actors, American voice actors, Deaths from pancreatic cancer, Actors from New York City, 1926 births, 1993 deaths
Cannabis	Cannabis
Nevada	Nevada, 1864 establishments in the United States, Western United States
Comoros	Comoros, French-speaking countries, Least developed countries, Members of the Organisation of Islamic Cooperation, 1975 establishments in Africa
Oat	Oats
Kapingamarangi	Atolls, Federated States of Micronesia
Kiribati	Kiribati, Least developed countries, 1979 establishments
Bisexuality	LGBT variations
Barbados	Barbados, Commonwealth realms, English-speaking countries, Current monarchies, Caribbean Community, Former British colonies, 1966 establishments in North America
Annie	Broadway musicals, West End musicals, 1970s musicals, Musicals based on comic strips, Musicals adapted to movies, Tony Award winning musicals
James Taylor	American singer-songwriters, Singers from North Carolina, Grammy Award winners, American pop musicians, Democrats (United States), 1948 births, Living people
Truro	County towns in England, Settlements in Cornwall, Cities in England, Civil parishes in Cornwall
1664	1664
San Francisco	San Francisco, County seats in California, 1850 establishments in California, 1776 establishments in North America, 18th-century establishments in California
Pelops	People in Greek mythology
Job	VOA Special English words, Employment
Crop	Agriculture
Proletariat	Communism
Ohio River	Rivers of Kentucky, Rivers of Illinois, Rivers of Indiana, Geography of Ohio, Rivers of Pennsylvania, Rivers of West Virginia
Croatia	Croatia, European Union member states, Italian-speaking countries
El Alamein	Cities in Egypt
Otis Redding	1941 births, 1967 deaths, African American musicians, American singer-songwriters, American soul musicians, Aviation deaths in the United States, Singers from Georgia (U.S. state)
Black Forest	Forests of Germany, Geography of Baden-Württemberg
Frankie Avalon	1939 births, Living people, American movie actors, American pop musicians, Actors from Philadelphia, Pennsylvania, Singers from Philadelphia, Pennsylvania
Celebrity chef	Celebrities, Chefs
Huntz Hall	1919 births, 1999 deaths, American movie actors, Actors from New York City
Robert Peel	1788 births, 1850 deaths, Chancellors of the Exchequer, British conservatives, People from Bury
Herodotus	484 BC births, 425 BC deaths, Ancient Greek historians
Chinook	Winds
Etoumbi	Towns in Africa, Settlements in the Republic of the Congo
Chad	Chad, French-speaking countries, Least developed countries, Members of the Organisation of Islamic Cooperation, 1960 establishments in Africa
Anal sex	Sexual acts
1248	1248
Honor Blackman	1925 births, 2020 deaths, Actors from Essex, Actresses who played Bond girls, English movie actors, English stage actors, English television actors
Hamlet	Plays by William Shakespeare
1605	1605
Bias	Psychology
1701	1701
Harpsichord	Keyboard instruments, Early musical instruments, Plucked string instruments
The Kingston Trio	Musical groups from California, Folk music groups, Palo Alto, California
The Passion of the Christ	2004 drama movies, American drama movies, American epic movies, Fiction set in the past, Movies set in Ancient Rome, Movies based on the Bible, Multilingual movies, Movies directed by Mel Gibson
Cavalry	Army, Horse riding, Military animals
Zachary Taylor	1784 births, 1850 deaths, Deaths from stroke, Politicians from Virginia, American military people, Zachary Taylor, 19th-century American politicians
Gianni Rodari	Italian writers, 1920 births, 1980 deaths
Montgomery, Alabama	Former national capitals, Montgomery, Alabama, County seats in Alabama, State capitals in the United States, 1819 establishments in Alabama
Omaha, Nebraska	Omaha, Nebraska, County seats in Nebraska, 1854 establishments in Nebraska Territory
Toledo, Spain	Capital cities in Spain, Toledo, Spain, World Heritage Sites in Spain
Tommy Tutone	American rock bands, American pop music groups, new wave bands, Musical groups from California
Judas Priest	1960s establishments in England, 1960s British music groups, 1970s British music groups, 1980s British music groups, 1990s British music groups, 2000s British music groups, 2010s British music groups, English heavy metal bands, Hard rock bands, Musical groups established in 1969, Musical groups from Birmingham, West Midlands, Speed metal bands
Palo Alto, California	Palo Alto, California
Everly Brothers	1957 establishments in the United States, Musical groups disestablished in 2014, 1950s American music groups, 1960s American music groups, 1970s American music groups, 1980s American music groups, 1990s American music groups, 2000s American music groups, 2010s American music groups, American rock bands, Country bands, Musical duos, Entertainers from Iowa, 20th-century establishments in Iowa, 2014 disestablishments in the United States, Musical groups established in 1957, Warner Bros. Records artists
1896	1896
42	40s
Willie Nelson	1933 births, Living people, American country singers, American guitarists, American movie actors, American songwriters, American television actors, Country guitarists, Musicians from Texas, Singers from Texas
Africa-Eurasia	Supercontinents
1916	1916
Cemetery	Death customs, Cemeteries
Linda Blair	1959 births, Living people, Actors from St. Louis, Missouri, American movie actors, American television actors
David Crosby	American guitarists, Musicians from Los Angeles, California, American folk musicians, American rock musicians, Organ transplant recipients, Singers from Los Angeles, California, 1941 births, Living people
Paul Harvey	American historians, American radio personalities, Writers from Tulsa, Oklahoma, 1918 births, 2009 deaths
Carbon dioxide	Organic compounds, Biochemistry, Greenhouse gases, Oxides
Intermission	Theater
David Duchovny	1960 births, Living people, American movie actors, American television actors, Actors from New York City, Golden Globe Award winning actors
Laramie, Wyoming	Cities in Wyoming, County seats in Wyoming, Albany County, Wyoming
Black Death	Plague pandemics, Middle Ages
Liverpool	Liverpool, Merseyside, Ports and harbours of the United Kingdom
1166	1166
Serfdom	Feudalism
Refrigerator	Home appliances, Machines
Janis Ian	1951 births, Living people, American composers, American folk musicians, American guitarists, American science fiction writers, Grammy Award winners, Jewish American writers, Lesbians, LGBT novelists, LGBT people from New York City, LGBT singers, LGBT songwriters, Musicians from New York City, Singers from New York City, Writers from New York City
Vilnius	Vilnius
1524	1524
Fungus	Fungi
Guernsey	Islands of the Channel Islands, Guernsey
Pottery	Pottery
Screenwriter	Screenwriters, Movie occupations
Sacramento, California	Cities in the Central Valley of California, County seats in California, Sacramento, California, State capitals in the United States, 1850 establishments in California
Alexander Scriabin	1872 births, 1915 deaths, 20th century composers, Musicians from Moscow, Romantic composers, Russian composers, Russian pianists
Robert Mugabe	1924 births, 2019 deaths, Deaths from prostate cancer, Former dictators, Former members of the Order of the Bath, Presidents of Zimbabwe, Prime Ministers of Zimbabwe, Roman Catholics, African Union chairpersons
Guyana	Guyana, Caribbean Community, English-speaking countries, 1966 establishments in South America
Sen no Rikyu	1522 births, 1591 deaths, People from Osaka Prefecture
Oscar Wilde	1854 births, 1900 deaths, Deaths from meningitis, Bisexual people, Disease-related deaths in France, Irish LGBT people, Irish novelists, Irish playwrights, Irish poets, LGBT novelists, LGBT playwrights, LGBT poets, Writers from Dublin
U2 (band)	20th century establishments in the Republic of Ireland, 1980s Irish music groups, 1990s Irish music groups, 2000s Irish music groups, 2010s Irish music groups, Irish rock bands, Musical groups established in 1976, Musical groups from Dublin, Musical quartets, U2, 1976 establishments in Europe
Bono	Honorary Knights Commander of the Order of the British Empire, 1961 births, Living people, Irish guitarists, Irish rock musicians, Irish singer-songwriters, Musicians from Dublin, Rock guitarists, Time People of the Year, U2
Adam Clayton	1960 births, Living people, Bassists, U2, English guitarists
The Edge	1961 births, Living people, English rock guitarists, English rock singers, Musicians from Dublin, Musicians from Essex, People from Barking, U2
Larry Mullen Jr.	1961 births, Living people, Irish rock musicians, Musicians from Dublin, Rock drummers, U2
Mariah Carey	People from New York, Living people, Actors from New York, African American actors, African-American singers, American philanthropists, Grammy Award winners, Mariah Carey, American contemporary R&B singers, American R&B singers, American pop musicians, American pop singers, Hip hop musicians, American soul musicians, Singers from New York, 1969 births
Andrology	Medical specialties
1503	1503
Herbert Hoover	1874 births, 1964 deaths, Deaths from gastrointestinal hemorrhage, Deaths from colorectal cancer, Cancer deaths in New York City, US Republican Party politicians, World War I, Presidents of the United States, Quakers, Herbert Hoover, United States Secretaries of Commerce, Politicians from Iowa, 20th-century American politicians
James A. Garfield	1831 births, 1881 deaths, United States representatives from Ohio, US Republican Party politicians, Assassinated United States Presidents, James A. Garfield, Deaths by firearm, 19th-century American politicians
Robert Reed	Actors from Illinois, American movie actors, American stage actors, American television actors, Cancer deaths in California, Deaths from AIDS, Deaths from colorectal cancer, Gay men, LGBT actors, LGBT people from Illinois, LGBT people from Oklahoma, LGBT people from Texas, People from Highland Park, Illinois, Infectious disease deaths in California, 1932 births, 1992 deaths
Dishwasher	Occupations, Home appliances
John Quincy Adams	1767 births, 1848 deaths, Deaths from stroke, John Quincy Adams, Presidents of the United States, Deans of the United States House of Representatives, United States Secretaries of State, Children of Presidents of the United States, United States senators from Massachusetts, United States representatives from Massachusetts, Ambassadors of the United States, Federalist party (US) politicians, Democratic Republican party (US) politicians, National Republican party (US) politicians, Whig party (US) politicians, 19th-century American politicians
Peter Fonda	1940 births, 2019 deaths, Actors from New York City, Actors from Omaha, Nebraska, American movie actors, American political activists, American screenwriters, American stage actors, American television actors, American voice actors, Cancer deaths in Los Angeles, Deaths from lung cancer, Deaths from respiratory failure, Democrats (United States), Disease-related deaths in Los Angeles, Golden Globe Award winning actors, Movie directors from New York City, Screenwriters from New York City, Writers from Nebraska
Dennis Hopper	Actors from Kansas, Actors from Kansas City, Missouri, Actors from San Diego, California, American painters, American movie actors, American photographers, American sculptors, American stage actors, American television actors, American voice actors, American writers, Cancer deaths in Los Angeles, Deaths from prostate cancer, People from Dodge City, Kansas, Movie directors from California, Movie directors from Missouri, Writers from California, Writers from Kansas, Writers from Missouri, 1936 births, 2010 deaths
Todd Rundgren	1948 births, Living people, American record producers, American rock guitarists, American rock singers, American singer-songwriters, Singers from Pennsylvania
1066	1066
1497	1497
1559	1559
1581	1581
1509	1509
1521	1521
Al-Qaeda	1980s establishments, Al-Qaeda, Rebel militia groups, Shiaphobia, Sunni organizations
1863	1863
1905	1905
1917	1917
1915	1915
Tallinn	World Heritage Sites in Europe, Tallinn
Lombardy	Lombardy
Regions of Italy	Regions of Italy
1886	1886
Vladimir Nabokov	1899 births, 1977 deaths, American novelists, Disease-related deaths in Switzerland, People from Saint Petersburg, Russian novelists
Abingdon, Oxfordshire	Towns in Oxfordshire, County towns in England
Yeadon	Towns in West Yorkshire
George Washington Carver	1864 births, 1943 deaths, Accidental deaths from falls in the United States, American activists, American adoptees, American botanists, American Christians, American inventors, Scientists from Missouri
1744	1744
Julian calendar	Calendars
Gregorian calendar	Calendars
Southern hemisphere	Hemispheres
Sufism	Sufism
Dove	Doves
Antonio Prohias	Cartoonists, Cuban people, 1921 births, 1998 deaths
Chancellor	Heads of government, Chancellors, Titles, Government occupations
MUD	Types of video games, Video game genres
Ulysses S. Grant	1822 births, 1885 deaths, Deaths from throat cancer, Ulysses S. Grant, American abolitionists, American Civil War generals, US Republican Party politicians, Politicians from Ohio, Politicians from Illinois, Military people from Illinois, 19th-century American politicians
Grenada	Grenada, Current monarchies, Caribbean Community, English-speaking countries, Commonwealth realms, 1974 establishments in North America
Accrington	Towns in Lancashire
Yateley	Towns in Hampshire
Stratford-upon-Avon	Towns in Warwickshire, Sites associated with William Shakespeare
Pune	Pune
Beer (Devon)	Villages in Devon
Fly	Basic English 850 words, Flies
Dhikr	Islam
Jockey	Horse riding, Sports occupations
George Lazenby	1939 births, Living people, Actors from New South Wales, Actors who played James Bond, Australian models, Australian movie actors, Australian television actors, Companions of the Order of Australia, Officers of the Order of the British Empire
Cone	Three-dimensional shapes
Ice cream	Ice cream
Grace Coolidge	First Ladies of the United States, Second Ladies of the United States, 1879 births, 1957 deaths, Calvin Coolidge, People from Burlington, Vermont
List of U.S. state flowers	Lists of United States state symbols, Flowers, Lists of plants
Blacksmith	Occupations
Caracas	Caracas, 1560s establishments in South America, Establishments in Venezuela, 1567 establishments, Capital cities in South America, Cities in Venezuela, World Heritage Sites in South America
Homestar Runner	Homestar Runner
Horst Köhler	1943 births, Living people, Managing Directors of the International Monetary Fund, Order of Merit of the Federal Republic of Germany, Politicians of the Christian Democratic Union of Germany, Presidents of Germany, Refugees
2012	2012
John Williams	1932 births, Living people, Academy Award winning composers, American composers, American conductors, American movie score composers, Brit Award winners, Golden Globe Award winning composers, Musicians from New York
Superman	Superman, DC Comics adapted into movies, DC Comics superheroes, Comic books, Fictional characters introduced in the 1930s, Kryptonians, Justice League, Fictional American people
Camellia	Camellia
Exponentiation	Mathematics, Hyperoperations
Sega	Sega
Primary school	Types of educational institutions
Restaurant	Restaurants
Skimmed milk	Milk
Chocolate	Food ingredients, Chocolate
1828	1828
Northumberland	Northumberland, Ceremonial counties of England
Violin	String instruments
Train station	Railway stations
Railway track	Rail transport
Rail transport	Rail transport
Waterway	Waterways
Junction	Transport
Station	Basic English 850 words
1816	1816
James Brown	1933 births, 2006 deaths, African-American singers, American people convicted of assault, American R&B singers, American robbers, American soul musicians, Deaths from heart failure, Deaths from pneumonia, Disease-related deaths in Atlanta, Infectious disease deaths in the United States, Musicians from Georgia (U.S. state), Singers from Georgia (U.S. state), Singers from South Carolina, Musicians from South Carolina
Aldous Huxley	1894 births, 1963 deaths, Cancer deaths in Los Angeles, Deaths from laryngeal cancer, English children's writers, English novelists, English playwrights, English poets, English screenwriters, English essayists, Huxley family, Writers from Surrey
Dylan Thomas	1914 births, 1953 deaths, Welsh poets, People from Swansea
Leo Gorcey	1917 births, 1969 deaths, American movie actors, Actors from New York City
1750	1750
Indiana	Indiana, 1816 establishments in the United States
Marun Field	Iran
Wolf	Wolves, Mammals of North America
Frank Lampard	1978 births, Living people, Chelsea F.C. players, English footballers, English football managers, Manchester City F.C. players, Sportspeople from London, Premier League players
Eswatini	1968 establishments in Africa, Current monarchies, English-speaking countries, States and territories established in 1968, Eswatini
Liberia	Liberia, Least developed countries
Central African Republic	Central African Republic, French-speaking countries, Least developed countries
Kim Jong-nam	1971 births, 2017 deaths, Assassinated people, North Korean politicians
Western Sahara	Western Sahara, Dependent territories
Tunis	Tunis
Mozambique	Mozambique, Portuguese-speaking countries, Least developed countries, Members of the Organisation of Islamic Cooperation
Dian Fossey	American biologists, American people murdered abroad, American zoologists, Female scientists, Murders by blade weapons, Scientists from San Francisco, Rwanda, 1932 births, 1985 deaths
Maryland	Maryland, 1788 establishments in the United States
Billy Paul	Grammy Award winners, Singers from Philadelphia, Pennsylvania, American R&B singers, Cancer deaths in New Jersey, Deaths from pancreatic cancer, 1934 births, 2016 deaths
Rita Coolidge	1945 births, Living people, Singers from Tennessee, Grammy Award winners
Carole Bayer Sager	Singer-songwriters from New York, Singers from New York City, Grammy Award winners, 1947 births, Living people, Best Original Song Academy Award-winning songwriters
Elvis Costello	1954 births, Living people, English rock guitarists, English rock singers, English singer-songwriters, Musicians from London, New wave musicians
The Cure	Musical groups established in 1976, 1970s British music groups, 1980s British music groups, 1990s British music groups, 2000s British music groups, 2010s British music groups, English rock bands, Entertainers from Sussex
Crawley	Towns in West Sussex
Blue Öyster Cult	1970s American music groups, 1980s American music groups, 1990s American music groups, 2000s American music groups, 2010s American music groups, American heavy metal bands, American hard rock bands, Musical groups from New York City, Musical groups established in 1971, 1971 establishments in New York (state)
Steppenwolf	American rock bands, American heavy metal bands, American hard rock bands, Canadian rock bands, Musical groups from Los Angeles, California, Musical entertainers from Toronto, 1967 establishments in North America, 1972 disestablishments, 1974 establishments in North America
Creedence Clearwater Revival	1967 establishments in California, 1972 disestablishments in the United States, American rock bands, Musical groups from California, Rock and Roll Hall of Fame inductees, Southern rock bands, 1970s disestablishments in California
Ferret	Mustelids, Pets
Three Dog Night	American rock bands, Soul bands, Musical groups from Los Angeles, California
Grand Funk Railroad	American rock bands, Musical groups from Michigan, People from Flint, Michigan
The Sweet	British rock bands, British pop music groups, British heavy metal bands, Glam metal bands
Prince (musician)	1958 births, 2016 deaths, Actors from Minneapolis, Minnesota, African-American movie actors, African-American singers, American activists, American composers, American funk musicians, American movie directors, American philanthropists, American funk singers, American pianists, American pop musicians, American pop singers, American Protestants, American R&B musicians, American R&B singers, American record producers, American rock guitarists, American saxophonists, American singer-songwriters, Best Original Song Academy Award-winning songwriters, Brit Award winners, Drug-related accidental deaths in the United States, Golden Globe Award winners, Grammy Award winners, Jehovah's Witnesses people, Musicians from Minnesota, New wave musicians, Prince (musician), Singers from Minnesota, Webby Award winners, Writers from Minnesota, Warner Bros. Records artists
Duane Eddy	American rock guitarists, Grammy Award winners, 1938 births, Living people
Nurse	Nursing, Healthcare occupations
Violent Femmes	American rock bands, American punk bands, People from Wisconsin
Ozzy Osbourne	British burglars, English rock musicians, English singer-songwriters, Grammy Award winners, Musicians from Birmingham, Actors from Birmingham, Writers from Birmingham, English artists, English rock singers, English movie actors, English television personalities, People with Parkinson's disease, 1948 births, Living people
Dinah Shore	Television talk show hosts, Singers from Tennessee, 1916 births, 1994 deaths
Bryan Adams	Bryan Adams, Canadian rock musicians, Canadian singer-songwriters, Grammy Award winners, Musicians from Ontario, 1959 births, Living people
Roy Orbison	American rock singers, Cardiovascular disease deaths in Tennessee, Deaths from myocardial infarction, Singers from Texas, 1936 births, 1988 deaths
Taylor Dayne	1962 births, Living people, Singers from New York
Stephen Stills	Singer-songwriters from Texas, Singers from Dallas, Texas, Writers from Dallas, Texas, 1945 births, Living people
SpongeBob SquarePants	Fictional animals, SpongeBob SquarePants, 1990s animated television series, 2000s animated television series, 2010s animated television series, 2020s animated television series, American animated television series, American children's television series, 1999 television series debuts, English-language television programs
Paul & Paula	Musical groups from Texas
Seafood	Seafood
Peer review	Science
Puerto Rico	Puerto Rico, 1898 establishments in the United States, Caribbean Community
Jonathan Ke Quan	1971 births, Living people, Vietnamese people, American child actors, American movie actors, American television actors, Actors from Los Angeles County, California
Pilgrimage	Religious behavior and experience, Religious places
1703	1703
Watermelon	Melons
Monrovia	Monrovia
Paul Anka	1941 births, Living people, American pop singers, Canadian pop singers, Canadian singer-songwriters, Naturalized citizens of the United States, People from Ottawa, Singers from Ontario
Neil Young	1945 births, Living people, Naturalized citizens of the United States, Canadian rock guitarists, Canadian rock singers, American rock guitarists, American rock singers, American country singers, American country musicians, Singers from Toronto
The Hitchhiker's Guide to the Galaxy	Science fiction, Media franchises
Cookbook	Books, Cooking
Somalia	Somalia, Italian-speaking countries, Least developed countries, Members of the Organisation of Islamic Cooperation
Mel Blanc	1908 births, 1989 deaths, Actors from San Francisco, American movie actors, American radio actors, American stage actors, American television actors, American voice actors, Cardiovascular disease deaths in the United States, Deaths from stroke
ConAgra Foods, Inc.	American food companies, 1919 establishments in North America
IPod	IPod
Costa Rica	Costa Rica, Spanish-speaking countries, 1949 establishments in North America, 20th-century establishments in Costa Rica
Wisconsin	Wisconsin, 1848 establishments in the United States
Odia Coates	1941 births, 1991 deaths, American pop musicians, Singers from Mississippi
Amy Grant	1960 births, Living people, Christian music singers, Gospel Music Hall of Fame inductees, People from Augusta, Georgia, Singers from Georgia (U.S. state), American pop musicians, Musicians from Georgia (U.S. state)
Dalida	1933 births, 1987 deaths, Actors who committed suicide, Burials at Montmartre Cemetery, Paris, Drug-related suicides, French movie actors, French singers, French television actors, Italian movie actors, Italian singers, Italian television actors, Musicians who committed suicide, People from Cairo, Suicides in France
The Bangles	1980s American music groups, 1981 establishments in California, 1990s American music groups, 2000s American music groups, 2010s American music groups, American girl groups, American pop music groups, American rock bands, Musical groups established in 1981, Musical groups from Los Angeles, California, Musical groups disestablished in 1989, 1989 disestablishments in the United States, 1980s disestablishments in California, Musical groups established in 1999, 1999 establishments in California
Britcom	British sitcoms
Millimetre	Units of length
Kris Kristofferson	1936 births, Living people, People from Edinburgh, Country musicians, Scottish movie actors, Rhodes scholars, British singer-songwriters
Mathematical constant	Mathematics
Leaning Tower of Pisa	Buildings and structures in Italy, Towers in Europe, Pisa
Tower	Towers
Tel Aviv	Tel Aviv, 1909 establishments in Asia, 1900s establishments in Israel
Trigonometry	Trigonometry
Monotheism	Theology
Polytheism	Religion
Nelvana	Canadian animation studios, Toronto, 1971 establishments in Canada
Jeb Bush	2016 United States presidential candidates, 1953 births, Living people, People from Midland, Texas, Businesspeople from Texas, Governors of Florida, Bush family, George H. W. Bush, Children of Presidents of the United States, US Republican Party politicians, 21st-century American politicians, 20th-century American politicians
Auckland	Auckland
Capitalism	Economic systems, Capitalism
Ghana	Ghana, 1957 establishments in Africa
Strawberry Shortcake	Dolls
Christina Aguilera	1980 births, Living people, Actors from Staten Island, American child singers, American movie actors, American pop musicians, American R&B musicians, Brit Award winners, Christina Aguilera, Grammy Award winners, Latin singers, Mouseketeers, Musicians from Staten Island, Singers from New York City, Latin Grammy Award winners, American contemporary R&B singers
Chicken	Phasianidae, Domesticated animals
Floppy disk	Storage devices
Nat King Cole	African American musicians, American jazz musicians, American pianists, American pop musicians, Singers from Chicago, Musicians from Chicago, Deaths from lung cancer, American jazz singers, Grammy Award winners, Singers from Alabama, Musicians from Alabama, 1919 births, 1965 deaths, People from Montgomery, Alabama
Voice of America	Communication, Radio, 1942 establishments in the United States
George Gershwin	American composers, American songwriters, American pianists, American Jews, 20th century composers, Deaths from brain cancer, 1898 births, 1937 deaths
Aaron Copland	1900 births, 1990 deaths, Kennedy Center honorees, American composers, 20th century composers, Grammy Award winners, Pulitzer Prize winners
464 BC	464 BC
Diphthong	Language
The Price is Right	Television game shows, CBS network shows, NBC network shows, First run syndicated television programs
Monophthong	Language
Kalua	Culture of Hawaii, Cooking methods
Ultraviolet	Energy
Ornithology	Birds, Branches of zoology
Rod Stewart	1945 births, English rock singers, English singer-songwriters, Living people, Singers from London, Warner Bros. Records artists
Sean Connery	1930 births, 2020 deaths, Academy Award winning actors, Actors from Edinburgh, Actors who played James Bond, BAFTA Award winning actors, British movie producers, Deaths from dementia, Deaths from heart failure, Deaths from pneumonia, Golden Globe Award winning actors, Knights Bachelor, Scottish movie actors, Scottish stage actors, Scottish television actors, Scottish voice actors
1666	1666
1867	1867
The Specials	1977 establishments in the United Kingdom, 1970s British music groups, 1980s British music groups, 1990s British music groups, 2000s British music groups, 2010s British music groups, Coventry, English musical groups, Musical groups established in 1977, New wave bands
KC & the Sunshine Band	American pop music groups, Disco groups, Funk bands, Musical groups from Miami, Florida, Musical groups established in 1973, 1973 establishments in the United States, 1970s establishments in Florida, Musical groups disestablished in 1983, 1983 disestablishments in the United States, 20th-century disestablishments in Florida, Musical groups established in 1993, 1993 establishments in Florida
Roberta Flack	1937 births, Living people, African American musicians, American R&B singers, American singer-songwriters, Grammy Award winners, Singers from North Carolina
Arad, Romania	County capitals of Romania
Transsexual	LGBT variations
Pianist	Entertainment occupations, Pianists
Telephone book	Telephone numbers
French dip sandwich	Sandwiches
Coventry	Coventry
Billy Preston	African American musicians, American funk musicians, American gospel musicians, American pianists, American R&B singers, American rock musicians, American soul musicians, Deaths from respiratory failure, Deaths from myocarditis, Disease-related deaths in the United States, LGBT African Americans, Gay men, LGBT musicians, Musicians from Houston, Texas, The Beatles, 1946 births, 2006 deaths
Computer virus	Malware
Hades	Greek gods and goddesses, Afterlife
Superlative	Parts of speech, Grammar
Learning disability	Disability, learning
Wheelbarrow	Gardening tools
Cold	Basic English 850 words
Electrical conductivity	Electricity, Materials science
Pierre Omidyar	1967 births, Living people, Businesspeople from Paris
Caribert of Laon	French people, Year of birth unknown, 8th century deaths
First Lady of the United States	Politics of the United States, First Ladies of the United States
Star Wars	Star Wars, American science fiction movies, Science fiction action movies
Korean language	Korean language, Language isolates, Korea
Kansas	Kansas, 1861 establishments in Kansas, Midwestern United States
James Buchanan	1791 births, 1868 deaths, Deaths from respiratory failure, James Buchanan, United States senators from Pennsylvania, United States representatives from Pennsylvania, United States Secretaries of State, US Democratic Party politicians, American diplomats, 19th-century American politicians
Hand	Basic English 850 words, Limbs and extremities
Rule	Law
1910s	1910s
Bahrain	Bahrain, Current monarchies, Members of the Organisation of Islamic Cooperation
William Christopher	1932 births, 2016 deaths, Deaths from lung cancer, Writers from Illinois, Actors from Illinois, American movie actors, American television actors, American voice actors, Cancer deaths in Los Angeles County, California, People from Evanston, Illinois
Boxer shorts	underwear
Compact disc player	Music technology, Audio technology
Fluid dynamics	Fluid mechanics
Ernest Hemingway	American journalists, American Nobel Prize winners, Military people from Chicago, People from Oak Park, Illinois, Suicides by firearm in the United States, Writers from Chicago, Writers who committed suicide, 1899 births, 1961 deaths
MSN	Microsoft websites, Internet service providers, Websites
Reed (instrument)	Musical instrument construction, Woodwind instruments
1790	1790
Nuuk	National capitals in North America, Settlements in Greenland
Lumberjack	Occupations, Forestry
Muhammad	570 births, 632 deaths, Islamic religious leaders, Muhammad
Ford Mustang	1960s automobiles, 1970s automobiles, 1980s automobiles, 1990s automobiles, 2000s automobiles, 2010s automobiles, Ford automobiles
Red Hat Linux	Linux distributions, Red Hat
Sacavém	Cities in Portugal
Shooter	Shooter video games, Types of video games, Video game genres
Sushi	Japanese food, Seafood dishes
The Thinker	Statues
Nazko Cone	Volcanoes of British Columbia
Anahim Volcanic Belt	Volcanoes of British Columbia
Chilcotin Group	Volcanoes of British Columbia, Igneous rocks
Garibaldi Volcanic Belt	Volcanoes of British Columbia
Mount Garibaldi	Volcanoes of British Columbia, Mountains of British Columbia
Mount Meager	Volcanoes of British Columbia
Metaphysics	Branches of philosophy, Reality
Washington (state)	Washington (U.S. state), 1889 establishments in the United States
Clematis	Flowers, Ranunculales
Rational number	Numbers
Saint Patrick's Day	Christian holidays, National Days
Edgar Cayce	1877 births, 1945 deaths, American esotericists, Mystics, People from Kentucky, People from Virginia Beach, Virginia
Hibiscus syriacus	Trees, Malvaceae
Hibiscus	Flowers, Malvaceae
Maceió	Cities in Alagoas, Capitals of Brazilian states
Alagoas	Alagoas, States of Brazil
René Descartes	1596 births, 1650 deaths, French physicists, French philosophers
Tanzania	1964 establishments in Africa, Least developed countries, States and territories established in the 1960s, Tanzania
Kingdom of Great Britain	1707 establishments, 1800 disestablishments, Kingdom of Great Britain, 1700s establishments in Europe, 1800s disestablishments in Europe
Ford Model T	Ford automobiles, 1920s automobiles
Volkswagen	Volkswagen, Wolfsburg
Toyota	Toyota, 1937 establishments in Asia, 1930s establishments in Japan
Interpreter	Linguistics
Horseshoe	Horses, Superstitions
Carlos Menem	1930 births, 2021 deaths, Deaths from renal failure, Deaths from urinary tract infection, Presidents of Argentina
Buenos Aires Province	Buenos Aires Province
Canadian Broadcasting Corporation	Canadian television networks, 1936 establishments in North America, 1930s establishments in Canada
Romeo and Juliet	Plays by William Shakespeare
Baz Luhrmann	1962 births, Living people, Australian movie directors
Rock and roll	African-American history, Rock music
Thomas Edison	Businesspeople from Ohio, American inventors, Deaths from diabetes, Disease-related deaths in the United States, Scientists from Ohio, 1847 births, 1931 deaths
Diabetes mellitus	Diabetes mellitus
18th century	18th century
17th century	17th century
Victor Hugo	1802 births, 1885 deaths, French deists, French novelists, French playwrights, French poets, Members of the Académie française, People from Bourgogne-Franche-Comté, Former Roman Catholics
FIFA World Cup	FIFA World Cup, 1930 establishments
1643	1643
Jakarta	Jakarta
Comedy Central	1991 establishments in New York (state), American television channels, Viacom
Apron	Protective clothing
Pearl Jam	1990s American music groups, 2000s American music groups, 2010s American music groups, American hard rock bands, Grunge bands, Musical groups from Seattle, Washington, Musical groups established in 1989, 1989 establishments in the United States, 1980s establishments in Washington (state)
Social Distortion	American punk bands, 1970s American music groups, 1980s American music groups, 1990s American music groups, 2000s American music groups, 2010s American music groups, Musical groups from Los Angeles, California
Andy Gibb	1958 births, 1988 deaths, Deaths from myocarditis, English pop musicians, English singers, Infectious disease deaths in England, Musicians from Manchester
INXS	1970s Australian music groups, 1980s Australian music groups, 1990s Australian music groups, 2000s Australian music groups, 2010s Australian music groups, 1977 establishments in Australia, Australian alternative rock bands, Musical groups disestablished in 2012, Musical groups established in 1977, Musical groups from Sydney, New wave bands
Chicago (band)	1967 establishments in the United States, 1960s American music groups, 1960s establishments in Illinois, 1970s American music groups, 1980s American music groups, 1990s American music groups, 2000s American music groups, 2010s American music groups, American rock bands, Musical groups established in 1967, Musical groups from Chicago, Warner Bros. Records artists
The Turtles	Musical groups from Los Angeles, California, American pop music groups, American rock bands, Folk music groups
Strawberry Alarm Clock	Musical groups from Los Angeles, California, American rock bands
Psychedelic pop	Music genres
Donovan	1946 births, Living people, British pop musicians, Scottish singers, Autobiographers
Frisian languages	Frisian languages
Smashing Pumpkins	1980s American music groups, 1990s American music groups, 2000s American music groups, 2010s American music groups, American rock bands, Musical groups established in 1988, 1988 establishments in the United States, 1980s establishments in Illinois, Musical groups from Chicago, Musical groups disestablished in 2000, 2000 disestablishments in the United States, 2000s disestablishments in Illinois, Musical groups established in 2006, 2006 establishments in Illinois
Tool (band)	1990 establishments in the United States, 1990s American music groups, 2000s American music groups, 2010s American music groups, American heavy metal bands, Progressive rock bands, Grammy Award winners, Musical groups established in 1990, Musical groups from Los Angeles, California, Progressive metal bands
Death (band)	1980s American music groups, 1990s American music groups, 2000s American music groups, American heavy metal bands, Death metal bands, Musical groups from Orlando, Florida, Musical groups established in 1983, 1983 establishments in the United States, 1980s establishments in Florida, Musical groups disestablished in 2001, 2001 disestablishments in the United States, 2000s disestablishments in Florida
Mötley Crüe	1980s American music groups, 1990s American music groups, 2000s American music groups, 2010s American music groups, Musical groups established in 1981, 1981 establishments in California, American heavy metal bands, American hard rock bands, Glam metal bands, Musical groups from Los Angeles, California, Musical groups disestablished in 2015, 2015 disestablishments in the United States, 2010s disestablishments in California
Radio control	Electronics, toys, weapons
Tucumán Province	Provinces of Argentina
Duran Duran	1978 establishments in the United Kingdom, 1970s British music groups, 1980s British music groups, 1990s British music groups, 2000s British music groups, 2010s British music groups, British pop rock bands, English pop music groups, English rock bands, Musical groups established in 1978, Musical groups from Birmingham, West Midlands, Warner Bros. Records artists
Peter Tosh	1944 births, 1987 deaths, Jamaican singers, Murdered musicians, Pop musicians
Billy Joel	1949 births, Living people, American pianists, American pop musicians, American rock musicians, American rock singers, Democrats (United States), Musicians from the Bronx, Entertainers from New York, Singer-songwriters from New York, Singers from New York City
Lake Constance	Geography of Baden-Württemberg, Geography of Bavaria, Lakes of Europe, Lakes of Austria, Lakes of Switzerland, Canton of Schaffhausen, Canton of St. Gallen, Thurgau, Vorarlberg, Konstanz
Samurai	Samurai
The Republic	Works of philosophy
Aesthetics	Philosophy
Wes Craven	1939 births, 2015 deaths, Scream (franchise), A Nightmare on Elm Street, Actors from Cleveland, Ohio, American movie actors, American movie editors, American television actors, American television directors, American television producers, American television writers, Cancer deaths in Los Angeles, Deaths from brain cancer, Movie directors from Ohio, Movie producers from Ohio, Screenwriters from Ohio, Writers from Cleveland, Ohio
Earth, Wind & Fire	1960s American music groups, 1969 establishments in Illinois, 1970s American music groups, 1980s American music groups, 1990s American music groups, 2000s American music groups, 2010s American music groups, African-American musical groups, American R&B bands, Funk bands, Musical groups established in 1969, Musical groups from Chicago, Soul bands
Fifth Dimension	1960s American music groups, 1970s American music groups
The Kinks	1964 establishments in the United Kingdom, 1996 disestablishments in England, 1960s British music groups, 1970s British music groups, 1980s British music groups, 1990s British music groups, English rock bands, Musical groups disestablished in 1996, Musical groups established in 1964, Musical groups from London
Diesel engine	Motors
Megabyte	Computing measurement
Waffle	Breakfast foods, Desserts, Baked foods, Sweet breads, Belgian food
Stargard	Towns in Poland, Hanseatic League
Ruby slippers	Movie industry
Pope John XXIII	1881 births, 1963 deaths, Italian popes, Beatified people, Time People of the Year, People from Lombardy
Beauty	Everyday life, Psychology
2020s	2020s
Guitar	Guitars, String instruments
List of guitarists	Guitarists, Lists of entertainers
British Sea Power	2000 establishments in England, 2000s British music groups, 2010s British music groups, Brighton, English rock bands, Indie rock bands, Musical groups established in 2000
Jimmy Eat World	American rock bands, American punk bands, Emo bands, Musical groups from Arizona, 1990s American music groups, 2000s American music groups, People from Mesa, Arizona, Musical groups established in 1993, 1993 establishments in the United States, 1990s establishments in Arizona
Phish	American rock bands, Musical groups established in 1983, 2004 disestablishments in the United States, Burlington, Vermont, 1983 establishments in the United States, 20th-century establishments in Vermont
Green Day	1986 establishments in the United States, 1980s American music groups, 1980s establishments in California, 1990s American music groups, 2000s American music groups, 2010s American music groups, American punk bands, Musicians from Berkeley, California, Green Day, Musical groups established in 1986, Musical groups from California, People's Choice Award winners, American Music Awards
Live album	Albums
Marvin Gaye	African American musicians, American manslaughter victims, American R&B singers, American singer-songwriters, American soul musicians, Deaths by firearm, Musicians from Washington, D.C., 1939 births, 1984 deaths, Murdered African-American people
Masturbation	Human sexuality
Animation	Movie industry, Animation
Confucius	551 BC births, 479 BC deaths, Eastern philosophers, Confucianism, Chinese philosophers
Consciousness	Philosophy, Consciousness
Architect	Construction occupations, Architects
La Jolla, San Diego	Spa towns in the United States, San Diego, California
Arch	Basic English 850 words, Construction, Architectural elements
Vagina	Anatomy of the female reproductive system
Breast	Breasts, Sexuality, Organs
Pregnancy	Pregnancy and childbirth
Forest	Forests
Barber	Personal service occupations
Carpenter	Construction occupations
Electrician	Construction occupations
Roof	Basic English 850 words, Construction
Brick	Basic English 850 words, Building materials
San Diego, California	San Diego, California, County seats in California, 1769 establishments, 18th-century establishments in California
Oriole	Passeriformes
Feather	Animal anatomy, Basic English 850 words
Mary-Kate and Ashley Olsen	1986 births, Living people, Actors from Los Angeles, California, American child actors, American movie actors, American movie producers, American singers, American television actors, American television producers, Businesspeople from Los Angeles, California, Sibling duos, Twin people
The Walt Disney Company	Companies based in Los Angeles, Disney companies, Movie studios
Hypercholesterolemia	Diseases and disorders of the cardiovascular system, Diseases
Cholesterol	Biochemistry, Macromolecules
Iowa	Iowa, 1846 establishments in the United States, Midwestern United States
Gender identity	Gender
America's Army	Shooter video games, 2002 video games
Heterosexuality	Human sexuality
Hate crime	Types of crime, Hatred, Discrimination
Gay bashing	LGBT, Bullying
Emergency medicine	Emergency medicine
Berkeley, California	Berkeley, California, 1878 establishments in California
Medical specialty	Medical specialties
Pediatrics	Medical specialties
Jenna Bush Hager	1981 births, Living people, George W. Bush, Bush family, Children of Presidents of the United States, Twin people from the United States
Uncyclopedia	2005 establishments, Wikis
Barbara Bush Coyne	1981 births, Living people, Bush family, Children of Presidents of the United States, George W. Bush, Twin people from the United States, Yale University alumni
Esperanto	Esperanto
Barbara Bush	1925 births, 2018 deaths, Deaths from COPD, Deaths from congestive heart failure, Cardiovascular disease deaths in Texas, Bush family, George H. W. Bush, First Ladies of the United States, Second Ladies of the United States, Yale University alumni, People from Rye, New York
Kadis-kot	Star Trek, Board games
Kenny Rogers	1938 births, 2020 deaths, Actors from Houston, Texas, Writers from Houston, Texas, American country singers, American movie actors, American songwriters, American television actors, Grammy Award winners, Musicians from Houston, Texas, Singers from Houston, Texas
Moundou	Cities in Chad
Andrew Aagesen	1826 births, 1887 deaths, Danish politicians, Danish businesspeople, Danish educators, Teachers, Lawyers
Heart (band)	1970s American music groups, 1980s American music groups, 1990s American music groups, 2000s American music groups, 2010s American music groups, American hard rock bands, American pop music groups, American rock bands, Folk music groups, Musical groups from Seattle, Washington, Musical groups established in 1973, 1973 establishments in the United States, 1970s establishments in Washington (state)
Golden Earring	Musical groups established in 1961, 1960s music groups, 1970s music groups, 1980s music groups, 1990s Dutch music groups, 2000s Dutch music groups, 2010s music groups, Rock bands, The Hague, 1960s establishments in the Netherlands, 1961 establishments in Europe
Rick Springfield	1949 births, Living people, Australian pop musicians, Australian rock musicians, Australian singer-songwriters, Australian television actors, Australian movie actors, Musicians from Sydney, Actors from Sydney
Anus	Anatomy of the digestive system
Orgasm	Sexuality
Prostate	Anatomy of the male reproductive system, Glands
Fossil	Paleontology, Fossils
Nine Inch Nails	1980s American music groups, 1990s American music groups, 2000s American music groups, 2010s American music groups, American heavy metal bands, Grammy Award winners, Alternative metal bands, Musicians from Cleveland, Ohio, musical groups from Ohio, Nine Inch Nails, Musical groups established in 1988, 1988 establishments in the United States, 1980s establishments in Ohio
Remixing	Music
H. P. Lovecraft	American novelists, Deaths from small intestine cancer, Cancer deaths in the United States, People from Providence, Rhode Island, 1890 births, 1937 deaths
Hormone	Hormones, Endocrine system
Testosterone	Steroid hormones
Patio	Construction
Cholera	Diseases caused by bacteria, History of medicine
Mandriva Linux	Linux distributions, X86-64 Linux distributions
Action theory	Philosophy
Xiangqi	Chess variants
Governor	Government occupations
Republican Party (United States)	United States Republican Party, 1854 establishments in the United States, Conservative parties
Democratic Party (United States)	United States Democratic Party, 1828 establishments in the United States
Taste	Basic English 850 words, Sensory system
Touch	Sensory system, Non-verbal communication
Classical mechanics	Mechanics
Moai	Statues, Easter Island
Diogenes of Sinope	Ancient Greek philosophers, 323 BC deaths
Vaccination	Immunization
Vice President of the United States	Government of the United States, Vice Presidents of the United States
Dick Cheney	1941 births, Living people, Businesspeople from Nebraska, American conservatives, American Methodists, Organ transplant recipients, People from Lincoln, Nebraska, Politicians from Nebraska, United States representatives from Wyoming, United States Secretaries of Defense, US Republican Party politicians, White House Chiefs of Staff, 21st-century American politicians, 20th-century American politicians, Recipients of the Order of the Rising Sun, Businesspeople from Wyoming
Toad the Wet Sprocket	American rock bands, Musical groups from California, Santa Barbara, California, Musical groups established in 1986, 1986 establishments in the United States, 1980s establishments in California, Musical groups disestablished in 1998, 1998 disestablishments in the United States, 1990s disestablishments in California, Musical groups established in 2002, 2002 establishments in the United States, 2000s establishments in California
Boyz II Men	1988 establishments in the United States, 1980s American music groups, 1990s American music groups, 2000s American music groups, 2010s American music groups, African-American musical groups, American boy bands, American R&B bands, Musical groups established in 1988, Musical groups from Philadelphia, Pennsylvania, 1980s establishments in Pennsylvania
Johnny Nash	1940 births, 2020 deaths, American soul singers, American composers, American singer-songwriters, Musicians from Houston, Texas, Writers from Houston, Texas, Actors from Houston, Texas, Singers from Houston, Texas, Reggae musicians
Linda Ronstadt	1946 births, Living people, American country singers, American pop singers, American rock singers, Entertainers from Tucson, Arizona, People with Parkinson's disease, Singers from Arizona
Heart	Basic English 850 words, Heart, Anatomy of the cardiovascular system
Heart disease	Heart disease
North Dakota	North Dakota, 1889 establishments in the United States
LGBT	LGBT
Rainbow flag	Flags
Dualism	Philosophical movements and positions, Theology
Vomit	Symptoms
Ancient Greece	Ancient Greece
Malaria	Diseases spread by insects, Apicomplexa, Diseases caused by protozoa
Blood vessel	Blood vessels
Jana Gana Mana	India, National anthems
Circulatory system	Cardiovascular system
Pink triangle	LGBT
Chat room	Internet communication, Messaging
Alan Wake	2008 video games, Xbox 360 games, Windows games
Devil May Cry 4	2008 video games, Devil May Cry, PlayStation 3 games, PlayStation 4 games, Xbox 360 games, Xbox One games
50 Cent	1975 births, Living people, 50 Cent, Actors from Queens, African American actors, African American musicians, American crime victims, American movie actors, American rap musicians from New York, Criminals from New York City, Drug dealers, Grammy Award winners, Movie producers from New York City, Musicians from Queens, Singers from New York City
Talk	linguistics
Subject (school)	Education
Learning English	Learning, English language
Ethical tradition	Religious ethics
Dildo	Sexuality
Bioinformatics	Biology, Computer science
Economy of India	Economy of India
Testicle	Anatomy of the male reproductive system, Glands
The Screwtape Letters	Books by C. S. Lewis, 1942 books
Multiplayer video game	Types of video games, Video game gameplay
"Weird Al" Yankovic	Actors from Los Angeles County, California, American movie actors, Singer-songwriters from California, Comedians from Los Angeles County, California, Musicians from Los Angeles County, California, Singers from Los Angeles County, California, 1959 births, Living people, People from Downey, California
Supertramp	British rock bands
New Mexico	New Mexico, 1912 establishments in the United States
1471	1471
Sting	1951 births, Living people, English guitarists, English movie actors, English rock musicians, English singer-songwriters, English television actors, People from Newcastle upon Tyne, Commanders of the Order of the British Empire
Starbucks	American food companies, Coffee houses, Seattle, Washington, 1971 establishments in the United States, 1970s establishments in Washington (state)
Frasier	1993 American television series debuts, 2004 American television series endings, 1990s American sitcoms, 2000s American sitcoms, American television spin-offs, NBC network shows, Television series about brothers, Television series about families, Television series set in Seattle, Washington, English-language television programs
Spin-off	Entertainment
Pedophilia	Child sexual abuse, Paraphilias
Igneous rock	Rocks
Bauxite	Rocks, Ores
Chalcopyrite	Minerals, Copper compounds
Hematite	Minerals, Ores, Iron compounds
Galena	Minerals, Ores
Bob Dole	1923 births, Living people, US Republican Party politicians, United States senators from Kansas, Minority leaders of the United States Senate, Majority leaders of the United States Senate, 1980 United States presidential candidates, 1988 United States presidential candidates, 1996 United States presidential candidates, Presidential Citizens Medal recipients, 20th-century American politicians, Kansas Republicans, People from Lawrence, Kansas, People with cancer, American military personnel of World War II, American lawyers, Businesspeople from Kansas, American political activists, State legislators of the United States, Presidential Medal of Freedom recipients, Lobbyists, Anti-Communists, American autobiographers, American political writers, American political commentators, Writers from Kansas
Lionel Richie	1949 births, Living people, Best Original Song Academy Award-winning songwriters, African American musicians, American pianists, American pop musicians, American R&B singers, American soul musicians, Golden Globe Award winning composers, Grammy Award winners, Singers from Alabama, Singers from Illinois, People from Joliet, Illinois
Walt Disney Pictures	Movie studios, American animation studios, Disney companies
Scrotum	Anatomy of the male reproductive system
Ministry (band)	1981 establishments in the United States, 1980s American music groups, 1980s establishments in Illinois, 1990s American music groups, 2000s American music groups, 2010s American music groups, American heavy metal bands, Electronic music bands, Musical groups established in 1981, Musical groups from Chicago, Thrash metal bands, Musical groups disestablished in 2008, 2008 disestablishments in the United States, 2000s disestablishments in Illinois, Musical groups established in 2011, 2011 establishments in the United States, 2010s establishments in Illinois
Ingot	Metals
Westlife	1990s Irish music groups, 2000s Irish music groups, 2010s Irish music groups, Boy bands, Irish pop music groups, Musical groups disestablished in 2012, Musical groups established in 1998, Musical quartets, Musical quintets
Ulcer	diseases, Dermatology
Peptic ulcer	Diseases and disorders of the digestive system
Symptom	Symptoms
Medical diagnosis	Medicine
True Jesus Church	Pentecostalism, Protestant denominations, Religion in China
Pokémon (video game series)	Pokémon
Homer Simpson	Fictional characters introduced in 1987, The Simpsons characters
Calcium	Alkaline earth metals
A Series of Unfortunate Events	A Series of Unfortunate Events, Children's books, 2004 movies, Paramount movies, Black comedy
Membrane	Cell biology, Plant anatomy
Voltaire	1694 births, 1778 deaths, 17th century philosophers, French deists, French philosophers, Pen names
Missouri	Missouri, 1821 establishments in the United States
South Dakota	South Dakota, 1889 establishments in the United States
Wimbledon, London	London Borough of Merton
Mersey Beat	Music genres, The Beatles, Liverpool, Merseyside
1078	1078
1766	1766
The Adventures of Pete and Pete	Comedy television series, Nickelodeon television series, 1993 American television series debuts, 1996 American television series endings, 1990s television series, American children's television series, American comedy television series, American comedy-drama television series, American drama television series, English-language television programs
427 BC	427 BC
Motorcycle	Motorcycles, Springfield, Massachusetts
1585	1585
Guinea pig	rodents, pets, Domesticated animals
1531	1531
Philip Glass	1937 births, Living people, American composers, 20th century composers
Audioslave	2000s American music groups, American rock bands, American hard rock bands, Post-grunge bands, Musical groups from Los Angeles, California, Musical groups established in 2001, 2001 establishments in California, Musical groups disestablished in 2007, 2007 disestablishments in the United States, 2000s disestablishments in California
Environment	Earth sciences
Tooth	Basic English 850 words, Teeth
Petula Clark	Actors from Surrey, British child actors, British child singers, English movie actors, English pop singers, English television actors, Singers from Surrey, 1932 births, Living people, Warner Bros. Records artists
Tom Jones (singer)	1940 births, Living people, Brit Award winners, British R&B musicians, British soul musicians, Grammy Award winners, Musicians from Glamorgan, Officers of the Order of the British Empire, Welsh pop singers, Knights Bachelor
Slade	English rock bands
1776	1776
Deep Purple	1968 establishments in England, 1960s British music groups, 1970s British music groups, 1980s British music groups, 1990s British music groups, 2000s British music groups, 2010s British music groups, Blues bands, English hard rock bands, English heavy metal bands, Musical groups established in 1968, Warner Bros. Records artists
Yogurt	Dairy products, Desserts
Marlon Brando	Academy Award winning actors, Actors from Omaha, Nebraska, American movie actors, American movie directors, American stage actors, American television actors, Disease-related deaths in the United States, Deaths from congestive heart failure, Deaths from respiratory failure, Deaths from pulmonary fibrosis, 1924 births, 2004 deaths
Galician language	Languages of Europe, Romance languages, Galicia
Ibn Khaldun	Historians, 1332 births, 1406 deaths, People from Tunis
Swabian Jura	Geography of Baden-Württemberg, Mountain ranges of Germany
Nerve	Basic English 850 words, Anatomy of the nervous system
Vaccine	Infectious diseases, Virology, Immunization
Injury	Health problems
Mercedes-Benz	Mercedes-Benz, 1886 establishments in Europe, 1880s establishments in Germany
Record label	Record labels
Pipette	Laboratory equipment
Muscle	Basic English 850 words, Animal tissues, Muscular system
Game Boy	Game Boy
Stomach	Basic English 850 words, Anatomy of the digestive system
Pain	Basic English 850 words, Pain
Drain	Basic English 850 words, Water infrastructure
Super Mario 64	Nintendo 64 games, 1996 video games, 3D platform games, Mario platform games
MP3	Computer file formats for audio
King Crimson	English rock bands, English hard rock bands, English heavy metal bands, New wave bands, Progressive rock bands, Musical groups from London
Fleetwood Mac	1967 establishments in England, 1960s British music groups, 1970s British music groups, 1980s British music groups, 1990s British music groups, 2000s British music groups, 2010s British music groups, English rock bands, Musical groups established in 1967, Musical groups from London, Warner Bros. Records artists
The Yardbirds	Musical groups from London
Grateful Dead	Musical groups from San Francisco, American rock bands, 1960s American music groups, 1970s American music groups, 1980s music groups, 1990s American music groups, Warner Bros. Records artists, Rock and Roll Hall of Fame inductees
Johnny Winter	1944 births, 2014 deaths, American guitarists, American record producers, Blues guitarists, People from Beaumont, Texas, Musicians from Texas, Musicians from Mississippi
Edgar Winter	Blues musicians, 1946 births, Living people
Albinism	Genetic disorders
Paco de Lucía	1947 births, 2014 deaths, Deaths from myocardial infarction, Entertainers from Andalusia, Guitarists, Spanish musicians, Latin Grammy Award winners
Hearing	Basic English 850 words, Hearing, Perception
Bhutan	Bhutan, Current monarchies, Least developed countries
Caucasian race	Anthropology, Race
Voice	Basic English 850 words
James Madison	1751 births, 1836 deaths, Deaths from heart failure, American deists, James Madison, Presidents of the United States, United States Secretaries of State, United States representatives from Virginia, Founding Fathers of the United States, Democratic Republican party (US) politicians, 19th-century American politicians, 18th-century American politicians, Slavers
James Monroe	1758 births, 1831 deaths, Deaths from tuberculosis, United States Secretaries of State, Governors of Virginia, Founding Fathers of the United States, James Monroe, 19th-century American politicians, 18th-century American politicians
Martin Van Buren	1782 births, 1862 deaths, American Calvinists, American lawyers, Deaths from asthma, Deaths from heart failure, Governors of New York, Martin Van Buren, Presidents of the United States, United States Secretaries of State, United States senators from New York, US Democratic Party politicians, 19th-century American politicians
South Holland	South Holland
Grand Theft Auto	PlayStation games, 1998 video games, Grand Theft Auto
The Black Eyed Peas	1995 establishments in California, 1990s American music groups, 2000s American music groups, 2010s American music groups, Hip hop bands, R&B bands, Electronic music bands, Musical groups established in 1995, Musical groups from Los Angeles, California, The Black Eyed Peas
PlayStation Portable	2004 establishments, 2014 disestablishments, Handheld video games, PlayStation, Sony, Sony consoles
Abortion	Abortion, Women's rights
Clock	Basic English 850 words, Clocks
Sexual orientation	LGBT
Smiley	Internet culture, Symbols
Flamenco	Music genres, Dance types, Entertainment, Masterpieces of the Oral and Intangible Heritage of Humanity
Cream (band)	1966 establishments in England, 1968 disestablishments, 1960s disestablishments in the United Kingdom, English rock bands, Musical groups established in 1966, Musical groups from London, Musical trios
Blind Faith	English rock bands, Blues bands
The Guess Who	Canadian rock bands, Canadian hard rock bands, Folk music groups, Blues bands, People from Manitoba, Musical groups established in 1963, 1963 establishments in North America, 1960s establishments in Canada, Musical groups disestablished in 1975, 20th century disestablishments in Canada, Musical groups established in 1977, 1977 establishments in North America, 1970s establishments in Canada
Bruce Springsteen	1949 births, Living people, American rock singers, American rock guitarists, American singer-songwriters, Singers from New Jersey, Musicians from New Jersey, Best Original Song Academy Award-winning songwriters, Kennedy Center honorees
Intersexuality	Gender, Genetic disorders, Developmental disorders
Digestive system	Digestive system
Mouth	Basic English 850 words, Mouth
Deacon	Christian religious occupations
Friedrich Engels	1820 births, 1895 deaths, Cancer deaths in London, Deaths from throat cancer, German atheists, German communists, German philosophers, German politicians, German writers, Marxism, Politicians from North Rhine-Westphalia
Dinner	Meals
Rosa Luxemburg	1871 births, 1919 deaths, 19th century philosophers, 20th century philosophers, Executed German people, German communists, German murder victims, German philosophers, Jewish atheists, Jewish feminists, Jewish German politicians, Jewish philosophers, Jewish women politicians, Marxism, Murders by firearm in Germany, People executed by firearm, Polish Jews, Socialists
Liver	Anatomy of the digestive system, Metabolism, Organs
Neck (disambiguation)	Basic English 850 words
Coachella Valley	Valleys of California, Riverside County, California
Derivative work	Intellectual property law
Rugby football	Rugby
Kidney	Anatomy of the urinary system
Prefix	Grammar
UNESCO	UNESCO, Cultural organizations, Scientific organizations, Educational organizations, 1945 establishments
Human rights	Human rights
Nationality	Nationality, International law
Medical ethics	Medicine, Ethics
Sperm	Biological reproduction, Human sexuality
Semen	Male reproductive system
Bilbao	Bilbao, Capital cities in Spain
Middle school	Types of educational institutions
List of Disney animated movies	Lists of movies, Disney animated movies
List of Disney movies	Disney movies, Lists of movies
Ku Klux Klan	1860s in the United States, 1865 establishments in the United States, 20th century in the United States, 21st century in the United States, African-American history, Christian terrorism, Crime in the United States, Discrimination, Gangs, Organizations based in the United States, Secret societies, Tennessee
Brown v. Board of Education	1954 in the United States, American civil rights, Topeka, Kansas, United States law, United States Supreme Court cases, 1950s in law
Well	Basic English 850 words, Tools, Aquifers
Honey	Spreads, Natural resources, Beekeeping
Sweet	Basic English 850 words
Cracker	Breads, Snack foods
Surgery	Surgery
Pizza	Pizza
Pepperoni	Sausage
Abdomen	Torso
Heaven	Afterlife
Button	Basic English 850 words
Multiprocessing	Computer science
Multitasking	Computer science
Multithreading	computer science
Fertilization	Biological reproduction
Whiteboard	Writing media, learning
Chemist	Chemists, Science occupations
Biologist	Biologists, Science occupations
Testicular cancer	Cancer
Future	Basic English 850 words, Time
Fetus	Biological reproduction
Past	Time
Particle	Chemistry, Nuclear physics, Matter
Ellen DeGeneres	1958 births, Living people, American comedians, American movie actors, American television actors, Emmy Award winners, Lesbians, LGBT actors, LGBT broadcasters, LGBT comedians, LGBT people from Louisiana, Mark Twain Prize recipients, Actors from New Orleans, Louisiana, People's Choice Award winners
Rosie O'Donnell	Actors from New York City, American movie actors, American television talk show hosts, Comedians from New York City, Emmy Award winners, Lesbians, LGBT actors, LGBT broadcasters, LGBT comedians, LGBT people from New York, American LGBT rights activists, Television personalities from New York, 1962 births, Living people, American bloggers
Ass	Pejoratives
Tissue	Tissues
Shit	English profanity
Cunt	Pejoratives, English profanity
Dick	Pejoratives, Names
Nut	Basic English 850 words
Bitch	Pejoratives, English profanity, Words
Whore	Profanity, English profanity, Prostitution, Pejoratives
Ball and chain	Law enforcement equipment
Faggot (food)	Meat dishes
Llanfairpwllgwyngyll	Long words, Villages in Wales
Pneumoconiosis	Long words, Diseases
Taumatawhakatangihangakoauauotamateaturipukakapikimaungahoronukupokaiwhenuakitanatahu	Long words, Hills, Geography of New Zealand
Something Awful	Websites
Fark.com	Websites
Menstruation	Female reproductive system
Corinthian-Casuals F.C.	English football clubs
Nightclub	Places where alcohol is served, Entertainment venues
Freezing	Matter
Precious metal	Geology, Metals
Jewellery	Jewelry
Potassium	Alkali metals, Chemical elements
The Simpsons	1989 American television series debuts, 1980s American sitcoms, 1980s animated television series, 1990s American sitcoms, 1990s animated television series, 1990s satirical television series, 2000s American sitcoms, 2000s animated television series, 2000s satirical television series, 2010s American sitcoms, 2010s animated television series, 2010s satirical television series, 2020s American sitcoms, 2020s animated television series, 2020s satirical television series, Adult animated television series, American animated television series, American satirical television series, American television spin-offs, English-language television programs, Fox television series, The Simpsons
Teresa Heinz	Businesspeople from Pittsburgh, Pennsylvania, John Kerry, Naturalized citizens of the United States, Writers from Pittsburgh, Pennsylvania, People with cancer, Portuguese writers, 1938 births, Living people
Museum	Museums
Camera	Cameras
News	News, Communication
Export	Economics
Observatory	Observatories
Epidemic	Infectious diseases
George of the Jungle	Animated television series
Westminster Abbey	Anglican Cathedrals, Westminster Abbey, World Heritage Sites in the United Kingdom
Eagles (band)	1971 establishments in California, 1970s American music groups, 1980s American music groups, 1990s American music groups, 2000s American music groups, 2010s American music groups, American rock bands, Musical groups established in 1971, Musical groups from Los Angeles, California, Musical groups disestablished in 1980, 1980s disestablishments in California, Musical groups established in 1994, 1994 establishments in California, Musical groups disestablished in 2016, 2016 disestablishments in the United States, 2010s disestablishments in California, Musical groups established in the 2010s, 2017 establishments in the United States, 2010s establishments in California
Himalayas	Himalayas
Brihanmumbai Electric Supply and Transport	1873 establishments, Public transport, Companies of India, Mumbai, 1870s establishments in India
Gelderland	Gelderland
Canvas	Basic English 850 words, Painting, Woven fabrics
Large format lens	Camera lenses
Ramones	1970s American music groups, 1974 establishments in the United States, 1980s American music groups, 1990s American music groups, 1996 disestablishments in the United States, American punk bands, Musical groups disestablished in 1996, Musical groups established in 1974, Musical groups from New York City, 1970s establishments in New York (state), 1990s disestablishments in New York (state)
Olivia Newton-John	1948 births, Living people, Actors from Cambridgeshire, Actors from Melbourne, Australian movie actors, Australian pop musicians, Australian singers, Australian television actors, People with cancer, English movie actors, English pop musicians, English singers, English television actors, Grammy Award winners, Musicians from Cambridge, Musicians from Melbourne, Naturalised citizens of Australia
Kansas (band)	American rock bands, American hard rock bands, Musicians from Kansas, People from Topeka, Kansas
Styx (band)	1970s American music groups, 1980s American music groups, 1990s American music groups, 2000s American music groups, 2010s American music groups, American rock bands, Musical groups established in 1972, 1972 establishments in Illinois, Musical groups disestablished in 1984, 1984 disestablishments in the United States, Musical groups established in 1990, 1990 establishments in Illinois, Musical groups disestablished in 1991, 1991 disestablishments in the United States, Musical groups established in 1995, 1995 establishments in Illinois
Jethro Tull (band)	1967 establishments in England, 1960s British music groups, 1970s British music groups, 1980s British music groups, 1990s British music groups, 2000s British music groups, 2010s British music groups, 2010s disestablishments in the United Kingdom, Blackpool, English hard rock bands, Musical groups established in 1967, Musical groups disestablished in 2014, 21st century disestablishments in England
Turtle	Turtles, Living fossils
Rage Against the Machine	1991 establishments in California, 1990s American music groups, 2000s American music groups, American heavy metal bands, Alternative metal bands, Musical groups established in 1991, Musical groups from Los Angeles, California
Product (mathematics)	Arithmetics
Universal Declaration of Human Rights	United Nations, 1948, Human rights
Dolphin	Toothed whales
Guinea	Guinea, French-speaking countries, Least developed countries, Members of the Organisation of Islamic Cooperation, 1958 establishments, 1950s establishments in Africa
Pig	Pigs, Ungulates
Wheat	Wheat, Poales
Taliban	Taliban
Screw	Basic English 850 words, Hardware (mechanical)
Tajikistan	Tajikistan, Members of the Organisation of Islamic Cooperation, 1991 establishments in Asia
Fear	Basic English 850 words, Emotions
Tongue	Basic English 850 words, Mouth, Sensory system
Titanium	Metals
Hebrew language	Hebrew language
Joan of Arc	1412 births, 1431 deaths, Christian saints, Hundred Years' War, French people
James Kopp	1954 births, Living people, American murderers, American prisoners, American Roman Catholics, American terrorists, Criminals from California, People from Pasadena, California
Millet	Grains
Sonic the Hedgehog (character)	Mascots, Fictional animals, Fictional characters introduced in 1991, Sonic the Hedgehog characters, Video game characters in movies
Hedgehog	Eulipotyphla
Final Fantasy	Video game series, Final Fantasy
Georges Brassens	1921 births, 1981 deaths, French singers, French songwriters
Display resolution	Display technology
Cervix	Anatomy of the female reproductive system, sexuality
Bullet	Ballistics, Ammunition
Frankfort, Kentucky	State capitals in the United States, Cities in Kentucky, County seats in Kentucky
Shahrukh Khan	1965 births, Living people, Indian movie actors, Indian movie producers, People from New Delhi, Game show hosts
Masashi Tashiro	1956 births, Living people, Japanese musicians, People from Saga Prefecture
New Orleans	1718 establishments, 18th-century establishments in Louisiana, Former United States state capitals, New Orleans, Louisiana, Parish seats in Louisiana
Mamluk	History of Egypt, Military, 1254 establishments, 1811 disestablishments, Establishments in Egypt, Disestablishments in Africa, 13th-century establishments in Africa
Laurent Clerc	1785 births, 1869 deaths, French educators
Ivory	Natural materials
Political subdivisions of Brazil	Politics of Brazil
Vice president	Vice presidents, Government occupations
Triple jump	Events in athletics
Texas hold 'em	Poker
Creationism	Intelligent design, Creation myths
Flute	Flutes
Staind	1994 establishments in the United States, 1990s American music groups, 2000s American music groups, 2010s American music groups, American heavy metal bands, American rock bands, Musical groups established in 1994, Musical groups from Massachusetts, Post-grunge bands
Ocarina	Flutes
Clarinet	Woodwind instruments
16th century	16th century
Lute	Plucked string instruments, Early musical instruments
Independence Day (United States)	National Days
Microsoft Office	Microsoft Office, Word processors
Afrikaans	Afrikaans
Leonard Bernstein	1918 births, 1990 deaths, 20th century composers, American composers, American conductors, American movie score composers, Bisexual Jews, Cardiovascular disease deaths in New York City, Deaths from myocardial infarction, Entertainers from Massachusetts, Grammy Award winners, Jewish American LGBT people, Jewish American musicians, Kennedy Center honorees, LGBT musicians, LGBT people from Massachusetts, People from Lawrence, Massachusetts, Tony Award winners
Afrikaans Language Monument	Monuments and memorials, Afrikaans
DC Comics	DC Comics, Comic books, 1934 establishments in the United States
Wonder Woman	Wonder Woman, DC Comics adapted into movies, Justice League, Fictional characters introduced in 1941
Bob Saget	American movie actors, American stage actors, American television actors, American stand-up comedians, Actors from Philadelphia, Pennsylvania, 1956 births, Living people, Comedians from Pennsylvania
Phil Collins	1951 births, Living people, Actors from London, Actors from Middlesex, English movie actors, English rock drummers, English rock singers, English television actors, English voice actors, Genesis (band), Musicians from London, Musicians from Middlesex, People from Chiswick, Phil Collins, Best Original Song Academy Award-winning songwriters, Golden Globe Award winners, Atlantic Records artists
Badfinger	Musical groups established in 1969, 1960s establishments in England, 20th century establishments in Wales, Musical groups disestablished in 1975, 1970s disestablishments in the United Kingdom, 1980s disestablishments in England, Musical groups established in 1978, 1978 establishments in the United Kingdom, 1970s establishments in England, Musical groups disestablished in 1984, 1984 disestablishments in the United Kingdom, 1960s British music groups, 1970s British music groups, 1980s British music groups, British rock bands
United Nations Security Council	United Nations
High jump	Events in athletics
Manhattan	Islands of New York, County seats in New York, Manhattan
The Bronx	County seats in New York, The Bronx, 1898 establishments in the United States, 1890s establishments in New York (state)
Bob Denver	American television actors, Actors from New York, 1935 births, 2005 deaths, Deaths from cancer
1100	1100
Monk	Religious occupations, Monks
Dream Theater	1980s American music groups, 1990s American music groups, 2000s American music groups, 2010s American music groups, American heavy metal bands, Progressive metal bands, Musical groups from New York, Warner Bros. Records artists, Atlantic Records artists
Triangle	Polygons
Feminism	Political movements, Feminism, Women's rights
Eivør Pálsdóttir	1983 births, Living people, Danish singers, Danish composers, Faroese people
Hippopotamus	Even-toed ungulates, Mammals of Africa
Prefecture	Prefectures
2010	2010
Eris (dwarf planet)	Dwarf planets
Operation Overlord	1944 in Europe, 1940s in France, Battles involving Australia, Battles involving Canada, Battles involving France, Battles involving Germany, Battles involving New Zealand, Battles involving the United Kingdom, Battles involving the United States, European battles of World War II, Normandy, June 1944 events, July events
Mike Tyson	1966 births, African-American boxers, American rapists, Criminals from New York City, Living people, Sportspeople from New York City, WWE Hall of Fame
Cleveland, Ohio	Cleveland, Ohio, County seats in Ohio
Lexus	Toyota
Against	Basic English 850 words, VOA Special English words
Dentition	Dentistry, Teeth
Plectrum	Plucked string instruments
Danny Barker	1909 births, 1994 deaths, African-American singers, American guitarists, American jazz musicians, American singer-songwriters, Musicians from New Orleans, Louisiana, Singers from New Orleans, Louisiana
Charlie Christian	1916 births, 1942 deaths, American guitarists, American jazz musicians, Musicians from Oklahoma
Franco Cerri	Italian musicians, Jazz musicians, Guitarists, 1926 births, Living people
Eddie Condon	American jazz musicians, Musicians from Indiana, 1905 births, 1973 deaths
Al Di Meola	American guitarists, American jazz musicians, Musicians from New Jersey, 1954 births, Living people, People from Jersey City, New Jersey
White House	Buildings and structures in Washington, D.C., Presidency of the United States
George Carlin	1937 births, 2008 deaths, Actors from Manhattan, American movie actors, American philosophers, American stand-up comedians, American television actors, American television producers, American television writers, American voice actors, Cardiovascular disease deaths in Los Angeles County, California, Comedians from New York City, Deaths from heart failure, Former Roman Catholics, Mark Twain Prize recipients, Writers from Manhattan
Portuguese language	Languages of Europe, Romance languages
Hurricane Katrina	2005 in the United States, Category 5 Atlantic hurricanes, George W. Bush, 2000s in Louisiana, Hurricane Katrina, Hurricanes in the United States, Retired tropical cyclone names, 2005 Atlantic hurricane season, Hurricanes in Louisiana
Carlos Fuentes	People from Panama City, Deaths from cardiovascular disease, Mexican historians, Mexican poets, Mexican journalists, Mexican novelists, Mexican screenwriters, 1928 births, 2012 deaths, Disease-related deaths in Mexico
Bass guitar	Bass guitars, Jazz instruments
Saint Anna	Early Christian saints
Nepal	Nepal, Former monarchies of Asia, Least developed countries
Zagreb	Zagreb, Establishments in Croatia, 11th century establishments in Europe, 1090s establishments, 1094
Swedish krona	Sweden, Currency of Europe
Giant	Legendary creatures
Piedmont	Piedmont
Terry Fox	1958 births, 1981 deaths, Canadian activists, Cancer deaths in British Columbia, Deaths from bone cancer, People from Winnipeg, Sportspeople from British Columbia
Rick Hansen	1957 births, Living people, Canadian activists, Canadian sportspeople, Order of Canada, Sportspeople from British Columbia
Fin	Animal anatomy
Region	Regions
1514	1514
Toothache	Teeth, Pain
Icing (food)	Food ingredients
Romford	Towns in London, London Borough of Havering
Maltose	Sweeteners, Carbohydrates
Toolbox	Tools
Stone	Basic English 850 words, Natural materials
Hotspot (computers)	Internet
Winnipeg	Winnipeg
Kilobyte	Computing measurement
Byte	Computer science, Computing measurement
Subatomic particle	Subatomic particles
Breathing	Physiology
Laura Bush	People from Midland, Texas, First Ladies of the United States, Bush family, George W. Bush, 1946 births, Living people
Dijon	Communes in Côte-d'Or, Departmental capitals in France, Dijon, Regional capitals in France
Simon Rodia	1879 births, 1965 deaths, Italian architects, American architects, People from Los Angeles, California
Terry Southern	American military people, writers from Texas, 1924 births, 1995 deaths
1615	1615
Emeril Lagasse	1959 births, Living people, American chefs, People from Massachusetts, Food Network
Hurricane Rita	2005 Atlantic hurricane season, Category 5 Atlantic hurricanes, Retired tropical cyclone names, Hurricanes in the United States, 2005 in the Bahamas, 2005 in Florida, 2005 in Cuba, 2000s in Louisiana, 2005 in Texas, 2005 in Mississippi, History of Arkansas, Hurricanes in Texas, Hurricanes in Louisiana, 2005 in the United States, Disasters in the United States, September 2005 events
Boeing 767	Boeing aircraft
1557	1557
Stephen King	1947 births, Living people, Actors from Maine, American movie actors, People from Portland, Maine, Writers from Maine, People from Bangor, Maine, Stephen King
Baby	Babies, Basic English 850 words
Cactus	Cactaceae
Desert	Deserts
Dessert	Desserts
William Henry Harrison	1773 births, 1841 deaths, Deaths from pneumonia, Deaths from jaundice, United States senators from Ohio, United States representatives from Ohio, Politicians from Virginia, William Henry Harrison, Benjamin Harrison, Whig party (US) politicians, 19th-century American politicians, 18th-century American politicians
Viacom	Entertainment companies, Viacom
Uniform Resource Locator	Internet
Cuckoo clock	Clocks
Labrador Retriever	Dog breeds
Margaret Thatcher	1925 births, 2013 deaths, Margaret Thatcher, British lawyers, Cardiovascular disease deaths in London, Chancellors of the College of William & Mary, Deaths from stroke, English Anglicans, English chemists, Female scientists, Former Conservative MPs (UK), Knights of the Garter, Leaders of the Conservative Party (UK), Leaders of the Opposition (United Kingdom), Members of the House of Lords, Order of Merit, People from Lincolnshire, People with cancer, Privy Councillors (UK), Secretaries of State of the United Kingdom, UK MPs 1959–1964, UK MPs 1964–1966, UK MPs 1966–1970, UK MPs 1970–1974, UK MPs 1974, UK MPs 1974–1979, UK MPs 1979–1983, UK MPs 1983–1987, UK MPs 1987–1992, United Kingdom Life Peers, Women lawyers, Women politicians
Firefighter	Occupations, Firefighting
Random	Mathematics, Cryptography, Causality
Political status of Taiwan	Politics of China, Politics of Taiwan
Cellular respiration	Metabolism, Cellular respiration
Lesotho	Lesotho, States and territories established in the 1960s, 1966 establishments, Current monarchies, Least developed countries, 1960s establishments in Africa
Alexander Hamilton	1750s births, 1804 deaths, Federalist party (US) politicians, United States Secretaries of the Treasury, Founding Fathers of the United States, Columbia University alumni, Politicians from New York, 18th-century American politicians, Slavers
Köbes	Germany
Stop-motion	Animation
D.C. United	American soccer teams, Major League Soccer teams, 1995 establishments in the United States, 1990s establishments in Washington, D.C.
Wendy Carlos	20th century composers, American movie score composers, Electronic musicians, LGBT musicians, Grammy Award winners, American LGBT people, Transgender and transsexual people, Musicians from Rhode Island, Women composers, 1939 births, Living people, People from Pawtucket, Rhode Island
Boolean algebra	Boolean algebra, Electronics
Harry Potter and the Philosopher's Stone	1997 books, Harry Potter books
Justin Timberlake	1981 births, Living people, Actors from Memphis, Tennessee, American child singers, American movie actors, American television actors, Former good articles, Grammy Award winners, Justin Timberlake, Mouseketeers, NSYNC, Singers from Memphis, Tennessee
Aramaic language	Semitic languages
Libya	Libya, Members of the Organisation of Islamic Cooperation
Population density	Social sciences, population
Saturday Night Fever	1977 drama movies, American drama movies, Dance movies, English-language movies, Movies set in New York City, United States National Film Registry movies, Movies directed by John Badham
Greyhound	Dog breeds
Grand unification theory	physics
Factory	Manufacturing buildings
United States Declaration of Independence	1776 in the United States, Official documents of the United States, Thomas Jefferson
Jordan	Jordan, Current monarchies, Members of the Organisation of Islamic Cooperation, 1946 establishments in Asia
Prejudice	Discrimination
Inflation	Inflation
Obsessive–compulsive disorder	Anxiety disorders
Industrial Revolution	Periods and ages in history, Economic history
Botswana	Botswana, English-speaking countries, 1966 establishments, 1960s establishments in Africa
Ferry	Public transport, Watercraft
Rapa	Islands of French Polynesia
Jo Whiley	1965 births, Living people, British radio personalities, English television presenters, People from Northampton
Windows Vista	Microsoft operating systems
The Gambia	The Gambia, English-speaking countries, Former British colonies, Least developed countries, Members of the Organisation of Islamic Cooperation, 1965 establishments, 1960s establishments in Africa
Londonderry	542 establishments, 6th century establishments in Europe, Cities in Northern Ireland, Establishments in Northern Ireland, County towns in Northern Ireland
Federal Reserve	1913 establishments in the United States, Banks of the United States, 1910s establishments in Washington, D.C.
Trent Reznor	Singers from Pennsylvania, 1965 births, Living people, Nine Inch Nails
Oklahoma	Oklahoma, 1907 establishments in the United States
Terry Jacks	1944 births, Living people, Canadian rock guitarists, Canadian rock singers, Environmentalists, Musicians from Winnipeg
Sark	Islands of the Channel Islands
Robert Crumb	American animators, Musicians from Philadelphia, Pennsylvania, Writers from Philadelphia, Pennsylvania, American cartoonists, 1943 births, Living people
Renée Zellweger	1969 births, Living people, Academy Award winning actors, Actors from Texas, American movie actors, American voice actors, American stage actors, Singers from Texas, American movie producers, American television actors, Golden Globe Award winning actors, Screen Actors Guild Award winners, People from Katy, Texas
Meryl Streep	1949 births, Living people, Actors from New Jersey, American movie actors, American stage actors, American television actors, American voice actors, Best Actress Academy Award winners, Best Supporting Actress Academy Award winners, Kennedy Center honorees, Screen Actors Guild Award winners
Bench	Furniture, Street furniture
List of national anthems	National anthems, Lists of songs
Celsius	Units of temperature
Fahrenheit	Imperial units, Units of temperature
Anthrax	Diseases caused by bacteria, Zoonoses
Napoleon	1769 births, 1821 deaths, Deaths from stomach cancer, Emperors and empresses, Former dictators, French deists, French generals, French politicians, House of Bonaparte, People from Corsica, People with foods named after them, Princes of Andorra
Wetzlar	1803 disestablishments, 1800s disestablishments in Germany
Andy Warhol	Andy Warhol, American artists, American crime victims, LGBT people from Pennsylvania, American painters, Pop artists, Deaths from surgical complications, Deaths from cardiac arrhythmia, Gay men, LGBT artists, People from Pittsburgh, Pennsylvania, 1928 births, 1987 deaths
Romulus and Remus	Roman mythology, Twin people
Confucianism	Confucianism, History of China, Religion in China
Lead	chemical elements, metals
Bell	Basic English 850 words, Bells
Transformers (toy line)	Animated television series, Toys, Transformers (franchise)
Simplicity	Basic English 850 words
Mathematician	Mathematicians, Science occupations
West Virginia	West Virginia, 1863 establishments in the United States
Virginia	Virginia, 1788 establishments in the United States
Vermont	Vermont, 1791 establishments in the United States
South Carolina	South Carolina, 1788 establishments in the United States
Rhode Island	Rhode Island, 1790 establishments in the United States
North Carolina	North Carolina, 1789 establishments in the United States
New Jersey	New Jersey, 1787 establishments in the United States
New Hampshire	New Hampshire, 1788 establishments in the United States, Former British colonies
Watch glass	Laboratory equipment
Funnel	Tools, Ships
Constantinople	Places of Ancient Rome, Istanbul, Ottoman Empire, Roman Empire, Byzantine Empire
Mormonism	Mormonism
Mohammad Khatami	1943 births, Living people, Iranian politicians, Muslims
Cider	Drinks, Apple products
1499	1499
Bison	Bovines, Mammals of North America, Mammals of Europe
Baseball cap	Baseball equipment, Headgear
Windows 95	Microsoft operating systems
Otto von Bismarck	1815 births, 1898 deaths, Chancellors of the German Empire, Ambassadors of Germany, German generals, German nobility, Members of the Reichstag (German Empire), Prime Ministers of Prussia, People from Prussia, People with foods named after them, Politicians from Saxony-Anhalt
Differential calculus	Calculus
Socialist country	Forms of government
Hamster	Hamsters
Watch	Clocks
Ed Gein	American serial killers, Cancer deaths in the United States, Disease-related deaths in Wisconsin, People from Wisconsin, 1906 births, 1984 deaths

