Art	Art, Non-verbal communication, Basic English 850 words
A	Basic English 850 words, Vowel letters
Air	Basic English 850 words, Physics, Atmosphere
Autonomous communities of Spain	Autonomous communities of Spain
Alan Turing	English computer scientists, English LGBT people, English mathematicians, Gay men, LGBT scientists, Scientists from London, Suicides by poison, Suicides in the United Kingdom, 1912 births, 1954 deaths, Officers of the Order of the British Empire
Alanis Morissette	1974 births, Living people, Alanis Morissette, American child actors, American movie actors, American pop musicians, American rock singers, American singer-songwriters, American television actors, Canadian movie actors, Canadian pop singers, Canadian rock singers, Canadian singer-songwriters, Canadian television actors, Grammy Award winners, People from Ottawa, Singers from Ontario, Twin people from Canada
Adobe Illustrator	Graphics software, Vector graphics editors, Adobe software
Andouille	Sausage
Farming	Agriculture
Arithmetic	Arithmetics
Addition	Basic English 850 words, Arithmetics, Hyperoperations
Australia	Australia, Australasia, Gondwana, Commonwealth realms, English-speaking countries, Federations, 1901 establishments
American English	Dialects of English, Languages of the United States
Aquaculture	Aquaculture
Abbreviation	Linguistics
Angel	Angels
Ad hominem	Latin words used in English
Native American	Native American
Apple	Basic English 850 words, Apples, Rosaceae
Abrahamic religion	Abrahamic religions
Algebra	Algebra
Atom	Chemistry, Nuclear physics
Astronomy	Astronomy
Architecture	Architecture, Architecture sciences, Construction
Anatomy	Anatomy
Asteroid	Asteroids
Afghanistan	Afghanistan, Least developed countries, Members of the Organisation of Islamic Cooperation
Angola	Angola, Portuguese-speaking countries, Least developed countries, 1975 establishments in Africa
Argentina	Argentina, Spanish-speaking countries
Austria	Austria, European Union member states, German-speaking countries, Federations
Armenia	Armenia, Caucasus
Archaeology	Archaeology
Animal	Animals, Basic English 850 words
Acceleration	Basic physics ideas, Mechanics
Black pudding	Sausage
Boot device	software, Computer hardware
Boot	Basic English 850 words, Footwear
Bankruptcy	Money, Law
Breakfast sausage	Sausage, Breakfast foods
Browser	Ecology, Zoology
Beekeeping	Beekeeping
British English	Dialects of English
Being	Philosophy, Religion
Beijing	Beijing, Olympic cities, Provinces of China
Bottle	Basic English 850 words, Containers
Boil	Basic English 850 words
Beard	Facial hair
Black	Basic English 850 words
Bubonic plague	Plague, Pulmonology, Zoonoses
Biology	Biology, Science-related lists
Botany	Botany, Agriculture
Belgium	Belgium, European Union member states, Benelux, Current monarchies, Dutch-speaking countries, French-speaking countries, German-speaking countries, Federations
Brazil	Brazil, Portuguese-speaking countries, 1825 establishments in South America
Chemistry	Chemistry
Computer science	Computer science
Computer	Computers
Continent	Continents, Geology
Classical element	Ancient Greece, History of science
China	China, Asian countries
Country	Countries, Basic English 850 words
Colchester	Towns in Essex
Cartography	Cartography
Creator	Theology
Chorizo	Sausage
Creativity	Human behavior, Creativity
Catharism	Gnosticism, Nontrinitarianism, Christianity of the Middle Ages
Cosmology	Astrophysics, Cosmology
Church (building)	Churches
City	Cities
Cooking	Cooking, Basic English 850 words
Chat	Human communication, Internet communication, Messaging
Cup	Basic English 850 words
Crime	Basic English 850 words, Crime
Time Cube	Pseudoscience, American websites, 1997 establishments in the United States, Conspiracy theories
Census of Marine Life	Biological oceanography
Maize	Maize, Model organisms
Civics	Politics
Calculus	Calculus
Coin	Currency, Coins
Conceptual metaphor	Metaphors
Comedy	Comedy, Genres
Comet	Comets
Cytology	Cell biology, Molecular biology
Christian	Christians
Cheese	Basic English 850 words, Cheese
Constitution	Constitutions
Circle	Shapes, Conic sections
Capitalization	Grammar
Cuba	Cuba, Spanish-speaking countries, Caribbean Community
Cube	Platonic solids
Cost of living	Economics
Dublin	Dublin, County towns in Ireland
Dance	Dance, Non-verbal communication
Dissolution of the monasteries	History of the British Isles, Anglicanism, Protestant Reformation
Deadline	time, Planning, Problem solving
Dutton's Speedwords	Constructed languages
Devil	Theology, Demons
Diarrhea	Symptoms
Dimension	Geometry, Algebra
Distance	Physical quantity, Mathematics
Depth	Physical quantity
Dictionary	Dictionaries, Reference works
Definition	Words
Denmark	Denmark, European Union member states, Nordic countries, Current monarchies, 10th century establishments in Europe
Death	Basic English 850 words, Death
Diesel-electric	Motors
Embassy	Politics
Europe	Europe, Laurasia
Encyclopedia	Encyclopedias
Earth science	Earth sciences
Earth	Earth, Geology, Geography, Astronomical objects, Planets, Terrestrial planets
Et cetera	Latin phrases
Experiment	Experiments
Ethics	Ethics
E Prime	English language
Einstein on the Beach	1970s operas, 1976
Ethnic group	Ethnic groups
Ebola virus	Infectious diseases, Diseases caused by viruses, Zoonoses
Ecology	Ecology
Economics	Economics, Social sciences
Chemical element	Chemical elements, Nuclear physics
Egypt	Egypt, Members of the Organisation of Islamic Cooperation, 1922 establishments in Africa
Everything2	Websites
Ecological yield	Ecology
Experience economy	Economics
Execution	Crime, Capital punishment
Flesch Reading Ease	Linguistics, Written communication
FAQ	Internet slang
Flame (disambiguation)	Basic English 850 words
Financial capital	Factors of production, Finance
Fecund universes	Cosmology
Food	Basic English 850 words, Foods
Fine	Punishments, Money
Frying	Cooking methods
Fish	Basic English 850 words, Fish
Foot	Basic English 850 words, Feet
France	France, European Union member states, Former good articles, French-speaking countries, G8 nations, G7 nations
Finland	Finland, European Union member states, Nordic countries, 1917 establishments in Europe
Fruit	Basic English 850 words, Fruits
Farm	Farms, Basic English 850 words
Geography	Geography
Good	Basic English 850 words
Grammar	Grammar
Great Lakes	Great Lakes, Ecology, Lakes of Canada, Geography of Ontario, Lakes of the United States
GNU Free Documentation License	Software licences
Glass	Glass, Basic English 850 words
God	Gods and goddesses
Ghost	Occult, Afterlife
Green	Basic English 850 words
God's eye view	Social sciences
Google	Google, 1998 establishments in the United States, Companies listed on NASDAQ, Mountain View, California, Search engines
Gallon	Imperial units, Units of volume
Government	Basic English 850 words, Government
Galaxy	Galaxies
Geometry	Geometry
Graph theory	Graph theory
Goatee	Facial hair
Herm	Islands of the Channel Islands
History	Basic English 850 words, History
Health	Health, Basic English 850 words
Harbor	Basic English 850 words, Ports and harbours
Hawaii	Hawaii, 1959 establishments in the United States
Honolulu	Honolulu, State capitals in the United States, 1907 establishments in North America, 1900s establishments in Hawaii, County seats in Hawaii
Hawaii (island)	Islands of Hawaii
Hawaii Ponoi	Culture of Hawaii, National anthems
Healing	Health, Tissues
History of Australia	History of Australia
History of Spain	History of Spain
Height	Physical quantity
Historian	Historians, Occupations
Human body	Anatomy
Hydrogen	Chemical elements, Nonmetals, Hydrogen
Helium	Helium
Home page	Websites
Hair	Basic English 850 words, Hair
Ireland	Ireland, Divided regions
Internet	Internet, Technology
Italy	Italy, European Union member states, Italian-speaking countries, G8 nations, G7 nations
If	Basic English 850 words
Island	Basic English 850 words, Islands
Idiom	Figures of speech
IELTS	English language, Tests
Ink	Basic English 850 words, Writing tools, Art materials
Inch	Units of length, Imperial units
Pint	Imperial units, Units of volume
ISO 19011	Accounting, ISO standards
India	India, Gondwana, 1950 establishments in Asia
Insult	Figures of speech
Immunology	Immunology
Infinity	Numbers, Mathematics
Japan	G7 nations, Japan, Current monarchies, G8 nations
Jargon	Slang, Terminology
Jupiter	Jupiter, Very good articles
King	Kings and queens
Knowledge	Basic English 850 words, Epistemology
Kauai	Islands of Hawaii
Kahoolawe	Islands of Hawaii, Volcanoes of Hawaii
Killing	Crime
Kilometre	Units of length
Language	Language
Leisure	Leisure
Live	VOA Special English words
Life	Life
Law	Law
L. L. Zamenhof	1859 births, 1917 deaths, Bible translators, Esperantists, Inventors, Jewish scientists, Legion of Honour, Linguists, Polish Jews, Polish scientists, Zionists
List of countries	Lists of countries
Provinces and territories of Canada	Provinces and territories of Canada, Canada-related lists
Las Vegas	Las Vegas, Nevada, County seats in Nevada, 1905 establishments in the United States, 20th-century establishments in Nevada
Lanai	Islands of Hawaii
Leap year	Years
Leather	Natural materials
License	Law
Link	Internet
Library	Libraries
List of mathematics topics	Mathematics lists
Like	Basic English 850 words
Political divisions of China	Provinces of China
List of fruits	Fruits, Food-related lists, Lists of plants
Legislature	Legislatures
Linear algebra	Linear algebra
London	London, Olympic cities
Litre	Units of volume
Lime	Citrus
Mathematics	Mathematics
Music	Basic English 850 words, Music, Non-verbal communication
Madrid	Madrid, Capital cities in Spain, 9th century establishments in Europe, Establishments in Spain
Montreal	Montreal, Olympic cities
Macadamia nut	Edible nuts and seeds
Maui	Islands of Hawaii
Molokai	Islands of Hawaii
Money	Basic English 850 words, Money
Multiplication	Arithmetics, Hyperoperations
Microsoft	1975 establishments in the United States, Bill Gates, Microsoft
Islamic world	Islam
Multiverse	Cosmology, Physics, Astrophysics, Universe
Mechanistic paradigm	Physics, Chemistry, Biology
MediaWiki	Wiki software, Wikimedia, Websites established in 2002
First language	Language
Mustache	Facial hair
Mile	Imperial units, Units of length
Margarine	Spreads
Milky Way	Spiral galaxies, Local galaxies, Milky Way
Movement	Mechanics, Physics
Metaphor	Metaphors, Words
Metabolism	Metabolism
Microscope	Microscopes
Mass	Physical quantity, Matter, Mechanics
Mercury (planet)	Solar System planets, Terrestrial planets
Mars	Mars
Mac OS	Operating systems, MacOS
Apple Macintosh	Computers, Apple hardware
Metre	SI units, Units of length
Magnifying glass	Tools, Philately
Molecule	Chemistry
Moral reasoning	ethics, psychology, philosophy
Mosque	Mosques
Mammal	Mammals
Number	Basic English 850 words, Numbers
National anthem	National anthems
Name	Basic English 850 words, Names
Niihau	Islands of Hawaii
Nēnē	Geese
Network	Networks, Computer networking, Relationships
Fishing net	Basic English 850 words, Fishing, Tools
Internet slang	Internet slang
Nauru	Commonwealth member states, Nauru
Noun	Parts of speech
Nature	Nature, Bionics
Natural resource	Natural resources, Economics, Factors of production
Negentropy	Thermodynamics
North America	North America, Laurasia
Neptune	Neptune, Solar System planets
Now	Basic English 850 words
New York City	1620s establishments in the Thirteen Colonies, 1624 establishments, 17th-century establishments in New York, Former capitals of the United States, New York City
Of	Basic English 850 words
1 (number)	Integers, Square numbers
O Canada	Canada, National anthems
Oahu	Islands of Hawaii
Open content	Software, Art, Free content
Orthography	Language
Oil	Basic English 850 words, Oils, Hydrocarbons
OK	Words
Oxymoron	Logic, Figures of speech
Operating system	Operating systems
Philosophy	Philosophy, Humanities
Physics	Physics
Politics	Politics
Value (personal and cultural)	Culture
Profanity	Profanity, Human communication
People's Republic of China	People's Republic of China
Psychoneuroimmunology	Immunology, Psychology
Political party	Political parties
Pet	Pets
Platonic realism	Philosophical movements and positions, Reality
Paradox	Logical paradoxes
Potato	Solanum, Potatoes
Plant	Basic English 850 words, Plants
Prediction	Everyday life
Probability	Probability theory
Probability experiment	Probability theory, Experiments
Protein	Proteins, Molecular biology
Periodic table	Periodic table
Physiology	Physiology
Planet	Planets
Political problems of China	Politics of China
Police	Law, Emergency services, Police
Pi	Geometry, Irrational numbers, Transcendental numbers
Proper noun	Parts of speech
Plastic	Polymers, Polymer chemistry
Product stewardship	Business, Ethics
Peace	Peace, Basic English 850 words, Society
Quebec	Quebec, 1867 establishments in Canada, Provinces and territories of Canada
Reading	Basic English 850 words, Learning
Religion	Religion, Religions, Basic English 850 words
Rudyard Kipling	1865 births, 1936 deaths, British children's writers, British Nobel Prize winners, Disease-related deaths in England, Deaths from ulcers, English poets, People buried in Westminster Abbey, People from Bombay
Recreation	Leisure, Life, Hobbies, Everyday life
Red	Basic English 850 words
Raw food	Food and drink, Health
Roman Empire	Roman Empire
Regime	Forms of government
River	Basic English 850 words, Rivers, Biomes
Right angle	Angles
Reward	Basic English 850 words
Ranch	Farms
Sport utility vehicle	Sport utility vehicles
Substance	Basic English 850 words, Physics
Symbol	Symbols
Sound	Basic English 850 words, Sound
Society	Society
Suggestion	Basic English 850 words
Spache Readability Formula	Language
Sport	Olympic sports, Sports
Science	Basic English 850 words, Science
Saint Lawrence River	Rivers of Canada
Seville	Seville, Capital cities in Spain
Salami	Sausage
Special English	English language
Sausage	Sausage
Slang	Slang
Social contract	Law
Social capital	Social sciences, Economics
Subtraction	Arithmetics
String theory	String theory
Scientist	Scientists, Science occupations
Soapbox	Human communication
Supernatural	Religion
Spirit	Spirituality
Seed	Basic English 850 words, Plant anatomy
Sail	Basic English 850 words, Boats
Skin	Basic English 850 words, Skin
Search engine	Search engines
Sabbath in Christianity	Liturgical calendar
Statistics	Statistics
Speed	Measurement, Physical quantity
Server log	internet, Software, Servers
Server	Internet, Servers, Computer science
Simile	Words, Figures of speech
State	Social sciences, International law, States
Stream	water
Solar System	Solar System
Saturn	Saturn
Slavery	Slavery
Soul	Death customs, Theology
Soap	Care, Chemistry
Summary	Writing
Service economy	Economics
Sense	Basic English 850 words
Synagogue	Synagogues, Judaism
Scarcity	Microeconomics
Readability	Written communication, Linguistics
Theatre	Theater
Test	Basic English 850 words, Tests
Time horizon	Time
Time limit	Time
Taiwan	Taiwan
Trademark	Symbols, Intellectual property law, Business
Ten Commandments	Old Testament
Tree	Basic English 850 words, Trees
Tragedy	Theatrical forms
Taxonomy	Taxonomy
Temple	Temples
Theft	Theft
United Kingdom	United Kingdom, Commonwealth realms, Current monarchies, English-speaking countries, G8 nations, G7 nations
Universe	Universe, Reality
UK	Redirects from acronyms
Unit of measurement	Units of measurement
United States customary units	Measurement
Uranus	Uranus (planet)
University	Colleges and universities
Value	Basic English 850 words, Economics
Volapük	Constructed languages
Vocabulary	Vocabulary
Vegetable oil	Cooking oils
Verb	Grammar
Volume	Physical quantity, Geometry
Venus	Venus (planet), Terrestrial planets
Vatican City	Vatican City, Current monarchies, 1929 establishments in Italy
Velocity	measurement, Velocity
Virtual community	Internet
World Wide Web	Internet
Wiki	Internet slang, Software, Wikis
Website	Websites
Word	Words, Basic English 850 words
Web browser	Web browsers
Webpage	Internet
Wiktionary	Dictionaries, Wikimedia, Wikis, Websites established in 2002
Microsoft Windows	Microsoft operating systems
Window	Basic English 850 words, Windows (architecture)
Wine	Basic English 850 words, Wine
Width	Physical quantity
Water	Natural resources, Hydrogen compounds, Oxygen compounds, Oxides, Water
War	War, Basic English 850 words
Yiddish	Yiddish language
Year	Basic English 850 words, Units of time, Years
You	Basic English 850 words, VOA Special English words
Chinese language	Chinese language, Tonal languages
Zero	Integers
Zoology	Zoology
Zinc	Chemical elements, Transition metals
Zebra	Zebras
Zoo	Zoos
Copyright	Copyright
Republic of China	Taiwan, 1949 establishments in Asia
Prison	Prisons, Basic English 850 words
Mexico	Mexico, Spanish-speaking countries, 1821 establishments in North America
Atlantic Ocean	Atlantic Ocean
Mercury (element)	Metals, Chemical elements
Africa	Africa, Gondwana
Butter	Butter, Basic English 850 words, Dairy products, Spreads, Cooking fats
Cold War	Cold War
Mainland China	China
Capital city	Capital cities
Climate	Climate
Fold (geology)	Geology
Volcanism	Volcanology
Pacific Ocean	Pacific Ocean
Antarctica	Antarctica, Gondwana, Uninhabited regions
South Pole	Geography of Antarctica
Indian Ocean	Indian Ocean
Arctic Ocean	Oceans, Arctic
Inuit	Native American, Arctic
Basket	Basic English 850 words
Software	Software, Computer science
Container	Containers
South America	South America, Gondwana
Bed	Basic English 850 words, Furniture
Asia	Asia
Wall	Basic English 850 words, Walls
Coordinated Universal Time	Time zones
Television	Television
Sociology	Sociology
Sky	Basic English 850 words
Tone language	Tonal languages
Dollar	Currency
Beer	Beer
IP address	Internet
Eurasia	Laurasia
North Pole	Arctic
Plural	Grammar
Alexander Gode	Linguists, Translators, American people, German people, 1906 births, 1970 deaths
Oceania	Oceania
Southern Ocean	Southern Ocean, Geography of Antarctica
Catalan language	Languages of Europe, Romance languages, Catalonia
Corset	Corset, Underwear
Pop music	Pop music
General semantics	Philosophy, Reality
Semiotics	Language, Semiotics
Nitrogen	Nitrogen compounds, Chemical elements, Nonmetals
Association football	Association football, Summer Olympic sports
Spamming	E-mail, Internet communication
Earthquake	Earthquakes, Plate tectonics
Colour	Basic English 850 words, Color, Vision
Scurvy	Diseases
Ion	Chemistry
Cognitive science	Science
Anthropology	Anthropology
Education	Basic English 850 words, Education
Army	Basic English 850 words, Army
Theology	Theology
Work	Basic English 850 words
Romania	Romania, European Union member states, 1859 establishments in Europe
Argon	Noble gases
Trade	Trade
European Union	European Union, 1952 establishments in Europe, G7 nations, G8 nations
Greece	Greece, European Union member states
Sweden	Sweden, European Union member states, Nordic countries, Current monarchies
Albert Einstein	1879 births, 1955 deaths, Albert Einstein, American physicists, Cardiovascular disease deaths in the United States, Deaths from aortic aneurysm, German Nobel Prize winners, German physicists, Jewish academics, Jewish American academics, Jewish American scientists, Jewish German academics, Jewish German scientists, Jewish Nobel Prize winners, Jewish scientists, Naturalized citizens of the United States, Nobel Prize in Physics winners, People from Ulm, Refugees from Nazism, Swiss Jews, Swiss scientists, Theoretical physicists
Euro	Currency of Europe, European Union
Currency	Currency
Radio telescope	Telescopes
Light year	Units of length, Astronomical distances
Korea	Korea, Divided regions, 918 establishments, 1948 disestablishments in Asia, 10th century establishments in Asia
English as a second language	English language
Switzerland	Switzerland, German-speaking countries, French-speaking countries, Italian-speaking countries, Federations
LOL	Internet slang
Toronto	Toronto
Names of numbers in English	Numbers
United States dollar	Currency of the United States
Fluid ounce	Imperial units, Units of volume
Shape of the universe	Geometry, Cosmology
Meteor shower	Meteorites
Cat	Cats
Engineering	Technology, Engineering
Communication	Communication
Miracle	Theology
Kami	Japanese deities, Shinto
Cardboard	Paper
English language	English language
Trier	Cities in Rhineland-Palatinate
Turkey	Turkey, European Union candidate states
Thomm	Villages in Rhineland-Palatinate, Municipalities in Rhineland-Palatinate, Trier-Saarburg
Moselle	Geography of Rhineland-Palatinate, Geography of Saarland, Rivers of France, Rivers of Germany, Rivers of Luxembourg, Grand Est
Bible	Bible
Bavaria	Bavaria
Rome	Rome, Olympic cities, Regional capitals in Italy
Carnivore	Carnivores
Cologne	Cities with more than a million inhabitants, Cities in North Rhine-Westphalia, Cologne, 1st century establishments in Europe, Establishments in Germany, 50 establishments
Senegal	Senegal, French-speaking countries, Least developed countries, Members of the Organisation of Islamic Cooperation
Developmental biology	Developmental biology
1924	1924
1929	1929
1920s	1920s
Outer space	Astrophysics, Space
Natural satellite	Moons
Gravity	Force, Basic physics ideas, Gravitation
Centripetal force	Force, Mechanics
Treaty	Treaties
Luxembourg	Luxembourg, European Union member states, Benelux, Current monarchies, French-speaking countries, German-speaking countries
Baden-Württemberg	Baden-Württemberg, 1952 establishments in Europe, 1950s establishments in Germany
Vienna	Vienna, World Heritage Sites in Austria
1925	1925
Telescope	Telescopes
Homonym	Words
Principal	Occupations
Peru	Peru, Spanish-speaking countries
States of Germany	States of Germany
Munich	Munich, Olympic cities, 1158 establishments, 12th century establishments in Europe, Establishments in Germany
Berlin	Berlin, Olympic cities
1930s	1930s
1940s	1940s
1950s	1950s
Hamburg	Hamburg, Imperial free cities
Emphysema	Diseases, Pulmonology
Oxygen	Nonmetals, Gases
Blood	Basic English 850 words, Biochemistry, Cardiovascular system, Blood
1960s	1960s
1970s	1970s
1980s	1980s
1990s	1990s
North Rhine-Westphalia	North Rhine-Westphalia
Computer program	Software, Technology
Data	Knowledge
2000s (decade)	2000s
Stuttgart	Stuttgart
Schwerin	States of the Holy Roman Empire, Urban districts of Mecklenburg-Vorpommern, German state capitals
Canton of Schwyz	1291 establishments, Establishments in Switzerland, Canton of Schwyz, 1290s establishments in Europe
Russia	Russia, G8 nations, Federations, 1991 establishments, 1990s establishments in Asia, 1990s establishments in Europe
Moscow	Moscow, Capital cities in Russia, Olympic cities, 1140s establishments, Round cities
Canton of St. Gallen	Canton of St. Gallen, 1803 establishments, 19th century establishments in Switzerland, 1800s establishments in Europe
Saarland	Saarland
1974	1974
Iceland	Iceland, European Union candidate states, Nordic countries, 1944 establishments in Europe
1965	1965
1969	1969
Saarbrücken	Saarbrücken (district), States of the Holy Roman Empire, German state capitals
Saarlouis	Saarlouis (district)
Brandenburg	Brandenburg
Russian language	Russian language, Languages of Russia, Languages of Azerbaijan
1978	1978
1982	1982
Professor	Education occupations
Slope	Basic English 850 words
California	California, 1850 establishments in the United States
Propaganda	Politics, Communication, Psychology
Topology	Mathematics, Geometry
1933	1933
Los Angeles	Los Angeles, County seats in California, Olympic cities, 1781 establishments in North America, 18th-century establishments in California
Census	Social sciences, Animals, Demography
Star	Stars, Astrophysics
List of U.S. states	States of the United States, Lists about U.S. states
Drunk driving	Types of crime
Creative Commons	Non-profit organizations of California, 2001 establishments in California, Companies based in San Francisco
HTML	Markup languages, Internet, Web design
Leg	Basic English 850 words, Limbs and extremities
Economic sector	Economics
Yellow	Basic English 850 words
Plymouth Argyle F.C.	English football clubs, Plymouth, Devon, 1886 establishments in England
Football	Football
Poland	Poland, European Union member states, 1989 establishments in Europe
England	England
Wales	Wales
Scotland	Scotland
Northern Ireland	Northern Ireland
Great Britain	Great Britain
List of English football teams	English football clubs, Lists of football teams, Lists about England
Scottish Football League	Football clubs
List of French football teams	French football clubs, Lists of football teams
1967	1967
List of German football teams	German football clubs, Lists of football teams
List of Italian football teams	Italian football clubs, Lists of football teams, Italy-related lists
List of Spanish football teams	Spanish football clubs, Lists of football teams
Welsh League	Welsh football clubs, Lists of football teams
Arsenal F.C.	Arsenal F.C., Premier League clubs, 1886 establishments in England
Aston Villa F.C.	Premier League clubs, 1874 establishments in England
Birmingham City F.C.	English football clubs, Birmingham, 1875 establishments in England
Blackburn Rovers F.C.	English football clubs, 1875 establishments in England
Bolton Wanderers F.C.	Premier League clubs, 1874 establishments in England
Charlton Athletic F.C.	English football clubs, 1905 establishments in England
Chelsea F.C.	1905 establishments in England, Premier League clubs, Football clubs in London
Everton F.C.	Premier League clubs, Liverpool, Merseyside, 1878 establishments in England
Fulham F.C.	Premier League clubs, 1879 establishments in England
Liverpool F.C.	Premier League clubs, Liverpool, Merseyside, 1892 establishments in England
Manchester City F.C.	1880 establishments in the United Kingdom, Premier League clubs, Sport in Manchester
Manchester United F.C.	1878 establishments in England, Premier League clubs, Sport in Manchester
Middlesbrough F.C.	1876 establishments in England, English football clubs, Middlesbrough
Newcastle United F.C.	Premier League clubs, Newcastle upon Tyne, 1892 establishments in England
Portsmouth F.C.	English football clubs, Portsmouth, 1898 establishments in England
Tottenham Hotspur F.C.	1882 establishments in England, Premier League clubs, Sport in London, Tottenham
Derby County F.C.	English football clubs, 1884 establishments in England
Ipswich Town F.C.	English football clubs, Ipswich, 1878 establishments in England
Sunderland A.F.C.	Premier League clubs, Sunderland
West Bromwich Albion F.C.	Premier League clubs, 1878 establishments in England
West Ham United F.C.	1895 establishments in England, Football clubs in London
Wigan Athletic F.C.	1932 establishments in the United Kingdom, 1930s establishments in England, English football clubs, Wigan
Wimbledon F.C.	English football clubs, 1889 establishments in England
Accrington Stanley F.C.	English football clubs, 1921 establishments in Europe, 1962 disestablishments, 1968 establishments in England, 1920s establishments in England, 1960s disestablishments in England
Telford United F.C.	English football clubs
A.F.C. Wimbledon	English football clubs, 2002 establishments in England
Sheffield F.C.	English football clubs, Sheffield, 1857 establishments in Europe, 1850s establishments in the United Kingdom
Asteroid belt	Asteroids
Essen	Imperial free cities, World Heritage Sites in Germany, Urban districts in Regierungsbezirk Düsseldorf, Essen
Gardening	Gardening
Democracy	Democracy
Nebraska	Nebraska, 1867 establishments in the United States
Time	Basic English 850 words, Philosophy, Time
Force	Force
Laboratory techniques	Chemistry
International System of Units	SI units, Systems
Lake Michigan	Great Lakes, Lakes of the United States
Gas syringe	Laboratory equipment, Measuring tools
Mixture	Chemistry
Language family	Languages, Language-related lists
Chess	Chess
Gold	Basic English 850 words, Gold
Century	Units of time
Kilogram	SI units, Units of mass
Second	Units of time, Basic English 850 words, SI units
Basque Country (greater region)	Geography of France, Geography of Spain
M-theory	String theory
Jaguar Cars	British automobile companies
Scientific method	Philosophy of science, Experiments
Gas	Gases
Family	Human behavior, Social groups
Wave (physics)	Wave physics
Weapon	Weapons
Christmas cake	Cakes, Christmas
Christmas cracker	Christmas
Fingerplate	Architectural elements
Floodlight	Theater, Light sources
Headrest	Auto parts
Inkpad	Technology, Writing tools
Jack-in-the-box	Toys
London boroughs	London boroughs
City of London	Ceremonial counties of England, City of London
City of Westminster	City of Westminster
London Borough of Lambeth	London Borough of Lambeth
London Borough of Southwark	London Borough of Southwark
London Borough of Camden	London Borough of Camden
London Borough of Merton	London Borough of Merton
Brixton	Areas of London
Bankside	London Borough of Southwark
River Thames	River Thames
Queen	Kings and queens
Female	Basic English 850 words, Humans, Animals, Biological reproduction
Camden	Areas of London
Royal Borough of Greenwich	London Borough of Greenwich
London Borough of Wandsworth	London Borough of Wandsworth
London Borough of Islington	London Borough of Islington
Bambuco	Folk music, Colombian culture
Christmas	Christmas
Adjective	Parts of speech
Paper	Basic English 850 words, Paper, Writing tools
Power	Basic English 850 words
States of matter	States of matter
Perimeter	Geometry
Nation	Basic English 850 words, Countries, Ethnicity, Nationalism
Metal	Metals
Indonesia	1949 establishments in Asia, Indonesia, States and territories established in the 20th century, Members of the Organisation of Islamic Cooperation
Property	Basic English 850 words, Property
NEWI Cefn Druids F.C.	Welsh football clubs
Aberystwyth Town F.C.	Welsh football clubs, 1884 establishments in the United Kingdom, 1880s establishments in Wales
German language	German language
Mississippi River	Rivers of Minnesota, Rivers of Arkansas, Rivers of Illinois, Rivers of Iowa, Rivers of Kentucky, Rivers of Louisiana, Rivers of Mississippi, Rivers of Missouri, Rivers of Tennessee, Rivers of Wisconsin
Tributary	Rivers
Missouri River	Rivers of Montana, Rivers of Missouri, Rivers of Iowa, Rivers of Kansas, Rivers of Nebraska, Rivers of South Dakota, Rivers of North Dakota
Meaning of life	Religion, Philosophy
Drainage basin	Drainage basins
Great Plains	Plains, Regions of Canada, Regions of the United States
Mythology	Mythology
Minnesota River	Rivers of Minnesota
List of mythologies	Mythology
Wisconsin River	Rivers of Wisconsin
Alaska	Alaska, 1959 establishments in the United States
BBC	1922 establishments in the United Kingdom, BBC
Illinois River	Rivers of Illinois
Milk	Basic English 850 words, Milk, Symbols of Oklahoma
Weather	Weather, Natural events, Basic English 850 words
British Columbia	British Columbia, 1871 establishments, 1870s establishments in Canada, Provinces and territories of Canada
20th century	20th century
Brussels	Brussels
Thuringia	Thuringia
Saxony	Saxony, 1990 establishments in Germany
Internet Explorer	Web browsers
Ulster	Ulster
List of mathematicians	French mathematicians, German mathematicians, Russian mathematicians, Mathematicians, Lists of scientists
Mancala	Board games
Coden, Alabama	Villages in the United States, Unincorporated communities in Alabama
Platypus	Monotremes, Living fossils
Kenya	Kenya, 1963 establishments in Africa
Swahili language	Niger-Congo languages
Long jump	Events in athletics
Elizabeth II	1926 births, Living people, Current national leaders, English Anglicans, House of Windsor, Kings and Queens of the United Kingdom, Order of Merit of the Federal Republic of Germany, Recipients of the Decoration for Services to the Republic of Austria, Recipients of the Nishan-e-Pakistan, Recipients of the Order of the Aztec Eagle, Royalty from London, Time People of the Year, Elizabeth II
Question	Basic English 850 words, Linguistics
Gun	Basic English 850 words, Firearms
Hobby	Hobbies
World Trade Center (1973–2001)	1973 establishments in New York (state), 2001 disestablishments in the United States, Buildings and structures in Manhattan, September 11 attacks, World Trade Organization
Hour	Basic English 850 words, Units of time
Minute	Basic English 850 words, Units of time, Geometry
Coat	Basic English 850 words, Clothing
Study skills	Learning
Head	Basic English 850 words, Head (body part)
Norway	Norway, Nordic countries, Current monarchies, 1945 establishments in Europe
Albania	Albania, European Union candidate states, Members of the Organisation of Islamic Cooperation
Hungary	Hungary, European Union member states
Netherlands	Netherlands, European Union member states, Benelux, Current monarchies, Dutch-speaking countries
Ukraine	Ukraine, 1991 establishments in Europe
Liechtenstein	Liechtenstein, Current monarchies, German-speaking countries, 1866 establishments in Europe
Portugal	Portugal, Portuguese-speaking countries, European Union member states, 1974 establishments in Europe
Slovakia	1993 establishments in Europe, European Union member states, Landlocked countries, Slovakia, States and territories established in the 1990s
Slovenia	Slovenia, European Union member states
Oldham Cricket Club	Cricket clubs, Oldham, Greater Manchester
Denarius	Former currencies, Former currencies of Europe, Ancient Rome, 3rd-century BC establishments, 3rd-century disestablishments
Jackknife	Blades
Luffa	Tropical fruit, Cucurbitaceae
Kimono	Japanese clothing
Sconce	Construction
Culture	Culture
Houseplant	Plants
Waxed paper	Kitchenware
Japanese tea ceremony	Japanese culture, Tea
Sideboard	Furniture
Movie	Movies
Holland	Geography of the Netherlands, History of the Netherlands
Isotope	Isotopes, Nuclear physics
Crushing by elephant	Asia, Capital punishment
Power network	Social sciences
Citizenship	Politics, Nationality
Elephant	Elephants, Animals used for transport
Buddhism	Buddhism
Governor General	Governors-general, Government occupations
Black hole	Black holes, Galaxies, Good articles
Sheffield	Sheffield, Metropolitan boroughs
Fertilizer	Agriculture
Military	Military
Photosynthesis	Cell biology, Cellular respiration, Metabolism, Photosynthesis
Casserole	Baked foods
Plate	Basic English 850 words, Kitchenware
Flea	Insects
Terrorism	Terrorism, Political philosophy
South Africa	English-speaking countries, South Africa, States and territories established in the 20th century, 1910 establishments, 1910s establishments in Africa
Andorra	Andorra, Current monarchies
Hiroshima	Hiroshima, World Heritage Sites in Japan
Richter scale	Earthquakes
Day	Units of time, Basic English 850 words
Phases of the Moon	Moon
Sphere	Three-dimensional shapes
Quantity	Numbers
Advertising	Advertising
Buddha	Buddhas, Buddhist terminology
Flag of the United States	Flags of the United States, National flags, Symbols of the United States
Mahatma Gandhi	Gandhian Era, 1869 births, 1948 deaths, Assassinated people, Hindus, Indian murder victims, Indian politicians, Indian revolutionaries, Nonviolence advocates, People murdered in India, National symbols of India, Vegetarians, Time People of the Year
Schizophrenia	Mental illnesses, Psychosis
Drink	Basic English 850 words, Drinks, Physiology
Need	Philosophy, Psychology
Freeware	Software
Yahoo!	Websites
Mecca	Mecca
Arabian Peninsula	Peninsulas, Arabia, Gondwana
South	Basic English 850 words, Compass directions
Central America	Central America
French language	French language, French culture
Prime minister	Prime ministers, Government occupations
Greenland	Greenland, Arctic islands
Soviet Union	Soviet Union, Former socialist republics, 1922 establishments, 1991 disestablishments, States and territories disestablished in the 1990s
Monarch	Kings and queens
Unit	Basic English 850 words
Uncle	Family
Information	Theoretical computer science
Airport	Airports
Ice	Basic English 850 words, Chemical compounds, Water
Travel	Travel
CNN	CNN
Leader	Politics
Blackboard	Blackboards, Learning, Writing media
Linux	Linux, Free software
Open source	Software, Free content
Desktop environment	Software, Desktop Environments
OpenOffice	Office suites, OpenOffice
Download	Computer networking, Internet, Technology, Computer science
GNOME	GNOME, Linux, Desktop Environments
Dog	Dogs
Blindness	Disability
Arctic	Arctic
Sin	Religious terminology, Religious ethics
Summer	Seasons
Month	Basic English 850 words, Units of time, Months
Alberta	Alberta, 1905 establishments in North America, 1900s establishments in Canada, Provinces and territories of Canada
Electronics	Electronics
Scalar	Measurement, Basic physics ideas
Photon	Basic physics ideas, Electromagnetism, Light, Elementary particles
Vector	Vectors, Basic physics ideas
Soap bubble	Water
Fire Brigades Union	Organisations based in London, Unions, Firefighting
Bicycle	Human-powered vehicles, Cycling
Wheel	Basic English 850 words, Tools
Physical exercise	Fitness
Percentage	Mathematics
Writing	Basic English 850 words, Writing, History of technology
Plato	427 BC births, 348 BC deaths, Ancient Greek philosophers, Slavers
Book	Basic English 850 words, Books, History of printing
Sundial	Clocks
Peninsula	Peninsulas
Combinatorial game theory	Game theory
Nim	Game theory
Memory	Basic English 850 words, Human skills, Memory
Murder	Types of crime, Murders, Terrorist attacks, Crime
Bird	Basic English 850 words, Birds
Freedom of speech	Human rights, Freedom, Libertarianism
Banana	Fruits, Musaceae
Biel/Bienne, Switzerland	Biel/Bienne, Switzerland
Swatch Internet Time	time
Test tube	Laboratory equipment
Beaker	Laboratory equipment, Containers, Measuring tools
Crucible	Laboratory equipment
Lithium	Alkali metals
Beryllium	Chemical elements, Alkaline earth metals
Data compression	Data structures
Compiler	Software, Computer programming
Eye	Basic English 850 words, Eye
Tongue-twister	Linguistics
AbiWord	Free software, Word processors, GNOME
Insect	Basic English 850 words, Insects
List of operating systems	Operating systems, Computer-related lists
Computer jargon	Computers
Million	Integers
1000 (number)	Integers
Gross domestic product	Gross domestic product, Economic indicators
Cricket	Cricket
Track and field athletics	Athletics
Badminton	Pune, Badminton
Chemical warfare	Chemical warfare
Iran	Iran, Members of the Organisation of Islamic Cooperation, 1979 establishments in Asia
Gautama Buddha	Eastern philosophers, Buddhist clergy, Mystics, Deaths from food poisoning, 6th century BC births, 5th century BC deaths
North	Basic English 850 words, Compass directions
List of Portuguese football teams	Portuguese football clubs, Lists of football teams
Epiphany (software)	Mozilla, Web browsers, GNOME
Video game console	Video game consoles
PlayStation	PlayStation
Election	Elections, Voting systems
Medicine	Medicine
Transport	Basic English 850 words, Transport
Road	Basic English 850 words, Roads
2004	2004
Hawaiian Islands	Islands of Hawaii
Mauna Kea	Volcanoes of Hawaii
Mauna Loa	Volcanoes of Hawaii
Kilauea	Volcanoes of Hawaii
Van	Vans
Luggage	Travel
Pantograph	tools
Paperback	Book terminology
Palette	Painting
Glow-worm	Beetles, Flies
Palette knife	Cutting tools
Foolscap	Paper
Polymer	Polymers
Phrase	Grammar
Preposition	Parts of speech
Pronoun	Pronouns, Parts of speech
Adverb	Parts of speech
Sunday	Days of the week
Ottawa	Ottawa, 1826 establishments in North America, 1820s establishments in Canada
News agency	Companies, News media, Journalism
Mudguard	Auto parts
Para rubber tree	Euphorbiaceae
Safety curtain	Theater, Opera terminology
Safety lamp	Safety
Christmas stocking	Christmas
List of Austrian football teams	Lists of football teams, Football in Austria, Austria-related lists
2001	2001
Sex	Sexuality, Biological reproduction
Hacksaw	Cutting tools
Spade	Basic English 850 words, Gardening tools
Hoe (tool)	Gardening tools
Shovel	Gardening tools, Tools
Plunger	Tools
Ladder	Tools, Construction
Oral history	History
Generation	Family, Time
Gene	Cell biology, DNA, Classical genetics
Alliteration	Figures of speech
Homophone	Language
Precipitation	Meteorology, Words
Relative humidity	Weather measurements, Meteorology
Vitamin C	Vitamins
Dichlorphenolindophenol	Chemical compounds
Healthy diet	Nutrition, Healthy lifestyle
Dye	Color, Cloth, Chemical compounds
Poetry	Poetry
Literature	Literature
Imagination	Everyday life, Psychology
Calorimeter	Laboratory equipment, Measuring tools
Bolus	Physiology, Medicine
Oesophagus	Anatomy of the digestive system
Protease	Enzymes
Dental floss	Hygiene, Teeth
Rickets	Diseases, Diseases and disorders of bones
Bile	Physiology
Dental pulp	Teeth
Protoplasm	Cells
Amylase	Enzymes, Evolution
Variegated leaf	Plant anatomy, Experiments
Seam ripper	Cutting tools, Needlework
Pin cushion	Tools
Chemical cell	Physical chemistry, Energy, Batteries
Das Lied der Deutschen	Germany, National anthems, Mottos
Evidence	Law, Criminal investigation
Hill	Hills
Enzyme	Biochemistry, Molecular biology, Enzymes
Mountain	Basic English 850 words, Mountains
Machine code	Computer science
Area	Geometry
Air space	Aviation, Geography
Swamp cooler	Home appliances
Saskatoon	Saskatoon
Glass rod	laboratory equipment
Thermometer	Laboratory equipment, Measuring tools, Temperature, Weather instruments, Thermometers
Week	Units of time, Basic English 850 words
Suffix	Grammar
Japanese language	Japanese language
Spice	Spices
Flavor	Food and drink, Characteristics
Bank	Banks
Halley's Comet	Comets
Hubble Space Telescope	Space telescopes
Motion sensor	Machines, Sensors
Arm	Limbs and extremities, Basic English 850 words
Arrow	Archery, Weapons
Golf	Golf
Spirituality	Religion, Spirituality
2002	2002
2003	2003
1999	1999
1998	1998
1997	1997
1996	1996
1995	1995
1994	1994
1993	1993
1992	1992
1991	1991
2005	2005
2006	2006
2007	2007
1989	1989
Common year	Years
Decade	Units of time
19th century	19th century
21st century	21st century
Ijtihad	Islam
Standard temperature and pressure	Measurement, Engineering, Chemistry, Standards, Thermodynamics
Jungle	Forests, Biomes
Light	Light
Stockholm	Stockholm, Olympic cities, 13th century establishments in Europe, Establishments in Sweden
Rain	Basic English 850 words, Precipitation
2009	2009
Gambling	Gambling
Monty Python	Monty Python
Time zone	Time zones
Market	Basic English 850 words, Retail markets
Electron	Basic physics ideas, Elementary particles
Chile	Chile, Spanish-speaking countries
Ambassador	Government occupations, Ambassadors
Monday	Days of the week
Nuclear war	War, Nuclear weapons
Tax	Basic English 850 words, Taxation
Florida	Florida, 1845 establishments in the United States
Mario	Fictional characters introduced in 1981, Fictional Italian people, Mario, Mascots, American culture
Video game	Video games
Oboe	Double reed instruments
GURPS	Role-playing games
Eric Idle	1943 births, Living people, Actors from County Durham, Alumni of the University of Cambridge, English comedians, English movie actors, English television actors, English voice actors, Grammy Award winners, Monty Python, Naturalized citizens of the United States
Enemy	War
2000	2000
Adelaide	1836 establishments, Adelaide, 1830s establishments in Australia
Yoshi	Fictional animals, Fictional characters introduced in 1990, Mario series characters, Fictional dinosaurs
Lake	Lakes, Biomes
East	Basic English 850 words, Compass directions
Tire	Auto parts, Polymers
Population	Social sciences
Snow	Basic English 850 words, Snow
West	Basic English 850 words, Compass directions
List of physics topics	Physics, Science-related lists
President	Presidents, Titles
List of colors	Color, Lists
List of lakes	Lists of lakes
Galileo Galilei	1564 births, 1642 deaths, Italian astronomers, People from Pisa, Italian physicists
Agreement	Basic English 850 words
Promise	Ethics, Law
Cloud	Basic English 850 words, Clouds
Water cycle	Water, Weather, Earth sciences
Water vapor	Thermodynamics, Water
Solid	Basic English 850 words, States of matter
Evaporation	Materials science, Gases
Contract	Law, Documents
Face	Basic English 850 words, Face
Kolkata	Former national capitals, Kolkata
Pencil	Writing tools
Logic	Logic
Communism	Communism
Resurrection	Theology, Afterlife
Monarchy	Monarchy
North Korea	North Korea, 1945 establishments in Asia
Parliament	Parliaments
Turing test	Artificial intelligence
Fuel	Fuel
List of volcanoes	Lists of volcanoes
Estonia	Estonia, European Union member states, 1991 establishments in Europe
Republic of Cyprus	European Union member states, Republic of Cyprus
Latvia	Latvia, European Union member states, 1991 establishments in Europe
Lithuania	Lithuania, European Union member states
Malta	Malta, Italian-speaking countries, European Union member states, Phoenician colonies, 1974 establishments in Europe
List of Soviet Union-related topics	Soviet Union, Geography-related lists
Comoving distance	Cosmology
Shaanxi	Shaanxi, Provinces of China
Lisbon	Phoenician colonies, Lisbon, 719 establishments, Establishments in Portugal
Surfing	Surfing
Lyon	Departmental capitals in France, Lyon, Regional capitals in France, World Heritage Sites in France
George W. Bush	1946 births, Living people, George W. Bush, 2000 United States presidential candidates, 2004 United States presidential candidates, 20th-century American politicians, 21st-century American politicians, American aviators, American conservatives, American Methodists, Bush family, Businesspeople from New Haven, Connecticut, Businesspeople from Texas, Children of Presidents of the United States, George H. W. Bush, Governors of Texas, People from Midland, Texas, Politicians from New Haven, Connecticut, Ranchers, Recipients of the Order pro merito Melitensi, Time People of the Year, US Republican Party politicians, Writers from New Haven, Connecticut, Writers from Texas, Yale University alumni
Organic compound	Organic compounds
Coal	Basic English 850 words, Fossil fuels, Sedimentary rocks, Environmental issues, Hydrocarbons
Petroleum	Hydrocarbons, Fossil fuels
Natural gas	Fossil fuels, Hydrocarbons
Energy	Energy
Jewel	Basic English 850 words, Gemstones
Xenon	Noble gases
Kuala Lumpur	Kuala Lumpur, Capital cities in Malaysia
Speed of light	Light, Astrophysics, Relativity
Denial	Psychology
Tokyo	Tokyo, Olympic cities
Laozi	Eastern philosophers, Spiritual teachers, Taoism
List of physicists	Physicists, Lists of scientists
Brass	Alloys, Basic English 850 words
Body	Body parts, Basic English 850 words
Alloy	Alloys, Metallurgy
Material	Materials
Brain	Basic English 850 words, Anatomy of the brain
Neuron	Anatomy of the nervous system, Cells
Middle East	Middle East
Warsaw	Warsaw
Hindu–Arabic numeral system	Mathematics, Numerals
Point (geometry)	Geometry
Line	Basic English 850 words, Geometry
Plane (mathematics)	Shapes, Geometry
Angle	Angles, Geometry, Mathematics, Basic English 850 words
List of astronomers	Astronomers, Lists of scientists, Astronomy lists

