Institution of Structural Engineers	Organisations based in London
Bahrain International Circuit	Formula One circuits, Sport in Bahrain, Buildings and structures in Bahrain, 2004 establishments in Asia
Phase 10	Card games
Muharraq Governorate	Governorates of Bahrain
1997 Qayen earthquake	1997 in Asia, Earthquakes in the 1990s, 20th century in Iran, Earthquakes in Asia
Wind turbine	Electricity distribution
Wet-tail	Rodents, Animal diseases
Luxury box	Sports buildings
Contactless smart card	Electronics
Pericles' Funeral Oration	Ancient Greece
Gorgoneion	Ancient Greece, Anthropology, Superstitions
Ryosuke Nakajima	1988 births, Living people, Footballers from Gifu Prefecture
Antônio Marcos da Silva Filho	1977 births, Living people, Brazilian footballers, People from Recife
Phil Younghusband	1987 births, Living people, Filipino sportspeople, Asian footballers
Carlo Zotti	1982 births, Living people, Italian association football goalkeepers
Alex Song	1987 births, Living people, Cameroonian footballers
Katsumi Yusa	1988 births, Living people, Footballers from Fukushima Prefecture
Ricardo Faty	1986 births, Living people, French footballers
Masayuki Miura	1966 births, Living people, Footballers from Hokkaidō Prefecture
Yasuyuki Akaike	1974 births, Living people, Footballers from Shizuoka Prefecture
Mariano González	1981 births, Living people, Argentine footballers
Evaldo Silva dos Santos	1983 births, Living people, Brazilian footballers
Atsushi Inoue	1977 births, Living people, Footballers from Saitama Prefecture
Alberto Luis de Souza	1975 births, Living people, Brazilian footballers, Mato Grosso do Sul
Georgios Samaras	1985 births, Living people, Greek footballers
Gustave Courbet	1819 births, 1877 deaths, Deaths from liver disease, French painters
Paul Le Guen	1964 births, Living people, French footballers, French football managers
Kohei Matsushita	1985 births, Living people, Footballers from Ishikawa Prefecture
Hideo Tanaka	1983 births, Living people, Footballers from Kumamoto Prefecture
Oswaldo de Oliveira	1950 births, Living people, Footballers from Rio de Janeiro
Yasuki Ishidate	1984 births, Living people, Footballers from Aichi Prefecture
Benoît Assou-Ekotto	1984 births, Living people, Cameroonian footballers
Yuki Tazawa	1979 births, Living people, Footballers from Hokkaidō Prefecture
Ibrahima Bakayoko	1976 births, Living people, Ivorian footballers
Kazunori Hiraoka	1965 births, Living people, Footballers from Kumamoto Prefecture, Japanese football managers
Tadashige Teranishi	1926 births, 1999 deaths, Footballers from Hiroshima Prefecture
Tomotaka Fukagawa	1972 births, Living people, Footballers from Hokkaidō Prefecture
Akihiro Tabata	1978 births, Living people, Footballers from Saitama Prefecture
Mark Delaney	1976 births, Living people, Welsh footballers
Ricardo Vaz Tê	1986 births, Living people, Portuguese footballers, Sportspeople from Lisbon
Naoki Kurimoto	1950 births, Living people, Footballers from Mie Prefecture
Alexandre da Silva Gabriel	1987 births, Living people, Footballers from Rio de Janeiro
Craig Beattie	1984 births, Living people, Scottish footballers, Crystal Palace F.C. players
Masayuki Nomura	1966 births, Living people, Footballers from Tokyo Prefecture, Japanese football managers
Minoru Takenaka	1976 births, Living people, Footballers from Hiroshima Prefecture
Amauri	1980 births, Living people, Brazilian footballers, Italian footballers
Masaki Yanagawa	1987 births, Living people, Footballers from Hyōgo Prefecture
Yoshihiro Uchimura	1984 births, Living people, Footballers from Hyōgo Prefecture
Yusuke Murayama	1981 births, Living people, Footballers from Shizuoka Prefecture
Naoya Tamura	1984 births, Living people, Footballers from Tokyo Prefecture
Tomonobu Hayakawa	1977 births, Living people, Footballers from Shizuoka Prefecture
Takanori Nakajima	1984 births, Living people, Footballers from Chiba Prefecture, Avispa Fukuoka players
Shu Abe	1984 births, Living people, Footballers from Osaka Prefecture, Avispa Fukuoka players
Takanobu Komiyama	1984 births, Living people, Footballers from Chiba Prefecture
Dispute	War, Communication, Conflicts, Sociology, Human issues
Seating capacity	Stadiums, Vehicles
Apotropaic magic	Superstitions, Magic (paranormal), Folklore
Possession Island, Queensland	Queensland, English explorers
Commelinaceae	Commelinaceae
Martin Gardner	1914 births, 2010 deaths, American mathematicians, American magicians, Writers from Tulsa, Oklahoma, Scientists from Tulsa, Oklahoma, Skeptics
Holes	1998 books, English-language novels, 20th century American novels, Children's books, Newbery Medal winning books, Texas in fiction, Young adult novels
Nuclear fuel	Nuclear energy
Manicure	Body art, Cosmetics
Dietitian	Nutrition, Healthcare occupations
Mycology	Fungi
Andoni Iraola	1982 births, Living people, Spanish footballers
Takeshi Saito	1982 births, Living people, Footballers from Hokkaidō Prefecture
Doniéber Alexander Marangon	1979 births, Living people, Brazilian association football goalkeepers
Luciano Spalletti	1959 births, Living people, Italian footballers
Yoichi Kamimaru	1984 births, Living people, Footballers from Aichi Prefecture
Ryosuke Sasagaki	1985 births, Living people, Footballers from Shizuoka Prefecture
Kengo Kawamata	1989 births, Living people, Footballers from Ehime Prefecture, Japan international footballers, J1 League players, J2 League players, Ehime FC players, Albirex Niigata players, Fagiano Okayama players, Nagoya Grampus players, Júbilo Iwata players, JEF United Chiba players
Tiko	1976 births, Living people, Spanish footballers, People from Pamplona
Daniel Aranzubia	1979 births, Living people, Spanish footballers
Daichi Matsuyama	1974 births, Living people, Footballers from Hokkaidō Prefecture
Tatsuya Asanuma	1970 births, Living people, Footballers from Saitama Prefecture
Ippei Saga	1980 births, Living people, Footballers from Hokkaidō Prefecture
Ryuhei Niwa	1986 births, Living people, Footballers from Kanagawa Prefecture
Kim Nam-il	1977 births, Living people, South Korean footballers, People from Incheon
Srečko Katanec	1963 births, Living people, Slovenian footballers, Slovenian football managers, Sportspeople from Ljubljana
Takahiro Kuniyoshi	1988 births, Living people, Footballers from Saitama Prefecture
Kim Dong-jin	1982 births, Living people, South Korean footballers
Keisuke Shimizu	1988 births, Living people, Footballers from Hyōgo Prefecture
Tatsuya Ikeda	1988 births, Living people, Footballers from Hyōgo Prefecture
Kyohei Sugiura	1989 births, Living people, Footballers from Shizuoka Prefecture
Takafumi Mikuriya	1984 births, Living people, Footballers from Nagasaki Prefecture
Webster-Hayne debate	1830 in the United States
Point Hicks	Geography of Victoria, Australia
Hobo Spider	Spiders
Fethullah Gülen	1941 births, Living people, Creationists, Turkish educators, Islamic religious leaders, Turkish writers
Thrace	Ancient history, Places of Ancient Rome, History of Europe, Regions of Europe
David Draiman	Living people, 1973 births, American Jews
Al Jackson, Jr.	African American musicians, American jazz musicians, American soul musicians, American murder victims, American drummers, Deaths by firearm, American funk musicians, Musicians from Memphis, Tennessee, 1935 births, 1975 deaths
Tatsuyuki Tomiyama	1982 births, Living people, Footballers from Chiba Prefecture
Takatoshi Matsumoto	1983 births, Living people, Footballers from Tokyo Prefecture
Junya Kuno	1988 births, Living people, Footballers from Shizuoka Prefecture
Zesh Rehman	1983 births, Living people, Pakistani people, Asian footballers
Hiroshi Ichihara	1987 births, Living people, Footballers from Kumamoto Prefecture
Kazuhiro Kawata	1982 births, Living people, Footballers from Fukuoka Prefecture
Abdoulaye Méïté	1980 births, Living people, Ivorian footballers, Sportspeople from Paris
Istanbul Park	Formula One circuits, Istanbul
Raphael Botti	1981 births, Living people, Brazilian footballers
David Jarolím	1979 births, Living people, Czech footballers
Tomoki Ikemoto	1985 births, Living people, Footballers from Fukuoka Prefecture
Noriyuki Sakemoto	1984 births, Living people, Footballers from Wakayama Prefecture
Shogo Tokihisa	1984 births, Living people, Footballers from Fukuoka Prefecture
Kota Fujimoto	1986 births, Living people, Footballers from Kumamoto Prefecture
Masaru Matsuhashi	1985 births, Living people, Footballers from Nagasaki Prefecture
Mu Kanazaki	1989 births, Living people, Footballers from Mie Prefecture, Japan international footballers, J1 League players, Oita Trinita players, Nagoya Grampus players, Kashima Antlers players, Sagan Tosu players
Human penis size	Male reproductive system, Human sexuality
Shun Nagasawa	1988 births, Living people, Footballers from Shizuoka Prefecture
Scantron	Companies based in California, Data input
Kara (South Korean group)	K-pop music groups, South Korean girl groups, 2007 establishments in South Korea
Jerry West	1938 births, Living people, American basketball players, Los Angeles Lakers players, Sportspeople from West Virginia, National Basketball Association players with retired numbers
Noida	Cities and towns in Uttar Pradesh
Akira Kajiwara	1987 births, Living people, Footballers from Oita Prefecture
Carlos Diogo	1983 births, Living people, Uruguayan footballers, Sportspeople from Montevideo
Taku Ishihara	1988 births, Living people, Footballers from Aichi Prefecture
Fumiya Yamamoto	1988 births, Living people, Footballers from Osaka Prefecture, People from Osaka
GMA Network	Philippine television networks, Quezon City, 1950s establishments in Asia
Ken Yorii	1984 births, Living people, Footballers from Hiroshima Prefecture
Tsubasa Oshima	1983 births, Living people, Footballers from Saitama Prefecture
Gai Assulin	1991 births, Living people, Israeli footballers, Jewish Israeli sportspeople
Serginho Baiano	1978 births, Living people, Brazilian footballers, People from Salvador, Bahia
Iñaki Lafuente	1976 births, Living people, Spanish association football goalkeepers
Claudio Biaggio	1967 births, Living people, Argentine footballers
Shota Kimura	1988 births, Living people, Footballers from Tokyo Prefecture
Martín Vilallonga	1970 births, Living people, Argentine footballers
Eisei Tomioka	1984 births, Living people, Footballers from Aichi Prefecture
Eduardo Bustos Montoya	1976 births, Living people, Argentine footballers
Daishiro Miyazaki	1983 births, Living people, Footballers from Kumamoto Prefecture
Patrick Müller	1976 births, Living people, Swiss footballers, People from Geneva
Ulrich Ramé	1972 births, Living people, French footballers, Association football goalkeepers, People from Nantes
David Jemmali	1974 births, Living people, Tunisian footballers, People from Tunis
Chickpea	Beans, Fabaceae
Philippe Christanval	1978 births, Living people, French footballers, Sportspeople from Paris
Hexameter	Poetry
Viktor Orbán	1963 births, Living people, Prime Ministers of Hungary, Current national leaders
Vetus Latina	Latin language, Bible versions
J. C. Bailey	1983 births, 2010 deaths, American professional wrestlers, Deaths from aneurysm, Sportspeople from Louisville, Kentucky
Historical rankings of presidents of the United States	Presidents of the United States, History of the United States
Reconstruction era	African-American history, American Civil War, 1860s in the United States, 1870s in the United States, Andrew Johnson, Rutherford B. Hayes
Lena Meyer-Landrut	1991 births, Living people, Entertainers from Lower Saxony, Eurovision Song Contest winners, German pop singers, People from Hanover
Troodontidae	Theropods
Sinovenator	Dinosaurs of Asia, Cretaceous dinosaurs, Theropods
Paraves	Coelurosaurs, Birds, Fossils
Stan (dinosaur)	Cretaceous dinosaurs
Treponema pallidum	Gram-negative bacteria
Persuasion (novel)	Books by Jane Austen, English novels, 1810s books
Praetorian Guard	Ancient Rome
Claudio Pizarro	1978 births, Living people, Peruvian footballers
Edílson José da Silva	1978 births, Living people, Brazilian footballers
Dragan Đukanović	1969 births, Living people, Serbian footballers
Petri Pasanen	1980 births, Living people, Finnish footballers, FC Red Bull Salzburg players
Tsuyoshi Yoshitake	1981 births, Living people, Footballers from Mie Prefecture
Caçapa	1978 births, Living people, Brazilian footballers
Anthony Réveillère	1979 births, Living people, French footballers
Sébastien Squillaci	1980 births, Living people, French footballers
Julien Faubert	1983 births, Living people, French footballers, People from Le Havre
Henrik Pedersen	1975 births, Living people, Danish footballers
Jonílson Clovis Nascimento Breves	1978 births, Living people, Brazilian footballers
Willian (footballer, born 1983)	1983 births, Living people, Brazilian footballers, Mato Grosso do Sul
David Kaufman (actor)	1961 births, Living people, American movie actors, American television actors, American voice actors, Actors from St. Louis, Missouri
Leonardo Augusto Vieira Moreira	1986 births, Living people, Brazilian footballers
Yasuharu Kurata	1963 births, Living people, Footballers from Shizuoka Prefecture, Japan international footballers, Japanese football managers, Japan Soccer League players, Honda FC players, Tokyo Verdy players
Yosuke Saito	1988 births, Living people, Footballers from Tokyo Prefecture
Non-penetrative sex	Contraception, Sexual acts
Masakazu Tashiro	1988 births, Living people, Footballers from Tokyo Prefecture
Ariajasuru Hasegawa	1988 births, Living people, Footballers from Saitama Prefecture
Greatest common divisor	Arithmetics
The Penguins of Madagascar	Animated television series, Nicktoons, Madagascar (franchise), English-language television programs, 2008 television series debuts, 2015 television series endings
Power of two	Mathematics
Piecewise	Mathematics
Elgin Marbles	Ancient Greece, Ancient Greek marble sculptures, British Museum, Ancient Greek and Roman statues
Mockumentary	Mockumentaries, Documentary movies
Waiting for Guffman	1997 movies, Mockumentaries, English-language movies
Abundant number	Integer sequences
Ant mill	Ants
Acanthomyops	Ants
Acanthomyops latipes	Ants
Felipe de Almeida Gomes	1988 births, Living people, Footballers from Rio de Janeiro
Leandro Teixeira Dantas	1987 births, Living people, Brazilian footballers
Enílton	1977 births, Living people, Brazilian footballers, Mato Grosso do Sul
Lady-in-waiting	Personal service occupations
Leandro Euzébio	1981 births, Living people, Brazilian footballers
Paulo Nunes	1971 births, Living people, Brazilian footballers
Shizuo Takada	1947 births, Living people, Footballers from Tokyo Prefecture
Medical microbiology	Microbiology, Medicine
Ranieli Jose Cechinato	1970 births, Living people, Brazilian footballers
Marco Aurélio Fernandes da Silva	1977 births, Living people, Brazilian footballers
Koichiro Nagatomo	1982 births, Living people, Footballers from Miyazaki Prefecture
Noritomo Harada	1984 births, Living people, Footballers from Fukuoka Prefecture
Keisuke Shuto	1984 births, Living people, Footballers from Fukuoka Prefecture
Daisuke Nitta	1980 births, Living people, Footballers from Miyazaki Prefecture
Masashi Uramoto	1981 births, Living people, Footballers from Oita Prefecture
Ismaïl Aissati	1988 births, Living people, Dutch footballers, Sportspeople from Utrecht (city)
Joe Bizera	1980 births, Living people, Uruguayan footballers
Jaroslav Plašil	1982 births, Living people, Czech footballers
Otto Rehhagel	1938 births, Living people, German footballers, German football managers, Sportspeople from Essen
Omar Bravo	1980 births, Living people, Mexican footballers
Neoclassicism	Art movements
Atsushi Kimura	1984 births, Living people, Footballers from Osaka Prefecture, People from Osaka
Yusuke Shimada	1982 births, Living people, Footballers from Saitama Prefecture
Robert Todd Lincoln	1843 births, 1926 deaths, United States Secretaries of War, Children of Presidents of the United States, American lawyers, Ambassadors of the United States, Burials at Arlington National Cemetery, Politicians from Springfield, Illinois
Kazuki Sakurada	1982 births, Living people, Footballers from Shizuoka Prefecture
Kazuto Tsuyuki	1984 births, Living people, Footballers from Shizuoka Prefecture
Tom Starke	1981 births, Living people, German association football goalkeepers, Sportspeople from Saxony
Sejanus	Roman people
Je Ne Sais Quoi	2010 songs
Hera Björk	1972 births, Living people, People from Reykjavík, Singers
Ovo je Balkan	2010 songs
Milan Stanković	1987 births, Living people, Serbian singers
Toni Kroos	1990 births, Living people, German footballers, Association football midfielders, 2010 FIFA World Cup players, UEFA Euro 2012 players, 2014 FIFA World Cup players, UEFA Euro 2016 players, 2018 FIFA World Cup players, Sportspeople from Mecklenburg-Vorpommern
Al Jolson	1886 births, 1950 deaths, American movie actors, Singers from Washington, D.C., Actors from Washington, D.C., Jewish American actors
Holger Badstuber	1989 births, Living people, German footballers, Sportspeople from Bavaria
Zhytomyr	Cities in Ukraine, 880s establishments, Establishments in Ukraine, 9th century establishments in Europe
Doctor-patient relationship	Medicine, Relationships
Corm	Botany
Army ant	Ants
Hematuria	Medical signs, Urinary system
Bladder cancer	Cancer, Urinary system
Streptococcus mutans	Gram-positive bacteria
Commutative property	Mathematics
Irrational number	Irrational numbers
Shogo Yoshizawa	1986 births, Living people, Footballers from Gunma Prefecture
Hideya Tanaka	1986 births, Living people, Footballers from Okayama Prefecture
Ryusuke Ofuchi	1956 births, Living people, Footballers from Kumamoto Prefecture
Robert Earnshaw	1981 births, Living people, Welsh footballers
Paul Jones	1967 births, Living people, Welsh footballers, British association football goalkeepers
Júnior Maranhão	1985 births, Living people, Brazilian footballers, Maranhão
Frank Rost	1973 births, Living people, German association football goalkeepers, People from Chemnitz, Sportspeople from Saxony
Antonio Langella	1977 births, Living people, Italian footballers
Luis Diego López	1974 births, Living people, Uruguayan footballers, Sportspeople from Montevideo
Diego Pérez	1980 births, Living people, Uruguayan footballers, Sportspeople from Montevideo
Mitsunori Yamao	1973 births, Living people, Footballers from Aichi Prefecture
Lucas Bernardi	1977 births, Living people, Argentine footballers
Gonzalo Vargas	1981 births, Living people, Uruguayan footballers, Sportspeople from Montevideo
Hisanori Ogawa	1984 births, Living people, Footballers from Fukuoka Prefecture
Kentaro Yano	1981 births, Living people, Footballers from Fukuoka Prefecture
Norita Ochiai	1980 births, Living people, Footballers from Miyazaki Prefecture
Kazuhiro Ninomiya	1982 births, Living people, Footballers from Oita Prefecture
Sebastián Riep	1976 births, Living people, Argentine footballers
Marcelo Carracedo	1970 births, Living people, Argentine footballers
Shinya Shirakawa	1981 births, Living people, Footballers from Kagoshima Prefecture
Yusuke Nakamura	1986 births, Living people, Footballers from Shizuoka Prefecture
Masaki Iwamoto	1983 births, Living people, Footballers from Oita Prefecture
Luis Augusto Osorio Romao	1983 births, Living people, Brazilian footballers
Oxfordshire Ironstone Railway	Metals, Oxfordshire, Materials, Defunct railway companies of the United Kingdom, 1917 establishments in Europe, 1910s establishments in the United Kingdom, 1967 disestablishments, 1960s disestablishments in the United Kingdom
Tomasz Radzinski	1973 births, Living people, Belgian footballers, Canadian footballers, People from Poznań, Polish footballers, Sportspeople from Ontario
Zat Knight	1980 births, Living people, Black British sportspeople, English footballers, People from Solihull, Premier League players
Yuji Okuma	1969 births, Living people, Footballers from Saitama Prefecture
Motonobu Tako	1972 births, Living people, Footballers from Shizuoka Prefecture
Shoji Ikitsu	1977 births, Living people, Footballers from Fukuoka Prefecture
Danilo Gabriel de Andrade	1979 births, Living people, Brazilian footballers
Shuta Sonoda	1969 births, Living people, Footballers from Nagasaki Prefecture
Jesús Navas	1985 births, Living people, Manchester City F.C. players, Spanish footballers
Michael Thwaite	1983 births, Living people, Australian footballers, People from Brisbane, People from Cairns, Queensland, Sportspeople from Queensland
Tomoyasu Asaoka	1962 births, Living people, Footballers from Tokyo Prefecture, Japan international footballers, Japan Soccer League players, NKK SC players, Tokyo Verdy players
Lee Myung-bak	1941 births, Living people, Presidents of South Korea, Mayors of Seoul, People from Osaka
Fernando Redondo	1969 births, Living people, Argentine footballers
Eddie Johnson	1984 births, Living people, American footballers
Ryosuke Matsuoka	1984 births, Living people, Footballers from Aichi Prefecture
Toru Hasegawa	1988 births, Living people, Footballers from Aichi Prefecture
Shinta Fukushima	1989 births, Living people, Footballers from Aichi Prefecture
Thomas Müller	1989 births, Living people, 2010 FIFA World Cup players, 2014 FIFA World Cup players, German footballers, Sportspeople from Bavaria
3. Liga	Football leagues
VfL Osnabrück	German football clubs, Osnabrück, Sport in Lower Saxony
1. FC Union Berlin	German football clubs, Sport in Berlin, 1960s establishments in Germany, 1966 establishments in Europe
TuS Koblenz	German football clubs, Koblenz, Sport in Rhineland-Palatinate
1. FSV Mainz 05	1905 establishments in Europe, 1900s establishments in Germany, German football clubs, Mainz, Sport in Rhineland-Palatinate
FC Augsburg	Augsburg, German football clubs, Sport in Bavaria, 1907 establishments in Europe, 1900s establishments in Germany
Phonon	Physics
HC Dynamo Moscow	Ice hockey teams in Russia, 1946 establishments in the Soviet Union
Thunder Bay Thunder Cats	Ice hockey teams in Ontario, Thunder Bay
Parser	Computer programming
Lymington Branch Line	Railway lines of England
HQ9+	Programming languages
Quine	Computer programming
ELIZA	Software
GNU Emacs	Free software, Microsoft Windows software, Linux software
Bacillus anthracis	Gram-positive bacteria
George Bancroft	1800 births, 1891 deaths, American historians, People from Worcester, Massachusetts, American diplomats, American writers, Democrats (United States), Harvard University alumni, United States Secretaries of the Navy, Writers from Washington, D.C.
Christadelphians	Unitarianism, United Kingdom, Christianity in the United States
Quezon City	Quezon City, Cities in the Philippines
Robert Larue Stewart	Filipino people, 1917 births, 2006 deaths
Gaza flotilla raid	2010, Arab–Israeli conflict, Conflicts, Gaza Strip, 2010s in Israel, History of Palestine, Ships, May events
Far Eastern Republic	1922 disestablishments, Puppet states, 1920 establishments in Asia, 1920s disestablishments in Asia
Acanthomyops murphii	Ants
Adelomyrmex boltoni	Ants
Bryology	Botany
Internet Message Access Protocol	Internet protocols, E-mail
Yuji Sugano	1961 births, Living people, Footballers from Aichi Prefecture, Japan international footballers, J1 League players, Japan Soccer League players, Nagoya Grampus players
Nobuyo Fujishiro	1960 births, Living people, Footballers from Chiba Prefecture, Japan international footballers, Japan Soccer League players, NKK SC players, Kashima Antlers players
Kuniharu Nakamoto	1959 births, Living people, Footballers from Hiroshima Prefecture, Japan international footballers, Japan Soccer League players, NKK SC players
Katsuhiko Sano	1988 births, Living people, Footballers from Shizuoka Prefecture
Kentaro Sakai	1975 births, Living people, Footballers from Fukuoka Prefecture
Masashi Miyamura	1969 births, Living people, Footballers from Tokyo Prefecture
Horticulture	Botany, Gardening, Agriculture
Ryujiro Ueda	1988 births, Living people, Footballers from Osaka Prefecture, People from Osaka
Cauê Santos da Mata	1986 births, Living people, Brazilian footballers, People from Salvador, Bahia
Davi José Silva do Nascimento	1984 births, Living people, Brazilian footballers, People from Fortaleza
Shinya Chiba	1983 births, Living people, Footballers from Miyagi Prefecture
Kazunari Okayama	1978 births, Living people, Footballers from Osaka Prefecture, People from Osaka
Hitoyoshi Satomi	1983 births, Living people, Footballers from Gunma Prefecture
Naoki Takahashi	1976 births, Living people, Footballers from Fukuoka Prefecture
Anderson Luis da Silva	1972 births, Living people, Brazilian footballers
Ryuji Sueoka	1979 births, Living people, Footballers from Yamaguchi Prefecture
Yasuhiro Tanaka	1984 births, Living people, Footballers from Niigata Prefecture
Koichi Sugiyama	1971 births, Living people, Footballers from Osaka Prefecture, People from Osaka
Eiichiro Ozaki	1984 births, Living people, Footballers from Shizuoka Prefecture, J3 League players, Azul Claro Numazu players
Mikito Nishihara	1980 births, Living people, Footballers from Nara Prefecture
Hayato Mizuki	1984 births, Living people, Footballers from Kanagawa Prefecture
Shoji Yamada	1984 births, Living people, Footballers from Osaka Prefecture, People from Osaka
Tatsuyuki Okuyama	1976 births, Living people, Footballers from Niigata Prefecture
Keiichiro Nakano	1976 births, Living people, Footballers from Kagawa Prefecture
Takefumi Sasaki	1978 births, Living people, Footballers from Fukuoka Prefecture
Takanobu Kondo	1978 births, Living people, Footballers from Fukuoka Prefecture
Daiji Nii	1973 births, Living people, Footballers from Shizuoka Prefecture
Bill Foulkes	1932 births, 2013 deaths, Deaths from prostate cancer, English footballers, English football managers, Sportspeople from Lancashire
Bert Patenaude	1909 births, 1974 deaths, American footballers, Sportspeople from Massachusetts
Gianpiero Combi	1902 births, 1956 deaths, Italian footballers
Pak Doo-Ik	1942 births, Living people, North Korean footballers, People from Pyongyang
Tatsuhiko Kubo	1976 births, Living people, Footballers from Fukuoka Prefecture, Japan international footballers, J1 League players, J2 League players, Sanfrecce Hiroshima players, Yokohama F. Marinos players, Yokohama FC players, Zweigen Kanazawa players, 2001 FIFA Confederations Cup players, 2000 AFC Asian Cup players, AFC Asian Cup-winning players
Varkala	Cities in India
Butch Huskey	1971 births, Living people, American baseball players, New York Mets players, Sportspeople from Oklahoma
Mesut Özil	1988 births, Living people, German footballers, People from Gelsenkirchen, Sportspeople from North Rhine-Westphalia
Queen's Gambit	Chess openings
Wheel loader	Construction
Corollary	Mathematics
Yusuke Minoguchi	1965 births, Living people, Footballers from Chiba Prefecture, J1 League players, Japan Soccer League players, JEF United Chiba players, Sagan Tosu players, Avispa Fukuoka players, Oita Trinita players, 1988 AFC Asian Cup players
Takashi Kawamura	1968 births, Living people, Footballers from Yamaguchi Prefecture
Kazutaka Okada	Year of birth missing (living people), Living people, Footballers from Shizuoka Prefecture
Kepa Blanco	1984 births, Living people, Spanish footballers
Teruo Nimura	1943 births, Living people, Footballers from Kyoto Prefecture, Japan international footballers, Japan Soccer League players, Sanfrecce Hiroshima players
Yoshinori Shigematsu	1930 births, 2018 deaths, Footballers from Hiroshima Prefecture, Japan international footballers, Sanfrecce Hiroshima players
Takuya Muro	1982 births, Living people, Footballers from Osaka Prefecture, People from Osaka
Yuzuki Ito	1974 births, Living people, Footballers from Shizuoka Prefecture
Kensuke Kagami	1974 births, Living people, Footballers from Saitama Prefecture
Hideki Katsura	1970 births, Living people, Footballers from Tokushima Prefecture
Miguel Torres Gómez	1986 births, Living people, Spanish footballers, Sportspeople from Madrid
Takayuki Kuwata	1941 births, Living people, Footballers from Hiroshima Prefecture, Japan international footballers, Japan Soccer League players, Sanfrecce Hiroshima players
Juan Mata	1988 births, Chelsea F.C. players, Living people, Manchester United F.C. players, Spanish footballers, People from Castile and León
Ricardo Costa	1981 births, Living people, Portuguese footballers
Zdeněk Grygera	1980 births, Living people, Czech footballers
Rafael dos Santos de Oliveira	1987 births, Living people, Brazilian footballers
Kenji Koyano	1988 births, Living people, Footballers from Ibaraki Prefecture
Yasushi Endo	1988 births, Living people, Footballers from Miyagi Prefecture
Goto	Computer programming
Lisa M. Buttenheim	1954 births, Living people, American diplomats, Women diplomats
Theanine	Organic compounds
Bichon Frisé	Dog breeds
30 (number)	Integers
80 (number)	Integers
90 (number)	Integers
Yazman Tehsil	Tehsils of Punjab (Pakistan)
Birdo	Mario series characters
Tyler Fredrickson	1981 births, Living people, Football players from California, American football safeties, Seattle Seahawks players, Dallas Cowboys players, Washington Redskins players, Oakland Raiders players, People from Santa Barbara, California
Classless Inter-Domain Routing	Internet
John Doe	Law
AK-74	Assault rifles, Rifles of the Cold War
Ambient occlusion	Computer graphics
Bedbug	Hemiptera
Antonio Adán	1987 births, Living people, Spanish footballers
Yosuke Niwa	1940 births, Living people, Footballers from Hiroshima Prefecture
Simon Davies	1979 births, Living people, Welsh footballers
Takayuki Toyomitsu	1987 births, Living people, Footballers from Kagoshima Prefecture
Gabriel Donizete de Santana	1987 births, Living people, Brazilian footballers
Maya Yoshida	1988 births, Living people, Footballers from Nagasaki Prefecture, Japan international footballers, J1 League players, Nagoya Grampus players, 2014 FIFA World Cup players, 2018 FIFA World Cup players, 2013 FIFA Confederations Cup players, Footballers at the 2008 Summer Olympics, Footballers at the 2012 Summer Olympics
Oribe Niikawa	1988 births, Living people, Footballers from Gifu Prefecture
Shohei Yamamoto	1982 births, Living people, Footballers from Kyoto
Abraão Lincoln Martins	1983 births, Living people, Brazilian footballers
Cristian Brocchi	1976 births, Living people, Italian footballers
Nicklas Bendtner	1988 births, Living people, Danish footballers, People from Copenhagen
Mbo Mpenza	1976 births, Living people, Belgian footballers, People from Kinshasa
Marco Streller	1981 births, Living people, Swiss footballers, Sportspeople from Basel
Oscar B. Cintas	1887 births, 1957 deaths, Cuban people
Hyperopia	Diseases and disorders of the eye
Dispersion	Physics
Absorption spectroscopy	Spectroscopy
Kim Jung-nam	1943 births, Living people, South Korean footballers, South Korean football managers, People from Seoul
Jun Sonoda	1989 births, Living people, Footballers from Shizuoka Prefecture
Takefumi Toma	1989 births, Living people, Footballers from Okinawa Prefecture
Yuji Funayama	1985 births, Living people, Footballers from Chiba Prefecture
Kosuke Yoshii	1986 births, Living people, Footballers from Kagoshima Prefecture
Atsushi Ichimura	1984 births, Living people, Footballers from Hokkaidō Prefecture
Tadayo Fukuo	1984 births, Living people, Footballers from Hyōgo Prefecture
Snowy River National Park	National parks in Australia, Protected areas of Victoria (Australia)
Kill.switch	Shooter video games, 2003 video games, Namco video games
Croissant	Breads
So Cold	Rock songs, 2004 songs
Suguru Hino	1982 births, Living people, Footballers from Osaka Prefecture, People from Osaka
Grizzly Rage	2007 horror movies, Television movies, Movies about bears, 2007 movies, Canadian movies, English-language movies
Trapezius muscle	Fitness, Muscles
William of Ockham	1280s births, 1347 deaths, Christian theologians, English philosophers, English Roman Catholics, English theologians, Franciscans, Writers from Surrey
Palm cockatoo	Cockatoos, Birds of Australia, Birds of Oceania
Sterling Knight	American television actors, American movie actors, Disney actors, Actors from Houston, Texas, 1989 births, Living people
Robert Kiprono Cheruiyot	Kenyan people, 1988 births, Living people, Competitors in athletics
Bellatrix Lestrange	Harry Potter characters, Fictional characters introduced in 2003
Long Wittenham	Villages in England
Hitoshi Morishita (footballer, born 1967)	1967 births, Living people, Footballers from Shizuoka Prefecture
Masahiko Kuboyama	1964 births, Living people, Footballers from Shizuoka Prefecture
Hitoshi Tomishima	1964 births, Living people, Footballers from Kumamoto Prefecture
Sun Xiang	1982 births, Living people, Chinese footballers
Manuel Pablo	1976 births, Living people, Spanish footballers
Shogo Shiozawa	1982 births, Living people, Footballers from Nagano Prefecture
Aldo Duscher	1979 births, Living people, Argentine footballers
Álvaro Arbeloa	1983 births, Living people, Spanish footballers, People from Salamanca
Wilson Carlos Mano	1964 births, Living people, Brazilian footballers
Tomoya Osawa	1984 births, Living people, Footballers from Saitama Prefecture
Sonkyo Nomura	1941 births, Living people, Footballers from Hiroshima Prefecture
Francismar Carioca de Oliveira	1984 births, Living people, Brazilian footballers
Blerim Džemaili	1986 births, Living people, Swiss footballers
Dominique Rocheteau	1955 births, Living people, French footballers
Pablo Mastroeni	1976 births, Living people, American footballers
José Nasazzi	1901 births, 1968 deaths, Uruguayan footballers, Uruguayan football managers, Sportspeople from Montevideo
Savo Milošević	1973 births, Living people, Serbian footballers
Snowy River	Rivers of Victoria (Australia), Rivers of New South Wales
Maxwell House	1892 establishments in New York (state), Coffee, Drink companies
Ben Hogan	1912 births, 1997 deaths, American golfers
Arsenic and Old Lace	1944 movies, 1940s comedy movies, American comedy movies, English-language movies, Movies directed by Frank Capra
Aleksandr Kerzhakov	1982 births, Living people, Russian footballers
Makoto Watanabe	1980 births, Living people, Footballers from Shizuoka Prefecture
Kazuaki Kamizono	1981 births, Living people, Footballers from Kanagawa Prefecture
Yuya Nagatomi	1982 births, Living people, Footballers from Fukuoka Prefecture
Kyohei Noda	1981 births, Living people, Footballers from Kanagawa Prefecture
Slashing	Hockey, Lacrosse
Pat Patterson	1941 births, Canadian LGBT people, Canadian professional wrestlers, Former WWE wrestlers, Gay men, 2020 deaths, Cancer deaths in Florida, LGBT sportspeople, Sportspeople from Montreal, WWE Hall of Fame
Peer support	Sociology
Sulphur-crested cockatoo	Birds of Australia, Cockatoos
Salty liquorice	Candy
Gotland	Islands of Sweden, Provinces of Sweden
Almunge	Settlements in Uppsala County
Roger Sherman	1721 births, 1793 deaths, Founding Fathers of the United States, United States representatives from Connecticut, United States senators from Connecticut
Hebrew people	History of the Middle East, Semitic peoples, Ancient Israeli people
Roundheads	17th century in England
Cavaliers	17th century in England
Mall of America	Malls, Buildings and structures in Minnesota, 1992 establishments in the United States, 1990s establishments in Minnesota
Petronas	Companies of Asia, Malaysia, 1974 establishments in Asia, 20th century establishments in Malaysia
Telefónica	Companies of Spain
Union (American Civil War)	American Civil War
Painful sexual act	Sexual acts
Neem	Meliaceae, Plants of Asia
Minoru Funakoshi	Year of birth missing (living people), Living people, Footballers from Fukuoka Prefecture
Hiroyuki Shinonaga	1971 births, Living people, Footballers from Fukuoka Prefecture
Jorge López Montaña	1978 births, Living people, Spanish footballers
Mazarópi	1953 births, Living people, Brazilian association football goalkeepers
Masatada Ishii	1967 births, Living people, Footballers from Chiba Prefecture
Ayila Yussuf	1984 births, Living people, Nigerian footballers, People from Lagos
Nigel de Jong	1984 births, Living people, A.C. Milan players, 2010 FIFA World Cup players, 2014 FIFA World Cup players, Dutch footballers, Sportspeople from Amsterdam
Paulo Nagamura	1983 births, Living people, Brazilian footballers
Kevin Doyle	1983 births, Living people, Irish footballers, People from County Wexford
Jun Suzuki (born in 1989)	1989 births, Living people, Footballers from Fukuoka Prefecture, Avispa Fukuoka players
Krassimir Balakov	1966 births, Living people, Bulgarian footballers, Bulgarian football managers
Martin Jiránek	1979 births, Living people, Czech footballers
Fan Zhiyi	1969 births, Living people, Chinese footballers, Crystal Palace F.C. players
Kew Jaliens	1978 births, Living people, 2006 FIFA World Cup players, Dutch footballers, Sportspeople from Rotterdam
Kang Hyun-Su	1984 births, Living people, North Korean footballers, People from Osaka
Kosuke Nakamachi	1985 births, Living people, Footballers from Gunma Prefecture, Avispa Fukuoka players
Starstruck	2010 movies
Nematomorpha	Minor phyla
Burgess Shale	Lagerstätten, Mountains of British Columbia, Cambrian, Geological formations, Sedimentary rocks, World Heritage Sites in Canada
Solnhofen limestone	Bavaria, Fossils, Lagerstätten
Aenictogiton	Ants
Ketosis	Metabolism
Melphalan	Drugs, Cancer treatment
Rhabdomyosarcoma	Cancer
Underweight	Health problems
Etihad Airways	Airlines of the Middle East, 2003 establishments in Asia
Petrol Ofisi	Companies of Turkey
Pot-in-pot refrigerator	Food and drink
Ankylosauridae	Ankylosauria
David Heiss	Year of birth missing (living people), Living people, Murderers
Koichi Hashimoto	1969 births, Living people, Japanese footballers
Shun Ichimura	1986 births, Living people, Footballers from Tokyo Prefecture
Shinji Suzuki	1986 births, Living people, Footballers from Shizuoka Prefecture
Taiji Furuta	1982 births, Living people, Footballers from Nara Prefecture
Koichi Hirono	1980 births, Living people, Footballers from Nara Prefecture
Shigeru Sarusawa	1960 births, Living people, Footballers from Hiroshima Prefecture
Jehol biota	Lagerstätten, Fossils, China, Geological formations
Kazuki Tsuda	1982 births, Living people, Footballers from Tokyo Prefecture
Tsuyoshi Tanikawa	1980 births, Living people, Footballers from Shizuoka Prefecture
Oleksandr Shovkovskiy	1975 births, Living people, Sportspeople from Kiev, Ukrainian footballers
New York Draft Riots	1863 in the United States, American Civil War, History of Manhattan, Riots in the United States
Andrés Escobar	1967 births, 1994 deaths, 1990 FIFA World Cup players, 1994 FIFA World Cup players, Colombian footballers, Murdered sportspeople, Murders by firearm
Igor Duljaj	1979 births, Living people, Serbian footballers
Richard Dunne	1979 births, Living people, Irish footballers, Sportspeople from Dublin
Ryo Sakai	1977 births, Living people, Footballers from Kanagawa Prefecture
Wataru Sumida	1988 births, Living people, Footballers from Ehime Prefecture
Yuji Mito	1988 births, Living people, Footballers from Kyoto
Tiago Prado	1984 births, Living people, Brazilian footballers
Jun Mizukoshi	1975 births, Living people, Footballers from Nara Prefecture
Eduardo César Gaspar	1978 births, Living people, Brazilian footballers
Kris Boyd	1983 births, Living people, Scottish footballers
Ludovic Butelle	1983 births, Living people, French footballers, Association football goalkeepers, People from Reims
Leandro Grimi	1985 births, Living people, Argentine footballers
Naldo	1982 births, Living people, Brazilian footballers
Kevin Nolan	1982 births, Living people, English footballers, People from Liverpool, Premier League players
Leon Osman	1981 births, Living people, English footballers, Sportspeople from Greater Manchester, Premier League players
Hirotada Ito	1987 births, Living people, Footballers from Osaka Prefecture, People from Osaka
Pete Backor	1919 births, 1988 deaths, Canadian ice hockey defencemen, Ice hockey people from Ontario, People from Thunder Bay, Stanley Cup champions, Toronto Maple Leafs players, American Hockey League players
Bob Bodak	1961 births, Canadian ice hockey left wingers, Ice hockey people from Ontario, Living people, People from Thunder Bay, American Hockey League players, ECHL players, International Hockey League (1945–2001) players
Yusuke Sato (born in 1982)	1982 births, Living people, Footballers from Kumamoto Prefecture
Ryuji Kitamura	1981 births, Living people, Footballers from Kanagawa Prefecture
Daisuke Tanaka	1983 births, Living people, Footballers from Shiga Prefecture
Koji Nakao	1981 births, Living people, Footballers from Kagoshima Prefecture
Yasuyoshi Nara	1982 births, Living people, Footballers from Kanagawa Prefecture
Christoph Daum	1953 births, Living people, German footballers, German football managers, Sportspeople from Saxony
Megumu Tamura	1927 births, 1986 deaths, Japanese footballers, Japan international footballers
Seki Matsunaga	1928 births, 2013 deaths, Footballers from Shizuoka Prefecture, Japan international footballers, Kashiwa Reysol players
Yoshio Okada	1926 births, 2002 deaths, Footballers from Hyōgo Prefecture, Japan international footballers
Koji Miyata	1923 births, Living people, Japanese footballers, Japan international footballers, Tanabe Mitsubishi Pharma SC players
Masanobu Aoyagi	1985 births, Living people, Footballers from Fukuoka Prefecture
Wataru Nakazato	1984 births, Living people, Footballers from Okinawa Prefecture
FC Erzgebirge Aue	1946 establishments in Germany, German football clubs, Sport in Saxony
Takashi Sambonsuge	1978 births, Living people, Footballers from Kanagawa Prefecture
Hiroyuki Dobashi	1977 births, Living people, Footballers from Yamanashi Prefecture
Hidehito Shirao	1980 births, Living people, Footballers from Kagoshima Prefecture
Nenad Đorđević	1979 births, Living people, Serbian footballers
Rot-Weiß Oberhausen	German football clubs, Oberhausen, Sport in North Rhine-Westphalia
Shoki Hirai	1987 births, Living people, Footballers from Tokushima Prefecture
Kohei Nishino	1982 births, Living people, Footballers from Hyōgo Prefecture
Hiroyuki Takeda	1983 births, Living people, Footballers from Hyōgo Prefecture
SC Paderborn 07	German football clubs, Sport in North Rhine-Westphalia
Encyclopædia Britannica Ultimate Reference Suite	Encyclopædia Britannica
Digital rights	Computers, Rights
Enigma machine	World War II, Cryptography
Northwest Passage	Exploration, Arctic
Chatroulette	Websites
The Human Centipede (First Sequence)	2009 horror movies, Body horror movies, Dutch movies, English-language movies, German-language movies, Japanese-language movies, Movies about murderers, Multilingual movies, Suicide in movies, Obscenity controversies
Isle Royale National Park	National parks in the United States, Biosphere reserves
Mare Tranquillitatis	Surface features of the Moon
Heterodontosaur	Heterodontosaurs
Antti Niemi (ice hockey)	1983 births, Chicago Blackhawks players, Living people, Stanley Cup champions, Vantaa, Finnish ice hockey goaltenders
Filé	Spices
Stephen Strasburg	American baseball players, Washington Nationals players, Sportspeople from San Diego, California, 1988 births, Living people
Amblyopone saundersi	Ants
Amyrmex golbachi	Ants
Ancyridris	Ants
Anillidris	Ants
Danijel Ljuboja	Serbian footballers, 1978 births, Living people
Shigeo Sugimoto	1926 births, 2002 deaths, Footballers from Hyōgo Prefecture, Japan international footballers
Takeshi Inoue	1928 births, 1992 deaths, Footballers from Hyōgo Prefecture, Japan international footballers, Urawa Red Diamonds players
Takashi Kano	1920 births, 2000 deaths, Footballers from Tokyo Prefecture, Japan international footballers
Pterygota	Insects
Kazuya Iwakura	1985 births, Living people, Footballers from Toyama Prefecture
Robert Schuman	1886 births, 1963 deaths, Former MEPs, Government ministers of France, MEPs for France, People from Luxembourg City, Presidents of the European Parliament, Prime Ministers of France, French Ministers of Finance
Neoptera	Insects
Endopterygota	Insects
Hidemaro Watanabe	1924 births, 2011 deaths, Footballers from Hiroshima Prefecture, Japan international footballers
Masao Ono	1923 births, 2001 deaths, Footballers from Kanagawa Prefecture, Japan international footballers
Tomohiko Ikoma	1932 births, 2009 deaths, Footballers from Hyōgo Prefecture, Japan international footballers, Japan Soccer League players, Urawa Red Diamonds players
Kakuichi Mimura	1931 births, Living people, Footballers from Tokyo Prefecture, Japan international footballers, Footballers at the 1956 Summer Olympics
Arawa Kimura	1931 births, 2007 deaths, Footballers from Hiroshima Prefecture, Japan international footballers
Yasukazu Tanaka	1933 births, Living people, Japanese footballers, Japan international footballers, Sanfrecce Hiroshima players
Hisataka Okamoto	1933 births, Living people, Japanese footballers, Japan international footballers, Kashiwa Reysol players
Nobuo Matsunaga	1921 births, 2007 deaths, Footballers from Shizuoka Prefecture, Japan international footballers
Reizo Fukuhara	1931 births, 1970 deaths, Footballers from Hiroshima Prefecture, Japan international footballers
Toshio Iwatani	1925 births, 1970 deaths, Footballers from Hyōgo Prefecture, Japan international footballers
Alvin Ceccoli	1974 births, Living people, Australian footballers, Sportspeople from Sydney
Kenzo Ohashi	1934 births, 2015 deaths, Footballers from Hiroshima Prefecture, Japan international footballers, Japan Soccer League players, Sanfrecce Hiroshima players
Isao Iwabuchi	1933 births, 2003 deaths, Footballers from Tochigi Prefecture, Japan international footballers, Footballers at the 1956 Summer Olympics
Gyoji Matsumoto	1934 births, 2019 deaths, Footballers from Saitama Prefecture, Japan international footballers, Deaths from cardiovascular disease
Hiroaki Sato	1932 births, 1988 deaths, Footballers from Hyōgo Prefecture, Japan international footballers, Footballers at the 1956 Summer Olympics
Kenji Tochio	1941 births, Living people, Japanese footballers, Japan international footballers, Japan Soccer League players, JEF United Chiba players
Hiroshi Saeki	1936 births, Living people, Footballers from Hiroshima Prefecture, Japan international footballers, Japan Soccer League players, Nippon Steel Yawata SC players
Takehiko Kawanishi	1938 births, Living people, Footballers from Hiroshima Prefecture, Japan international footballers, Japan Soccer League players, Sanfrecce Hiroshima players
Koji Sasaki	1936 births, Living people, Japanese footballers, Japan international footballers
Shigenari Izumi	1969 births, Living people, Footballers from Ehime Prefecture
David Navarro	1980 births, Living people, Spanish footballers
Takao Nishiyama	1942 births, Living people, Japanese footballers, Japan international footballers, Japan Soccer League players
Nobuyuki Oishi	1939 births, Living people, Footballers from Hiroshima Prefecture, Japan international footballers, Japan Soccer League players, Nippon Steel Yawata SC players
Katsuyoshi Kuwahara	1944 births, Living people, Footballers from Shizuoka Prefecture, Japan international footballers, Japan Soccer League players
Masanobu Izumi	1944 births, Living people, Footballers from Hiroshima Prefecture, Japan international footballers, Japan Soccer League players, Nagoya Grampus players
Shigeki Kurata	1972 births, Living people, Footballers from Kyoto
Takayuki Yokoyama	1972 births, Living people, Footballers from Osaka Prefecture, People from Osaka
Tamotsu Komatsuzaki	1970 births, Living people, Footballers from Chiba Prefecture
Kenji Oba	1967 births, Living people, Footballers from Kanagawa Prefecture
Junji Koizumi	1968 births, Living people, Footballers from Tochigi Prefecture
Keisuke Moriya	1986 births, Living people, Footballers from Kanagawa Prefecture
Yoichi Akiba	1983 births, Living people, Footballers from Saitama Prefecture
Yohei Sakai	1986 births, Living people, Footballers from Kanagawa Prefecture
Stanley Smith Stevens	Scientists from Utah, American psychologists, 1906 births, 1973 deaths, People from Ogden, Utah
Daiki Niwa	1986 births, Living people, Footballers from Osaka Prefecture, Japan international footballers, J1 League players, J2 League players, J3 League players, Gamba Osaka players, Tokushima Vortis players, Omiya Ardija players, Avispa Fukuoka players, Sanfrecce Hiroshima players, FC Tokyo players, FC Tokyo U-23 players
Naoya Ishigami	1985 births, Living people, Footballers from Ibaraki Prefecture
New Found Glory	American rock bands, American punk bands, Emo bands, Pop punk bands, Musical groups from Florida
Anochetus goodmani	Ants
Anochetus pattersoni	Ants
Anonychomyrma	Ants
Anoplolepis nuptialis	Ants
Marko Marin	1989 births, Living people, German footballers
Cacau	1981 births, Living people, German footballers, Brazilian footballers
Sami Khedira	1987 births, Living people, 2010 FIFA World Cup players, 2014 FIFA World Cup players, German footballers, Sportspeople from Stuttgart
Lotus Racing	Formula One constructors, Formula One current
Kingston, Rhode Island	Cities in Rhode Island
Rot Weiss Ahlen	German football clubs, Sport in North Rhine-Westphalia, 1996 establishments in Europe, 1990s establishments in Germany
Vienna Declaration	Human rights, United Nations
Nihon Odai Ichiran	History of Japan
Morpheme	Grammar
Strong Bad's Cool Game for Attractive People	2008 video games, Homestar Runner
Strong Bad	Animated characters, Fictional characters introduced in 1996, Homestar Runner, Internet memes
Old Style and New Style dates	History, Time
Clarence S. Campbell Bowl	National Hockey League trophies and awards
Kangwŏn-do (North Korea)	North Korea
UVERworld	Japanese rock bands
Shabu shabu	Japanese food
Yoshikazu Suzuki	1982 births, Living people, Footballers from Shizuoka Prefecture
Tetsuya Oishi	1979 births, Living people, Footballers from Shizuoka Prefecture
Benigno Aquino III	1960 births, 2021 deaths, Presidents of the Philippines, Corazon Aquino, Deaths from diabetes, Deaths from renal failure
Toshimasa Toba	1975 births, Living people, Footballers from Aichi Prefecture
Kenji Arima	1972 births, Living people, Footballers from Kanagawa Prefecture, Japanese football managers
Tsutomu Nishino	1971 births, Living people, Footballers from Nara Prefecture
Daiki Wakamatsu	1976 births, Living people, Footballers from Aichi Prefecture
Toshihiro Yoshimura	1971 births, Living people, Footballers from Shizuoka Prefecture
Takashi Kuramoto	1984 births, Living people, Footballers from Oita Prefecture
Hiromasa Kanazawa	1983 births, Living people, Footballers from Shizuoka Prefecture
Kazuhiko Shingyoji	1986 births, Living people, Footballers from Tokyo Prefecture
Tadao Onishi	1943 births, 2006 deaths, Footballers from Kyoto Prefecture, Japan international footballers, Japan Soccer League players, Urawa Red Diamonds players
Tsuyoshi Kunieda	1944 births, Living people, Footballers from Hiroshima Prefecture, Japan international footballers, Japan Soccer League players, Sanfrecce Hiroshima players
Junji Kawano	1945 births, Living people, Footballers from Oita Prefecture, Japan international footballers, Japan Soccer League players, Sanfrecce Hiroshima players
Masafumi Hara	1943 births, Living people, Footballers from Saitama Prefecture, Japan international footballers, Japan Soccer League players, Nippon Steel Yawata SC players
Norio Yoshimizu	1946 births, Living people, Japanese footballers, Japan international footballers, Japan Soccer League players, JEF United Chiba players
Yusuke Omi	1946 births, Living people, Footballers from Tokyo Prefecture, Japan international footballers, Japan Soccer League players, Kashiwa Reysol players
Marcio Richardes	1981 births, Living people, Brazilian footballers, Albirex Niigata players
Yoichi Futori	1982 births, Living people, Footballers from Chiba Prefecture
Ryuichi Dogaki	1988 births, Living people, Footballers from Osaka Prefecture
Naoya Shibamura	1982 births, Living people, Footballers from Hiroshima Prefecture
Patrik Berger	1973 births, Living people, Czech footballers, Sportspeople from Prague
Miguel Pallardó	1986 births, Living people, Spanish footballers
David Cerrajería	1983 births, Living people, Spanish footballers, People from Valencia
Takeshi Ono	1944 births, Living people, Japanese footballers, Japan international footballers, Japan Soccer League players, Sanfrecce Hiroshima players
George Kobayashi	1947 births, Living people, Brazilian-Japanese footballers, Japan international footballers, Japan Soccer League players, Cerezo Osaka players
Seiichi Sakiya	1950 births, Living people, Footballers from Hiroshima Prefecture, Japan international footballers, Japan Soccer League players, Nippon Steel Yawata SC players
Noritaka Hidaka	1947 births, Living people, Footballers from Tokyo Prefecture, Japan international footballers, Japan Soccer League players, Nippon Steel Yawata SC players
Minoru Kobata	1946 births, Living people, Footballers from Saitama Prefecture, Japan international footballers, Japan Soccer League players, Kashiwa Reysol players
Shusaku Hirasawa	1949 births, Living people, Footballers from Akita Prefecture, Japan international footballers, Japan Soccer League players, Kashiwa Reysol players
Kazuhisa Kono	1950 births, Living people, Footballers from Hiroshima Prefecture, Japan international footballers, Japan Soccer League players, Kashiwa Reysol players
Koji Funamoto	1942 births, Living people, Footballers from Hiroshima Prefecture, Japan international footballers, Japan Soccer League players, Sanfrecce Hiroshima players
Kazumi Takada	1951 births, 2009 deaths, Footballers from Shizuoka Prefecture, Japan international footballers, Japan Soccer League players, Urawa Red Diamonds players
Michio Ashikaga	1950 births, Living people, Footballers from Akita Prefecture, Japan international footballers, Japan Soccer League players, Urawa Red Diamonds players
Ignacio Insa Bohigues	1986 births, Living people, Spanish footballers
Toshio Takabayashi	1953 births, Living people, Japanese footballers, Japan international footballers, Japan Soccer League players, Kashiwa Reysol players
Nilüfer, Bursa	Districts of Bursa Province
Vuvuzela	Africa, Sports
ING Group	Business, Banks, Companies of the Netherlands
Web accessibility	Internet, Disability
Brachiosaur	Brachiosaurs
Giraffatitan	Brachiosaurs, Jurassic dinosaurs, Dinosaurs of Africa
Level (device)	Construction
Hiroji Imamura	1949 births, Living people, Footballers from Shiga Prefecture, Japan international footballers, Japan Soccer League players, Cerezo Osaka players
Masaki Yokotani	1952 births, Living people, Footballers from Kyoto Prefecture, Japan international footballers, Japan Soccer League players, Kashiwa Reysol players, Yokohama Flügels players
Kiyoshi Saito	1982 births, Living people, Footballers from Miyagi Prefecture
Juan Luis Mora	1973 births, Living people, Spanish association football goalkeepers
Alexis Ruano Delgado	1985 births, Living people, Spanish footballers
Hisao Sekiguchi	1954 births, Living people, Footballers from Saitama Prefecture, Japan international footballers, Japan Soccer League players, Urawa Red Diamonds players
Ichiro Hosotani	1946 births, Living people, Footballers from Hyōgo Prefecture, Japan international footballers, Japan Soccer League players, Urawa Red Diamonds players
Toyohito Mochizuki	1953 births, Living people, Footballers from Shizuoka Prefecture, Japan international footballers, Japan Soccer League players, Kawasaki Frontale players
Shigemi Ishii	1951 births, Living people, Japanese footballers, Japan international footballers, Japan Soccer League players, JEF United Chiba players
Kazuyoshi Nakamura	1955 births, Living people, Footballers from Shizuoka Prefecture, Japan international footballers, Japan Soccer League players, Kawasaki Frontale players
Yoshiichi Watanabe	1954 births, Living people, Japanese footballers, Japan international footballers, Japan Soccer League players, Sanfrecce Hiroshima players
Michio Yasuda	1949 births, Living people, Japanese footballers, Japan international footballers, Japan Soccer League players, Nippon Steel Yawata SC players
Mitsuo Kato	1953 births, Living people, Japanese footballers, Japan international footballers, Japan Soccer League players, Urawa Red Diamonds players
Yukitaka Omi	1952 births, Living people, Footballers from Tokyo Prefecture, Japan international footballers, Japanese football managers, Japan Soccer League players, Tokyo Verdy players
Ikuo Takahara	1957 births, Living people, Japanese footballers, Japan international footballers, Japan Soccer League players, Urawa Red Diamonds players
Hiroyuki Sakashita	1959 births, Living people, Footballers from Kanagawa Prefecture, Japan international footballers, Japan Soccer League players, Shonan Bellmare players, Tokyo Verdy players
Yoshio Kato	1957 births, Living people, Footballers from Saitama Prefecture, Japan international footballers, J1 League players, Japan Soccer League players, JEF United Chiba players
Yasuhito Suzuki	1959 births, Living people, Footballers from Osaka Prefecture, Japan international footballers, Japan Soccer League players, Cerezo Osaka players
Toyokazu Fukuda	1958 births, Living people, Footballers from Mie Prefecture
Nobutaka Suzuki	1983 births, Living people, Footballers from Saitama Prefecture
Genki Haraguchi	1991 births, Living people, Footballers from Saitama Prefecture, Japan international footballers, J1 League players, Urawa Red Diamonds players, 2018 FIFA World Cup players
Ryo Kanazawa	1988 births, Living people, Footballers from Kyoto
Seiko Yamanaka	1989 births, Living people, Footballers from Kōchi Prefecture
Alceu	1984 births, Living people, Brazilian footballers
Kota Morimura	1988 births, Living people, Footballers from Tokyo Prefecture
Nobuyuki Abe (footballer)	1984 births, Living people, Footballers from Tokyo Prefecture
Kei Uemura	1981 births, Living people, Footballers from Kanagawa Prefecture
Takumi Shimohira	1988 births, Living people, Footballers from Osaka Prefecture, People from Osaka
Shu Kurata	1988 births, Living people, Footballers from Osaka Prefecture, Japan international footballers, J1 League players, J2 League players, Gamba Osaka players, JEF United Chiba players, Cerezo Osaka players
Kenta Hoshihara	1988 births, Living people, Footballers from Osaka Prefecture, People from Osaka
Kim Tae-Yeon	1988 births, Living people, South Korean footballers, People from Seoul
Gakuto Kondo	1981 births, Living people, Footballers from Aichi Prefecture
Matthew (ship)	Ships
Yosuke Ishibitsu	1983 births, Living people, Footballers from Osaka Prefecture, People from Osaka
Takahide Kishi	1987 births, Living people, Footballers from Hyōgo Prefecture
Object (grammar)	Grammar
Subject (grammar)	Grammar
Frigate	Warships, Ships
Eugène Gigout	1844 births, 1925 deaths, French composers, People from Nancy
Schola Cantorum	Music schools
Voice (grammar)	Grammar
Transitivity (mathematics)	Mathematics
Beer Sheba	Beer Sheba
Desert scorpion	Arachnids
Black widow	Spiders
Pill bug	Isopods
Druze	Druze, Ethnic groups in Israel, Lebanon, Religion in Israel, Syria
Ready to Fall	Rise Against
Soccer City	Soccer City, FIFA World Cup, Football stadiums in South Africa, Johannesburg, 1987 establishments in Africa, 1980s establishments in South Africa
Acacia	Trees, Mimosoideae
Mimosoideae	Mimosoideae
Affix	Grammar
New Caledonia national football team	National football teams, Football in France
Midshipman	Military ranks
Impressionist music	Music
Neoclassicism music	Music
Vincent d'Indy	French composers, 1851 births, 1931 deaths
Edgard Varèse	1883 births, 1965 deaths, French composers
Conservapedia	Wikis
Text grammar	Grammar, Literature, Linguistics
Discourse analysis	Linguistics
Super Paper Mario	Mario roleplaying games, 2007 video games, Wii games
Power-up	Video game design
Kamloops	Cities in British Columbia
Tsutomu Sonobe	1958 births, Living people, Footballers from Ibaraki Prefecture, Japan international footballers, Japan Soccer League players, Shonan Bellmare players
Satoshi Yamaguchi (footballer, born 1959)	1959 births, Living people, Footballers from Oita Prefecture, Japan international footballers, Japan Soccer League players, Urawa Red Diamonds players
Naoji Ito	1959 births, Living people, Footballers from Mie Prefecture, Japan international footballers, Japan Soccer League players, Honda FC players, Sagan Tosu players
Masaaki Kato	1958 births, Living people, Footballers from Aichi Prefecture, Japan international footballers, Japan Soccer League players, Hokkaido Consadole Sapporo players, Yokohama Flügels players
Toshihiko Okimune	1959 births, Living people, Footballers from Hiroshima Prefecture, Japan international footballers, Japan Soccer League players, Kawasaki Frontale players
Mitsugu Nomura	1956 births, Living people, Footballers from Hokkaidō Prefecture, Japan international footballers, Japan Soccer League players, Shonan Bellmare players
Toru Yoshikawa	1961 births, Living people, Footballers from Mie Prefecture, Japan international footballers, Japan Soccer League players, Kashiwa Reysol players, Kyoto Sanga FC players
Hiroshi Yoshida	1958 births, Living people, Footballers from Shizuoka Prefecture, Japan international footballers, Japan Soccer League players, JEF United Chiba players
Atsushi Uchiyama	1959 births, Living people, Footballers from Shizuoka Prefecture, Japan international footballers, Japanese football managers, Japan Soccer League players, Júbilo Iwata players
Yutaka Ikeuchi	1961 births, Living people, Footballers from Aichi Prefecture, Japan international footballers, Japan Soccer League players, Shonan Bellmare players
Masaru Uchiyama	1957 births, Living people, Footballers from Shizuoka Prefecture, Japan international footballers, Japan Soccer League players, Júbilo Iwata players
Takeshi Koshida	1960 births, Living people, Footballers from Ishikawa Prefecture, Japan international footballers, Japan Soccer League players, Yokohama F. Marinos players, Zweigen Kanazawa players
Artichoke	Asteraceae
Yoshinori Ishigami	1957 births, Living people, Footballers from Shizuoka Prefecture, Japan international footballers, Japan Soccer League players, Júbilo Iwata players
Osamu Taninaka	1964 births, Living people, Footballers from Tokyo Prefecture, Japan international footballers, Japan Soccer League players, Shonan Bellmare players, Sagan Tosu players
Hisashi Kaneko	1959 births, Living people, Footballers from Saitama Prefecture, Japan international footballers, Japan Soccer League players, JEF United Chiba players
Takaya Kawanabe	1988 births, Living people, Footballers from Saitama Prefecture
Kunihiro Shibasaki	1985 births, Living people, Footballers from Tokyo Prefecture
Takuya Sonoda	1984 births, Living people, Footballers from Miyazaki Prefecture
Kim Dong-Soo	1986 births, Living people, South Korean footballers
Koji Asato	1987 births, Living people, Footballers from Okinawa Prefecture
Park Jong-Jin	1987 births, Living people, South Korean footballers
Márcio Rodrigues Araújo	1984 births, Living people, Brazilian footballers
Takahiro Oshima	1988 births, Living people, Footballers from Chiba Prefecture
Taishi Koyama	1988 births, Living people, Footballers from Yamanashi Prefecture
Kenji Suzuki	1986 births, Living people, Footballers from Akita Prefecture
Eltinho	1987 births, Living people, Brazilian footballers, Coritiba Foot Ball Club players
Anderson Santos Silva	Brazilian footballers, 1981 births, Living people
Kentaro Sato (footballer)	1984 births, Living people, Footballers from Mie Prefecture
Kenichi Mori	1984 births, Living people, Footballers from Gunma Prefecture
Keisuke Endo	1989 births, Living people, Footballers from Chiba Prefecture
Yoshinobu Harada	1986 births, Living people, Footballers from Saitama Prefecture
Adam Burish	1983 births, American Hockey League players, American ice hockey players, Chicago Blackhawks players, Dallas Stars players, Living people, People from Madison, Wisconsin, San Jose Sharks players, Sportspeople from Wisconsin, Stanley Cup champions, Swedish Hockey League players, United States Hockey League players
Jun Tanaka	1983 births, Living people, Footballers from Saitama Prefecture
Ryota Kobayashi	1988 births, Living people, Footballers from Gunma Prefecture
Kim Yeong-Gi	1985 births, Living people, South Korean footballers
Takahiro Yamaguchi	1984 births, Living people, Footballers from Tokyo Prefecture
Yuki Igari	1988 births, Living people, Footballers from Kanagawa Prefecture
Aphaenogaster kimberleyensis	Ants
Aphaenogaster	Ants
NGO Monitor	Political organizations based in Asia, Arab–Israeli conflict, 2001 establishments in Asia, Jerusalem
Satoru Hayashi	1988 births, Living people, Footballers from Kanagawa Prefecture
Shuichi Akai	1981 births, Living people, Footballers from Hokkaidō Prefecture
Akihiro Sakata	1984 births, Living people, Footballers from Kyoto
Kim Shin-Young	1983 births, Living people, South Korean footballers
Rui Komatsu	1983 births, Living people, Footballers from Kōchi Prefecture
Kenta Tanno	1986 births, Living people, Footballers from Miyagi Prefecture
Tatsuya Yamashita	1987 births, Living people, Footballers from Hyōgo Prefecture
Kazuyuki Mugita	1984 births, Living people, Footballers from Ishikawa Prefecture
Eigo Sekine	1981 births, Living people, Footballers from Saitama Prefecture
Kazuki Abe	1987 births, Living people, Footballers from Tokushima Prefecture
Kohei Kawata	1987 births, Living people, Footballers from Oita Prefecture
Orust	Islands of Sweden
Georg Philipp Schmidt von Lübeck	1766 births, 1849 deaths, German poets, People from Lübeck
Cosimo Rosselli	1439 births, 1500s deaths, People from Florence, 15th century Italian painters
Der Wanderer	19th century songs
Erzincan	Cities in Turkey
J.P. Manoux	1969 births, Living people, American television actors, American voice actors, People from Fresno, California
Life Before Life	Non-fiction books, 2005 books, Parapsychology
Ian Stevenson	Psychiatrists, People from Quebec, 2007 deaths, 1918 births, Parapsychologists
Jhelum	Cities in Pakistan
Parapsychology	Parapsychology
Handedness	Motor skills, Writing
Andromeda galaxy	Spiral galaxies, Local galaxies
Moses Mabhida Stadium	Football stadiums in South Africa, FIFA World Cup, Durban, 2009 establishments, 2000s establishments in South Africa
Endive	Asteraceae
Cape Town Stadium	Cape Town Stadium, Football stadiums in South Africa, FIFA World Cup, Cape Town, 1987 establishments in Africa, 1980s establishments in South Africa
Mechanical bull	Amusement rides
Naoki Hashimoto	1982 births, Living people, Footballers from Fukushima Prefecture
Kenichiro Uchida	1976 births, Living people, Footballers from Saitama Prefecture
Masato Chiba	1978 births, Living people, Footballers from Miyagi Prefecture
Hideki Kirita	1980 births, Living people, Footballers from Shimane Prefecture
Katsunobu Saga	1978 births, Living people, Footballers from Akita Prefecture
Kazutaka Takano	1979 births, Living people, Footballers from Yamagata Prefecture
Takeshi Yamaguchi	1979 births, Living people, Footballers from Kumamoto Prefecture
Kiyokazu Masuda	1987 births, Living people, Footballers from Hyōgo Prefecture
Shingo Kinoshita	1987 births, Living people, Blaublitz Akita players, Footballers from Hyōgo Prefecture
Keiichi Misawa	1988 births, Living people, Footballers from Nagano Prefecture
Ryota Doi	1987 births, Living people, Footballers from Hyōgo Prefecture
Kohei Doi	1988 births, Living people, Footballers from Hyōgo Prefecture
Tomohisa Nakata	1987 births, Living people, Footballers from Aichi Prefecture
Keita Sogabe	1988 births, Living people, Footballers from Hyōgo Prefecture
Masahiro Ito	1988 births, Living people, Footballers from Hyōgo Prefecture
Sho Okubo	1988 births, Living people, Footballers from Kanagawa Prefecture
Eiji Sato	1971 births, Living people, Footballers from Saitama Prefecture
Koki Kotegawa	1989 births, Living people, Footballers from Oita Prefecture
Mischa Maisky	1948 births, Living people, Cellists, Jewish Israeli musicians, Latvian Jews, Naturalized citizens of Israel, People from Riga, Soviet Jews, Soviet musicians
Hidenori Tabata	1970 births, Living people, Footballers from Aomori Prefecture
Masayuki Mita	1969 births, Living people, Footballers from Miyagi Prefecture
Fukutaro Shino	1982 births, Living people, Footballers from Tokyo Prefecture
List of Indo-European languages	Indo-European languages, Language-related lists
Shinya Hatta	1984 births, Living people, Footballers from Osaka Prefecture, People from Osaka
Edinaldo Batista dos Santos	1987 births, Living people, Brazilian footballers
Kim Ki-Su	1982 births, Living people, North Korean footballers
Jun Shimanuki	1988 births, Living people, Footballers from Tokyo Prefecture
Celso Cardoso de Moraes	1979 births, Living people, Brazilian footballers
Wataru Yamazaki	1980 births, Living people, Footballers from Saitama Prefecture
Mário Brandão da Silveira	1987 births, Living people, Brazilian footballers
Daiki Sato	1988 births, Living people, Footballers from Chiba Prefecture
Jin Kanaoya	1988 births, Living people, Footballers from Saitama Prefecture
Shota Iwata	1988 births, Living people, Footballers from Chiba Prefecture
Émile Mpenza	1978 births, Living people, Belgian footballers
Anatoliy Tymoshchuk	1979 births, Living people, Ukrainian footballers
IOS	IOS
Ford Model A (1927–1931)	Ford automobiles, 1920s automobiles, 1930s automobiles
Ellis Park Stadium	Ellis Park Stadium, FIFA World Cup, Football stadiums in South Africa, Johannesburg, 1982 establishments in Africa, 1980s establishments in South Africa
Ferman Akgül	1979 births, Living people, Turkish singers, People from Ankara
Bruce Greyson	Psychiatry, 1946 births, Living people, Parapsychologists
Gail Kim	1977 births, Canadian professional wrestlers, Female professional wrestlers, Living people, Sportspeople from Toronto
Mission, British Columbia	Cities in British Columbia
Near death experience	Psychiatry, Death, Afterlife
Duracell	Electronics companies, Batteries
Loftus Versfeld Stadium	Loftus Versfeld, FIFA World Cup, Football stadiums in South Africa, Pretoria, 1906 establishments, 20th-century establishments in South Africa, 1900s establishments in Africa
Periodontitis	Diseases and disorders of the mouth
Nelson Mandela Bay Stadium	Nelson Mandela, FIFA World Cup, Football stadiums in South Africa
Mbombela Stadium	Mbombela Stadium, FIFA World Cup, Football stadiums in South Africa
Suda	Byzantine Empire, Encyclopedias, Literature
Toshitaka Tsurumi	1986 births, Living people, Footballers from Kanagawa Prefecture
Yohei Hamasaki	1987 births, Living people, Footballers from Kōchi Prefecture
Yosuke Kawamata	1985 births, Living people, Footballers from Tokyo Prefecture
Kyaw Din	1900 births, Living people, Burmese people, Coaches
Hideto Inoue	1982 births, Living people, Footballers from Ehime Prefecture
Joey Barton	1982 births, Living people, British people convicted of assault, English footballers, Sportspeople from Merseyside, Premier League players
Alexandre Luiz Fernandes	1986 births, Living people, Brazilian footballers
Misao Tamai	1903 births, 1978 deaths, Footballers from Hyōgo Prefecture, Japan international footballers
Gilberto Martínez	1979 births, Living people, Costa Rican footballers
Flag of Slovenia	Slovenia, National flags, 1991 establishments in Slovenia
Yegor Titov	1976 births, Living people, Russian footballers
Abdul Kader Keïta	1981 births, Living people, Ivorian footballers
Cockatoo Island (New South Wales)	Geography of New South Wales, Australian Convict Sites, Museums in Australia, Sydney, Prisons
Mikael Nilsson	1978 births, Living people, Swedish footballers
Warren Buffett	American billionaires, American chief executives, Businesspeople from Omaha, Nebraska, People with cancer, 1930 births, Living people, Writers from Omaha, Nebraska, American philanthropists
Christoph Spycher	1978 births, Living people, Swiss footballers
Pentatomoidea	Hemiptera
Port of Kaohsiung	Transport in Taiwan, Ports and harbours of Taiwan
Martti Ahtisaari	1937 births, Living people, Presidents of Finland, Finnish Nobel Prize winners, People with Alzheimer's disease
Guatemala City	1773 establishments, National capitals in North America, Cities in Central America, Guatemala City, Establishments in Guatemala, 1770s establishments in North America
National Park Service	National parks in the United States, United States government agencies, United States Department of the Interior
Babysitter	Children, Personal service occupations
Noboru Nakayama	1987 births, Living people, Footballers from Osaka Prefecture, People from Osaka
Cleberson Luis Marques	1984 births, Living people, Brazilian footballers
Stephen Ireland	1986 births, Living people, Irish footballers, People from Cork (city)
Takashi Sasano	1983 births, Living people, Footballers from Kanagawa Prefecture
Yushi Ito	1984 births, Living people, Footballers from Saitama Prefecture
Kenji Takahashi (born in 1985)	1985 births, Living people, Footballers from Osaka Prefecture, People from Osaka
Hiroyuki Nitao	1973 births, Living people, Footballers from Kagoshima Prefecture
Ivan Saenko	1983 births, Living people, Russian footballers
Pedro Zaballa	1938 births, 1997 deaths, Spanish footballers
Cha Du-ri	1980 births, Living people, South Korean footballers
Kim Tae-young (footballer, born 1970)	1970 births, Living people, South Korean footballers
Stipe Pletikosa	1979 births, Living people, Croatian footballers, People from Split
Hyun Young-min	1979 births, Living people, South Korean footballers
Lee Min-sung	1973 births, Living people, South Korean footballers
Choi Eun-sung	1971 births, Living people, South Korean association football goalkeepers
Koffi Ndri Romaric	1983 births, Living people, Ivorian footballers
Hasan Şaş	1976 births, Living people, Turkish footballers
Okan Buruk	1973 births, Living people, Turkish footballers
Out of body experience	Spirituality
American Arts Commemorative Series medallions	Money, Cultural history
Implication and inference	Grammar, Human communication
Nonverbal communication	Non-verbal communication
Triangular number	Integer sequences
Skeptical Inquirer	Skepticism, Science and technology magazines, Pseudoscience
Animal Collective	American rock bands, Indie rock bands, Musicians from Baltimore, Maryland, Musical groups from Maryland, 1999 establishments in the United States, Musical groups established in 1999, 1990s establishments in Maryland
Comox, British Columbia	Cities in British Columbia, 1953 establishments, 1950s establishments in Canada
Walled In	2009 horror movies, 2009 thriller movies, American horror movies, American thriller movies, Canadian horror movies, English-language movies, French horror movies, French thriller movies, Movies based on books, Movies directed by Gilles Paquet-Brenner
Pair production	Wave physics
Acupuncture	Alternative medicine, Chinese culture
Nishogakusha University	Colleges and universities in Tokyo, 1877 establishments, 1870s establishments in Japan
Order of Australia	Order of Australia, 1975 establishments, 1970s establishments in Australia
Pedro María Zabalza	1944 births, Living people, Spanish footballers, Spanish football managers, People from Pamplona
Ilsinho	1985 births, Living people, Brazilian footballers
Osamu Adachi	1972 births, Living people, Footballers from Shimane Prefecture
Akihiro Kameda	1966 births, Living people, Japanese footballers
Angelos Basinas	1976 births, Living people, Greek footballers
Claude Davis	1979 births, Living people, Caribbean footballers, Jamaican sportspeople, Crystal Palace F.C. players
Tommaso Rocchi	1977 births, Living people, Italian footballers, People from Venice
Futoshi Ikeda	1970 births, Living people, Footballers from Tokyo Prefecture
Denílson Pereira Neves	1988 births, Living people, Brazilian footballers
Maurizio Ganz	1968 births, Living people, Italian footballers
Rami Shaaban	1975 births, Living people, Swedish footballers
Nawaf Al-Temyat	1976 births, Living people, Saudi Arabian footballers
Clemente Rodríguez	1981 births, Living people, Argentine footballers, Sportspeople from Buenos Aires
Martín Palermo	1973 births, Living people, Argentine footballers
Sheamus	1978 births, Actors from Dublin, Irish professional wrestlers, Living people, Professional wrestlers, WWE wrestlers
Glenmore, Wisconsin	Towns in Wisconsin, Brown County, Wisconsin
Rover 600 Series	Rover automobiles, 1990s automobiles
Radymno	Cities in Poland
Volkswagen Golf Plus	Volkswagen Golf, 2000s automobiles, 2010s automobiles
Sexual selection	Evolutionary biology
Sabine Bergmann-Pohl	1946 births, Living people, Former members of the German Bundestag, German Lutherans, Government ministers of Germany, Members of the Volkskammer, Politicians from Thuringia, Presidents of East Germany
Google Sidewiki	Google
César Aparecido Rodrigues	1974 births, Living people, Brazilian footballers
Shoji Akimitsu	1977 births, Living people, Footballers from Oita Prefecture
Javier Navarro	1974 births, Living people, Spanish footballers, People from Valencia
Paul Telfer	1971 births, Living people, Scottish footballers
Minoru Ueda	1977 births, Living people, Footballers from Tokyo Prefecture
Kazutoshi Miura	1977 births, Living people, Footballers from Miyazaki Prefecture
José Marcelo Ferreira	1973 births, Living people, Brazilian footballers
Onagraceae	Myrtales
Yusuke Amano	1978 births, Living people, Footballers from Ehime Prefecture
Ryuzo Okamitsu	1940 births, Living people, Footballers from Hiroshima Prefecture
Shinya Tamaoki	1988 births, Living people, Footballers from Osaka Prefecture, People from Osaka
Damiano Zenoni	1977 births, Living people, Italian footballers
Giampiero Pinzi	1981 births, Living people, Italian footballers, Sportspeople from Rome
Tamon Machida	1982 births, Living people, Footballers from Saitama Prefecture
Hideyuki Nakamura	1984 births, Living people, Footballers from Saitama Prefecture
Suguru Hashimoto	1982 births, Living people, Footballers from Hyōgo Prefecture
Yusuke Tasaka	1985 births, Living people, Footballers from Hiroshima Prefecture
Blood atonement	Mormonism
František Straka	1958 births, Living people, Czech footballers, Czech football managers
Luís Boa Morte	1977 births, Living people, Portuguese footballers, Sportspeople from Lisbon
John Michael Wright	1617 births, 1694 deaths, English painters, Scottish painters
Frank Leboeuf	1968 births, Living people, French footballers, Sportspeople from Marseille
Öland	Islands of Sweden, Provinces of Sweden
Gräsö	Islands of Sweden
Vicente del Bosque	1949 births, Living people, Spanish footballers, Spanish football managers, People from Salamanca
Xenophanes	Skepticism, Ancient Greek philosophers
Maihama Station	1988 establishments in Japan
Modus tollens	Rules of inference
Metta World Peace	1979 births, African-American basketball players, Living people, Chicago Bulls players, Houston Rockets players, Indiana Pacers players, Los Angeles Lakers players, Sacramento Kings players, Sportspeople from New York City
On the Origin of Species	Evolutionary biology, Biology books, 1859 books, Books by Charles Darwin
Armitage Shanks	1817 establishments, Ceramics, Companies of the United Kingdom, Waste, 1810s establishments in the United Kingdom
Uriah Fuller	Pen names
George Groth	Pen names
Standard of living	Economics, Human rights
Canaanite	Bible
U.S. Route 101 in California	U.S. Highways, Roads in California
Yelp, Inc.	2004 establishments in the United States, Internet culture, Companies based in San Francisco, Social networking, Web 2.0
John Stalberg, Jr.	Year of birth missing (living people), Living people, American movie directors, American screenwriters
Free State Stadium	Free State Stadium, FIFA World Cup, Football stadiums in South Africa, Bloemfontein, 1952 establishments, 20th-century establishments in South Africa
Peter Mokaba Stadium	Peter Mokaba Stadium, FIFA World Cup, Football stadiums in South Africa
Royal Bafokeng Stadium	Royal Bafokeng Stadium, FIFA World Cup, Football stadiums in South Africa
The Dirty Energy Dilemma	Non-fiction books, Energy, 2008 books
Narita Airport Station	1991 establishments in Japan
Nobuhiro Sadatomi	1979 births, Living people, Footballers from Tokyo Prefecture
Veljko Paunović	1977 births, Living people, Serbian footballers
Sebastián Battaglia	1980 births, Living people, Argentine footballers, People from Santa Fe, Argentina
Piotr Sowisz	1971 births, Living people, Polish footballers
Frédéric Kanouté	Malian footballers, 1977 births, Living people
Cosmin Contra	1975 births, Living people, Romanian footballers
Manu del Moral	1984 births, Living people, Spanish footballers
Miguel de las Cuevas	1986 births, Living people, Spanish footballers, People from Alicante
Fabiano Eller	1977 births, Living people, Brazilian footballers
Julien Escudé	1979 births, Living people, French footballers, People from Centre-Val de Loire
Antonio Puerta	1984 births, 2007 deaths, Spanish footballers
Nélson Marcos	1983 births, Living people, Portuguese footballers
Fumiaki Iwamoto	1968 births, Living people, Footballers from Nagasaki Prefecture
Leandro Somoza	1981 births, Living people, Argentine footballers, Sportspeople from Buenos Aires
Tadao Takayama	1904 births, 1980 deaths, Footballers from Tokyo Prefecture, Japan international footballers
Sylvain N'Diaye	1976 births, Living people, Senegalese footballers, Sportspeople from Paris
Ramesses II	Pharaohs
David Rozehnal	1980 births, Living people, Czech footballers
Ballonmuseum Gersthofen	Buildings and structures in Bavaria, Museums in Germany
Governor of New South Wales	Governors of New South Wales
Chūbu region	Geography of Japan, Honshu
Space bar	Computing
AZERTY	Computing
Parintins	Cities in Amazonas State, 1852 establishments, 19th-century establishments in Brazil, 1850s establishments in South America
Itacoatiara	Cities in Amazonas State, 1874 establishments, 1870s establishments in Brazil
East River	Geography of New York City
American Society of Civil Engineers	Civil engineering
Tarbosaurus	Theropods, Tyrannosaurids, Dinosaurs of Asia
Torosaurus	Ceratopsids
Dung beetle	Polyphaga
Bombardier beetle	Carabidae
Luigi Delneri	1950 births, Living people, Italian footballers
Toshikazu Kato	1981 births, Living people, Footballers from Hiroshima Prefecture
Hidekazu Tajiri	1975 births, Living people, Footballers from Kumamoto Prefecture
Wataru Tagami	1982 births, Living people, Footballers from Fukuoka Prefecture
Yoshihiro Saisho	1982 births, Living people, Footballers from Kagoshima Prefecture
Valentino Mazzola	1919 births, 1949 deaths, Italian footballers
Guillermo Barros Schelotto	1973 births, Living people, Argentine footballers
Ichiji Otani	1912 births, 2007 deaths, Footballers from Hyōgo Prefecture, Japan international footballers
Hidekazu Orita	1961 births, Living people, Footballers from Hiroshima Prefecture
Hiroshi Kagawa	1924 births, Living people, Footballers from Hyōgo Prefecture
Mauricio Salles	1978 births, Living people, Brazilian footballers, People from Salvador, Bahia
Stanislav Varga	1972 births, Living people, Slovak footballers
Albert Meyong	1980 births, Living people, Cameroonian footballers
Bonaventure Kalou	1978 births, Living people, Ivorian footballers
Matías Fernández	1986 births, Living people, Chilean footballers, Sportspeople from Buenos Aires
Jason Culina	1980 births, Living people, Australian footballers, Sportspeople from Melbourne
Martin Laursen	1977 births, Living people, Danish footballers
Libor Sionko	1977 births, Living people, Czech footballers
Lightning arrester	Electricity distribution
Alfred Macalik	Romanian composers, Austrian composers, Sculptors, Painters, 1888 births, 1979 deaths
StarHub TV	Singaporean companies, Cable television, Entertainment companies
Mediacorp	Singaporean companies, Media in Asia
Glomerular filtration rate	Medical tests
Sutton United F.C.	English football clubs, London Borough of Sutton
Freaky Friday (1976 movie)	1976 comedy movies, 1970s teen movies, American fantasy movies, American teen comedy movies, Body swapping in fiction, English-language movies, Movies based on books, Disney movies
Dairy Queen	1940 establishments in Illinois, American fast food restaurants
Fallout (video game)	Role-playing video games, Windows games, MacOS games, Fallout series
Hamilton, Bermuda	National capitals in North America, Bermuda
Brooklyn Museum	Museums in New York City, Art museums in the United States, Brooklyn, 1895 establishments in the United States, 1890s establishments in New York (state)
Centrosaurus	Ceratopsia
Tenontosaurus	Ornithopods, Cretaceous dinosaurs
Alicia Fox	1977 births, Living people, WWE wrestlers, Female professional wrestlers, Sportspeople from Florida
Stick insect	Phasmids
Extra time	Sports
Olivier Kapo	1980 births, Living people, French footballers
Frédéric Déhu	1972 births, Living people, French footballers
Félix Dja Ettien	1979 births, Living people, Ivorian footballers
Matthew Connolly	1987 births, Living people, English footballers, Sportspeople from London, Premier League players
Mark Randall	1989 births, Living people, Arsenal F.C. players, English footballers, Milton Keynes, Sportspeople from Buckinghamshire
Bernard Mendy	1981 births, Living people, French footballers
Mario Yepes	1976 births, Living people, Colombian footballers
Cristian Rodríguez	1985 births, Living people, Uruguayan footballers
Mikel Alonso	1980 births, Living people, Spanish footballers
Xabier Prieto	1983 births, Living people, Spanish footballers
Aitor López Rekarte	1975 births, Living people, Spanish footballers
Jurica Vranješ	1980 births, Living people, Croatian footballers
Javier Aguirre	1958 births, Living people, Sportspeople from Mexico City, Mexican footballers, Mexican football managers, Japan national football team managers
Erwin Koeman	1961 births, Living people, Dutch football managers, Dutch footballers, Eredivisie managers, People from Zaanstad, Sportspeople from North Holland
Ivica Osim	1941 births, Living people, People from Sarajevo, Bosnia and Herzegovina footballers, Bosnia and Herzegovina football managers, Japan national football team managers
Jewish cemetery of Besançon	Cemeteries, Judaism in France, Besançon
Alcides Ghiggia	1926 births, 2015 deaths, Deaths from myocardial infarction, Uruguayan footballers, Uruguayan football managers, Italian footballers, Italian football managers, Sportspeople from Montevideo
United States Army Center of Military History	United States Army
Marko Babić	1981 births, Living people, Croatian footballers
Hetepheres I	Ancient Egyptian queens, 3rd millennium BC
Binaural beats	Sound, Neurology, Hearing
Benjamin K. Sovacool	Year of birth missing (living people), Living people, American academics
Kate Cary	1967 births, Living people, English writers
David Pall	1914 births, 2004 deaths, Deaths from Alzheimer's disease, Canadian scientists
Barosaurus	Dinosaurs of North America, Dinosaurs of Africa, Jurassic dinosaurs, Diplodocids
NHL 11	2010 video games, Electronic Arts video games, PlayStation 3 games, Xbox 360 games, Sports video games
Yusuke Suzuki	1982 births, Living people, Footballers from Saitama Prefecture
Takaaki Hisadome	1982 births, Living people, Footballers from Kagoshima Prefecture
Iñigo Díaz de Cerio	1984 births, Living people, Spanish footballers
Gène Hanssen	1959 births, Living people, Dutch footballers, Sportspeople from Limburg (Netherlands)
Edwin Ifeanyi	1972 births, Living people, Cameroonian footballers
Uğur Yıldırım	1982 births, Living people, Dutch footballers, People from Apeldoorn, Sportspeople from Gelderland
Hisanori Yae	1980 births, Living people, Footballers from Nagasaki Prefecture
Takahiro Ishikawa	1983 births, Living people, Footballers from Tokyo Prefecture
Mark Burke	1969 births, Living people, English footballers, People from Solihull
Edson Araujo da Silva	1980 births, Living people, Brazilian footballers
Taro Kawano	1980 births, Living people, Footballers from Tokyo Prefecture
Koichi Higashi	1978 births, Living people, Footballers from Nara Prefecture
Hwang Hak-Sun	1976 births, Living people, North Korean footballers
Roberto Torres	1972 births, Living people, Paraguayan footballers
Krunoslav Lovrek	1979 births, Living people, Croatian footballers
Djefatnebti	Ancient Egyptian queens
Meresankh I	Ancient Egyptian queens, 3rd millennium BC
Huni	Pharaohs
Peace treaty	Treaties, Documents, Dispute resolution
Khaba	Pharaohs
Monoamine oxidase inhibitor	Drugs used in psychiatry
Isoform	Molecular biology, Biochemistry
Google Wave	Google
Cherith Baldry	1947 births, Living people
Annihilationism	Christian eschatology, Afterlife
Wenzhou	Cities in China, Zhejiang
Mejirodai	Settlements in Tokyo Prefecture, Neighborhoods
Swiss Family Robinson	Movies based on books, 1960 movies, English-language movies, Movies set in islands
Fabrosaurus	Ornithischia, Dinosaurs of Africa
Lesothosaurus	Ornithischia
Stygimoloch	Pachycephalosauria
Hypacrosaurus	Hadrosauridae
Kesha	1987 births, Living people, American LGBT rights activists, American pop musicians, Kesha, Musicians from Nashville, Tennessee, Singers from Nashville, Tennessee, Writers from Nashville, Tennessee, Singer-songwriters from California, Singers from Los Angeles, California, Bisexual people
Abbotsford, British Columbia	Cities in British Columbia, 1892 establishments in North America, 1890s establishments in Canada
Gus Bodnar	1923 births, 2005 deaths, Boston Bruins players, Canadian ice hockey centres, Chicago Blackhawks players, Ice hockey people from Ontario, People from Thunder Bay, Toronto Maple Leafs players, Stanley Cup champions, Calder Trophy winners
Danny Bois	1983 births, American Hockey League players, Canadian ice hockey right wingers, Ice hockey people from Ontario, Living people, Ontario Hockey League players, Ottawa Senators players, People from Thunder Bay
Vanua Levu	Islands of Fiji
HiT Entertainment	Companies of the United Kingdom, Entertainment companies, 1980 establishments in the United Kingdom, 1980s establishments in the United Kingdom
Apple A4	Microprocessor design, Apple hardware, 2010
IPhone 4	IPhone, Mobile phones released in 2010
Champlin, Minnesota	Cities in Minnesota
Fred Hollows	1929 births, 1993 deaths, Australian educators, Australian medical doctors, Australian of the Year Award winners, Cancer deaths in New South Wales, Deaths from kidney cancer, New Zealand scientists, People from Dunedin
Procompsognathus	Coelophysidae
Saltopus	Reptiles, Fossils
Baroness Sophie Buxhoeveden	1883 births, 1956 deaths
Grand Duchess Olga Alexandrovna of Russia	1882 births, 1960 deaths, Russian grand dukes and duchesses, House of Holstein-Gottorp-Romanov
Tori Amos	American singer-songwriters, Mezzo-sopranos, People from Salisbury, Maryland, Musicians from Baltimore, Maryland, Singers from Baltimore, Maryland, Writers from Baltimore, Maryland, Singers from North Carolina, 1963 births, Living people
Computer vision	Computers
Catal Huyuk	Ancient history, Archaeological sites in Asia, World Heritage Sites in Turkey
Tui Sutherland	1978 births, Living people, American writers
Blood and soil	Political philosophy, Nazism
Argentinosaurus	Titanosaurs, Cretaceous dinosaurs
National Public Radio	1970 establishments in the United States, Radio
Propithecus	Lemuriformes
Hornbill	Coraciiformes
Weaver ant	Ants
Bellbird	Passeriformes
Greater bulldog bat	Bats, Mammals of North America, Mammals of South America
Chelsea Grin (band)	2000s American music groups, 2010s American music groups, Deathcore bands, Musical groups from Utah, Salt Lake City, Musical groups established in 2007, 2007 establishments in the United States, 21st-century establishments in Utah
Ogden, Utah	Ogden, Utah, County seats in Utah, 1846 establishments in the United States, 19th-century establishments in Utah
Macleans College	Schools in New Zealand, Auckland, 1980 establishments in Oceania, 20th-century establishments in New Zealand
Hattusili III	Hittite Empire, Mesopotamian people
Garfield and Friends	Animated television series, 1988 television series debuts, CBS network shows, 1994 television series endings, English-language television programs
Heungseon Daewongun	1820 births, 1898 deaths, Korean politicians, Regents
Marc Ferrez	1843 births, 1923 deaths, Brazilian photographers
XSLT	Programming languages
Goo Ha-ra	1991 births, 2019 deaths, People who committed suicide, South Korean movie actors, South Korean television actors, South Korean singers, K-pop singers
Avimimus	Oviraptorosauria, Feathered dinosaurs
Merv Griffin	1925 births, 2007 deaths, Actors from San Mateo County, California, LGBT people from California, American movie actors, American radio actors, American radio personalities, American stage actors, American television actors, American television presenters, American voice actors, Bisexual people, Businesspeople from California, Cancer deaths in Los Angeles, Deaths from prostate cancer, Emmy Award winners, LGBT actors, LGBT broadcasters, LGBT businesspeople, Musicians from California, Television personalities from California, People from San Mateo, California
Thescelosaurus	Hypsilophodontidae
Segnosaurus	Cretaceous dinosaurs, Dinosaurs of Asia, Theropods
Riojasaurus	Prosauropods
Nicol David	1983 births, Living people, Malaysian sportspeople, Squash (sport)
Penang	States of Malaysia
Karnak	Ancient Egypt
Orochimaru (Naruto)	Science fiction, Naruto
Answerbag	Websites, 2003 establishments, 2015 disestablishments
Constitution of the United Kingdom	Government of the United Kingdom, Constitutions
German philosophy	Germany, Philosophy
Ghee	Dairy products, Indian food, Pakistani food
Library of Alexandria	Ancient Egypt, Libraries, Alexandria
International Auxiliary Language Association	Language
Ubaldo Jiménez	Colorado Rockies players, 1984 births, Living people, Baltimore Orioles players
JavaScript engine	JavaScript
Upper Volta	History of France
Oxford spelling	Vocabulary, English language
Chanelle Hayes	Big Brother contestants, English models, English pop musicians, English singers, Musicians from Cheshire, Musicians from West Yorkshire, Reality television participants, Television personalities from Cheshire, Television personalities from Yorkshire, 1987 births, Living people
East Riding of Yorkshire	East Riding of Yorkshire, Ceremonial counties of England
Daniel Inouye	1924 births, 2012 deaths, American military personnel of World War II, Deans of the United States Senate, Disease-related deaths in Maryland, Politicians from Honolulu, Presidents pro tempore of the United States Senate, Purple Heart recipients, United States Army Medal of Honor recipients, United States representatives from Hawaii, United States senators from Hawaii, US Democratic Party politicians
Martin Niemöller	1892 births, 1984 deaths, Christian ministers, Christian religious leaders, Christian theologians, German Lutherans, German military personnel of World War I, German people of World War II, German poets, German prisoners, German theologians, Holocaust survivors, Order of Merit of the Federal Republic of Germany, People from North Rhine-Westphalia
First they came...	Nazi Germany, Poems
ARP Spoofing	Computers, Internet, Internet protocols
History of slave trade	History
A36 steel	Alloys
Yorkshire County Cricket Club	Cricket clubs, Yorkshire
Headingley Stadium	Leeds, Sports buildings in the United Kingdom
Headingley	Leeds
Headingley railway station	Leeds, Railway stations in England, 1849 establishments in England
North Marine Road	Scarborough, North Yorkshire, Cricket
Burley Park railway station	Leeds, Railway stations in England
Burley, Leeds	Leeds
The Leeds Studios	ITV, Leeds
Hatshepsut	Ancient Egypt, Pharaohs
Slime mould	Microbiology, Protista
Mouse deer	Even-toed ungulates
Crab spider	Spiders
Julia Gillard	1961 births, Living people, Commonwealth Chairpersons-in-Office, Australian Labor Party politicians, Deputy Prime Ministers of Australia, People from Adelaide, Politicians from Glamorgan, Politicians from Melbourne, Politicians from South Australia, Prime Ministers of Australia, Republicans, Welsh politicians, University of Adelaide alumni
The Political Cesspool	Radio programs
Dino Bravo	1948 births, 1993 deaths, Canadian professional wrestlers, Former WWE wrestlers, Murder victims, Murders by firearm, Unsolved murders
Our Lady Peace	1990s music groups, 1992 establishments in Canada, 2000s music groups, 2010s music groups, Canadian rock bands, Post-grunge bands, Our Lady Peace
Katie Weatherston	1983 births, Canadian ice hockey forwards, Canadian Olympic gold medalists, Ice hockey people from Ontario, Living people, Medalists at the 2006 Winter Olympics, People from Thunder Bay
Council of Constance	Christianity in Germany, Councils, History of Germany, Konstanz, Roman Catholicism, 1410s, History of Switzerland
Pythagorean triple	Mathematics
Summer of 4 Ft. 2	The Simpsons (season 7) episodes, 1996 television episodes
Homerpalooza	The Simpsons (season 7) episodes, 1996 television episodes
Christian Wulff	1959 births, Living people, Ministers-President of Lower Saxony, Order of Merit of the Federal Republic of Germany, People from Osnabrück, Politicians from Lower Saxony, Presidents of Germany
United States presidential doctrines	History of the United States
Jens Böhrnsen	1949 births, Living people, German judges, German lawyers, Mayors of Bremen, Politicians from Bremen (state), Politicians of the Social Democratic Party of Germany, Presidents of Germany
Moncrabeau	Communes in Lot-et-Garonne
Claude Bernard	1813 births, 1878 deaths, Physiology, French scientists
Vivisection	Surgery
Lee Kuan Yew	Prime Ministers of Singapore, People's Action Party (Singapore) politicians, Members of the Cabinet of Singapore, 1923 births, 2015 deaths, Deaths from pneumonia, Companions of Honour, Knights Grand Cross of the Order of St Michael and St George, Singaporean politicians, Political office-holders in Singapore, Autobiographers
Wednesday Morning, 3 AM	1964 albums, Folk albums
Three 6 Mafia	Musical groups from Tennessee, American rap music groups, Hip hop bands, Best Original Song Academy Award-winning songwriters, Musical groups established in 1991, 1991 establishments in the United States, 1990s establishments in Tennessee
Hotspot (geology)	Geological formations
Beautiful Girls (movie)	1996 romance movies, 1996 comedy-drama movies, 1990s romantic comedy movies, 1990s romantic drama movies, American comedy-drama movies, American romantic comedy movies, American romantic drama movies, English-language movies
Teimour Radjabov	1987 births, Living people, Azerbaijani chess players, People from Baku, Chess grandmasters
Rumble Fighter	Online games, Massively multiplayer online role-playing games
Peak oil	Energy
Corgi	Dog breeds
Dave Bolland	1986 births, Canadian ice hockey centres, Chicago Blackhawks players, Florida Panthers players, Ice hockey people from Ontario, Living people, Sportspeople from Toronto, Stanley Cup champions, Toronto Maple Leafs players, American Hockey League players, Ontario Hockey League players, Memorial Cup winners
Middlesex	Middlesex
Ernst Heinrich Meier	1813 births, 1866 deaths, German people
Chico Slimani	Dancing on Ice participants, Moroccan entertainers, The X Factor contestants, Welsh pop musicians, Welsh singers, 1971 births, Living people
Recaredo Santos Tornero	People from Valparaíso, Chilean journalists, 1842 births, 1902 deaths
Madonna discography	Madonna (entertainer), Discographies
Addictive personality	Personal life, Addiction
Nexus (professional wrestling)	WWE teams and stables, 2010 establishments, 2011 disestablishments
British Film Institute	British movies
Yasuhito Endo	1980 births, Living people, Footballers from Kagoshima Prefecture, Japan international footballers, J1 League players, J2 League players, Yokohama Flügels players, Kyoto Sanga FC players, Gamba Osaka players, Júbilo Iwata players, 2006 FIFA World Cup players, 2010 FIFA World Cup players, 2014 FIFA World Cup players, 2003 FIFA Confederations Cup players, 2005 FIFA Confederations Cup players, 2013 FIFA Confederations Cup players
Leader of the Opposition (New Zealand)	Leaders of the Opposition (New Zealand), Politics of New Zealand
Premier of Victoria	Premiers of Victoria
El Mercurio de Valparaíso	Newspapers in South America, Valparaíso, 1827 establishments, 19th-century establishments in Chile, 1820s establishments in South America
Valparaíso	Valparaíso
Azoximer bromide	Immunology, Biochemistry
Ray Traylor	American professional wrestlers, Sportspeople from Georgia (U.S. state), Deaths from myocardial infarction, Former WWE wrestlers, 1963 births, 2004 deaths
Chilliwack	Cities in British Columbia, 1873 establishments in Canada
Whitesnake	1978 establishments in the United Kingdom, 1970s British music groups, 1980s British music groups, 1990s British music groups, 2000s British music groups, 2010s British music groups, English hard rock bands, Musical groups established in 1978, Musical groups from Yorkshire
Printer (publishing)	Printers
Kris Aquino	1971 births, Living people, Filipino actors, Corazon Aquino
List of infectious diseases	Infectious diseases, Disease-related lists
University of Melbourne	1853 establishments in Oceania, 1850s establishments in Australia, Buildings and structures in Melbourne, Colleges and universities in Australia
Fabiano Caruana	1992 births, Living people, Sportspeople from Miami, Florida, American chess players, Italian people, Chess grandmasters
Twig	Trees
2010 Tour de France	2010 in Europe, 2010 in sports, 2010s in Belgium, 2010s in France, 2010s in the Netherlands, Sport in Belgium, Sport in France, Sport in the Netherlands, Tour de France
Growth ring	Climate, Trees
Albert Esch	1883 births, 1954 deaths, Austrian painters, Czech people, Painters
José Manuel Balmaceda	1838 births, 1891 deaths, Presidents of Chile
Ozymandias	19th-century British poems
ESCP Europe	Education in France
Norwich International Airport	Airports in England, Norwich
International Air Transport Association airport code	Airports, Geocodes
International Civil Aviation Organization airport code	Airports, Geocodes
Boston	1630 establishments in Massachusetts, Boston, Massachusetts, County seats in Massachusetts, State capitals in the United States
Parti Québécois	Nationalist organizations in North America, Social democratic parties, Political parties in Canada, Quebec
Wheel gymnastics	Gymnastics
Trampolining	Gymnastics
Priapulida	Minor phyla
Kinorhyncha	Minor phyla
Loricifera	Minor phyla, Extremophiles
Saturation (chemistry)	Chemistry
Sulphide	Chemistry
Sulphate	Chemistry
L'Atalante basin	Oceanography, Earth sciences
Tactical voting	Voting
Queensberry (band)	2000s German music groups, 2010s German music groups, German pop music groups, Girl groups, Musical groups disestablished in 2013, Musical groups established in 2008
Strait of Gibraltar	Straits, Geography of Morocco, Geography of Spain
Hurricane Fran	Hurricanes in Virginia, Hurricanes in North Carolina, Hurricanes in South Carolina
Type 1 diabetes	Diabetes mellitus, Autoimmune diseases
Eagle Mountain (Minnesota)	Geography of Minnesota, Mountains of the United States
Al Franken	Comedians from New York City, American movie actors, American screenwriters, American television actors, US Democratic Party politicians, Emmy Award winners, Grammy Award winners, Harvard University alumni, Actors from Minnesota, United States senators from Minnesota, Politicians from New York City, Politicians from Minneapolis, Minnesota, Actors from New York City, Writers from New York City, Writers from Minneapolis, Minnesota, 1951 births, Living people, Comedians from Minnesota
Minneapolis–Saint Paul	Cities in Minnesota, Saint Paul, Minnesota, Minneapolis, Minnesota, Metropolitan areas of the United States
Arrowhead Region	Geography of Minnesota
Misquah Hills	Geography of Minnesota, Wilderness Areas of the United States, Landforms of the United States
Sawtooth Mountains (Minnesota)	Geography of Minnesota, Mountains of the United States
Leaf Hills Moraines	Geography of Minnesota, Hills
Minnesota Democratic–Farmer–Labor Party	Minnesota, Political parties in the United States, United States Democratic Party, 1944 establishments in the United States, 1940s establishments in Minnesota
List of United States senators from Minnesota	United States senators from Minnesota, Lists of politicians from the United States
Governor of Minnesota	Governors of Minnesota
Okutama, Tokyo	Towns in Japan, Settlements in Tokyo Prefecture
Flag of Minnesota	United States state flags, Minnesota
Seal of Minnesota	Minnesota, United States state seals
Sweet corn	Vegetables
Alternative country	Country music
Upper Midwest	Midwestern United States
Animikie Group	Geology, Mountain ranges, Mountains of the United States, Mountains of Canada
Hail! Minnesota	Minnesota, 1900s establishments in Minnesota, United States state songs
Morchella	Edible fungi
Cypripedium reginae	Orchids
Lake Superior agate	Gemstones
Wild rice	Rice
Red pine	Conifers, Plants of North America
L'Étoile du Nord	Minnesota, Mottos
Grace (photograph)	Photography
Walleye	Edible fish, Perciformes, Freshwater fish
Minnesota Territory	1849 establishments in the United States, 1850s disestablishments in the United States, 1840s in the United States, History of Minnesota, 1858 disestablishments, Former territories of the United States
Constitution of Australia	Government of Australia, Constitutions
Wildlife management	Ecology
Drift velocity	Velocity
Alex Auld	1981 births, American Hockey League players, Boston Bruins players, Canadian ice hockey goaltenders, Dallas Stars players, ECHL players, Florida Panthers players, Ice hockey people from Alberta, Living people, Ontario Hockey League players, Ottawa Senators players, People from Thunder Bay, Phoenix Coyotes players, Vancouver Canucks players
Grove (nature)	Trees
Igor Sikorsky	1889 births, 1972 deaths, Russian people, Aviators, Eastern Orthodox Christians, Russian inventors, American inventors
Food poisoning	Illnesses, Food and drink
Rungrado May Day Stadium	Stadiums in Asia, Pyongyang, Buildings and structures in Korea, 1989 establishments in Asia, Establishments in North Korea
Badwater Basin	Geography of California, Drainage basins
Brian Campbell	1979 births, Living people, Buffalo Sabres players, Canadian ice hockey defencemen, Chicago Blackhawks players, Florida Panthers players, San Jose Sharks players, Stanley Cup champions, Ice hockey people from Ontario, American Hockey League players, Ontario Hockey League players, Memorial Cup winners, Lady Byng Memorial Trophy winners
Bush Doctrine	Politics of the United States
Truman Doctrine	Cold War, 1947 in the United States
God Defend New Zealand	National anthems, New Zealand
Troy Hudson	1976 births, Living people, People from Carbondale, Illinois, African-American basketball players, Sportspeople from Illinois, Golden State Warriors players, Los Angeles Clippers players, Minnesota Timberwolves players, Orlando Magic players, Utah Jazz players, American basketball players
Target Center	Target Corporation, National Basketball Association, Sports buildings in Minneapolis, Minnesota, 1990 establishments in the United States, 1990s establishments in Minnesota
John Joseph Woods	1849 births, 1934 deaths, People from Tasmania, New Zealand people, Composers, Australian composers
FC Twente	Dutch football clubs, Enschede
James and the Giant Peach (movie)	1996 movies, Disney animated movies, Movies based on books, English-language movies
Eddie Griffin (basketball)	1982 births, 2007 deaths, African-American basketball players, Houston Rockets players, Minnesota Timberwolves players, Sportspeople from Philadelphia, Pennsylvania, American basketball players
Target Field	Target Corporation, Major League Baseball venues, Sports buildings in Minneapolis, Minnesota, Minnesota Twins, 2010 establishments in the United States, 21st-century establishments in Minnesota
Xcel Energy Center	2000 establishments in the United States, Saint Paul, Minnesota, Sports buildings in the United States, Buildings and structures in Minnesota, 21st-century establishments in Minnesota
Honeycrisp	Apples
Tom Pyatt	1987 births, American Hockey League players, Canadian ice hockey centres, ECHL players, Ice hockey people from Ontario, Living people, Montreal Canadiens players, Ontario Hockey League players, Ottawa Senators players, People from Thunder Bay, Swedish Hockey League players, Tampa Bay Lightning players
Paper mill	Manufacturing buildings, Industries, Paper
Louise Glück	1943 births, Living people, American Nobel Prize winners, American poets, Columbia University alumni, Jewish American academics, Jewish American writers, Jewish Nobel Prize winners, Pulitzer Prize winners, Writers from New York City
Sailing	Sailing, Summer Olympic sports
Ben Gibbard	1976 births, Living people, Singers from Washington
Danny Lennon	1970 births, Living people, Irish footballers
Chip Ganassi Racing	NASCAR, IndyCar Series
Ishmaelites	Arab world, Old Testament people, History of the Middle East, Semitic peoples
SOAP	Internet protocols
Jamaica, Land We Love	Jamaica, National anthems, 1962 establishments in North America, 1960s establishments in Jamaica
Bethel, Maine	Cities in Maine, 1796 establishments in the United States, 1790s establishments in Maine
List of Madonna tours	Madonna (entertainer), Concert tours, Music-related lists
Usain Bolt	1986 births, Living people, 2012 Summer Olympics, Jamaican sportspeople, Male athletes, Olympic gold medalists, Sprinters
Ghebaleh	cities in Lebanon
Cinchona pubescens	Rubiaceae, Ecuador
International Friendship Day	Holidays
Joseph Merrick	1862 births, 1890 deaths, Accidental deaths in the United Kingdom, English entertainers, People from Leicester
John Logie Baird	1888 births, 1946 deaths, Cardiovascular disease deaths in England, Deaths from stroke, Scottish inventors, Scottish scientists
The Co-operative Food	Supermarkets of the United Kingdom
Co-operative Group	Business
Somerfield	Supermarkets of the United Kingdom, Defunct companies of the United Kingdom, 1875 establishments in the United Kingdom, 2009 disestablishments in the United Kingdom
Alvin and the Chipmunks (movie)	American comedy movies, 2007 movies, 20th Century Fox movies, Alvin and the Chipmunks movies
AIDS orphan	HIV/AIDS
Hejaz	Geography of Saudi Arabia
Endianness	Microprocessor design
Mercedes AMG High Performance Powertrains	Formula One engine manufacturers
Age of majority	Legal terms
Parvicursor	Coelurosaurs, Fossils, Cretaceous dinosaurs
Caenagnathasia	Oviraptorosauria, Fossils
Anchiornis	Coelurosaurs, Jurassic dinosaurs
Šumadija	Šumadija
New York Hall of Science	Museums in New York City, 1964 establishments in New York (state), Queens (New York City)
Guadarrama	Municipalities in the Community of Madrid
Cia-Cia language	Austronesian languages
Elmer Gedeon	1917 births, 1944 deaths, American baseball players, American military personnel of World War II, Burials at Arlington National Cemetery, Major League Baseball players, Military people killed in World War II, Purple Heart recipients, Sportspeople from Cleveland, Ohio
Scott Hall	1958 births, American murderers, American professional wrestlers, Former WWE wrestlers, Living people, Sportspeople from Florida, Total Nonstop Action Wrestling alumni, WWE Hall of Fame
August Rush	2007 drama movies, American drama movies, Movies set in California
Wikimania	Wikimedia, 2005 establishments
Bob the Builder	Channel 5 (UK) television programmes, 1999 television series debuts, 1990s television series, 2000s television series, 2010s television series, 2011 television series endings, Children's television series, PBS Kids shows, Television characters, CBeebies
Free license	Licenses, Free content
Padlock	Locks
Market economy	Economics
Mayra Verónica	1980 births, Living people, American models, American singers, Cuban musicians, Latin singers, People from Havana
Epidexipteryx	Coelurosaurs, Fossils, Jurassic dinosaurs
Driver	Vehicles
Taylor Lautner	1992 births, Living people, Actors from Michigan, American movie actors, American voice actors, Actors from Grand Rapids, Michigan
Hanyu Shuiping Kaoshi	Chinese language
Foxtrot	Ballroom dances
United Service Organizations	United States Army, 1941 establishments in the United States
Symphony No.8 "Symphony of a Thousand" (Mahler)	Symphonies, Compositions by Gustav Mahler, Faust
Simon Boccanegra	Compositions by Giuseppe Verdi, Operas
Fire hydrant	Fire
Betty Grable	1916 births, 1973 deaths, Actors from St. Louis, Missouri, American dancers, American movie actors, American television actors, Cancer deaths in California, Deaths from lung cancer, Singers from Missouri
Geyser	Geysers
Charles Mackerras	1925 births, 2010 deaths, People from Schenectady, New York, Conductors, Grammy Award winners, Oboists, Order of Australia, Gilbert and Sullivan
Renault Mégane	Renault automobiles, 1990s automobiles, 2000s automobiles, 2010s automobiles
Ryan Atwood	Television characters
Renault Laguna	Renault automobiles, 1990s automobiles, 2000s automobiles, 2010s automobiles
Tata Indica	1990s automobiles, 2000s automobiles, 2010s automobiles
Market capitalization	Business, Legal terms
Vernon and Irene Castle	People from Norwich, English dancers, English entertainers, People from New Rochelle, New York, Models from New York, American dancers, American entertainers, Vaudeville performers, 1887 births, 1918 deaths, 1893 births, 1969 deaths
Fiat Stilo	Fiat automobiles, 2000s automobiles, 2010s automobiles
Fiat Doblò	Fiat automobiles, 1990s automobiles, 2000s automobiles, 2010s automobiles
Payment	Money, Finance, Commerce
Pedro Martinez	1971 births, Living people, Dominican Republic sportspeople
Remy Zero	American rock bands, Post-grunge bands, Musical groups from Alabama, Entertainers from Birmingham, Alabama
Matthew Broderick	1962 births, Living people, Actors from Manhattan, American movie actors, American stage actors, American television actors, American voice actors, Jewish American actors, Tony Award winning actors
Everyone Says I Love You	1990s musical movies, 1996 comedy movies, American musical comedy movies, Movies directed by Woody Allen, English-language movies
Hurricane Allen	Hurricanes in Mexico, Deadly storms, Hurricanes in the United States, 1980, 1980s in Mexico, 1980s in Texas
Housecleaning	Home
Tom Welling	1977 births, Living people, American movie actors, American television actors, Actors from New York
Make Way for Ducklings	1941 books, English-language picture books
Sequence dance	Dance types
Škoda Felicia	Škoda automobiles, 1990s automobiles, 2000s automobiles
Minos	People in Greek mythology
Paso doble	Latin dances, Music genres, Spanish culture
Daedalus	People in Greek mythology
Emergency medical dispatcher	Medical emergencies
Santa Cruz, Chile	Cities in Chile, Settlements in the Region of O'Higgins
Bircham International University	1992 establishments
Drew Hankinson	1983 births, Former WWE wrestlers, Living people, Sportspeople from Maryland, Total Nonstop Action Wrestling alumni
Emirates (airline)	Airlines of the Middle East, United Arab Emirates
San Jose State Spartans	Sports clubs, Western Athletic Conference, Sports in California
Mossad	Mossad
Fiat Idea	Fiat automobiles, Front wheel drive vehicles, 2000s automobiles, 2010s automobiles
Fiat Fiorino	Fiat automobiles, 1970s automobiles, 1980s automobiles, 1990s automobiles, 2000s automobiles, 2010s automobiles
DC Shoes	American clothing companies, 1993 establishments in the United States
Tigger	Characters in written fiction, Fictional animals, Disney characters, Kingdom Hearts characters
Brewer, Maine	Towns in Maine
Curt Hawkins and Zack Ryder	WWE teams and stables
Pump action shotgun	Shotguns
Jacob Black	Characters in written fiction, Fictional American people, Fictional characters introduced in 2005, Movie characters, Science fiction, Washington (U.S. state)
Living room	Home, Rooms
Winter swimming	Fitness, Survival skills, Water sports, Swimming
Zombieland	2009 comedy movies, 2009 horror movies, 2000s adventure movies, 2000s road movies, American adventure movies, American comedy movies, American horror movies, American road movies, Comedy horror movies, English-language movies, Screenplays by Paul Wernick, Screenplays by Rhett Reese, Zombie movies, Post-apocalyptic movies
Dragunov sniper rifle	Rifles
Alyson Stoner	1993 births, Living people, American movie actors, American television actors, Disney actors, American dancers, Actors from Ohio, People from Toledo, Ohio
Woody Harrelson	1961 births, Living people, Actors from Texas, American movie actors, American television actors, People acquitted of crimes, Vegetarians, People from Midland, Texas
Death at a Funeral (2010 movie)	2010 movies, 2010s comedy movies, English-language movies, Movies directed by Neil LaBute
Persian cat	Cat breeds
Botanical garden	Botanical gardens
Pentateuch	Old Testament books
Butt plug	Human sexuality
Padang	Cities in Indonesia, 1669 establishments, Establishments in Indonesia, 17th century establishments in Asia
Australian Grand Prix	Formula One Grands Prix, 1985 establishments in Australia
Eschatology	Eschatology
SEAT Altea	SEAT automobiles, 2000s automobiles, 2010s automobiles
SEAT Córdoba	SEAT automobiles, 1990s automobiles, 2000s automobiles
SEAT León	SEAT automobiles, 1990s automobiles, 2000s automobiles, 2010s automobiles
List of governors of California	Lists of governors, Governors of California, California-related lists
Malaysian Grand Prix	Formula One Grands Prix
Alfa Romeo 155	Alfa Romeo automobiles, 1990s automobiles
Fragments (movie)	2008 movies, 2000s crime drama movies, English-language movies, American independent movies
Chinese Grand Prix	Formula One Grands Prix
Audi A2	Audi automobiles, 1990s automobiles, 2000s automobiles
Volkswagen Golf Mk4	Volkswagen Golf, 1990s automobiles, 2000s automobiles
Volkswagen Golf Mk3	Volkswagen Golf, 1990s automobiles, 2000s automobiles
Frederick Russell Burnham	1861 births, 1947 deaths, American activists, American explorers, British military people, Majors, People from Minnesota, People of the Boer Wars, Scouting
Volkswagen Golf Mk5	Volkswagen Golf, 2000s automobiles
OS/2	Operating systems
Puffin	Seabirds, Charadriiformes
Dance Flick	2009 comedy movies, 2009 movies, American musical comedy movies, 2000s parody  movies, 2000s teen comedy  movies, American movies, American musical comedy  movies, American parody  movies, American teen comedy  movies, English-language  movies, Movies set in Manhattan, Movies set in New York City
Quickstep	Ballroom dances
Steve Passmore	1973 births, American Hockey League players, Canadian ice hockey goaltenders, Chicago Blackhawks players, Edmonton Oilers players, Ice hockey people from Ontario, Kamloops Blazers players, Living people, Los Angeles Kings players, People from Thunder Bay, Tri-City Americans players, Victoria Cougars (1971–94) players, ECHL players, International Hockey League (1945–2001) players, Memorial Cup winners
Waltz (International)	Ballroom dances
The Arrogant Worms	Canadian musical groups, Musical groups established in 1991, 1991 establishments in Canada
Turkish Grand Prix	Formula One Grands Prix
Arn Anderson	1958 births, Former WWE wrestlers, Living people, Sportspeople from Charlotte, North Carolina, WWE Hall of Fame
Absolut Vodka	Alcoholic spirits
Naveed (album)	1994 albums, Our Lady Peace albums, Debut albums, Rock albums
Clumsy (album)	1997 albums, Our Lady Peace albums
Happiness... Is Not a Fish That You Can Catch	1999 albums, Our Lady Peace albums
Tracking (education)	Education
Declaration of Montreal	LGBT, Human rights
Basshunter	1984 births, Living people, People acquitted of sex crimes, Celebrity Big Brother contestants, Swedish singers, Swedish record producers, DJs, Electronic musicians, Pop musicians, Basshunter
James Yun	American professional wrestlers, 1981 births, Sportspeople from Los Angeles, California, Former WWE wrestlers, Living people
Lindsey Vonn	1984 births, Living people, 2002 Winter Olympics, 2006 Winter Olympics, 2010 Winter Olympics, American Olympic gold medalists, American Olympic silver medalists, American skiers, Sportspeople from Minnesota
Gregory Helms	1974 births, American professional wrestlers, Former WWE wrestlers, Living people, Sportspeople from North Carolina, American bloggers
Natalya (wrestler)	1982 births, Living people, Female professional wrestlers, Canadian professional wrestlers, People from Calgary
Godsmack	American heavy metal bands, American hard rock bands
Monsieur Pierre	French dancers, 1963 deaths, 1890s births
Nazirite	Bible
Imperial Society of Teachers of Dancing	Dance
Arthur Murray	1895 births, 1991 deaths, Naturalized citizens of the United States, American dancers, Businesspeople from New York City
Occupational Safety and Health	Social sciences, Health
Suraj Narredu	Living people, 1985 births, Indian sportspeople, Equestrians
The Three Caballeros	1944 movies, Disney animated movies, American family movies, American musical movies, Movies composed by Oliver Wallace
Protocarnivorous plant	Plants
Nomar Garciaparra	1973 births, American League All-Stars, Baseball players from California, Boston Red Sox players, Chicago Cubs players, Living people, Los Angeles Dodgers players, Major League Baseball broadcasters, National League All-Stars, Oakland Athletics players, People from Whittier, California
Perez Hilton	Bloggers, Celebrity Big Brother contestants, Democrats (United States), Gay men, LGBT people from Florida, LGBT writers, Writers from Miami, Florida, 1978 births, Living people, American Internet celebrities, American bloggers
Hook-handed man	A Series of Unfortunate Events
Los Santos Province	Provinces of Panama
Andy Dick	1965 births, Living people, Actors from South Carolina, American LGBT people, American movie actors, American radio personalities, American television actors, American television personalities, Comedians from South Carolina, LGBT actors, LGBT comedians, People from Charleston, South Carolina
Anthony Norris	1963 births, Living people, African-American wrestlers, American professional wrestlers, Sportspeople from Indiana, Former WWE wrestlers
Rikishi (wrestler)	1965 births, American professional wrestlers, Living people, Sportspeople from San Francisco, WWE Hall of Fame
Cryme Tyme	WWE teams and stables
Road Dogg	1969 births, Living people, American professional wrestlers, Former WWE wrestlers, Sportspeople from Georgia (U.S. state), Total Nonstop Action Wrestling alumni, People from Marietta, Georgia
Epic Movie	2007 comedy movies, 2000s parody movies, American parody movies, English-language movies, 20th Century Fox movies
Keloid	Integumentary system
Coconut cake	Cakes
Evan Bourne	1983 births, American professional wrestlers, Former WWE wrestlers, Living people, Sportspeople from St. Louis, Missouri, Total Nonstop Action Wrestling alumni
Honda Racing F1	Formula One constructors, Formula One engine manufacturers
Emma Stone	1988 births, Living people, Actors from Arizona, American movie actors, American television actors, People from Scottsdale, Arizona, American Lutherans, People's Choice Award winners
Rick Pitino	College basketball coaches, National Basketball Association coaches, 1952 births, Living people, Sportspeople from New York City
Ben Coates	1969 births, Living people, Baltimore Ravens players, New England Patriots players
The Royal Ballet	Ballet companies
Money in the Bank (2010)	2010 in American television, 2010 in professional wrestling, Sports in Kansas City, Missouri, WWE Money in the Bank, 2010 in Missouri, History of Kansas City, Missouri, July events
Layla El	1978 births, English dancers, English professional wrestlers, Female professional wrestlers, Living people, Sportspeople from London
Eve Torres	1984 births, Living people, American professional wrestlers, Female professional wrestlers, Former WWE wrestlers, Sportspeople from Denver, Colorado
WWF Over the Edge	World Wrestling Entertainment pay-per-view events, 1998 establishments, 1999 disestablishments
False protagonist	Fiction
Solifugae	Arachnids
Eresus	Araneomorphae
Shoichi Funaki	1968 births, Living people, Former WWE wrestlers, Japanese professional wrestlers, Sportspeople from Tokyo
David Otunga	1980 births, American lawyers, American professional wrestlers, American television actors, Living people, People from Elgin, Illinois, Sportspeople from Illinois, WWE wrestlers
Abc notation	Music technology
Bread roll	Breads
MP-40	Submachine guns
Racial Harmony Day	Singapore, Holidays, Race
Jive (dance)	African-American history, Latin dances
Imperial Vengeance	British musical groups, English heavy metal bands
Albuquerque, New Mexico	1700s establishments in North America, 1706 establishments, 18th-century establishments in New Spain, Albuquerque, New Mexico, County seats in New Mexico
The Bella Twins	1983 births, Living people, Sportspeople from San Diego, California, Female professional wrestlers, Twin people from the United States, WWE wrestlers
Wade Barrett	1980 births, Living people, English professional wrestlers, People from Preston, Lancashire, Sportspeople from Lancashire, WWE wrestlers
Royal Oak, Michigan	Cities in Michigan
Dirge	Musical forms
Benediction	Christian genres
Diane Kruger	Satellite Award winners, Living people, 1976 births, Actors from Lower Saxony, German models, German movie actors, German television actors
Diagnostic and Statistical Manual of Mental Disorders	Medical manuals
B cell	Immunology, Blood cells
Performing arts	Performing arts, Non-verbal communication
Steve Brookstein	British jazz musicians, British soul musicians, English singers, Musicians from London, The X Factor winners, 1968 births, Living people
Albert Roussel	1869 births, 1937 deaths, French composers, People from Hauts-de-France
Troy (movie)	2004 movies, 2000s action movies, 2000s war movies, American action movies, American epic movies, American war movies, British action movies, British war movies, Maltese movies, Movies directed by Wolfgang Petersen, Movies based on Greek and Roman mythology
Wolfgang Petersen	1941 births, Living people, German movie directors, German movie producers, German screenwriters, People from Emden, Television directors, Television producers, Television writers
Emden	Port cities and towns of the North Sea
Gabor Acs	1926 births, Living people, Architects, Hungarian people
Table football	Football
Keith Magnuson	1947 births, 2003 deaths, Canadian ice hockey coaches, Canadian ice hockey defencemen, Chicago Blackhawks players, Ice hockey people from Saskatchewan, National Hockey League broadcasters, Saskatoon Blades players
Heidi Montag	Actors from Colorado, American models, American television actors, American television personalities, Celebrity Big Brother contestants, I'm a Celebrity...Get Me Out of Here! contestants, Singers from Colorado, 1986 births, Living people
Lauren Conrad	1986 births, Living people, Models from California, American bloggers
Spencer Pratt	1983 births, Living people, Celebrity Big Brother contestants, Participants in American reality television series, People from Los Angeles, California, Television personalities from California
Training Day	2001 crime movies, 2001 drama movies, 2001 thriller movies, 2000s crime drama movies, 2000s crime thriller movies, 2000s drama thriller movies, Academy Award winning movies, American crime drama movies, American crime thriller movies, American drama thriller movies, American gangster movies, Antisocial personality disorder in fiction, English-language movies, Film noir, Movies set in Los Angeles, California
Tosh.0	Comedy television series, 2000s American television series, English-language television programs
Daniel Tosh	Comedians from Florida, Living people, 1975 births, American television presenters
Veil	Culture, Human communication, Headgear
Anne Wills	1944 births, Living people, Australian television presenters, People from Victoria (Australia), Australian radio personalities
1240s	1240s
Asian tiger mosquito	Flies
French Island (Victoria)	Islands of Australia, Geography of Victoria, Australia
Leni Riefenstahl	1902 births, 2003 deaths, Actors from Berlin, German movie actors, German movie directors, German movie producers, German screenwriters
Olympia (1938 movie)	Sports movies, 1938 movies
Carbon paper	Paper
Billy Butler	Kansas City Royals players, 1986 births, Living people, American baseball players, Sportspeople from Florida
Karen Horney	1885 births, 1952 deaths, German psychiatrists
Aryan race	Race, Nazism, Indo-European
Eurovision Song Contest 2011	2011 in music, 2011 in Germany, Düsseldorf, Eurovision Song Contest, May 2011 events
Keynesian economics	Economic theories
Kaiser Chiefs	2000 establishments in England, 2000s British music groups, 2010s British music groups, Alternative rock bands, English rock bands, Leeds, Musical groups established in 2000, Musical groups from Yorkshire
Rob Zombie	1965 births, American rock singers, Heavy metal musicians, Living people, Movie directors from Massachusetts, Movie producers from Massachusetts, Singers from Massachusetts, Screenwriters from Massachusetts, People from Haverhill, Massachusetts
Elam	Mesopotamia, History of Iran
Dental braces	Orthodontics
Braces	Accessories
Doves (band)	1998 establishments in England, 1990s British music groups, 2000s British music groups, 2010s British music groups, Cheshire, English rock bands, Musical groups established in 1998
Shin-Soo Choo	1982 births, Living people, South Korean baseball players, Cincinnati Reds players, Cleveland Indians players, Seattle Mariners players, People from Busan, Texas Rangers players
Bryan Bickell	1986 births, Canadian ice hockey left wingers, Carolina Hurricanes players, Chicago Blackhawks players, Ice hockey people from Ontario, Living people, People with multiple sclerosis, Stanley Cup champions, American Hockey League players, Ontario Hockey League players
Khloé Kardashian	1984 births, Living people, American television personalities, Television personalities from Los Angeles, California, Participants in American reality television series, Kardashian family
Amar Ramasar	1981 births, Living people, Ballet dancers
2008 Kosovo declaration of independence	Declarations of independence
Equal justice under law	Law
Six-hour clock	Clocks
Grupo Santander	Banks, 1857 establishments in Europe, Cantabria, Companies of Spain
Canteen (bottle)	Containers
Canteen (place)	Restaurants
Surfboard	Sports equipment, Surfing
Škoda Yeti	Škoda automobiles, 2000s automobiles, 2010s automobiles, Sport utility vehicles
Hungarian Grand Prix	Formula One Grands Prix
Volkswagen Golf Mk6	Volkswagen Golf, 2000s automobiles, 2010s automobiles
NBC Symphony Orchestra	American orchestras, NBC, 1937 establishments, 1954 disestablishments
Gabriel Pierné	1863 births, 1937 deaths, French composers
The Flash	DC Comics superheroes, Comic books
Terry Wogan	1938 births, 2016 deaths, Deaths from cancer of unknown primary origin, BBC radio presenters, BBC television presenters, British entertainers, British radio personalities, British television personalities, Cancer deaths in England, Disease-related deaths in Buckinghamshire, Eurovision Song Contest presenters, Irish television presenters, Naturalised citizens of the United Kingdom, People from Limerick
Wake Up to Wogan	Radio programs
Attica Correctional Facility	Prisons, Buildings and structures in New York
Happy slapping	Types of crime
Eni	Companies of Italy, 1953 establishments in Europe, 1950s establishments in Italy
Mercedes GP	Formula One constructors, Formula One current, Formula One engine manufacturers
Germania (painting)	19th century paintings, National personifications
Philipp Veit	1793 births, 1877 deaths, German painters
Pöcking	Municipalities in Bavaria, Starnberg (district)
BMW Compact	BMW, 1990s automobiles, 2000s automobiles, Rear wheel drive vehicles
Volkswagen Jetta Mk2	Volkswagen automobiles, 1980s automobiles, 1990s automobiles
Alfa Romeo 159	Alfa Romeo automobiles, 2000s automobiles, 2010s automobiles
Damselfly	Odonata
Klinefelter syndrome	Syndromes, Trisomies
Rumba	Dance music, Latin dances
The Gadget Show	2004 British television series debuts, 2000s British television series, 2010s British television series, Channel 5 (UK) television programmes, English-language television programs
Bullfighting	Sport in Spain, Animal rights, Sports involving animals, Spanish culture
Casual sex	Human sexuality
Ice algae	Snow, Algae
Scuderia Toro Rosso	Formula One constructors, Formula One current
John Deere	1804 births, 1886 deaths, American inventors, Businesspeople from Illinois, American chief executives, American engineers, American mayors, Politicians from Vermont, Businesspeople from Vermont, Politicians from Illinois
Quena	Flutes, South American culture, World music
Fedor Emelianenko	1976 births, Living people, Russian sportspeople, Martial artists
Gyeonggi Province	Provinces of South Korea
Gondwana	Gondwana
Marc Staal	1987 births, Canadian ice hockey defencemen, Ice hockey people from Ontario, Living people, New York Rangers players, People from Thunder Bay, American Hockey League players, Ontario Hockey League players
Macrophage	Cells, Immunology
Granulocyte	Immunology, Blood cells
To Surveil with Love	The Simpsons episodes, 2010 television episodes
You Kent Always Say What You Want	The Simpsons episodes, 2007 in American television, Television episodes about profanity, 2007 television episodes
Dual carriageway	Roads
Sin tax	Taxation
N. Gregory Mankiw	1958 births, Living people, American economists, People from Trenton, New Jersey
Poznań Fortress	Buildings and structures in Poland, Poznań, Fortification
Vesoul	Communes in Haute-Saône, Departmental capitals in France
Hungaroring	Formula One circuits
Don Drysdale	1936 births, 1993 deaths, Baseball players from California, Los Angeles Dodgers players, Brooklyn Dodgers players, National League All-Stars
Building model	Buildings and structures, Architecture, Earthquake engineering, Modeling
Chuck Mangione	1940 births, Living people, American composers, Musicians from New York, People from Rochester, New York
Virgin Racing	Formula One constructors, Formula One current
The Jazz Singer (1927 movie)	1927 movies, United States National Film Registry movies, English-language movies
Love Parade disaster	2010 disasters, 2010 in Europe, 2010s disasters in Europe, 2010s in Germany, Disasters in Germany, Duisburg, History of North Rhine-Westphalia, July events
Manhattan Melodrama	1934 movies, 1930s drama movies, Academy Award winning movies, English-language movies, Movies directed by W. S. Van Dyke
Monocyte	Immunology, Blood cells
Brent Seabrook	1985 births, American Hockey League players, Canadian ice hockey defencemen, Canadian Olympic gold medalists, Chicago Blackhawks players, Ice hockey people from British Columbia, Lethbridge Hurricanes players, Living people, Stanley Cup champions
Viktor Stålberg	1986 births, American Hockey League players, Chicago Blackhawks players, Living people, Nashville Predators players, People from Gothenburg, Stanley Cup champions, Swedish Hockey League players, Swedish ice hockey players, Toronto Maple Leafs players
Brent Sopel	1977 births, American Hockey League players, Atlanta Thrashers players, Canadian ice hockey defencemen, Chicago Blackhawks players, Ice hockey people from Alberta, Living people, Los Angeles Kings players, Montreal Canadiens players, New York Islanders players, People from Calgary, Stanley Cup champions, Saskatoon Blades players, Swift Current Broncos players, Vancouver Canucks players, International Hockey League (1945–2001) players
Ben Eager	1984 births, American Hockey League players, Atlanta Thrashers players, Canadian ice hockey left wingers, Chicago Blackhawks players, Edmonton Oilers players, Ice hockey people from Ontario, Living people, People from Ottawa, Philadelphia Flyers players, San Jose Sharks players, Stanley Cup champions, Ontario Hockey League players
Bedtime Stories (movie)	2008 comedy movies, 2000s fantasy-comedy movies, American fantasy-comedy movies
San Francisco Chronicle	Newspapers in California, Companies based in San Francisco, 1865 establishments in the United States, 1860s establishments in California
Brecqhou	Islands of the Channel Islands, Guernsey
Hurricane Donna	Hurricanes in the United States, 20th century in Puerto Rico, 20th centuy in Haiti, 20th century in the Dominican Republic, 1960s in Cuba, 20th century in the Bahamas, 1960 in the United States, 1960s in Canada, Hurricanes in Virginia, Hurricanes in South Carolina
John Madden (ice hockey)	1973 births, Canadian ice hockey centres, Chicago Blackhawks players, Florida Panthers players, Ice hockey people from Ontario, Living people, Minnesota Wild players, New Jersey Devils players, Stanley Cup champions, American Hockey League players
C14 Timberwolf	Rifles
The Exterminators (TV series)	2009 television series debuts, American reality television series, English-language television programs
Convention on the Rights of Persons with Disabilities	Disability, Human rights, United Nations
Bethesda Game Studios	Video game companies
Accessibility	Disability
Nicolas-Joseph Cugnot	1725 births, 1804 deaths, French inventors
Classical antiquity	Ancient Greece, Ancient Rome
Casey Stengel	1890 births, 1975 deaths, American baseball players, Sportspeople from Missouri
Dora the Explorer	American children's television series, Animated television series, 1990s television series debuts, 2000 television series debuts, Nickelodeon television series
Dalby Forest	Forests of England, North Yorkshire
Avant Browser	Web browsers
Kris Versteeg	1986 births, American Hockey League players, Calgary Flames players, Canadian ice hockey right wingers, Carolina Hurricanes players, Chicago Blackhawks players, Florida Panthers players, Ice hockey people from Alberta, Kamloops Blazers players, Lethbridge Hurricanes players, Living people, Los Angeles Kings players, People from Lethbridge, Philadelphia Flyers players, Red Deer Rebels players, Stanley Cup champions, Toronto Maple Leafs players, Swedish Hockey League players
Kerry King	1964 births, Living people, Musicians from Los Angeles, California
Reign in Blood	1986 albums, Slayer albums
Joe Satriani	1956 births, Living people, American rock guitarists, Musicians from New York, American heavy metal musicians
Surfing with the Alien	1987 albums
For Whom the Bell Tolls (Metallica song)	1985 songs, Metallica
Surfing with the Alien (song)	1987 songs
Eddie Colón	1982 births, Living people, Puerto Rican professional wrestlers, People from San Juan, Puerto Rico
Frank White (baseball)	1950 births, Living people, American baseball players, Sportspeople from Mississippi, Kansas City Royals players
Imagine (John Lennon album)	1971 albums, John Lennon
Imagine (John Lennon song)	1971 songs, John Lennon
John Lennon/Plastic Ono Band	1970 albums, Rock albums, Folk albums, John Lennon
God (John Lennon song)	1970 songs
Tom Seaver	1944 births, 2020 deaths, Deaths from dementia with Lewy bodies, Deaths from the COVID-19 pandemic in the United States, Baseball players from California, Cincinnati Reds players, New York Mets players, Chicago White Sox players, Boston Red Sox players, National League All-Stars, People from Fresno, California
Kim Johnsson	1976 births, Chicago Blackhawks players, Living people, Minnesota Wild players, New York Rangers players, Philadelphia Flyers players, Swedish ice hockey players, People from Malmo, Swedish Hockey League players, Ice hockey defencemen
Craig Stansberry	1982 births, Living people, American baseball players
Kelly Slater	1972 births, Living people, Sportspeople from Florida, Surfers
Government of Canada	Government of Canada
List of Formula One circuits	Formula One circuits, Formula One current, Formula One lists
Omniverse	Universe
Lee Harvey Oswald	1939 births, 1963 deaths, American murder victims, American murderers, Assassins, Murdered criminals, Murders by firearm in the United States, People from New Orleans, Louisiana, United States Marine Corps personnel
Conspiracy	Legal terms, Politics
Race track	Sports buildings
Misdemeanor	Legal terms
County jail	Government buildings, Criminal justice, Punishments
Sheriff	Law enforcement occupations
Circle MRT line	2009 establishments in Asia, 2000s establishments in Singapore, Mass Rapid Transit (Singapore) lines
Battle of the Nile	Battles, 1790s in France, 18th century in the Kingdom of Great Britain, 1798, History of Egypt, August events
Gil Hodges	1924 births, 1972 deaths, Brooklyn Dodgers players, Los Angeles Dodgers players, National League All-Stars, New York Mets players, Sportspeople from Brooklyn
Mickey Mantle	American baseball players, Cancer deaths in the United States, Deaths from liver cancer, Organ transplant recipients, New York Yankees players, National Baseball Hall of Fame members, Sportspeople from Oklahoma, 1931 births, 1995 deaths
The Fame	2008 albums, Lady Gaga albums, Debut albums, Pop albums, Dance pop albums, R&B albums, Concept albums, Dance albums
President of Ukraine	Presidents of Ukraine
Prime Minister of Ukraine	Prime Ministers of Ukraine
Singapore Telecommunications	Singaporean companies
Cabinet of Ministers of Ukraine	Ukrainian politicians
Verkhovna Rada	Ukraine, National legislatures, 1938 establishments in Europe, 20th century establishments in Ukraine
List of amphibians of Russia	Russia-related lists, Amphibians, Lists of animals
How Do You Sleep?	1971 songs
Who's Next	1971 albums, Rock albums
The Song Is Over	1971 songs
Baba O'Riley	1971 songs
Katarina Waters	1980 births, Living people, English professional wrestlers, Former WWE wrestlers, Total Nonstop Action Wrestling alumni
Because (Beatles song)	The Beatles songs, 1969 songs
Come Together	The Beatles songs, 1969 songs
Something	The Beatles songs, 1969 songs
Marlboro (cigarette)	Smoking, Companies of the United States
Maxwell's Silver Hammer	The Beatles songs, 1969 songs
Oh! Darling	The Beatles songs, 1969 songs
Octopus's Garden	The Beatles songs, 1969 songs
I Want You (She's So Heavy)	The Beatles songs, 1969 songs
Here Comes the Sun	1969 songs, The Beatles songs
Reggie Jackson	1946 births, Living people, African-American baseball players, Baltimore Orioles players, California Angels players, Kansas City Athletics players, New York Yankees players, Oakland Athletics players, National Baseball Hall of Fame members, Sportspeople from Pennsylvania
Spiritual Machines	2000 albums, Our Lady Peace albums
Gravity (Our Lady Peace album)	2002 albums, Our Lady Peace albums
Healthy in Paranoid Times	2005 albums, Our Lady Peace albums
Burn Burn (album)	2009 albums, Our Lady Peace albums
Raine Maida	1970 births, Living people, Canadian singers, People from Ontario, Rock musicians
Order of the Arrow	Scouting
Lingua franca	Languages
Sauber	Formula One constructors, Formula One current
Lawrence, Kansas	1854 establishments in Kansas Territory, Bleeding Kansas, County seats in Kansas, Lawrence, Kansas, Oregon Trail
Hilo, Hawaii	Hilo, Hawaii, County seats in Hawaii
Lennon–McCartney	The Beatles, John Lennon, Paul McCartney
Birmingham Triennial Music Festival	Birmingham, Classical music festivals, Music festivals in England, 1784 establishments, 1780s establishments in England, 1912 disestablishments, 20th century disestablishments in England
You Never Give Me Your Money	The Beatles songs, 1969 songs
Whenever You Need Somebody (song)	1987 songs, Rick Astley songs
Sun King (song)	The Beatles songs, 1969 songs
Alan Gray	1855 births, 1935 deaths, English organists, English composers
Mean Mr. Mustard	The Beatles songs, 1969 songs
Magnificat	Christian hymns, Mary (mother of Jesus)
Nunc dimittis	Christian hymns
Zangalewa	1986 songs
Polythene Pam	The Beatles songs, 1969 songs
She Came in Through the Bathroom Window	The Beatles songs, 1969 songs
The End (Beatles song)	The Beatles songs, 1969 songs
History of ancient Israel and Judah	Ancient Israel and Judah
Golden Slumbers	The Beatles songs, 1969 songs
Carry That Weight	1969 songs, The Beatles songs
Her Majesty (song)	The Beatles songs, 1969 songs
Sgt. Pepper's Lonely Hearts Club Band (song)	The Beatles songs, 1967 songs
With a Little Help from My Friends	1967 songs, The Beatles songs, Works about friendship
Lucy in the Sky with Diamonds	The Beatles songs, 1967 songs
Getting Better	The Beatles songs, 1967 songs
Fixing a Hole	The Beatles songs, 1967 songs
Ian MacDonald	1948 births, 2003 deaths, British writers
She's Leaving Home	The Beatles songs, 1967 songs
Being for the Benefit of Mr. Kite!	The Beatles songs, 1967 songs
Within You Without You	The Beatles songs, 1967 songs
Rocks (album)	1976 albums, Rock albums, Aerosmith
Walk This Way	1975 songs, Rock songs, Aerosmith
Sauber Petronas Engineering	Formula One engine manufacturers, Companies of Switzerland, Malaysia
Anglo-Saxon charters	Anglo-Saxons
Book of Wisdom	Old Testament books
Glendale, Arizona	Glendale, Arizona
Cooktown, Queensland	Towns in Queensland
Endeavour River	Rivers of Queensland
Lil Jon	1971 births, Living people, African American musicians, American rap musicians from Georgia, Singers from Atlanta, Georgia, Actors from Atlanta, Georgia, American movie actors, Grammy Award winners
J.J. Redick	1984 births, American basketball players, Living people, Los Angeles Clippers players, Milwaukee Bucks players, Orlando Magic players, Sportspeople from Tennessee, American Christians, Philadelphia 76ers players
Redman (rapper)	American rap musicians from New Jersey, 1970 births, Living people, Singers from New Jersey, Actors from New Jersey, American movie actors
Liv Ullmann	1938 births, Living people, Actors from Tokyo, Actors from Toronto, Autobiographers, Golden Globe Award winning actors, Norwegian movie directors, Norwegian entertainers, Norwegian movie actors, Norwegian television actors, Norwegian voice actors
Dinner for Schmucks	2010 comedy movies, 2010s movie remakes, American comedy movies, American movie remakes, English-language movies
Teddy Pendergrass	1950 births, 2010 deaths, Singers from Philadelphia, Pennsylvania, Musicians from Philadelphia, Pennsylvania, Deaths from respiratory failure
Barry White	1944 births, 2003 deaths, African-American singers, American R&B singers, Singer-songwriters from California, American soul musicians, Deaths from renal failure, Disease-related deaths in Los Angeles, Grammy Award winners, People from Galveston, Texas, American soul singers, Singers from Los Angeles, California, Singers from Texas
Story of the Year	American rock bands, American punk bands, Post-hardcore bands, Musical groups from Missouri, Musical groups established in 1995, 1995 establishments in the United States, 1990s establishments in Missouri
Ray Lewis	1975 births, Living people, Baltimore Ravens players, American football linebackers, Sportspeople from Florida, American Christians, African American players of American football, National Football League broadcasters
Marty Turco	1975 births, Canadian ice hockey goaltenders, Boston Bruins players, Chicago Blackhawks players, Dallas Stars players, Ice hockey people from Ontario, Living people, International Hockey League (1945–2001) players, Swedish Hockey League players
Ray Rice	1987 births, Living people, African American players of American football, American football running backs, Baltimore Ravens players, Sportspeople from New York, People from New Rochelle, New York
Marpa Lotsawa	1012 births, 1097 deaths, Tibetan Buddhist lamas
Keith Urban	1967 births, Living people, Australian country musicians, Australian guitarists, Australian singer-songwriters, Grammy Award winners, Musicians from Queensland, New Zealand singers, People from North Island
Kenny Chesney	1968 births, Living people, American country musicians, People from Knoxville, Tennessee, Singers from Tennessee
Bel and the Dragon	Septuagint
Kazimierz Pospiszyl	1938 births, Living people, Psychologists
When I'm Sixty-Four	The Beatles songs, 1967 songs
Hispania Racing	Formula One constructors, Formula One current, Murcia
Brad Paisley	1972 births, Living people, American country guitarists, American country singers, American singer-songwriters, Singers from West Virginia, Musicians from West Virginia, Writers from West Virginia
Papa Roach	American hard rock bands, musical groups from California
Coureur de bois	Trade
Smart Guy	1997 American television series debuts, Children's television series, American sitcoms, 1999 American television series endings, English-language television programs
Luis Gonzalez (outfielder)	1967 births, Living people, American baseball players, Arizona Diamondbacks players, Sportspeople from Tampa, Florida, National League All-Stars
Yoko Kanno	1964 births, Japanese musicians, Japanese composers, Movie score composers, Living people, People from Miyagi Prefecture
Conker's Bad Fur Day	2001 video games, Nintendo 64 games
Tony Hawk's Underground	2003 video games, Xbox games, Nintendo GameCube games, PlayStation 2 games, Windows games, Game Boy Advance games, Tony Hawk video games
Arby's	1964 establishments in the United States, American fast food restaurants, Ohio
The Other Guys	2010 buddy movies, 2010 comedy movies, 2010s action comedy movies, American action comedy movies, American buddy movies, Buddy action movies, Buddy comedy movies, Buddy cop movies, English-language movies, Movies set in New York City, Police comedy movies
Rusty blackbird	Passeriformes
Coenobitidae	Decapods
Leominster	Towns in Herefordshire, Market towns in England
Troy Brouwer	1985 births, American Hockey League players, Canadian ice hockey right wingers, Chicago Blackhawks players, Ice hockey people from British Columbia, Living people, Moose Jaw Warriors players, Stanley Cup champions, Washington Capitals players
Lincoln Navigator	1990s automobiles, 2000s automobiles, 2010s automobiles, 2020s automobiles, Sport utility vehicles, Lincoln automobiles
Nick Swisher	1985 births, Living people, American baseball players, Chicago White Sox players, New York Yankees players, Oakland Athletics players, Sportspeople from Columbus, Ohio
Dane Cook	1972 births, Living people, Actors from Cambridge, Massachusetts, American movie actors, American television actors, American television writers, Comedians from Massachusetts
Hookah	Drug paraphernalia, Smoking
Jassen Cullimore	1972 births, Canadian ice hockey defencemen, Chicago Blackhawks players, Florida Panthers players, Ice hockey people from Ontario, Living people, Montreal Canadiens players, Tampa Bay Lightning players, Vancouver Canucks players, Stanley Cup champions, American Hockey League players, Ontario Hockey League players
Big L	1974 births, 1999 deaths, African American musicians, American rap musicians from New York, Murdered African-American people, Murdered musicians, Murders by firearm in New York, People murdered in New York, Singers from New York City, Unsolved murders in the United States
Down with Webster	1990s music groups, 2000s music groups, 2010s music groups, Canadian musical groups, Hip hop bands, 1998 establishments in Canada
Murray Bannerman	1957 births, American Hockey League players, Canadian ice hockey goaltenders, Chicago Blackhawks players, Ice hockey people from Ontario, Living people, Vancouver Canucks players
Carnival of Carnage	1992 albums, Debut albums, Insane Clown Posse albums, Hip hop albums
2010 Israel–Lebanon border clash	2010 in Asia, 2010s in Israel, 21st century in Lebanon, Arab–Israeli conflict, August events
South Lebanon conflict	Middle East, Conflicts
Arab–Israeli conflict	Arab–Israeli conflict
Gaza War	2008 in Asia, 2009 in Asia, Arab–Israeli conflict, Gaza Strip, Wars
Peugeot 406	Peugeot automobiles, 1990s automobiles, 2000s automobiles
RZA	1969 births, Living people, American rap musicians from New York, Musicians from New York City
Jordan Staal	1988 births, Canadian ice hockey centres, Ice hockey people from Ontario, Living people, People from Thunder Bay, Carolina Hurricanes players, Pittsburgh Penguins players, Stanley Cup champions, Ontario Hockey League players
News Corp. Digital Media	News Corporation
Napoleon and Tabitha D'umo	Living people, American dancers, American choreographers, Emmy Award winners
Audi Q5	Audi automobiles, Sport utility vehicles, 2000s automobiles, 2010s automobiles
Suica	Tokyo
Jared Staal	1990 births, Canadian ice hockey right wingers, Ice hockey people from Ontario, Living people, People from Thunder Bay, American Hockey League players, ECHL players, Ontario Hockey League players
Attabad Lake	Lakes of Pakistan
Fastest lap	Motor sports
Informed consent	Medicine, Ethics, Legal terms
Ali Baba	Characters in written fiction
Bullitt	1968 movies, 1960s crime movies, 1968 thriller movies, American crime thriller movies, Chase movies, English-language movies, Movies about murderers, Movies based on books, Movies set in San Francisco, United States National Film Registry movies, Movies directed by Peter Yates
Mercedes-Benz Grand Prix results	Formula One constructor results, Formula One current
Akon	1973 births, Living people, American rap musicians from Missouri, American R&B singers, Senegalese people, Singers from Missouri
Thích Quảng Đức	1897 births, 1963 deaths, Buddhist clergy, Monks, People who committed suicide, Vietnamese people
Storms of My Grandchildren	Climate change, Non-fiction books, Environment
Star of Bethlehem	Gospels, Bethlehem, Astrology, Christian terminology
Immortal Technique	1978 births, Activists, American rap musicians from New York, Living people, Peruvian entertainers, Poets, Singers from New York City, Writers, People from Lima
Diners, Drive-Ins and Dives	2000s American television series, 2010s American television series, 2006 American television series debuts, Food Network, English-language television programs
Kiddieland Amusement Park	1929 establishments in Illinois, 2009 disestablishments in the United States, Buildings and structures in Chicago, Illinois, Theme parks in the United States
Monmouth	Towns in Monmouthshire
Franklin (TV series)	1997 television series debuts, 2004 television series endings, 1990s American television series, 1990s Canadian television series, 2000s American television series, 2000s Canadian television series, American animated television series, Canadian animated television series, American children's television series, Canadian children's television series, English-language television programs
Johnny Cage	Fictional American people, Fictional characters introduced in 1992, Mortal Kombat characters, Video game characters in movies
Twinkie	Snack foods
Ryan Getzlaf	1985 births, American Hockey League players, Anaheim Ducks players, Calgary Hitmen players, Canadian ice hockey centres, Canadian Olympic gold medalists, Ice hockey people from Saskatchewan, Living people, Mighty Ducks of Anaheim players, People from Regina, Saskatchewan, Stanley Cup champions
Big Pun	1971 births, 2000 deaths, American rap musicians from New York, Cardiovascular disease deaths in New York, Deaths from myocardial infarction, Singers from New York City, American hip hop musicians, Gangsta rappers
Ángel Sánchez (baseball)	1983 births, Living people, Sportspeople from Puerto Rico, Houston Astros players, Boston Red Sox players, Kansas City Royals players
John Scott	1982 births, Arizona Coyotes players, Buffalo Sabres players, Canadian ice hockey defencemen, Chicago Blackhawks players, Ice hockey people from Ontario, Living people, Minnesota Wild players, Montreal Canadiens players, New York Rangers players, San Jose Sharks players
Kevin Cash	1983 births, Living people, American baseball players, Boston Red Sox players, Houston Astros players, New York Yankees players, Tampa Bay Rays, Tampa Bay Devil Rays players, Toronto Blue Jays players, Sportspeople from Tampa, Florida
Armor for Sleep	American rock bands, Emo bands, 2001 in music, Musical groups from New Jersey, Musical groups established in 2001, 2001 establishments in the United States, 2000s establishments in New Jersey, Musical groups disestablished in 2009, 2009 disestablishments in the United States, 2010s disestablishments in New Jersey
Haralson County, Georgia	1856 establishments in Georgia (U.S. state), Georgia (U.S. state) counties
List of Formula One World Championship points scoring systems	Formula One lists
Hank Bassen	1932 births, 2009 deaths, American Hockey League players, Canadian ice hockey coaches, Canadian ice hockey goaltenders, Cardiovascular disease deaths in Canada, Chicago Blackhawks players, Deaths from myocardial infarction, Detroit Red Wings players, Disease-related deaths in Alberta, Ice hockey people from Alberta, Medicine Hat Tigers players, Pittsburgh Penguins players, Sportspeople from Calgary, Central Professional Hockey League players
Bremen, Georgia	Cities in Georgia (U.S. state)
Bad Lieutenant	1992 crime movies, 1992 drama movies, 1990s crime drama movies, American crime drama movies, English-language movies, Film noir, Movies set in New York City, Murder in movies, NC-17 rated movies, Rape in movies, Movies directed by Abel Ferrara, Obscenity controversies, American independent movies
Mur de la peste	18th century in France, Geography of France
Simply Bird	2007 albums
Melaleuca leucadendra	Trees of Australia
Royal Rumble (2010)	Royal Rumble, 2010 in professional wrestling, Sports in Atlanta, Georgia, 2010 in the United States, 21st century in Atlanta, Georgia, 2010s in Georgia (U.S. state)
Silverstone Circuit	Formula One circuits
Lovely Rita	The Beatles songs, 1967 songs
Cali	Cities in Colombia, Geography of Colombia
Functional group	Functional groups, Organic chemistry
Good Morning Good Morning	1967 songs, The Beatles songs
A Day in the Life	The Beatles songs, 1967 songs
Maks Ćatović	1950 births, Living people, Serbian people
Climbing harness	Safety, Rock climbing, Mountain climbing, Sports equipment
Alcester	Towns in Warwickshire
Aldeburgh	Towns in Suffolk, Civil parishes in Suffolk, Suffolk Coastal
Computer vision syndrome	Computers, Vision
McLaren Grand Prix results	Formula One constructor results, Formula One current
Dale Jarrett	NASCAR drivers, 1956 births, Living people, Daytona 500 winners, American racecar drivers, Sportspeople from North Carolina
2007 Formula One espionage controversy	Formula One, Espionage
Lithium oxide	Lithium compounds, Oxides
Lithium carbonate	Lithium compounds, Carbonates
Lithium chloride	Lithium compounds, Chlorine compounds
Oxidation state	Chemical bonding, Oxides
Oxidizing agent	Physical chemistry
Reducing agent	Chemistry
Reduction (chemistry)	Chemistry
Electroplating	Technology, Physical chemistry
Potassium hydroxide	Potassium compounds
Elverta, California	Unincorporated communities in California, Settlements in Sacramento County, California
Elena Kagan	1960 births, Living people, Alumni of the University of Oxford, American judges, American lawyers, Harvard University alumni, Jewish American academics, Jewish judges, Jewish lawyers, People from Manhattan, Princeton University alumni, United States Solicitors General, United States Supreme Court justices, Women judges
Sonia Sotomayor	1954 births, Living people, Princeton University alumni, Puerto Rican people, United States Supreme Court justices, Yale University alumni, People from the Bronx
Suzanne Collins	1963 births, Living people, Writers from Hartford, Connecticut
Calcium chloride	Chlorine compounds, Calcium compounds
Bob Probert	1985 births, 2010 deaths, American Hockey League players, Canadian ice hockey right wingers, Cardiovascular disease deaths in Canada, Chicago Blackhawks players, Deaths from heart failure, Detroit Red Wings players, Disease-related deaths in Ontario, Ice hockey people from Ontario, Ontario Hockey League players, Deaths from chronic traumatic encephalopathy
Vampires Suck	2010 movies, 20th Century Fox movies
JPEG	Computer file formats
WilliamsF1 Grand Prix results	Formula One constructor results, Formula One current
Invertible matrix	Linear algebra
Flag of New Mexico	United States state flags, New Mexico
Pontiac Sunfire	1990s automobiles, 2000s automobiles, Pontiac automobiles
Michael Cera	1988 births, Living people, Actors from Ontario, Canadian movie actors, Canadian television actors, Canadian voice actors
Kardinal Offishall	1976 births, Living people, Canadian musicians, Canadian rap musicians, People from Ontario
Laurasia	Laurasia
Dangerous (Kardinal Offishall song)	2008 songs
Justin Upton	1987 births, Living people, People from Norfolk, Virginia, Sportspeople from Virginia, African-American baseball players, Arizona Diamondbacks players, Atlanta Braves players, Detroit Tigers players, San Diego Padres players, National League All-Stars
Tetris DS	2006 video games, Nintendo DS games
Tony Hawk's Pro Skater 4	2002 video games, Xbox games, Nintendo GameCube games, Windows games, PlayStation 2 games, Game Boy Advance games, Tony Hawk video games
Potassium chloride	Potassium compounds, Chlorine compounds
Sodium bromide	Sodium compounds, Bromine compounds
Bromide	Bromine compounds
Iron(III) oxide	Iron compounds, Oxides
Iron(II) oxide	Iron compounds, Oxides
Saratoga Trunk	1945 movies, 1940s romance movies, English-language movies, American romance movies, Movies directed by Sam Wood
Index on Censorship	Human rights organisations in the United Kingdom, 1972 establishments in the United Kingdom, Censorship, Organisations based in London
Iron(II) hydroxide	Iron compounds
Jimmy Ward	1906 births, 1990 deaths, Canadian ice hockey right wingers, Ice hockey people from Ontario, Montreal Canadiens players, Montreal Maroons players, People from Thunder Bay, Stanley Cup champions
Gary Veneruzzo	1943 births, Canadian ice hockey left wingers, Ice hockey people from Ontario, Living people, People from Thunder Bay, St. Louis Blues players, World Hockey Association players
Vic Venasky	1951 births, American Hockey League players, Canadian ice hockey centres, Ice hockey people from Ontario, Living people, Los Angeles Kings players, People from Thunder Bay, Central Professional Hockey League players
Sodium bicarbonate	Sodium compounds, Carbonates
Heartburn	Symptoms, Digestive system
Nitrogen triiodide	Nitrogen compounds, Iodine compounds
Material safety data sheet	Documents, Materials, Safety
NFPA 704	Standards, Safety, Chemistry
Fluorite	Minerals
Fluoride	Chemicals
Fluoridation	Chemistry
Iron(II,III) oxide	Minerals, Iron compounds, Oxides
Beck, Bogert & Appice	Hard rock bands
Beck, Bogert & Appice (album)	1973 albums, Blues rock albums, Hard rock albums
Wonderwall (song)	1995 songs, Oasis (band) songs
Iron(III) chloride	Iron compounds, Chlorine compounds
Iron(II) chloride	Iron compounds, Chlorine compounds
V10 engine	Motors
Iron(II) sulfate	Sulfur compounds, Iron compounds
Iron(III) sulfate	Sulfur compounds, Iron compounds
Chromate	Chromium compounds
Chromium(III) oxide	Chromium compounds, Oxides
Chromium(III) chloride	Chlorine compounds, Chromium compounds
Mike Tomlak	1965 births, Canadian ice hockey centres, Hartford Whalers players, Ice hockey people from Ontario, Living people, People from Thunder Bay, American Hockey League players, International Hockey League (1945–2001) players, Ontario Hockey League players
Ralph Stewart	1948 births, Canadian ice hockey centres, Ice hockey people from Ontario, Living people, New York Islanders players, Vancouver Canucks players
Potassium chromate	Potassium compounds, Chromium compounds
Sodium chromate	Sodium compounds, Chromium compounds
Clockwork radio	Machines
Mechanically powered torch	Machines, Light sources
Alkaline battery	Batteries
Leclanche battery	Batteries
Electrolyte	Electricity, Chemistry
Manganese dioxide	Manganese compounds, Oxides
Ironic (song)	1996 songs, Alanis Morissette songs, Rock songs
Super Crazy	1973 births, Living people, Mexican professional wrestlers, Hidalgo (state)
Permanganate	Manganese compounds
The Velvet Underground & Nico	The Velvet Underground albums, Debut albums, 1967 albums, Rock albums
Lithium battery	Batteries
Lithium-ion battery	Batteries
White Light/White Heat	The Velvet Underground albums, 1968 albums, Rock albums
Sweetness (song)	2002 songs
Glycerine (song)	1995 songs
The Velvet Underground (album)	The Velvet Underground albums, 1969 albums, Rock albums
Loaded (The Velvet Underground album)	The Velvet Underground albums, 1970 albums, Rock albums
V8 engine	Motors
Ammonium	Nitrogen compounds
Protonation	Chemistry
Deprotonation	Chemical reactions
Stink bomb	Pranks
Ammonium chloride	Nitrogen compounds, Chlorine compounds
Necro (rapper)	1976 births, Living people, American rap musicians from New York, Jewish American musicians, Movie directors from New York, Singers from New York City
Zinc chloride	Chlorine compounds, Zinc compounds
Wet cell	Batteries
Mercury battery	Batteries
Silver oxide battery	Batteries
E.T. the Extra Terrestrial (video game)	1982 video games, Atari 2600 games, Video games based on movies
Mercury(II) oxide	Mercury compounds, Oxides
Silver(I) oxide	Silver compounds
Household ammonia	Chemicals
Cape York Peninsula	Geography of Queensland, Peninsulas
Crankshaft	Motors
Motorboat	Boats
Thongchai McIntyre	1958 births, Living people, Movie actors, People from Bangkok, Thai singers, Television actors, Thai actors
Don't Look Back in Anger	Oasis (band) songs, 1996 songs
Rover 800 Series	Rover automobiles, 1980s automobiles, 1990s automobiles
Edward Bairstow	1874 births, 1946 deaths, English composers, English organists, Musicians from Yorkshire, People from Huddersfield
Neutralization	Physical chemistry, Analytical chemistry, Thermodynamics
Chloralkali process	Chemical processes, Electricity
Calcium hydroxide	Calcium compounds
Calcium oxide	Calcium compounds, Oxides

