Mametz, Somme	Former communes in Somme
Caulières	Communes in Somme
Cayeux-sur-Mer	Communes in Somme
Cerisy-Buleux	Communes in Somme
Chaulnes	Communes in Somme
Chaussoy-Epagny	Communes in Somme
Chépy	Communes in Somme
Mons-Boubert	Communes in Somme
Chilly, Somme	Communes in Somme
Torricella Peligna	Settlements in Abruzzo
Citerne	Communes in Somme
Somewhere Beyond Love	1974 drama movies, Italian drama movies, Movies directed by Luigi Comencini
Albuzzano	Settlements in Lombardy
Birdz	Fictional birds, Canadian children's television series, Animated television series
Top Wing	Fictional birds, Canadian children's television series, Animated television series
Kingdom Force	Fictional animals, Canadian children's television series, Animated television series
Dendropsophus pseudomeridianus	Frogs, Animals of South America
400 (number)	Integers, Square numbers
Mr. Bean (video game)	PlayStation 2 games, Nintendo DS games, Wii games, Windows games, 2007 video games, Mr. Bean
Garbage bag	Containers, Waste management
Hankyu Hanshin Toho Group	Business, Economics, Japan
Sounder (movie)	1972 drama movies, American family movies, American drama movies, Movies based on books, 20th Century Fox movies, Movies directed by Martin Ritt
Ichizō Kobayashi	1873 births, 1957 deaths, Japanese businesspeople
200 (number)	Integers
300 (number)	Integers
800 (number)	Integers
900 (number)	Integers, Square numbers
104 (number)	Integers
Mother Tucker	Family Guy (season 5) episodes, 2006 television episodes
Viva (2015 movie)	2015 drama movies, 2010s LGBT movies, Irish movies, Cuban movies, Movies directed by Paddy Breathnach
105 (number)	Integers
Geom Cube	PlayStation-only games, PlayStation games, Puzzles, Puzzle video games, Technos Japan, 1994 video games, 1995 video games
Passive smoking	Health problems, Everyday life
Clairy-Saulchoix	Communes in Somme
Cléry-sur-Somme	Communes in Somme
Cocquerel	Communes in Somme
Coisy	Communes in Somme
Colincamps	Communes in Somme
Aldama Municipality, Chihuahua	Municipalities of Chihuahua
Carex	Poales
Japan Landa Imphal	Manipur, World War II
Imphal 1944	Manipur, Japan, World War II
Death of Kelsey Smith-Briggs	2002 births, 2005 deaths, 2005 crimes, Children victims of violence
Condé-Folie	Communes in Somme
Crime Crackers 2	1997 video games, PlayStation-only games, PlayStation games, Role-playing video games, Video games developed in Japan
Dreambuilders	2020 movies, 2020s science fiction movies, 2020s comedy movies, Warner Bros. movies, American comedy movies, American science fiction movies, Danish movies, Adventure movies
Nini Gogichaishvili	1993 births, Living people
Son of the Nile	1951 drama movies, 1950s romantic drama movies, Egyptian movies, Movies directed by Youssef Chahine
Dances of Manipur	Meitei culture, Jagoi
The Shop on Main Street	1965 drama movies, 1960s war movies, Slovakian movies, World War II movies, Movies directed by Elmar Klos, Movies directed by Ján Kadár
B.O.C Road, Perumbavoor	Kerala
Montevarchi	Towns in Tuscany
Anghiari	Settlements in Tuscany
Bear in the Big Blue House (video game)	Game Boy Color games, PlayStation games, 2001 video games, 2002 video games
Cortona	Towns in Tuscany
Morgex	Settlements in Valle d'Aosta
Ollomont	Settlements in Valle d'Aosta
Oyace	Settlements in Valle d'Aosta
Samurai Deeper Kyo (video game)	2002 video games, 2008 video games, PlayStation games, Game Boy Advance games
Hyères	Communes in Var
Saint-Raphaël, Var	Communes in Var
Adelaide Kane	1990 births, Living people, Actors from Perth, Western Australia, Australian child actors, Australian LGBT people, Australian movie actors, Australian television actors, Bisexual people, LGBT actors
Winter Carnival	1939 movies, 1930s comedy movies, 1930s drama movies, American comedy-drama movies, Movies directed by Charles Reisner
Paul Tibbitt	1968 births, American animators, American cartoonists, American comedians, American television directors, American television producers, American television writers, American movie directors, American movie producers, American songwriters, American screenwriters, Living people
Stolen Kisses	1968 comedy movies, 1968 drama movies, 1960s romantic comedy movies, 1960s romantic drama movies, 1960s comedy-drama movies, French romance movies, French comedy movies, French drama movies, Movies directed by François Truffaut
Bellman-Ford algorithm	Algorithms
Contalmaison	Communes in Somme
Contay	Communes in Somme
Conteville, Somme	Communes in Somme
Contre	Communes in Somme
Bitlis	Cities in Turkey
Conty	Communes in Somme
Gorenflos	Communes in Somme
Coullemelle	Communes in Somme
Paul Heckingbottom	1977 births, Living people, English footballers, People from South Yorkshire, English football managers
Courcelette	Communes in Somme
Courcelles-au-Bois	Communes in Somme
Courcelles-sous-Thoix	Communes in Somme
Cramont	Communes in Somme
Montignoso	Settlements in Tuscany
Bagnone	Settlements in Tuscany
Comano, Tuscany	Settlements in Tuscany
Casola in Lunigiana	Settlements in Tuscany
Filattiera	Settlements in Tuscany
Interior tree frog	Frogs, Animals of South America
AI Song Contest	2020 establishments in Europe, AI Song Contest, Artificial intelligence
Charles Darrow	Businesspeople from Philadelphia, Pennsylvania, 1889 births, 1967 deaths
Baby Blue (group)	2020 establishments, Girl groups
Aachen dialect	Languages of Germany, German dialects, Aachen
The Knife (movie)	1961 drama movies, Dutch drama movies, Movies based on books, Movies directed by Fons Rademakers
Zus & Zo	2001 romance movies, 2001 comedy movies, 2000s romantic comedy movies, 2000s fantasy movies, 2000s LGBT movies, Dutch romance movies, Dutch comedy movies, Movies directed by Paula van der Oest
1st.One	Filipino boy bands, 2020 establishments, Musical groups established in 2020, Musical groups from Manila, Filipino pop music groups
Alamat (band)	P-pop, Boy bands, 2021 establishments, Alamat (band)
Homura (video game)	2005 video games, PlayStation 2 games, PlayStation 2-only games, Taito games, Video games developed in Japan
Nathaniel Walter Barnardiston	1858 births, 1919 deaths, British military personnel of World War I
The Man Who Sold His Skin	2020 drama movies, Tunisian movies, French drama movies, German drama movies, Belgian movies, Swedish movies, Turkish movies, Cypriot movies
Fivizzano	Settlements in Tuscany
Fosdinovo	Settlements in Tuscany
Manila in the Claws of Light	1975 drama movies, Filipino movies, Movies based on short stories, Movies directed by Lino Brocka
Dicomano	Settlements in Tuscany
Quo Vadis, Aida?	2020 drama movies, 2020s war movies, Bosnia and Herzegovina movies, Austrian movies, Romanian movies, Dutch drama movies, German drama movies, Polish movies, French drama movies, Norwegian movies, Turkish movies, Movies directed by Jasmila Žbanić
No Man's Land (2001 movie)	2001 comedy-drama movies, 2000s war movies, Bosnia and Herzegovina movies, French comedy movies, French drama movies, Belgian movies, Italian comedy movies, Italian drama movies, Slovenian movies, British war movies, British comedy movies, British drama movies, Movies directed by Danis Tanović
Licciana Nardi	Settlements in Tuscany
Mulazzo	Settlements in Tuscany
King of Thieves (2004 movie)	2004 drama movies, Slovakian movies, Czech movies, Slovenian movies, Dutch drama movies, Austrian movies, Belgian movies, German drama movies, French drama movies, Movies directed by Ivan Fíla
Hive (movie)	2021 movies, 2020s drama movies, Kosovan movies, Swiss movies, Albanian movies, Macedonian movies
God Exists, Her Name Is Petrunija	2019 drama movies, Macedonian movies, Belgian movies, Slovenian movies, Croatian movies, French drama movies
The Parade (movie)	2011 comedy-drama movies, 2010s LGBT movies, Serbian movies, Slovenian movies, Croatian movies, French comedy movies, French drama movies, Macedonian movies, British comedy-drama movies, British LGBT movies
Westland, Michigan	Cities in Michigan
Journey of Hope (movie)	1990 drama movies, Swiss movies, Turkish movies, British drama movies, French drama movies, Movies directed by Xavier Koller
Dangerous Moves	1980s sports movies, 1984 drama movies, Swiss movies, French drama movies, Liechtenstein movies
Crémery	Communes in Somme
Cressy-Omencourt	Communes in Somme
2021 Meron stampede	2021 disasters in Asia, 21st century in Israel, April 2021 events
Bob Baffert	1953 births, Living people, Sportspeople from Arizona
Medina Spirit	2018 births, Thoroughbred racehorses
Murder of Christopher Barrios Jr.	People murdered in the United States, Murdered children, 2001 births, 2007 deaths, 2007 crimes
Benalup-Casas Viejas	Municipalities in Andalusia
Windows Virtual PC	Microsoft Windows software
Eurovision Asia Song Contest	Music competitions
Croix-Moligneaux	Communes in Somme
Podenzana	Settlements in Tuscany
Tresana	Settlements in Tuscany
Villafranca in Lunigiana	Settlements in Tuscany
Zeri	Settlements in Tuscany
Arcidosso	Settlements in Tuscany
Campagnatico	Settlements in Tuscany
Liceo Tommaso Gulli	18th century establishments in Italy, 1935s establishments in Europe, 1835 establishments, Buildings and structures in Reggio Calabria
Croixrault	Communes in Somme
Curchy	Communes in Somme
Damery, Somme	Communes in Somme
Dancourt-Popincourt	Communes in Somme
Kilis	Cities in Turkey
Ajka	Cities in Hungary
Tallaght Stadium	Football stadiums in Europe
Shochiku	1895 establishments, 1890s establishments in Asia, 19th century establishments in Japan
Dialectical materialism	Philosophy of science
Sophie Reynolds	Living people, American actors, Actors from Washington, American dancers, American television actors, American voice actors, 1999 births
Gamer's Guide to Pretty Much Everything	2010s American children's comedy television series, 2015 American television series debuts, 2017 American television series endings, Disney XD original programming, English-language television programs, Television series by It's a Laugh Productions, Television shows about video games
Daours	Communes in Somme
Davenescourt	Communes in Somme
San Francisco de Borja Municipality	Municipalities of Chihuahua
Démuin	Communes in Somme
Devise, Somme	Communes in Somme
Saint-Sauveur, Somme	Communes in Somme
Roundup (herbicide)	Chemical compounds, Agriculture
Metropolitan Waterworks Museum	Museums in Massachusetts, Buildings and structures in Boston, Massachusetts
KFConsole	KFC, Video game consoles
Lagoa Santa tree frog	Frogs, Animals of South America
Charny-Orée-de-Puisaye	2016 establishments in France, Communes in Yonne
Domart-en-Ponthieu	Communes in Somme
Guyencourt-sur-Noye	Communes in Somme
Domesmont	Communes in Somme
Ramburelles	Communes in Somme
Moonstruck	1987 romance movies, 1987 comedy movies, 1980s romantic comedy movies, American romantic comedy movies, MGM movies, Movies directed by Norman Jewison
Grouches-Luchuel	Communes in Somme
Belgentier	Communes in Var
Gassin	Communes in Var
Dominois	Communes in Somme
Phalène	Spaniels
Merzig	Merzig-Wadern, Towns in Saarland
Wadern	Towns in Saarland, Merzig-Wadern
Sarafina! (movie)	1992 movies, 1990s musical movies, South African movies, British musical movies, American musical movies, French movies, Movies about Apartheid, Movies directed by Darrell Roodt
DZMZ	Radio stations in the Philippines
Space Debris (video game)	PlayStation games, PlayStation-only games, 2000 video games, Action video games
Beckingen	Merzig-Wadern
Kakinoki Shogi	PlayStation games, Sega Saturn games, Super Nintendo Entertainment System games, 1994 video games, 1995 video games, Puzzle video games, Board games
Kakinoki Shogi II	PlayStation-only games, PlayStation games, 1998 video games, Japan exclusive video games
Totally Spies! Totally Party	PlayStation 2 games, Wii games, 2007 video games, 2008 video games
Nekketsu Oyako	PlayStation games, Sega Saturn games, Japan exclusive video games, 1994 video games, 1995 video games
Plunder Road	1957 movies, 1950s crime movies, American crime movies, 20th Century Fox movies
The Man with Two Brains	1983 comedy movies, 1983 science fiction movies, 1980s black comedy movies, American black comedy movies, American science fiction movies, Warner Bros. movies, Movies directed by Carl Reiner
Securities fraud	Organized crime
Diet in diabetes	Diets, Diabetes mellitus
TwinBee Taisen Puzzle-Dama	PlayStation games, PlayStation-only games, 1994 video games, Puzzle video games, Japan exclusive video games
Twin Goddesses	PlayStation games, PlayStation-only games, 1994 video games, Japan exclusive video games
Europe Racing	PlayStation games, 2001 video games, Racing video games
Conquest of the Planet of the Apes	1972 science fiction movies, Planet of the Apes movies, 20th Century Fox movies, Movies directed by J. Lee Thompson
Moorhuhn X	2003 video games, 2005 video games, PlayStation games, PlayStation 2 games, Mobile phones, Action video games
N. V. Ramana	1957 births, Living people
Virbhadra Singh	1934 births, 2021 deaths, Deaths from the COVID-19 pandemic in India, Indian politicians
Rampur, Himachal Pradesh	Himachal Pradesh
Daniel Sanfourche said de Lamothe	1683 births, 1763 deaths
Fortune Street (video game)	Wii games, Wii-only games, 2011 video games, Nintendo, Party video games, Board games
Itadaki Street DS	Nintendo DS games, Nintendo DS-only games, 2007 video games, Board games, Party video games, Japan exclusive video games
Anton Du Beke	1966 births, Living people, British dancers, British television presenters
Four Heavenly Kings	Buddhism
Aberaeron	Towns in Ceredigion
Flint, Flintshire	Towns in Flintshire
The Aquarium	2008 drama movies, Egyptian movies, French drama movies, German drama movies, Movies directed by Yousry Nasrallah
2021 Colombian protests	2021 crimes, 2021 in South America, 2020s riots, April 2021 events, Arson, Crime in South America, History of Colombia, June 2021 events, May 2021 events, Protests in 2021
2021 Kyrgyzstan–Tajikistan conflict	2021 in Asia, 2020s in Kyrgyzstan, History of Tajikistan, April 2021 events, May 2021 events
Sun God	Mythology
Iain Rankin (politician)	Living people, 1983 births, Premiers of Nova Scotia
Caroline Cochrane	1960 births, Living people, Premiers of the Northwest Territories
Andrew Furey	1970s births, Living people, Premiers of Newfoundland and Labrador
Anura Bandaranaike	Sri Lankan politicians
Murder of Zachary Turner	2002 births, 2003 deaths, Murder in Canada
Salem Spartans	Tamil Nadu Premier League
Habesha Community	Ethnic groups in Africa
Lesser tree frog	Frogs, Animals of South America
Arc length	Mathematics, Measurement
Brunton Park	Football stadiums in the United Kingdom
2021–22 Fußball-Bundesliga	Bundesliga seasons
Missions of California	History of California
TextSecure	Messaging, Instant messaging software
Kabiru Bala	1964 births, Living people
Attahiru Bafarawa	1954 births, Living people
Conus adversarius	Gastropods
Save Your Tears	2020 songs, 2021 songs, The Weeknd, Ariana Grande songs, Synth-pop
Reggae rock	Reggae music, Rock music
Power pop	Pop rock
Hiroyuki Ôta	Japanese actors, 1947 births, Living people
Corn smut	Diseases and disorders of plants, Fungi
I Am Peter, Hear Me Roar	Family Guy episodes, 2000 television episodes
Kevin Carrigan	American actors, People from Memphis, Tennessee
Sacred language	Languages, History of religion
Meitei Vaishnavism	Meitei culture, History of Manipur
Ahmed Musa	1992 births, Living people, Nigerian footballers
Femi Hamzat	1964 births, Living people, Nigerian politicians
Balogun Market	Nigeria
Dressmaker	Fashion designers
Isomerization	Chemistry
Meitei wedding	Meitei culture, Meitei religion
Super Mario Bros. 35	2020 video games, Mario video games, Nintendo Switch-only games, Nintendo video games
The Man Who Saved The World	1982 action movies, 1982 science fiction movies, 1980s adventure movies, Turkish movies, Star Wars, Apocalyptic movies
Adlai Stevenson IV	American businesspeople, 1956 births, Living people
Rakesh Roshan	Indian movie actors, Indian screenwriters, Indian movie directors, Indian movie producers, 1949 births, Living people
Chinese Singaporeans	Overseas Chinese, Chinese people
Dendropsophus rozenmani	Frogs, Animals of South America
GfK Entertainment	Baden-Baden, Companies of Germany
Michael Bisping	1979 births, Living people, Mixed martial artists, Sportspeople from Lancashire
Shaun Murphy	1982 births, Living people, Snooker players, Sportspeople from Essex
Mexico City Metro	Mexico City
Mexico City Metro overpass collapse	2021 in North America, 21st century in Mexico, Disasters in Mexico, 2020s disasters in North America, May 2021 events, Mexico City, Railway accidents in North America
City of London swords	City of London, Swords
Nikki Fried	1977 births, Living people, American lawyers, Politicians from Miami, Florida, People from Fort Lauderdale, Florida, US Democratic Party politicians, State legislators of the United States
Reggae fusion	Reggae music
The Scorpio (movie)	1984 movies, 1980s thriller movies, Dutch movies, Movies directed by Ben Verbong
Cholecystitis	Diseases and disorders of the digestive system, Inflammation
The Girl with the Red Hair	1981 drama movies, 1980s war movies, 1980s biographical movies, Dutch drama movies, World War II movies, Movies based on books, Movies directed by Ben Verbong
Taça da Liga	Establishments in Portugal, 2007 establishments in Europe, 2007 in association football, Football competitions, Football in Portugal
Barreiro, Portugal	Cities in Portugal, Municipalities of Portugal
Potloi (costume)	Meitei culture
Kingdom in the Clouds	1969 movies, 1960s fantasy movies, Romanian movies, Russian movies, Movies directed by Elisabeta Bostan
Cairo Station	1958 drama movies, 1950s crime movies, Egyptian movies, Movies directed by Youssef Chahine
The Blazing Sun (1954 movie)	1954 drama movies, 1950s romantic drama movies, Egyptian movies, Movies directed by Youssef Chahine
Doris Leuthard	1963 births, Presidents of the Swiss Confederation, Swiss lawyers, Living people
The Angel of Mercy	1946 movies, 1940s drama movies, Egyptian movies, Movies directed by Youssef Wahbi
In Your Hands	1960 comedy movies, 1960s romantic comedy movies, Egyptian movies, Movies directed by Youssef Chahine
Aggtelek	Villages in Hungary
Jean Muir	1928 births, 1995 deaths, British fashion designers
A. & L. Tirocchi Gowns	Dresses, Manufacturing, Rhode Island
Carb loading	Carbohydrates
Alice Palmer	American politicians
Robert Lustig	1957 births, American physicians, Diets, People from Brooklyn, Living people
Ryan Potter	1995 births, American child actors, American movie actors, American martial artists, American television actors, American voice actors, Actors from Los Angeles, California, Actors from Portland, Oregon, Jewish American actors, Living people
The Bus (video game)	2021 video games, Simulator video games
Steve McKean	1940s births, 2021 deaths, American basketball players, Coaches, Deaths from cancer, New Zealand sportspeople
Gyros (food)	Greek food, Meat dishes
Merten's yellow tree frog	Frogs, Animals of South America
Magua (clothing)	Clothing
2021 Peru bus crash	2021 disasters, 2021 in South America, 21st century in Peru, April 2021 events, Disasters in South America, Transport disasters
Hiʻiaka (moon)	Moons, Space, Astronomy
Pitch (resin)	Polymers
Destiny (1997 movie)	1997 drama movies, Egyptian movies, French drama movies, Movies directed by Youssef Chahine
Louis I, Duke of Bourbon	13th century births, 14th century deaths, Princes and princesses, French royalty
E♭(musical note)	Musical notes
Yalkaparidontia	Marsupials, Marsupials of Australia
Pomona (goddess)	Gods and goddesses, Roman mythology
Bedkot Municipality	Municipalities of Nepal
McStroke	Family Guy episodes, 2008 television episodes
U.S. economic performance under Democratic and Republican presidents	Economic history, History of the United States
James I, Count of La Marche	1319 births, 1362 deaths, Princes and princesses, French royalty
Pitch Lake	Lakes, Lakes_of_Trinidad_and_Tobago
Operational transformation	Computer science
J. Martin Hunter	Living people, 1937 births, British academics, British lawyers
Stephen M. Schwebel	American judges, People from New York City, 1929 births, Living people
Power Play	2003 action movies, 2003 movies, American action movies, Movies directed by Joseph Zito
Archezoa	Taxonomy, History of science
Jacques d'Amboise (dancer)	1934 births, 2021 deaths, Deaths from stroke, American dancers, American educators, American choreographers, American movie actors, American television actors, American stage actors, Actors from Massachusetts, Actors from New York City
Rulers of Ancient Manipur before Nongta Lailen Pakhangpa	Kings of Ancient Manipur, History of Manipur
Shavkat Mirziyoyev	1957 births, Living people, Presidents of Uzbekistan, Prime Ministers of Uzbekistan, Current national leaders
President of Uzbekistan	Presidents of Uzbekistan
Persian pop	Music genres, Pop music
Prime Minister of Uzbekistan	Prime Ministers of Uzbekistan
Abdulhashim Mutalov	1947 births, Prime Ministers of Uzbekistan, Living people
Abdulla Aripov	1961 births, Living people, Prime Ministers of Uzbekistan
Nigmatilla Yuldashev	1962 births, Living people, Presidents of Uzbekistan
Gulnara Karimova	1972 births, Living people, Uzbekistani people, Ambassadors, Criminals
Lola Karimova-Tillyaeva	Living people, 1978 births, Uzbekistani people, Philanthropists, Ambassadors
Vadim Schneider	1986 births, 2003 deaths, Accidental deaths in Canada, Actors from Quebec, Canadian television actors, Canadian voice actors, Child actors, Road accident deaths
President of Tajikistan	Presidents of Tajikistan
Rahmon Nabiyev	1930 births, 1993 deaths, Presidents of Tajikistan
Prime Minister of Tajikistan	Prime Ministers of Tajikistan
Akbar Mirzoyev	1939 births, Living people, Prime Ministers of Tajikistan
Jamshed Karimov	1940 births, Living people, Prime Ministers of Tajikistan
Oqil Oqilov	1944 births, Living people, Prime Ministers of Tajikistan
Romani people in Canada	Ethnic groups in Canada
Kokhir Rasulzoda	1959 births, Living people, Prime Ministers of Tajikistan
Steve McMichael	1957 births, Living people, New England Patriots players, Chicago Bears players, Green Bay Packers players, American professional wrestlers, American sports commentators, Sportspeople from Chicago, Politicians from Chicago, Sportspeople from Houston, Texas, Politicians from Houston, Texas, American football defensive tackles
Romeoville, Illinois	Villages in Illinois, Suburbs of Chicago, Illinois
Lynn Conway	1938 births, Living people, American computer scientists, Engineers from New York, American LGBT rights activists, Transgender and transsexual people, LGBT scientists, American inventors, Scientists from New York, People from Mount Vernon, New York, LGBT people from New York, Writers from New York, American academics, LGBT writers
Carver Mead	1934 births, Living people, Engineers from California, American computer scientists, American academics, Scientists from California, Writers from California, People from Bakersfield, California
Ann Bannon	1932 births, Living people, American academics, American feminist writers, American LGBT rights activists, Lesbian feminists, LGBT academics, LGBT people from Illinois, LGBT writers, People from Joliet, Illinois, Women linguists, Writers from Illinois
Natalia Poklonskaya	1980 births, Living people, Russian politicians, Russian military people, Russian lawyers, Ukrainian military people
Nikita Mikhalkov	1945 births, Living people, Russian movie actors, Russian movie directors, Russian movie producers, Russian screenwriters, Cinematographers, Actors from Moscow, Writers from Moscow, Academy Award winning directors
2019 in Angola	History of Angola, 2019 in Africa
Black Adam (movie)	American superhero movies, DC Extended Universe movies, Warner Bros. movies, Movies directed by Jaume Collet-Serra
The Flash (movie)	2022 movies, American superhero movies, DC Extended Universe movies, Warner Bros. movies
Don (2006 Hindi movie)	2006 movies, Hindi-language movies, Indian movies
Supergirl	DC Comics superheroes
Sasha Calle	Living people, 1995 births, Actors from Boston, Massachusetts, American television actors, American movie actors
Maribel Verdú	1970 births, Living people, Spanish movie actors, Spanish television actors, Spanish voice actors, Spanish stage actors, Actors from Madrid
Iris West	Fictional characters introduced in the 1950s, DC Comics characters
Daniel Maldini	Italian footballers, 2001 births
Godot	Video game technology
Floride Calhoun	Second Ladies of the United States, 1792 births, 1866 deaths
Executioner tree frog	Frogs, Animals of South America
Euskirchen	Euskirchen (district), Towns in North Rhine-Westphalia
Amrish Puri	Indian actors
Bad Münstereifel	Spa towns in Germany, Euskirchen (district)
Mechernich	Towns in North Rhine-Westphalia, Euskirchen (district)
Killing of Andrew Brown Jr.	1979 births, 2021 deaths, Police misconduct, People shot dead by law enforcement officers in the United States, April 2021 events, 2021 in the United States, 21st century in North Carolina
Zero-coupon bond	Finance
2021 Rio de Janeiro shootout	2020s in Brazil, 2021 in South America, 2021 mass shootings, Crime in South America, May 2021 events, Rio de Janeiro
Francis, Duke of Châtellerault	1492 births, 1515 deaths, House of Bourbon, House of Bourbon-Montpensier, House of Capet, Capetian dynasty, French royalty, French nobility, 16th-century peers of France, Dukes of Châtellerault, Military leaders of the Italian Wars, Military personnel killed in action
Cadet branch	Nobility, Genealogy
The Man Who Would Be King	1975 movies, 1970s adventure movies, British adventure movies, American adventure movies, Movies based on books, Movies set in Afghanistan, Movies directed by John Huston
Five Nights at Candy's	Games
European Institute for International Law and International Relations	International relations, 2008 establishments in Europe
Killing of Ma'Khia Bryant	2021 in the United States, 2021 deaths, April 2021 events, 2004 births, 2021 crimes
Central, Louisiana	Cities in Louisiana
Twait shad	Edible fish, Clupeiformes, Threatened species
Pac-Man (character)	Video game characters
Power pellets	Video game gameplay
Follonica	Towns in Tuscany
Capalbio	Settlements in Tuscany
The Corn Harvesters (Filippini)	Paintings by Francesco Filippini
Castel del Piano	Settlements in Tuscany
Scutching of the canapa (Filippini, Pinacoteca di Brera)	Paintings by Francesco Filippini
The Trip hammer (Filippini, Pinacoteca di Brera)	paintings by Francesco Filippini
Nino Camardo	1949 births, Living people
Life and Extraordinary Adventures of Private Ivan Chonkin	1994 comedy-drama movies, 1990s war movies, Russian movies, Czech movies, British war movies, British comedy-drama movies, French comedy movies, French drama movies, Italian comedy movies, Italian drama movies, Movies based on books, Movies directed by Jiří Menzel
Johnny Destiny, Space Ranger	1979 movies, 1983 movies, American action movies, American science fiction movies, South Korean movies
Rivers of Babylon (movie)	1998 comedy movies, Slovakian movies, Czech movies, Movies based on books, Movies directed by Vlado Balco
Vrahovice	Villages in the Czech Republic
Veronica se întoarce	1973 movies, 1970s fantasy movies, 1970s musical movies, Romanian movies, Movies directed by Elisabeta Bostan
San Carlos tree frog	Frogs, Animals of South America
Gnocchi	Italian food
Castell'Azzara	Settlements in Tuscany
Castiglione della Pescaia	Settlements in Tuscany
Cinigiano	Settlements in Tuscany
Civitella Paganico	Settlements in Tuscany
Gavorrano	Settlements in Tuscany
Magliano in Toscana	Settlements in Tuscany
Manciano	Towns in Tuscany
Massa Marittima	Towns in Tuscany
Monte Argentario	Settlements in Tuscany
Schleiden	Euskirchen (district), CS1 German-language sources (de), Coordinates on Wikidata
Monterotondo Marittimo	Settlements in Tuscany
Montieri	Settlements in Tuscany
Pitigliano	Towns in Tuscany
Roccalbegna	Settlements in Tuscany
Zülpich	Euskirchen (district), Towns in North Rhine-Westphalia, CS1 German-language sources (de), Coordinates on Wikidata
Roccastrada	Settlements in Tuscany
Santa Fiora	Settlements in Tuscany
Scansano	Settlements in Tuscany
Seggiano	Settlements in Tuscany
Semproniano	Settlements in Tuscany
Sorano	Settlements in Tuscany
Laterina Pergine Valdarno	2010s establishments in Italy, 2018 establishments in Europe, Settlements in Tuscany
Blankenheim, North Rhine-Westphalia	Euskirchen (district), CS1 German-language sources (de), Coordinates on Wikidata, Municipalities in North Rhine-Westphalia
Laterina	Former municipalities of Tuscany
Pergine Valdarno	Former municipalities of Tuscany
Dahlem, North Rhine-Westphalia	Euskirchen (district), Municipalities in North Rhine-Westphalia, CS1 German-language sources (de), Coordinates on Wikidata
Castelfranco di Sopra	Former municipalities of Tuscany
San Giovanni Valdarno	Towns in Tuscany
Domléger-Longvillers	Communes in Somme
Dommartin, Somme	Communes in Somme
Ranveer Singh	Indian movie actors, 1985 births, Living people
Dommartin, Doubs	Communes in Doubs
RSGC1-F01	Supergiants
Dommartin-le-Franc	Communes in Haute-Marne
Domqueur	Communes in Somme
Dompierre-aux-Bois	Communes in Meuse
Dompierre-les-Tilleuls	Communes in Doubs
Dompierre-les-Églises	Communes in Haute-Vienne
Dompierre-les-Ormes	Communes in Saône-et-Loire
Dompierre-sous-Sanvignes	Communes in Saône-et-Loire
Dompierre-sur-Charente	Communes in Charente-Maritime
Lunel	Communes in Hérault
Les Adrets-de-l'Estérel	Communes in Var
Hellenthal	Euskirchen (district), Municipalities in North Rhine-Westphalia, CS1 German-language sources (de), Coordinates on Wikidata
Kall, North Rhine-Westphalia	Euskirchen (district), Municipalities in North Rhine-Westphalia, CS1 German-language sources (de), Coordinates on Wikidata
Jim Cawley	Lieutenant Governors of Pennsylvania, 1969 births, Living people, US Republican Party politicians
Douilly	Communes in Somme
Dreuil-lès-Amiens	Communes in Somme
Dury, Somme	Communes in Somme
Société Générale	19th century establishments in France, 1864 establishments in Europe, Companies of France, Banks
Compression artifact	Data structures
Eaucourt-sur-Somme	Communes in Somme
L'Échelle-Saint-Aurin	Communes in Somme
Éclusier-Vaux	Communes in Somme
Lloyd Price	1933 births, 2021 deaths, Deaths from diabetes, American R&B singers, American rock singers, American singer-songwriters, Businesspeople from Louisiana, Singers from Louisiana, Writers from Louisiana
Bobby Unser	1934 births, 2021 deaths, American racecar drivers, Formula One drivers, Sportspeople from Colorado, People from Colorado Springs, Colorado
Bermuda, Louisiana	Unincorporated communities in Natchitoches Parish, Louisiana
George Jung	1942 births, Living people, American people convicted of drug offenses, People from Boston, Massachusetts, Deaths from liver failure, Deaths from renal failure
Helen Murray Free	1923 births, 2021 deaths, American chemists, American academics, Scientists from Pittsburgh, Pennsylvania, Female scientists, American inventors, Deaths from stroke
Georgy Prokopenko	1937 births, 2021 deaths, Soviet Olympic silver medalists, Swimmers
Yitzhak Arad	1926 births, 2021 deaths, Israeli military people, Israeli historians, Israeli writers, Generals
Hohenwald, Tennessee	Cities in Tennessee, County seats in Tennessee
Jacksboro, Tennessee	Towns in Tennessee, County seats in Tennessee
Leonard Jeffries	1937 births, Living people, American academics, African American writers, American civil rights activists, Writers from Newark, New Jersey
Forever Yours (1959 movie)	1959 drama movies, 1950s romantic drama movies, Egyptian movies, Movies directed by Youssef Chahine
Benigno Aquino III 2010 presidential campaign	2010 in Asia, 2010s in the Philippines, Politics of the Philippines
The Emigrant (1994 movie)	1994 drama movies, Egyptian movies, French drama movies, Movies directed by Youssef Chahine
Shaggs' Own Thing	1982 albums, Compilation albums, Pop rock albums
The Indecent Woman	1991 thriller movies, 1991 drama movies, 1990s erotic movies, Dutch drama movies, Movies directed by Ben Verbong
Uncle Marin, the Billionaire	1979 comedy movies, Romanian movies, Movies directed by Sergiu Nicolaescu
Seixal	Cities in Portugal, Municipalities of Portugal
Badia Tedalda	Settlements in Tuscany
Bibbiena	Settlements in Tuscany
Bucine	Settlements in Tuscany
Castiglion Fiorentino	Towns in Tuscany
Terranuova Bracciolini	Settlements in Tuscany
Capolona	Settlements in Tuscany
Caprese Michelangelo	Settlements in Tuscany
Übermensch	Philosophy
My Life (Clinton autobiography)	2004 books, Autobiographies, Bill Clinton
Washington Monthly	Newspapers in the United States
Rogers Morton	1914 births, 1979 deaths, United States representatives from Maryland, United States Secretaries of Commerce, United States Secretaries of the Interior, Politicians from Louisville, Kentucky, US Republican Party politicians, Deaths from prostate cancer
Kansas's 6th congressional district	Congressional districts of Kansas
Wounded in action	Military terminology
10th Mountain Division	United States Army
Keith Sebelius	1916 births, 1982 deaths, Kansas Republicans, United States representatives from Kansas, Deaths from prostate cancer
Wint Smith	1892 births, 1976 deaths, Kansas Republicans, United States representatives from Kansas
Sheila Frahm	1945 births, Living people, Kansas Republicans, United States senators from Kansas
Frank Carlson	1893 births, 1987 deaths, Kansas Republicans, United States senators from Kansas, United States representatives from Kansas, Governors of Kansas
Untermensch	Racism
United States Senate Committee on Finance	Committees of the United States Senate
Senate Republican Conference	United States Senate, Republicans (United States)
Senate Democratic Caucus	United States Senate, Democrats (United States)
United States Senate Committee on Agriculture, Nutrition, and Forestry	Committees of the United States Senate
William H. Avery (politician)	1911 births, 2009 deaths, United States representatives from Kansas, Governors of Kansas, Kansas Republicans, Businesspeople from Kansas, Bankers
Wakefield, Kansas	Cities in Kansas
Victims of Communism Memorial Foundation	1994 establishments in the United States, Non-profit organizations of Washington, D.C.
Law firm	Law
1988 Republican Party presidential primaries	1988 in the United States, United States presidential primary elections, United States Republican Party
1996 Republican Party presidential primaries	1996 in the United States, United States presidential primary elections, United States Republican Party
1996 Republican National Convention	1996 in the United States, United States Republican Party, United States presidential nominating conventions
Winfield Scott Hancock	1824 births, 1886 deaths, American generals, Politicians from Pennsylvania, US Democratic Party politicians
Kappa Sigma	1869 establishments in the United States, Education in the United States
Anaphia	Medical signs
Castel d'Aiano	Settlements in Emilia-Romagna
Civil Rights Act of 1968	1968 in the United States, United States law
1995–1996 United States federal government shutdowns	1995 in the United States, 1996 in the United States
Cheitharol Kumbaba	History of Manipur, Puya
Embreville	Communes in Somme
Ennemain	Communes in Somme
Épaumesnil	Communes in Somme
Épécamps	Communes in Somme
Épehy	Communes in Somme
Épénancourt	Communes in Somme
Shija Laioibi	History of Manipur, Meitei culture, Manipur
Brioux-sur-Boutonne	Communes in Deux-Sèvres
The Famous Paparazzo	1999 drama movies, 1999 action movies, Romanian movies, Movies directed by Nicolae Mărgineanu
Chef-Boutonne	Communes in Deux-Sèvres
La Bataille	Former communes in Deux-Sèvres
Crézières	Former communes in Deux-Sèvres
Tillou	Former communes in Deux-Sèvres
Mauzé-Thouarsais	Former communes in Deux-Sèvres
Better Days (movie)	2019 romance movies, 2019 drama movies, 2010s romantic drama movies, 2010s crime drama movies, Hong Kong movies, Chinese movies, Movies based on books, Movies directed by Derek Tsang
A Rumor of Love	1960 comedy movies, 1960s romantic comedy movies, Egyptian movies, Movies directed by Fatin Abdel Wahab
Appropriations bill (United States)	United States federal legislation
Federal City Council	20th-century establishments in Washington, D.C., 1954 establishments in the United States, Non-profit organizations of Washington, D.C.
World War II Memorial	Monuments and memorials in the United States, Buildings and structures in Washington, D.C.
Bipartisan Policy Center	Think tanks
Bipartisanship	Political systems
Commission on Presidential Debates	1987 establishments in the United States, United States presidential elections
Public service announcement	Advertising
Presidential Citizens Medal	Orders, decorations, and medals of the United States, 1969 establishments in the United States
National Flag Decoration	1996 establishments in Europe, Orders, decorations, and medals, Albania
Hong Nam-ki	1960 births, Living people, Prime Ministers of South Korea
Kim Boo-kyum	1958 births, Living people, South Korean politicians
Gustavo Petro	1960 births, Living people, Colombian politicians, People from Bogotá
Pedro Castillo	1969 births, Living people, Teachers, Political activists, Presidents of Peru, Peruvian educators, Current national leaders
Shaun Bailey (AM)	1971 births, Living people, Conservative Party (UK) people, Politicians from London
The Weekend Top 30	Radio programs
Ruffle (software)	Free software
Margaret Pomeranz	1944 births, Living people, Television personalities, Writers from New South Wales, Movie critics
Merida tree frog	Frogs, Animals of South America
Periostracum	Skin, Molluscs
Castel Focognano	Settlements in Tuscany
Castel San Niccolò	Settlements in Tuscany
Jerago con Orago	Settlements in Lombardy
Castiglion Fibocchi	Settlements in Tuscany
Cavriglia	Settlements in Tuscany
Chitignano	Settlements in Tuscany
Pomarance	Settlements in Tuscany
Chiusi della Verna	Settlements in Tuscany
Civitella in Val di Chiana	Settlements in Tuscany
Foiano della Chiana	Settlements in Tuscany
Castelfranco Piandiscò	2014 establishments in Italy, Settlements in Tuscany
Pian di Scò	Former municipalities of Tuscany
Fatherland Front (Austria)	Political parties in Austria
Loro Ciuffenna	Settlements in Tuscany
Belizean American	Ethnic groups in the United States
Islam in South Asia	Islam, South Asia
Herstadberg	Settlements in Ostergotland County
Öbonäs	Settlements in Ostergotland County
Graversfors	Settlements in Ostergotland County
Nettersheim	Euskirchen (district), Municipalities in North Rhine-Westphalia, CS1 German-language sources (de), Coordinates on Wikidata
Weilerswist	Euskirchen (district), Municipalities in North Rhine-Westphalia, CS1 German-language sources (de), Coordinates on Wikidata
Feichten	Altötting (district), CS1 German-language sources (de), Coordinates on Wikidata
Kirchweidach	Altötting (district), CS1 German-language sources (de), Coordinates on Wikidata
Racketeering	Organized crime
Garching an der Alz	Altötting (district), CS1 German-language sources (de), Coordinates on Wikidata
Lucignano	Settlements in Tuscany
Marciano della Chiana	Settlements in Tuscany
Haiming, Germany	Altötting (district), CS1 German-language sources (de), Coordinates on Wikidata
Halsbach	Altötting (district), CS1 German-language sources (de), Coordinates on Wikidata
Point shaving	Organized crime, Basketball
Al Hudaydah	Cities in Yemen, Settlements in Al Hudaydah Governorate, Port cities in the Arabian Peninsula, Port cities and towns of the Red Sea
Kastl, Upper Bavaria	Altötting (district), CS1 German-language sources (de), Coordinates on Wikidata
Unterneukirchen	Altötting (district), CS1 German-language sources (de), Coordinates on Wikidata
Marktl	Altötting (district), CS1 German-language sources (de), Coordinates on Wikidata, Municipalities in Bavaria
Monte San Savino	Towns in Tuscany
Montemignaio	Settlements in Tuscany
Monterchi	Settlements in Tuscany
Ortignano Raggiolo	Settlements in Tuscany
Spain national under-21 football team	Articles containing Spanish-language text, National under-21 football teams, Football in Spain
Pieve Santo Stefano	Settlements in Tuscany
Poppi	Settlements in Tuscany
Guidonia Montecelio	Cities in Lazio
Aprilia, Lazio	Cities in Lazio
Thiais	Communes in Val-de-Marne
2021 UEFA European Under-21 Championship qualification Group 6	2021 in association football
Nothing in Common	1986 romance movies, 1986 comedy movies, 1986 drama movies, 1980s romantic comedy movies, 1980s romantic drama movies, American romantic comedy movies, American romantic drama movies, Movies directed by Garry Marshall
ASEAN Declaration	1967, 20th century treaties, ASEAN, History of Asia, History of Indonesia, International organizations
Yusof Ishak	Singaporean politicians, 1910 births, 1970 deaths
Popular Force	Political parties in Peru, Conservative parties
Netherlands national under-21 football team	National under-21 football teams, Football in the Netherlands
AI Song Contest 2020	AI Song Contest, Artificial intelligence, 2020s in the Netherlands
Ferenc Deák (footballer)	1922 births, 1998 deaths, Hungarian footballers, Association football forwards, Sportspeople from Budapest
Explosion (1973 movie)	1973 drama movies, Romanian movies, Movies directed by Mircea Drăgan
Nemzeti Bajnokság I	Football leagues, Football in Hungary, Establishments in Hungary, 1901 establishments in Europe
Nándor Hidegkuti	1922 births, 2002 deaths, Hungarian footballers, Hungarian football managers, 1954 FIFA World Cup players, 1958 FIFA World Cup players, Olympic medalists in football, Medalists at the 1952 Summer Olympics, Association football forwards, Sportspeople from Budapest
MTK Budapest FC	Hungarian football clubs, Budapest, Establishments in Hungary, 1888 establishments in Europe
Peruvian food	Foods by nationality, Peruvian culture
Expedition 64	Spaceflight
Expedition 65	Spaceflight
Crew Dragon Resilience	Spacecraft
Nick Kamen	1962 births, 2021 deaths, English pop singers, Singer-songwriters from London, Musicians from London, Models from London
2019 UEFA European Under-21 Championship qualification Group 4	2019 in association football
Alan McLoughlin	1967 births, 2021 deaths, Deaths from kidney cancer, Irish footballers, Irish football managers, Sportspeople from Manchester
Bertil Johansson	1935 births, 2021 deaths, Swedish footballers, Swedish football managers, People from Gothenburg
Tawny Kitaen	1961 births, 2021 deaths, American movie actors, American television actors, American voice actors, American stage actors, Television personalities from California, Models from San Diego, California, Actors from San Diego, California, Comedians from California
Martín Pando	1934 births, 2021 deaths, Argentine footballers
United States presidential pets	United States presidential pets
Champ and Major	Joe Biden, United States presidential pets, Individual dogs
Sunny (dog)	2012 births, United States presidential pets, Individual dogs, Obama family
Willy Baumgärtner	1890 births, 1953 deaths, German footballers, Association football forwards, Sportspeople from Berlin
Ronald Inglehart	1934 births, 2021 deaths, American political scientists, American academics, Writers from Milwaukee, Wisconsin
Theodore Katsanevas	1947 births, 2021 deaths, Greek politicians, Greek economists, Academics, People from Athens, Deaths from the COVID-19 pandemic in Greece
Eli Broad	1933 births, 2021 deaths, American billionaires, American Jews, American philanthropists, Businesspeople from New York City, Jewish billionaires, Jewish businesspeople, Jewish philanthropists, People from the Bronx
Brazil national under-20 football team	National under-20 football teams, Football in Brazil
Edythe Broad	1936 births, Living people, American billionaires, American philanthropists, Businesspeople from Detroit, Michigan
Gad Elmaleh	1971 births, Living people, Canadian movie actors, Canadian television actors, Canadian voice actors, Canadian comedians, People from Casablanca, Naturalized citizens of Canada
Tony Curran	1969 births, Living people, BAFTA Award winning actors, Scottish movie actors, Scottish stage actors, Scottish voice actors, Scottish television actors, Actors from Glasgow
Soviet Union national under-20 football team	National under-20 football teams, Disestablishments in Europe, Soviet Union
GTC Africa	2002 video games, PlayStation 2 games, PlayStation 2-only games, Racing video games
Hearty Channel and Blue Star Entertainment Philippines Film	Philippines
Pratovecchio Stia	2014 establishments in Italy, Settlements in Tuscany
Pratovecchio	Former municipalities of Tuscany
Stia	Former municipalities of Tuscany
Sestino	Settlements in Tuscany
Subbiano	Settlements in Tuscany
Talla	Settlements in Tuscany
Bibbona	Settlements in Tuscany
Campiglia Marittima	Settlements in Tuscany
Campi Bisenzio	Settlements in Tuscany
Cerreto Guidi	Settlements in Tuscany
Scarperia e San Piero	2014 establishments in Italy, Settlements in Tuscany
Scarperia	Former municipalities of Tuscany
San Piero a Sieve	Former municipalities of Tuscany
Barberino Val d'Elsa	Former municipalities of Tuscany
Tavarnelle Val di Pesa	Former municipalities of Tuscany
Barberino Tavarnelle	2010s establishments in Italy, 2019 establishments in Europe, Settlements in Tuscany
Asphalt concrete	Building materials, Road transport
The Fourth Man (2007 movie)	2007 movies, 2000s action movies, Serbian movies, Movies directed by Dejan Zečević
River Tales	2020 movies, Documentary movies, Luxembourgian movies
Kyle Lafferty	1987 births, Living people, Northern Irish footballers
Steven Zuber	1991 births, Swiss footballers, 2018 FIFA World Cup players, Association football midfielders, People from Winterthur, Living people
Nokia 7610	Nokia mobile phones, Mobile phones released in 2000s
Asphalt, Kentucky	Unincorporated communities in Kentucky
The Virgin of Lust	2002 drama movies, Mexican movies, Movies directed by Arturo Ripstein
No One Writes to the Colonel (movie)	1999 drama movies, French drama movies, Spanish movies, Mexican movies, Movies based on short stories, Movies directed by Arturo Ripstein
Bagno a Ripoli	Settlements in Tuscany
Greve in Chianti	Settlements in Tuscany
Castelfiorentino	Towns in Tuscany
Barberino di Mugello	Settlements in Tuscany
Gambassi Terme	Settlements in Tuscany
Lastra a Signa	Settlements in Tuscany
Panini	Italian food, Sandwiches
Certaldo	Towns in Tuscany
Éplessier	Communes in Somme
2021–22 FC Bayern Munich season	2021 in association football, 2022 in sports, Football in Germany, Sport in Munich
List of rulers of Moirang kingdom	History of Manipur, Meitei culture
Abdul Aziz al-Hakim	1953 births, 2009 deaths, Iraqi politicians
Gil Vicente F.C.	20th century establishments in Portugal, 1924 establishments in Europe, Portuguese football clubs
Portugal national under-19 football team	National football teams, Football in Portugal
Kyle Walker	1990 births, Living people, English footballers, Association football defenders, Tottenham Hotspur F.C. players, Aston Villa F.C. players, Manchester City F.C. players, Premier League players, UEFA Euro 2016 players, 2018 FIFA World Cup players, Black British sportspeople, Sportspeople from Sheffield
2020–21 Premier League	2020 in association football, 2021 in association football, Premier League
TIAA Bank Field	National Football League venues, Sports buildings in Florida
Ireland national football team (1882–1950)	National football teams, Football in Ireland, Football in Northern Ireland, Disestablishments in the United Kingdom
Bycatch	Fishing
Childhood schizophrenia	Diseases
Équancourt	Communes in Somme
Équennes-Éramecourt	Communes in Somme
American Diabetes Association	Organizations based in the United States, 1940 establishments in the United States
Mehring	Altötting (district), CS1 German-language sources (de), Coordinates on Wikidata
Agnes Bluhm	1862 births, 1940 deaths, German doctors, People from Istanbul
Perach	Altötting (district), CS1 German-language sources (de), Coordinates on Wikidata
Toby Alderweireld	1989 births, Belgian footballers, Association football defenders, 2014 FIFA World Cup players, UEFA Euro 2016 players, 2018 FIFA World Cup players, Tottenham Hotspur F.C. players, Premier League players, People from Antwerp, Living people
Erches	Communes in Somme
1977 Russian flu	Diseases caused by viruses, 1977
Frequent urination	Symptoms
Thomas Meunier	1991 births, Belgian footballers, Association football defenders, UEFA Euro 2016 players, 2018 FIFA World Cup players, People from Luxembourg (Belgium), Living people
Jan Vertonghen	1987 births, Belgian footballers, Association football defenders, Tottenham Hotspur F.C. players, Premier League players, 2014 FIFA World Cup players, UEFA Euro 2016 players, 2018 FIFA World Cup players, People from East Flanders, Living people
Ercheu	Communes in Somme
Ercourt	Communes in Somme
Cusihuiriachi Municipality	Municipalities of Chihuahua
Wasquehal	Communes in Nord
Mohammed Baqir al-Hakim	1939 births, 2003 deaths
John Whiteaker	Governors of Oregon, United States representatives from Oregon
A. C. Gibbs	Governors of Oregon, People from New York, 1825 births
George Lemuel Woods	1832 births, 1890 deaths, Governors of Oregon
La Fayette Grover	United States senators from Oregon, Governors of Oregon, United States representatives from Oregon, 1823 births, 1911 deaths
Stephen F. Chadwick	Governors of Oregon
W. W. Thayer	Governors of Oregon, Idaho History
Z. F. Moody	Governors of Oregon, 1832 births, 1917 deaths
Rusch's tree frog	Frogs, Animals of South America
Sylvester Pennoyer	1831 births, 1902 deaths, Politicians from Oregon
William Paine Lord	Governors of Oregon
Leslie Marr	1922 births, 2021 deaths, British racecar drivers, British painters, Sportspeople from County Durham
Campton Hills, Illinois	Villages in Illinois, Suburbs of Chicago, Illinois
Liberty Place	Buildings and structures in Philadelphia, Pennsylvania, Skyscrapers in the United States
Melanie Stansbury	1979 births, Living people, United States representatives from New Mexico, State legislators of the United States, Politicians from Albuquerque, New Mexico, US Democratic Party politicians, Scientists from New Mexico
Paul Mooney (comedian)	1941 births, 2021 deaths, American movie actors, American television actors, American voice actors, African American actors, African American comedians, American critics, African American writers, Writers from Louisiana, Actors from Louisiana, People from Shreveport, Louisiana, Deaths from myocardial infarction, Cardiovascular disease deaths in California
Molly Crabapple	1983 births, Living people, American illustrators, American autobiographers, American editors, Artists from New York City, Writers from Queens
George Earle Chamberlain	Governors of Oregon, United States senators from Oregon, 1854 births, People from Mississippi
Frank W. Benson (Oregon Governor)	Governors of Oregon
Jay Bowerman	1873 births, 1960 deaths, Governors of Oregon
Oswald West	1873 births, 1960 deaths, Governors of Oregon, Democratic Republican party (US) politicians
James Withycombe	Governors of Oregon
Ben W. Olcott	Governors of Oregon
Walter M. Pierce	Oregon State Senators, Governors of Oregon, United States representatives from Oregon
I. L. Patterson	Governors of Oregon, Oregon State Senators
A. W. Norblad	Governors of Oregon
Julius L. Meier	1874 births, 1937 deaths, Governors of Oregon
Dimetri Hogan	1992 births, African American actors, American record producers, Living people
Cyberattack	Computer security
Lily Lake, Illinois	Villages in Illinois, Suburbs of Chicago, Illinois
Borgo San Lorenzo	Settlements in Tuscany
Capraia e Limite	Settlements in Tuscany
Figline Valdarno	Former municipalities of Tuscany
Incisa in Val d'Arno	Former municipalities of Tuscany
Figline e Incisa Valdarno	2014 establishments in Italy, Settlements in Tuscany
Firenzuola	Settlements in Tuscany
Fucecchio	Towns in Tuscany
Impruneta	Towns in Tuscany
Treviglio	Cities in Lombardy
Solza	Settlements in Lombardy
Bauduen	Communes in Var
Moustiers-Sainte-Marie	Communes in Alpes-de-Haute-Provence
Alexander	Given names
Aiguines	Communes in Var
Habermann (movie)	2010 drama movies, 2010s war movies, Czech movies, German drama movies, Austrian movies, Movies directed by Juraj Herz
Incarnations of Nongthang Leima	Meitei culture, Meitei folklore, Meitei literature, Meitei mythology, Meitei religion
Oggy and the Cockroaches (video game)	Cancelled video games, 2005 video games, Xliam, Game Boy Advance games
Yellow tree frog	Frogs, Animals of South America, Animals of North America
T. T. Geer	1851 births, 1924 deaths, Democratic Republican party (US) politicians, Governors of Oregon
Charles A. Sprague	Politicians from Kansas, 1887 births, 1969 deaths
Florida's 27th congressional district	United States House of Representatives, Government of Florida
Hypixel	Minecraft, Servers
Akshaye Khanna	Actors from Mumbai
Webdings	Fonts
Germany national under-20 football team	National under-20 football teams, Football in Germany
A♭(musical note)	Musical notes
Ergnies	Communes in Somme
Haris Seferović	1992 births, Swiss footballers, Association football forwards, 2014 FIFA World Cup players, UEFA Euro 2016 players, 2018 FIFA World Cup players, Living people
Érondelle	Communes in Somme
Esclainvillers	Communes in Somme
Cremenaga	Settlements in Lombardy
Imung Lai	Meitei culture, Meitei religion
Londa	Settlements in Tuscany
Marradi	Settlements in Tuscany
Montaione	Settlements in Tuscany
Montelupo Fiorentino	Settlements in Tuscany
Apokpa	Meitei culture, Meitei religion
Montespertoli	Settlements in Tuscany
Courtenay Bartholomew	Physicians
Karl Wirsum	1939 births, 2021 deaths, Artists from Chicago
Palazzuolo sul Senio	Settlements in Tuscany
Pleiskirchen	Municipalities in Bavaria, Altötting (district)
Esmery-Hallon	Communes in Somme
Essertaux	Communes in Somme
Estrébœuf	Communes in Somme
Estrées-Deniécourt	Communes in Somme
Dompierre-sur-Helpe	Communes in Nord
Julian Nagelsmann	1987 births, Living people, German footballers, German football managers, Association football defenders, Sportspeople from Bavaria
2017-18 United States flu season	2017 in the United States, 2018 in the United States, Diseases
Kelly Oubre Jr.	1995 births, African-American basketball players, American basketball players, Golden State Warriors players, Phoenix Suns players, Washington Wizards players, Sportspeople from New Orleans, Louisiana, Living people
Homeric Greek	Greek language
Umang Lai	Meitei culture, Meitei folklore, Meitei mythology, Meitei religion
Alkoxide	Physical chemistry, Analytical chemistry, Functional groups
Classes of deities in Meitei religion	Meitei folklore, Meitei mythology, Meitei religion
Apokpa Marup	Meitei culture, Meitei religion
Metal toxicity	Metals, Toxicology
Washi	Japanese culture, Paper
Deux Rivières	2017 establishments in France, Communes in Yonne
Treigny-Perreuse-Sainte-Colombe	2019 establishments in France, Communes in Yonne
Andrew Symonds	1975 births, Living people, Adoptees, Australian cricketers, Naturalised citizens of Australia, Sportspeople from Birmingham, Sportspeople from Queensland
The Cow (movie)	1969 drama movies, Iranian movies, Movies directed by Dariush Mehrjui
Pelago	Settlements in Tuscany
Pontassieve	Towns in Tuscany
Reggello	Settlements in Tuscany
Rignano sull'Arno	Settlements in Tuscany
Sesto Fiorentino	Cities in Tuscany
Rufina	Settlements in Tuscany
Luhansk	Cities in Ukraine
Zeolite	Minerals
Singapore-Cambridge GCE Ordinary Level	Examinations
Dendropsophus dutrai	Frogs, Animals of South America
Veigy-Foncenex	Communes in Haute-Savoie
DanTDM	1991 births, Living people, British YouTubers, Twitch (service) streamers
A627(M) motorway	Motorways in England
Meitei philosophy	Meitei culture
Coleman, Alberta	Settlements in Alberta
Kameni Nakamura	1894 births, 2004 deaths, Deaths from natural causes, Japanese centenarians, People from Okinawa Prefecture
Monroe Hayward	1840 births, 1899 deaths, American lawyers, Military personnel of the American Civil War, Politicians from Nebraska, Politicians from New York, US Republican Party politicians
Willsboro, New York	Towns in New York
Whitewater, Wisconsin	Cities in Wisconsin
San Casciano in Val di Pesa	Settlements in Tuscany
Morgan Hill, California	Cities in California, Cities in the San Francisco Bay Area, Settlements in Santa Clara County, California
San Godenzo	Settlements in Tuscany
Estrées-lès-Crécy	Communes in Somme
Estrées-Mons	Communes in Somme
Estrées, Nord	Communes in Nord
Estrées-sur-Noye	Communes in Somme
Abscon	Communes in Nord
Étalon, Somme	Communes in Somme
Granit Xhaka	1992 births, Swiss footballers, Arsenal F.C. players, Premier League players, 2014 FIFA World Cup players, UEFA Euro 2016 players, 2018 FIFA World Cup players, Association football midfielders, Sportspeople from Basel, Living people
Ételfay	Communes in Somme
Huế Massacre	War crimes
Josh Duggar	1988 births, American television personalities, American political activists, People from Arkansas, Living people
Stammham, Altötting	Municipalities in Bavaria, Altötting (district)
Teising	Municipalities in Bavaria, Altötting (district)
Tüßling	Altötting (district)
Tyrlaching	Altötting (district)
Winhöring	Altötting (district)
Geretsried	Bad Tölz-Wolfratshausen
Bad Heilbrunn	Spa towns in Germany, Bad Tölz-Wolfratshausen
Barnier	Surnames
Red cabbage	Leaf vegetables, Brassica oleracea
Benediktbeuern	Bad Tölz-Wolfratshausen
Plague of Cyprian	Plague pandemics, Roman  Empire
Happy Land fire	Fires in the United States, 1990 in the United States, 1990s in New York City
Savoy cabbage	Leaf vegetables, Brassica oleracea
Sixth cholera pandemic	Disasters in the 20th century, Cholera pandemics
Gai lan	Leaf vegetables, Brassica oleracea
Shadow of Destiny	2001 video games, Konami games, PlayStation 2 games, PlayStation Portable games, Video games developed in Japan, Windows games, Xbox games
Ico	2001 video games, PlayStation 2 games, PlayStation 2-only games, Video games developed in Japan
Tracery	Windows (architecture), Gothic architecture, Church architecture
Action Henk	2014 video games, Racing video games, MacOS games, PlayStation 3 games, PlayStation 4 games, Windows games, Xbox One games, Xbox 360 games
Murder of Ennis Cosby	Murders by firearm in California, 1997
Date rape drug	Rape, Drugs
Men who have sex with men	Human sexuality
Book series	Series of books
Hebe (asteroid)	Asteroids
Iris (asteroid)	Asteroids
Jim Henson's The Hoobs (video game)	2002 video games, PlayStation games, PlayStation-only games, Action video games
Nankhari	Himachal Pradesh, Shimla, Tehsils of India
Samsung Galaxy A32	Samsung Galaxy A-series, Mobile phones released in 2021, Mobile phones with multiple rear cameras
Samsung Galaxy A52	Samsung Galaxy A-series, Mobile phones released in 2021, Mobile phones with multiple rear cameras, Mobile phones with 4K video recording
Samsung Galaxy A72	Samsung Galaxy A-series, Mobile phones released in 2021, Mobile phones with multiple rear cameras, Mobile phones with 4K video recording
2020 FIFA Club Confederations Cup	2020 in sports, FIFA
Dendropsophus salli	Frogs, Animals of South America
Strap	Clothing
Carbonara	Pasta, Italian food
William D. Moseley	People from North Carolina, 1795 births, 1863 deaths, Governors of Florida
Bichl	Bad Tölz-Wolfratshausen
Dietramszell	Bad Tölz-Wolfratshausen
Egling	Bad Tölz-Wolfratshausen
Eurasburg	Bad Tölz-Wolfratshausen
Gaißach	Bad Tölz-Wolfratshausen
Greiling	Bad Tölz-Wolfratshausen
Icking	Bad Tölz-Wolfratshausen
Tamago kake gohan	Japanese food, Rice dishes
Jachenau	Bad Tölz-Wolfratshausen
Reichersbeuern	Bad Tölz-Wolfratshausen
Kochel	Towns in Bavaria
Königsdorf	Bad Tölz-Wolfratshausen
Lenggries	Bad Tölz-Wolfratshausen, 1250s establishments
Münsing	Bad Tölz-Wolfratshausen
Singdarin	Chinese language, Languages of Asia, Singapore
Chilli crab	Asian foods, Singapore, Seafood dishes
Kaya toast	Singapore, Asian foods, Breakfast foods, Breads
Jurong Island	Artificial islands, Islands of Asia, Geography of Singapore
Places in Singapore	Places in Singapore
CCH Pounder	1952 births, Living people, American movie actors, American stage actors, American television actors, American voice actors, Guyanese people, Naturalized citizens of the United States
Waste treatment	Waste management
Democracy sausage	Australian culture, Elections, Foods
Home Movies (TV series)	1999 television series debuts, Animated television series
Dubach, Louisiana	Towns in Louisiana
Vienna, Louisiana	Towns in Louisiana
Gonzales, Louisiana	Cities in Louisiana
DeQuincy, Louisiana	Cities in Louisiana
Playing for Time (movie)	Movies set in the 1940s, 1980 movies, Movies based on books, American drama movies, Television movies, World War II movies
Westlake, Calcasieu Parish, Louisiana	Cities in Louisiana
New Llano, Louisiana	Towns in Louisiana
Rosepine, Louisiana	Towns in Louisiana
2021 Kabul school bombing	2021 in Asia, 2020s explosions in Asia, 2020s in Afghanistan, 2020s murders in Asia, Attacks on buildings and structures in 2021, Attacks on buildings and structures in Asia, Attacks on schools, Car and truck bombings in Asia, Crime in Afghanistan, Kabul, Mass murder in 2021, Mass murder in Asia, May 2021 events, Terrorist incidents in 2021, Terrorist incidents in Asia in the 2020s, War in Afghanistan (since 1978)
2021 Israel–Palestine crisis	2021 crimes, 2021 in Asia, 21st century in Israel, 2020s riots, Attacks on buildings and structures in Asia, Attacks on buildings and structures in the 2020s, History of Palestine, Jerusalem, May 2021 events, Terrorist incidents in Asia in the 2020s
Kazan school shooting	2021 crimes in Europe, 2021 mass shootings, 2020s explosions, 2020s mass shootings in Europe, 21st century in Russia, Attacks on buildings and structures in 2021, Attacks on schools in Europe, Explosions in Europe, May 2021 events, School shootings, Tatarstan
Syosset, New York	Hamlets in New York, Census-designated places in New York (state)
Muja (alligator)	Individual animals, 1937 births
Robert Sarah	1945 births, Living people, Cardinals of the Roman Catholic Church, Guinean people
Angelo Scola	1941 births, Living people, Cardinals of the Roman Catholic Church, Italian Roman Catholics, Italian philosophers, Theologians, People from Milan
2020 Iowa Democratic caucuses	United States presidential primary elections, Controversies in the United States, 2020 in the United States, History of Iowa, 2020 United States presidential election
Arizona City, Arizona	Census-designated places in Arizona
Lorenzo Baldisseri	1940 births, Living people, Cardinals of the Roman Catholic Church, Italian Roman Catholics, People from Tuscany
Stan Francis	1899 births, 1966 deaths, Canadian actors
Hundred Days Offensive	World War I
AFC Fylde	English football clubs, Lancashire
Sony Yay	Television channels, 2017 establishments in Asia, 2010s establishments in India
Honey Bunny Ka Jholmaal	Indian television, 2018 Indian television series debuts
Female bodybuilding	Bodybuilding, Women
Mubeen Saudagar	Indian comedians
Dendropsophus haddadi	Frogs, Animals of South America
The Honey Bunny Show With Kapil Sharma	Indian television series
Social stigma of obesity	Sociology, Obesity
Neusoft	Companies of China
Tortellini	Pasta, Italian food
Larry (cat)	Individual cats, Chief Mouser
Waffle iron	Kitchenware
Evaporated milk	Milk
Belgian waffles	Belgian food
Caroline Rose	1989 births, American folk musicians, American rock singers, American pop singers, Singer-songwriters from New York, Living people
Madilyn Bailey	Singers from Wisconsin, American singer-songwriters, American pop singers, 1992 births, Living people
Nib sugar	Sweeteners
James Garner (footballer, born 2001)	2001 births, Living people, English footballers, People from Birkenhead, Manchester United F.C. players
Kingdom of Bohemia	1190s establishments in Europe, 1198 establishments, 1918 disestablishments in Europe, States of the Holy Roman Empire, Former countries in Europe, Bohemia, States and territories disestablished in the 20th century
Thae Yong-ho	1962 births, Living people, Asian diplomats, North Korean politicians, People from Pyongyang, South Korean politicians
Caramelization	Cooking methods
Bergisches Land	Mountain ranges of Germany, Geography of North Rhine-Westphalia
Wuppertal Schwebebahn	Transport in Germany, Rail transport in Europe, Wuppertal
Camp Lakebottom	English-language television programs
Candice	Given names
Christy Altomare	1986 births, Living people, American singer-songwriters, Singers from Pennsylvania, Award winners, American stage actors
Rocket Monkeys	English-language television programs
Littlest Pet Shop (2012 TV series)	English-language television programs
Dinofroz	English-language television programs
Dinotrux	English-language television programs
Chinese cabbage	Brassicaceae, Leaf vegetables
Elizabeth, Louisiana	Towns in Louisiana
Reeves, Louisiana	Villages in Louisiana
Church Point, Louisiana	Towns in Louisiana
Iota, Louisiana	Towns in Louisiana
Grand Cane, Louisiana	Villages in Louisiana, Ark-La-Tex, Settlements in DeSoto Parish, Louisiana
Longstreet, Louisiana	Villages in Louisiana, Ark-La-Tex, Settlements in DeSoto Parish, Louisiana
South Mansfield, Louisiana	Villages in Louisiana, Ark-La-Tex, Settlements in DeSoto Parish, Louisiana
Stanley, Louisiana	Villages in Louisiana, Ark-La-Tex, Settlements in DeSoto Parish, Louisiana
Irkutsk Oblast	Webarchive template wayback links, CS1 Russian-language sources (ru), Articles with Russian-language sources (ru), Articles containing Russian-language text, Coordinates on Wikidata, Oblasts of Russia, Federal subjects of Russia
Napa cabbage	Leaf vegetables, Brassicaceae
Sachsenkam	Bad Tölz-Wolfratshausen
Schlehdorf	Bad Tölz-Wolfratshausen
Wackersberg	Bad Tölz-Wolfratshausen
Éterpigny, Somme	Communes in Somme
Cernobbio	Settlements in Lombardy
Signa	Settlements in Tuscany
Vaglia	Settlements in Tuscany
Vicchio	Settlements in Tuscany
Vinci, Tuscany	Settlements in Tuscany
Careggine	Settlements in Tuscany
Special K	Breakfast cereals
Furikiwheels	English-language television programs
Kapil Sharma (comedian)	Indian comedians, Indian actors
Boursorama	1990s establishments in France, 1995 establishments in Europe, Companies of France, Banks
IP address blocking	Internet security
Madlax	Light novels, 2004 anime television series
Y Combinator	Companies based in California, 2005 establishments in the United States
Drezzo	Former municipalities of Lombardy
Gironico	Former municipalities of Lombardy
Parè	Former municipalities of Lombardy
Colverde	2014 establishments in Italy, Settlements in Lombardy
Histiocytosis	Blood cells, Blood disorders
Airbnb	2008 establishments in California, Companies based in San Francisco, American websites
Jim Jackson	Living people, 1970 births, American basketball players
Urbino	Cities in Marche, World Heritage Sites in Italy
Lutcher, Louisiana	Towns in Louisiana
Gramercy, Louisiana	Towns in Louisiana
Campo nell'Elba	Settlements in Tuscany
Dendropsophus cruzi	Frogs, Animals of South America
Capoliveri	Settlements in Tuscany
Capraia Isola	Settlements in Tuscany
Castagneto Carducci	Settlements in Tuscany
Collesalvetti	Settlements in Tuscany
Boccioleto	Settlements in Piedmont
Cravagliana	Settlements in Piedmont
Bernd Leno	1992 births, German association football goalkeepers, Arsenal F.C. players, Premier League players, UEFA Euro 2016 players, Sportspeople from Baden-Württemberg, Living people
Adygea	Republics of Russia, Articles containing Russian-language text, CS1 Russian-language sources (ru), CS1 uses Russian-language script (ru), Coordinates on Wikidata
Lorenzo Insigne	1991 births, Italian footballers, Association football forwards, 2014 FIFA World Cup players, UEFA Euro 2016 players, Living people
Frattamaggiore	Settlements in Campania
L'Étoile, Somme	Communes in Somme
Étréjust	Communes in Somme
Étricourt-Manancourt	Communes in Somme
La Faloise	Communes in Somme
Falvy	Communes in Somme
Faverolles, Somme	Communes in Somme
Anykščiai	Cities in Lithuania
Abaucourt-Hautecourt	Communes in Meuse
Favières, Somme	Communes in Somme
Beverly Hills Cop (2006 video game)	2006 video games, Shooter video games, PlayStation 2 games, PlayStation 2-only games
Phillip Glenister	Living people, 1963 births, English movie actors, Actors from London, English television actors
Gina Yashere	Living people, Year of birth missing (living people), English comedians, Black British people, English movie actors, British stand-up comedians, English television actors, Lesbians, LGBT comedians
Lisa Hammond (actress)	Living people, 1978 births, English television actors
Youngsville, Louisiana	Cities in Louisiana, Acadiana
List of Dave Spud & Friends episodes	2020s British spin-off series
Edward Foster	Human name disambiguation pages
Tim Bain	1978 births, Australian children's writers, Writers from Melbourne, Living people
Broussard, Louisiana	Cities in Louisiana, Acadiana
Montpelier, Louisiana	Villages in Louisiana
La Tuque, Quebec	Cities and towns in Quebec
Whole grain	Grains
Blind Ambition	Family Guy (season 4) episodes, 2005 television episodes
Dave Spud	2019 television series debuts, 2010s British television series, Animated television series, Comedy television series, Fantasy television series, ITV children's television shows
Ailly, Eure	Communes in Eure
First cholera pandemic	1810s, 1820s, 19th century in India, Disasters in India, Cholera pandemics
1826–1837 cholera pandemic	1830s, 1820s, Cholera pandemics
Ampus	Communes in Var
Premier of Anguilla	Premiers of Anguilla, Chief Ministers of Anguilla
Osbourne Fleming	1940 births, Living people, Chief Ministers of Anguilla
Hubert Hughes	1933 births, 2021 deaths, Chief Ministers of Anguilla
Victor Banks	1947 births, Chief Ministers of Anguilla, Premiers of Anguilla, Living people
Ellis Webster	Premiers of Anguilla, Living people, Year of birth missing (living people)
Dileeni Daniel-Selvaratnam	Living people, Governors of Anguilla, Year of birth missing (living people), British lawyers
Governor of Anguilla	Governors of Anguilla
Christina Scott	1974 births, Living people, Governors of Anguilla
Svante Thuresson	1937 births, 2021 deaths, Drummers, Jazz singers, Singers from Stockholm, Musicians from Stockholm, Eurovision Song Contest entrants
Spencer Silver	1941 births, 2021 deaths, Cardiovascular disease deaths in the United States, American inventors, American chemists, Scientists from San Antonio, Texas, Scientists from Minnesota, People from Saint Paul, Minnesota
Zhang Enhua	1973 births, 2021 deaths, Deaths from cardiac arrest, Chinese footballers
Hans van Baalen	1960 births, 2021 deaths, Cancer deaths in the Netherlands, Colonels, Dutch military people, Former members of the House of Representatives of the Netherlands, Former MEPs, MEPs for the Netherlands, People's Party for Freedom and Democracy politicians, Politicians from Rotterdam
Federico Salas	1950 births, 2021 deaths, Prime Ministers of Peru, Deaths from the COVID-19 pandemic in Peru
Vice President of Venezuela	Vice Presidents of Venezuela
Aristóbulo Istúriz	1946 births, 2021 deaths, Vice Presidents of Venezuela, Deaths from surgical complications
Delcy Rodríguez	1969 births, Living people, Vice Presidents of Venezuela
Nicholas Cheong Jin-suk	1931 births, 2021 deaths, Cardinals of the Roman Catholic Church, People from Seoul
Tamara Press	1937 births, 2021 deaths, Soviet sportspeople, Soviet Olympic gold medalists, Soviet Olympic silver medalists
Shunsuke Kikuchi	1931 births, 2021 deaths, Japanese composers, Deaths from pneumonia
Milva	1939 births, 2021 deaths, Italian singers, Italian movie actors, Italian television personalities, Italian television actors, People from Emilia-Romagna
Marc Ferro	1924 births, 2021 deaths, French historians, Writers from Paris
Håkon Brusveen	1927 births, 2021 deaths, Norwegian Olympians, Olympic gold medalists, Olympic silver medalists
Willy van der Kuijlen	1946 births, 2021 deaths, Deaths from Alzheimer's disease, Dutch football managers, Dutch footballers, People from Helmond, Sportspeople from North Brabant
Sebastian Koto Khoarai	1929 births, 2021 deaths, Cardinals of the Roman Catholic Church
Charles Geschke	1939 births, 2021 deaths, American computer scientists, Businesspeople from Cleveland, Ohio, Scientists from Cleveland, Ohio, Cancer deaths in California
Conn Findlay	1930 births, 2021 deaths, American Olympic bronze medalists, American Olympic gold medalists, Sportspeople from California, People from Stockton, California
Julen Madariaga	1932 births, 2021 deaths, Spanish politicians, Spanish lawyers
Marshall Sahlins	1930 births, 2021 deaths, American anthropologists, American academics, Writers from Chicago, Scientists from Chicago
Roland Thöni	1951 births, 2021 deaths, Italian Olympians, Olympic bronze medalists
Zygmunt Malanowicz	1938 births, 2021 deaths, Polish movie actors, Polish television actors, Polish stage actors
Sugako Hashida	1925 births, 2021 deaths, Japanese screenwriters, People from Seoul
Montferrat, Var	Communes in Var
Cottonport, Louisiana	Towns in Louisiana
Evergreen, Louisiana	Towns in Louisiana
Fay, Somme	Communes in Somme
Mansura, Louisiana	Towns in Louisiana
Estrées-Saint-Denis	Communes in Oise
Mesnil-sur-l'Estrée	Communes in Eure
Ponchatoula, Louisiana	Cities in Louisiana
Independence, Louisiana	Towns in Louisiana
Cankton, Louisiana	Villages in Louisiana
Palmetto, Louisiana	Villages in Louisiana
Clarks, Louisiana	Villages in Louisiana
Grayson, Louisiana	Villages in Louisiana
Basile, Louisiana	Towns in Louisiana
Duson, Louisiana	Towns in Louisiana
Estherwood, Louisiana	Villages in Louisiana
Walker, Louisiana	Cities in Louisiana
England national under-20 football team	National under-20 football teams, Football in England
Omega-6 fatty acid	Lipids, Health
Omega-3 fatty acid	Lipids, Health
Italy national under-20 football team	National under-20 football teams, Football in Italy
Nokia N900	Nokia mobile phones
Chicken as food	Poultry
Boston Market	American restaurants
United States men's national under-20 soccer team	National under-20 football teams, Soccer in the United States
TCBY	American restaurants, 1981 establishments in the United States
List of presidents of the People's Republic of China	Chinese politicians, History of China
The Athletic	2016 establishments in the United States, American websites, Sports media
Hard Rock Cafe	Companies of the United States, 1971 establishments
Golden Corral	American restaurants, 20th-century establishments in North Carolina, 1973 establishments in the United States
Hooters	1980s establishments in Florida, 1983 establishments in the United States, American restaurants
Nesquik	Drinks, Nestlé
Dzmitry Baskau	1978 births, Belarusian ice hockey players, People from Minsk, Living people
Perkele	Profanity
Arkhangai Province	Provinces, Mongolia
Duplex (movie)	2003 movies, American movies, American black comedy movies, English-language movies, Movies about writers, Movies set in Brooklyn, Movies set in New York City, Movies directed by Danny DeVito, Miramax movies, 2003 comedy movies
Sea of Japan naming dispute	Geography of South Korea, Geography of Japan, Articles containing Japanese-language text, Geography of Russia
Jennifer Crystal Foley	1973 births, Living people, Actors from Los Angeles, California, American movie actors, American television actors
Benhall	Suffolk Coastal, Civil parishes in Suffolk, Villages in Suffolk
Boulge	Villages in Suffolk, Civil parishes in Suffolk, Suffolk Coastal
Henry Priestman	1955 births, Living people, English rock singers, English songwriters, British record producers, British keyboardists, People from Kingston upon Hull
Moss Bluff, Louisiana	Census-designated places in Louisiana
Hackberry, Louisiana	Census-designated places in Louisiana
Mermentau, Louisiana	Villages in Louisiana
Morse, Louisiana	Villages in Louisiana
Directed graph	Graph theory
Branch, Louisiana	Census-designated places in Louisiana
Egan, Louisiana	Census-designated places in Louisiana
Longville, Louisiana	Census-designated places in Louisiana
Oretta, Louisiana	Census-designated places in Louisiana
Woodbury, Tennessee	Towns in Tennessee, County seats in Tennessee
Rutledge, Tennessee	Cities in Tennessee, County seats in Tennessee
Fescamps	Communes in Somme
Friville-Escarbotin	Communes in Somme
Fonches-Fonchette	Communes in Somme
Feuillères	Communes in Somme
2012–13 North American drought	Droughts, 2012 in North America, 2013 in the United States
Bijan	Given names
Feuquières-en-Vimeu	Communes in Somme
Fieffes-Montrelet	Communes in Somme
Fienvillers	Communes in Somme
Wybren van Haga	1967 births, Living people, Dutch businesspeople, Dutch councillors, Dutch engineers, Independent politicians in the Netherlands, Leaders of political parties in the Netherlands, Members of the House of Representatives of the Netherlands, People from Haarlem, People's Party for Freedom and Democracy politicians, Politicians from The Hague
Aibes	Communes in Nord
Eth, Nord	Communes in Nord
Bry, Nord	Communes in Nord
Waterford Township, Michigan	Townships in Michigan
Bloomfield Township, Oakland County, Michigan	Townships in Michigan
Georgetown Township, Michigan	Townships in Michigan
Lemannville, Louisiana	Census-designated places in Louisiana
Union, Louisiana	Unincorporated communities in Louisiana, Census-designated places in Louisiana
Fignières	Communes in Somme
Agde	Communes in Hérault
Electronics right to repair	Everyday life
Fins, Somme	Communes in Somme
Flaucourt	Communes in Somme
Grand Point, Louisiana	Unincorporated communities in Louisiana, Census-designated places in Louisiana
French Settlement, Louisiana	Villages in Louisiana
Killian, Louisiana	Villages in Louisiana
Port Vincent, Louisiana	Villages in Louisiana
Springfield, Louisiana	Towns in Louisiana
Nikkatsu	Companies of Japan
Adenocarcinoma of the lung	Cancer
Flers, Somme	Communes in Somme
Flers-sur-Noye	Communes in Somme
Flesselles	Communes in Somme
World's Largest Entertainment McDonald's	Restaurants, Fast food, McDonald's
Planned obsolescence	Economics
2015 UEFA European Under-21 Championship	2015 in Europe, 2015 in association football, Football in the Czech Republic, June 2015 events
The Truth Is	2018 albums, Alexandra Burke albums, Pop albums, Soul albums, R&B albums
Heartbreak on Hold	2012 albums, Alexandra Burke albums, Pop albums, Dance albums, R&B albums
2021 UEFA Champions League Final	Scheduled association football competitions, 21st century in Portugal, 2021 in Europe, 2021 in association football, Football in Portugal, May 2021 events
Omiécourt	Former communes in Somme
Fleury, Somme	Communes in Somme
Flixecourt	Communes in Somme
Fluy	Communes in Somme
Heucourt-Croquoison	Communes in Somme
Guyencourt-Saulcourt	Communes in Somme
Folies	Communes in Somme
Freilassing	Berchtesgadener Land
Laufen, Germany	Berchtesgadener Land
Bayerisch Gmain	Berchtesgadener Land
Megadrought	Droughts
Marktschellenberg	Berchtesgadener Land
Schönau am Königssee	Berchtesgadener Land
Bodman-Ludwigshafen	Konstanz (district)
Schneizlreuth	Berchtesgadener Land
Bischofswiesen	Berchtesgadener Land
Dendropsophus reichlei	Frogs, Animals of South America
Saaldorf-Surheim	Berchtesgadener Land
Ramsau bei Berchtesgaden	Berchtesgadener Land
Sopron District	Districts in Győr-Moson-Sopron County
Bethany Hall-Long	1963 births, US Democratic Party politicians, Lieutenant Governors of Delaware, Living people
Districts of Hungary	Districts of Hungary
Tét District	Districts in Győr-Moson-Sopron County
Győr District	Districts in Győr-Moson-Sopron County
Avneet Kaur	2001 births, Living people, Child actors, Dance
Griselda Blanco	1943 births, 2012 deaths, Colombian people, Drug traffickers, Murderers
Drug lord	Organized crime, Drug traffickers
Black (2006 video game)	2006 video games, PlayStation 2 games, Shooter video games, Xbox games, Xbox 360 games, Xbox One games
Stockach	Konstanz (district)
Allensbach	Konstanz (district)
Hot Shots Golf 3	2001 video games, Golf video games, Hot Shots Golf, PlayStation 2 games, PlayStation 2-only games, Sports video games, Video game sequels, Video games developed in Japan
Eigeltingen	Konstanz (district)
Gaienhofen	Konstanz (district)
Gailingen am Hochrhein	Konstanz (district)
Hilzingen	Konstanz (district)
Hohenfels, Konstanz	Konstanz (district)
Moos, Baden-Württemberg	Konstanz (district)
Öhningen	Konstanz (district)
Mühlhausen-Ehingen	Konstanz (district)
Mühlingen	Konstanz (district)
Tengen, Germany	Konstanz (district)
Rielasingen-Worblingen	Konstanz (district)
Kingston, Norfolk Island	Norfolk Island, Towns in Australia, Capital cities in Oceania
Burnt Pine	Norfolk Island, Towns in Australia
Intifada	Arabic words and phrases, Rebellions
Sơn Tùng M-TP	1994 births, Living people
Stephen Gately	1976 births, 2009 deaths, Children's writers, Deaths from pulmonary edema, Disease-related deaths in Spain, Gay men, Irish LGBT people, Irish pop singers, Irish singer-songwriters, Irish stage actors, LGBT dancers, LGBT singers, LGBT songwriters, Tenors
Attack Force Z	1982 drama movies, 1980s war movies, Australian drama movies, Taiwanese movies, World War II movies, Movies directed by Tim Burstall
Volkertshausen	Konstanz (district)
Reichenau, Baden-Württemberg	Konstanz (district)
Orsingen-Nenzingen	Konstanz (district)
Darter	Seabirds
Godzilla, King of the Monsters!	1956 movies, 1950s science fiction movies, Godzilla, American monster movies, American horror movies, Movies about dinosaurs, American science fiction movies, Japanese movies, Movies set in Japan
Wikipedia App	Wikipedia
Folleville, Somme	Communes in Somme
Fontaine-le-Sec	Communes in Somme
Sara Sidner	CNN people, American television news anchors, Living people, 1972 births
Ralph A. Gamble	20th-century American politicians, United States representatives from New York, Princeton University alumni, 1959 deaths, 1885 births
Saint Michaels, Maryland	Towns in Maryland, Pages using infobox settlement with possible area code list, Coordinates on Wikidata, Pages using infobox settlement with possible motto list, Pages with unreviewed translations
Economies of scale	Economics
Chemung, New York	Towns in New York
Bruno Covas	1980 births, 2021 deaths, Brazilian economists, Brazilian politicians, Cancer deaths in Brazil, Brazilian lawyers, Mayors, People from São Paulo, Deaths from gastrointestinal cancer
Steißlingen	Konstanz (district)
Prakash Karat	1948 births, Living people, Communist politicians, Indian politicians
Reducing (movie)	1931 movies, 1930s comedy movies, American comedy movies, MGM movies, Movies directed by Charles Reisner
Jaz Sinclair	1994 births, Living people, Actors from Dallas, Texas, American child actors, American movie actors, American television actors
Real Girl	2007 albums, Debut albums, R&B albums
National-anarchism	Anarchism
Székesfehérvár District	Districts in Fejér County
Dunaújváros District	Districts in Fejér County
Bicske District	Districts in Fejér County
Sab Jholmaal Hai	2017 Indian television series debuts, Indian children's animated comedy television series, Indian children's animated fantasy television series, Sony Yay original programming
Dombóvár District	Districts in Tolna County
Bonyhád District	Districts in Tolna County
Tamási District	Districts in Tolna County
M2 motorway (Northern Ireland)	Motorways in Northern Ireland
Fontaine-lès-Cappy	Communes in Somme
M3 motorway (Northern Ireland)	Motorways in Northern Ireland
Victoria Beckham (album)	2001 albums, Debut albums, Pop albums, R&B albums, Virgin Records albums
Fontaine-sous-Montdidier	Communes in Somme
Fontaine-sur-Maye	Communes in Somme
Fontaine-sur-Somme	Communes in Somme
Forceville	Communes in Somme
Forceville-en-Vimeu	Communes in Somme
Ploemeur	Communes in Morbihan
Teisendorf	Berchtesgadener Land
Break Up with Your Girlfriend, I'm Bored	2019 songs, Ariana Grande songs, Trap songs, Pop songs, R&B songs
Fort-Mahon-Plage	Communes in Somme
Piding	Berchtesgadener Land
A48(M) motorway	Motorways in Wales
Fossemanant	Communes in Somme
Sarayacu tree frog	Frogs, Animals of South America
Foucaucourt-en-Santerre	Communes in Somme
Foucaucourt-Hors-Nesle	Communes in Somme
Fouencamps	Communes in Somme
Fouilloy, Somme	Communes in Somme
Fouquescourt	Communes in Somme
Villebon-sur-Yvette	Communes in Essonne
Reuven Fahn	1878 births, Year of death missing, Polish writers
Lesbophobia	LGBT, Hatred
Đorđe Marjanović	1931 births, 2021 deaths, Serbian musicians, Serbian singers, Deaths from the COVID-19 pandemic in Serbia
Eva Wilma	1933 births, 2021 deaths, Deaths from ovarian cancer, Brazilian movie actors, Brazilian television actors, Brazilian stage actors, Dancers, People from São Paulo
William Roth	1921 births, 2003 deaths, Deaths from heart failure, United States representatives from Delaware, United States senators from Delaware, American lawyers, Politicians from Montana, Businesspeople from Montana, Businesspeople from Wilmington, Delaware, People from Great Falls, Montana, Politicians from Wilmington, Delaware, US Republican Party politicians
2021 Texas power crisis	February 2021 events, 21st century in Houston, Texas
Food bank	Charities
Serve America Movement	2017 establishments in the United States, Political parties in the United States
Governor (United States)	State governors of the United States, State government in the United States
Sam Sloan	1944 births, Living people, American chess players, American lawyers, Businesspeople from New York City, Politicians from New York City, US Democratic Party politicians, 2016 United States presidential candidates, 2020 United States presidential candidates
Lise Bourdin	1925 births, Living people, French movie actors, French stage actors
Jacqueline White	1922 births, Living people, American movie actors, American stage actors, Actors from Beverly Hills, California
Jimmy Lydon	1923 births, Living people, American television producers, American movie actors, American stage actors, American child actors, American television actors, Actors from New Jersey, Businesspeople from New Jersey
Noreen Nash	1924 births, Living people, American movie actors, American television actors, American stage actors, Actors from Washington
Helen Grayco	1924 births, Living people, American pop singers, American movie actors, American television actors, People from Tacoma, Washington, Singers from Washington, Actors from Washington
Spike Jones	1911 births, 1965 deaths, Deaths from emphysema, American bandleaders, Musicians from California, Actors from Long Beach, California, Comedians from California, American movie actors
Joyce Reynolds (actress)	1924 births, Living people, American movie actors, Actors from Detroit, Michigan
Maria Riva	1924 births, Living people, Naturalized citizens of the United States, German movie actors, German television actors, German stage actors, American movie actors, American television actors, American stage actors, American radio actors, American activists, German activists, American autobiographers, German autobiographers, Writers from Berlin, Actors from Berlin, Writers from Los Angeles, California, Actors from Los Angeles, California
Marilyn Knowlden	1926 births, Living people, American movie actors, American stage actors, Actors from Oakland, California
Hyouka	Anime series, Manga series, Novels
Carleton Carpenter	1926 births, Living people, American movie actors, American television actors, American stage actors, American magicians, American dancers, American television writers, American songwriters, American screenwriters, American novelists, Writers from Vermont, Actors from Vermont, Bisexual people, LGBT dancers, LGBT actors, LGBT novelists, LGBT screenwriters, LGBT songwriters
Hermione Gingold	1897 births, 1987 deaths, Deaths from pneumonia, Deaths from heart failure, Naturalized citizens of the United States, English movie actors, English television actors, English stage actors, American movie actors, American television actors, American stage actors, Actors from London, Actors from New York City
Betty Lynn	1926 births, Living people, American movie actors, American stage actors, American voice actors, American television actors, Actors from Kansas City, Missouri
Robert Brown (American actor)	American stage actors, American television actors, American movie actors, 1926 births, Living people, Actors from New Jersey, People from Trenton, New Jersey
Terry Kilburn	1926 births, Living people, Naturalized citizens of the United States, English movie actors, English television actors, English stage actors, American television actors, American stage actors, American movie actors, Actors from London, LGBT actors, English LGBT people, Gay men
Cora Sue Collins	1927 births, Living people, American child actors, American movie actors, Actors from West Virginia
Donna Martell	1927 births, Living people, American movie actors, American television actors, American stage actors, Actors from Los Angeles, California
Sara Shane	1928 births, Living people, American movie actors, American television actors, American stage actors, Actors from St. Louis, Missouri, Writers from St. Louis, Missouri
Kathleen Hughes	1928 births, Living people, American stage actors, American movie actors, American television actors, Actors from Hollywood
Colleen Townsend	1928 births, Living people, American movie actors, American television actors, American stage actors, Humanitarians, Actors from Glendale, California, Writers from California
Margaret Kerry	1929 births, Living people, American movie actors, American television actors, American voice actors, American stage actors, American radio personalities, Actors from Los Angeles, California, Models from Los Angeles, California, Disney actors
Ana Luisa Peluffo	1929 births, Living people, Mexican movie actors, Mexican television actors, Mexican stage actors
Joyce MacKenzie	1925 births, Living people, Actors from California, American movie actors, American television actors, American stage actors
Claudia Barrett	1929 births, 2021 deaths, American movie actors, American television actors, American stage actors, Actors from Los Angeles, California
Betta St. John	1929 births, Living people, American movie actors, American television actors, American stage actors, American dancers, Actors from Los Angeles, California, Singers from Los Angeles, California
Harrington Park, New Jersey	Boroughs in New Jersey
Gwen Graham	1963 births, Living people, United States representatives from Florida, US Democratic Party politicians
Namib Desert	Deserts, Geography of Namibia, Geography of South Africa, Geography of Angola
Take a Chance on Me	ABBA songs, 1978 songs
Mamma Mia (ABBA song)	Pop songs, ABBA songs, 1975 songs
Fernando (song)	Pop songs, ABBA songs, 1976 songs
Shell (computing)	Computing
Pink Chanel suit of Jacqueline Bouvier Kennedy	John F. Kennedy
Pillbox hat	Fashion
John Vernou Bouvier III	1891 births, 1957 deaths, John F. Kennedy, Businesspeople from New York City, Deaths from liver cancer
Janet Lee Bouvier	1907 births, 1989 deaths, American socialites, John F. Kennedy, Deaths from Alzheimer's disease
Washington Times-Herald	Newspapers in the United States
Gallop Racer	1996 video games, Video game series, Video games developed in Japan
State funeral of John F. Kennedy	1963 in the United States, State funerals, John F. Kennedy
Viking Press	1925 establishments in the United States
Doubleday (publisher)	1897 establishments in the United States
Maurice Tempelsman	1929 births, Living people, Naturalized citizens of the United States, Belgian businesspeople, Democrats (United States), Businesspeople from New York City
Vassar College	1860s establishments in New York (state), 1861 establishments in the United States, Colleges and universities in New York
Dizzy (Guilty Gear)	Guilty Gear, Video game characters
Chapin School	Schools in New York, Buildings and structures in Manhattan
Hugh D. Auchincloss	1897 births, 1976 deaths, American lawyers, Businesspeople from Rhode Island, Businesspeople from New York City, People from Newport, Rhode Island
Thank U, Next Perfume	Perfumery
RNA-Seq	RNA
Charles L. Bartlett (journalist)	1921 births, 2017 deaths, Journalists from Chicago, Pulitzer Prize winners, Deaths from heart failure
Richard Cushing	1895 births, 1970 deaths, Cardinals of the Roman Catholic Church, People from Boston, Massachusetts
Kennedy Compound	Houses in the United States, Buildings and structures in Massachusetts, Kennedy family
Hyannis Port, Massachusetts	Villages in Massachusetts
Maitreya	Buddhism
1960 Democratic National Convention	1960s in Los Angeles, California, 1960 in the United States, United States presidential nominating conventions, United States Democratic Party, July events
Jacqueline Kennedy Garden	1965 establishments in the United States
President's Park	Parks in the United States, Washington, D.C.
Pamela Turnure	1937 births, Living people, People from New York City, Democrats (United States), John F. Kennedy
White House Historical Association	1961 establishments in the United States
Committee for the Preservation of the White House	1964 establishments in the United States
White House Office of the Curator	1961 establishments in the United States
Leva del Biberón	History of Spain
A Tour of the White House with Mrs. John F. Kennedy	John F. Kennedy, 1960s television series
John Kenneth Galbraith	1908 births, 2006 deaths, Ambassadors of the United States, American economists, Deaths from natural causes in the United States, Canadian economists, Canadian academics, US Democratic Party politicians, Naturalized citizens of the United States, Politicians from Ontario, Politicians from Massachusetts, People from Cambridge, Massachusetts
Otis Air National Guard Base	Buildings and structures in Massachusetts
Infant respiratory distress syndrome	Medical emergencies
Anger, Bavaria	Berchtesgadener Land
Green dotted tree frog	Frogs, Animals of South America
Uniunea Independenta Pentru Sighisoara (Romania)	Political parties in Romania
Affair	Sexual acts
Virginia strawberry	Strawberries
List of postcode districts in the United Kingdom	United Kingdom-related lists, Postal codes
Ainring	Berchtesgadener Land
Altomünster	Dachau (district)
Bergkirchen	Dachau (district)
Erdweg	Dachau (district)
DZAB-AM	Radio stations in the Philippines
The Hopeless Case (Rotta)	19th century paintings, Paintings by Antonio Rotta
The Devoted Child (Antonio Rotta)	19th century paintings, Paintings by Antonio Rotta
The little girl found in Venice (Rotta)	19th century paintings, Paintings by Antonio Rotta
Raimund Hoghe	1949 births, 2021 deaths
The death of the chick (Rotta)	19th century paintings, Paintings by Antonio Rotta
NHS Test and Trace	2020 establishments in Europe, Health care
My Street (video game)	2003 video games, Party video games, PlayStation 2 games, PlayStation 2-only games
2021 FA Cup Final	May 2021 events
Island Xtreme Stunts	2003 video games, Lego video games, Windows games, PlayStation 2 games, Game Boy Advance games
Gallop Racer 2001	2001 video games, PlayStation 2 games, PlayStation 2-only games, Tecmo games, Video games developed in Japan
Ken Leung	1970 births, Living people, American movie actors, American television actors, American stage actors, American voice actors, Actors from New York City
Anandhi (TV series)	2008 Indian television series, Indian television
VC-137C SAM 26000	Individual aircraft, United States Air Force
Naval Air Station Joint Reserve Base Fort Worth	Buildings and structures in Texas
Dallas Love Field	1910s establishments in Texas, 1917 establishments in the United States, Airports in the United States, Buildings and structures in Texas, Dallas, Texas
ThunderCats	ThunderCats, 1985 TV series, 2011 TV series
Nellie Connally	1919 births, 2006 deaths, People from Austin, Texas
Dallas Market Center	Buildings and structures in Texas, Dallas, Texas
Back-fire	Motors
Clint Hill (Secret Service)	1932 births, Living people, People from North Dakota, John F. Kennedy
Cathedral of St. Matthew the Apostle (Washington, D.C.)	Roman Catholic Cathedrals, Buildings and structures in Washington, D.C.
Evening Standard	Newspapers published in the United Kingdom, English-language newspapers
Theodore H. White	1915 births, 1986 deaths, American historians, Deaths from stroke, Pulitzer Prize winners, American journalists, Writers from Boston, Massachusetts
Randolph Churchill	1911 births, 1968 births, Former Conservative MPs (UK), UK MPs 1935–1945, Politicians from London, Deaths from myocardial infarction
Cartoon Network (Australian and New Zealand TV channel)	Cartoon Network, 1992 establishments in the Australia
Space Chickens In Space	English-language television programs
Humor based on the September 11 attacks	Humor, September 11 attacks
W. Averell Harriman	1891 births, 1986 deaths, Ambassadors of the United States, Governors of New York, Businesspeople from New York City, US Democratic Party politicians
1040 Fifth Avenue	Skyscrapers in New York City, Buildings and structures in Manhattan
David Ormsby-Gore, 5th Baron Harlech	1918 births, 1985 deaths, Politicians from London, Road accident deaths in the United Kingdom, Ambassadors of the United Kingdom
USS John F. Kennedy (CV-67)	John F. Kennedy
Skorpios	Islands of Greece
Christina O	Ships
Alexander Onassis	1948 births, 1973 deaths, Aviation deaths, Greek businesspeople, Businesspeople from New York City
Black Southerners	African-American people
John Leonard (critic)	1939 births, 2008 deaths, Deaths from lung cancer, American movie critics, Journalists from New York City, Writers from Washington, D.C.
Suicide among African Americans	Suicide
Shall We Tell the President?	1977 books
Larry Gonick	1946 births, Living people, American cartoonists, Writers from San Francisco
B. L. Patil	Indian politicians, 1924 births, 2002 deaths
The Cartoon History of the Universe	1990 books
Cairo Trilogy	Novels
COVID-19 pandemic in Eritrea	COVID-19 pandemic by country, Eritrea
Gelsey Kirkland	1952 births, Living people, American dancers, Entertainers from Pennsylvania
Diana Vreeland	1903 births, 1989 deaths, Deaths from myocardial infarction, American editors, Natural disasters in the United States, American columnists, Writers from Paris, Writers from New York City
Olana State Historic Site	Buildings and structures in New York
COVID-19 pandemic in Georgia (U.S. state)	COVID-19 pandemic in the United States, 21st century in Georgia (U.S. state)
Frederic Edwin Church	1826 births, 1900 deaths, American painters, People from Hartford, Connecticut, Artists from New York City
Ron Galella	1931 births, Living people, American photographers, Artists from New York City
Fox hunting	Hunting
NewYork-Presbyterian Hospital	Hospitals in the United States, Buildings and structures in New York City
Municipal Art Society	Non-profit organizations of New York
Jacqueline Kennedy Onassis High School for International Careers	Schools in New York, Buildings and structures in Manhattan
Jacqueline Kennedy Onassis Reservoir	Parks in the United States
Gallup (company)	Companies of the United States
Jackie (2016 movie)	John F. Kennedy, 2010s biographical movies, 2016 drama movies, American biographical movies, American drama movies, English-language movies, Movies set in the 1960s, Movies set in Washington, D.C., Movies set in Massachusetts
Jamaican dollar	Currency of South America, Jamaica
Franco Battiato	1945 births, 2021 deaths, Italian singers, Italian composers, Italian writers, Songwriters, Italian movie directors, People from Sicily, Italian painters, Italian musicians, Eurovision Song Contest entrants
Kingdom of Sicily	Sicily
Manuel Blanco Encalada	1790s births, 1876 deaths, Chilean military people, Chilean politicians, Presidents of Chile
Colette (2013 movie)	2013 drama movies, 2010s war movies, 2010s biographical movies, Slovakian movies, Czech movies, Dutch drama movies, World War II movies, Movies directed by Milan Cieslar
Kepler-16b	Exoplanets
Dendropsophus delarivai	Frogs, Animals of South America
Happy New Year (2014 movie)	2014 action movies, 2014 comedy movies, Indian movies
Filet Mignon	Cuts of beef
Strip steak	Cuts of beef
Flank steak	Cuts of beef
Avocado oil	Cooking oils, Avocados
D♭(musical note)	Musical notes
Boatsetter	2012 establishments in the United States, 2010s establishments in Florida, Companies of the United States
U.S. Route 425	Roads in the United States
Suleiman Abba	1959 births, Living people, Police officers, Nigerian people
Ahmed Makarfi	1956 births, Living people, Nigerian politicians
Umar Farouk Ahmed	Nigerian military people
The Man from G.R.A.M.P.A.	The Simpsons (season 32) episodes, 2021 in entertainment
9Go!	2009 establishments in Australia, Television channels
Negro leagues	African-American history, Baseball leagues, History of baseball
Curlew	Charadriiformes
National Republican Convention	Nigeria, Political parties in Africa
List of cities in Kenya	Lists of cities in Africa, Lists of cities by country, Cities in Kenya
Leader of the New Zealand Labour Party	New Zealand politicians
Kelvin Davis (politician)	Living people, 1967 births, New Zealand politicians
Andrew Little (New Zealand politician)	1965 births, Living people, Leaders of the Opposition (New Zealand)
Deputy Leader of the New Zealand Labour Party	New Zealand politicians
Annette King	1947 births, Living people, New Zealand politicians
Mount Albert (New Zealand electorate)	New Zealand electorates
David Shearer	1957 births, Living people, Leaders of the Opposition (New Zealand)
List MP	Politics
Raymond Huo	1964 births, Living people, New Zealand politicians
Clarke Gayford	1976 births, Living people, Jacinda Ardern, Television presenters, New Zealand radio personalities
Ross Ardern	1954 births, Living people, Jacinda Ardern, Police officers, New Zealand politicians
Premier House	Prime Ministers of New Zealand
University of Waikato	1960s establishments in New Zealand, 1964 establishments, Colleges and universities
Morrinsville	Towns in New Zealand
Murupara	Towns in New Zealand
Cabinet Office	United Kingdom
International Union of Socialist Youth	1907 establishments, International organizations
2008 New Zealand general election	2008 elections, 21st century in Oceania, Elections in New Zealand, November 2008 events
New Zealand electorates	New Zealand electorates
2017 Mount Albert by-election	2017 elections, 2010s in New Zealand, Elections in New Zealand, February 2017 events, Jacinda Ardern
Julie Anne Genter	1979 births, Living people, New Zealand politicians, Politicians from Minnesota, People from Rochester, Minnesota
New Zealand First	1990s establishments in New Zealand, 1993 establishments, Political parties in New Zealand
Green Party of Aotearoa New Zealand	1990s establishments in New Zealand, 1990 establishments, Political parties in New Zealand
New Zealand property bubble	New Zealand
Child poverty	Poverty
Social inequality	Politics
Public relations	Business
Harry Duynhoven	1955 births, Living people, New Zealand politicians
1999 New Zealand general election	1999 elections, 20th century in Oceania, Elections in New Zealand, November events
New Zealand Young Labour	New Zealand
Waikato (New Zealand electorate)	New Zealand electorates
TVNZ	20th-century establishments in New Zealand, Television networks, 1980 establishments in Oceania
Breakfast (New Zealand TV programme)	New Zealand
Auckland Central (New Zealand electorate)	New Zealand electorates
2011 New Zealand general election	2011 elections, 2010s in New Zealand, Elections in New Zealand, November events
2014 New Zealand general election	2014 elections, 2010s in New Zealand, Elections in New Zealand, September 2014 events
Nikki Kaye	1980 births, Living people, New Zealand politicians, People from Auckland, Breast cancer survivors
Denise Roche	1963 births, Living people, New Zealand politicians
Sandinista National Liberation Front	Political parties in South America, Nicaragua
Leima Linthoingambi	History of Manipur, Manipur
Maharani Kumudini	History of Manipur, Manipur
2017 New Zealand Labour Party leadership election	2017 elections, 2010s in New Zealand, Elections in New Zealand, August 2017 events, Jacinda Ardern
Steven Joyce	1963 births, Living people, New Zealand politicians
University of Auckland	19th-century establishments in New Zealand, 1883 establishments, Colleges and universities, Auckland
Minister of Foreign Affairs (New Zealand)	New Zealand
Nanaia Mahuta	1970 births, Living people, New Zealand politicians, People from Auckland
Council of Women World Leaders	International organizations
Edward Stafford (politician)	1819 births, 1901 deaths, People from Edinburgh, Prime Ministers of New Zealand
Capital gains tax	Taxation
Women in the history of Manipur kingdom	History of Manipur
Waitangi, Northland	Settlements in New Zealand
Waitangi Day	New Zealand
Marae	Maori
The Spinoff	Newspapers, New Zealand
Comprehensive and Progressive Agreement for Trans-Pacific Partnership	Trade
Xinjiang internment camps	Prisons, China, Xinjiang
Rohingya genocide	Genocide
Gun buyback program	Legislation
Community centre	Public services
Assault weapon	Weapons
Christchurch Call to Action Summit	Jacinda Ardern
COVID-19 lockdowns	COVID-19 pandemic
Carbon neutrality	Climate change
Hybrid vehicle	Vehicles
Māori Party	2000s establishments in New Zealand, 2004 establishments, Political parties in New Zealand
ACT New Zealand	1990s establishments in New Zealand, 1994 establishments in Oceania, Political parties in New Zealand
Novavax	20th-century establishments in Maryland, 1987 establishments in the United States, Companies of the United States, Montgomery County, Maryland
Zhao Lijian	1972 births, Living people, Chinese politicians
Suhayra Aden	1995 births, Living people, New Zealand people
British Vogue	1910s establishments in the United Kingdom, 1916 establishments in Europe, Magazines of the United Kingdom, Fashion magazines
Time 100	People
Italian lira	Former currencies of Europe, Italy
Grape juice	Fruit juices
Prospect (magazine)	1995 establishments in the United Kingdom, Magazines of the United Kingdom
Wētā	Insects, Animals of New Zealand
Hemiandrus jacinda	Jacinda Ardern, Insects, Animals of Oceania
Mecodema jacinda	Beetles, Animals of Oceania
Whanganui	Cities in New Zealand
Hamish McDouall	Living people, Mayors, New Zealand politicians, Jacinda Ardern
Shane Ardern	1960 births, Living people, New Zealand politicians
Māori electorates	Maori, New Zealand electorates
Marriage (Definition of Marriage) Amendment Act 2013	New Zealand
Crimes Act 1961	New Zealand
Abortion Legislation Act 2020	New Zealand, Abortion
Two-state solution	New Zealand
2018–2019 Gaza border protests	Israel, Palestine
Ritz Crackers	Snack foods, Breads
Epidemiology of HIV/AIDS	Epidemiology, HIV/AIDS
Sybil (cat)	Individual cats, Chief Mouser
Baba Fingo	Folklore, Roma
The Gap Band	Singers from Tulsa, Oklahoma, American R&B singers, 1974 establishments in the United States, 2010 disestablishments
Dendropsophus ozzyi	Frogs, Animals of South America
Old Bawn	Towns in Ireland
Pollinator	Symbiosis, Insects, Beekeeping, Ecology, Plant physiology
Irish migration to Great Britain	Ethnic groups in the United Kingdom
Gengan Tonaki	1884 births, 1997 deaths, Japanese supercentenarians, People from Okinawa Prefecture
French migration to the United Kingdom	Ethnic groups in the United Kingdom
Meitei families and their serving respective pantheons	Meitei culture, History of Manipur
George Little (New Brunswick politician)	1937 births, 2021 deaths
Cyclone Tauktae	2021 in Asia, 2020s disasters in Asia, 2020s in India, 21st century in Pakistan, Disasters in India, May 2021 events, Natural disasters in Asia
Darwin's Arch	Galápagos Islands
Lee Evans (sprinter)	1947 births, 2021 deaths, American track and field athletes, American Olympic gold medalists, American civil rights activists, Sportspeople from California, People with cancer, Deaths from stroke
Jason Derek Brown	People from Los Angeles, California, American robbers, American murderers, 1969 births, Living people
Styrian International	2020 establishments in Austria, Badminton, Sports competitions, Sport in Austria
Styrian motorcycle Grand Prix	2020 establishments in Austria, 2020 in sports, Motorcycling, Sport in Austria, Styria
Abujam	Meitei surnames
Ahanthem	Meitei surnames
Fox Kids Distribution	Fox, Disney
Aheibam	Meitei surnames
Akham	Meitei surnames
Akoijam	Meitei surnames
Amakcham	Meitei surnames
Amom	Meitei surnames
Angom	Meitei surnames
Angomjambam	Meitei surnames
Arambam	Meitei surnames
Aribam	Meitei surnames
Arubam	Meitei surnames
Asem	Meitei surnames
Athokpam	Meitei surnames
Atom (surname)	Meitei surnames
Ayekpam	Meitei surnames
Chabungbam	Meitei surnames
Chakpram	Meitei surnames
Chanambam	Meitei surnames
Chandam	Meitei surnames
Chingakham	Meitei surnames
Kentaro Miura	1966 births, 2021 deaths, Japanese manga artists, Deaths from aortic dissection
Chingangbam	Meitei surnames
Chingshubam	Meitei surnames
Aleksandr Privalov	1933 births, 2021 deaths, Soviet sportspeople, Soviet Olympic silver medalists
Chingsubam	Meitei surnames
Guillermo Sepúlveda	1934 births, 2021 deaths, Mexican footballers
Chingtham	Meitei surnames
Jeffrey R. Holland	1940 births, Living people, American educators, People from Utah
Chirom	Meitei surnames
Klymaxx	Musical groups from Los Angeles, California, American girl groups, African-American musical groups, 1979 establishments in the United States, Musical groups disestablished in 2013
Dieter F. Uchtdorf	1940 births, Living people, German businesspeople
Chongtham	Meitei surnames
Chungkham	Meitei surnames
Quentin L. Cook	1940 births, Living people, American lawyers, Businesspeople from Utah, People from Logan, Utah
Elam (surname)	Meitei surnames
Elangbam	Meitei surnames
Hanglem	Meitei surnames
Hanjabam	Meitei surnames
Haobam	Meitei surnames
Prime Minister of Samoa	Prime Ministers of Samoa
Tui Atua Tupua Tamasese Efi	1938 births, Living people, O le Ao o le Malo of Samoa, Prime Ministers of Samoa
Tuilaepa Aiono Sailele Malielegaoi	1945 births, Living people, Prime Ministers of Samoa, Current national leaders
Fiame Naomi Mataʻafa	Living people, 1957 births, Prime Ministers of Samoa, Current national leaders
O le Ao o le Malo	O le Ao o le Malo of Samoa
Tuimalealiifano Va'aletoa Sualauvi II	1947 births, Living people, O le Ao o le Malo of Samoa
Malietoa Tanumafili II	O le Ao o le Malo of Samoa, 1912 births, 2007 deaths, Deaths from myocardial infarction, Deaths from pneumonia
Tupua Tamasese Meaʻole	1905 births, O le Ao o le Malo of Samoa, 1963 deaths
Amy Fisher	Writers from New York, Criminals from New York, American pornographic actors, American people convicted of assault, Actors from New York, 1974 births, Living people
Haobijam	Meitei surnames
Hawaibam	Meitei surnames
Heigrujam	Meitei surnames
Heikrujam	Meitei surnames
Heisnam	Meitei surnames
Hemmam	Meitei surnames
Hidam	Meitei surnames
Hijam	Meitei surnames
Huidrom	Meitei surnames
Huiningshumbam	Meitei surnames
Huirem	Meitei surnames
Huirongbam	Meitei surnames
Ingudam	Meitei surnames
Janine Wissler	1981 births, Living people, German politicians, People from Hesse
Irengbam	Meitei surnames
Susanne Hennig-Wellsow	1977 births, Living people, German politicians
Irom	Meitei surnames
Dietmar Bartsch	1958 births, Living people, German politicians
Irungbam	Meitei surnames
Kakyenlakpam	Meitei surnames
2012 Arkansas Democratic presidential primary	2012 elections, 2012 in the United States, History of Arkansas, November events
Kangabam	Meitei surnames
Kangjam	Meitei surnames
Gerald R. Molen	1935 births, Living people, American movie producers, Businesspeople from Las Vegas, Nevada, Businesspeople from Montana, People from Great Falls, Montana, Academy Award winners
Conspiracy (criminal)	Law, Crime
Bobby Rydell	1942 births, Living people, American rock singers, American pop singers, American rock drummers, American pop musicians, American movie actors, Actors from Philadelphia, Pennsylvania, Singers from Philadelphia, Pennsylvania, Musicians from Philadelphia, Pennsylvania
Nausibius major	Polyphaga, Animals of North America
Match fixing	Sports, Organized crime
Sports betting	Sports, Organized crime
Prosciutto	Italian food, Ham
Alia Shawkat	1989 births, Living people, American actors
Kangujam	Meitei surnames
Karam	Meitei surnames
Kayenpaibam	Meitei surnames
Keisham	Meitei surnames
Keithellakpam	Meitei surnames
Khaidem	Meitei surnames
Khangembam	Meitei surnames
Germs Nerawareta Machi	PlayStation-only games, PlayStation games, 1999 video games, Horror video games, Adventure games, First-person video games, Survival video games, Japan exclusive video games
Khangjarakpam	Meitei surnames
Kharibam	Meitei surnames
Khoinaijam	Meitei surnames
Haimhausen	Dachau (district)
Hebertshausen	Dachau (district)
Hilgertshausen-Tandern	Dachau (district)
Icosane	Alkanes
Karlsfeld	Dachau (district)
Markt Indersdorf	Dachau (district)
Dwarf tree frog	Frogs, Animals of South America
Chuck steak	Cuts of beef
Gangster Disciples	People from Chicago, Gangs, 1968 establishments in the United States
Sirloin steak	Cuts of beef
World Taekwondo Grand Prix	Taekwondo competitions
Aditya Roy Kapur	1985 births, Indian movie actors, Living people, People from Mumbai, Punjabi people
European Taekwondo Championships	Taekwondo competitions
Rib eye steak	Cuts of beef
Odelzhausen	Dachau (district)
Tápiószentmárton	Villages in Hungary
Shama (TV series)	Television programs
Ayuba Wabba	1968 births, Living people, Activists, People from Lagos
Banks (singer)	1988 births, Singer-songwriters from California, American poets, People from Orange County, California, Living people
Baked potato	Baked foods, Potatoes
Portrait of Adele Bloch-Bauer I	20th century paintings, 1907, Supreme Court of the United States
Maritime science fiction	Science fiction
List of maritime science fiction works	Science fiction
Petershausen	Dachau (district)
Pfaffenhofen an der Glonn	Dachau (district)
Röhrmoos	Dachau (district)
Schwabhausen	Dachau (district)
Sulzemoos	Dachau (district)
Vierkirchen	Dachau (district)
Weichs	Dachau (district)
Imo State University	Colleges and universities in Africa, 1981 establishments, 1980s establishments in Africa
Gandia	Cities in Valencia (autonomous community), Municipalities in Valencia (autonomous community)
Auerbach in der Oberpfalz	Amberg-Sulzbach
Toshio Fukui	1947 births, Living people, People from Shiga Prefecture, Japanese musicians
Yuji Iwata	1946 births, Living people, People from Shiga Prefecture, Japanese musicians, Drummers
Shiro Okada	1949 births, Living people, People from Osaka Prefecture, Japanese guitarists
Hideto Maki	1950 births, Living people, Japanese singers
Ai Akamatsu	Japanese musicians, 1951 births, Living people, People from Hyōgo Prefecture
Yûsuke Natsu	1950 births, Japanese musicians, 2010 deaths
Hiroshi Koshikawa	1946 births, Living people, Japanese musicians
Keikichi Usui	1946 births, Living people
Tadao Oka	1948 births, Living people, Japanese musicians
Jiro Kitamura	1946 births, Living people, Japanese guitarists
Paul Okada	1947 births, People from Shiga Prefecture, Living people, Japanese singers
Aryan Nations	Terrorism, 1970s establishments in the United States
Khoinam	Meitei surnames
Khoirom	Meitei surnames
Khoisnam	Meitei surnames
Khomdram	Meitei surnames
American Nazi Party	Neo-Nazism, 1959 establishments in the United States, Political parties in the United States
Female gangs in the United States	Women, Gangs, Crime in the United States
Hombre (movie)	1967 movies, 1960s western movies, American western movies, 20th Century Fox movies, Movies based on books, Movies directed by Martin Ritt
Princess Elisabeth of Hesse and by Rhine (1864–1918)	German people
Amy Siskind	LGBT Jews, Lesbian feminists, Jewish feminists, Writers from New York, Writers from Massachusetts, Cornell University alumni, American political writers, Living people, 1965 births
Leeton, New South Wales	Towns in New South Wales
Tahir Salahov	1928 births, 2021 deaths, Soviet people, Azerbaijani people, Russian painters
Julie Su	1969 births, Living people, American lawyers, Politicians from Wisconsin, Businesspeople from Wisconsin, US Democratic Party politicians, Politicians from California, Businesspeople from California
Titanic Waltz	1964 comedy movies, Romanian movies, Movies based on plays, Movies directed by Paul Călinescu
Regina and Margaret DeFrancisco	Criminals from Chicago, American people convicted of murder, 2000 in the United States
When We're Born	2019 drama movies, Egyptian movies, Movies directed by Tamer Ezzat
Dendropsophus rhea	Frogs, Animals of South America
Hirschau	Amberg-Sulzbach
2020 Vermont Republican presidential primary	United States presidential primary elections, March 2020 events, 2020 in the United States, 2020 United States presidential election, History of Vermont
Schnaittenbach	Amberg-Sulzbach
Sulzbach-Rosenberg	Amberg-Sulzbach
Pain au chocolat	French food, Desserts, Breads
Biscotti	Cookies, Italian food
The Jaguars	Japanese musical groups, Musical groups established in 1964, 1964 establishments in Asia, 1960s establishments in Japan, 1971 disestablishments, Musical groups disestablished in the 1970s, 1970s disestablishments in Asia, 20th century disestablishments in Japan, Musical groups established in 1981, 1981 establishments in Japan, Musical groups disestablished in 2009, 2000s disestablishments in Asia, 21st century disestablishments in Japan
Khongbantabam	Meitei surnames
Jack Stauber	1996 births, Living people, Shorty Award winners, American YouTubers, American animators, American folk musicians, American pop musicians, Internet memes, American singer-songwriters
Khudrakpam	Meitei surnames
Khullem	Meitei surnames
Khumallambam	Meitei surnames
Khumanthem	Meitei surnames
Khumbongmayum	Meitei surnames
Khumujam	Meitei surnames
Khumukcham	Meitei surnames
Khundongbam	Meitei surnames
Khundrakpam	Meitei surnames
Khuraijam	Meitei surnames
Khuyenthem	Meitei surnames
Khwairampam	Meitei surnames
Koijam	Meitei surnames
Garlic butter	Butter, Garlic dishes, Spreads
Skirt steak	Cuts of beef
Mohadese Honarmand	1995 births, Living people, Karate, Iranian sportspeople
Visaginas	Cities in Lithuania
James Maslow	American actors, Living people, 1990 births
Hinduism in Indonesia	Hinduism by country
Industry, Texas	Cities in Texas
Mouse melon	Cucurbitaceae, Vegetables
Sealy, Texas	Cities in Texas
Framerville-Rainecourt	Communes in Somme
Framicourt	Communes in Somme
Francières, Somme	Communes in Somme
Ralph Puckett	1926 births, Living people, Medal of Honor recipients, American military personnel of the Korean War, People from Georgia (U.S. state)
Friedberg, Bavaria	Aichach-Friedberg
Chaim Herzog	1918 births, 1997 deaths, Presidents of Israel, Israeli generals, Israeli lawyers, Israeli writers, People from Belfast, Deaths from heart failure, Deaths from pneumonia
Adelzhausen	Aichach-Friedberg
Yitzhak Ben-Zvi	1884 births, 1963 deaths, Presidents of Israel, Israeli historians
Fransart	Communes in Somme
Zalman Shazar	1889 births, 1974 deaths, Presidents of Israel, Israeli writers, Poets
Fransu	Communes in Somme
Ephraim Katzir	1916 births, 2009 deaths, Presidents of Israel, Israeli scientists, Biophysicists, People from Kiev
Fransures	Communes in Somme
HaTzionim HaKlaliym	1920s establishments in Asia, 1960s disestablishments in Asia, Former political parties in Israel, Zionist parties
General Zionists	1920s establishments in Asia, 1960s disestablishments in Asia, Former political parties in Israel, Zionist parties
Lindy Thackston	1980 births, Living people, American television news anchors, People with cancer, People from Indiana
Jack Hanna	1947 births, Living people, American zoologists, Scientists from Tennessee, Scientists from Columbus, Ohio, People from Knoxville, Tennessee, People with Alzheimer's disease
Franvillers	Communes in Somme
Fresnes-Mazancourt	Communes in Somme
Fresnes-Tilloloy	Communes in Somme
Fresneville	Communes in Somme
Fresnoy-Andainville	Communes in Somme
The Company of Wolves	1984 horror movies, 1980s fantasy movies, British fantasy movies, British horror movies, Irish movies, Movies based on short stories, Movies directed by Neil Jordan
Jimmy Carter 1976 presidential campaign	United States presidential campaigns, Jimmy Carter
Ronald Reagan 1984 presidential campaign	Ronald Reagan, United States presidential campaigns
In the Name of the Father (1993 movie)	1993 drama movies, 1990s biographical movies, Irish movies, British biographical movies, British drama movies, Movies based on books, Movies directed by Jim Sheridan
Under the Dome (TV series)	2010s American drama television series, 2013 American television series debuts, 2015 American television series endings, English-language television programs
2008–09 Premier League	English football clubs, 2008 in sports, 2009 in sports
Ronald Reagan 1976 presidential campaign	1976 in the United States, Ronald Reagan, United States presidential campaigns
Taipei Zoo station	Railway stations in Taipei
Daran Norris	1964 births, Living people, American actors, American voice actors
The Weeknd discography	The Weeknd, Discographies
Affing	Aichach-Friedberg
Aindling	Aichach-Friedberg
Dr Sachin Bhardwaj	1987 births, Living people, Indian businesspeople, People from Haryana
Prisoners (2013 movie)	2013 drama movies, 2013 thriller movies, 2010s drama thriller movies, American drama thriller movies, Movies directed by Denis Villeneuve
Fresnoy-en-Chaussée	Communes in Somme
Fresnoy-lès-Roye	Communes in Somme
Fressenneville	Communes in Somme
Frohen-le-Grand	Former communes in Somme
Frohen-le-Petit	Former communes in Somme
Frohen-sur-Authie	Communes in Somme
Frise, Somme	Communes in Somme
To Grab the Ring	1968 movies, 1960s crime movies, Dutch movies, Movies directed by Nikolai van der Heyde
Daan metro station	Railway stations in Taipei
The Reenactment	1968 drama movies, Romanian movies, Movies based on books, Movies directed by Lucian Pintilie
Wild Arms	Video game series, Wild Arms
Zhongxiao Fuxing metro station	Railway stations in Taipei
Nanjing Fuxing metro station	Railway stations in Taipei
Francesc Arnau	1975 births, 2021 deaths, Spanish footballers, Spanish businesspeople
Yuan Longping	1930 births, 2021 deaths, Wolf Prize winners, Chinese academics, Chinese politicians, Chinese scientists, Researchers, People from Beijing, Accidental deaths from falls, Deaths from multiple organ failure
Thiago Silva	1984 births, Living people, Brazilian footballers, Chelsea F.C. players
Donal Logue	1966 births, Living people, Naturalized citizens of the United States, Canadian movie actors, American stage actors, American television actors, American voice actors, Canadian television actors, Canadian voice actors, Canadian stage actors, Irish movie actors, Irish television actors, Irish stage actors, Irish voice actors, Movie directors from California, Movie producers from California, Screenwriters from California, Writers from Oregon, Canadian movie directors, Canadian screenwriters, Canadian movie producers, Irish movie directors, Irish movie producers, Irish screenwriters, Writers from Ontario, Actors from Ottawa, Businesspeople from Oregon, Harvard University alumni
The Oak	1992 drama movies, Romanian movies, Movies directed by Lucian Pintilie
Laininghan Naoriya Phulo	Meitei people
Disappearance of Kyron Horman	2002 births, Missing people
San Agustin tree frog	Frogs, Animals of South America
The Night of Counting the Years	1969 drama movies, Egyptian movies
Siberia (1998 movie)	1998 comedy movies, Dutch comedy movies, Movies directed by Robert Jan Westdijk
Adele Bloch-Bauer	Austrian Jews, 1881 births, 1925 deaths, Socialites
Zhongshan Junior High School metro station	Railway stations in Taipei
Songshan Airport metro station	Railway stations in Taipei
Dazhi metro station	Railway stations in Taipei
Jiannan Road metro station	Railway stations in Taipei
Xihu metro station	Railway stations in Taipei
Gangqian metro station	Railway stations in Taipei
An Unforgettable Summer	1994 drama movies, Romanian movies, French drama movies, Movies directed by Lucian Pintilie
Wende metro station	Railway stations in Taipei
Neihu metro station	Railway stations in Taipei
Dahu Park metro station	Railway stations in Taipei
Huzhou metro station	Railway stations in Taipei
Donghu metro station	Railway stations in Taipei
Nangang Software Park metro station	Railway stations in Taipei
Taipei Nangang Exhibition Center metro station	Railway stations in Taipei
Microsoft Flight Simulator (2020 video game)	Simulator video games
Babak Khorramdin	Iranian writers, 1974 births, 2021 deaths
Mark Labbett	1965 births, Living people, English television personalities, People from Devon
Antiphon (music)	Music, Christianity
Antiphon the Sophist	Ancient Greek philosophers
Gauville, Somme	Communes in Somme
Gézaincourt	Communes in Somme
Glisy	Communes in Somme
Gorges, Somme	Communes in Somme
Goyencourt	Communes in Somme
Grandcourt, Somme	Communes in Somme
Grand-Laviers	Communes in Somme
Grébault-Mesnil	Communes in Somme
20 em 1	1995 video games, Master System games
Antiphon the Orator	Ancient Greek politicians, 480 BC, 411 BC
Hailles	Communes in Somme
Hallencourt	Communes in Somme
Hallivillers	Communes in Somme
Halloy-lès-Pernois	Communes in Somme
Hallu	Communes in Somme
Le Hamel, Somme	Communes in Somme
Zuzu Angel	1976 deaths, 1921 births, Fashion designers, Pages with unreviewed translations
Levitating	2020 songs, Dua Lipa songs, Funk music, Disco songs
Dasing	Aichach-Friedberg
Eurasburg, Swabia	Aichach-Friedberg
Inchenhofen	Aichach-Friedberg
Kühbach	Aichach-Friedberg
Merching	Aichach-Friedberg
Accident (1976 movie)	1976 movies, 1970s thriller movies, Romanian movies, Movies directed by Sergiu Nicolaescu
Mering	Aichach-Friedberg
Obergriesbach	Aichach-Friedberg
Petersdorf, Bavaria	Aichach-Friedberg
Pöttmes	Aichach-Friedberg
Rehling	Aichach-Friedberg
Marciana Marina	Settlements in Tuscany
Ried, Bavaria	Aichach-Friedberg
Schiltberg	Aichach-Friedberg
Schmiechen	Aichach-Friedberg
Hansi Flick	Association football midfielders, 1965 births, German footballers, German football managers, Sportspeople from Baden-Württemberg, People from Heidelberg, Living people
Sielenbach	Aichach-Friedberg
The Fixer (2016 movie)	2016 drama movies, Romanian movies, French drama movies, Movies directed by Adrian Sitaru
Steindorf	Aichach-Friedberg
Todtenweis	Aichach-Friedberg
Tamsui-Xinyi Line	Taipei, Railway stations
Taipei 101/World Trade Center metro station	Railway stations in Taipei
Xinyi Anhe metro station	Railway stations in Taipei
Daan Park metro station	Railway stations in Taipei
Dongmen metro station	Railway stations in Taipei
Chiang Kai-shek Memorial Hall metro station	Railway stations in Taipei
NTU Hospital metro station	Railway stations in Taipei
1999 Stanley Cup Finals	Stanley Cup Finals, Ice hockey in the United States, Dallas Stars
Taipei Main Station	Railway stations in Taipei
Zhongshan metro station	Railway stations in Taipei
Shuanglian metro station	Railway stations in Taipei
Minquan West Road metro station	Railway stations in Taipei
Yuanshan metro station	Railway stations in Taipei
Jiantan metro station	Railway stations in Taipei
Shilin metro station	Railway stations in Taipei
Zhishan metro station	Railway stations in Taipei
Mingde metro station	Railway stations in Taipei
Shipai metro station	Railway stations in Taipei
Qilian metro station	Railway stations in Taipei
Qiyan metro station	Railway stations in Taipei
Beitou metro station	Railway stations in Taipei
Fuxinggang metro station	Railway stations in Taipei
Zhongyi metro station	Railway stations in Taipei
Guandu metro station	Railway stations in Taipei
Zhuwei metro station	Railway stations in Taipei
Hongshulin station	Railway stations in Taipei
Tamsui metro station	Railway stations in Taipei
Xinbeitou metro station	Railway stations in Taipei
Guangci/Fengtian Temple metro station	Railway stations in Taipei
Vilseck	Amberg-Sulzbach
Birgland	Amberg-Sulzbach
Songshan-Xindian Line	Taipei, Railway stations
Illschwang	Amberg-Sulzbach
Xindian metro station	Railway stations in Taipei
Xindian District Office metro station	Railway stations in Taipei
Qizhang metro station	Railway stations in Taipei
Dapinglin metro station	Railway stations in Taipei
Jingmei metro station	Railway stations in Taipei
Wanlong metro station	Railway stations in Taipei
Gongguan metro station	Railway stations in Taipei
Taipower Building metro station	Railway stations in Taipei
Dance Dance Revolution Disney Channel Edition	PlayStation 2 games, PlayStation 2-only games, 2008 video games, Rhythm video games
Yukio Miya	1937 births, Japanese songwriters, 2013 deaths
Guting metro station	Railway stations in Taipei
Xiaonanmen metro station	Railway stations in Taipei
Kongbam	Meitei surnames
Kongkham	Meitei surnames
Konjengbam	Meitei surnames
Laikangbam	Meitei surnames
Laikhuram	Meitei surnames
Disney Move (video game)	PlayStation 2 games, PlayStation 2-only games, 2004 video games, Action video games
Ximen metro station	Railway stations in Taipei
Beimen metro station	Railway stations in Taipei
Songjiang Nanjing metro station	Railway stations in Taipei
Taipei Arena metro station	Railway stations in Taipei
Nanjing Sanmin metro station	Railway stations in Taipei
Songshan station	Railway stations in Taipei
Xiaobitan metro station	Railway stations in Taipei
Porto Azzurro	Settlements in Tuscany
Sassetta	Settlements in Tuscany
Hollenbach	Aichach-Friedberg
Rio Marina	Former municipalities of Tuscany
Rio nell'Elba	Former municipalities of Tuscany
Rio, Italy	2010s establishments in Italy, 2018 establishments in Europe, Settlements in Tuscany
Marciana	Settlements in Tuscany
Portoferraio	Towns in Tuscany
San Vincenzo, Tuscany	Settlements in Tuscany
Suvereto	Settlements in Tuscany
Evolution of plants	Evolution, Trees
PageCloud	Software, Web design
Rahama Sadau	1993 births, Living people, Nigerian people, African actors
Greg Evans (television host)	1953 births, Living people, Australian television presenters
Ali Nuhu	1974 births, Living people, Nigerian people
Lehman Brothers	Defunct companies of the United States, Banks of the United States, 1844 establishments in the United States, 2008 disestablishments in the United States
Bala Mohammed	1958 births, Living people, Nigerian politicians
Cracker Barrel	American restaurants, 1969 establishments in the United States
Perkins Restaurant & Bakery	American restaurants, 1957 establishments in the United States
The Nightingale's Prayer	1959 drama movies, 1950s romantic drama movies, Egyptian movies, Movies based on books, Movies directed by Henry Barakat
Immortal Song (movie)	1952 drama movies, 1950s romantic drama movies, Egyptian movies, Movies directed by Henry Barakat
Dendropsophus branneri	Frogs, Animals of South America
In the Alleys of Love	1991 movies, 1990s war movies, Iranian movies, Movies directed by Khosrow Sinai
The Sin (1965 movie)	1965 drama movies, Egyptian movies, Movies based on books, Movies directed by Henry Barakat
Hamelet	Communes in Somme
Hangard	Communes in Somme
Hangest-en-Santerre	Communes in Somme
Harbonnières	Communes in Somme
Hardecourt-aux-Bois	Communes in Somme
Harponville	Communes in Somme
Hattencourt	Communes in Somme
Hautvillers-Ouville	Communes in Somme
Havernas	Communes in Somme
Faygate	Villages in West Sussex
Hébécourt, Somme	Communes in Somme
Longueville, Lot-et-Garonne	Communes in Lot-et-Garonne
Swift Xi	Establishments in Japan by decade, 2000s establishments in Japan, Technology companies of Japan, 2000s establishments in Asia
Ebermannsdorf	Amberg-Sulzbach
Edelsfeld	Amberg-Sulzbach
Laiphrakpam	Meitei surnames
Archery World Cup	Archery
Lairenjam	Meitei surnames
Lairenlakpam	Meitei surnames
Shin Okamoto	1949 births, 2009 deaths, Japanese musicians
Lairikyengbam	Meitei surnames
Laishangbam	Meitei surnames
Laishram	Meitei surnames
Koichi Miyazaki	1942 births, 2014 deaths, Musicians from Tokyo, Japanese guitarists
Laithangbam	Meitei surnames
Mikio Morita	1944 births, Living people, Musicians from Chiba Prefecture, Bass guitarists, Japanese guitarists
Laitonjam	Meitei surnames
Lambalmayum	Meitei surnames
Langpoklakpam	Meitei surnames
Leimajam	Meitei surnames
Leimapokpam	Meitei surnames
Leiphrakpam	Meitei surnames
Leishangbam	Meitei surnames
Leishangthem	Meitei surnames
Leitam	Meitei surnames
Leitanthem	Meitei surnames
Lisham	Meitei surnames
Yasuji Sato	1946 births, 2021 deaths, Japanese pianists
Loitongbam	Meitei surnames
Loktongbam	Meitei surnames
Longjam	Meitei surnames
Lourembam	Meitei surnames
Lousigam	Meitei surnames
Takeshi Hamano	1949 births, Living people, Japanese musicians
Lukram	Meitei surnames
Maharabam	Meitei surnames
Maibam	Meitei surnames
Maibram	Meitei surnames
Maikam	Meitei surnames
Maimom	Meitei surnames
Mainam	Meitei surnames
Mairembam	Meitei surnames
Maitham	Meitei surnames
Mandingbam	Meitei surnames
Mayangbam	Meitei surnames
Mayanglambam	Meitei surnames
Mayengbam	Meitei surnames
Meinam	Meitei surnames
Meitram	Meitei surnames
Moirangmayum	Meitei surnames
Moirangthem	Meitei surnames
Mudum	Meitei surnames
Murtum	Meitei surnames
Mutum	Meitei surnames
Hédauville	Communes in Somme
Chernivtsi	Cities in Ukraine
Ivano-Frankivsk	Cities in Ukraine
Kiss Me More	Doja Cat songs, Disco songs, SZA songs, 2021 songs
Jan Kubelík	1880 births, 1940 deaths, Czech composers, 20th century composers, Violinists, Musicians from Prague
Creola, Louisiana	Villages in Louisiana
Dry Prong, Louisiana	Villages in Louisiana
Georgetown, Louisiana	Villages in Louisiana
Cotton Valley, Louisiana	Towns in Louisiana
Cullen, Louisiana	Towns in Louisiana
Sibley, Louisiana	Towns in Louisiana
Dispur	Capital cities in India, Assam
Agartala	Capital cities in India, Tripura
Ensdorf, Bavaria	Amberg-Sulzbach
Etzelwang	Amberg-Sulzbach
Neukirchen bei Sulzbach-Rosenberg	Amberg-Sulzbach
Guillon-Terre-Plaine	2019 establishments in France, Communes in Yonne
Portugal national under-21 football team	National under-21 football teams, Football in Portugal
Glère	Communes in Doubs
Montancy	Communes in Doubs
Saint-Hippolyte, Doubs	Communes in Doubs
Montandon	Communes in Doubs
T-ICU	Companies of Japan, 2016 establishments in Japan
In America (movie)	2002 drama movies, Irish movies, British drama movies, American drama movies, 20th Century Fox movies, Movies directed by Jim Sheridan
Nahakpam	Meitei surnames
Nameirakpam	Meitei surnames
Nandeibam	Meitei surnames
Naorem	Meitei surnames
Naoroibam	Meitei surnames
Grid Network (company)	Indonesia, Companies
Nepram	Meitei surnames
Ngairangbam	Meitei surnames
Ngangbam	Meitei surnames
Ngangom	Meitei surnames
Ngasekpam	Meitei surnames
Ngasepam	Meitei surnames
Ningombam	Meitei surnames
Ningthoujam	Meitei surnames
Ningthoukhongjam	Meitei surnames
Nongmaithem	Meitei surnames
Nongmeikapam	Meitei surnames
Nongthombam	Meitei surnames
Okram	Meitei surnames
Khwairakpam	Meitei surnames
Pangambam	Meitei surnames
Pangshatabam	Meitei surnames
Paonam	Meitei surnames
Pebam	Meitei surnames
Phamdom	Meitei surnames
Phanjoubam	Meitei surnames
Pharembam	Meitei surnames
Pheiroijam	Meitei surnames
Phijam	Meitei surnames
Auto Modelista	2002 video games, Capcom games, Nintendo GameCube games, PlayStation 2 games, Racing video games, Video games developed in Japan, Xbox games
Phirem	Meitei surnames
Phurem	Meitei surnames
Phuritsabam	Meitei surnames
Pichimayum	Meitei surnames
Potshangbam	Meitei surnames
Pukhrambam	Meitei surnames
Miesbach	Miesbach (district)
Alinani Precious Metals Limited	2017 establishments
Tegernsee	Spa towns in Germany, Miesbach (district)
Bayrischzell	Miesbach (district)
Måneskin	Eurovision Song Contest winners, Italian musical groups
Fischbachau	Miesbach (district)
Zitti e buoni	2021 songs
Roman Protasevich	1995 births, Living people, Belarusian writers, Journalists, Political activists, Political prisoners according to Viasna Human Rights Centre
Ryanair Flight 4978	2021 in Europe, Athens, Aviation, History of Belarus, History of Greece, History of Lithuania, International relations, May 2021 events, Minsk, Vilnius
Minsk National Airport	Airports in Europe, Belarus
Jorge Larrañaga	1956 births, 2021 deaths, Deaths from myocardial infarction, Uruguayan politicians, People from Montevideo
Cristóbal Halffter	1930 births, 2021 deaths, Spanish composers, Conductors, Writers from Madrid
Villafranca del Bierzo	Municipalities in Castile and León
Gmund am Tegernsee	Miesbach (district)
Ron Hill	1938 births, 2021 deaths, British Olympians, British athletes, Sportspeople from Lancashire
Jill Hennessy	1968 births, Living people, Canadian movie actors, Canadian television actors, Canadian stage actors, Canadian voice actors, Canadian singers, Actors from Alberta, People from Edmonton
Hausham	Miesbach (district)
Schliersee	Miesbach (district)
Dirty Harry (movie series)	Action movies, Series of movies, Warner Bros. movies
Harry Callahan (character)	Fictional American people
Sadokpam	Meitei surnames
Sagolsem	Meitei surnames
Salam (surname)	Meitei surnames
Samjetsabam	Meitei surnames
Samom	Meitei surnames
Sanasam	Meitei surnames
Sandam	Meitei surnames
Sandham	Meitei surnames
Sapam	Meitei surnames
Sarangthem	Meitei surnames
Sarungbam	Meitei surnames
Senjam	Meitei surnames
Seram	Meitei surnames
Shaikhom	Meitei surnames
Oleksii Prokhorenko	Living people, 1985 births, Ukrainian businesspeople
Shairem	Meitei surnames
Sinam	Meitei surnames
Soibam	Meitei surnames
Soraisam	Meitei surnames
Soram	Meitei surnames
Sorokhaibam	Meitei surnames
Soubam	Meitei surnames
Sougaijam	Meitei surnames
Sougrakpam	Meitei surnames
Soyam	Meitei surnames
Sukham	Meitei surnames
Nuns on the Run	1990 crime movies, 1990 comedy movies, 1990s criminal comedy movies, British criminal comedy movies, 20th Century Fox movies, Movies directed by Jonathan Lynn
A Heart in Winter	1992 romance movies, 1992 drama movies, 1990s romantic drama movies, French romance movies, French drama movies, Movies directed by Claude Sautet
Kherson	Cities in Ukraine
Lutsk	Cities in Ukraine
Novoselytsia	Cities in Ukraine
The Boxer (1997 movie)	1997 drama movies, 1990s sports movies, Irish movies, British drama movies, American sports drama movies, Universal Pictures movies, Movies directed by Jim Sheridan
Atorvastatin	Statins
Statin	Statins
Dendropsophus padreluna	Frogs, Animals of South America
Rosuvastatin	Statins
Pão de queijo	Breads, Brazilian food
Holzkirchen, Upper Bavaria	Miesbach (district)
Irschenberg	Miesbach (district)
Kobe Institute of Computing	Colleges and universities in Japan, 2005 establishments in Japan
Kreuth	Spa towns in Germany, Miesbach (district)
Otterfing	Miesbach (district)
Rottach-Egern	Miesbach (district)
Valley, Bavaria	Miesbach (district)
Waakirchen	Miesbach (district)
Warngau	Miesbach (district)
Weyarn	Miesbach (district)
Hongi	Traditions
Takenjam	Meitei surnames
Takhellambam	Meitei surnames
Takhelmayum	Meitei surnames
Taorem	Meitei surnames
Thangjam	Meitei surnames
Thaoroijam	Meitei surnames
Thingnam	Meitei surnames
Thingom	Meitei surnames
Thingujam	Meitei surnames
Thiyam	Meitei surnames
Thoidingjam	Meitei surnames
Thokchom	Meitei surnames
Thongam	Meitei surnames
Thongbam	Meitei surnames
Thongkhongmayum	Meitei surnames
Thongram	Meitei surnames
Thoudam	Meitei surnames
Siezbüttel	Former municipalities in Schleswig-Holstein, Steinburg (district)
Thounaojam	Meitei surnames
Jesca Wilfredy	1997 births, Living people, Tanzanian people
Cento Pittori via Margutta	Events in Europe, Art
Thunaojam	Meitei surnames
Toijam	Meitei surnames
Tonambam	Meitei surnames
Mixed (United Kingdom ethnicity category)	Ethnic groups in the United Kingdom
Tongbram	Meitei surnames
Torongbam	Meitei surnames
Toujam	Meitei surnames
Ukmabam	Meitei surnames
Urikhinbam	Meitei surnames
Uriksibam	Meitei surnames
Usham	Meitei surnames
Wahengbam	Meitei surnames
Waikhom	Meitei surnames
Wairokpam	Meitei surnames
Alberto Moioli	Art
Wangjam	Meitei surnames
Wangkheimayum	Meitei surnames
Wangkhem	Meitei surnames
Wangmayum	Meitei surnames
Warekpam	Meitei surnames
Watham	Meitei surnames
Dutch people in the United Kingdom	Ethnic groups in the United Kingdom
Yaikhom	Meitei surnames
Max Mosley	1940 births, 2021 deaths, British lawyers, British racecar drivers, Businesspeople from London, Sportspeople from London, Cancer deaths in London
Yambem	Meitei surnames
Yendembam	Meitei surnames
Carondelet Palace	Presidents of Ecuador, Quito
Yendrembam	Meitei surnames
Yengkhom	Meitei surnames
Yenshenbam	Meitei surnames
Yensembam	Meitei surnames
Yumkhaibam	Meitei surnames
Yumkham	Meitei surnames
Yumlembam	Meitei surnames
Yumnam	Meitei surnames
Yumrembam	Meitei surnames
Yurembam	Meitei surnames
Yurenjam	Meitei surnames
Aftab Shivdasani	actors from Mumbai
Rick Gomez	1972 births, Living people, Actors from New Jersey, American voice actors
Online piracy	Copyright infringement
Heilly	Communes in Somme
Hem-Hardinval	Communes in Somme
Hem-Monacu	Communes in Somme
LGBT rights in Peru	Peru, LGBT, Human rights, LGBT rights by country
Herbécourt	Communes in Somme
Peer-to-peer file sharing	Internet, File sharing
Tequeño	Venezuelan food, Breads, Snack foods
Dyslipidemia	Health
Asian Boxing Championships	Asian championships
Herleville	Communes in Somme
Herly, Somme	Communes in Somme
Hesbécourt	Communes in Somme
Hescamps	Communes in Somme
Yôichi Maeda (film director)	1934 births, 1998 deaths, People from Hyōgo Prefecture, Japanese movie directors
Grainau	Garmisch-Partenkirchen (district)
Bad Bayersoien	Spa towns in Germany, Garmisch-Partenkirchen (district)
Cachitos	Venezuelan food, Breads, Sandwiches
Gummo	1997 drama movies, 1990s teen drama movies, 1990s LGBT movies, American teen drama movies, American LGBT movies, Obscenity controversies
Murnau am Staffelsee	Garmisch-Partenkirchen (district)
Farchant	Garmisch-Partenkirchen (district)
Krün	Garmisch-Partenkirchen (district)
Mittenwald	Garmisch-Partenkirchen (district)
Pinto bean	Beans
Heudicourt, Somme	Communes in Somme
Heuzecourt	Communes in Somme
Hiermont	Communes in Somme
Haider Ali Khan	1993 births, Living people, Australian people
Bruce Lanoil	1960 births, American actors, American voice actors, Puppeteers
Hornoy-le-Bourg	Communes in Somme
Hyencourt-le-Grand	Former communes in Somme
Pertain	Former communes in Somme
Hypercourt	2017 establishments in France, Communes in Somme
Humbercourt	Communes in Somme
Akiko Nakamura	1945 births, Living people, Japanese singers, Japanese actors
Full employment	Economics
Sô Kuramoto	Japanese writers, 1934 births
Tomio Fukuoka	1936 births, Japanese educators, Living people
2019 CONCACAF Gold Cup	Association football templates, 2019 in association football
Gilbert Etienne	French economists, 1928 births, 2014 deaths
Gimlet Media	2014 establishments in New York (state), Companies of the United States
Competera	Artificial intelligence, 2014 establishments in Europe
Adam Mosseri	Living people, 1983 births
List of Atari 2600 prototype games	Atari 2600 games
Dunblane	Towns in Scotland, Stirling
Jack Brooksbank	1986 births, Businesspeople from London, Living people, House of Windsor, English businesspeople
Fire on the Amazon	1993 drama movies, 1990s adventure movies, American adventure movies, American drama movies, Peruvian movies, Movies directed by Luis Llosa
Dendropsophus nekronastes	Frogs, Animals of South America
Brisket	Cuts of beef
Nizamuddin Asir Adrawi	1926 births, 2021 deaths
Gregory Peter XX Ghabroyan	1934 births, 2021 deaths, Syrian people, People from Beirut, Catholics
Frenzo Harami	Living people, Grime music artists, 1990s births, British rap musicians, Pakistani entertainers, Pakistani music, Punjabi language, English rap musicians
Scrufizzer	People from Ealing, Living people, English rap musicians, Black British people, Year of birth missing (living people)
Cooli Carlito	1996 births, Living people, British rap musicians, Singer-songwriters from London, Musicians from London
List of Meitei surnames	Meitei surnames
Lorraine Bowen	1961 births, English singer-songwriters, English comedians, Musicians from Gloucestershire, Living people
Family Guy (season 2)	Family Guy, 1999 television seasons, 2000 television seasons
Picanha	Cuts of beef, Brazilian food
Kasra Nouri	Iranian journalists, Human rights activists, People from Tehran, 1990 births, Living people
Cathy Dennis	Grammy Award winners, English singer-songwriters, English pop singers, 1969 births, Living people
Les Fleurs du mal	French literature
Katie Griffin	1973 births, Living people, Canadian voice actors, Canadian comedians
Andrea Baker	Living people, American actors
The Elephant Whisperer (book)	2009 books, Elephants, South Africa
Legislative Assembly of Samoa	Samoa
2021 Samoan constitutional crisis	May 2021 events, Samoa, June 2021 events
Stresa–Mottarone cable car crash	2021 disasters, 2021 in Europe, 2020s disasters in Europe, 2020s in Italy, Disasters in Italy, May 2021 events, Piedmont, Transport disasters in Europe
Malian Armed Forces	Mali
Moctar Ouane	1955 births, Living people, Prime Ministers of Mali
Samuel E. Wright	1946 births, 2021 deaths, Deaths from prostate cancer, American movie actors, American television actors, American stage actors, American voice actors, Actors from South Carolina, Singers from South Carolina
Camden, South Carolina	Cities in South Carolina, County seats in South Carolina
Walden, New York	Villages in New York
Montgomery, New York	Towns in New York
Montgomery (village), New York	Villages in New York
Maybrook, New York	Villages in New York
List of The Backyardigans episodes	Lists of animated television series episodes, Lists of Nickelodeon television series episodes
Mohsen Lorestani	Living people, 1984 births, Iranian singers
Ebru Gündeş	Turkish singers
Ayşegül Coşkun	Turkish actors, Turkish singers, 1985 births, Living people
Vahid Khazaei	1985 births, Living people
Everybody in Our Family	2012 thriller movies, 2012 drama movies, Romanian movies, Dutch drama movies, Movies directed by Radu Jude
Bad Luck Banging or Loony Porn	2021 movies, 2020s comedy movies, 2020s drama movies, Romanian movies, Croatian movies, Czech movies, Luxembourgian movies, Movies directed by Radu Jude
Voices from Chernobyl (movie)	2016 movies, Documentary movies, Luxembourgian movies, Austrian movies, Belarusian movies, Ukrainian movies, Movies based on books, Movies directed by Pol Cruchten
Erica Watson	1973 births, 2021 deaths, American actors, Deaths from the COVID-19 pandemic
Eurovision Young Musicians	Music competitions, 1982 establishments in Europe
Shakshouka	Egg dishes
Koechlin's tree frog	Frogs, Animals of South America
Berrymans Lace Mawer (BLM)	Companies of the United Kingdom
Damiano David	Italian singers
Kateryna Pavlenko	1988 births, Living people
Saeed Ganji	Mixed martial artists
Dunabogdány	Villages in Hungary
Chuckle Time	Comedy television series, English-language television programs, 2010s television series, 2010s comedy television series, 2010s British television series, 2010s British comedy television series, 2018 television series debuts, 2018 television series endings
Eurovision Song Contest 2022	Eurovision Song Contest
Pamela Hayden	1953 births, Living people, American actors
Kenneth C. Griffin	1968 births, Living people, Businesspeople from Florida, Businesspeople from Chicago, People from Daytona Beach, Florida
Premiera	1976 comedy movies, Romanian movies, Movies directed by Mihai Constantinescu
A Case of Murder	2004 movies, 2000s thriller movies, South African movies, Movies set in South Africa
Silent Wedding	2008 comedy-drama movies, Romanian movies, Luxembourgian movies, French comedy movies, French drama movies, Movies directed by Horațiu Mălăele
Naruto (season 1)	Naruto
Toonz Animation India	Animation studios in Asia, 1990s establishments in India, 1999 establishments in Asia
Blockbuster LLC	Companies of the United States
Loyumba Shinyen	Meitei culture, History of Manipur, Constitutions
2021 San Jose shooting	2021 mass shootings in the United States, 2021 murders in the United States, 21st century in California, History of San Jose, California, Mass murder in California, Mass murder in 2021, Mass shootings in California, Murder-suicides in California, Suicide in the 2020s
List of awards and nominations received by Chungha	Lists of awards received by South Korean musician
Refinancing	Accounting
A Wedding (2016 movie)	2016 drama movies, Belgian movies, French drama movies, Pakistani movies, Luxembourgian movies, Movies directed by Stephan Streker
Dendropsophus arndti	Frogs, Animals of South America
Ougri	Meitei culture, Meitei literature, Meitei religion
Garlic bread	Breads, Garlic dishes
Ougri festival	Manipur, Festivals
Hanger steak	Cuts of beef
Oswald Mosley	1896 births, 1980 deaths, British politicians
Jaime Lerner	1937 births, 2021 deaths, Brazilian architects, Brazilian politicians, Deaths from kidney disease
Carla Fracci	1936 births, 2021 deaths, Cancer deaths in Italy, Italian stage actors, Ballerinas, Dancers, Actors from Milan, Italian movie actors
Oatmeal cookie	Cookies
Ring Tone Text Transfer Language	Computer file formats, Musical notation
2009 FIFA Puskás Award	FIFA, 2009 in sports
Sorrento, Louisiana	Towns in Louisiana
Jackson, Louisiana	Towns in Louisiana
Jonesville, Louisiana	Towns in Louisiana
Patterson, Louisiana	Cities in Louisiana
Harahan, Louisiana	Cities in Louisiana
Westwego, Louisiana	Cities in Louisiana
St. Gabriel, Louisiana	Cities in Louisiana
Kaplan, Louisiana	Cities in Louisiana
Wind River (movie)	2017 movies, 2010s mystery movies, 2010s western movies, 2010s thriller movies, American mystery movies, American western movies, American thriller movies, Movies set in Wyoming
Wind River Indian Reservation	Wyoming, Native American
I Do Not Care If We Go Down in History as Barbarians	2018 movies, 2010s war movies, 2010s black comedy movies, Romanian movies, Czech movies, German movies, French comedy movies, Bulgarian movies, World War II movies, Movies directed by Radu Jude
The Doom	1976 drama movies, Romanian movies, Movies directed by Sergiu Nicolaescu
Revolution (1985 movie)	1985 drama movies, 1980s war movies, 1980s adventure movies, British war movies, British adventure movies, British drama movies, Norwegian movies, Warner Bros. movies
Lev Mei	1822 births, 1862 deaths, People from Moscow, Russian poets
United States Fish and Wildlife Service	United States Department of the Interior, United States government agencies, Fishing
COVID-19 pandemic in Bahrain	COVID-19 pandemic by country, History of Bahrain
COVID-19 pandemic in Florida	COVID-19 pandemic in the United States, 21st century in Florida
COVID-19 pandemic in Mississippi	COVID-19 pandemic in the United States, History of Mississippi
COVID-19 pandemic in New York (state)	COVID-19 pandemic in the United States, 21st century in New York
Michael the Brave (movie)	1971 drama movies, Romanian movies, French drama movies, Italian drama movies, Movies directed by Sergiu Nicolaescu
Who Shot Mr. Burns?	The Simpsons (season 6) episodes, The Simpsons (season 7) episodes, 1995 television episodes
Chernobyl Nuclear Power Plant	Nuclear power plants in Europe, Ukraine
Kees de Jager	1921 births, 2021 deaths, Accidental deaths from falls, Astrophysicists, Dutch astronomers, Dutch centenarians, People from North Holland, Skeptics
Foster Friess	1940 births, 2021 deaths, American philanthropists, American political activists, American conservatives, American billionaires, Politicians from Wisconsin, Businesspeople from Wisconsin, Politicians from Wyoming, Businesspeople from Wyoming, US Republican Party politicians, Deaths from myelodysplastic syndrome
Rice Lake, Wisconsin	Cities in Wisconsin
Barron, Wisconsin	Cities in Wisconsin, County seats in Wisconsin
Jackson Hole	Valleys of the United States, Geography of Wyoming
Gros Ventre Range	Mountain ranges of the United States, Geography of Wyoming
Amala	2018 albums, Debut albums, Doja Cat albums, Hip hop albums, Dancehall albums, R&B albums
Hot Pink (album)	2019 albums, Doja Cat albums, Hip hop albums, Pop albums, Funk albums, R&B albums
Two-spotted tree frog	Frogs, Animals of South America
Iran Badminton International	Badminton
Ninja Warrior UK	2015 television series debuts, 2019 television series endings
Haluk Bilginer	1954 births, Turkish movie actors, Turkish television actors, Turkish stage actors, People from İzmir
Herman Chernoff	1923 births, Living people, American mathematicians, American physicists, American academics, Scientists from New York City, Writers from New York City
Jerome Hellman	1928 births, 2021 deaths, Movie producers from New York City
Reza Motorcyclist	1970 drama movies, 1970s crime drama movies, Iranian movies, Movies directed by Masoud Kimiai
Wood Pigeon (1970 movie)	1970 drama movies, Iranian movies, Movies directed by Ali Hatami
Black nationalism	History of the United States
Keiretsu	Japan, Business
Elham Jdi	1997 births, Living people, Iranian actors
Circles in a Forest	1989 drama movies, 1980s adventure movies, Movies based on books, South African movies, Movies set in South Africa, Movies directed by Regardt van den Bergh
Siavash (TV Series 2021)	Series of movies
Chocolate with Nuts	SpongeBob SquarePants episodes, 2002 television episodes
Shibuya Crossing	Tokyo
Gao Jiamin	1966 births, Living people, Chinese sportspeople
Yesterday (2004 movie)	2004 drama movies, South African movies, Movies set in South Africa, Movies directed by Darrell Roodt
Time crystal	Quantum mechanics, Time
Croatian kuna	Currency of Europe, Croatia
2020 FIFA Club Confederation Cup play-off (AFC)	2020 in sports, FIFA
One False Move	1992 crime movies, 1992 thriller movies, 1990s crime thriller movies, American crime thriller movies, Movies directed by Carl Franklin
Charles Fredrick Wiesenthal	1726 births, 1789 deaths, German inventors
A Rose for Everyone	1967 comedy movies, Italian comedy movies, Movies directed by Franco Rossi
Honolulu (movie)	1939 movies, 1930s musical movies, 1930s comedy movies, American musical comedy movies, Movies directed by Edward Buzzell
The Angel Levine	1970 drama movies, American drama movies, Movies directed by Ján Kadár
On the Path	2010 drama movies, Bosnia and Herzegovina movies, Austrian movies, German drama movies, Croatian movies, Movies directed by Jasmila Žbanić
East Palo Alto, California	Cities in California, Cities in the San Francisco Bay Area, Settlements in San Mateo County, California
South San Francisco, California	Cities in California, Cities in the San Francisco Bay Area, Settlements in San Mateo County, California
Coutances	Communes in Manche, Subprefectures in France
Boissy-Saint-Léger	Communes in Val-de-Marne
Bonneuil-sur-Marne	Communes in Val-de-Marne
Bry-sur-Marne	Communes in Val-de-Marne
Charenton-le-Pont	Communes in Val-de-Marne
SLK	English hip hop groups, Grime music groups, Musical groups from London
Chennevières-sur-Marne	Communes in Val-de-Marne
Chevilly-Larue	Communes in Val-de-Marne
Fontenay-sous-Bois	Communes in Val-de-Marne
Fresnes, Val-de-Marne	Communes in Val-de-Marne
Gentilly, Val-de-Marne	Communes in Val-de-Marne
Joinville-le-Pont	Communes in Val-de-Marne
Limeil-Brévannes	Communes in Val-de-Marne
Mandres-les-Roses	Communes in Val-de-Marne
Kropyvnytskyi	Cities in Ukraine
Nikopol, Ukraine	Cities in Ukraine
Bohuslav	Cities in Ukraine
Marolles-en-Brie, Val-de-Marne	Communes in Val-de-Marne
Marolles-en-Brie, Seine-et-Marne	Communes in Seine-et-Marne
Inval-Boiron	Communes in Somme
Irles	Communes in Somme
Jumel	Communes in Somme
Laboissière-en-Santerre	Communes in Somme
Lachapelle, Somme	Communes in Somme
Lafresguimont-Saint-Martin	Communes in Somme
Lahoussoye	Communes in Somme
Laleu, Somme	Communes in Somme
Sotteville-lès-Rouen	Communes in Seine-Maritime
Lamotte-Brebière	Communes in Somme
Lamotte-Warfusée	Communes in Somme
Lanches-Saint-Hilaire	Communes in Somme
Piennes-Onvillers	Communes in Somme
Educational research	Education, Research methods
A Reasonable Man	1999 crime movies, 1999 drama movies, 1990s crime drama movies, South African movies, French crime movies, French drama movies, Movies set in South Africa, Movies directed by Gavin Hood
Niki Yang	1985 births, Living people, Korean writers
Telefe	Television stations, 1990s establishments in South America
Nokia N810	Nokia mobile phones, Mobile phones released in 2000s
Honor Thy Father (movie)	2015 movies, 2010s crime thriller movies, Filipino movies, Movies directed by Erik Matti
Dendropsophus cachimbo	Frogs, Animals of South America
Kyrgyzstani som	Kyrgyzstan, Currency of Asia
Gagamboy	2004 comedy movies, 2004 science fiction movies, 2000s action movies, 2000s fantasy movies, Filipino movies, Movies directed by Erik Matti
Alpine Racer 3	2002 video games, Arcade games, Namco games, PlayStation 2 games, Racing video games, Sony Interactive Entertainment games, Video game sequels, Video games developed in Japan, Zeebo games
Telefe Internacional	1990s establishments in South America, Television channels
Uzbekistani so'm	Uzbekistan, Currency of Asia
Air Crash Investigation Special Report	Television programs
Vagabond (1950 movie)	1950 drama movies, Iranian movies, Movies directed by Mehdi Reisfirooz
Arcana Heart (series)	Video game series
Man About Town (1939 movie)	1939 movies, 1930s musical movies, 1930s comedy movies, American musical comedy movies, Paramount movies, Movies directed by Mark Sandrich
Snatch (movie)	2000 crime movies, 2000 comedy movies, 2000s criminal comedy movies, British criminal comedy movies, American criminal comedy movies, Columbia Pictures movies, Movies directed by Guy Ritchie
Shock Treatment (1973 movie)	1973 drama movies, French drama movies, Italian drama movies, Movies directed by Alain Jessua
The Baader Meinhof Complex	2000s biographical movies, 2008 drama movies, 2000s drama thriller movies, German drama movies, French drama movies, French thriller movies, Czech movies, Movies based on books, Movies directed by Uli Edel
Moûtiers	Communes in Savoie
Montvalezan	Communes in Savoie
Archamps	Communes in Haute-Savoie
Abondance, Haute-Savoie	Communes in Haute-Savoie
The Pillow Book (movie)	1996 drama movies, 1990s erotic movies, 1990s LGBT movies, Dutch drama movies, British LGBT movies, British drama movies, French drama movies, Luxembourgian movies, Austrian movies, Movies based on books, Movies directed by Peter Greenaway
Tim Tipene	Publications
Hajji Washington	1983 comedy-drama movies, Iranian movies, Movies directed by Ali Hatami
Mark Eaton	1957 births, 2021 deaths, Utah Jazz players, Sportspeople from California, People from Inglewood, California, Road accident deaths in the United States
The Perfect Circle	1997 drama movies, 1990s war movies, Bosnia and Herzegovina movies, French drama movies
Marcell Jankovics	1941 births, 2021 deaths, Hungarian movie directors, Hungarian writers, Animators, Artists, People from Budapest
Cornelius Sim	1951 births, 2021 deaths, Bruneian people, Cardinals of the Roman Catholic Church, Deaths from cancer, Deaths from cardiac arrest
Serbian Canadians	Ethnic groups in Canada
Croatian Canadian	Ethnic groups in Canada
Slovak Canadian	Ethnic groups in Canada
Venezuelan Canadian	Ethnic groups in Canada
List of Top of the Pops presenters	Television presenters
Estonian Canadian	Ethnic groups in Canada
Languevoisin-Quiquery	Communes in Somme
Laviéville	Communes in Somme
Lawarde-Mauger-l'Hortoy	Communes in Somme
Luís Leal	1987 births, Portuguese footballers, African footballers, São Tomé and Príncipe people, Association football forwards, Living people
Lesbœufs	Communes in Somme
Misery, Somme	Former communes in Somme
Marchélepot	Former communes in Somme
Marchélepot-Misery	2019 establishments in France, Communes in Somme
Jerky	Snack foods, Meat
Mathiasson's tree frog	Frogs, Animals of South America
The Weather Network	1988 establishments in Canada, Television channels, Canadian television, Ontario
Datalake	Computing
Una Mae Carlisle	1915 births, 1956 deaths, American singer-songwriters, African-American singers, Deaths from pneumonia, Singers from Ohio, People from Zanesville, Ohio
Gwen Shamblin Lara	1955 births, 2021 deaths, Christian writers, Aviation deaths in the United States, Writers from Memphis, Tennessee
Akrotiri (prehistoric city)	Ancient Greek cities, Archaeological sites in Europe, History of Greece
Arturo de Jesús Correa Toro	1941 births, 2021 deaths, Colombian people, Roman Catholic bishops, Deaths from the COVID-19 pandemic in Colombia
Pasto, Colombia	Cities in Colombia
Fish as food	Seafood
Liancourt-Fosse	Communes in Somme
Limeux, Somme	Communes in Somme
Long, Somme	Communes in Somme
Longavesnes	Communes in Somme
Longpré-les-Corps-Saints	Communes in Somme
Longueau	Communes in Somme
Longueval	Communes in Somme
Aubréville	Communes in Meuse
Bezonvaux	Communes in Meuse
Ratatoskr	Norse mythology
Microkini	Swimwear
Longuevillette	Communes in Somme
Louvencourt	Communes in Somme
Les Hauts de Forterre	2017 establishments in France, Communes in Yonne
Mailly-Maillet	Communes in Somme
Mailly-Raineval	Communes in Somme
The Go-Go's	1978 establishments in California, Musical groups established in 1978, American rock bands, American girl groups, Musical groups from Los Angeles, California, 1970s American music groups, 1980s American music groups, 1990s American music groups, 2000s American music groups, 2010s American music groups
UK Dance Singles and Albums Charts	British record charts, Electronic dance music
Channel U	Television channels
The Brothers Grimm (movie)	2005 comedy movies, 2000s adventure movies, 2000s fantasy movies, Czech movies, British adventure movies, British comedy movies, British fantasy movies, American adventure movies, American comedy movies, American fantasy movies, Movies directed by Terry Gilliam
SCP Foundation	Internet
List of heads of state of Eritrea	Eritrea
Robert L. Gibson	1946 births, Living people, American astronauts, American aviators, Engineers from New York, Scientists from New York
George II of Greece	1890 births, 1947 deaths, Kings of Greece, Deaths from arteriosclerosis
Richford, New York	Towns in New York
List of kings of Greece	Kings of Greece
Otto of Greece	1915 births, 1867 deaths, Kings of Greece
Constantine I of Greece	1868 births, 1923 deaths, Kings of Greece
Alexander of Greece	1893 births, 1920 deaths, Deaths from sepsis, Kings of Greece
Barbary macaque	Old World monkeys, Mammals of Africa, Mammals of Europe
Blair House	Buildings and structures in Washington, D.C.
Metal Max (video game)	1991 video games, Japan exclusive video games, Metal Max, Nintendo Entertainment System games, Super Nintendo Entertainment System games, Video games developed in Japan
Destroy All Humans! (video game series)	Destroy All Humans!, Video game series
Hot Shots Golf 2	1999 video games, Golf video games, Hot Shots Golf, PlayStation games, PlayStation-only games, Sports video games, Video game sequels, Video games developed in Japan
Hinduism in Assam	Hinduism in South Asia
Aquiles Este	Semioticians, Semiotics, American writers
Andriy Beshta	1976 births, 2021 deaths, Ambassadors, Deaths from myocardial infarction, Ukrainian politicians
Thunder of Gigantic Serpent	1980s adventure movies, 1988 horror movies, English-language movies, Movies about animals, American monster movies, Taiwanese movies, 1980s monster movies, Monster movies
Pacific lowland tree frog	Frogs, Animals of South America
Edith Cowan	1861 births, 1932 deaths, Australian activists, Disease-related deaths in Australia, Nationalist Party of Australia politicians, Officers of the Order of the British Empire, Politicians from Western Australia
Hossein Omidi	Iranian actors, 1984 births, Living people
South African braille	Language, South Africa
In Desert and Wilderness (2001 movie)	2001 movies, 2000s adventure movies, Polish movies, Movies based on books, Movies directed by Gavin Hood
Stephen Thompson (fighter)	1983 births, Living people, American mixed martial artists, Sportspeople from South Carolina
Evanston, Wyoming	Cities in Wyoming, County seats in Wyoming
Lil Loaded	2000s births, 2021 deaths, Singers from Dallas, Texas
Cat Deeley	1976 births, Living people, People from West Midlands (county), English models, English movie actors, English television actors, English voice actors, English television personalities
List of national parks of the United States	Lists of national parks, National parks in the United States, United States-related lists
The Landowner's Daughter	1953 drama movies, Brazilian movies, Movies based on books
Street fighting	Violence
Paranoid Park (2007 movie)	Movies based on books, 2007 drama movies, French drama movies, American drama movies, Movies directed by Gus Van Sant
Thatgamecompany	Companies of the United States, 2006 establishments in the United States
Oath Keepers	Political parties in the United States, Nationalism, 2009 establishments in the United States
Aurora Pita Alonso	1936 births, 2021 deaths
Dendropsophus meridianus	Frogs, Animals of South America
Tarlan Parvaneh	1998 births, Living people, Iranian actors
Alireza Jafari	1994 births, Living people, Iranian actors
Milad Keymaram	Iranian actors, 1985 births, Living people
Poolside (movie)	American movies
The Lonely Villa	American movies
Antiziganism	Hatred, Roma
Marion Leonard	1881_births, American_movie_actors, 1956 deaths
1902 Navy Midshipmen football team	20th century in sports, 1900s in the United States
Early 1990s recession in the United States	Financial crises, 1990 in the United States, 1991 in the United States, 1992 in the United States
Prince Amedeo, Duke of Aosta (born 1943)	1943 births, 2021 deaths, Italian people, Princes and princesses, Deaths from cardiac arrest, Deaths from surgical complications
Christa Stubnick	1933 births, 2021 deaths, German Olympic silver medalists
Buddy Van Horn	1928 births, 2021 deaths, Stuntmen, Movie directors from Los Angeles, California
Lesbian bar	Places where alcohol is served, LGBT
Violet Hill (song)	2008 songs, Coldplay songs
Gap (clothing retailer)	1960s establishments in California, 1969 establishments in the United States, Companies based in San Francisco, American clothing companies
Temple of Kom Ombo	Temples, Egypt
Paradise (Coldplay song)	2011 songs, Coldplay songs
Gorani	Balkan Mountains, Islam, History of Persia
Gainax	Animation studios in Asia, Japanese video game designers
Horror and terror	Horror
Passion (emotion)	Emotions
Pomak	Ottoman Empire
Dyke March	LGBT rights
A Rush of Blood to the Head Tour	Coldplay, Musical groups
Jodi Balfour	1987 births, Living people, South African actors, People from Cape Town
Melissa Barrera (actress)	1990 births, Living people, Mexican movie actors, Mexican television actors, Mexican voice actors, Mexican singers, People from Monterrey
Hichem Djait	1935 births, Living people, Tunisian writers, Historians, Academics, People from Tunis
Adnan Al Sharqi	1941 births, 2021 deaths, Lebanese footballers, Football managers, People from Beirut
Alice Weidel	1979 births, Living people, German politicians
Harry Turtledove	1949 births, Living people, American novelists, American historians, American essayists, Writers from Los Angeles, California
Ketogenesis	Metabolism
ESPN Xtra	Radio stations in the United States
José Manuel Pinto	1975 births, Living people, Sportspeople from Andalusia, Spanish association football goalkeepers
Grbavica (movie)	2006 movies, 2000s war movies, Bosnia and Herzegovina movies, Austrian movies, German movies, Croatian movies, Movies directed by Jasmila Žbanić
R.O.S.E. (Jessie J album)	2018 albums, Jessie J albums, R&B albums
Non-fungible token	Cryptography, Currency, Technology
Wow! signal	SETI
Love Island (2014 movie)	2014 comedy movies, 2014 romance movies, 2010s romantic comedy movies, Croatian movies, German romance movies, German comedy movies, Swiss movies, Bosnia and Herzegovina movies, Movies directed by Jasmila Žbanić
Foro TV	2010 establishments in North America, 2010s establishments in Mexico, Television channels
ESPNews	American television networks, 1996 establishments in the United States
U-Carmen e-Khayelitsha	2005 movies, 2000s musical movies, South African movies, Movies based on plays, Movies set in South Africa, Movies directed by Mark Dornford-May
Whitney (album)	1987 albums, Whitney Houston albums, Pop albums, Dance albums, R&B albums
The Orange Suit	2012 comedy-drama movies, Iranian movies, Movies directed by Dariush Mehrjui
I'm Your Baby Tonight	1990 albums, Whitney Houston albums, Dance albums, New jack swing albums, R&B albums
Thank U, Next	Ariana Grande albums, 2019 albums, Pop albums, Trap albums, R&B albums
2020–21 EFL Championship	2021 in sports, 2020 in sports
Jacques Lacoursière	1932 births, 2021 deaths, Canadian historians, Canadian television presenters, Writers from Quebec
Little One (movie)	2012 drama movies, South African movies, Movies set in South Africa, Movies directed by Darrell Roodt
Mike Marshall (pitcher)	1943 births, 2021 deaths, Detroit Tigers players, Milwaukee Brewers players, Houston Astros players, Montreal Expos players, Los Angeles Dodgers players, Atlanta Braves players, Texas Rangers players, Minnesota Twins players, New York Mets players, Sportspeople from Michigan
Bunny Matthews	1951 births, 2021 deaths, American cartoonists, Writers from Louisiana, Deaths from lymphoma
For Those Who Can Tell No Tales	2013 drama movies, Bosnia and Herzegovina movies, Qatari movies, German drama movies, Movies directed by Jasmila Žbanić
Lady Dimitrescu	Resident Evil characters
Resident Evil Village	2021 video games, Resident Evil
Ethan Winters	Resident Evil characters, Fictional American people, Fictional characters introduced in the 2010s
Parliament of Cambodia	Cambodia
National Assembly of Cambodia	Cambodia
Senate of Cambodia	Cambodia
Tram Iv Tek	1948 births, 2021 deaths, Cambodian people, Asian politicians
Rick Mitchell	1955 births, 2021 deaths, Australian Olympic silver medalists, Australian athletes, Sportspeople from Sydney, Deaths from prostate cancer, Cancer deaths in Sydney
Old Navy	Companies based in San Francisco, American clothing companies, 1994 establishments in California
Grace Fulton	1996 births, Living people, American dancers, American movie actors, American television actors, American stage actors, American voice actors, American child actors
Levi Strauss & Co.	Companies listed on the New York Stock Exchange, 1853 establishments in the United States, Companies based in San Francisco, American clothing companies
List of songs recorded by ABBA	ABBA songs
Sam's Club	Supermarkets of the United States, 1983 establishments in the United States
Jovino Novoa	1945 births, 2021 deaths, Deaths from emphysema, Chilean lawyers, Chilean politicians, People from Santiago
José Manuel Piñeiro Amigo	Spanish politicians, Spanish lawyers, 1938 births, 2021 deaths
Indian classical dance	Dance in India
Samira Hosseini	Iranian actors, Living people
Esma Redžepova	1943 births, 2016 deaths, Singers, People from Skopje, Roma
Lisa Marie (actress)	1968 births, Living people, American movie actors, American television actors, American voice actors, American stage actors, Actors from New Jersey, Models from New Jersey
IRIS Kharg	2021 disasters, 2020s disasters in Asia, 2020s fires, 21st century in Iran, Fires in Asia, June 2021 events, Maritime disasters, Ships, Transport disasters in Asia
Georgina Bloomberg	1983 births, Living people
New York's 17th congressional district	Congressional districts of New York (state)
Alfredo (name)	Given names
Pop it (toy)	Toys
Barnsley	Towns in South Yorkshire, County towns in England
Azerbaijani Soviet Encyclopedia	Encyclopedias, Azerbaijani culture, Soviet culture
Crump tree frog	Frogs, Animals of South America
12 Years a Slave	19th century books, Slavery
The Three Musketeers (1993 movie)	1993 action movies, 1993 comedy movies, 1990s adventure movies, Austrian movies, American action movies, American adventure movies, American comedy movies, Movies based on books
Joy (2018 movie)	2018 drama movies, Austrian movies
Freihung	Amberg-Sulzbach
Freudenberg, Bavaria	Amberg-Sulzbach
Lake Genval	Lakes of Europe, Geography of Belgium, Flemish Brabant, Walloon Brabant
Warren, Pennsylvania	Cities in Pennsylvania, County seats in Pennsylvania
Wood, South Dakota	Towns in South Dakota
White River, South Dakota	Cities in South Dakota, County seats in South Dakota
Mound City, South Dakota	Towns in South Dakota, County seats in South Dakota
Sex in movies	Human sexuality, Movies
John Rutherford (Florida politician)	1952 births, Living people, American police officers, United States representatives from Florida, Politicians from Omaha, Nebraska, Politicians from Jacksonville, Florida, US Republican Party politicians
Katie Hobbs	1969 births, Living people, State legislators of the United States, Politicians from Phoenix, Arizona, US Democratic Party politicians
Kimberly Yee	1974 births, Living people, State legislators of the United States, Politicians from Phoenix, Arizona, US Republican Party politicians
Belle de Jour (movie)	1967 drama movies, French drama movies, Adultery in movies, Movies based on books, Movies directed by Luis Buñuel
Breast fetishism	Human sexuality, Breasts
Sexual stimulation	Sexuality
Musi	Rivers of India, Telangana
Bev Bergeron	2020 deaths, American actors, American magicians
Lisa Lisa and Cult Jam	1980s establishments in New York (state), 1984 establishments in the United States, 1990s disestablishments in New York (state), 1991 disestablishments in the United States, American R&B bands, American pop music groups, Musical groups from New York City, Musical groups established in 1984, Musical groups disestablished in 1991, 1980s American music groups, 1990s American music groups
Olympia LePoint	Living people, People from California, American businesspeople
Platinum Jubilee of Elizabeth II	2022, Elizabeth II, Events in the United Kingdom
When I Saw You (movie)	2012 drama movies, Palestinian movies, Jordanian movies, Greek movies, United Arab Emirates movies, Movies directed by Annamarie Jacir
Den Burg	Settlements in North Holland, Texel
Dunnock	Passeriformes
Gold Digger (Kanye West song)	Rap songs, Kanye West songs, 2005 songs
Salt of this Sea	2008 drama movies, Palestinian movies, French drama movies, Belgian movies, American drama movies, Dutch drama movies, Spanish movies, Swiss movies, Movies directed by Annamarie Jacir
99 Bottles of Beer	Children's songs
849	849
850s	850s
853	853
Phil Lombardi	1963 births, 2021 deaths, American baseball players, Cancer deaths in California, Deaths from brain cancer, New York Mets players, New York Yankees players, Sportspeople from Texas, People from Abilene, Texas
F1 Circular Quay to Manly Ferry	Transport in Sydney, Water transport
Meiteism	Meitei religion
Lakshmi Nandan Bora	1931 births, 2021 deaths, Indian novelists, Deaths from the COVID-19 pandemic in India
Herman Stok	1927 births, 2021 deaths, Dutch radio personalities, Dutch television presenters, People from Rotterdam
Ian Shearer	1941 births, 2021 deaths, New Zealand politicians, Deaths from idiopathic pulmonary fibrosis
Hsing Yin Shean	1952 births, 2021 deaths, Deaths from the COVID-19 pandemic in Malaysia, Malaysian politicians
Pema Chödrön	1936 births, Living people, American Buddhists, Nuns, American teachers, Writers from New York City
Joel Wachs	1939 births, Living people, Politicians from Los Angeles, California, Politicians from Pennsylvania, People from Scranton, Pennsylvania, US Democratic Party politicians, LGBT politicians, Gay men, LGBT people from Los Angeles, California, LGBT people from Pennsylvania
Wendy Greuel	1961 births, Living people, Politicians from Los Angeles, California, US Democratic Party politicians
770s BC	770s BC
Ted Lieu	1969 births, Living people, United States representatives from California, Naturalized citizens of the United States, Taiwanese politicians, Politicians from Cleveland, Ohio, Politicians from Los Angeles, California, US Democratic Party politicians
Debbie Dingell	1953 births, Living people, United States representatives from Michigan, Politicians from Detroit, Michigan, US Democratic Party politicians
Nury Martinez	1973 births, Living people, Politicians from Los Angeles, California, US Democratic Party politicians
Yoshio Yatsu	1934 births, 2021 deaths, Deaths from liver cancer, Japanese politicians
X-Press Pearl	2021 disasters, 2020s disasters in Asia, 2020s fires, 21st century in Sri Lanka, Fires in Asia, Indian Ocean, June 2021 events, Maritime disasters, Transport disasters in Asia
Tajadas	Venezuelan food, Caribbean, Nicaraguan culture, Colombian food, Honduran culture, Panamanian culture
Leader of the Opposition (Israel)	Israeli opposition leaders
Shelly Yachimovich	1960 births, Living people, Former Members of Knesset, HaAvoda politicians, Israeli journalists, Israeli opposition leaders, Jewish Israeli writers, Jewish women politicians, Political commentators
STAMSITE	1992 births, Internet celebrities, Living people, Swedish YouTubers
17th century BC	17th century BC
Maduro	Surnames
Meir Ya'ari	1897 births, 1987 deaths, Israeli opposition leaders, Israeli activists, Israeli educators
Isaura Abelairas	1951 births, 2021 deaths, Cancer deaths in Spain, Spanish educators, Spanish politicians
Binyamin Ben-Eliezer	1936 births, 2016 deaths, Deaths from kidney disease, Israeli opposition leaders, Naturalized citizens of Israel, Iraqi politicians, Iraqi military people, Israeli generals, People from Tel Aviv
Shaul Mofaz	1948 births, Living people, Naturalized citizens of Israel, Iranian military people, Iranian politicians, Israeli military people, Israeli opposition leaders, Kadima politicians, People from Tehran
1491	1491
Journey (2012 video game)	2012 video games
Gluconeogenesis	Metabolism
Yorai Lahav-Hertzano	1988 births, Living people, Gay Jews, Israeli LGBT people, Jewish Israeli politicians, LGBT politicians, Members of Knesset, People from Tel Aviv, Tel Aviv University alumni, Yesh Atid politicians
University of Botswana	1982 establishments in Africa, Botswana, Colleges and universities in Africa
Linah Mohohlo	1952 births, 2021 deaths, Botswana people, African businesspeople, African writers, Academics, Economists, Bankers, Deaths from the COVID-19 pandemic

