Anne Wiazemsky	1947 births, 2017 deaths, Cancer deaths in France, French movie actors, French television actors, French novelists, Writers from Berlin
Gene Stallings	1935 births, Living people, American football coaches, American football players, Sportspeople from Texas, People from Paris, Texas
Command-line interface	Computing
Romantic friendship	Sociology, Emotions, Relationships
Feroz	Spanish movies, Fantasy movies, Drama movies, 1984 movies
Dwarkanath Sanzgiri	Living people
Vikram Singh Puar	1989 births, Living people
Alappuzha district	Districts of Kerala
Ernakulam district	Districts of Kerala
Malappuram district	Districts of Kerala
Idukki district	Districts of Kerala
Reich Chancellor	Lists of prime ministers, Germany-related lists, Reich Chancellors
Thiruvananthapuram district	Districts of Kerala
Kollam district	Districts of Kerala
Kasaragod district	Districts of Kerala
Kannur district	Districts of Kerala
Kottayam district	Districts of Kerala
Pathanamthitta district	Districts of Kerala
Palakkad district	Districts of Kerala
Thrissur district	Districts of Kerala
Wayanad district	Districts of Kerala
North Goa district	Districts of Goa
South Goa district	Districts of Goa
List of states and union territories of India by area	States and territories of India-related lists
List of state and union territory capitals in India	States and territories of India-related lists
Indian states ranked by unemployment	States and territories of India-related lists
Eberhard van der Laan	1955 births, 2017 deaths, Deaths from lung cancer, Dutch councillors, Dutch lawyers, Dutch mayors, Government ministers of the Netherlands, Labour Party (Netherlands) politicians, People from Leiden, Politicians from Amsterdam, Politicians from South Holland
Central Los Angeles	Geography of Los Angeles, California
Alain Bui	Living people, 1969 births, French educators, Presidents of the Université de Versailles Saint-Quentin-en-Yvelines, Versailles Saint-Quentin-en-Yvelines University faculty
Sechs Kies	South Korean boy bands, 1997 establishments in Asia, 1990s establishments in South Korea, 2000 disestablishments, 2016 establishments in South Korea, 2000s disestablishments in Asia, Disestablishments in South Korea
2AM	K-pop music groups
Red Velvet (group)	2010s establishments in South Korea, 2014 establishments in Asia, K-pop music groups, South Korean girl groups
Blackpink	2016 establishments in South Korea, South Korean girl groups, K-pop music groups, Musical quartets
Steve Baker (illusionist)	1938 births, 2017 deaths, American magicians, Comedians from California, People from Oakland, California
Günter Halm	1922 births, 2017 deaths, German military personnel of World War II, SS officers, People from Hanover
Vladimir Voevodsky	Fields Medalists, 1966 births, 2017 deaths, Deaths from aortic aneurysm, Cardiovascular disease deaths in New Jersey, Russian mathematicians, Naturalized citizens of the United States, American mathematicians, Writers from Moscow, Writers from New Jersey
Terry Downes	1936 births, 2017 deaths, British boxers, British movie actors, Sportspeople from London, Actors from London
Toon Geurts	1932 births, 2017 deaths, Dutch Olympic silver medalists, Sportspeople from North Brabant
Ralphie May	1972 births, 2017 deaths, Deaths from myocardial infarction, Deaths from pneumonia, Cardiovascular disease deaths in the United States, American television actors, American movie actors, American television personalities, American voice actors, American comedians, Actors from Tennessee, Actors from Arkansas
John Herrnstein	1938 births, 2017 deaths, Deaths from leukemia, Cancer deaths in Ohio, American football players, Philadelphia Phillies players, Chicago Cubs players, Atlanta Braves players, Sportspeople from Virginia, Sportspeople from Michigan, Sportspeople from Ohio
Jon Huntsman Sr.	1937 births, 2018 deaths, Deaths from prostate cancer, American philanthropists, Businesspeople from Idaho, Businesspeople from Utah, Politicians from Idaho, Politicians from Utah
Rainer Weiss	1932 births, Living people, Astrophysicists, American academics, American astronomers, American Nobel Prize winners, American physicists, Massachusetts Institute of Technology alumni, Naturalized citizens of the United States, Refugees from Nazism, Scientists from Berlin
Barry Barish	1936 births, Living people, American Nobel Prize winners, American physicists, Jewish American academics, Jewish American scientists, Jewish Nobel Prize winners, Scientists from Omaha, Nebraska, California Institute of Technology faculty
Kip Thorne	1940 births, Living people, American academics, American astronomers, American atheists, American Nobel Prize winners, American physicists, Astrophysicists, Scientists from Utah, Princeton University alumni, Theoretical physicists
Daisaku Ikeda	1928 births, Living people, Buddhists, Philosophers, Japanese educators, Writers from Tokyo, Activists, Heads of state, Politicians from Tokyo, Presidents (organizations)
AKMU	2010s music groups, Folk music groups, K-pop music groups, Musical duos, Musical groups established in 2012, Sibling musical duos, South Korean musical groups
Santiago Tequixquiac	Settlements in Mexico (state), 1520s establishments in Mexico, 1522 establishments
Malinalco Municipality	Municipalities of Mexico (state)
Apaxco Municipality	Municipalities of Mexico (state)
Atlacomulco Municipality	Municipalities of Mexico (state)
Lydie Polfer	1952 births, Living people, Former MEPs, Government ministers of Luxembourg, Luxembourgian mayors, People from Luxembourg City
Cantons of the Allier department	Cantons of France
Camille Polfer	1924 births, 1983 deaths, Luxembourgian mayors, Luxembourgian sportspeople, People from Namur, Teachers
Kruth	Communes in Haut-Rhin
Kunheim	Communes in Haut-Rhin
Bronisław Chromy	1925 births, Living people, Polish painters, Polish sculptors, Polish educators
Konstantin Sarsania	1968 births, 2017 deaths, Russian footballers, Russian football managers, Sportspeople from Moscow
Darsi Ferrer Ramírez	1969 births, 2017 deaths, Physicians, Journalists, People from Havana
Howie Mandel	1955 births, Living people, Canadian comedians, Canadian movie actors, Canadian television actors, Canadian voice actors, Canadian television presenters, Actors from Toronto
Louis Walsh	1952 births, Living people, Irish television presenters
Marek Gołąb	1940 births, 2017 deaths, Weightlifters, Polish Olympic medalists, Olympic bronze medalists
Canton of Bellerive-sur-Allier	Cantons of France
National Day of the People's Republic of China	Holidays of the People's Republic of China, National Days
Hollow structural section	Engineering
Structural pipe fitting	Engineering
Arrondissements of the Isère department	Arrondissements of France
Perforated pipe	Engineering
Connie Hawkins	1942 births, 2017 deaths, Phoenix Suns players, Los Angeles Lakers players, Atlanta Hawks players, Sportspeople from New York City, National Basketball Association players with retired numbers
Jim Landis	1934 births, 2017 deaths, Chicago Cubs players, Kansas City Athletics players, Cleveland Indians players, Detroit Tigers players, Houston Astros players, Boston Red Sox players, Sportspeople from California, People from Richmond, California
Harold Bloom	1930 births, 2019 deaths, American educators, American novelists, American historians, American literary critics, Writers from New York City
Geoffrey Chater	Actors from Hertfordshire, 1921 births, Living people, English poets
Charles Harris (photographer)	1908 births, 1998 deaths, American photographers
Inma Cuesta	1980 births, Spanish movie actors, Spanish television actors, Spanish stage actors
Robotboy	Cartoon Network series, English-language television programs, 2005 television series debuts, 2008 television series endings
Vijayanagara architecture	Indian culture, Architecture
Wilhelm Mohnke	German generals of World War II
Aziz Sancar	1946 births, Turkish Nobel Prize winners, Living people, Turkish scientists
Arrondissement of Grenoble	Arrondissements of France, Auvergne-Rhône-Alpes
Washington SyCip	1921 births, 2017 deaths, Deaths from myocardial infarction, Naturalized citizens of the United States, Accountants, American philanthropists, American military personnel of World War II, People from Manila
Slim Chaker	1961 births, 2017 deaths, Deaths from myocardial infarction, Tunisian politicians, Civil servants
Birgitta Ulfsson	1928 births, 2017 deaths, Finnish actors, Swedish movie actors, Swedish television actors, Swedish stage actors, People from Helsinki
Milano Golf Club Le Rovedine	Golf, Sport in Italy, 1976 establishments in Europe, 1970s establishments in Italy
Tiananmen	National symbols, Buildings and structures in Beijing, 1420 establishments, Establishments in China
Abacab	1981 albums
Neustrelitz	Towns in Mecklenburg-Vorpommern
Alan Hawkins (athlete)	1960s births, Living people, Australian athletes, British athletes, People from Geelong, Sportspeople from Victoria (Australia)
Hamish Nelson	1980s births, Living people, People from Geelong, Sportspeople from Victoria (Australia)
Martin Jackson (athlete)	1978 births, Living people, People from Geelong, Sportspeople from Victoria (Australia)
Runcorn	Towns in Cheshire
Dragon Boat Festival	Holidays of the People's Republic of China
Wacław Józef Świerzawski	1927 births, 2017 deaths, Polish Roman Catholics, Roman Catholic bishops
Malans	Malans, Municipalities of Graubünden
Labaroche	Communes in Haut-Rhin
Kadayam	Towns in India, Settlements in Tamil Nadu, Tirunelveli District
Das Kapital	Marxism
Rem Koolhaas	1944 births, Living people, Architects, Dutch academics, Dutch artists, People from Rotterdam, Pritzker Prize winners
Richard Thaler	1945 births, Living people, American economists, American Nobel Prize winners, Jewish American academics, Jewish American scientists, Jewish Nobel Prize winners, People from East Orange, New Jersey, Scientists from New Jersey, University of Rochester alumni
Vettabbia Canal	Canals, Bodies of water of Europe, Geography of Italy
Arrondissement of La Tour-du-Pin	Arrondissements of France, Auvergne-Rhône-Alpes
Sylke Tempel	1963 births, 2017 deaths, German journalists, German novelists, Writers from Berlin
Armando Calderón Sol	1949 births, 2017 deaths, Deaths from lung cancer, Cancer deaths in Texas, Presidents of El Salvador
Savur	Districts of Turkey
Rafe Mair	1931 births, 2017 deaths, Canadian lawyers, Politicians from British Columbia, Canadian radio personalities, Columnists, Political commentators, People from Vancouver, Writers from British Columbia
Arrondissement of Vienne	Arrondissements of France, Auvergne-Rhône-Alpes
Avril Lavigne (album)	2013 albums, Avril Lavigne albums
Atherton, California	Towns in California, Settlements in San Mateo County, California
San Mateo County, California	San Mateo County, California, 1856 establishments in California
Riigikogu	Estonia
Blade Runner 2049	2017 science fiction movies, Warner Bros. movies, American science fiction movies, Movies based on books, Movies directed by Denis Villeneuve, Dystopian movies
Hans Fallada	1893 births, 1947 deaths, Beekeepers, German mayors, German novelists, Politicians from Mecklenburg-Vorpommern
Scriptio continua	Language, Writing systems
Pennant Hills, New South Wales	Geography of New South Wales, Sydney
École nationale supérieure des mines de Paris	Technical colleges and universities in Paris, 1783 establishments, 18th century establishments in France, 1780s establishments in Europe
Wikimedia Bangladesh	Wikimedia, Bangladesh
South Luzon Expressway	Roads in the Philippines
Pulilan	Settlements in the Philippines, 1749 establishments, Establishments in the Philippines
Yamato kotoba	Japanese language
YG Entertainment	South Korean record labels
2PM	K-pop music groups
Cheyenne people	Native American people
Mitchell County, Iowa	1851 establishments in Iowa
List of Provinces of Turkey	Provinces of Turkey, Geography-related lists, Turkey-related lists
Kazys Almenas	1935 births, 2017 deaths, Lithuanian writers, Essayists, Novelists, Physicists
Ole Krarup	1935 births, 2017 deaths, Deaths from pneumonia, Danish academics, Danish politicians, Former MEPs, Aarhus
László Aradszky	1935 births, 2017 deaths, Hungarian entertainers, Pop singers, People from Budapest
Sidhi	Settlements in Madhya Pradesh, Cities in India
Jerry Kleczka	1943 births, 2017 deaths, Deaths from Parkinson's disease, Disease-related deaths in Wisconsin, United States representatives from Wisconsin, Accountants, Politicians from Milwaukee, Wisconsin, US Democratic Party politicians
Gianni Bonagura	1925 births, 2017 deaths, Italian movie actors, Italian television actors, Italian stage actors, Italian voice actors, Radio actors, Actors from Milan
Sociological imagination	Sociology, Theory
Grady Tate	1932 births, 2017 deaths, American drummers, American jazz musicians, American soul musicians, Musicians from North Carolina, Singers from North Carolina, People from Durham, North Carolina
Manuel Busto	1932 births, 2017 deaths, French cyclists
Allan Chumak	1935 births, 2017 deaths, People from Moscow
Fernando de Szyszlo	1925 births, 2017 deaths, Accidental deaths from falls, Peruvian painters, Sculptors, Peruvian educators, People from Lima
Bob Schiller	1918 births, 2017 deaths, American television writers, Writers from San Francisco, Emmy Award winning actors, Deaths from congestive heart failure, Cardiovascular disease deaths in Los Angeles
List of oldest living state leaders	Lists of politicians
Shandong	Provinces of China
Eric Hargan	1968 births, Living people, American lawyers, Politicians from Illinois, US Republican Party politicians
Gabrielle Blunt	1919 births, 2014 deaths, British actors
2016 United States presidential election in Wyoming	History of Wyoming, 2016 United States presidential election by state
List of Bollywood actors	Indian actors, Lists of entertainers, Lists of Indian people
Landser, Haut-Rhin	Communes in Haut-Rhin
Jhajjar	Cities in India, Settlements in Haryana, Cities and towns in Haryana
Lapoutroie	Communes in Haut-Rhin
Largitzen	Communes in Haut-Rhin
Lautenbach, Haut-Rhin	Communes in Haut-Rhin
Lautenbachzell	Communes in Haut-Rhin
Rixheim	Communes in Haut-Rhin
Hamhung	Cities in North Korea
Kirstjen Nielsen	1972 births, Living people, United States Secretaries of Homeland Security, Politicians from Colorado, Politicians from Florida, Politicians from Virginia, People from Colorado Springs, Colorado
Michel Diefenbacher	1947 births, 2017 deaths, French politicians, People from Grand Est
Cho Jin-ho	1973 births, 2017 deaths, Deaths from myocardial infarction, South Korean footballers, South Korean football managers
James R. Ford	1925 births, 2017 deaths, Deaths from Alzheimer's disease, Disease-related deaths in Florida, American educators, American mayors, American activists, Businesspeople from Florida, Politicians from Florida, US Democratic Party politicians
Arrondissements of the Loire department	Arrondissements of France
Andy Hopkins	1949 births, 2017 deaths, Tennessee Titans players, Sportspeople from Texas
IDS Center	Buildings and structures in Minnesota
Liberland	Libertarianism, Croatia, Territorial disputes, Serbia, 2015 establishments in Europe
Paramount Animation	Animation studios, American entertainment companies
The Carolinas	Divided regions, Geography of North Carolina, Geography of South Carolina
Jean-Baptiste Donatien de Vimeur, comte de Rochambeau	French nobility
Palazzo Vigo	Palaces in Italy
Philippe de Nanteuil	Knights, French poets, 13th century deaths
Gairaigo	Japanese language, Words
Tupper Lake (town), New York	Towns in New York, 1844 establishments in the United States, 1840s establishments in New York (state)
Milo of Nanteuil	1230s deaths, French Roman Catholics, Roman Catholic bishops
Doreen Mantle	1926 births, Living people, South African actors, English movie actors, English radio actors, English television actors, People from Cape Town
Margaret Barton	1926 births, Living people, English movie actors, Actors from London
Sue Wallace	English television actors, Living people
Gerard Monaco	Living people, Year of birth missing (living people), Alumni of the Royal Academy of Dramatic Art, British movie actors, British stage actors, British television actors
Harold Goodwin	1917 births, 2004 deaths, English movie actors, English television actors, Alumni of the Royal Academy of Dramatic Art, Actors from Yorkshire
Zoe Cramond	1984 births, Living people, New Zealand actors
Arrondissement of Montbrison	Arrondissements of France, Auvergne-Rhône-Alpes
Amadou-Mahtar M'Bow	1921 births, Living people, Educators, People from Dakar
Federico Mayor Zaragoza	1934 births, Living people, Spanish diplomats, Spanish poets, Spanish scientists, Politicians from Barcelona, Writers from Barcelona
Hessie	1936 births, 2017 deaths, French artists, People from Santiago
Arrondissement of Roanne	Arrondissements of France, Auvergne-Rhône-Alpes
Pentti Holappa	1927 births, 2017 deaths, Deaths from respiratory failure, Poets, Finnish politicians
Stauroteuthis syrtensis	Cephalopods
Arrondissement of Saint-Étienne	Arrondissements of France, Auvergne-Rhône-Alpes
Bencoolen MRT station	Mass Rapid Transit (Singapore) stations
Cross-sex friendship	Emotions, Relationships
Eve Poole	1924 births, 1992 deaths, British military personnel of World War II, Deputy mayors, German Jews, Jewish women politicians, Mayors, New Zealand politicians, Oceanic Jews, People from Dunedin, Refugees from Nazism, Teachers
Sino-Japanese vocabulary	Chinese language, Japanese language
Tomils	2009 establishments in Switzerland, 2015 disestablishments in Switzerland, Former municipalities of Graubünden
Domleschg	2015 establishments in Switzerland, Municipalities of Graubünden
Venkatraman Ramakrishnan	1952 births, Living people, American academics, American biochemists, American Nobel Prize winners, Biophysicists, British academics, British Nobel Prize winners, British scientists, Indian Nobel Prize winners, Naturalised citizens of the United Kingdom, Naturalized citizens of the United States, People from Tamil Nadu
Ei-ichi Negishi	1935 births, 2021 deaths, Japanese chemists, Japanese Nobel Prize winners, University of Tokyo alumni
Ningxia	Autonomous regions of China
Cam Clarke	1957 births, Living people, Actors from Burbank, California, American singers, American voice actors, American movie actors, American television actors, American video game actors
Muntaka Connmassie	1946 births, 2017 deaths, Judges, Nigerian people
Edward B. Giller	1918 births, 2017 deaths, Deaths from pneumonia, People with Alzheimer's disease, Military people from Illinois
Montbrison, Loire	Communes in Loire, Subprefectures in France
Downey Studios	Companies based in California
Pierre Hanon	1936 births, 2017 deaths, Belgian footballers, Sportspeople from Brussels
William Lombardy	1937 births, 2017 deaths, Deaths from myocardial infarction, American chess players, American educators, Writers from New York City
Bo Holmström	1938 births, 2017 deaths, Deaths from gangrene, Swedish journalists, Writers from Stockholm
Anna Lindh	1957 births, 2003 deaths, Assassinated people, Crime victims, Swedish politicians
Satish Chandra	1922 births, 2017 deaths, Indian writers, Indian historians, People from Uttar Pradesh
Billy Green Bush	1935 births, Living people, American movie actors, American television actors, American voice actors, American stage actors, Actors from Montgomery, Alabama
Willi Gerdau	1929 births, 2011 deaths, German footballers, German Olympians, Sportspeople from Schleswig-Holstein
Our Perfect Wedding	Television series
Music of Africa	African culture, Music
President of Liberia	Presidents of Liberia
2017 Liberian general election	2017 elections, Liberia, October 2017 events
Joseph Boakai	1944 births, Living people, Liberian people, African politicians, Vice presidents
Oh Na Na Na	2013 songs, Songs about sexuality, 2015 songs
Handjob	Sexual acts, Sexual slang
Malix	Former municipalities of Graubünden, Villages in Graubünden
Ventilator	Medical procedures
The Killing of a Sacred Deer	2017 horror movies, 2010s horror thriller movies, British thriller movies, British horror movies, Irish movies
Kim Wall	1987 births, 2017 deaths, Swedish journalists, 2017 crimes, Alumni of the London School of Economics, Columbia University alumni, Journalists from New York City, Murder victims
2016 United States presidential election in Maine	History of Maine, 2016 United States presidential election by state
Bandi Chhor Divas	Festivals, Sikhism
Tagus	Rivers of Spain
Automated external defibrillator	Medical equipment, Emergency medicine
Commodity substitution bias	Economics
Tissue paper	Hygiene, Paper
Sasha Clements	1990 births, Living people, Canadian child actors, Canadian movie actors, Canadian television actors, People from Toronto, Actors from Toronto
Lekh Tandon	1929 births, 2017 deaths, Indian movie directors, Indian movie actors, Television directors
Wolfgang Bötsch	1938 births, 2017 deaths, Former members of the German Bundestag, Government ministers of Germany, Politicians from Rhineland-Palatinate, Politicians of the Christian Social Union of Bavaria
Rhins	Rivers of France, Auvergne-Rhône-Alpes
Cinemax	American television channels
Viva Piñata	2006 television series debuts
Harvey Weinstein	1952 births, Living people, American Jews, American people convicted of assault, American rapists, Businesspeople from Connecticut, Criminals from New York City, Democrats (United States), Jewish businesspeople, Movie producers from New York City
Ryan White	1971 births, 1990 deaths, Deaths from AIDS, Disease-related deaths in Indiana, People from Indiana
Dawn Brancheau	1969 births, 2010 deaths, Deaths by drowning, Entertainers from Indiana, Entertainers from Illinois
Paul F. Tompkins	1968 births, Living people, American stand-up comedians, American voice actors, American comedians, American movie actors, American television actors, American video game actors, Actors from Philadelphia, Pennsylvania
The War	2017 albums, Exo albums
Medina, Washington	Cities in Washington (U.S. state)
Mlondi Dlamini	1997 births, 2017 deaths, South African footballers, Road accident deaths
El Ranco Province	Provinces of Chile
Ninozca Vasquez	1992 births, Living people, Venezuelan models
Valdivia Province	Provinces of Chile
Isnilon Hapilon	1966 births, 2017 deaths, Filipino military people, Islamic State people
Sean Hughes	1965 births, 2017 deaths, Deaths from cirrhosis, Deaths from cardiac arrest, Cardiovascular disease deaths in London, Irish movie actors, Irish television actors, Irish comedians, Comedians from London
Daphne Caruana Galizia	1964 births, 2017 deaths, Assassinated people, Maltese writers, Journalists
Bastian Obermayer	1977 births, Living people, German journalists, People from Munich, Pulitzer Prize winners, Writers from Bavaria
Floodplain restoration	Flood control
Abdul Ali Mazari	Hazara politicians, Hazara people
John Dunsworth	1946 births, 2017 deaths, Disease-related deaths in Canada, Canadian movie actors, Canadian television actors, Canadian voice actors, People from Nova Scotia
Phonetic transcription	Pronunciation, Language transcription
Don Pedro Colley	1938 births, 2017 deaths, Deaths from pancreatic cancer, Cancer deaths in the United States, American movie actors, American television actors, American voice actors, Actors from Oregon
Samara Weaving	1992 births, Living people, Australian movie actors, Australian television actors, Australian voice actors, Australian child actors, Australian models, Actors from Adelaide
Almost Heroes	1998 comedy movies, English-language movies, American comedy movies
History of organizational changes in the NHL	National Hockey League
Kingdom of France	History of France
Wamego, Kansas	Cities in Pottawatomie County, Kansas, 1866 establishments in Kansas
Aylesford railway station	Railway stations in England, Kent, 1856 establishments in Europe, 1850s establishments in England
Schnaus	Former municipalities of Graubünden
Modernist music	Musical movements
Palm Islands	Dubai
Dine and dash	Theft, Deception
Aylesford, Kent	Villages in Kent
Particularly Dangerous Situation	Meteorology
Panama Papers	History of Panama, 2016
Mychael Knight	1979 births, 2017 deaths, American fashion designers, American television personalities, People from Nuremberg
Ricardo Vidal	1931 births, 2017 deaths, Cardinals of the Roman Catholic Church, Deaths from sepsis, Filipino educators, Filipino Roman Catholics, Roman Catholic archbishops
Winnie Chlomin Lee	American fashion designers, 1977 births
I'm on Fire	2013 albums, Mixtape albums, Hip hop albums, Pop albums
Maidstone Barracks railway station	Railway stations in England, Kent
Mauser 1918 T-Gewehr	Rifles
MIMO	Computer networking
Issam Zahreddine	1961 births, 2017 deaths, Assassinated people, Military people, Syrian people
Beverly Reid O'Connell	1965 births, 2017 deaths, Deaths from intracranial aneurysm, American judges, Politicians from California, Women judges
Kowalczyk brothers	1937 births, 2017 deaths, 1942 births, Living people, Activists, Polish educators, People from Warsaw
Yeoh Tiong Lay	1929 births, 2017 deaths, Deaths from myocardial infarction, Malaysian businesspeople
Cannabidiol	Cannabis, Organic compounds, Pharmacology
Eamonn Campbell	1946 births, 2017 deaths, Deaths from heart failure, Irish guitarists, Musicians from Dublin
Ingvar Lidholm	1921 births, 2017 deaths, Swedish writers, Composers
Building design	Architecture
Yongle Emperor	1360 births, 1424 deaths, Emperors and Empresses of China
Mountain weasel	IUCN Red List near threatened species, Mammals of Pakistan
Yoweri Museveni	1944 births, Living people, Anti-LGBT rights activists, Commonwealth Chairpersons-in-Office, Current national leaders, Evangelicals, Presidents of Uganda
Instaknow Software	Software
History of genetic engineering	Genetic engineering
Trevor Noah	Comedy Central personalities
Arrondissements of the Puy-de-Dôme department	Arrondissements of France
Hurricane Ophelia	2017 in Europe, Hurricanes, October 2017 events, 2017 in weather
Arrondissement of Ambert	Arrondissements of France, Auvergne-Rhône-Alpes
Arrondissement of Clermont-Ferrand	Arrondissements of France, Auvergne-Rhône-Alpes
Miguel Ángel Loayza	1940 births, 2017 deaths, Peruvian footballers, People from Buenos Aires
Umberto Lenzi	1931 births, 2017 deaths, Italian movie directors, Italian screenwriters
Venantino Venantini	1930 births, 2018 deaths, Deaths from surgical complications, Italian movie actors
Sebastian Kurz	1986 births, Living people, Chancellors of Austria, Current national leaders, Government ministers of Austria, Politicians from Vienna
Gastrodon	Pokémon monsters
The Little Red Hen	Fables
British cuisine	British food
Networking hardware	Computer hardware, Computer networking
Artemisia annua	Plants of Asia
Next of kin	Law
Letter case	Alphabet, Typography
2016 United States presidential election in Hawaii	21st century in Hawaii, 2016 United States presidential election by state
October 2017 Northern California wildfires	2017 California wildfires, October 2017 events
Everyday Is Christmas	2017 albums
2017–18 NHL season	2017 in North America, 2018 in North America, National Hockey League seasons
Arrondissement of Issoire	Arrondissements of France, Auvergne-Rhône-Alpes
Oakland firestorm of 1991	Fires in the United States, 1991 in California, Natural disasters in the San Francisco Bay Area
2018 FIFA World Cup qualification (UEFA)	2018 FIFA World Cup qualification (UEFA)
Brent Briscoe	1961 births, 2017 deaths, Accidental deaths from falls in the United States, American movie actors, American television actors, American television writers, American screenwriters, Actors from Missouri, Writers from Missouri
Zapolyarny, Murmansk Oblast	Towns in Russia
People's Party (United States)	Political parties in the United States, 1891 establishments in the United States, 1908 disestablishments, 1900s disestablishments in the United States
People's Party (United States, 1971)	Political parties in the United States, Unknown disestablishments
2018 FIFA World Cup qualification (CONMEBOL)	2018 FIFA World Cup qualification
Eva Todor	1919 births, 2017 deaths, Deaths from pneumonia, People with Alzheimer's disease, People with Parkinson's disease, Brazilian movie actors, Brazilian television actors, Actors from Budapest
Isabella Karle	1921 births, 2017 deaths, Deaths from brain cancer, Cancer deaths in Virginia, Scientists from Detroit, Michigan
Jerome Karle	1918 births, 2013 deaths, Deaths from liver cancer, Cancer deaths in Virginia, American chemists, Jewish American scientists, Scientists from New York City
Greer Grammer	Actors from Los Angeles, California, American movie actors, American television actors, 1992 births, Living people
Women's History Month	March events, Women, History
Garbage collection (computer science)	Computer science
Richard Arvin Overton	1906 births, 2018 deaths, Deaths from pneumonia, African-American supercentenarians, American military personnel of World War II, Disease-related deaths in Texas, Infectious disease deaths in the United States, Military people from Texas
Gavin McInnes	1970 births, Living people, English television personalities
Tityos	Greek legendary creatures
Arrondissement of Thiers	Arrondissements of France, Auvergne-Rhône-Alpes
Michael Hardie Boys	1931 births, Living people, Governors General of New Zealand
Lech Ordon	1928 births, 2017 deaths, Deaths from pneumonia, Deaths from stroke, Disease-related deaths in Poland, Polish movie actors, Polish television actors, Polish stage actors, People from Poznań
People's Summit	Chicago, Illinois, Bernie Sanders
Bernie Sanders Guide to Political Revolution	Bernie Sanders, Non-fiction books
Francis W. Nye	1918 births, 2019 deaths, American centenarians, American military personnel of World War II, American military personnel of the Korean War, People from Vermont, People from Albuquerque, New Mexico
Jeanne Manet	1917 births, 2012 deaths, French movie actors
Doris Grumbach	1918 births, Living people, American novelists, American educators, LGBT writers, American literary critics, American essayists, Lesbians, LGBT people from New York City, Writers from New York City
Indumati Bhattacharya	1918 births, Living people, Indian politicians
Saint Xavier University	1846 establishments in the United States, Colleges and universities in Chicago, 1840s establishments in Illinois
Judith McGrath	1947 births, 2017 deaths, Deaths from aortic aneurysm, Cardiovascular disease deaths in Australia, Australian movie actors, Australian television actors, Australian stage actors, People from Brisbane, Actors from Queensland
Emilio D'Amore	1914 births, 2017 deaths, Deaths from congestive heart failure, Cardiovascular disease deaths in Italy, Italian politicians, Italian centenarians
NYC Health + Hospitals/Bellevue	Hospitals in the United States, Buildings and structures in Manhattan
Maidstone West railway station	Railway stations in England, Kent
Hastein	Danish people, 9th century births, 9th century deaths
Arrondissement of Riom	Arrondissements of France, Auvergne-Rhône-Alpes
Rosemary Leach	1935 births, 2017 deaths, English movie actors, English television actors, English stage actors
Martin Eric Ain	1967 births, 2017 deaths, Deaths from myocardial infarction, American bass guitarists, American songwriters, Swiss musicians
Julian May	1931 births, 2017 deaths, American science fiction writers, American children's writers, American novelists, Writers from Chicago
Mercer Island, Washington	Cities in Washington (U.S. state), Islands of the United States
Andrej Babiš	1954 births, Living people, Prime Ministers of the Czech Republic, Czech businesspeople, Current national leaders
George Saunders	1958 births, Living people, American novelists, American children's writers, American journalists, American educators, American essayists, Writers from Texas, Writers from Chicago
Kübler-Ross model	Psychology, Death
Japanophile	Japanese culture
Area code 710	Area codes, Government of the United States
List of Mesopotamian deities	Lists of gods and goddesses
Stan Kowalski	1926 births, 2017 deaths, Deaths from Alzheimer's disease, Disease-related deaths in Minnesota, American wrestlers, Sportspeople from Minneapolis, Minnesota
Dick Beyer	1930 births, 2019 deaths, American wrestlers, American educators, Sportspeople from New York City
Pampero Firpo	1930 births, 2020 deaths, Naturalized citizens of the United States, American wrestlers, People from Buenos Aires
Bill Mercer	1926 births, Living people, American educators, Writers from Oklahoma, Sportspeople from Oklahoma
Railbus	Trains
M1917 Browning machine gun	Heavy machine guns
Spanish Golden Age	History of Spain
Hugo van der Goes	Belgian painters, 1430s births, 1482 deaths
Parenthesome	Cell biology
Changqing Subdistrict	Subdivisions of China
A Different World	American comedy television series, 1980s American black sitcoms, 1987 American television series debuts, 1990s American television series endings, 1993 television series endings, English-language television programs
Anya Taylor-Joy	1996 births, Living people, Actors from Florida
Jeanne Brousse	1921 births, 2017 deaths, French people, World War II people
Walter Lassally	Academy Award winners, 1926 births, 2017 deaths, Deaths from surgical complications, British cinematographers, Greek people, People from Berlin
George Young (rock musician)	1946 births, 2017 deaths, Australian rock musicians, Australian guitarists, Bass guitarists, Australian pianists, Australian songwriters, Writers from Sydney, Musicians from Sydney, Musicians from Glasgow
Al Hurricane	1936 births, 2017 deaths, Deaths from prostate cancer, American singer-songwriters, American saxophonists, American rock guitarists, American pianists, American country guitarists, American country singers, American rock singers, Singers from New Mexico, Writers from New Mexico, Musicians from New Mexico
Jasmine Guy	1962 births, American television actors, American stage actors, American movie actors, Actors from Boston, Massachusetts, Actors from Atlanta, Georgia, Living people
Tony Richardson	Academy Award winning directors, BAFTA Award winning directors, 1928 births, 1991 deaths, Deaths from AIDS, Disease-related deaths in California, English movie directors, English movie producers, Bisexual people, English LGBT people, People from Yorkshire
Al-Qaryatayn massacre	War crimes
Dennis Skinner	1932 births, Living people, Former Labour MPs (UK), UK MPs 1970–1974, UK MPs 1974, UK MPs 1974–1979, UK MPs 1979–1983, UK MPs 1983–1987, UK MPs 1987–1992, UK MPs 1992–1997, UK MPs 1997–2001, UK MPs 2001–2005, UK MPs 2005–2010, UK MPs 2010–2015, UK MPs 2015–2017, UK MPs 2017–2019
Melissa Benoist	1988 births, Living people, Actors from Houston, Texas, American movie actors, American television actors
Paul J. Weitz	1932 births, 2017 deaths, American astronauts, American aviators, American engineers, Cancer deaths in Arizona, Deaths from myelodysplastic syndrome, Scientists from Pennsylvania
Guion Bluford	1942 births, Living people, American astronauts, American aviators, Engineers from Pennsylvania, American military people, Scientists from Philadelphia, Pennsylvania
Dhanteras	Indian culture, Hinduism, Religious holidays, Nepali culture
Grottaglie	Towns in Italy, Settlements in Apulia
Muthal Mariyathai	Tamil-language movies
Madhan Bob	Tamil actors, Tamil comedians
T. S. Balaiah	Tamil actors
M. R. Radha	1907 births, 1979 deaths, Deaths from jaundice, Tamil actors, Indian movie actors, Tamil comedians
The New Mutants (movie)	American horror movies, American LGBT movies, Movies produced by Lauren Shuler Donner, Movies produced by Simon Kinberg, X-Men (movie series), 2020 horror movies, 2020s superhero movies, Superhero horror movies
Wilhelm Ostwald	1853 births, 1932 deaths, Esperantists, German academics, German chemists, German Nobel Prize winners, Latvian scientists, People from Riga, Russian Nobel Prize winners
Singer 2018	Chinese music, 2018 in television
Ugo Fangareggi	1938 births, 2017 deaths, People from Genoa, Italian stage actors, Italian movie actors, Italian television actors, Deaths from Parkinson's disease
ESPCI Paris	Technical colleges and universities in Paris, 1882 establishments in France
Mustafa Adrisi	1922 births, 2013 deaths
Ambert	Communes in Puy-de-Dôme, Subprefectures in France
Topaz Solar Farm	Energy in California, Solar power
I. V. Sasi	1948 births, 2017 deaths, Deaths from myocardial infarction, Indian movie directors
Girija Devi	1929 births, 2017 deaths, Deaths from cardiac arrest, Indian singers
Glenn Barr	1942 births, 2017 deaths, Irish politicians, Political activists
Ebrahim Ashtiani	1942 births, 2017 deaths, Deaths from cardiovascular disease, Sportspeople from Tehran, Iranian footballers, Olympians
Agave deserti	Agavaceae
Robert Campin	Belgian painters, 1370s births, 1444 deaths
IPhone SE (1st generation)	IPhone, Mobile phones released in 2016
Leviathan (book)	17th century books, Non-fiction books
La Noche Triste	Battles, 1520, Aztec, 16th century in Spain, History of Mexico
Shedinja	Pokémon monsters
Additional Member System	Voting systems
Port Blair	Andaman and Nicobar Islands
Cellular Jail	Andaman and Nicobar Islands
Ross Island, South Andaman district	Andaman and Nicobar Islands
Amaravati	Settlements in Andhra Pradesh, Cities in India, 2015 establishments in India
Naya Raipur	Chhattisgarh
Shaheed Veer Narayan Singh International Cricket Stadium	Chhattisgarh
Famous places in Shanghai	Buildings and structures in Shanghai
Muhammad Qudrat-i-Khuda	1900 births, 1977 deaths, Bangladeshi people, Chemists, Recipients of the Ekushey Padak, Bangladeshi Muslims, Recipients of the Independence Day Award
Against All Odds (Take a Look at Me Now)	1984 songs, Pop songs, Phil Collins
Lauw	Communes in Haut-Rhin
Misenum	Naples
Inga Borg	1925 births, 2017 deaths, Cartoonists, Swedish artists, Swedish children's writers, Writers from Stockholm
Albaston	Hamlets in Cornwall
Contribution claim	Law
Marcus Terentius Varro Lucullus	Roman people, Roman generals
Lu Guanqiu	1945 births, 2017 deaths, People from Hangzhou, Billionaires, Chinese businesspeople
Vilnis Edvīns Bresis	1938 births, 2017 deaths, Deaths from pulmonary edema, Latvian politicians
Cheri Bustos	1961 births, Living people, United States representatives from Illinois, Journalists from Illinois, Writers from Springfield, Illinois, Politicians from Springfield, Illinois, US Democratic Party politicians
Billy the Puppet	Fictional characters introduced in 2003, Fictional murderers, Movie characters, Saw (franchise)
David A. Kessler	1951 births, Living people, Commissioners of the Food and Drug Administration, American lawyers, Writers from New York City
Donald Kennedy	1931 births, 2020 deaths, Deaths from the COVID-19 pandemic in the United States, Commissioners of the Food and Drug Administration, American educators, Journalists from New York City, Scientists from New York City
Icelandic horse	Horse breeds, Iceland
Lierna	Lake Como, Settlements in Lombardy
List of places in Cornwall	Cornwall
Team Fortress Classic	1999 video games
Asiago	Towns in Italy, Settlements in Veneto
Miitopia	2016 video games, Nintendo video games, Role-playing video games, Video games developed in Japan, Nintendo 3DS games, Nintendo Switch games
Allusion	Figures of speech, English language
Marmorera	Former municipalities of Graubünden
Kahlil Gibran	1883 births, 1931 deaths, American novelists, American painters, American philosophers, American poets, American sculptors, Christian mystics, Christian writers, Deaths from cirrhosis, Deaths from tuberculosis, Humanists, Infectious disease deaths in New York, Lebanese poets, Lebanese Christians, Ottoman people
Anatoliy Solovianenko	1932 births, 1999 deaths, Tenors, European opera singers
Privacy	Everyday life, Law
Emmy Noether	1882 births, 1935 deaths, German mathematicians
Parenting	Childhood
Tritiated water	Chemicals, Water
Ywain the Bastard	Arthurian legend, Fictional knights
Amalebra	Hamlets in Cornwall
Gualtiero Galmanini	Italian architects, 1909 births, 1978 deaths
Antony Passage	Hamlets in Cornwall
Tekeda Alemu	Living people, 1951 births, Ethiopian people, Ambassadors to the United Nations, International relations
Chusquea albilanata	Bamboo species
Dore (river)	Rivers of France, Auvergne-Rhône-Alpes
Helen DeVos	1927 births, 2017 deaths, American philanthropists, American Protestants, Cancer deaths in Michigan, Cardiovascular disease deaths in the United States, Deaths from leukemia, Deaths from stroke, Businesspeople from Grand Rapids, Michigan, Richard DeVos
Jack Bannon	1940 births, 2017 deaths, American movie actors, American television actors, American stage actors, Actors from Idaho, Actors from Los Angeles, California
Aggron	Fictional dinosaurs, Pokémon monsters
Bambusa basihirsutoides	Bamboo species, China
Villarrica (volcano)	Volcanoes of Chile
Villarrica, Chile	Cities in Chile, 1550s establishments in South America, 16th-century establishments in Chile, 1552 establishments
Pinito del Oro	1930 births, 2017 deaths, Deaths from stroke, Spanish novelists, Spanish entertainers
Ronald Breslow	1931 births, 2017 deaths, Deaths from pancreatic cancer, Cancer deaths in New York City, American chemists, American educators, Scientists from New Jersey, Writers from New Jersey
Stephen Toulouse	1972 births, 2017 deaths, Engineers from Washington (state), Microsoft people
Punathil Kunjabdulla	1940 births, 2017 deaths, Deaths from bladder cancer, Indian poets, Physicians, Novelists
Gordon Moore	1929 births, Living people, American philanthropists, American billionaires, American inventors, Engineers from California, American computer scientists, American chemists, American educators, Scientists from San Francisco, Writers from San Francisco, Businesspeople from San Francisco
Din Tai Fung	1972 establishments in Asia, Asian restaurants, 20th century establishments in Taiwan
Central Cornwall	Geography of Cornwall
Carrick	Cornwall, Local government in England
Carrick District Council	Local government in England, Government of Cornwall, 2009 disestablishments in England
Cornwall Council	Government of Cornwall, 2009 establishments in England
District council	District and borough councils in England
Ouch, Lower Dir	Towns in Pakistan
Timergara	Lower Dir District
Pakistan National Assembly	Government of Pakistan
Muttahida Majlis-e-Amal	Politics of Pakistan
Qazi Hussain Ahmad	Pakistani people, Pakistani politicians
Constituency NA-34	Khyber Pakhtunkhwa
Constituency PK-97 (Lower Dir-IV)	Pakistan
Constituency PK-96 (Lower Dir-III)	Pakistan
Constituency PK-95 (Lower Dir-II)	Pakistan
Constituency PK-94 (Lower Dir-I)	Khyber Pakhtunkhwa
Sivaji Ganesan filmography	Indian filmographies
Vadivelu filmography	Indian filmographies
Rajinikanth filmography	Indian filmographies
Vijay filmography	Indian filmographies
Vivek filmography	Indian filmographies
Vijayakanth filmography	Indian filmographies
Kamal Haasan filmography	Indian filmographies
Manivannan filmography	Indian filmographies
Sino-Korean vocabulary	Vocabulary, Writing systems, Korean culture, Chinese language
Council of the Isles of Scilly	Isles of Scilly, Government of Cornwall
Henry Jenner	People from Cornwall, 1848 births, 1934 deaths
Callington, Cornwall	Towns in Cornwall, Civil parishes in Cornwall, Market towns in England
Mebyon Kernow	Politics of Cornwall, Political parties in the United Kingdom, 1951 establishments in the United Kingdom, 1950s establishments in England
Masein	Municipalities of Graubünden
Mountain gorilla	Apes, Mammals of Africa
P-value	Statistics
George Kingsley Zipf	Scientists from Illinois, 1902 births, 1950 deaths, Harvard University alumni
List of Pixar movies	Pixar, Lists of movies
Cornish Assembly	Politics of Cornwall
Civil parishes in Cornwall	Cornwall, Lists of civil parishes in England
Frank Darabont	1959 births, Living people, Hungarian people, American filmmakers, People from Bourgogne-Franche-Comté
Daylight (Maroon 5 song)	Maroon 5 songs, 2012 songs
Teddybears	Alternative rock bands, Swedish rock music groups, Punk bands
Wrinkle (skin)	Skin
Sticker	Stationery, Collecting
Nuclear weapons states	Nuclear weapons, Cold War
Gemini Ganesan filmography	Indian filmographies
Jayalalithaa filmography	Indian filmographies
Gilbert Stork	1921 births, 2017 deaths, American chemists, People from Brussels
Atle Hammer	1932 births, 2017 deaths, Engineers, Jazz musicians, Trumpeters, Musicians from Oslo
Ian Cathie	1932 births, 2017 deaths, Politicians from Melbourne
Ali Ashraf Darvishian	1941 births, 2017 deaths, Deaths from respiratory failure, Activists, Iranian educators, Iranian writers
Arnett E. Girardeau	1929 births, 2017 deaths, Deaths from myocardial infarction, Cardiovascular disease deaths in Florida, American civil rights activists, African American politicians, Politicians from Jacksonville, Florida, US Democratic Party politicians
Shea Norman	1971 births, 2017 deaths, Deaths from diabetes, African-American singers, American singer-songwriters, American gospel musicians, American Christians, Musicians from Memphis, Tennessee, Singers from Memphis, Tennessee, Writers from Tennessee, Musicians from Alabama, Singers from Alabama, Writers from Alabama, People from Sheffield, Alabama
Nelly Olin	1941 births, 2017 deaths, Deaths from breast cancer, Cancer deaths in France, French politicians
Zermelo–Fraenkel set theory	Set theory
Disjoint sets	Set theory
Power set	Set theory, Algebra
Second Anglo-Mysore War	Wars involving England, Wars involving France, Wars involving India, 1780s, 18th century in Asia, 18th century in the Kingdom of Great Britain
Olorotitan	Dinosaurs
Abdul Taleb Zaki	Hazara politicians, Hazara people, 1960 births, 1998 deaths
Leimbach, Haut-Rhin	Communes in Haut-Rhin
M. S. Viswanathan	1928 births, 2015 deaths, Deaths from respiratory failure, Indian singers, Composers, Tamil musicians, Tamil singers
Mohamed Abshir Muse	1926 births, 2017 deaths, Military people
Manfredi Nicoletti	1930 births, 2017 deaths, Italian architects
Manuel Sanchís Martínez	1938 births, 2017 deaths, Deaths from pulmonary embolism, Spanish footballers, Sportspeople from Madrid
Pasty	Baked foods, Cornwall
Fort Provintia	Forts, History of Taiwan, 1653 establishments, 17th century establishments in Asia
AFC East	National Football League
Stranger Things	2016 establishments in the United States, 2010s American drama television series, 2010s mystery television series, 2010s science fiction television series, American horror television series, American mystery television series, American science fiction television series, Indiana in fiction, Period television series, Works set in the 1980s, 2016 television series debuts, Netflix original shows, English-language television programs
Mark of Cornwall	People from Cornwall, Kings and queens
National Congress of Brazil	Parliaments, Government of Brazil, 1825 establishments in South America, 19th-century establishments in Brazil
Subrahmanyan Chandrasekhar	1910 births, 1995 deaths, Indian scientists, Indian Nobel Prize winners
Trippie Redd	1999 births, Living people, Pop artists
Ming Chang	1932 births, 2017 deaths, Deaths from Parkinson's disease, Disease-related deaths in Virginia, Naturalized citizens of the United States, Military people from Virginia, People from Shanghai
Władysław Kowalski	1936 births, 2017 deaths, Deaths from myocardial infarction, Polish movie actors, Polish television actors
Gert Timmerman	1935 births, 2017 deaths, Baritones, Bassists, Clarinetists, Converts to Christianity, Deaths from pancreatic cancer, Dutch musicians, Dutch Protestants, Dutch singers, Keyboardists, People from Overijssel, Saxophonists
List of comuni of the Province of Chieti	Settlements in Abruzzo, Lists of settlements in Europe
Queue (unit)	Units of volume
John Saxon	1936 births, 2020 deaths, Deaths from pneumonia, American movie actors, American television actors, American martial artists, Actors from New York City
Lil Uzi Vert	1995 births, Living people, African-American rappers, American hip hop musicians, American rap musicians from Pennsylvania, Musicians from Philadelphia, Pennsylvania, Singers from Philadelphia, Pennsylvania, Trap musicians
Philippe, Chevalier de Lorraine	LGBT people, 1643 births, 1702 deaths, Noblemen from France
TD Ameritrade	Finance, American financial companies, 1971 establishments in the United States, 20th-century establishments in Nebraska
Mutual of Omaha	20th-century establishments in Nebraska, 1909 establishments in the United States, Insurance companies, Companies of the United States, Omaha, Nebraska
Mutual insurance	Insurance
Lil Yachty	Living people, African-American singers, American rap musicians from Georgia, African-American rappers, 1997 births, Twitch (service) streamers
Fortune 500	Economy of the United States, 1955 establishments in the United States
Fortune (magazine)	American magazines, 1929 establishments in the United States, 1920s establishments in New York (state), Magazines published in New York City
Seismic wave	Mechanics
Tony Madigan	1930 births, 2017 deaths, Deaths from pneumonia, Disease-related deaths in France, Australian rugby league players, Australian boxers, Australian Olympic medalists, Sportspeople from Sydney
Denise P. Barlow	1950 births, 2017 deaths, Deaths from pancreatic cancer, Cancer deaths in Austria, English geneticists, People from Yorkshire
Hossein Rajabian	1984 births, Living people, People from Tehran, Filmmakers, Iranian screenwriters, Iranian movie directors, Photographers
Anarcho-primitivism	Political movements
United States presidential elections in Hawaii	History of Hawaii, United States presidential elections
2021 FIFA Confederations Cup	Football in Qatar, FIFA Confederations Cup
La zona	Police television series
Vadivelu	Tamil actors, Tamil singers, Living people, Tamil comedians
Ilaiyaraaja	Tamil musicians, Tamil singers
Yuvan Shankar Raja	Tamil musicians, Tamil singers, Bollywood playback singers
National deep fried clams day	Holidays
Arthrostylidium schomburgkii	Bamboo species
Arthrostylidium judziewiczii	Bamboo species
Pontresina	Municipalities of Graubünden
+ (album)	2011 albums, Acoustic pop albums, Folk albums, Hip hop albums
Erie County, New York	New York (state) counties
Shimmer and Shine	American children's television series, Canadian children's television series, English-language television programs
Katalin Szőke	1935 births, 2017 deaths, Hungarian sportspeople, Hungarian swimmers, Olympic gold medalists, People from Brussels
Josaphat-Robert Large	1942 births, 2017 deaths, Cancer deaths in New York City, Naturalized citizens of the United States, Haitian people, American novelists, American poets, American educators, American art critics
Dennis Banks	1937 births, 2017 deaths, Deaths from pneumonia, Disease-related deaths in Minnesota, American movie actors, American activists, American educators, 2016 United States vice-presidential candidates, Politicians from Minnesota, Writers from Minnesota, Actors from Minnesota
Linda Nochlin	1931 births, 2017 deaths, American historians, American feminists, American educators, American essayists, American critics, Writers from New York City
Kim Joo-hyuk	1972 births, 2017 deaths, Road accident deaths, South Korean actors, South Korean movie actors, South Korean television actors, People from Seoul
James D. Martin	1918 births, 2017 deaths, Businesspeople from Alabama, Deaths from congestive heart failure, United States representatives from Alabama, US Republican Party politicians
Melanmai Ponnusamy	1951 births, 2017 deaths, Deaths from myocardial infarction, Indian writers, Communists, Indian journalists
Daniel Te'o-Nesheim	1987 births, 2017 deaths, Samoan people, Philadelphia Eagles players, American football defensive ends, Tampa Bay Buccaneers players
Aterno-Pescara	Rivers of Italy
Delphine Gibson	1903 births, 2018 deaths, American supercentenarians, People from South Carolina, People from Pennsylvania
Jean Daniel	1920 births, Living people, African Jews, French journalists, Jewish French writers
Parasakthi (movie)	Tamil-language movies
Goliath frog	Frogs, Animals of Africa
Boomerang (Central and Eastern Europe)	Cartoon Network, 2005 establishments in Europe
Artturi Ilmari Virtanen	1895 births, 1973 deaths, Academics, Biochemists, Finnish Nobel Prize winners, Finnish scientists, People from Helsinki
Spider-tailed horned viper	Vipers
Polo Hofer	1945 births, 2017 deaths, Swiss musicians
Dieter Kurrat	1942 births, 2017 deaths, German footballers, German football managers, Sportspeople from North Rhine-Westphalia, People from Dortmund
List of former municipalities of Switzerland	Former municipalities of Switzerland
Siat	Former municipalities of Graubünden
Gert and Hermien	Dutch singers, Musical duos, People from Overijssel
Vincent de Paul	1581 births, 1660 deaths
A. R. Rahman	Tamil singers, Tamil musicians, Living people, Bollywood playback singers
Queue (abstract data type)	Data structures
Flag Day (United Arab Emirates)	National Days
Deva (composer)	Tamil musicians, Living people, 1950 births, Tamil singers, Composers
Gangai Amaran	Tamil musicians, Tamil singers, 1947 births, Tamil directors, Living people
Prince Andrew of Greece and Denmark	Greek people, Danish royalty, Princes and princesses, 1882 births, 1944 deaths
Szlachcic	Nobility
Audi Q7	Audi automobiles, Sport utility vehicles, 2000s automobiles, 2010s automobiles
Eugène Parlier	1930 births, 2017 deaths, Swiss footballers, 1954 FIFA World Cup players
Jotaro Kujo	Manga, Fictional characters, Anime characters
Poschiavo	Municipalities of Graubünden
Knights Hospitaller	Middle Ages, Orders of knighthood
Ahmed Boukouss	Living people, 1946 births, Moroccan scientists, Linguists, Sociologists, Moroccan writers
Deaths in November 2017	2017 deaths, November 2017 events
2017 Lower Manhattan attack	2017 murders in the United States, 2010s in New York (state), 21st century in Manhattan, Islamic terrorist incidents in the United States, Islamic State, Mass murder in 2017, Mass murder in New York, Massacres in the United States, October 2017 events
Milo Yiannopoulos	British journalists
S. A. Chandrasekhar	Tamil directors
K. Balachander filmography	Indian filmographies
Buddhist texts	Buddhist texts
Grand Traverse County, Michigan	Michigan counties, 1851 establishments in Michigan
Password policy	Computer security
Shivalinga (2017 movie)	Tamil-language movies
Maroon (people)	Ethnic groups in North America, Ethnic groups in South America
Raghava Lawrence	Tamil actors, Tamil singers, Tamil directors
Sri Lankan Tamils	Tamil people
Muni (movie)	Tamil-language movies
Microsoft 4Afrika	Microsoft
Ghulam Ali Wahdat	Hazara politicians, Hazara people
Angloposeidon	Dinosaurs of Europe
Qasim Akhgar	Hazara people
Fano	Cities in Marche
Francia	Former countries in Europe, 5th century establishments in Europe, 481 establishments
Strange matter	States of matter
Vladimir Makanin	1937 births, 2017 deaths, Russian novelists, Short story writers
Yisrael Rosen	1941 births, 2017 deaths, Chief Rabbinate of Israel, Deaths from pancreatic cancer, Israeli journalists, Israeli judges, Israeli rabbis, Jewish Israeli writers, Jewish judges, People from Tel Aviv
María Martha Serra Lima	1944 births, 2017 deaths, Argentine singers, People from Buenos Aires
Dina Wadia	1919 births, 2017 deaths, Deaths from pneumonia, Disease-related deaths in New York City, Indian politicians, Civil servants, Politicians from London
Richard E. Cavazos	1929 births, 2017 deaths, Deaths from Alzheimer's disease, Disease-related deaths in Texas, American military personnel of the Vietnam War, American military personnel of the Korean War, Military people from Texas
Fred Beckey	1923 births, 2017 deaths, Mountain climbers, Writers from Seattle, Washington
Daniel Viglietti	1939 births, 2017 deaths, Folk singers, Folk musicians, Guitarists, Political activists, People from Montevideo
Abbas Zandi	1930 births, 2017 deaths, Olympians, Wrestlers, People from Tehran
Mario das Neves	1951 births, 2017 deaths, Deaths from cardiopulmonary arrest, Argentine politicians, People from Buenos Aires
Papi Oviedo	1938 births, 2017 deaths, Deaths from lung cancer, Cuban musicians
Aboubacar Somparé	1944 births, 2017 deaths, Presidents of Guinea
Jigsaw (Saw character)	Fictional American people, Fictional characters introduced in 2004, Fictional murderers, Movie characters, Saw (franchise)
Vinu Chakravarthy	Tamil actors, Tamil directors, 1945 births, 2017 deaths
Moza bint Nasser	Living people, 1959 births, Qatar Foundation people
Tamim bin Hamad Al Thani	1980 births, Qatari people, Current national leaders, Living people
Reborrowing	Linguistics
Peter MacGregor-Scott	1947 births, 2017 deaths, American movie producers, Road accident deaths in New York
Third Rutte cabinet	Cabinets of the Netherlands, 2017 establishments in the Netherlands
Vernier	Cities in Switzerland, Municipalities of Geneva
Chair of the Federal Reserve	Chairs of the Federal Reserve
Minnesota State University, Mankato	Colleges and universities in Minnesota, Western Collegiate Hockey Association, 1868 establishments in the United States, 19th-century establishments in Minnesota
Jerome Powell	1953 births, Living people, American lawyers, Chairs of the Federal Reserve, Politicians from Washington, D.C., Businesspeople from Washington, D.C., US Republican Party politicians
Brad Bufanda	1983 births, 2017 deaths, Actors from San Bernardino, California, Actors who committed suicide, American movie actors, American television actors, Suicides by jumping in the United States
Václav Riedlbauch	1947 births, 2017 deaths, Deaths from COPD, Czech academics, Czech composers, Czech politicians
Hussain Muhammad Ershad	1930 births, 2019 deaths, Deaths from myelodysplastic syndrome, Presidents of Bangladesh, Bangladeshi Muslims
Shahabuddin Ahmed	1930 births, Living people, Presidents of Bangladesh, Bangladeshi Muslims
Muhammad Jamiruddin Sircar	1931 births, Living people, Presidents of Bangladesh, Bangladeshi Muslims
Gyalo Thondup	1928 births, Living people, Tibetan people, Prime ministers
Frederica Wilson	1942 births, Living people, United States representatives from Florida, Politicians from Miami, Florida, US Democratic Party politicians
A. Q. M. Badruddoza Chowdhury	1932 births, Living people, Presidents of Bangladesh, Bangladeshi Muslims, Physicians, Activists, Essayists, Bangladeshi playwrights, Television presenters
Renzo Calegari	1933 births, 2017 deaths, Deaths from stroke, Italian comics artists, Illustrators, Cartoonists, People from Genoa
William Deane	1931 births, Living people, Australian Governors-General, Australian judges, Politicians from Melbourne
Bill Hayden	1933 births, Living people, Australian Governors-General, Australian judges, Leaders of the Opposition (Australia), Politicians from Brisbane
John K. Singlaub	1921 births, Living people, American autobiographers, Anti-Communists, American military personnel of World War II, American military personnel of the Korean War, American military personnel of the Vietnam War, Military people from California, Writers from California
Aminoglycoside	Antibiotics
Normandy landings	Invasions of World War II, June 1944 events
Joel Kinnaman	1979 births, Living people, Naturalized citizens of the United States, Swedish movie actors, Swedish television actors, Swedish voice actors, American movie actors, American television actors, American voice actors, Actors from Stockholm
Jack Nichols (activist)	1938 births, 2005 deaths, American journalists, American LGBT people, American LGBT rights activists, Cancer deaths in Florida, Deaths from salivary gland cancer, Gay men, LGBT journalists, Writers from Washington, D.C.
Ibrahim Cevahir	1938 births, 2015 deaths, Turkish businesspeople
Hugo de Jonge	1977 births, Living people, Christian Democratic Appeal politicians, Deputy Prime Ministers of the Netherlands, Aldermen of the Netherlands, Dutch Calvinists, Dutch civil servants, Dutch councillors, Dutch teachers, Former leaders of political parties in the Netherlands, Government ministers of the Netherlands, Politicians from Zeeland
Bruinisse	Settlements in Zeeland, Former municipalities of Zeeland, Schouwen-Duiveland
Agulu lake	Lakes of Africa, Nigeria
Mahadev Ghurhu	Cities and towns in Uttar Pradesh
Bairavaa	Tamil-language movies
Revenue Village	Local government in India
Revenue block	Local government in India
Nagar panchayat	Local government in India
Chidambaram taluk	Cuddalore district
Kattumannarkoil taluk	Cuddalore district
Dharmapuri taluk	Dharmapuri district
Palacode taluk	Dharmapuri district
Formic acid	Ants, Carboxylic acids
Salvador Minuchin	1921 births, 2017 deaths, Cardiovascular disease deaths in Florida, Argentine scientists, American psychologists, Naturalized citizens of the United States, Argentine writers, Writers from New York City
Peter Schutz	1930 births, 2017 deaths, Deaths from Alzheimer's disease, Disease-related deaths in Florida, German businesspeople, Naturalized citizens of the United States, Businesspeople from Chicago, People from Berlin
Michael Augustine	1933 births, 2017 deaths, Deaths from myocardial infarction, Indian people, Roman Catholic archbishops
Muse Watson	1948 births, Living people, American movie actors, American television actors, American stage actors, American voice actors, Actors from Louisiana, Actors from Kentucky
Polity IV	Democracy
Norman Hardie	1924 births, 2017 deaths, Mountain climbers, New Zealand sportspeople, People from South Island
Joe Brown (climber)	1930 births, 2020 deaths, Mountain climbers, People from Manchester
Tony Streather	1926 births, 2018 deaths, Mountain climbers, British military people
Achille Silvestrini	1923 births, 2019 deaths, Ambassadors, Cardinals of the Roman Catholic Church, Humanitarians, Italian Roman Catholics, Roman Catholic bishops
Mecklenburg County, North Carolina	North Carolina counties, 1762 establishments in the Thirteen Colonies, 1760s establishments in North Carolina
Churchill County School District	Schools, Nevada
Arthrostylidium simpliciusculum	Bamboo species
Bambusa dissimulator	Bamboo species
Bambusa farinacea	Bamboo species
Bambusa affinis	Bamboo species, Flora of Indo-China
Bambusa balcooa	Flora of Indo-China
Bambusa blumeana	Bamboo species
Ampelocalamus scandens	Bamboo species
Pennagaram taluk	Dharmapuri district
Harur taluk	Dharmapuri district
Appukutty	Tamil actors, Tamil comedians
MGR Kazhagam	Political parties in Tamil Nadu
Sergei Ignashevich	1979 births, Russian footballers, Living people
2017–18 Russian Premier League	2017 in sports, 2018 in association football, Russian Premier League
2016–17 Russian Premier League	2016 in sports, 2017 in sports, Russian Premier League
Alp Buğdaycı	1964 births, 2016 deaths
Piet Derksen	1913 births, 1996 deaths, Dutch businesspeople, People from Rotterdam
Westerhoven	Settlements in North Brabant, Former municipalities of North Brabant
Qatar Foundation	Non-profit organizations of Asia, Qatar
Center Parcs	Hotel chains, Companies of the Netherlands
Center Parcs UK	Tourism, 1987 establishments in the United Kingdom, Companies of the United Kingdom
Silatech	2008 establishments in Asia, Research organizations in Asia, Youth organizations, Political organizations based in Asia, Qatar
Ballast	Electronic components
Frank Holder	1925 births, 2017 deaths, Deaths from congestive heart failure, Guyanese people, Jazz singers, Jazz musicians
Kit Harington	English television actors, English stage actors, English movie actors, Actors from London, 1986 births, Living people
Nancy Friday	1933 births, 2017 deaths, Deaths from Alzheimer's disease, Disease-related deaths in New York City, American feminists, American educators, Writers from Pittsburgh, Pennsylvania, Writers from South Carolina, People from Charleston, South Carolina
Paradise Papers	November 2017 events
Sutherland Springs church shooting	2017 mass shootings in the United States, 2017 murders in the United States, 2010s crimes in Texas, Attacks on buildings and structures in 2017, Attacks on buildings and structures in the United States, Attacks on churches, Mass murder in 2017, Mass murder in Texas, Mass shootings in Texas, Massacres in the United States, Murders by firearm in Texas, November 2017 events
Offshore investment	Finance
Paul Manafort	1949 births, Living people, American lawyers, American lobbyists, American fraudsters, People from Connecticut, Republicans (United States), 2016 United States presidential election
Dudley Simpson	1922 births, 2017 deaths, Australian composers, Conductors, People from Melbourne
Dionatan Teixeira	1992 births, 2017 deaths, Deaths from myocardial infarction, Brazilian footballers
Mansour bin Muqrin	1973 births, 2017 deaths, Aviation deaths, Politicians, Princes and princesses, Saudi Arabian businesspeople
Royapuram	Neighbourhoods of Chennai
Eser Tümen	1945 births, 2010 deaths, Turkish businesspeople
Adyar, Chennai	Neighbourhoods of Chennai
Besant Nagar	Neighbourhoods of Chennai
Adambakkam	Neighbourhoods of Chennai
Velachery	Neighbourhoods of Chennai
Nihat Özbağı	1950 births, Living people, Turkish businesspeople
Independent clauses	Grammar
Zuni language	Isolated languages
Flag of Bulgaria	Bulgaria, National flags
Voronezh	Capital cities in Russia
Brahma Kumaris	New religious movements
Landmark Worldwide	New religious movements
Cave Creek disaster	Disasters in the 1990s, 20th century in New Zealand, April events, 1995
Anna Diggs Taylor	1932 births, 2017 deaths, Deaths from Parkinson's disease, Disease-related deaths in Michigan, American judges, Politicians from Washington, D.C., Politicians from Michigan, US Democratic Party politicians, Women judges
Arthrostylidium longiflorum	Bamboo species
Feliciano Rivilla	1936 births, 2017 deaths, Spanish footballers
Roosevelt Corollary	History of the United States, Theodore Roosevelt
Acidosasa edulis	Bamboo species
Harald Krüger	Living people, 1965 births, People from Freiburg im Breisgau, German businesspeople
Betty Dodson	1929 births, 2020 deaths, Deaths from cirrhosis, American feminists, American educators, American critics, LGBT writers, American LGBT people, Bisexual people, Writers from Wichita, Kansas
Robert Knight	1945 births, 2017 deaths, Disease-related deaths in Tennessee, American R&B singers, American soul musicians, American pop singers, Musicians from Tennessee, Singers from Tennessee
Quartermaster	Military ranks
David Harbour	1975 births, Living people, Actors from New York, Actors who played in James Bond movies, American movie actors, American stage actors, American television actors
Finn Wolfhard	2002 births, Living people, Actors from Vancouver, Canadian child actors, Canadian movie actors, Canadian rock guitarists, Canadian rock singers, Canadian television actors, Musicians from Vancouver
Millie Bobby Brown	2004 births, Living people, English child actors, English movie actors, English television actors, People from Andalusia, People from Bournemouth
Sutherland Springs, Texas	Unincorporated communities in Texas
Albany, California	Cities in California, Settlements in Alameda County, California, Cities in the San Francisco Bay Area, 1908 establishments in California
Dublin, California	Settlements in Alameda County, California, Cities in California, Cities in the San Francisco Bay Area, 1982 establishments in California
Gaten Matarazzo	2002 births, Living people, Actors from New Jersey, American child actors, American stage actors, American television actors
Caleb McLaughlin	2001 births, Living people, Actors from New York, American child actors, American movie actors, American stage actors, American television actors
Noah Schnapp	2004 births, Living people, Actors from New York, American child actors, American movie actors, American television actors, American voice actors, American TikTokers
Natalia Dyer	1997 births, Living people, American child actors, American movie actors, American television actors, Actors from Nashville, Tennessee
Charlie Heaton	1994 births, Living people, English movie actors, English rock musicians, English television actors
Seibu ikebukuro line	Railway stations in Japan
Cara Buono	1974 births, Living people, Actors from the Bronx, American movie actors, American stage actors, American television actors, Movie directors from New York City, Screenwriters from New York City, Writers from the Bronx
Joe Keery	1992 births, Living people, Actors from Massachusetts, American movie actors, American rock guitarists, American television actors, Musicians from Massachusetts
Sadie Sink	2002 births, Living people, Actors from Texas, American child actors, American movie actors, American stage actors, American television actors
Dacre Montgomery	1994 births, Living people, Actors from Perth, Western Australia, Australian movie actors, Australian television actors
Scottish & Newcastle	Drink companies, Edinburgh, Beer, 1749 establishments, Companies of the United Kingdom, 2008 disestablishments in the United Kingdom, Establishments in Scotland, 1740s establishments in Europe
Lot (biblical person)	Old Testament people
Nazi ghettos	The Holocaust
European migrant crisis	Events in Europe, Migration, 2015 in Europe
Lancy	Municipalities of Geneva, Cities in Switzerland
Jansug Charkviani	1931 births, 2017 deaths, Writers from Georgia (country), Poets, Members of the Parliament of Georgia, People from Tbilisi
Lissy Tempelhof	1929 births, 2017 deaths, Actors from Berlin, East German people, German movie actors, German stage actors
Thomas Hooton Michael Dix	1908 births, 1985 deaths, People from Bedfordshire
Li Hongzhi	Chinese people, New religious movements
Abdul Aziz bin Fahd	1973 births, living people, Princes and princesses, Saudi Arabian people, Deaths by firearm, Civil servants
Carl Sargeant	1968 births, 2017 deaths, Suicides by hanging in the United Kingdom, Politicians who committed suicide, Welsh politicians
Tulip Siddiq	1982 births, Living people, Muslims, Politicians from London
Jo Stevens	1966 births, Living people, Welsh politicians
Bayard Rustin	1912 births, 1987 deaths, Deaths from appendicitis, Disease-related deaths in New York City, American civil rights activists, Socialists, American LGBT rights activists, Gay men, LGBT people from Pennsylvania, Writers from Pennsylvania
Kathryn Hays	1933 births, Living people, American movie actors, American television actors, American voice actors, American stage actors, People from Joliet, Illinois, Actors from Illinois
Don Hastings	1934 births, Living people, American child actors, American movie actors, American television actors, American voice actors, American stage actors, American radio actors, Singers from New York City, Writers from New York City, Actors from New York City
Sander Levin	1931 births, Living people, United States representatives from Michigan, US Democratic Party politicians, Politicians from Detroit, Michigan, 20th-century American politicians, 21st-century American politicians
Matt Morson	Living people, Canadian singers
Post Malone	1995 births, Living people, American rap musicians from New York, American musicians, Singers from New York, People from Texas, American pop singers, American singer-songwriters, American actors
Scheduling (computing)	Combinatorial optimization
Kajsa Ollongren	1967 births, Living people, Democrats 66 politicians, Deputy Prime Ministers of the Netherlands, Aldermen of the Netherlands, Dutch civil servants, Dutch LGBT people, Dutch mayors, Dutch nobility, Dutch women politicians, Government ministers of the Netherlands, Lesbians, LGBT politicians, People from Leiden, Politicians from South Holland, Swedish people
Mastrils	Former municipalities of Graubünden
Landquart, Switzerland	2012 establishments in Switzerland, Municipalities of Graubünden
Trimmis	Municipalities of Graubünden
Lumnezia	2013 establishments in Switzerland, Municipalities of Graubünden
Suraua	Former municipalities of Graubünden
Zizers	Municipalities of Graubünden
Tenczynek	Villages in Poland
Carola Schouten	1977 births, Living people, ChristianUnion politicians, Deputy Prime Ministers of the Netherlands, Dutch Calvinists, Dutch civil servants, Dutch women politicians, Government ministers of the Netherlands, Members of the House of Representatives of the Netherlands, People from 's-Hertogenbosch, Politicians from North Brabant
List of South Africans	South African people, Lists of people by nationality
Alice Martin	US Republican Party politicians, Politicians from Mississippi, Politicians from Alabama, American lawyers, Living people, 1950s births
Emeryville, California	Cities in California, Settlements in Alameda County, California, Cities in the San Francisco Bay Area
Gay Talese	1932 births, Living people, Writers from New Jersey, Journalists from New York City
Nan A. Talese	1933 births, Living people, Editors, Writers from New York
Lothar Thoms	1956 births, 2017 deaths, East German sportspeople, German cyclists, German Olympic gold medalists, Sportspeople from Brandenburg
Karin Dor	1938 births, 2017 deaths, Actresses who played Bond girls, Actors who played Bond villains, Entertainers from Hesse, German movie actors, German stage actors, German television actors, People from Wiesbaden
Shadia	1931 births, 2017 deaths, Deaths from stroke, Deaths from respiratory failure, Egyptian movie actors, Egyptian singers, People from Cairo
Cardi B	American rap musicians from New York, American hip hop musicians, American songwriters, Musicians from the Bronx, Atlantic Records artists, Television personalities, American Internet celebrities
Antonio Carluccio	1937 births, 2017 deaths, Accidental deaths in the United Kingdom, Italian chefs, Italian writers, Restaurateurs, Italian television personalities
Roger Grenier	1919 births, 2017 deaths, Deaths from pneumonia, Disease-related deaths in France, French essayists, French journalists, French novelists, French playwrights, People from Caen
Brad Harris	1933 births, 2017 deaths, American movie actors, American television actors, American movie producers, Stuntmen, Bodybuilders, Actors from Idaho
Arrondissements of the Nord department	Arrondissements of France
Constituency PK-89 (Chitral-I)	Khyber Pakhtunkhwa
Constituency PK-90 (Chitral-II)	Khyber Pakhtunkhwa
Calico (company)	Google, Gerontology, Research organizations in the United States, 2013 establishments in the United States
Elisabeth Köstinger	1978 births, Living people, Former MEPs, Government ministers of Austria, Legislative speakers, People from Carinthia (state)
Cyrtandra (plant)	Plants of Asia, Plants of Australia, Monocots
Arrondissement of Avesnes-sur-Helpe	Arrondissements of France
Grete Berget	1954 births, 2017 deaths, Deaths from cancer, Norwegian politicians
Hans-Michael Rehberg	1938 births, 2017 deaths, German movie actors, German stage actors, German television actors, People from Brandenburg
Arrondissement of Cambrai	Arrondissements of France
Arrondissement of Douai	Arrondissements of France
Indooroopilly Silver Mine	Pages created with the Article Wizard from 2017, Brisbane, Mining
Explanatory variable	Statistics
Fritz Lichtenhahn	1932 births, 2017 deaths, Swiss movie actors, Swiss stage actors, Graubünden
Dennis Gabor	British engineers, British physicists, 1900 births, 1979 deaths, Nobel Prize in Physics winners
Water rocket	Toys
Salishan languages	Languages of North America
History of the London Underground	History of London, London Underground, History of rail transport, London-related lists, History-related lists, Rail transport timelines
Giessen, Netherlands	Settlements in North Brabant, Former municipalities of North Brabant, Altena, Netherlands
Arrondissement of Dunkirk	Arrondissements of France
Arrondissement of Valenciennes	Arrondissements of France
AF Waltrip	Auto racing, Sports clubs, 2013 disestablishments, 2011 establishments
Akbar Eftekhari	1943 births, 2017 deaths, Iranian footballers
Kenting National Park	IUCN Category II, Geography of Taiwan, National parks in Asia, 1984 establishments in Asia
Arrondissement of Lille	Arrondissements of France
Avon Products	Companies of the United States, 1886 establishments in the United States, Cosmetics companies
Kim Guadagno	1959 births, Living people, American lawyers, American police officers, Politicians from Iowa, Lieutenant Governors of New Jersey, People from Waterloo, Iowa, US Republican Party politicians
Adela of Champagne	1140s births, 1206 deaths, Kings and Queens consort of France, Regents
Kıvanç Oktay	1964 births, Turkish businesspeople, Living people
Kaya Paşakay	Living people, 1943 births, Turkish businesspeople
Duffer Brothers	1984 births, Living people, People from Durham, North Carolina, American movie directors, American movie producers, American screenwriters, American television directors, American television producers, American television writers, Twin people from the United States, Writers from North Carolina, Sibling duos
The Son of a Migrant from Syria	Murals, Steve Jobs, Refugees, Syrian people, French paintings
Passendale	Settlements in Belgium, West Flanders
Alyssa	Given names
Hurricane Rick (2009)	Hurricanes, Pacific Ocean, 2009 in weather
Edzná	Maya civilization, Buildings and structures in Mexico
Hind bint Hamad bin Khalifa Al-Thani	1984 births, Living people, Qatar Foundation people
Hillsboro, Ohio	Cities in Ohio, County seats in Ohio
Kharp	Cities in Russia
Bekbol Sagyn	Living people, 1972 births
Shawn Levy	1968 births, Living people, Actors from Montreal, Canadian Jews, Canadian movie actors, Canadian movie directors, Canadian movie producers, Canadian television actors, Canadian television directors, Canadian television producers, Canadian television writers, Jewish writers, Writers from Montreal
Taeyeon	South Korean singers, 1989 births, Living people, K-pop singers
Kamehameha I	People from Hawaii, 1730s births, Kings and queens, 1819 deaths, Native Hawaiians
Mohamed Salah	1992 births, Living people, 2018 FIFA World Cup players, Chelsea F.C. players, Competitors at the 2012 Summer Olympics, Egypt international footballers, Egyptian footballers, Egyptian Muslims, Liverpool F.C. players
Aldo Kaslowski	1937 births, Italian people, Turkish people
Göksel Gümüşdağ	Living people, 1972 births, Turkish businesspeople
Michael Imperioli	1966 births, Living people, Actors from New York, American movie actors, American movie directors, American screenwriters, American television actors, American television writers, Emmy Award winning actors, People from Mount Vernon, New York
Tigga & Togga	American television series, Canadian television series, 2006 American television series debuts, 2013 American television series endings, Children's television series, Animation
Alan MacDiarmid	1927 births, 2007 deaths, New Zealand scientists, New Zealand Nobel Prize winners
Denudation	Geology
Recruitment (biology)	Ecosystems
Cyclone Dirk	2013 in weather, Weather events, Natural disasters, December events, 2013 in Europe
Shelby County, Alabama	Alabama counties
Fred Cole	1948 births, 2017 deaths, Deaths from liver disease, American singer-songwriters, American rock guitarists, Writers from Washington, Writers from Oregon, Writers from Las Vegas, Nevada, Singers from Washington, Singers from Oregon, Musicians from Oregon, Musicians from Washington, Musicians from Nevada, People from Tacoma, Washington, Singers from Las Vegas, Nevada
Chuck Mosley	1959 births, 2017 deaths, Drug-related deaths in the United States, American singer-songwriters, American rock guitarists, American heavy metal musicians, Musicians from Los Angeles, California, Singers from Los Angeles, California, Writers from Los Angeles, California
Priyan (cinematographer)	1964 births, 2017 deaths, Deaths from myocardial infarction, Indian cinematographers
Shyla Stylez	1982 births, 2017 deaths, Actors from British Columbia, Adult models, Canadian models, Canadian movie actors, Canadian sex industry people, Erotic dancers, Pornographic actors
Mikhail Nikolayevich Zadornov	1948 births, 2017 deaths, Deaths from brain cancer, Russian writers, Comedians
Daqing	Cities in China
Sophia (robot)	2015, Robots, Saudi Arabia
Nellie Bly	1864 births, 1922 deaths, American inventors, American journalists, American novelists, Deaths from pneumonia, Infectious disease deaths in New York City, Writers from Pennsylvania
Carlos Dívar	1941 births, 2017 deaths, Deaths from pulmonary edema, Civil servants, Spanish politicians
Valery Rozov	1964 births, 2017 deaths, Accidental deaths from falls, BASE jumpers, Deaths in sport, Russian sportspeople
Ian Wachtmeister	1932 births, 2017 deaths, Swedish businesspeople, Deaths from lymphoma, Earls and countesses, Swedish nobility, Swedish politicians
Tamara Natalie Madden	1975 births, 2017 deaths, Deaths from ovarian cancer, Cancer deaths in the United States, Jamaican people, Naturalized citizens of the United States, American painters, People from Atlanta, Georgia, People from Milwaukee, Wisconsin
Jack Ralite	1928 births, 2017 deaths, Communists, Deaths from respiratory failure, Disease-related deaths in France, French mayors, Government ministers of France, People from Grand Est
Freddy Cole	1931 births, 2020 deaths, Cardiovascular disease deaths in the United States, American jazz singers, American jazz musicians, American pianists, Singers from Chicago, Musicians from Chicago
Ray Lovelock	1950 births, 2017 deaths, Deaths from bone cancer, Cancer deaths in Italy, Italian movie actors, Italian television actors, Rock musicians, Actors from Rome, Musicians from Rome
Roman calendar	Calendars, Ancient Rome
James T. Butts Jr.	Pages needing to be simplified from November 2017, 1953 births, African American politicians, American mayors, American police officers, Politicians from California, People from Inglewood, California, Living people
Norman Hallendy	Nunavut, Canadian writers, Ethnography
Ron Gardenhire	1957 births, Living people, German sportspeople, Detroit Tigers managers, Minnesota Twins, New York Mets players
Allschwil	Municipalities of Basel-Landschaft, Cities in Switzerland
Solothurn (city)	Municipalities of the canton of Solothurn, Districts of Solothurn, Capital cities in Switzerland, Imperial free cities
Highland County, Ohio	1800s establishments in Ohio, 1805 establishments in the United States, Ohio counties
Gholamreza Hassani	1928 births, 2018 deaths, Iranian politicians, Conservatives
Mary Wells Lawrence	1928 births, Living people, Businesspeople from New York City, Businesspeople from Ohio, People from Youngstown, Ohio
Cindy Adams	1930 births, Living people, American activists, Models from New York City, Journalists from New York City
Edith Savage-Jennings	1924 births, 2017 deaths, American civil rights activists, People from Jacksonville, Florida, People from Trenton, New Jersey
Wojciech Zabłocki	1930 births, 2020 deaths, Polish Olympic medalists, Architects, Olympic bronze medalists, Olympic silver medalists, Fencers, Sportspeople from Warsaw
Bernard Panafieu	1931 births, 2017 deaths, Cardinals of the Roman Catholic Church, Deaths from Parkinson's disease, Disease-related deaths in France, French Roman Catholics, People from Nouvelle-Aquitaine, Roman Catholic archbishops
Photometry (astronomy)	Astronomy
Santiago Vernazza	1928 births, 2017 deaths, Argentine footballers, Sportspeople from Buenos Aires
David Poisson	1982 births, 2017 deaths, Deaths in sport, French Olympians, French skiers, People from Auvergne-Rhône-Alpes
Alex Azar	1967 births, Living people, United States Secretaries of Health and Human Services, Politicians from Pennsylvania, Politicians from Maryland, Businesspeople from Pennsylvania, People from Johnstown, Pennsylvania, Businesspeople from Indianapolis, Indiana, Politicians from Indianapolis, Indiana, US Republican Party politicians
Sam Johnson	Purple Heart recipients, 1930 births, 2020 deaths, Deaths from natural causes in the United States, United States representatives from Texas, Politicians from San Antonio, Texas, American military personnel of the Korean War, American military personnel of the Vietnam War, Military people from Texas, US Republican Party politicians
President of Singapore	Political office-holders in Singapore
Tan Kah Kee MRT station	Mass Rapid Transit (Singapore) stations
Botanic Gardens MRT station	Mass Rapid Transit (Singapore) stations
MacPherson MRT station	Mass Rapid Transit (Singapore) stations, 2017 establishments in Asia, 2010s establishments in Singapore
Lavender MRT station	Mass Rapid Transit (Singapore) stations
Bugis MRT station	Mass Rapid Transit (Singapore) stations
Tanjong Pagar MRT station	Mass Rapid Transit (Singapore) stations
Tiong Bahru MRT station	Mass Rapid Transit (Singapore) stations
Kallang MRT station	Mass Rapid Transit (Singapore) stations
Redhill MRT station	Mass Rapid Transit (Singapore) stations
Little India MRT station	Mass Rapid Transit (Singapore) stations
Farrer Park MRT station	Mass Rapid Transit (Singapore) stations
Chinese Garden MRT station	Mass Rapid Transit (Singapore) stations
Downtown MRT station	Mass Rapid Transit (Singapore) stations
Telok Ayer MRT station	Mass Rapid Transit (Singapore) stations
Rochor MRT station	Mass Rapid Transit (Singapore) stations
Jalan Besar MRT station	Mass Rapid Transit (Singapore) stations
Fort Canning MRT station	Mass Rapid Transit (Singapore) stations
Kevin Cramer	1961 births, Living people, United States senators from North Dakota, United States representatives from North Dakota, US Republican Party politicians
Gabarnmung	Indigenous Australian culture, Archaeological sites in Australia, Northern Territory
Earl Pomeroy	1952 births, Living people, American lobbyists, United States representatives from North Dakota, US Democratic Party politicians
District of Eixample	Barcelona
Mayor of Coimbatore	Coimbatore district, Tamil Nadu politicians, Mayors, Lists of politicians, Lists of Indian people
Hurst-Euless-Bedford Independent School District	Organizations based in the United States
The War of the Worlds (radio drama)	Radio programs, 1938
Thruepang Palace	Buildings and structures
Monika Kørra	1989 births, Living people, Norwegian writers
Untervaz	Municipalities of Graubünden
Levoncourt, Haut-Rhin	Communes in Haut-Rhin
Leymen	Communes in Haut-Rhin
Liebenswiller	communes in Haut-Rhin
Backbend	Gymnastics, Human skills, Yoga
VxWorks	Operating systems
Sindhi writers	Indian culture, Sindh
Sun Moon Lake	Geography of Taiwan, Lakes of Asia
Shyama	1935 births, 2017 deaths, Deaths from respiratory tract infection, Infectious disease deaths in India, Indian movie actors
Eric Salzman	1933 births, 2017 deaths, 20th century composers, 21st century composers, American academics, American composers, American music critics, Cardiovascular disease deaths in New York City, Columbia University alumni, Deaths from myocardial infarction, Musicians from Queens, Princeton University alumni
Madarsha Union	Bangladesh
Jean-Pierre Schmitz	1932 births, 2017 deaths, Deaths from multiple myeloma, Luxembourgian sportspeople, Tour de France cyclists
Orchard MRT station	Mass Rapid Transit (Singapore) stations
Somerset MRT station	Mass Rapid Transit (Singapore) stations
Serangoon MRT station	Mass Rapid Transit (Singapore) stations
Nick Begich	1932 births, 1972 deaths, People declared dead in absentia, Aviation deaths in the United States, Missing American people, Politicians from Minnesota, United States representatives from Alaska, US Democratic Party politicians, 20th-century American politicians
Kuntala Kumari Sabat	1901 births, 1938 deaths, Indian poets, Indian writers, People of British India, Physicians
Howard Wallace Pollock	1920 births, 2011 deaths, American military personnel of World War II, Politicians from Chicago, United States representatives from Alaska, US Republican Party politicians
Black Clover	2010s anime
People of the Book	Islam
Communist Party USA	Political parties in the United States, Communism
Kaziranga National Park	National parks in India, World Heritage Sites in India, 1974 establishments in Asia, 1970s establishments in India
André-Louis Debierne	French chemists, 1874 births, 1949 deaths
2017 Zimbabwean coup d'état	2017 in Africa, November 2017 events, Coups d'état, History of Zimbabwe
Emmerson Mnangagwa	1946 births, Living people, Presidents of Zimbabwe, Current national leaders, Vice-Presidents of Zimbabwe
Philip Kotler	1931 births, Living people, American educators, DePaul University alumni, Writers from Chicago
Gunnar Uldall	1940 births, 2017 deaths, Politicians from Hamburg, Politicians of the Christian Democratic Union of Germany
Luis Bacalov	Academy Award winning composers, 1933 births, 2017 deaths, Deaths from leukemia, Cancer deaths in Italy, Italian composers, People from Buenos Aires
Keith Barron	1934 births, 2017 deaths, English movie actors, English television actors, English stage actors, English radio actors, Actors from Yorkshire
Sarah Lawson	1928 births, Living people, British movie actors, British television actors, British radio actors, Actors from London
Yuri Kayurov	1927 births, Living people, Russian movie actors, Russian television actors, Russian stage actors
Françoise Héritier	1933 births, 2017 deaths, French philosophers, Feminists, French educators
Wolfgang Schreyer	1927 births, 2017 deaths, East German people, German novelists, German screenwriters, Nazis, People from Magdeburg, Television writers
Frans Krajcberg	1921 births, 2017 deaths, Brazilian artists, Brazilian Jews, Deaths from pneumonia, Engravers, Environmentalists, Holocaust survivors, Jewish artists, Jewish military people, Brazilian photographers, Polish Jews, Polish military people, Polish painters
Rudi Kurz	1921 births, 2020 deaths, German movie actors, German movie directors, German screenwriters, Television directors
World War I Victory Medal (United States)	1919 establishments in the United States, Orders, decorations, and medals of the United States, World War I
My Voice	2017 albums
Tom Tauke	1950 births, Living people, American chief executives, American lawyers, Businesspeople from Iowa, United States representatives from Iowa, US Republican Party politicians
Sohni Mahiwal	Prose
Propellant	Gases, Propulsion
Liebsdorf	Communes in Haut-Rhin
Lil Peep	1996 births, 2017 deaths, Drug-related deaths in the United States, American rap musicians from New York, Bisexual people, LGBT musicians, LGBT singers, LGBT people from New York, Musicians from New York, Singers from New York
List of political parties in Bulgaria	Political parties in Bulgaria
Tobias Enverga	1955 births, 2017 deaths, Filipino politicians, Politicians from Ontario
Franz Vranitzky	1937 births, Living people, Chancellors of Austria, Austrian businesspeople
F. David Mathews	1935 births, Living people, United States Secretaries of Health, Education, and Welfare, American educators, Politicians from Alabama, Writers from Alabama, Independent politicians in the United States
Robert Hirsch	1925 births, 2017 deaths, Actors from Ile-de-France, French comedians, French Jews, French movie actors, French stage actors, French television actors, Jewish actors, Jewish comedians
Lou Adler	Grammy Award winners, 1933 births, Living people, American songwriters, Movie directors from Chicago, Movie producers from Chicago, Writers from Chicago
Gennady Golovkin	1982 births, Living people, Medalists at the 2004 Summer Olympics, Boxers, Kazakhstani sportspeople
Tyson Fury	1988 births, Living people, British boxers, English Roman Catholics, Sportspeople from Greater Manchester
Anthony Joshua	1989 births, Living people, Black British sportspeople, British boxers, Medalists at the 2004 Summer Olympics, Sportspeople from Hertfordshire, People from Watford
Harry Potter and the Deathly Hallows – Part 1	2010 movies, 2010s fantasy movies, English-language movies, 2010s sequel movies, Harry Potter movies, British fantasy movies, American fantasy movies, American sequel movies, Warner Bros. movies, Movies based on books, Movies directed by David Yates
Erik Meijs	1991 births, 2017 deaths, Badminton players, Road accident deaths, Sportspeople from South Holland
Aleksandr Salnikov	1949 births, 2017 deaths, Basketball players, Soviet sportspeople, Medalists at the 1976 Summer Olympics, Medalists at the 1980 Summer Olympics
Lièpvre	Communes in Haut-Rhin
Schönenwerd	Municipalities of the canton of Solothurn
Fritz Egner	1949 births, Living people, People from Munich, German television presenters
1996 African Cup of Nations	Africa Cup of Nations, Football in South Africa, 1996 in association football, 1990s in Africa, 20th century in South Africa
Ruth Dreifuss	1940 births, Living people, Presidents of the Swiss Confederation
Pierre Imhasly	1939 births, 2017 deaths, Swiss poets, Novelists, Deaths from cancer
Paspels	Former municipalities of Graubünden
List of English-translated volumes of Découvertes Gallimard	Lists of books, Encyclopedias, Series of books, Non-fiction books, English-language picture books
Behavioural Responses to Stress in Animals	Biology
Taroko National Park	Geography of Taiwan, National parks in Asia, 1986 establishments in Asia
2016–17 First Professional Football League (Bulgaria)	2016 in sports, 2017 in sports, Football in Bulgaria
Ligsdorf	Communes in Haut-Rhin
Masevaux-Niederbruck	Communes in Haut-Rhin, 2016 establishments in France
Linsdorf	Communes in Haut-Rhin
Demirören Group	Istanbul, Holding companies of Turkey
Erdoğan Demirören	1938 births, 2018 deaths, Turkish businesspeople
Linthal, Haut-Rhin	Communes in Haut-Rhin
Canaan (son of Noah)	Quran, Islam
Meresha	Musicians from Florida, American pop singers, Living people, American singer-songwriters
Vignemale	Pyrenees, Mountains of France, Occitanie
Richard H. Watson	Living people, American biochemists
Invercargill	Cities in New Zealand, 1853 establishments in Oceania, 19th-century establishments in New Zealand
Bhimbetka	India
Malwa	Geography of India
Kalibangan	History of Pakistan, Ancient history, History of India, History of Afghanistan
Jiří Kormaník	1935 births, 2017 deaths, Czech sportspeople, Wrestlers, Olympic silver medalists
Wendell Eugene	1923 births, 2017 deaths, Deaths from pneumonia, American jazz musicians, American trombonists, Musicians from New Orleans, Louisiana
Bernhard Eckstein	1935 births, 2017 deaths, German cyclists, German Olympians
Franciszek Kornicki	1916 births, 2017 deaths, Polish people, Deaths from myocardial infarction, Military people
Salvatore Riina	1930 births, 2017 deaths, Deaths from sepsis, Deaths from surgical complications, Italian people, Mobsters, Murderers
Rikard Wolff	1958 births, 2017 deaths, Deaths from emphysema, Swedish movie actors, Swedish television actors, Swedish voice actors, Swedish stage actors, Swedish singers, Gay men, LGBT actors, LGBT singers
Earle Hyman	1926 births, 2017 deaths, Deaths from stomach cancer, Cancer deaths in New Jersey, American movie actors, American television actors, American stage actors, American voice actors, Actors from North Carolina, People from Rocky Mount, North Carolina
Giorgio Antonucci	1933 births, 2017 deaths, Italian physicians, People from Tuscany
Commins Menapi	1977 births, 2017 deaths, Deaths from myocardial infarction, Oceanic footballers, Solomon Islands
Skunk Fu!	2007 television series debuts, 2008 television series endings, 2007 establishments in the United States, 2000s establishments in the Republic of Ireland, English-language television programs
Youssouf Ouédraogo	1952 births, 2017 deaths, Prime Ministers of Burkina Faso, Ambassadors to the United Kingdom
Friedel Rausch	1940 births, 2017 deaths, German football managers, German footballers, Deaths from skin cancer
Mönchsdeggingen	Donau-Ries
Ben Riley	1933 births, 2017 deaths, American jazz musicians, American drummers, Musicians from Georgia (U.S. state), People from Savannah, Georgia
Why Him?	2016 movies, American comedy movies, Movies set in California, Movies set in Michigan
Naim Süleymanoğlu	1967 births, 2017 deaths, Deaths from liver failure, Deaths from cerebral edema, Turkish sportspeople, Olympians
Hiromi Tsuru	1960 births, 2017 deaths, Deaths from aortic dissection, Japanese movie actors, Japanese television actors, Japanese voice actors
Andrea Cordero Lanza di Montezemolo	1925 births, 2017 deaths, Cardinals of the Roman Catholic Church, Italian Roman Catholics, People from Turin
Tai Chen-yao	1948 births, 2017 deaths, Deaths from pancreatic cancer, Taiwanese politicians
Pancho Segura	1921 births, 2017 deaths, Deaths from Parkinson's disease, Disease-related deaths in California, Naturalized citizens of the United States, American tennis players, Sportspeople from California, People from Guayaquil
Fernando Matthei	1925 births, 2017 deaths, Deaths from cardiopulmonary arrest, Chilean politicians, Military people
Hou Zongbin	1929 births, 2017 deaths, Deaths from myocardial infarction, Chinese politicians, Communists
Kim Tae-yeon discography	Discographies
Muhammad Mansuruddin	1904 births, 1987 deaths, Bangladeshi people, writers, Bangla Academy Literary Award winners, Recipients of the Ekushey Padak, Bangladeshi Muslims, Recipients of the Independence Day Award
Fernando Ricksen	1976 births, 2019 deaths, Deaths from motor neurone disease, Dutch footballers, People from Heerlen, Sportspeople from Limburg (Netherlands)
Freddie Jones	1927 births, 2019 deaths, English movie actors, English television actors, English stage actors, People from Staffordshire
Michael Aspel	1933 births, Living people, English television presenters, English television personalities, English television actors, English radio personalities, Actors from London
Shane MacGowan	1957 births, Living people, Irish singer-songwriters, Irish guitarists, British singer-songwriters, British guitarists, British pianists, Writers from Kent

