List of astrophysicists	Astrophysicists, Lists of scientists
List of walls	Walls, Lists
List of vegetables	Vegetables, Food-related lists
List of terrorist incidents	History-related lists, Terrorist attacks
List of telescope types	Telescopes, Astronomy lists
List of shipwrecks	Transport lists, Ships
List of religions	Religions, Religion-related lists
List of national parks in Africa	National parks in Africa, Africa-related lists, Lists of national parks
List of languages	Language-related lists
List of endangered languages	Language-related lists, Africa
List of emotions	Emotions, Non-verbal communication, Lists
List of earthquakes	Earthquakes, Science-related lists
List of disasters	Disasters, History-related lists
List of diseases	Disease-related lists
List of mental disorders	Mental illnesses
List of communist parties	Lists of political parties, Communist parties
List of color topics	Color, Lists
List of buildings	Lists of buildings
List of bridges	Lists of bridges
List of bones of the human skeleton	Bones, Science-related lists
Lists of astronomical objects	Astronomy lists
List of stars	Lists of stars
List of nearest stars	Lists of stars
List of planets	Planets, Astronomy lists
List of galaxies	Galaxies, Astronomy lists
List of nearest galaxies	Galaxies, Astronomy lists
List of satellites of the Milky Way	Local galaxies, Astronomy lists, Milky Way
List of comets	Comets, Astronomy lists
List of stars with confirmed extrasolar planets	Lists of stars, Planets
List of water sports	Water sports, Sports lists
List of waterways	Waterways, Geography-related lists
List of wave topics	Science-related lists, Wave physics
List of waterfalls	Waterfalls, Geography-related lists
List of tunnels	Tunnels, Transport lists
List of tallest structures in the world	Lists of buildings
List of symbols	Symbols, Lists
List of supermarkets	Supermarkets, Lists
Acid	Basic English 850 words, Acids
White dwarf	Types of stars
Beach	Beaches
Mental illness	Diseases, Mental illnesses
Depression (mental illness)	Mood disorders
Qur'an	Quran, Islam, Arabic words and phrases, Religious terminology
Tony Blair	1953 births, Living people, Alumni of the University of Oxford, British Roman Catholics, British autobiographers, Former Labour MPs (UK), Former members of the British House of Commons for English constituencies, Leaders of the Labour Party (UK), Leaders of the Opposition (United Kingdom), Politicians from Edinburgh, Presidential Medal of Freedom recipients, Privy Councillors (UK), UK MPs 1983–1987, UK MPs 1987–1992, UK MPs 1992–1997, UK MPs 1997–2001, UK MPs 2001–2005, UK MPs 2005–2010
Accident	Health
Acne	Diseases caused by bacteria, Skin
Dinosaur	Dinosaurs
Stone Age	Stone Age
Adolf Hitler	1889 births, 1945 deaths, Anti-Communists, Austrian painters, Austrian politicians, Chancellors of Nazi Germany, Former dictators, Former Roman Catholics, German military personnel of World War I, German military personnel of World War II, German painters, Hitler family, Holocaust perpetrators, Members of the Reichstag (Nazi Germany), Members of the Reichstag (Weimar Republic), Ministers-President of Prussia, Murderers, Nazi leaders, Nazis who committed suicide, People from Upper Austria, People with borderline personality disorder, Politicians of the Nazi Party, Politicians who committed suicide, Presidents of Nazi Germany, Suicides by firearm in Germany, Time People of the Year
Virgil	70 BC births, 19 BC deaths, Ancient Roman writers
Alcohol	Alcohols, Carbohydrates, Functional groups
Wolfgang Amadeus Mozart	1756 births, 1791 deaths, Austrian composers, Child prodigies, Classical era composers, People from Salzburg, Smallpox survivors, Austrian Roman Catholics
Johann Sebastian Bach	1685 births, 1750 deaths, Bach family, Baroque composers, German composers, German Lutherans, German organists, People from Saxony-Anhalt
Atmosphere of Earth	Atmosphere
Human penis	Anatomy of the male reproductive system
Sahara	Deserts
Paris	Paris, Capital of France, Departmental capitals in France, Regional capitals in France, Olympic cities
The Holocaust	The Holocaust, Judaism in Germany
Kyoto	Kyoto, Former capitals of Japan
Anarchy	Anarchism, Economic systems, Society
DNA	DNA, Cell biology, Macromolecules
Karl Marx	1818 births, 1883 deaths, 19th century philosophers, Former Christians, German atheists, German communists, German economists, German historians, German philosophers, German sociologists, Infectious disease deaths in London, Jewish atheists, Jewish German scientists, Jewish German writers, Jewish philosophers, Marxism, People from Rhineland-Palatinate
Bread	Basic English 850 words, Breads
Shinto	Shinto
Volcano	Volcanoes
Big Bang	Cosmology, Astrophysics, Astrology
Gmail	Google, E-mail
Astronomer	Astronomers, Science occupations
Analysis	Philosophy, Research methods
Foolishness	Knowledge, Basic English 850 words
Aristotle	384 BC births, 322 BC deaths, Ancient Greek philosophers, Ancient Greek writers, Polymaths
Carl Sagan	1934 births, 1996 deaths, Agnostics, American astronomers, Deaths from pneumonia, Infectious disease deaths in the United States, Jewish American scientists, Jewish American writers, Pulitzer Prize winners, Scientists from New York, Writers from New York City, Emmy Award winners
Matsuo Basho	1644 births, 1694 deaths, Japanese poets
Colonization	Politics
Choreography	Dance, Choreographers
Electrical cell	Tools, Electricity
Dry cell	Electronics, Physical chemistry, Batteries
Vietnam War	Vietnam War, Cold War, 20th century in Vietnam, 1950s in Asia, 1960s in Asia, 1970s in Asia
Sahel	Geography of Africa, Biomes
Chemical change	Chemical reactions
Physical change	Chemistry, Physics
Ronald Reagan	Presidential Medal of Freedom recipients, Honorary Knights Grand Cross of the Order of the Bath, Congressional Gold Medal recipients, Recipients of the Order pro merito Melitensi, Recipients of the Order of the White Eagle (Poland), National Radio Hall of Fame inductees, 1968 United States presidential candidates, 1976 United States presidential candidates, 1980 United States presidential candidates, 1984 United States presidential candidates, Actors from Illinois, American movie actors, American radio actors, American labor leaders, American television presenters, American crime victims, American autobiographers, American conservatives, Major League Baseball broadcasters, Deaths from pneumonia, People with Alzheimer's disease, Governors of California, Infectious disease deaths in Los Angeles, Reagan family, American military personnel of World War II, Military people from Illinois, Politicians from Illinois, Writers from Illinois, Tampico, Illinois, Ronald Reagan, Skin cancer survivors, Anti-Communists, Time People of the Year, Presidents of the Screen Actors Guild, US Republican Party politicians, 1911 births, 2004 deaths, 20th-century American politicians
United Nations	United Nations, 1945 establishments
Global	Geography
List of historians	Historians, Lists of people
Marco Polo	1254 births, 1324 deaths, Italian explorers, European geographers, People from Venice
Herpes zoster	Diseases caused by viruses
A Brief History of Time	1988 books, Science books
Alexander Graham Bell	Deaths from diabetes, Disease-related deaths in Canada, People from Edinburgh, Royal Society of Arts, Scottish inventors, Scottish scientists, 1847 births, 1922 deaths, British inventors, Canadian inventors, Canadian scientists, British scientists, American inventors, People from Nova Scotia, Naturalized citizens of the United States, Naturalized citizens of Canada, Deaths from anemia
Heinrich Rudolf Hertz	1857 births, 1894 deaths, German academics, German physicists, People from Hamburg
1850	1850
1869	1869
1621	1621
1619	1619
1687	1687
1822	1822
1824	1824
1826	1826
1827	1827
1815	1815
Deep house	Music genres
Cytokine	Proteins, Immunology, Cell biology
Bristol	Slavery, Unitary authorities, Bristol, Ceremonial counties of England, Ports and harbours of the United Kingdom
List of cities and towns in England	Lists of settlements in England
1858	1858
1899	1899
Bright Eyes (band)	American rock bands, Indie bands, Electronic music bands, Musical groups from Nebraska, Musicians from Omaha, Nebraska, Musical groups established in 1995, 1995 establishments in the United States, 20th-century establishments in Nebraska
Honeycomb	Bees
Greek language	Greek language
Kamishibai	Japanese culture, Entertainment in Japan
Murasaki Shikibu	Japanese writers, 970s births, 1020s deaths, Japanese poets, People from Kyoto Prefecture
Pepsin	Metabolism, Enzymes
PH	Chemistry
Tapeworm	Flatworms, Parasites
Omnivore	Omnivores
Herbivore	Animals, Ecology
Hindi	Hindi
1870	1870
1871	1871
1882	1882
1941	1941
1945	1945
Ludwig van Beethoven	1770 births, 1827 deaths, Deaths from cirrhosis, Child prodigies, Classical era composers, German composers, Ludwig van Beethoven, People from Bonn, Romantic composers, German Roman Catholics
Roald Amundsen	1872 births, 1928 deaths, Norwegian people, Norwegian explorers, People with foods named after them, Missing people
Christopher Columbus	1451 births, 1506 deaths, Deaths from heart failure, Disease-related deaths in Spain, Italian explorers, People from Genoa
GNU General Public License	Software licences
Square	Polygons, Basic English 850 words
Computer hardware	Computer hardware
Meat	Meat
Anders Celsius	1701 births, 1744 deaths, Astronomers, Meteorologists, Swedish scientists, People from Uppsala
Tuvalu	Tuvalu, Current monarchies, Commonwealth realms, Least developed countries, 1978 establishments in Oceania
Java	Java
James Watt	1736 births, 1819 deaths, British engineers, British inventors, British mathematicians, Members of the Lunar Society, Scottish scientists
1267	1267
Michelangelo	1475 births, 1564 deaths, 15th century Italian painters, 16th century Italian painters, Italian architects, Italian sculptors, Italian poets, Polymaths
Leonardo da Vinci	1452 births, 1519 deaths, Italian people, Inventors, Italian mathematicians, Italian architects, Italian sculptors, Botanists, People from Florence, 15th century Italian painters, Anatomists, Polymaths
1844	1844
1902	1902
1895	1895
1796	1796
1879	1879
1769	1769
1807	1807
1885	1885
1837	1837
Platinum	Chemical elements
List of rock types	Rocks, Science-related lists
List of minerals	Minerals, Science-related lists
Mineral	Minerals, Natural resources
Craft	Occupations
Kim Jong-il	1941 births, 2011 deaths, Dictators, Former dictators, North Korean military people, North Korean politicians, Deaths from myocardial infarction
Silver	Basic English 850 words, Metals, Chemical elements
Pope	Popes, Christian religious occupations
San Andreas Fault	Geography of California, Faults, San Francisco Bay Area
Void (astronomy)	Astronomical objects
Computer mouse	Computer hardware, Data input
Metallurgy	Metallurgy, Metals, Materials science, Chemistry
Fixed-wing aircraft	Aircraft, Aerospace engineering
Aircraft	Aircraft, Aerospace engineering
Victoria, British Columbia	Victoria, British Columbia
Suez Canal	1869 establishments, 19th-century establishments in Egypt, Canals, Buildings and structures in Egypt, Transport in Egypt
Canal	Canals
Mars (mythology)	Roman gods and goddesses
Cessna	Aircraft companies, Wichita, Kansas
Clothing	Clothing
Shoe	Basic English 850 words, Footwear
Footwear	Footwear
Café	Food and drink, Restaurants
Jazz	Jazz music, African-American history
Coffee	Coffee
Beef	Beef
Hyaena	Hyaenas
Table salt	Condiments, Sodium compounds, Chlorine compounds
Silk	Basic English 850 words, Fibers, Cloth
The Beatles	Musical groups disestablished in 1970, 1960s British music groups, 1970s disestablishments in the United Kingdom, 1960s establishments in England, 1970s British music groups, British pop rock bands, English pop music groups, English rock bands, Musical groups established in 1960, Musical groups from Liverpool, Musical quartets, The Beatles, 1960 in the United Kingdom
Reincarnation	Theology, Cultural studies, Afterlife
EBay	Websites
Gerhard Schröder	1944 births, Living people, Chancellors of Germany, Former members of the German Bundestag, German lawyers, Ministers-President of Lower Saxony, Politicians from North Rhine-Westphalia
Melbourne	Melbourne, Former national capitals, Olympic cities
Canberra	Canberra, 1913 establishments, 1910s establishments in Australia
Sydney	Sydney, Olympic cities, 1788 establishments in Australia
Greenhouse effect	Weather, Climate change, Greenhouse gases, Ecology
World War	War
Ionizing radiation	Nuclear physics
Click	Computing
Buzz Aldrin	1930 births, Living people, American astronauts, American aviators, Apollo astronauts, People from Glen Ridge, New Jersey, Scientists from New Jersey
Tuberculosis	Diseases caused by bacteria, Pulmonology
American (word)	North America, South America
Grain	Basic English 850 words, Grains
Clause	Grammar
Marxism	Marxism
Sacred	Religion
Zürich	Zürich, Imperial free cities
Translation	Language
Astronaut	Astronauts
Hacker	Computing, Internet security
Broadcasting	Mass media
Socialism	Forms of government, Socialism
Leninism	Communism, Marxism
Bolshevik	Russian Revolution
Saddam Hussein	1937 births, 2006 deaths, Criminals, Former dictators, Generals, Iraqi military people, Murderers, Muslims, People executed by hanging, Presidents of Iraq, Prime Ministers of Iraq, People from Tikrit, Vice Presidents of Iraq
List of traditional star names	Lists of stars
List of tectonic plates	Plate tectonics, Science-related lists
List of oil fields	Geography-related lists, Fuel
Anarchism	Anarchism
List of countries by area	Lists of countries
List of countries by continents	Lists of countries, Lists by continent
List of countries and dependencies by population	Lists of countries
List of oil-producing nations	Lists of countries
Forests in the United Kingdom	Forests of the United Kingdom
List of prime numbers	Prime numbers, Mathematics lists
List of publishers	Lists, Publishing
ΜCLinux	Operating systems
UNIX	Operating systems, Unix
Signature	Writing, Authentication methods
Cocoa	Food ingredients
Ivory Coast	Ivory Coast, French-speaking countries, Members of the Organisation of Islamic Cooperation, 1960 establishments in Africa
Luke McCormick	British criminals, English association football goalkeepers, People from Coventry, 1983 births, Living people
God paradox	Philosophy
Libertarianism	Libertarianism
Auction	Commerce
Hong Kong	Hong Kong
Blitzkrieg	Military of Germany, World War II
Tank	Tanks, Army
Edinburgh	Edinburgh, Port cities and towns of the North Sea, Port cities and towns of Scotland
Head of state	Heads of state
Vladimir Lenin	Russian atheists, Russian communists, Deaths from stroke, Disease-related deaths in the Soviet Union, Marxism, Russian lawyers, 1870 births, 1924 deaths, Russian philosophers, Heads of government of the Soviet Union, Saint Petersburg State University alumni
Disease	Basic English 850 words, Diseases
Carbon	Carbon
Zaza language	Zazaki, Iranian languages
Chemical reaction	Chemistry
Rectangle	Polygons
Trafalgar Square	Roads in London, National squares
Official language	Languages, Vocabulary
Cake	Cakes, Basic English 850 words
House	Basic English 850 words, Houses
Gigabyte	Computing measurement
Sailor	Occupations, Water transport, Sailing, Navy
Farmer	Agricultural occupations
Constellation	Constellations
Flood	Floods
Hell	Afterlife, Religion
October 21	Days of the year
112 (emergency telephone number)	European Union, Emergency phone numbers
Government-in-exile	Governments in exile
Stonehenge	Prehistoric buildings and structures, Buildings and structures in England, Religious buildings, Wiltshire, Archaeological sites in Wiltshire, World Heritage Sites in the United Kingdom, Stone circles, Henges, Neolithic
Granite	Igneous rocks
1970	1970
Syracuse, New York	County seats in New York, Syracuse, New York
Soap opera	Soap operas, Television genres
The Young and the Restless	1973 television series debuts, 1970s American television series, 1980s American television series, 1990s American television series, 2000s American television series, 2010s American television series, American soap operas, Television series set in Wisconsin, CBS network shows, English-language television programs
Georgia (U.S. state)	Georgia (U.S. state), 1788 establishments in the United States
Prem Rawat	1957 births, Living people, Religious leaders, Indian people
Immanuel Kant	1724 births, 1804 deaths, 18th century philosophers, 19th century philosophers, Continental philosophers, German academics, German philosophers, German writers, People from former German territories, People from Kaliningrad, People from Prussia
Aunt	Family
Homer	Ancient Greek poets
Marquis de Sade	1740 births, 1814 deaths, Bisexual people, French criminals, French LGBT people, French novelists, French prisoners, LGBT criminals, LGBT writers, Sex offenders, Writers from Paris
Eurozone	European Union
Ordinal number	Number theory
Republic	Forms of government
Martin Luther	1483 births, 1546 deaths, Martin Luther, Bible translators, Christian theologians, German academics, German Lutherans, German theologians, Monks, People excommunicated by the Catholic Church, People from Saxony-Anhalt, Protestant Reformers
Noh	Japanese culture, Theatrical forms, Entertainment in Japan
Manga	Manga, Comic books
Spree	Geography of Berlin, Geography of Brandenburg, Geography of Saxony, Rivers of Germany
Liberalism	Liberalism
Zeno's paradoxes	Mathematics, Philosophical problems, Logical paradoxes
Mandrake	Nightshades
Debian	Linux distributions, Debian, X86-64 Linux distributions
GNU	Operating systems, GNU project
Serbia	Serbia, European Union candidate states, 2006 establishments in Europe
Cancer	Cancer
Photography	Photography
Acronym	Acronyms
Radio wave	Wave physics, Radio technology, Electromagnetic radiation
Bridge	Basic English 850 words, Bridges
Mysticism	Theology, Reality
Ontario	Ontario, 1867 establishments in Canada, Provinces and territories of Canada
Manitoba	Manitoba, 1870 establishments in North America, 1870s establishments in Canada, Provinces and territories of Canada
Head of government	Heads of government
Saskatchewan	Saskatchewan, 1905 establishments in North America, 1900s establishments in Canada, Provinces and territories of Canada
Classical music	Music genres
SNAFU	Figures of speech, Acronyms
Atlanta	Atlanta, Georgia, Fulton County, Georgia, County seats in Georgia, State capitals in the United States, Olympic cities, 1837 establishments in Georgia (U.S. state)
Niccolò Machiavelli	1469 births, 1527 deaths, 16th century philosophers, Civil servants, Italian philosophers, Italian playwrights, Italian writers, People from Florence
Supply line	Military
Michigan	Michigan, 1837 establishments in the United States
Caenorhabditis elegans	Nematodes, Model organisms
Saxe-Weimar	States of the Confederation of the Rhine, States of the Holy Roman Empire, Thuringia, Weimar
Oldham	Oldham, Greater Manchester
Pakistan	Pakistan, 1947 establishments in Asia, British India, English-speaking countries, Federations, Members of the Organisation of Islamic Cooperation
New Zealand	New Zealand, Commonwealth realms, English-speaking countries, Australasia, Gondwana, Current monarchies
South Korea	South Korea, 1945 establishments in Asia
Republic of Ireland	Republic of Ireland, European Union member states, English-speaking countries, 1949 establishments in Europe
Vietnam	Vietnam, 1975 establishments in Asia
Lance Armstrong	1971 births, 2000 Summer Olympics, American adoptees, American cyclists, American Olympic bronze medalists, Cancer survivors, Doping cases in cycling, Living people, Sportspeople from Texas, Tour de France cyclists, People from Plano, Texas
Phoebe (moon)	Saturn's moons
Three Peaks Challenge	Mountain climbing
Pennsylvania	Pennsylvania, 1787 establishments in the United States
Box	Basic English 850 words, Containers
Philippines	Philippines, 1946 establishments in Asia
Fawlty Towers	1975 television series debuts, 1979 disestablishments, 1970s British sitcoms, 1970s British workplace television series, 1970s workplace comedy television series, BBC television sitcoms, British workplace comedy television series, Television series about marriage, Torquay, English-language television programs
Custom	Social sciences, Culture
Fort Ouiatenon	Buildings and structures in Indiana, 1717 establishments, 18th-century establishments in North America
Chennai	Chennai, 1661 establishments, 17th century establishments in India, 1660s establishments in England
Mumbai	Mumbai
Bangalore	Bangalore
Akbar the Great	1542 births, 1605 deaths, Akbar, History of India, Deaths from dysentery
New Delhi	New Delhi
Edmund Hillary	1919 births, 2008 deaths, Beekeepers, Deaths from myocardial infarction, Explorers, Mountain climbers, People from Auckland
Wright brothers	American aviators, American inventors, Sibling duos, Businesspeople from Dayton, Ohio
Charles Darwin	1809 births, 1882 deaths, Charles Darwin, Darwin family, Agnostics, Alumni of the University of Cambridge, British abolitionists, British zoologists, Cardiovascular disease deaths in England, Deaths from heart failure, English activists, English Anglicans, English botanists, English evolutionary biologists, English geologists, English naturalists, English science writers, People buried in Westminster Abbey, People from Shropshire
Adam Smith	1723 births, 1790 deaths, 18th century philosophers, British economists, British philosophers, Scottish scientists, Scottish writers
Isaac Newton	1643 births, 1727 deaths, English mathematicians, English physicists, English science writers, Fellows of the Royal Society, People buried in Westminster Abbey, Presidents of the Royal Society, Theoretical physicists, Writers from Lincolnshire
Johann Wolfgang von Goethe	1749 births, 1832 deaths, 18th century philosophers, 19th century philosophers, German autobiographers, German philosophers, German poets, Writers from Frankfurt
Pythagoras	580s BC births, 496 BC deaths, Presocratic philosophers, Ancient mathematicians
Socrates	460s BC births, 399 BC deaths, Ancient Greek philosophers, Executed people
Dante Alighieri	1265 births, 1321 deaths, Italian poets, Medieval poets, People from Florence, Writers from Tuscany
Virginia Woolf	1882 births, 1941 deaths, Bisexual people, British crime victims, British feminists, English LGBT people, English novelists, English playwrights, Feminist writers, LGBT feminists, LGBT novelists, People with bipolar disorder, Suicides by drowning, Suicides in the United Kingdom, Writers from London, Writers who committed suicide
March 28	Days of the year
January 25	Days of the year
Jane Austen	1775 births, 1817 deaths, Disease-related deaths in Hampshire, English novelists, Jane Austen, Writers from Hampshire
Charlotte Brontë	1816 births, 1885 deaths, Disease-related deaths in Yorkshire, English novelists, English poets, Writers from Yorkshire
Emily Brontë	1818 births, 1848 deaths, Deaths from tuberculosis, Disease-related deaths in Yorkshire, English novelists, English poets, Infectious disease deaths in England, Writers from Yorkshire
Anne Brontë	1820 births, 1849 deaths, Deaths from tuberculosis, Disease-related deaths in Yorkshire, English novelists, English poets, Infectious disease deaths in England, Writers from Yorkshire
Charles Dickens	Cardiovascular disease deaths in England, Deaths from stroke, English novelists, Unitarians, People buried in Westminster Abbey, People from Portsmouth, Writers from Hampshire, 1812 births, 1870 deaths
Portsmouth	Portsmouth, Ports and harbours of the United Kingdom
HMS Victory	British warships, Portsmouth
HMS Warrior (1860)	British warships, Portsmouth
Mary Rose	British warships, Portsmouth
1603	1603
April 28	Days of the year
Mutiny on the Bounty	History of the United Kingdom, Mutiny on the Bounty, 1789 works
1787	1787
August 16	Days of the year
December 23	Days of the year
1788	1788
October 25	Days of the year
1789	1789
April 4	Days of the year
May 28	Days of the year
Political virtues	Ethics
Lady Jane Grey	1537 births, 1554 deaths, 1550s in England, English Anglicans, Executed English people, House of Tudor, People executed by decapitation, Royalty from London
Tower of London	Castles in England, Buildings and structures in London, Royal residences in the United Kingdom, World Heritage Sites in the United Kingdom, Towers in the United Kingdom, London Borough of Tower Hamlets
Anne Boleyn	People executed by decapitation, House of Tudor, Kings and Queens consort of England, People from Norfolk, Executed English people, 1500s births, 1536 deaths
Mona Lisa	16th century paintings, Paintings by Leonardo da Vinci
December 14	Days of the year
1542	1542
February 13	Days of the year
January 31	Days of the year
1981	1981
Britney Spears	1981 births, Living people, Actors from Mississippi, American child singers, American movie actors, American pop musicians, Britney Spears, Grammy Award winners, Mouseketeers, Singers from Mississippi
The Matrix	1999 movies, 1999 science fiction movies, Matrix series, Drone movies, Transgender in movies, Warner Bros. movies, Post-apocalyptic movies, Dystopian movies
September 11 attacks	September 11 attacks
Cardiff	Cardiff
Valladolid	Capital cities in Spain, Valladolid
Elizabeth Gaskell	1810 births, 1865 deaths, Cardiovascular disease deaths in England, Deaths from myocardial infarction, English novelists, Writers from Cheshire, Writers from London
Venice	History of Italy, Venice, Regional capitals in Italy
Naples	Naples, Regional capitals in Italy, 6th-century BC establishments
Florence	Florence, Regional capitals in Italy, World Heritage Sites in Italy
Milan	Milan, Regional capitals in Italy
Glamorgan	Glamorgan
Cornwall	Cornwall, Ceremonial counties of England
Tintagel Castle	Castles in England
Gwyneth Paltrow	Actors from Los Angeles, California, American movie actors, American stage actors, American television actors, Screen Actors Guild Award winners, 1972 births, Living people
Sarah Michelle Gellar	1977 births, Actors from New York City, American movie actors, American television actors, American voice actors, Emmy Award winning actors, Living people, Whedonverse
Jennifer Garner	1972 births, Living people, American movie actors, Actors from Houston, Texas, Actors from West Virginia, American movie producers, American television actors, Golden Globe Award winners, Screen Actors Guild Award winners
Heather Graham	American movie actors, American television actors, Actors from Milwaukee, Wisconsin, 1970 births, Living people
Christina Ricci	1980 births, Actors from New Jersey, Actors from Santa Monica, California, American child actors, American movie actors, American voice actors, American television actors, Living people, People from Montclair, New Jersey
Julia Roberts	American movie actors, American movie producers, American television actors, Actors from Atlanta, Georgia, BAFTA Award winning actors, Best Actress Academy Award winners, Golden Globe Award winning actors, Screen Actors Guild Award winners, 1967 births, Living people, Converts to Hinduism
Angelina Jolie	1975 births, Living people, Academy Award winning actors, Satellite Award winners, Actors from Los Angeles, California, American movie actors, Bisexual people, LGBT actors, LGBT people from California, LGBT producers, Movie producers from Los Angeles, California, Saturn Award winners
Lisa Kudrow	1963 births, Living people, American movie actors, American television actors, Actors from Los Angeles, California, Screen Actors Guild Award winners, Emmy Award winning actors, Webby Award winners
Grace Kelly	Academy Award winning actors, Actors from Philadelphia, Pennsylvania, American movie actors, American stage actors, American television actors, Golden Globe Award winning actors, Road accident deaths, Deaths from stroke, 1929 births, 1982 deaths, Recipients of the Order pro merito Melitensi, Princes and princesses of Monaco
Elizabeth Taylor	1932 births, 2011 deaths, Actors from London, Actors from Los Angeles, California, American activists, American movie actors, American stage actors, American television actors, Cardiovascular disease deaths in the United States, Converts to Judaism, Deaths from congestive heart failure, English movie actors, English stage actors, English television actors, Jewish activists, Jewish American actors, Jewish British actors, Presidential Citizens Medal recipients, Former Roman Catholics, Knights and Dames Commander of the Order of the British Empire
Hilary Swank	1974 births, Living people, Academy Award winning actors, Actors from Nebraska, American movie actors, American television actors, Golden Globe Award winning actors, Screen Actors Guild Award winners, People from Lincoln, Nebraska, BBC 100 Women
Nana Visitor	American television actors, Actors from New York City, 1957 births, Living people
Alexander Siddig	Sudanese people, 1965 births, Living people
Eiffel Tower	Buildings and structures completed in the 19th century, Buildings and structures in Paris, Towers in Europe
Louvre	Art museums in France, Buildings and structures in Paris
Venus de Milo	Ancient Greece, Ancient Greek marble sculptures, Ancient Greek and Roman statues
Aphrodite	Twelve Olympians
Venus (mythology)	Roman gods and goddesses
Jupiter (mythology)	Roman gods and goddesses
Minerva	Roman gods and goddesses
Athena	Twelve Olympians, National personifications
Salt Lake City	Salt Lake City, County seats in Utah, State capitals in the United States, Olympic cities, 1847 establishments in the United States, 19th-century establishments in Utah
Nagano, Nagano	Cities in Japan, Olympic cities, Settlements in Nagano Prefecture
Barcelona	Barcelona, Olympic cities, Cities with more than a million inhabitants, Capital cities in Spain
Denise Lewis	Black British sportspeople, British female athletes, British Olympic bronze medalists, British Olympic gold medalists, Medalists at the 1996 Summer Olympics, Medalists at the 2000 Summer Olympics, Sports commentators, Sportspeople from West Midlands (county), Strictly Come Dancing participants, 1972 births, Living people
Michael Johnson	1967 births, Living people, African-American track and field athletes, American male athletes, American Olympic gold medalists, American track and field athletes, Sportspeople from Dallas, Texas, Sprinters
Bronze Age	Ancient history, Periods and ages in history
Louis XIV	1638 births, 1715 deaths, Deaths from gangrene, Kings and Queens of France, House of Bourbon, Dauphins and Dauphines of France, Princes of Andorra
Olympic Games	Olympic Games, Multi-sport events
Iron Age	Ancient history, Periods and ages in history
Entertainment	Entertainment, Media
Open Site	Encyclopedias, Learning, Websites
Coca-Cola	Coca-Cola, Atlanta, Georgia, Soft drinks
Sulfur	Chemical elements, Nonmetals
Aluminium	Aluminium
Drawing	Art
Texas	Texas, 1845 establishments in the United States
Prussia	1525 establishments, House of Hohenzollern, Prussia, States and territories disestablished in the 20th century, 1947 disestablishments, 16th century establishments in Europe, 1940s disestablishments in Europe
Sodium	Alkali metals, Chemical elements
Dice	Dice games
Matrix (mathematics)	Linear algebra
British Isles	British Isles
Mandarin Chinese	Sino-Tibetan languages, Tonal languages
Algeria	Algeria, Members of the Organisation of Islamic Cooperation, 1962 establishments in Africa
Plymouth	Unitary authorities in Devon, Plymouth, Devon, Ports and harbours of the United Kingdom
George Washington	1732 births, 1799 deaths, American deists, American esotericists, American generals, American revolutionaries, Businesspeople from Virginia, Chancellors of the College of William & Mary, Deaths from pneumonia, Episcopalians, Founding Fathers of the United States, Freemasons, George Washington, Military people from Virginia, Politicians from Virginia, 18th-century American politicians, Slavers
February 22	Days of the year
Abraham Lincoln	1809 births, 1865 deaths, Abraham Lincoln, American abolitionists, American lawyers, American murder victims, Assassinated United States Presidents, Deaths by firearm, Politicians from Springfield, Illinois, Politicians from Kentucky, United States representatives from Illinois, American Civil War, 19th-century American politicians
February 12	Days of the year
April 15	Days of the year
Calvin Coolidge	1872 births, 1933 deaths, Calvin Coolidge, Deaths from coronary thrombosis, US Republican Party politicians, Governors of Massachusetts, Politicians from Vermont, 20th-century American politicians, Massachusetts Republicans
Harry S. Truman	1884 births, 1972 deaths, American military personnel of World War I, American people of World War II, American Presbyterians, Anti-Communists, Colonels, Deaths from multiple organ failure, Deaths from pneumonia, Disease-related deaths in Missouri, Harry S. Truman, People from Independence, Missouri, People of the Korean War, Time People of the Year, United States senators from Missouri, US Democratic Party politicians, 20th-century American politicians
John Adams	1735 births, 1826 deaths, Ambassadors of the United States, American lawyers, American Protestants, American revolutionaries, Deaths from heart failure, Federalist party (US) politicians, Founding Fathers of the United States, Harvard University alumni, John Adams, Politicians from Massachusetts, Presidents of the United States, Signers of the U.S. Declaration of Independence, Unitarians, Vice Presidents of the United States, 19th-century American politicians, 18th-century American politicians
Bill Clinton	1946 births, Living people, 1992 United States presidential candidates, 1996 United States presidential candidates, 20th-century American politicians, 21st-century American politicians, Alumni of the University of Oxford, American Baptists, American lawyers, American LGBT rights activists, American progressives, American saxophonists, Governors of Arkansas, Hillary Rodham Clinton, Musicians from Arkansas, Musicians from New York City, People from Hope, Arkansas, Political scandals in the United States, Politicians from New York City, Rhodes scholars, Time People of the Year, US Democratic Party politicians, Writers from Arkansas, Writers from New York City, Yale University alumni
Yield	Finance
Moral purchasing	Ethics
Social network	Relationships, Social groups
Cabal	Forms of government
Creating	Art
Human science	Social sciences
Flaying	Torture, Punishments
Rice	Basic English 850 words, Rice
Yoga	Meditation, India
Human development theory	Economics
Cattle	Bovines, Domesticated animals, Basic English 850 words
Friend	Basic English 850 words
Thunder	Basic English 850 words, Weather, Severe weather
1	1
2	0s
3	0s
4	4
5	0s
6	0s
7	0s
8	0s
9	9
10	10s
11	10s
12	12
13	10s
30	30
50	50
3 (number)	Integers, Prime numbers
10 (number)	Integers
Man	Men, Basic English 850 words
Woman	Basic English 850 words, Women
Position	Basic English 850 words, Geometry
Arundel Castle	Castles in England, West Sussex
Religious Society of Friends	Protestantism
Size	Basic English 850 words, Measurement
Opposite	Basic English 850 words
Direction	Basic English 850 words
Starvation	Hunger, Food and drink
Microsoft Word	Microsoft Office, Word processors
Ant	Ants
Scissors	Basic English 850 words, Cutting tools
Malcolm IV of Scotland	1140s births, 1165 deaths, Kings and Queens of Scotland
David I of Scotland	1084 births, 1153 deaths, Kings and Queens of Scotland
Saint Margaret of Scotland	1045 births, 1093 deaths, Christian saints, Kings and Queens consort of Scotland
Alexander I of Scotland	1078 births, 1124 deaths, Kings and Queens of Scotland
Henry I of England	1068 births, 1135 deaths, Anglo-Normans, House of Normandy
William the Conqueror	1020s births, 1087 deaths, Kings and Queens of England, House of Normandy, Anglo-Normans, Dukes and duchesses, Accidental deaths
Matilda of Flanders	1031 births, 1083 deaths, House of Normandy, Kings and Queens consort of England
Robert II of France	972 births, 1031 deaths, Capetian dynasty, Kings and Queens of France, Orléans, People from Centre-Val de Loire
Adelaide of Aquitaine	945 births, 1004 deaths, Kings and Queens consort of France
William III of Aquitaine	915 births, 963 deaths, Dukes and Duchesses of Aquitaine
Basilica of Saint-Denis	Cathedrals in France, Île-de-France, 13th century establishments in Europe, Establishments in France
Gothic architecture	Gothic architecture
Cathedral	Cathedrals
Patron saint	Saints
Saint David	512 births, 587 deaths, British priests, British Roman Catholics, Christian saints, Roman Catholic bishops, Roman Catholic priests, Welsh Christians
Saint George	3rd century births, 303 deaths, Christian saints, England, Legends
Saint Andrew	Early Christian saints, Twelve Apostles, 1st century births, 1st century deaths
Saint Patrick	402 births, 490s deaths, Christian saints, Slaves
491	491
March 17	Days of the year
402	402
Somerset	Somerset, Ceremonial counties of England
Glastonbury	Towns in Somerset, Civil parishes in Somerset
Glastonbury Abbey	Abbeys, Somerset, Churches in England
Somerton	Towns in Somerset, Civil parishes in Somerset
Yeovil, Somerset	Towns in Somerset, County towns in England
Bridgwater	Towns in Somerset
Street	Basic English 850 words
Taunton	Towns in Somerset
Shepton Mallet	Towns in Somerset, Mendip
Bath, Somerset	Spa towns in the United Kingdom, World Heritage Sites in the United Kingdom, Bath, Somerset
Wells	Cities in Somerset, Mendip
East Coker, Somerset	Villages in Somerset
Tatworth	Villages in Somerset
Chard (Somerset)	Towns in Somerset
Crewkerne	Towns in Somerset, Civil parishes in Somerset
Stoford, Somerset	Villages in Somerset
River Tone	Rivers of England, Somerset
River Yeo	Rivers of England
River Adur	Rivers of England
River Aire	Rivers of England
River Aln	Rivers of England
River Alt	Rivers of England
River Yare	Rivers of England, Norfolk
River Exe	Rivers of England, Devon
Ilminster, Somerset	Towns in Somerset
South Cadbury	History of England, Somerset, Archaeological sites in England
Watchet	Towns in Somerset
Burnham-on-Sea	Towns in Somerset
Cheddar cheese	Cheeses
Yatton	Villages in Somerset
Backwell	Villages in Somerset
Nailsea	Towns in Somerset, Civil parishes in Somerset
Clevedon	Towns in Somerset
Weston-super-Mare	Towns in Somerset, Civil parishes in Somerset
South Somerset	District and borough councils in England, Somerset, 1974 establishments in England
Scone	Sweet breads
Ankara	Ankara
Johannes Gutenberg	1390s births, 1468 deaths, German inventors, People from Mainz, Publishers
Elizabeth I	1533 births, 1603 deaths, 1600s in England, 16th century in England, English Anglicans, House of Tudor, People excommunicated by the Catholic Church, Slavers
Cate Blanchett	Satellite Award winners, 1969 births, Living people, Actors from Melbourne, Australian movie actors, Australian stage actors, Australian television actors, Best Actress Academy Award winners, Best Supporting Actress Academy Award winners, BAFTA Award winning actors, Golden Globe Award winning actors, Screen Actors Guild Award winners
Kylie Minogue	1968 births, Living people, Actors from Melbourne, Australian child actors, Australian movie actors, Australian pop singers, Australian singer-songwriters, Australian television actors, Australian voice actors, Breast cancer survivors, Musicians from Melbourne, Officers of the Order of the British Empire, Officers of the Order of Australia
Natalie Imbruglia	Actors from Sydney, Australian movie actors, Australian pop musicians, Australian singer-songwriters, Australian television actors, Musicians from Sydney, Singers from New South Wales, 1975 births, Living people, Officers of the Order of Australia
Nicole Kidman	Academy Award winning actors, Actors from Honolulu, American movie actors, American movie producers, American television actors, American voice actors, Australian movie actors, Australian movie producers, Australian television actors, Australian voice actors, BAFTA Award winning actors, Golden Globe Award winning actors, 1967 births, Living people
Hugh Jackman	1968 births, Living people, Actors from Sydney, Australian movie actors, Australian movie producers, Australian singers, Australian stage actors, Australian television actors, Australian voice actors, Companions of the Order of Australia, Emmy Award winning actors, Golden Globe Award winning actors, Musical theater actors, People's Choice Award winners, Saturn Award winners, Skin cancer survivors, Television producers, Tony Award winning actors
Mel Gibson	Mel Gibson, 1956 births, Living people, Academy Award winning actors, Actors from New York, American movie actors, American television actors, Movie directors from New York, Movie producers from New York, Order of Australia, People from Peekskill, New York, People's Choice Award winners, Screenwriters from New York
Natalie Portman	1981 births, Living people, Academy Award winning actors, Actors from New York City, American movie actors, American television actors, American stage actors, American voice actors, Movie producers from New York City, Movie directors from New York City, Screenwriters from New York City, BAFTA Award winning actors, Golden Globe Award winning actors, Israeli movie actors, Israeli television actors, Israeli stage actors, Israeli movie producers, Israeli movie directors, Israeli screenwriters, Israeli voice actors, Israeli Jews, Jewish American actors, Naturalized citizens of the United States, People from Jerusalem, Saturn Award winners, Screen Actors Guild Award winners
Alyson Hannigan	1974 births, Living people, Actors from Atlanta, Georgia, Actors from Washington, D.C., American child actors, American movie actors, American television actors, American voice actors, Whedonverse
Jessica Alba	1981 births, Living people, Actors from Beverly Hills, California, American child actors, American movie actors, American television actors, American video game actors, American voice actors, Democrats (United States), Models from California, People from Pomona, California
Brad Pitt	People from Shawnee, Oklahoma, Saturn Award winners, Academy Award winning actors, Screen Actors Guild Award winners, Golden Globe Award winning actors, 1963 births, Living people, Actors from Oklahoma, Actors from Missouri, Movie producers from Missouri, American movie actors, People from Springfield, Missouri, American television actors, American voice actors
Jennifer Aniston	1969 births, Living people, Actors from Los Angeles, California, American movie actors, American television actors, American voice actors, Emmy Award winning actors, Golden Globe Award winning actors
Jennifer Love Hewitt	Actors from Texas, American child actors, American movie actors, American movie producers, American pop musicians, American television actors, American television producers, American voice actors, People from Waco, Texas, Singers from Texas, 1979 births, Living people
Katie Holmes	1978 births, Living people, Actors from Toledo, Ohio, American movie actors, American television actors, Scientologists
Sigourney Weaver	1949 births, Living people, American movie actors, American stage actors, American television actors, BAFTA Award winning actors, Golden Globe Award winning actors, Actors from New York City, American voice actors, HuffPost writers and columnists
Audrey Hepburn	1929 births, 1993 deaths, Deaths from appendix cancer, Actors from Brussels, BAFTA Award winning actors, Best Actress Academy Award winners, Cancer deaths in Switzerland, Deaths from colorectal cancer, English movie actors, English stage actors, English television actors, Golden Globe Award winning actors, Screen Actors Guild Award winners, Tony Award winning actors
Katharine Hepburn	1907 births, 2003 deaths, Actors from Hartford, Connecticut, American autobiographers, American LGBT people, American movie actors, American stage actors, American television actors, BAFTA Award winning actors, Best Actress Academy Award winners, Cancer deaths in Connecticut, Emmy Award winning actors, LGBT actors, Screen Actors Guild Award winners
Charles Kay Ogden	1889 births, 1957 deaths, English writers, English philosophers, Linguists
God Save the Queen	National anthems, British music, British monarchy
Lion	Panthera, Mammals of Africa, Felines
Galatasaray S.K.	Turkish football clubs
E	Vowel letters
I	Basic English 850 words, Vowel letters
O	Vowel letters
U	Vowel letters
Y	Vowel letters
Fuck	English profanity
Virus	Viruses, Parasites, Infectious diseases
Microprocessor	Electronic components, Microprocessor design
Heat	Basic English 850 words, Heat, Basic physics ideas, Thermodynamics
Shogun	History of Japan, Shoguns
Bratislava	Bratislava
Wellington	Capital cities in Oceania, Wellington, 1865 establishments, 1860s establishments in New Zealand
Biochemistry	Biochemistry
Sadness	Basic English 850 words, Emotions
Microeconomics	Microeconomics
Cryptography	Cryptography, Computer security, Computer science, Human communication
Tuesday	Days of the week
Wednesday	Days of the week
Thursday	Days of the week
Friday	Days of the week
Saturday	Days of the week
Laos	Laos, Least developed countries, 1949 establishments in Asia
Yes	Basic English 850 words
Amaterasu	Japanese deities, Shinto, National personifications
Organism	Biology, Organisms
Kinetic energy	Energy, Mechanics, Basic physics ideas
Potential energy	Energy, Basic physics ideas, Force
Ship	Basic English 850 words, Ships, Navigation
Boat	Boats
Navy	Navy
Air force	Air force
List of words about computers	Computing, Computer-related lists, Glossaries
Adware	Software
Gender	Gender
Dutch language	West Germanic languages, Languages of Europe
Creative Commons licenses	Software licences
Marshall Islands	Marshall Islands
Alphabet	Alphabet
County	Counties
New York University	Association of American Universities, Colleges and universities in New York City
Bee	Basic English 850 words, Bees, Symbols of Kansas
Dragonfly	Odonata
Wind	Basic English 850 words, Winds
Vertebrate	Vertebrates
Alpha male	Animals, Ethology
Singapore	Singapore, 1963 establishments in Asia
Johannesburg	Johannesburg, 1886 establishments, 1880s establishments in South Africa
Johannesburg Zoo	Zoos, Johannesburg, Buildings and structures completed in the 20th century
Breakfast	Meals
Town	Basic English 850 words, Towns
Condensed matter physics	Matter, Basic physics ideas
Bag	Basic English 850 words, Containers
Julius Caesar	100 BC births, 44 BC deaths, Assassinated people, Former dictators, Ancient Roman historians, European politicians, Murders by blade weapons, Roman generals
Sapporo	Olympic cities, Sapporo
Hokkaidō Prefecture	Hokkaido Prefecture
Hinduism	Hinduism, Indian religions
List of elements by symbol	chemical elements, Chemistry lists
Periodic table (big)	Periodic table
Periodic table (metals and non-metals)	Periodic table
Hernán Cortés	1485 births, 1547 deaths, Deaths from pleurisy, Spanish explorers, People from Extremadura
Bible study	Bible
Medlar	Mespilus germanica, Fruits, Amygdaloideae
Atheism	Religion, Philosophical movements and positions, Society, Lifestyles
Hippocrates	460 BC births, 377 BC deaths, Greek physicians, Ancient Greek philosophers, History of medicine
Commensurability	Philosophy of science
Harvest	Agriculture
ELISPOT	Biochemistry
List of biochemistry topics	Biochemistry, Chemistry lists
Aztecs	Aztec
Richard Nixon	1913 births, 1994 deaths, American lawyers, Cardiovascular disease deaths in the United States, Deaths from stroke, People from Whittier, California, People of the Vietnam War, Presidents of the United States, Quakers, Recipients of the Nishan-e-Pakistan, Richard Nixon, Time People of the Year, 1960 United States presidential candidates, 1964 United States presidential candidates, 1968 United States presidential candidates, 1972 United States presidential candidates, United States representatives from California, United States senators from California, US Republican Party politicians, Yorba Linda, California, 20th-century American politicians, Watergate scandal
Gerald Ford	1913 births, 2006 deaths, American adoptees, American lawyers, Cardiovascular disease deaths in the United States, Deaths from cardiac arrest, Deaths from cerebrovascular disease, Deaths from coronary artery disease, Gerald Ford, Politicians from Omaha, Nebraska, People of the Vietnam War, 1976 United States presidential candidates, United States representatives from Michigan, US Republican Party politicians, 20th-century American politicians, Minority leaders of the United States House of Representatives
John Kerry	1943 births, Living people, American military personnel of the Vietnam War, American Roman Catholics, Aurora, Colorado, 2004 United States presidential candidates, John Kerry, Politicians from Boston, Massachusetts, Politicians from Colorado, Purple Heart recipients, United States Secretaries of State, United States senators from Massachusetts, US Democratic Party politicians, Yale University alumni, 21st-century American politicians, 20th-century American politicians
White blood cell	Cell biology, Immunology, Blood cells
Lymphocyte	Cell biology, Immunology, Blood cells
Author	Writers
Pedipalp	Animal anatomy, Arachnids
Ionic compound	Chemistry
ELISA	Biochemistry
David Hume	1711 births, 1776 deaths, People from Edinburgh, 18th century philosophers
Bath	Home, Hygiene
Brush	Basic English 850 words, Tools
Starch	Carbohydrates
Thomas Hobbes	1588 births, 1679 deaths, 17th century philosophers, English philosophers
Trevi	Towns in Italy, Settlements in Umbria
Nicomachus	Given names
Logo	Symbols
Picture	Graphics
Building	Buildings and structures, Civil engineering
Candle	Light sources, Fire, Christian symbols
Salamander	Salamanders
Newt	Newts, Amphibians
Poison	Poisons, Basic English 850 words, Health
Powder	Materials, Cosmetics
Larva	Animals, Developmental biology
Amphibian	Amphibians
Father	Basic English 850 words, Family
Gill	Animal anatomy, Anatomy of the respiratory system
Frog	Frogs, Amphibians
Chemical compound	Chemical compounds
Wood	Basic English 850 words, Wood
Chalk	Basic English 850 words, Carbonate rocks, Writing tools, Cretaceous
Utilitarianism	Philosophical movements and positions, Ethics
Village	Villages
Chelmsford	Chelmsford, County towns in England
Gangnihessou	History of Africa, Kings and queens, 16th century births, 17th century deaths
Contract bridge	Contract bridge, Card games
No	Basic English 850 words
Leon Trotsky	1879 births, 1940 deaths, Government ministers, Jewish politicians, Jewish writers, Marxism, Murders by blade weapons, People murdered in North America, Political activists, Russian communists, Russian historians, Russian Jews, Russian murder victims, Russian politicians, Russian Revolution, Soviet Jews, Ukrainian Jews
Second International	International organizations, 1889 establishments, Political organizations, 1916 disestablishments
Devon	Devon, Ceremonial counties of England
Latin script	Ancient Rome, Latin alphabet
Insectivore	Animals
Copy	Basic English 850 words
Vapor	water
Vehicle	Vehicles
Line dance	Dance types
Three Kingdoms of Korea	History of Korea
Archduke Franz Ferdinand of Austria	1863 births, 1914 deaths, Archdukes and Archduchesses of Austria, Assassinated people, Habsburg Dynasty, Murders by firearm, World War I people
Black Hand	20th century in Europe, Serbia, 1911 establishments in Europe, 1910s establishments in Serbia
Edmonton	Edmonton
Autarky	Economics
Bonsai	Trees, Japanese culture
Chastity belt	BDSM
Mount Arafat	Hills, Holy places in Islam, Geography of Saudi Arabia
Ariel Sharon	1928 births, 2014 deaths, Deaths from renal failure, Deaths from stroke, Former Members of Knesset, Government ministers of Israel, Hebrew University of Jerusalem alumni, Israeli former political leaders, Israeli generals, Israeli opposition leaders, Jewish Israeli politicians, Jewish military people, Kadima politicians, Likud politicians, Prime Ministers of Israel, Tel Aviv University alumni
Jameson	Whisky
Syria	Syria, Members of the Organisation of Islamic Cooperation
Psychology	Psychology
Louisiana	Louisiana, 1812 establishments in the United States
Synonym	Words
Yosa Buson	1716 births, 1784 deaths, Japanese artists, Japanese poets, People from Osaka
Chopsticks	Food utensils
Telephone	Telephone
Checkers	Draughts, Board games
Kobe, Hyōgo	Cities in Japan, Settlements in Hyōgo Prefecture
Oradea	County capitals of Romania
Henry Ford	1863 births, 1947 deaths, Deaths from cerebral hemorrhage, Businesspeople from Michigan, Ford
George Orwell	1903 births, 1950 deaths, Deaths from tuberculosis, English novelists, English poets, Infectious disease deaths in England, People of British India, Pen names, Democratic socialists
Genghis Khan	1160s births, 1227 deaths, Mongolian people
Joseph Stalin	1878 births, 1953 deaths, Russian atheists, Deaths from stroke, Disease-related deaths in the Soviet Union, Former Christians, Former dictators, Politicians from Georgia (country), Joseph Stalin, Recipients of the Order of Lenin, Heads of government of the Soviet Union, Smallpox survivors, Soviet people of World War II, Time People of the Year, World War II political leaders
Antigua and Barbuda	Commonwealth realms, Antigua and Barbuda, 1981 establishments in North America, Caribbean Community
San Marino	San Marino, Italian-speaking countries
Philippe's	American restaurants, Buildings and structures in Los Angeles, California, Companies based in Los Angeles, 1908 establishments in the United States, 1900s establishments in California
Orbit	Orbits
Funeral	death customs
Georgian Uprising of Texel	1945 in Europe, 1940s in the Netherlands, Battles involving Canada, Battles involving Germany, Battles involving the Soviet Union, Battles involving the Netherlands, European battles of World War II, April 1945 events, May 1945 events, Texel
Neutrino	Astrophysics, Elementary particles
Play (theatre)	Plays
Phrasal verb	Parts of speech, English language
Season	Seasons, Units of time
Carisbrooke Castle	Isle of Wight, Castles in England
Atlantis	Greek mythology, Ancient history
Comparative	Grammar
US	Redirects from acronyms
Asbestos	Asbestos
Syllable	Grammar
Umbrella	Basic English 850 words, Tools
Usenet	Internet communication, Internet culture
Diagonal	Geometry
Kwashiorkor	Nutrition, Diseases and disorders of the digestive system, Hunger
Popocatépetl	Volcanoes of Mexico
North Sea	Seas of the Atlantic Ocean, Bodies of water of Europe
Letter	Basic English 850 words, Letters (alphabet), Typography
Anne Frank	1929 births, 1945 deaths, Anne Frank, Deaths from typhus, Diarists, German people of World War II, Holocaust victims, Infectious disease deaths in Germany, Jewish German writers, Refugees from Nazism, Writers from Amsterdam, Writers from Frankfurt
Jan Peter Balkenende	1956 births, Living people, Christian Democratic Appeal politicians, Dutch academics, Dutch Calvinists, Dutch councillors, Dutch jurists, Former leaders of political parties in the Netherlands, Former members of the House of Representatives of the Netherlands, Politicians from Zeeland, Prime Ministers of the Netherlands
Toleration	Politics
William the Silent	1533 births, 1584 deaths, Dutch royalty
Simón Bolívar	1783 births, 1830 deaths, Deaths from tuberculosis, Presidents of Colombia, Presidents of Venezuela, Presidents of Bolivia, Presidents of Peru, People with foods named after them, People from Caracas
Pythagorean theorem	Geometry
Temperature	Temperature, Weather measurements, Heat, Physical quantity, Thermodynamics, Basic physics ideas
Tux	Linux, Mascots, Penguins
Mein Kampf	Nazism, 1925 books
Computer graphics	Computer graphics
FC Bayern Munich	German Bundesliga, German football clubs, Sport in Munich, 1900 establishments in Germany
Cape of Good Hope	Capes, Geography of South Africa, Peninsulas
Hand washing	Healthy lifestyle
Franklin D. Roosevelt	1882 births, 1945 deaths, American lawyers, American people of World War II, Cardiovascular disease deaths in the United States, Deaths from cerebral hemorrhage, Disease-related deaths in Georgia (U.S. state), Franklin D. Roosevelt, Governors of New York, National Radio Hall of Fame inductees, Presidents of the United States, Time People of the Year, US Democratic Party politicians, World War II political leaders, 20th-century American politicians
Venezuela	Venezuela, Spanish-speaking countries, 1845 establishments, 1840s establishments in South America
Saudi Arabia	Saudi Arabia, Current monarchies, Members of the Organisation of Islamic Cooperation
Colombia	Colombia, Spanish-speaking countries, 1810 establishments, 1810s establishments in South America
Abel Tasman	1603 births, 1659 deaths, Dutch explorers, Exploration of Australia, People from Groningen (province)
Hard science	Science
Artificial intelligence	Artificial intelligence
Programmer	Computer science
Programming language	Programming languages
Visual Basic	Programming languages, IDEs, Microsoft software
Booting	Computing, Software
Tea	Tea
Interlingua	Interlingua
World	Geography
Azerbaijan	Azerbaijan, Caucasus, Azerbaijani republics, Members of the Organisation of Islamic Cooperation, 1991 establishments
Actor	Actors, Entertainment occupations
Al-Khwarizmi	780s births, 840s deaths, Muslims, Persian mathematicians, Astronomers
Ptolemy	100 births, 165 deaths, Ancient Greek astronomers, Greek geographers
Moctezuma II	1466 births, 1520 deaths, Mexican people, Emperors and empresses, Aztec
Antonio López de Santa Anna	1794 births, 1876 deaths, Mexican military people, People from Veracruz, Presidents of Mexico
Granzyme	Blood cells, Enzymes
Apartheid	20th century in South Africa, Crimes against humanity, Apartheid
Dreyfus Affair	19th century in France, Judaism in France, French military people, Espionage
Baseball	Baseball
Antonym	Words
Names of God in Judaism	Judaism
EFL Championship	English Football League, Football in England, 1888 establishments in England
Birmingham	Birmingham
Richmond, Virginia	Former national capitals, Richmond, Virginia, County seats in Virginia, State capitals in the United States, 1737 establishments, 1730s establishments in Virginia
American Civil War	American Civil War, Wars involving the United States, Rebellions in North America, 19th century rebellions
Tutankhamun	Pharaohs
Independence	Politics, Nationalism
Anubis	Egyptian gods and goddesses
Atum	Egyptian gods and goddesses
Antisemitism	Discrimination, Judaism
Esteban Huertas	Panamanian people, 1876 births, 1943 deaths
Panama	Panama, Spanish-speaking countries, 1903 establishments in North America
Spanish language	Spanish language
Nahuatl	Languages of Mexico, Aztec, Languages with ISO 639-2 code, Mesoamerica, Pre-Columbian cultures
Stephen Hawking	1942 births, 2018 deaths, Deaths from motor neurone disease, Disease-related deaths in the United Kingdom, People buried in Westminster Abbey, Astrophysicists, Commanders of the Order of the British Empire, Companions of Honour, English mathematicians, English physicists, English science writers, Fellows of the Royal Society, People from Oxford, Royal Society of Arts, Presidential Medal of Freedom recipients, Theoretical physicists, Writers from Hertfordshire, Writers from Oxfordshire
Czech Republic	1993 establishments in Europe, Czech Republic, European Union member states, Landlocked countries, States and territories established in the 1990s
Flag	Flags, Basic English 850 words, Messaging
Karaite Judaism	Jewish denominations
Warship	Warships, Ship types
Coast guard	Coast guards
Equilibrium market price	Microeconomics
Samba	Music genres, Latin dances
Nuclear weapon	Nuclear weapons
Chojnów	Cities in Poland
Comics	Art
Diamond	Diamonds, Birthstones, Carbon
Thanksgiving	Thanksgiving
Nobel Prize	Nobel Prize
Graph	Mathematics, Statistics, Graphics
Collision detection	Computer science
Berkeley Software Distribution	BSD
Jacques Cartier	1491 births, 1557 deaths, Explorers, People from Brittany
Vasco da Gama	1469 births, 1524 deaths, Portuguese explorers, Sailors, Explorers
Kayseri	Cities in Turkey
Iodised salt	Condiments
College	Types of educational institutions, Colleges and universities
Battery	Batteries
Knife	Basic English 850 words, Food utensils, Cutting tools, Blades
Nyngan, New South Wales	Towns in New South Wales
Photographic film	Photography
Compass	Tools, Navigation
Ferdinand Magellan	1480 births, 1521 deaths, Portuguese explorers, Sailors
Henry the Navigator	1394 births, 1460 deaths, Portuguese royalty, Princes and princesses
Concrete	Building materials, Materials
Marathon	Running
Holy Roman Empire	Holy Roman Empire, States and territories disestablished in the 19th century, 1806 disestablishments, 1800s disestablishments in Europe
Friesland	Friesland
Groningen (province)	Groningen (province)
Burgundy	Former administrative regions of France, Bourgogne-Franche-Comté
Duke	Dukes and duchesses
Latin	Latin language
Middle Ages	Middle Ages
Louis Bonaparte	1779 births, 1884 deaths, House of Bonaparte, Kings and Queens of the Netherlands, People from Corsica
Michiel de Ruyter	1607 births, 1676 deaths, Admirals, Dutch military people, People from Vlissingen
Johan Rudolf Thorbecke	1798 births, 1872 deaths, Dutch academics, Dutch jurists, Dutch Protestants, Former members of the House of Representatives of the Netherlands, Government ministers of the Netherlands, Lutherans, Politicians from Overijssel, Prime Ministers of the Netherlands, Writers from Overijssel
Karel Doorman	1889 births, 1942 deaths, Admirals, Dutch military personnel of World War II, Military people killed in World War II, People from Utrecht (city)
The Star-Spangled Banner	1814, 19th century American songs, National anthems, Songs about the United States, Symbols of the United States
Abdou Diouf	Presidents of Senegal, 1935 births, Living people, Prime Ministers of Senegal
Needle	Needles, Tools
February 3	Days of the year
Province	Provinces
Jade	Gemstones
Viktor Yushchenko	1954 births, Living people, Presidents of Ukraine, Prime Ministers of Ukraine, Economists, Bankers
Viktor Yanukovych	1950 births, Living people, Criminals, Engineers, Presidents of Ukraine, Prime Ministers of Ukraine, Ukrainian scientists
Salt	Basic English 850 words, Chemical compounds
Business	Basic English 850 words, Business
June 1	Days of the year
Junta	politics, military, Forms of government
Nezahualcoyotl	1402 births, 1472 deaths, Mexican people, Poets, Kings and queens, Aztec
Miguel Hidalgo	Mexican poets, People executed by firearm, 1753 births, 1811 deaths, Hidalgo (state)
Death penalty	Capital punishment, Punishments
Kofi Annan	1938 births, 2018 deaths, Disease-related deaths in Switzerland, African politicians, African diplomats, Ghanaian people, Knights Grand Cross of the Order of St Michael and St George, Order of Merit of the Federal Republic of Germany, Recipients of the Decoration for Services to the Republic of Austria
United Nations General Assembly	United Nations, 1946 establishments
Mining	Mining
Bomber	Bombers
Bull	Cattle
Huntingdon Life Sciences	1951 establishments in the United Kingdom, Cambridgeshire, Companies of the United Kingdom
Huntingdon	Towns in Cambridgeshire
Condom	Contraception
Osaka	Osaka, Former capitals of Japan
Piano	Piano, Keyboard instruments, Percussion instruments
Channel Islands	Channel Islands
Hedonism	Ethics, Philosophical movements and positions
Shinkansen	Shinkansen
Copper	Chemical elements, Metals
Prince	Princes and princesses
Princess	Princes and princesses, Stubs
Ore	Metals
Gainesville, Florida	Cities in Florida, County seats in Florida
University of Florida	Association of American Universities, Colleges and universities in Florida, Oak Ridge Associated Universities, Southeastern Conference, 1853 establishments in Florida
X-Men	Marvel Comics superheroes, Marvel Comics adapted into movies
Iron Man	Fictional characters introduced in 1963, Marvel Comics adapted into movies, Marvel Comics superheroes, Marvel vs. Capcom fighters, Tony Hawk's (series) guest characters
Andris Piebalgs	1957 births, Living people, European Commissioners, Latvian politicians
Augusto Pinochet	1915 births, 2006 deaths, Anti-Communists, Chilean military people, Deaths from congestive heart failure, Deaths from myocardial infarction, Deaths from pulmonary edema, Disease-related deaths in Chile, Former dictators, Generals, People from Valparaíso, Presidents of Chile
Plasma (physics)	States of matter, Astrophysics
Puebla (state)	Puebla (state), States of Mexico
Dan Aykroyd	Actors from Ottawa, Canadian movie actors, Canadian movie directors, Canadian movie producers, Canadian screenwriters, Canadian television actors, Canadian television producers, Canadian television writers, Canadian voice actors, Emmy Award winners, 1952 births, Living people, People on the autism spectrum
John Belushi	1949 births, 1982 deaths, Actors from Chicago, American Eastern Orthodox Christians, American movie actors, American television actors, Comedians from Chicago, Drug-related accidental deaths in the United States, Television personalities from Chicago
The Blues Brothers	1980 movies, 1980s criminal comedy movies, 1980s musical movies, 1980s road movies, American buddy movies, American criminal comedy movies, American musical comedy movies, American road movies, Chase movies, English-language movies, Movies set in Chicago, Illinois, Movies shot in Chicago, Illinois, Works about brothers, Universal Pictures movies, Movies directed by John Landis, United States National Film Registry movies
Arnhem	Arnhem, Cities in the Netherlands, Settlements in Gelderland, Provincial capitals of the Netherlands
KNIL	Army, History of the Netherlands
Bronbeek	Buildings and structures in the Netherlands, Arnhem
David Bowie	1947 births, 2016 deaths, Actors from London, Cancer deaths in New York City, David Bowie, Deaths from liver cancer, English movie actors, English rock singers, Musicians from London, Webby Award winners
1952	1952
Benito Mussolini	1883 births, 1945 deaths, Deaths by firearm in Italy, Former dictators, Former members of the Order of the Bath, Generals, Italian atheists, Italian military people, People executed by firearm, Politicians from Emilia-Romagna, Prime Ministers of Italy, World War II people
Puppet state	Politics, Puppet states
Banana republic	Politics
Banana Republic	1978 establishments in California, American clothing companies, Companies based in California
Kingdom of Holland	Puppet states, 19th century in the Netherlands
Victor Emmanuel III of Italy	1869 births, 1947 deaths, Kings and Queens of Italy, World War II people, Princes and Princesses of Savoy
Alter ego	Latin words used in English, Psychology, Human behavior
Ziggy Stardust	Fictional characters, David Bowie
The Spiders from Mars	English rock bands, David Bowie
Michael Schumacher	1969 births, Living people, Formula One drivers, Formula One current, German racecar drivers, Sportspeople from North Rhine-Westphalia
Yokohama	Cities in Kanagawa Prefecture, 19th century establishments in Japan
Axis countries	World War II, Nazi Germany, 20th century in Japan, 20th century in Italy, Military alliances
Icelandic language	Germanic languages, Languages of Europe
Passu	Geography of Kashmir, Villages in Pakistan, Gilgit-Baltistan
Equator	Lines of latitude
Rocket	Rockets, Ballistics
Advisor	People
MacOS	MacOS, Unix, BSD
Jacques Chirac	1932 births, 2019 deaths, French criminals, Prime Ministers of France, French Roman Catholics, Mayors of Paris, Presidents of France, Princes of Andorra, Recipients of the Decoration for Services to the Republic of Austria
Mario Jeckle	German computer scientists, 1974 births, 2004 deaths
Eighty Years' War	Eighty Years' War, Wars involving England, Wars involving France, Wars involving the Netherlands, Wars involving Spain, 1568, 16th century in Europe, 1648, 17th century in Europe
Exponent	Mathematics
Moresnet	1816 establishments in Europe, 1920 disestablishments in Europe, 19th century in Germany, Former countries in Europe, German Empire, History of Belgium, Liège (province), States and territories disestablished in the 20th century, States and territories established in the 19th century, Wallonia, Weimar Republic
MacGyver	1980s American television series, 1985 American television series debuts, 1990s American television series, 1992 American television series endings, 1992 television series endings, Action television series, Spy television series, English-language television programs
December 22	Days of the year
December 24	Days of the year
Quark	Quarks
Northern Hemisphere	Hemispheres
Yesterday	Basic English 850 words
Messiah	Christology, Islamic theology, Judaism, Jesus Christ
César Chávez	1927 births, 1993 deaths, People from California, American labor leaders, Nonviolence advocates, People from Arizona, Recipients of the Order of the Aztec Eagle
Hamilton, Ontario	Hamilton, Ontario
Shape	Shapes
Quechua	Languages of South America, Inca civilization
Drinking water	Water infrastructure
Pen	Basic English 850 words, Writing tools
Leet	Internet, Slang, Encodings
Waterfall	Waterfalls
Garden	Gardens, Plants, Basic English 850 words
Great Zimbabwe	History of Zimbabwe, Cities in Zimbabwe, World Heritage Sites in Africa, Prehistoric Africa, 11th-century establishments in Africa, 15th-century disestablishments
Machu Picchu	Inca civilization, World Heritage Sites in South America, 1450s establishments, Establishments in Peru, 1572 disestablishments, 16th century disestablishments in South America
Apple Inc.	1976 establishments in California, Apple Inc., Steve Jobs
Soil	Ecology, Geology, Natural resources, Soil
3D	Computing, Animation, Mathematics
Humidity	Meteorology, Weather measurements
Calabi-Yau manifold	Algebra, Geometry
Quantum mechanics	Basic physics ideas, Mechanics, Nuclear physics, Quantum mechanics
Duisburg	Imperial free cities, Urban districts in Regierungsbezirk Düsseldorf, Duisburg
Kuopio	Cities in Finland, Municipalities of Northern Savonia
Hammer	Basic English 850 words, Tools
Feces	Digestive system
Catholicism	Catholicism
Nail	Basic English 850 words, Hardware (mechanical)
Dictatorship	Forms of government
Electricity	Basic English 850 words, Electricity
Sailor Moon	Manga, Anime, Animated television series, 1995 television series debuts, 2000 television series endings
Anesthetic	Drugs, Pain
Fidel Castro	1926 births, 2016 deaths, Communist politicians, Cuban military people, Fidel Castro, Presidents of Cuba, Prime ministers, Socialists, People excommunicated by the Catholic Church
Latin America	North America, South America
Washington, D.C.	Washington, D.C., United States capital cities, 1790 establishments in the United States
President of the United States	Presidents of the United States
1948	1948
1949	1949
1950	1950
J. R. R. Tolkien	1892 births, 1973 deaths, J. R. R. Tolkien, Academics of the University of Oxford, Bloemfontein, British academics, Deaths from pneumonia, English novelists
Adolescence	Childhood
KDE	KDE
UK Independence Party	1993 establishments in the United Kingdom, Political parties in the United Kingdom, Nationalist organisations in the United Kingdom, Eurosceptic parties, Brexit
Space Oddity	1969 albums, Rock albums, Folk albums, David Bowie
Saxophone	Woodwind instruments, Jazz instruments
Bryophyte	Bryophytes, Non-vascular plants
Kent	Kent, Ceremonial counties of England
Gavrilo Princip	1894 births, 1918 deaths, Assassins, Deaths from tuberculosis, People who died in prison custody, Serbian people, World War I people
Formula	Mathematics
Independence and Democracy	European Parliament
Musician	musicians, Entertainment occupations
Carrot	Root vegetables, Apiaceae
Conservatism	Conservatism
Machine	Machines, Basic English 850 words, Engineering
Wario Land 4	2001 video games, Game Boy Advance games, Game Boy Advance-only games, Wario
Mrs. Doubtfire	1993 comedy-drama movies, 1990s family movies, 20th Century Fox movies, Academy Award winning movies, American comedy-drama movies, American family movies, Cross-dressing in movies, English-language movies, Golden Globe Award winning movies, Movies about entertainers, Movies about families, Movies based on books, Movies set in California, Movies that won the Best Makeup Academy Award, Movies about divorce, Movies directed by Chris Columbus
Super Mario 64 DS	Nintendo DS games, 3D platform games, Mario platform games, 2004 video games, Virtual Console games for Wii U
Epistemology	Epistemology
Ford Focus	2000s automobiles, Ford automobiles
Friends	1994 American television series debuts, 2004 American television series endings, 1990s American sitcoms, 1990s romance television series, 2000s American sitcoms, 2000s romance television series, Manhattan in fiction, NBC network shows, Romantic comedy television series, Television series about friendship, Television series about siblings, Television series set in New York City, English-language television programs
Seinfeld	1989 American television series debuts, 1998 American television series endings, 1980s American comedy television series, 1990s American comedy television series, American sitcoms, Emmy Award winning programs, Golden Globe Award winning programs, NBC network shows, Screen Actors Guild Award winners, Seinfeld, Television series set in New York City, English-language television programs
Joey (TV series)	2004 American television series debuts, 2006 American television series endings, 2000s American comedy television series, American sitcoms, NBC network shows, Television series about families, Television series set in Los Angeles, California, Television spin-offs, English-language television programs
Eastern Orthodox Church	Eastern Orthodox Church
Lisgar Collegiate Institute	Schools in Canada, 1874 establishments, 1870s establishments in Canada
Aberdeen	Aberdeen, Port cities and towns of Scotland, Port cities and towns of the North Sea
Psoriasis	Dermatology
Jurassic Park	20th century American novels, Books by Michael Crichton, Jurassic Park, Science fiction books, 1990 books, Dinosaurs in fiction, Fantasy books, Science fiction
H. G. Wells	1866 births, 1946 deaths, English novelists, Writers from Kent
Landseer (Continental-European type)	Dog breeds
Glasgow	Glasgow
Grampian	Scottish Council Areas
Scottish Borders	Scottish Council Areas
Central Region, Scotland	Scottish Council Areas
Dumfries and Galloway	Scottish Council Areas
Fife	Fife
Highland (council area)	Highland
Lothian	Scottish Council Areas
Strathclyde	Geography of Scotland
Tayside	Scottish Council Areas
Dundee	Dundee, Port cities and towns of Scotland, Port cities and towns of the North Sea
Oxford	County towns in England, Oxford
George VI	1895 births, 1952 deaths, Cancer deaths in England, Deaths from lung cancer, English Anglicans, English royalty, House of Windsor, Kings and Queens of the United Kingdom, People from Norfolk, Elizabeth II
Asia Minor	Middle East, Peninsulas
Zoroastrianism	Zoroastrianism
Science Olympiad	Science, Competitions, Events in the United States, 1982 establishments in the United States
Bookstore	Books, Shops
Lemonade	Drinks
Melting	Matter
September 11	Days of the year
Essex	Essex, Ceremonial counties of England
County town	County towns
Southend-on-Sea	Essex boroughs, Towns in Essex
Cumbria	Ceremonial counties of England, Cumbria, 1974 establishments in England
Bob Dylan	1941 births, Living people, Accordionists, American blues musicians, American country musicians, American folk musicians, American guitarists, American Nobel Prize winners, American rock musicians, American rock singers, Best Original Song Academy Award-winning songwriters, Jewish American musicians, Jewish Nobel Prize winners, Jews who converted to Christianity, Kennedy Center honorees, Multi-instrumentalists, Musicians from Minnesota, Nobel Prize in Literature winners, People from Duluth, Minnesota, Singers from Minnesota
Diana Ross	1944 births, African American actors, African-American singers, Diana Ross, Living people, People from Bessemer, Alabama, Singers from Alabama, Actors from Alabama, Actors from Detroit, Michigan, Singers from Detroit, Michigan
Enid Blyton	1897 births, 1968 deaths, British children's writers, Deaths from Alzheimer's disease, Disease-related deaths in London, Writers from London
Saint Denis	3rd century births, 272 deaths, Christian saints
Dragon	Legendary creatures
Inertia	Mechanics, Basic physics ideas
Sherlock Holmes	Characters in written fiction, Fictional British people, Arthur Conan Doyle
York	Unitary authorities, York
North Yorkshire	Ceremonial counties of England, North Yorkshire, 1974 establishments in England
Pig Latin	Constructed languages, Word games
Binary number	Numbers
Nickname	Names
Martin Luther King Jr.	Martin Luther King Jr., 1929 births, 1968 deaths, American Baptists, American civil rights activists, American murder victims, Writers from Atlanta, Georgia, American Nobel Prize winners, Boston University alumni, Christian ministers, Democratic socialists, Nonviolence advocates, Social democrats, Time People of the Year, Assassinated people, Murdered African-American people, Murders by firearm in the United States
Jumanji	1995 movies, Fantasy books, Movies based on books, English-language movies
Neopets	Online games, Entertainment websites
Queen Victoria	1819 births, 1901 deaths, Kings and Queens of the United Kingdom, Cardiovascular disease deaths in England, Deaths from cerebral hemorrhage, English Anglicans, House of Hanover, House of Saxe-Coburg and Gotha, Indian monarchs, Royalty from London
Freak the Mighty	1993 books
Daniel Handler	1970 births, Living people, Writers from San Francisco
Global warming	Energy, Climate change, Air pollution
House music	Electronic dance music
Ammonia	Nitrogen compounds
Alkali	Chemistry
The White Stripes	1990s establishments in Michigan, 1997 establishments in the United States, 1990s American music groups, 2000s American music groups, 2010s American music groups, 2011 disestablishments in the United States, American punk bands, American rock bands, Blues bands, Grammy Award winners, Musical duos, Musical groups disestablished in 2011, Musical groups established in 1997, Musical groups from Detroit, Michigan
Millennium Dome	Buildings and structures in London
Millennium	Units of time, Millennia
Outlook.com	Microsoft websites, E-mail, 1995 establishments in California
J. K. Rowling	1965 births, Living people, Alumni of the University of Exeter, British children's writers, English novelists, Harry Potter, Officers of the Order of the British Empire, Royal Society of Literature, Writers from Gloucestershire
Charmed	1998 American television series debuts, 2006 American television series endings, 1990s American drama television series, 2000s American drama television series, Charmed, Fantasy television series, Telekinesis in fiction, Television series about sisters, Television series set in San Francisco, WB network shows, English-language television programs, The WB original programming
Falkland Islands	Falkland Islands
Neil Armstrong	1930 births, 2012 deaths, American deists, American astronauts, American aviators, Apollo astronauts, Deaths from surgical complications, Deaths from hemorrhage, Scientists from Cincinnati, Ohio, Congressional Gold Medal recipients
Caretaker	Occupations
Samuel Beckett	1906 births, 1989 deaths, Crime victims, Deaths from emphysema, Disease-related deaths in France, Irish novelists, Irish poets, Irish theatre directors, Irish playwrights, Writers from Dublin, Irish Nobel Prize winners
Vegetarianism	Vegetarianism, Diets
British	United Kingdom
Think Quest	Websites
Terry Gilliam	1940 births, Living people, Actors from Minnesota, American cartoonists, American movie directors, British movie directors, Monty Python, Writers from Minnesota
John Cleese	1939 births, Living people, Actors from Somerset, Actors who played Q, Alumni of the University of Cambridge, BAFTA Award winning actors, Emmy Award winning actors, English comedians, English movie actors, English movie producers, English radio actors, English screenwriters, English stage actors, English television actors, English television personalities, English television producers, English television writers, English voice actors, Monty Python, Naturalized citizens of the United States, Writers from Somerset
Arthur Conan Doyle	1859 births, 1930 deaths, Scottish writers, Knights of Grace of the Order of St John, Arthur Conan Doyle, Former Roman Catholics
Muslims	Muslims, Islam, Quranic words and phrases, Religious identity
Ray Charles	1930 births, 2004 deaths, Deaths from hepatitis, Deaths from liver failure, Actors from Florida, Actors from Georgia (U.S. state), African American actors, African American musicians, American jazz musicians, American movie actors, American R&B singers, American R&B musicians, American singer-songwriters, American soul musicians, American television actors, Kennedy Center honorees, Musicians from Georgia (U.S. state), Musicians from Florida, Singers from Florida, Singers from Georgia (U.S. state), People from Albany, Georgia, Atlantic Records artists, Warner Bros. Records artists
Jalisco	Jalisco, States of Mexico
Ferrari	Ferrari, Italian automobile companies
Fiat	1899 establishments in Europe, Italian automobile companies, Turin, 1890s establishments in Italy
Daihatsu	Toyota, 1907 establishments in Asia, 1900s establishments in Japan
Hydrocarbon	Hydrocarbons
Shanghai	Shanghai
Hunter S. Thompson	1937 births, 2005 deaths, American journalists, American novelists, Suicides by firearm in the United States, Writers from Louisville, Kentucky, Writers who committed suicide
Johnny Depp	1963 births, Living people, Actors from Kentucky, Actors from Florida, American movie actors, American movie directors, American stage actors, American television actors, American voice actors, Musicians from Kentucky, People from Owensboro, Kentucky, Screen Actors Guild Award winners
Uncle John's Bathroom Reader	Series of books, Non-fiction books
Catalonia	Catalonia
Civil engineering	technology, construction, Civil engineering
Comparison	Basic English 850 words
Golden Gate Bridge	Buildings and structures completed in the 20th century, Buildings and structures in San Francisco, Seven Wonders of the Modern World, Steel bridges, Suspension bridges, Marin County, California, Landmarks in San Francisco, 1937 establishments in the United States, 1930s establishments in California, California Historical Landmarks, Bridges in the San Francisco Bay Area
Kitchen	Rooms
Software engineering	Software, Engineering, Computer science
Student	Learning, People
Suburb	Cities
Skyscraper	Skyscrapers
Integer	Number theory, Integers, Mathematics
Natural number	Number theory
Golden Rule	Religion, Philosophy, Phrases
Leicester	Leicester, Unitary authorities
Hollywood	Movie industry, Neighborhoods of Los Angeles
Saturday Night Live	1975 American television series debuts, 1970s American comedy television series, 1980s American comedy television series, 1990s American comedy television series, 2000s American comedy television series, 2010s American comedy television series, Entertainment in New York City, NBC network shows, Emmy Award winning programs, English-language television programs
Elvis Presley	1935 births, 1977 deaths, Presidential Medal of Freedom recipients, Actors from Memphis, Tennessee, Actors from Mississippi, American country musicians, American movie actors, American rock musicians, American rock singers, Cardiovascular disease deaths in Tennessee, Deaths from myocardial infarction, Elvis Presley, Singers from Memphis, Tennessee, Singers from Mississippi, Former Roman Catholics, People from Tupelo, Mississippi
Sherwood Forest	Forests of England, Nottinghamshire
Mount Everest	Himalayas, Mountains of China, Mountains of Nepal, Tibet
Luanda	Cities in Angola, Capital cities in Africa, 1575 establishments, Establishments in Angola, Establishments in Portugal
Pepsi	Soft drinks
Penguin	Penguins, Flightless birds, Animals of Antarctica
March 6	Days of the year
1953	1953
1820	1820
Cannibalism	Cannibalism
May 29	Days of the year
Halloween	Holidays
Frida Kahlo	1907 births, 1954 deaths, Bisexual people, Communists, Deaths from pulmonary embolism, Deaths from bronchopneumonia, Disease-related deaths in Mexico, LGBT artists, Mexican painters, People with disabilities
1932	1932
Fear and Loathing in Las Vegas	1971 books, 20th century American novels, Las Vegas, Nevada in fiction, Works about drugs, Autobiographies
Graham Chapman	1941 births, 1989 deaths, Cancer deaths in England, Deaths from oropharyngeal cancer, Disease-related deaths in Kent, English comedians, English movie actors, English physicians, English screenwriters, English television actors, English television writers, Entertainers from Leicestershire, Gay men, Monty Python, People from Leicester, Writers from Leicestershire
Michael Palin	1943 births, Living people, Actors from Yorkshire, Alumni of the University of Oxford, BAFTA Award winners, British television writers, Comedians from Yorkshire, English movie actors, English television actors, English television presenters, English voice actors, Entertainers from Sheffield, Monty Python, Television personalities from Yorkshire, Writers from Yorkshire
Terry Jones	1942 births, 2020 deaths, British historians, British screenwriters, Deaths from primary progressive aphasia, Monty Python, Welsh movie actors, Welsh television actors
New York (state)	New York, 1788 establishments in the United States
Rolling Stone	1967 establishments in the United States, American magazines, Music magazines
Ralph Steadman	Cartoonists, British illustrators, 1949 births, Living people, People from Manchester
Tunisia	Tunisia, Members of the Organisation of Islamic Cooperation, 1956 establishments in Africa
1972	1972
1979	1979
Malaysia	1963 establishments in Asia, States and territories established in the 1960s, Current monarchies, Malaysia, Members of the Organisation of Islamic Cooperation
Mickey Mouse	Fictional mice and rats, Kingdom Hearts characters, Mickey Mouse universe characters
HIV	Sexually transmitted diseases, Viruses, HIV/AIDS
Frank Zappa	Actors from Baltimore, Maryland, Actors from California, Actors from Florida, American jazz musicians, American rock guitarists, American songwriters, American television actors, Cancer deaths in the United States, Deaths from prostate cancer, Multi-instrumentalists, Musicians from California, Musicians from Florida, Musicians from Maryland, 1940 births, 1993 deaths
Tasmania	Tasmania, Australasia, Gondwana, Islands of Australia
M*A*S*H	1972 television series debuts, 1983 disestablishments in the United States, 1970s American workplace television series, 1970s workplace comedy television series, 1980s American workplace television series, 1980s workplace comedy television series, 1980s workplace drama television series, American black comedy movies, American comedy-drama movies, American comedy-drama television series, American novels, American war movies, American workplace comedy television series, American workplace drama television series, Black comedy television series, English-language movies, Korean War, Movies set in the 1950s
Donald Sutherland	1935 births, Living people, Academy Award Honorary Award winners, Canadian movie actors, Canadian movie producers, Canadian stage actors, Canadian television actors, Canadian voice actors, Emmy Award winning actors, Golden Globe Award winning actors, Order of Canada, People from New Brunswick, Satellite Award winners
Paul Martin	1938 births, Living people, Privy Councillors (Canada), Members of the House of Commons of Canada from Quebec, Politicians from Montreal
Machine gun	Machine guns
Robin Hood	Robin Hood
Basketball	Basketball, Springfield, Massachusetts, Summer Olympic sports
Folk hero	Folklore
January 1	Days of the year
Seth Green	American television actors, American movie actors, American voice actors, Whedonverse, Actors from Philadelphia, Pennsylvania, Comedians from Pennsylvania, 1974 births, Living people
Ashton Kutcher	Actors from Iowa, American movie actors, American movie producers, American television actors, American television personalities, American television producers, Comedians from Iowa, Actors from Cedar Rapids, Iowa, Twin people from the United States, 1978 births, Living people, People's Choice Award winners
Linus Torvalds	1969 births, Living people, Finnish scientists, Computer scientists, Linux, People from Helsinki, American bloggers
Thomas Jefferson	1743 births, 1826 deaths, American deists, Deaths from uremia, American revolutionaries, Businesspeople from Virginia, Deaths from pneumonia, Democratic Republican party (US) politicians, Founding Fathers of the United States, Governors of Virginia, Presidents of the United States, Signers of the U.S. Declaration of Independence, Thomas Jefferson, United States Secretaries of State, Vice Presidents of the United States, 19th-century American politicians, 18th-century American politicians
Tahiti	Islands of French Polynesia
Geneva (canton)	Canton of Geneva
H. John Heinz III	1938 births, 1991 deaths, Aviation deaths in the United States, Politicians from Pittsburgh, Pennsylvania, United States representatives from Pennsylvania, United States senators from Pennsylvania, US Republican Party politicians
The Tempest	Plays by William Shakespeare
Calendar	Calendars
Randall Cobb	American boxers, American movie actors, Sportspeople from Texas, Actors from Texas, 1950 births, Living people
Aquilino Pimentel Jr.	1933 births, 2019 deaths, Deaths from pneumonia, Deaths from lymphoma, Presidents of the Senate of the Philippines, Majority leaders of the Senate of the Philippines, Minority leaders of the Senate of the Philippines, Legislative speakers
Pat Robertson	1930 births, Living people, American activists, American Baptists, American conservatives, Anti-Communists, Anti-pornography activists, Christian religious leaders, Southern Baptist Convention, Television evangelists, 1988 United States presidential candidates, Zionists
Full House	1987 American television series debuts, 1995 television series endings, 1980s American television series, 1990s American television series, 1990s American sitcoms, Television series set in San Francisco, 1980s American sitcoms, English-language television programs
1888	1888
Hot Press	Music magazines
Alabama Song	1930s songs, 1930 works
The Doors	1965 establishments in California, 1960s American music groups, 1970s American music groups, 1973 disestablishments, 1970s disestablishments in California, American rock bands, Musical groups disestablished in the 1970s, Musical groups established in 1965, Musical groups from Los Angeles, California
Mickey Gilley	1936 births, Living people, Musicians from Louisiana, Singers from Louisiana, American country singers, American country musicians
Jerry Lee Lewis	American rock musicians, Country musicians, Musicians from Louisiana, Singers from Louisiana, Singers from Mississippi, Musicians from Mississippi, 1935 births, Living people
Jimmy Swaggart	1935 births, Living people, American Pentecostals, People from Louisiana, Television evangelists
Johnny Cash	1932 births, 2003 deaths, Actors from Arkansas, American Baptists, American country musicians, American gospel musicians, American guitarists, American movie actors, American singer-songwriters, American television actors, American writers, Country guitarists, Deaths from diabetes, Disease-related deaths in the United States, Johnny Cash, Musicians from Arkansas, American gospel singers
Pluto (mythology)	Roman gods and goddesses
Maoism	Politics of the People's Republic of China, Marxism
C++	Programming languages
Korean War	Korean War, Cold War, Wars involving Australia, Wars involving Belgium, Wars involving Canada, Wars involving France, Wars involving Greece, Wars involving New Zealand, Wars involving South Africa, Wars involving the Netherlands, Wars involving the United Kingdom, Wars involving the United States, 1950s in Asia
John Landis	1950 births, Living people, Actors from Chicago, Actors from Los Angeles, California, American movie actors, American television actors, American television directors, American television producers, Movie directors from Los Angeles, California, Movie directors from Chicago, Movie producers from Los Angeles, California, Movie producers from Chicago, Screenwriters from Chicago, Screenwriters from Los Angeles, California
March 21	Days of the year
Edith Massey	American movie actors, 1918 births, 1984 deaths, Actors from San Francisco
Statue of Liberty	Statues, Buildings and structures in Manhattan, New York City Designated Landmarks, World Heritage Sites in the United States, Symbols of the United States
1875	1875
Ankst	British record labels, 1988 establishments in the United Kingdom, 20th century establishments in Wales
1988	1988
April 1	Days of the year
January 8	Days of the year
October 4	Days of the year
February 11	Days of the year
T. S. Eliot	1888 births, 1965 deaths, Alumni of the University of Oxford, American Christians, American essayists, American literary critics, American playwrights, American poets, British Anglicans, British essayists, British Nobel Prize winners, British playwrights, British poets, Deaths from emphysema, Disease-related deaths in England, Harvard University alumni, Literary critics, Naturalised citizens of the United Kingdom, Order of Merit, Writers from St. Louis, Missouri
Andrew Lloyd Webber	1948 births, Living people, Academy Award winning composers, Alumni of the University of Oxford, Cancer survivors, Emmy Award winners, English theatre directors, English composers, Golden Globe Award winning composers, Theatre producers, Grammy Award winners, Members of the House of Lords, People educated at Westminster School, London, Television personalities from London, Tony Award winners, Best Original Song Academy Award-winning songwriters
October 24	Days of the year
Bob Kane	Writers from New York City, American cartoonists, American comics artists, American comics writers, American entertainers, DC Comics, Batman, 1915 births, 1998 deaths
Batman	Batman, DC Comics adapted into movies, Fictional characters introduced in 1939, Fictional orphans, Justice League, DC Comics superheroes
Val Kilmer	1959 births, Living people, Cancer survivors, Actors from Los Angeles, California, Actors who played Batman, Christian Scientists, American movie actors, American television actors, American voice actors, American stage actors
Eva Gabor	Actors from Budapest, American movie actors, American television actors, American voice actors, Deaths from pneumonia, Hungarian movie actors, Hungarian television actors, Infectious disease deaths in California, 1919 births, 1995 deaths
Snoopy	Fictional dogs
John Wilkes Booth	1838 births, 1865 deaths, Abraham Lincoln, Actors from Maryland, American murderers, American stage actors, Assassins, People shot dead by law enforcement officers in the United States
Annapolis, Maryland	Former capitals of the United States, Annapolis, Maryland, County seats in Maryland, State capitals in the United States, 1640s establishments in the Thirteen Colonies
Keanu Reeves	1964 births, Living people, Actors from Toronto, Canadian movie actors, Canadian television actors, Native Hawaiians
Kurt Cobain	1967 births, 1994 deaths, American rock guitarists, American rock singers, Drug-related suicides in the United States, Musicians from Washington, Musicians who committed suicide, Nirvana members, People from Aberdeen, Washington, People with bipolar disorder, Suicide in the 1990s, Suicides by firearm in the United States
Mikhail Gorbachev	1931 births, Living people, Grammy Award winners, Mikhail Gorbachev, Order of Merit of the Federal Republic of Germany, Recipients of the Order of Lenin, Russian communists, Russian lawyers, Russian Nobel Prize winners, Russian politicians, Soviet politicians, Time People of the Year
Tron	1982 science fiction movies, American science fiction movies, Cult movies, Disney movies, English-language movies
Garfield	Comic strips
Michael Moore	American Roman Catholics, American movie directors, American movie producers, American political commentators, American journalists, American historians, American activists, Writers from Michigan, People from Flint, Michigan, 1954 births, Living people
Hawaiian Punch	Drinks
Whale	Cetaceans
Marker	Art, Writing tools
Anchor	Ship building, Boats
Light pollution	Light, Pollution
Nintendo	1889 establishments, Nintendo, 1880s establishments in Japan
São Paulo	São Paulo, Capitals of Brazilian states, 1550s establishments in South America, 16th-century establishments in Brazil, 1554 establishments
Tim Burton	1958 births, Living people, American movie directors, American movie producers, American television directors, American television producers, Movie directors from Los Angeles County, California, Movie producers from Los Angeles County, California, Naturalised citizens of the United Kingdom, People from Burbank, California, People with bipolar disorder, Screenwriters from California, Writers from Los Angeles County, California
DVD	Optical discs
Submarine	Warships
Lebanon	Lebanon, Members of the Organisation of Islamic Cooperation, 1943 establishments, Beirut, Population
Alan Alda	1936 births, Living people, Actors from New York City, American movie actors, American television actors, Emmy Award winning actors, Emmy Award winning directors, Golden Globe Award winning actors
Sally Kellerman	1936 births, Living people, Actors from Long Beach, California, American movie actors, American television actors
Hagar the Horrible	Comic strips, Comics characters
Baghdad	Baghdad, 762 establishments, 8th century establishments in Iraq, 760s establishments in Asia
Mediterranean Sea	Oceanography, Seas of the Atlantic Ocean, Bodies of water of Africa, Bodies of water of Asia, Bodies of water of Europe
Shirley Bassey	1937 births, Living people, Black British musicians, Musicians from Cardiff, Welsh pop singers
Captain Beefheart	Singers from Los Angeles, California, American rock musicians, People with multiple sclerosis, Deaths from multiple sclerosis, 1941 births, 2010 deaths, Multi-instrumentalists
December 30	Days of the year
C (programming language)	Programming languages
Drake & Josh	2000s American sitcoms, Nickelodeon television series, 2004 American television series debuts, 2007 American television series endings, English-language television programs
The Amanda Show	Comedy television series, Nickelodeon television series, 1999 American television series debuts, Television spin-offs, English-language television programs
1983	1983
Sally Ride	American astronauts, American physicists, Cancer deaths in San Diego County, Deaths from pancreatic cancer, LGBT people from Los Angeles, California, LGBT scientists, Scientists from Los Angeles, California, 1951 births, 2012 deaths
Court	Courts (law)
Birth	Pregnancy and childbirth
Pollution	Pollution
Immunity (medical)	Immunology
Roman numerals	Ancient Rome, Numerals
Map	Basic English 850 words, Cartography, Survival skills, Tools
Globe	Cartography
Noah	Old Testament people
1452	1452
Ned's Declassified School Survival Guide	Nickelodeon television series, English-language television programs, 2004 television series debuts, 2007 television series endings
VH1	American television networks, Companies based in New York City, Music media, Cable television
Cabinet	Government
Newspaper	Newspapers, Printing, Reference works
1833	1833
July 4	Days of the year
Public domain	Intellectual property law
Child	Children, Basic English 850 words
Nickelodeon	Nickelodeon, American television networks, Viacom
Jimmy Carter	American Nobel Prize winners, Governors of Georgia (U.S. state), Jimmy Carter, American progressives, Cancer survivors, Presidents of the United States, Time People of the Year, 1976 United States presidential candidates, 1980 United States presidential candidates, US Democratic Party politicians, 1924 births, Living people, 20th-century American politicians
Cannes	Cannes
Theodore Roosevelt	1858 births, 1919 deaths, American environmentalists, American military personnel of the Spanish-American War, American Nobel Prize winners, American progressives, Deaths from pulmonary embolism, Cardiovascular disease deaths in the United States, Civil servants, Colonels, Governors of New York, Politicians from New York, Theodore Roosevelt, United States Army Medal of Honor recipients, US Republican Party politicians, 20th-century American politicians, 19th-century American politicians
Composer	Composers
Cannes Film Festival	Cannes, Entertainment in France, Festivals in Europe, Lists of movies, Movie festivals, 1939 establishments, 1930s establishments in France
Henry VIII	1491 births, 1547 deaths, 1500s in Europe, 1510s in Europe, 1520s in Europe, 1530s in Europe, 1540s in Europe, 16th century in England, English Anglicans, English royalty, Former Roman Catholics, House of Tudor, People excommunicated by the Catholic Church, People from Kent
Orchestra	Orchestras
Homosexuality	LGBT variations
Dwight D. Eisenhower	1890 births, 1969 deaths, American military personnel of World War I, American military personnel of World War II, Deaths from congestive heart failure, Cardiovascular disease deaths in Washington, D.C., Dwight D. Eisenhower, Honorary Knights Grand Cross of the Order of the Bath, Military-industrial complex, Military people from Texas, Order of Merit, Politicians from Texas, Recipients of the Nishan-e-Pakistan, Recipients of the Order of the Aztec Eagle, Recipients of the Order pro merito Melitensi, Time People of the Year, US Republican Party politicians, 20th-century American politicians, Kansas Republicans, People from Denison, Texas
Ball	Basic English 850 words
Ferrocement	Construction
Camera lens	Camera lenses
Boy	Basic English 850 words, Humans, Childhood
Company clerk	Occupations
Paul McCartney	Paul McCartney, 1942 births, Living people, British bass guitarists, English guitarists, English pianists, English singer-songwriters, English composers, Grammy Award winners, Kennedy Center honorees, Musicians from Liverpool, The Beatles members, Knights Bachelor, Companions of Honour, Members of the Order of the British Empire
Afrikaner people	South African people
John Lennon	1940 births, 1980 deaths, English guitarists, English pianists, English murder victims, English rock singers, English singer-songwriters, John Lennon, Murdered musicians, Murders by firearm in the United States, Musicians from Liverpool, Nonviolence advocates, The Beatles members, Members of the Order of the British Empire, People murdered in New York, Former Roman Catholics
Invention	Basic English 850 words
Genocide	Genocide, Ethnicity
Yoko Ono	1933 births, Feminists, Grammy Award winners, Living people, Japanese artists, Musicians from Tokyo, HuffPost writers and columnists, John Lennon
Coast	Landforms
George Harrison	1943 births, 2001 deaths, Cancer deaths in Los Angeles, Deaths from throat cancer, Deaths from lung cancer, English guitarists, Musicians from Liverpool, The Beatles members, Former Roman Catholics
Ravi Shankar	Indian musicians, 1920 births, 2012 deaths
Sentence	Sentences
James Joyce	Irish novelists, Irish poets, Works of James Joyce, Writers from Dublin, 1882 births, 1941 deaths
May 1	Days of the year
Andes	Andes, Mountains of South America
February 21	Days of the year
Meal	Meals
Leipzig	Leipzig
1351	1351
January 30	Days of the year
Evil	Ethics, Logic, Philosophy, Theology
1872	1872
Poznań	Poznań
Cartoonist	Cartoonists
Jim Henson	1936 births, 1990 deaths, Actors from Mississippi, American artists, American movie directors, American movie producers, American television actors, American television directors, American television producers, American television writers, Puppeteers, American voice actors, Deaths from pneumonia, Deaths from multiple organ failure, Deaths from sepsis, Infectious disease deaths in New York City, Muppets, Writers from Mississippi, Emmy Award winners
Game Boy Advance Video	Game Boy
Butterfly	Butterflies
Nazism	Nazism
Pork	Pork
Mike Farrell	American movie actors, American voice actors, American stage actors, American television actors, American political activists, American human rights activists, Democrats (United States), Actors from Saint Paul, Minnesota, Screenwriters from Los Angeles, California, Movie producers from Los Angeles, California, Movie directors from Los Angeles, California, Actors from Los Angeles, California, Writers from Saint Paul, Minnesota, 1939 births, Living people
David Ogden Stiers	1942 births, 2018 deaths, Actors from Illinois, Actors from Oregon, American movie actors, American television actors, American voice actors, American television directors, Cancer deaths in the United States, Deaths from bladder cancer, Democrats (United States), Disease-related deaths in Oregon, Gay men, LGBT actors, LGBT people from Illinois, People from Peoria, Illinois
Beauty and the Beast	Fairy tales
Wayne Rogers	1933 births, 2015 deaths, Deaths from pneumonia, American movie actors, American television actors, Actors from Birmingham, Alabama
McLean Stevenson	1929 births, 1996 deaths, Deaths from bladder cancer, Deaths from myocardial infarction, American movie actors, American television actors, American stage actors, American television presenters, Actors from Illinois, Golden Globe Award winning actors, People from Normal, Illinois
Friedrich Georg Wilhelm von Struve	1793 births, 1864 deaths, Russian astronomers
Mario Party (series)	Mario Party games
Helsinki	Helsinki, Olympic cities, 1550s establishments in Europe, 16th century establishments in Finland, 1550 establishments
Jehovah's Witnesses	Jehovah's Witnesses, 1930s establishments in the United States
Wife	Family
Catherine Parr	1512 births, 1548 deaths, English Anglicans, English Roman Catholics, Former Roman Catholics, Kings and Queens consort of England, Royalty from London
Queen (band)	1970 establishments in England, 1970s British music groups, 1980s British music groups, 1990s British music groups, 2000s British music groups, 2010s British music groups, English rock bands, Musical groups established in 1970, Musical groups from London, Queen (band)
Simon & Garfunkel	Musical groups from New York City, American rock bands, Folk music groups
Madagascar	Madagascar, States and territories established in the 1960s, Gondwana, Least developed countries, 1960 establishments in Africa
Board game	Board games
Aerosmith	1970 establishments in the United States, 1970s establishments in Massachusetts, 1970s American music groups, 1980s American music groups, 1990s American music groups, 2000s American music groups, 2010s American music groups, Aerosmith, American rock bands, Musicians from Boston, Massachusetts, Musical groups established in 1970, Musical groups from Massachusetts
Brighton	Brighton
April 20	Days of the year
Vincent van Gogh	1853 births, 1890 deaths, Artists who committed suicide, Dutch painters, Missionaries, People from North Brabant, Suicides by firearm, Suicides in France
April 2	Days of the year
October 14	Days of the year
February 2	Days of the year
Rainbow	Optics, Weather
Central Intelligence Agency	United States intelligence agencies
1975	1975
July 16	Days of the year
Thomas Dolby	English musicians, Living people, 1958 births, New wave musicians, Warner Bros. Records artists
Seismic retrofit	Earthquake engineering
Company (disambiguation)	Basic English 850 words
1890	1890
Rio de Janeiro	Capital of Brazil, Former national capitals, Rio de Janeiro, Capitals of Brazilian states, 1565 establishments, 16th-century establishments in Brazil, 1560s establishments in South America
Andrew Jackson	1767 births, 1845 deaths, Deaths from tuberculosis, Deaths from heart failure, Andrew Jackson, US Democratic Party politicians, Presidents of the United States, United States senators from Tennessee, United States representatives from Tennessee, Politicians from South Carolina, Military people from Tennessee, 19th-century American politicians, 18th-century American politicians
Pillow	Home
Whaler	Boats, Occupations
Crayon	Crayons, Art, Writing tools
Self-defence	Survival skills
March 22	Days of the year
May 24	Days of the year
1153	1153
January 9	Days of the year
1913	1913
May 3	Days of the year
1469	1469
Dodgeball	Team sports
Local area network	Computer networking
February 18	Days of the year
Pharaoh	Pharaohs
Gilligan's Island	American sitcoms, 1964 television series debuts, CBS network shows, English-language television programs
Diaper	Clothing
Mork & Mindy	1978 television series debuts, 1982 disestablishments in the United States, 1970s American television series, 1980s American television series, American science fiction television series, American sitcoms, Television series set in Colorado, Boulder, Colorado, Television spin-offs, 1978 establishments in the United States, ABC network shows, English-language television programs
April 23	Days of the year
1954	1954
American Samoa	American Samoa, 1967 establishments in Oceania, 1967 establishments in the United States
Disgust	Emotions
February 7	Days of the year
1723	1723
Oven	Basic English 850 words, Cooking appliances
Pot	Cookware and bakeware
Liquid	Basic English 850 words, States of matter
January 24	Days of the year
October 12	Days of the year
1806	1806
July 13	Days of the year
1836	1836
White	Basic English 850 words
French Guiana	French Guiana
Nigger	Pejoratives, English profanity, Slurs
Biography	Genres, Literary terms
January 3	Days of the year
Ralph Nader	1934 births, Living people, Politicians from Connecticut, American political activists
Jamie Farr	1934 births, Living people, Actors from Toledo, Ohio, American movie actors, American television actors
Free software	Free software
1804	1804
1812	1812
Zookeeper	Occupations, Zoos
Cage	Containers, Traps
Toddler	Children
Ronald McDonald	Mascots, McDonald's
Bob Marley	Cancer deaths in Florida, Deaths from melanoma, American guitarists, Jamaican singers, Rastafari, Reggae musicians, Jamaican businesspeople, Singers from Delaware, Businesspeople from Wilmington, Delaware, Musicians from Wilmington, Delaware, 1945 births, 1981 deaths, Former Roman Catholics
Leonardo DiCaprio	1974 births, Living people, Actors from Los Angeles, California, American movie actors, American movie directors, American movie producers, American television actors, American voice actors, Movie producers from California, Movie directors from California, Satellite Award winners, Screen Actors Guild Award winners, Best Actor Academy Award winners, Golden Globe Award winning actors
John Candy	1950 births, 1994 deaths, Actors from Toronto, Canadian movie actors, Canadian television actors, Canadian voice actors, Cardiovascular disease deaths in Mexico, Comedians from Ontario, Deaths from myocardial infarction, Emmy Award winners
Erwin Rommel	1891 births, 1944 deaths, German generals of World War II, German Lutherans, German military personnel of World War I, People from Baden-Württemberg, Suicides by poison, Suicides in Germany, Victims of Nazism
Fermentation	Fermented drinks, Fermentation
Flower	Basic English 850 words, Flowers
1939	1939
Square kilometre	Units of area
Judge	Basic English 850 words, Law occupations
Guilt (law)	Law
Length	Physical quantity
Weight	Measurement, Basic English 850 words
Truth	Basic English 850 words, Logic
Zimbabwe	Zimbabwe, 1980 establishments, 1980s establishments in Africa
Monaco	Monaco, Italian-speaking countries, French-speaking countries, Current monarchies
Supermarkets in the United Kingdom	United Kingdom-related lists, Supermarkets of the United Kingdom
Jettingen	Municipalities in Baden-Württemberg, Villages in Baden-Württemberg
Ken Jennings	1974 births, Television game shows, Living people, Jeopardy!, American bloggers
Sublimation	Chemistry, Physics
Malcolm McDowell	1943 births, Living people, Actors from Yorkshire, English movie actors, English stage actors, English television actors, English voice actors, Naturalized citizens of the United States, People from West Yorkshire
MAD Magazine	American magazines
Traverse City, Michigan	Cities in Michigan, County seats in Michigan
Will Smith	African American actors, American rap musicians from Pennsylvania, Singers from Philadelphia, Pennsylvania, Actors from Philadelphia, Pennsylvania, American television actors, American movie actors, 1968 births, Living people
Vladimir Putin	1952 births, Living people, Current national leaders, Presidents of Russia, Prime Ministers of Russia, Russian Orthodox Christians, Time People of the Year, Saint Petersburg State University alumni
Henry VII of England	1457 births, 1509 deaths, House of Tudor, 16th century in England, 1480s in England, 1490s in England, 1500s in Europe
Dover, Kent	Towns in Kent
Tonbridge	Towns in Kent
Inverness	Inverness
Boycott	Economics
Artificial	Technology, Anthropology
King Arthur	Arthurian legend
Johnny Appleseed	American folklore, Deaths from pneumonia, People from Massachusetts, Missionaries, 1774 births, 1847 deaths

