Hironobu Sakaguchi	1962 births, Living people, Japanese video game designers, People from Ibaraki Prefecture
Wii Balance Board	Wii hardware
Colleges and universities in the U.S. Virgin Islands	Colleges and universities in the United States by location, US Virgin Islands, Lists of colleges and universities, United States-related lists
Colleges and universities in American Samoa	Colleges and universities in Oceania, Colleges and universities in the United States by location, American Samoa, Lists of colleges and universities
Colleges and universities in Guam	Colleges and universities in Oceania, Colleges and universities in the United States by location, Guam, Lists of colleges and universities
Education in the Northern Mariana Islands	Education in the United States, Northern Mariana Islands
Colleges and universities in Puerto Rico	Colleges and universities in the United States by location, Puerto Rico, Lists of colleges and universities
Colleges and universities in Alaska	Colleges and universities in the United States by location, Lists of colleges and universities, Alaska
Hugo Wolf	1860 births, 1903 deaths, Austrian composers, Austrian musicians, Romantic composers
Colleges and universities in Arizona	Colleges and universities in Arizona, Lists of colleges and universities
Rosé Quartet	String quartets
Colleges and universities in the District of Columbia	Colleges and universities in the District of Columbia, Lists of colleges and universities
Colleges and universities in Arkansas	Colleges and universities in Arkansas, Lists of colleges and universities
Colleges and universities in Delaware	Colleges and universities in Delaware, Lists of colleges and universities
Colleges and universities in Wyoming	Colleges and universities in the United States by location, Lists of colleges and universities, Wyoming
Colleges and universities in West Virginia	West Virginia, Lists of colleges and universities, Colleges and universities in the United States by location
Colleges and universities in Nebraska	Colleges and universities in Nebraska, Lists of colleges and universities
Colleges and universities in Montana	Colleges and universities in Montana, Lists of colleges and universities
Colleges and universities in Idaho	Colleges and universities in Idaho, Lists of colleges and universities
Colleges and universities in the United States	Colleges and universities in the United States, Lists of colleges and universities, United States-related lists
Colleges and universities in Iowa	Colleges and universities in Iowa, Lists of colleges and universities
Colleges and universities in Rhode Island	Colleges and universities in Rhode Island, Lists of colleges and universities
Colleges and universities in South Dakota	Colleges and universities in South Dakota, Lists of colleges and universities
Colleges and universities in Maine	Colleges and universities in Maine, Lists of colleges and universities
Colleges and universities in Maryland	Colleges and universities in Maryland, Lists of colleges and universities
Gothic fiction	Fiction genres
Colleges and universities in Nevada	Colleges and universities in the United States by location, Lists of colleges and universities, Nevada
Colleges and universities in South Carolina	Colleges and universities in South Carolina, Lists of colleges and universities
Colleges and universities in North Dakota	North Dakota, Lists of colleges and universities, Colleges and universities in the United States by location
Colleges and universities in Louisiana	Colleges and universities in Louisiana, Lists of colleges and universities
Colleges and universities in Virginia	Colleges and universities in Virginia, Lists of colleges and universities
Colleges and universities in New Mexico	Colleges and universities in New Mexico, Lists of colleges and universities
Colleges and universities in Wisconsin	Colleges and universities in Wisconsin, Lists of colleges and universities
List of colleges and universities in Tennessee	Colleges and universities in Tennessee, Lists of colleges and universities
Colleges and universities in New Hampshire	Colleges and universities in New Hampshire, Lists of colleges and universities
Colleges and universities in Oklahoma	Colleges and universities in Oklahoma, Lists of colleges and universities
Betta splendens	Perciformes, Freshwater fish, Aquarium fish
Colleges and universities in Texas	Colleges and universities in Texas, Lists of colleges and universities
Through the Fire and Flames	2006 songs, Power metal, DragonForce
East Asian calligraphy	Asia, Chinese language
Washington Nationals	Washington Nationals, 1969 establishments in the United States
Catcher	Baseball positions
Satin	Woven fabrics
Charles O. Finley	Businesspeople from Indiana, Baseball executives, People from Gary, Indiana, Oakland Athletics, 1918 births, 1996 deaths
Detroit Wolverines	Major League Baseball teams, Sports in Detroit, Michigan, 1881 establishments in the United States, 1880s establishments in Michigan, 1888 disestablishments, 1880s disestablishments in the United States, Disestablishments in Michigan
Flannel	Woven fabrics
American Association (19th century)	Baseball leagues
Toyota Supra	Toyota automobiles
Ana Ivanović	1987 births, Living people, Female tennis players, French Open champions, People from Belgrade, Serbian tennis players, World No. 1 tennis players
Colleges and universities in North Carolina	Colleges and universities in North Carolina, Lists of colleges and universities
Women's Tennis Association	1973 establishments, St. Petersburg, Florida, Tennis organisations, WTA Tour
Grand Slam (tennis)	Grand Slam tennis tournaments
Colleges and universities in Kentucky	Colleges and universities in Kentucky, Lists of colleges and universities
Colleges and universities in Mississippi	Colleges and universities in Mississippi, Lists of colleges and universities
Lewis Hamilton	1985 births, Living people, Black British sportspeople, English racecar drivers, Formula One current, Formula One drivers, GP2 Series drivers, People from Stevenage, Sportspeople from Hertfordshire
Todd Bentley	1976 births, Living people, Canadian Christians, Evangelicals, Evangelists, People from British Columbia
NCAA Division I	NCAA Division I athletics conferences
NCAA Division II	National Collegiate Athletic Association, College athletics conferences
NCAA Division III	National Collegiate Athletic Association, College athletics conferences
Atlantic Coast Conference	Atlantic Coast Conference
Keir Hardie	1856 births, 1915 deaths, Cardiovascular disease deaths in the United Kingdom, Deaths from stroke, Disease-related deaths in Scotland, Former Labour MPs (UK), Scottish politicians
Southeastern Conference	Southeastern Conference
Fausto Coppi	1919 births, 1960 deaths, Disease-related deaths in Italy, Italian cyclists, Military personnel of World War II, Sportspeople from Piedmont, Tour de France winners
Hurricane Hazel	Retired tropical cyclone names, Category 4 Atlantic hurricanes, Hurricanes in the United States, 1954 in the United States, History of Grenada, 20th centuy in Haiti, 20th century in the Bahamas, 20th century in South Carolina, 1950s in North Carolina, 20th century in Virginia, 20th century in West Virginia, 20th century in Maryland, 1950s in Pennsylvania, 1950s in New York (state), 1954 in Canada, October events
Miguel Induráin	1964 births, Giro d'Italia winners, Living people, Medalists at the 1996 Summer Olympics, Olympic gold medalists, People from Navarre, Spanish cyclists, Spanish Olympic medalists, Spanish Roman Catholics, Tour de France cyclists, Tour de France winners
Shimon Peres	1923 births, 2016 deaths, Belarusian Jews, Deputy government ministers of Israel, Deaths from stroke, Disease-related deaths in Israel, Former Members of Knesset, Government ministers of Israel, HaAvoda politicians, Harvard University alumni, Israeli civil servants, Israeli former political leaders, Israeli Nobel Prize winners, Israeli opposition leaders, Jewish Israeli politicians, Jewish Nobel Prize winners, Kadima politicians, Mapai politicians, Naturalized citizens of Israel, New York University alumni, Polish Jews, Presidents of Israel, Prime Ministers of Israel, Honorary Knights Commander of the Order of the British Empire, Honorary Knights Grand Cross of the Order of St Michael and St George
Ehud Olmert	1945 births, Living people, Former Members of Knesset, Government ministers of Israel, Israeli former political leaders, Israeli lawyers, Israeli mayors, Israeli prisoners, Jewish Israeli criminals, Jewish Israeli politicians, Jewish lawyers, Kadima politicians, Likud politicians, Prime Ministers of Israel
Kadima	2005 establishments in Asia, 2000s establishments in Israel, Former political parties in Israel, Zionist parties, Liberal parties
Svetlana Kuznetsova	1985 births, Living people, Female tennis players, Russian tennis players
Jacques Anquetil	1934 births, 1987 deaths, Cancer deaths in France, Deaths from stomach cancer, Doping cases in cycling, French cyclists, Giro d'Italia winners, Tour de France winners, Vuelta a España winners
Hour record	Cycling
Billie Jean King Cup	Tennis tournaments
Kateryna Bondarenko	1986 births, Living people, Female tennis players, Ukrainian sportspeople
Melinda Czink	Female tennis players, 1982 births, Hungarian sportspeople, Living people
Maria Kirilenko	Sportspeople from Moscow, 1987 births, Living people, Female tennis players, Russian tennis players
Alberto Contador	1982 births, Living people, Doping cases in cycling, Giro d'Italia winners, Spanish cyclists, Sportspeople from Madrid, Tour de France winners, Vuelta a España winners
Dinara Safina	1986 births, Female tennis players, Living people, Medalists at the 2008 Summer Olympics, Russian tennis players, Tatars, US Open (tennis) champions, World No. 1 tennis players
Alejandro Valverde	1980 births, Living people, Spanish cyclists, Vuelta a España winners
Time trial	Cycling, Tour de France
Markhor	Caprids, National symbols of Pakistan, Mammals of Asia
She's So Unusual	1983 albums, Pop albums
Betta	Perciformes, Freshwater fish
Lichtenstein, Saxony	Towns in Saxony, Zwickau Rural District
Otogizōshi	Japanese mythology, Japanese folklore
Salem, Massachusetts	Cities in Massachusetts, County seats in Massachusetts
Deval Patrick	1956 births, Living people, African American politicians, Governors of Massachusetts, 2020 United States presidential candidates, Politicians from Chicago, US Democratic Party politicians, 21st-century American politicians
Structure of the Earth	Earth, Structure of the Earth
Provisional designation in astronomy	Astronomical objects
Traffic sign	Traffic signs
Istituto Nazionale di Statistica	Italy
Harold Rubin	1932 births, 2020 deaths, South African entertainers, White South African people, Israeli musicians, Jazz musicians, Activists
List of Adventures in Odyssey characters	Adventures in Odyssey, Lists of fictional characters
List of WTA number 1 ranked players	Tennis, Lists of sportspeople, WTA Tour
Barbour County, Alabama	Alabama counties, 1832 establishments in Alabama
Monpazier	Bastides, Communes in Dordogne
Sarlat-la-Canéda	Subprefectures in France, Communes in Dordogne
Hurricane Erika (2003)	2003 Atlantic hurricane season, Hurricanes in Mexico, Hurricanes in the United States, Category 1 Atlantic hurricanes, 2003 in Texas, 2003 in Florida, 2000s in Mexico
Bergerac	Subprefectures in France, Communes in Dordogne, Wine regions of France
Sweet chestnut	Fagales, Trees
James S. Sherman	1855 births, 1912 deaths, Deaths from Bright's disease, Vice Presidents of the United States, Politicians from New York, US Republican Party politicians, 20th-century American politicians
Rainer Küchl	1950 births, Living people, Austrian violinists, Concertmasters
Wilson Allen Wallis	1912 births, 1998 deaths, American economists, Scientists from Philadelphia, Pennsylvania
March of the Penguins	Documentary movies, 2005 movies, Academy Award winning movies, Movies about animals, English-language movies, French-language movies, Multilingual movies, Buena Vista International movies
Mangrio	Pakistani tribes, Ethnic groups in Pakistan, Ethnic groups in India, Ethnic groups in Sindh
Enlightenment (Window Manager)	Free software
Buddhism in Pakistan	Religion in Pakistan, Buddhism
Colleges and universities in Utah	Colleges and universities in Utah, Lists of colleges and universities
World Series of Poker	Poker
Colleges and universities in Washington	Colleges and universities in Washington, Lists of colleges and universities
Big 12 Conference	Big 12 Conference, 1996 establishments in the United States
OpenDocument	Computer file formats, OpenOffice
Pac-12 Conference	Pac-12 Conference
Big East Conference	Big East Conference
Boston College	Atlantic Coast Conference, Association of Jesuit Colleges and Universities, Colleges and universities in Massachusetts, Hockey East, 1859 establishments in the United States, 19th-century establishments in Massachusetts
Clemson University	Atlantic Coast Conference, Colleges and universities in South Carolina, 1889 establishments in the United States, 1880s establishments in South Carolina
Virginia Polytechnic Institute and State University	Atlantic Coast Conference, Colleges and universities in Virginia, Oak Ridge Associated Universities, 1872 establishments in the United States, 19th-century establishments in Virginia
University of Virginia	Association of American Universities, Atlantic Coast Conference, Colleges and universities in Virginia, Oak Ridge Associated Universities, World Heritage Sites in the United States, 1819 establishments in the United States, 1810s establishments in Virginia
North Carolina State University	Atlantic Coast Conference, Colleges and universities in North Carolina, Oak Ridge Associated Universities, Raleigh, North Carolina, 1887 establishments in the United States, 1880s establishments in North Carolina
University of Miami	Atlantic Coast Conference, Colleges and universities in Florida, Oak Ridge Associated Universities, 1925 establishments in Florida
Nagios	Network management
Egyptian Arabic	Semitic languages
Wenedyk	Constructed languages
Brithenig	Constructed languages
EastLink, Melbourne	Roads in Australia
Transport for London	Local government in London, Transport in London
Jules Joseph Lefebvre	1836 births, 1911 deaths, French painters
Louisiana State University and A&M College	Colleges and universities in Louisiana, Oak Ridge Associated Universities, Southeastern Conference, Baton Rouge, Louisiana, 1860 establishments in the United States, 19th-century establishments in Louisiana
University of Kansas	Association of American Universities, Big 12 Conference, University of Kansas, 1866 establishments in the United States, 1860s establishments in Kansas, Lawrence, Kansas, Buildings and structures in Lawrence, Kansas
Kansas Jayhawks	University of Kansas
University of Pennsylvania	Association of American Universities, Colleges and universities in Pennsylvania, Ivy League, Philadelphia, Pennsylvania
Western Athletic Conference	Western Athletic Conference, 1962 establishments in the United States
Wilhelm Wundt	1832 births, 1920 deaths, German doctors, German psychologists
Bean machine	Engineering
Regression analysis	Statistics, Mathematical approximation
Forensic science	Forensics
Fingerprint	Criminal justice, Forensics, Computer security
Physical cosmology	Cosmology
Ronald Fisher	1890 births, 1962 deaths, English biologists, English mathematicians, English evolutionary biologists, Eugenics, Fellows of the Royal Society, English geneticists, Scientists from London
Urla	Cities in Turkey
Monash Freeway	Melbourne, Roads in Australia
The Art of War	Non-fiction books, Sun Tzu
Princes Freeway	Roads in Australia, Melbourne
Conference USA	Conference USA, 1995 establishments in the United States
Sewall Wright	1889 births, 1988 deaths, Scientists from Massachusetts, American evolutionary biologists, American geneticists
Tartan	Cloth
Jeff Tesreau	1888 births, 1946 deaths, New York Giants (NL) players, American baseball players, Sportspeople from Missouri
Sun Belt Conference	Sun Belt Conference, 1976 establishments in the United States
Mountain West Conference	Mountain West Conference, 1999 establishments in the United States
Super Punch-Out!! (Super NES)	1994 video games, Super Nintendo Entertainment System games, Sports video games
Mid-American Conference	Mid-American Conference, 1946 establishments in the United States
Super Metroid	1994 video games, Intelligent Systems games, Metroid, Nintendo Research & Development 1 games, Super Nintendo Entertainment System games, Virtual Console games
University at Buffalo	Association of American Universities, Colleges and universities in New York, Mid-American Conference, Buffalo, New York
Rock Band (video game)	2007 video games, PlayStation 2 games, PlayStation 3 games, Xbox 360 games, Wii games, Rock Band series
Excelsior of Brooklyn	Baseball teams, Brooklyn, Sports in New York City, 1854 establishments in the United States, 1850s establishments in New York (state)
Association of American Universities	Association of American Universities
Charizard	Fictional characters introduced in 1996, Pokémon monsters, Fictional dragons
Heiko Westermann	1983 births, Living people, German footballers, Sportspeople from Bavaria
Liz Shaw	Doctor Who characters
Jo Grant	Doctor Who characters
Pope Pius XII	1876 births, 1958 deaths, Italian popes, People from Rome, Venerated Catholics
Procyonidae	Procyonids
Tamburello	Team sports
Caniformia	Caniformia
Attribute-value system	Modeling
Tim Henman	1974 births, British male tennis players, British Olympic silver medalists, English sportspeople, Living people, Medalists at the 1996 Summer Olympics, Officers of the Order of the British Empire, People from Oxfordshire
Lasi	Sindh, Pakistani tribes
Ormuri	Languages of Pakistan, Languages of Afghanistan
Sansi	Languages of Pakistan, Languages of India, Indo-Aryan languages
Sindhi language	Indo-Aryan languages, Languages of Pakistan, Languages of India, Languages of Sindh
Burig	Pakistani people
West Pakistan	20th century in Pakistan, Former subdivisions of Pakistan, 1947 establishments in Asia, 1970 disestablishments, 1970s disestablishments in Asia
Ferozpur District	Districts of British India, Districts of Punjab, India
Pathankot	Settlements in Punjab, India, Cities in India
Kori Creek	Rivers of Pakistan, Territorial disputes of India, Territorial disputes of Pakistan
Yonex	Companies of Japan, Sports equipment, 1946 establishments in Asia, 1940s establishments in Japan
Bangladesh Liberation War	Bangladesh Liberation War, Wars involving India, Wars involving Pakistan, Wars of independence, 1971 in Bangladesh, 1971 in Pakistan
Toray Pan Pacific Open	Tennis tournaments
Home City Ice	American food companies, 1896 establishments in the United States, Cincinnati, Ohio
Peter Potamus	Animated characters, Animated television series, 1964 television series debuts, 1966 television series endings
Muscovy duck	Ducks
Feliformia	Feliformia
Eared seal	Pinnipeds
Earless seal	Pinnipeds
Ernst Mayr	1904 births, 2005 deaths, American centenarians, American evolutionary biologists, Foreign Members of the Royal Society, German centenarians, German evolutionary biologists, Ornithologists, People from Bavaria
Ovis	Caprids
Aberdeen F.C.	Scottish Premier League clubs, Aberdeen, 1903 establishments in Scotland
Gunnar Nordström	1881 births, 1923 deaths, Finnish scientists, Physicists, People from Helsinki
Pope Pius XI	1857 births, 1939 deaths, Deaths from myocardial infarction, Italian popes
Defender (football)	Football (soccer) terminology
Modern evolutionary synthesis	Evolution, History of science
Midfielder	Football (soccer) terminology
Forward	Football (soccer) terminology
Daniela Hantuchová	1983 births, Living people, Female tennis players, People from Poprad, Slovakian sportspeople
Lollywood	Lahore, Cinema of Pakistan
Mugger crocodile	Crocodilia, Reptiles of Pakistan, National symbols of Pakistan
Sikhism in Pakistan	religion in Pakistan, Sikhism
Banbury	Towns in Oxfordshire
Mecha	Science fiction technology
Glyph	Writing systems, Typography
Tilde	Writing systems, Alphabetic diacritics
Burlington, Iowa	Cities in Iowa, County seats in Iowa
Regis High School (Cedar Rapids)	Schools in the United States, Cedar Rapids, Iowa, 1958 establishments in the United States, 20th-century establishments in Iowa, 1998 disestablishments in the United States
Cedar Rapids, Iowa	Cedar Rapids, Iowa, County seats in Iowa
University of Northern Iowa	Colleges and universities in Iowa, Missouri Valley Conference, Missouri Valley Football Conference, 1876 establishments in the United States, 19th-century establishments in Iowa
Bowling	Sports, Hobbies
Abbot Suger	1081 births, 1151 deaths, French people
Arch of Constantine	Buildings and structures in Rome
Great hall	Middle Ages
Louis VI of France	1081 births, 1137 deaths, Kings and Queens of France, People from Paris
Louis VII of France	Kings and Queens of France, 1120 births, 1180 deaths
Gatehouse	Fortification
Pittodrie Stadium	Football stadiums in Scotland, Aberdeen
Florence Cathedral	Roman Catholic Cathedrals, Cathedrals in Italy, Buildings and structures in Florence, 1296 establishments, 13th century establishments in Italy, 1290s establishments in Europe
Beauvais Cathedral	Roman Catholic Cathedrals, Cathedrals in France, Hauts-de-France, 13th century establishments in Europe, Establishments in France
Orvieto Cathedral	Roman Catholic Cathedrals, Cathedrals in Italy, Umbria, 14th century establishments in Europe, Establishments in Italy
Laon Cathedral	Roman Catholic Cathedrals, Cathedrals in France, Hauts-de-France
Lincoln Cathedral	Cathedrals in England, Anglican Cathedrals, Lincolnshire
Milan Cathedral	Roman Catholic Cathedrals, Cathedrals in Italy, Milan, 1965 establishments in Europe, 1960s establishments in Italy
Sainte Chapelle	Buildings and structures in Paris, Churches in France
Gloucester Cathedral	Anglican Cathedrals, Cathedrals in England, Gloucester
Legendary creature	Legendary creatures, Mythology, Folklore
Uppsala Cathedral	Church of Sweden cathedrals, Uppsala
Toledo Cathedral	Roman Catholic Cathedrals, Cathedrals in Spain, Toledo, Spain
Equilateral triangle	Polygons
Limoges Cathedral	Roman Catholic Cathedrals, Cathedrals in France, Limoges
Rouen Cathedral	Roman Catholic Cathedrals, Cathedrals in France, Rouen
St Stephen's Cathedral, Vienna	Buildings and structures in Austria, Christianity in Austria, Roman Catholic Cathedrals, 1140s establishments in Europe, Establishments in Austria, 1147 establishments
Carlisle Cathedral	Anglican Cathedrals, Cathedrals in England, Carlisle
Notre-Dame de Saint-Omer	Roman Catholic Cathedrals, Cathedrals in France, Hauts-de-France
Selby Abbey	Abbeys, Churches in England, North Yorkshire, Anglican churches
Rochester Cathedral	Anglican Cathedrals, Kent, Cathedrals in England
Le Mans Cathedral	Roman Catholic Cathedrals, Cathedrals in France, Le Mans
Types of tennis match	Tennis
Love Street	Football stadiums in Scotland, Sports buildings in the United Kingdom, 2009 disestablishments in the United Kingdom
Valdas Adamkus	People from Kaunas, Presidents of Lithuania, 1926 births, Living people, Civil servants
Islamic architecture	Architectural styles, Islamic culture
Easter Road	Football stadiums in Scotland, Buildings and structures in Edinburgh
New Douglas Park	Football stadiums in Scotland
Falkirk Stadium	Football stadiums in Scotland
Rugby Park	Football stadiums in Scotland
Tannadice	Football stadiums in Scotland, Dundee
Tynecastle	Football stadiums in Scotland, Buildings and structures in Edinburgh
Ibrox	Football stadiums in Scotland, Buildings and structures in Glasgow
Caledonian Stadium	Football stadiums in Scotland
Fir Park	Football stadiums in Scotland, North Lanarkshire, 1895 establishments in the United Kingdom, 1890s establishments in Scotland
Flag of Lithuania	National flags, Lithuania
Wikiversity	Wikimedia, Wikis, Websites established in 2006
Pollywood	Cinema of Pakistan, Peshawar
Thomas Andrews	Irish businesspeople, Victims of the RMS Titanic, People from County Down, 1873 births, 1912 deaths
Poprad	Poprad
Martina Navratilova	1956 births, American autobiographers, American female tennis players, American LGBT people, American LGBT rights activists, Australian Open champions, Breast cancer survivors, Coaches, Czech tennis players, French Open champions, Lesbians, Living people, LGBT sportspeople, Naturalized citizens of the United States, Participants in American reality television series, Sportspeople from Prague, People with cancer, US Open (tennis) champions, Wimbledon champions, World No. 1 tennis players, BBC 100 Women
Leoš Friedl	1977 births, Living people, Male tennis players, Czech tennis players
Kevin Ullyett	1972 births, Living people, Male tennis players, Zimbabwean people
Arantxa Sánchez Vicario	1971 births, Female tennis players, French Open champions, Living people, Medalists at the 1992 Summer Olympics, Medalists at the 1996 Summer Olympics, Sportspeople from Barcelona, Spanish sportspeople, US Open (tennis) champions, Wimbledon champions, World No. 1 tennis players
Ai Sugiyama	1975 births, Female tennis players, French Open champions, Japanese tennis players, Living people, People from Kanagawa Prefecture
Patty Schnyder	1978 births, Female tennis players, Living people, Sportspeople from Basel, Swiss tennis players
Indian Wells, California	Cities in California, Settlements in Riverside County, California
Indian Wells Masters	Tennis tournaments, Sports in California
Zeeshan	Given names
Mahmood	Given names
Kite	Toys, Sports equipment
University of Portsmouth	Universities in England, Portsmouth
Winchester Cathedral	Cathedrals in England, Anglican Cathedrals, Winchester
Racing Stripes	2005 movies, American comedy movies, American adventure movies, American animated movies, Movies about animals, 2000s adventure movies, Movies composed by Ennio Morricone
Forehand	Tennis
Vogue (magazine)	1892 establishments in New York (state), Fashion magazines, Monthly magazines
Sponsor	Culture, Economics
Texas Rangers (baseball)	Texas Rangers (baseball), 1961 establishments in the United States, 20th-century establishments in Washington, D.C., 1960s establishments in Texas
Office suite	Office suites
The Rake's Progress	Compositions by Igor Stravinsky, 1950s operas, 1951
Port of Karachi	Geography of Pakistan
Sonmiani Bay	Geography of Pakistan, Bays
Churma Island	Islands of Pakistan
Clifton Oyster Rocks	Islands of Pakistan
Khiprianwala Island	Islands of Pakistan
Malan Island	Volcanoes of Asia, Islands of Pakistan, Mountains of Pakistan
Manora Island	Islands of Pakistan
Trillian	Instant messaging software
Frankie Muniz	People from Ridgewood, New Jersey, Actors from Los Angeles, California, Actors from New Jersey, Actors from North Carolina, American child actors, American movie actors, American racecar drivers, American television actors, American voice actors, Sportspeople from Los Angeles, California, Sportspeople from New Jersey, Sportspeople from Raleigh, North Carolina, 1985 births, Living people, Actors from Raleigh, North Carolina
Wendee Lee	1955 births, Living people, American voice actors, Vegetarians, Actors from Los Angeles, California
Weilheim-Schongau	Weilheim-Schongau
El Muerto	Comics characters, Comic books
El Muerto (movie)	2007 movies, American superhero movies, American independent movies
Thomas Mitchell	Australian explorers, Scottish people, Exploration of Australia, 1792 births, 1855 deaths
Wagga Wagga	Cities in New South Wales
Low Countries	Regions of Europe
Palestine Liberation Organization	Politics of Palestine, Nationalist organizations in Palestine, 1964 establishments in Asia, Arab–Israeli conflict
Dome of the Rock	Buildings and structures in Jerusalem, Holy places in Islam, Religion in Israel, Temple Mount
Illegal prime	Prime numbers, Computers
Temple Mount	Temple Mount, Holy places in Islam, Judaism in Israel
Content Scramble System	Cryptography, DVD
Rangers F.C.	Scottish football clubs, Glasgow, 1872 establishments in the United Kingdom, 1870s establishments in Scotland
Yahya Khan	1917 births, 1980 deaths, Pakistani politicians
Pakistan Peoples Party	Socialist International, Social democratic parties, Political parties in Pakistan
Aksai Chin	Geography of China, Territorial disputes of India, Territorial disputes of China
Bury St Edmunds	Towns in Suffolk
Muhammad bin Qasim al-Thaqafi	695 births, 715 deaths, Generals, Muslims, National symbols of Pakistan, Syrian military people
United States Army Air Force	United States Air Force, 1941 establishments in the United States, 1947 disestablishments in the United States
Salem Witch Trials	Salem Witch Trials, 17th century in Massachusetts, 1692, 1693
Baron	Nobility
Telephone box	Street furniture, Telephone
Running gag	Humor
Harran	Cities in Turkey, Assyria
Phil O'Donnell	Scottish footballers, 1972 births, 2007 deaths
Toronto Blue Jays	1977 establishments in North America, Toronto Blue Jays, 1970s establishments in Canada
Toronto Raptors	Toronto Raptors, 1995 establishments in Canada
Toronto Argonauts	Canadian football clubs, Sport in Toronto, 1873 establishments in Canada
TD Canada Trust	Banks, Companies listed on the Toronto Stock Exchange
Pocoyo	Children's television series, Animated television series
Potato chip	Snack foods, Potatoes
York University	Toronto, Colleges and universities in Canada
University of Toronto	Association of American Universities, Colleges and universities in Canada, Toronto
Brampton, Ontario	Cities in Ontario
Greater Toronto Area	Toronto, Metropolitan areas
James Cameron	1954 births, Living people, Academy Award winning directors, Canadian movie directors, Oceanographers, Golden Globe Award winning directors
The World Ends with You	2007 video games, Nintendo DS games, Nintendo DS-only games, Role-playing video games
Stroller	Children, Human-powered vehicles, Safety
Bomberman Land Touch!	2006 video games, Atlus, Bomberman, Online games, Nintendo DS games, Nintendo DS-only games
Bomberman	Bomberman
Prince Sports	Companies of the United States
Dustin Pedroia	Baseball players from California, Boston Red Sox players, 1983 births, Living people
Apollo 11	1969 in the United States, Apollo program
Roger Clemens	1962 births, American baseball players, American League All-Stars, Boston Red Sox players, Houston Astros players, Living people, National League All-Stars, New York Yankees players, Sportspeople from Dayton, Ohio, Toronto Blue Jays players
Universal Music Group	Universal Music Group, 1934 establishments in California, American companies established in 1934, Companies based in Santa Monica, California, Companies listed on NASDAQ, Corporate spin-offs, Entertainment companies based in California, Entertainment companies established in 1934, IFPI members, Record label distributors, Recording Industry Association of America, Comcast, NBCUniversal subsidiaries
Dundee United F.C.	Scottish Premier League clubs, Dundee, 1909 establishments in Europe, 1900s establishments in Scotland
Two Hands	1999 movies, English-language movies, Australian crime movies
Paisley	Towns in Scotland
Daniel Gonzales Guiza	1980 births, Living people, Spanish footballers, People from Jerez de la Frontera
Kilmarnock	Ayrshire, Towns in Scotland
Falkirk	Towns in Falkirk council area
The Scotsman	Media in Scotland, Newspapers published in the United Kingdom
BBC Sport	BBC Online, Sports media
Turkey national football team	Turkey national football team
Falkirk F.C.	Scottish football clubs, Falkirk council area, 1876 establishments in the United Kingdom, 1870s establishments in Scotland
Hampden Park	Football stadiums in Scotland, 1903 establishments in Scotland
Feodor III of Russia	1661 births, 1682 deaths, Russian tsars, Emperors and empresses, House of Romanov
Lengnau, Berne	Municipalities of Bern
Sivasspor	Turkish football clubs
Otto Abetz	1903 births, 1958 deaths, Ambassadors of Germany, German prisoners, German war criminals, Holocaust perpetrators, People from Baden-Württemberg, Road accident deaths, SS officers
Statute of Labourers 1351	1350s in England, Acts of the Parliament of the United Kingdom, 1351
Christine de Pizan	1364 births, 1420s deaths, French writers
Danse Macabre	Death customs, Middle Ages, Horror
Patrick Poivre d'Arvor	1947 births, Living people, French journalists, People from Reims
Marcus Davis	American mixed martial artists, 1973 births, Living people
Kalamazoo, Michigan	Cities in Michigan, County seats in Michigan, 1831 establishments in the United States, 1830s establishments in Michigan Territory
El Gato Negro	Comics characters, Comic books
Richard Dominguez	People from Dallas, Texas, 1960 births, American comics artists, Living people
Jan Gotlib Bloch	1836 births, 1902 deaths, Polish writers, Polish Jews
McDonnell Douglas DC-10	Civil aircraft
Ocean liner	Ship types
Akakor	Cities in South America, Fictional locations
Gutenberg Bible	Bibles, Christianity in Germany, History of Germany, Mainz, 15th century books
Dancing with the Stars (video game)	2007 video games, Dancing with the Stars, PlayStation 2 games, Wii games, Video games based on television shows
Fight song	Songs, Sports words
World Draughts Federation	Draughts, Sports organizations, 1947 establishments
Kenny Florian	American mixed martial artists, 1976 births, Living people
Sophie Germain	1776 births, 1831 deaths, French mathematicians
Ingrid Betancourt	1961 births, Living people, French politicians, Colombian politicians, Kidnapped people, People from Bogotá, BBC 100 Women
Cutting board	Kitchenware
Measuring cup	Kitchenware
Simple English Wikipedia	Wikipedias, Websites established in 2001
Missouri Valley Conference	Missouri Valley Conference
Missouri Valley Football Conference	Missouri Valley Football Conference
Rights	Human rights
Ohio State University	American Lacrosse Conference, Association of American Universities, Big Ten Conference, Colleges and universities in Ohio, Columbus, Ohio, ECAC Lacrosse, Oak Ridge Associated Universities, Western Collegiate Hockey Association, 1870 establishments in the United States, 1870s establishments in Ohio
Pinoy Idol	Reality television series
Hulagu Khan	1217 births, 1265 deaths, Emperors and empresses, Mongol Empire
Dalgety Bay	Towns in Fife
Elena Bovina	1983 births, Australian Open champions, Female tennis players, Living people, Russian tennis players, Sportspeople from Moscow
Anastasia Myskina	1981 births, Female tennis players, French Open champions, Living people, Russian tennis players, Sportspeople from Moscow
WTA Awards	Tennis
Hopman Cup	Tennis tournaments in Australia, Perth, Western Australia, 1989 establishments in Australia
Wells Cathedral	Cathedrals in England, Anglican Cathedrals, Somerset
Santa Maria Assunta (Siena)	Roman Catholic Cathedrals, Cathedrals in Italy, Tuscany, 1263 establishments, 13th century establishments in Italy, 1260s establishments in Europe
Caen	Caen, Departmental capitals in France, Former regional capitals in France
St. Michael and Gudula Cathedral	Roman Catholic Cathedrals, Buildings and structures in Belgium, Brussels
Strasbourg Cathedral	Roman Catholic Cathedrals, Cathedrals in France, Strasbourg
Ely Cathedral	Cathedrals in England, Anglican Cathedrals, Cambridgeshire
Exeter Cathedral	Cathedrals in England, Anglican Cathedrals
Lasbela District	Districts of Balochistan (Pakistan)
Awaran District	Districts of Balochistan (Pakistan)
Coutances Cathedral	Roman Catholic Cathedrals, Cathedrals in France, Normandy
Kalat District	Districts of Balochistan (Pakistan)
Regensburg Cathedral	Buildings and structures in Bavaria, Cathedrals in Germany, Regensburg, Roman Catholic Cathedrals
Kharan District	Districts of Balochistan (Pakistan)
Khuzdar District	Districts of Balochistan (Pakistan)
Barcelona Cathedral	Roman Catholic Cathedrals, Cathedrals in Spain, Buildings and structures in Barcelona
Mastung District	Districts of Balochistan (Pakistan)
Gwadar District	Districts of Balochistan (Pakistan)
Panjgur District	Districts of Balochistan (Pakistan)
Kech District	Districts of Balochistan (Pakistan)
Valencia Cathedral	Roman Catholic Cathedrals, Valencia, Cathedrals in Spain
Dera Bughti District	Districts of Balochistan (Pakistan)
Jaffarabad District	Districts of Balochistan (Pakistan)
Nasirabad District	Districts of Balochistan (Pakistan)
Bad Doberan Minster	Abbeys, Buildings and structures in Germany, Christianity in Germany, Mecklenburg-Vorpommern
Sibi District	Districts of British India, Districts of Balochistan (Pakistan)
Kohlu District	Districts of Balochistan (Pakistan)
Ziarat District	Districts of Balochistan (Pakistan)
Hammerbeam roof	Architectural elements
Quetta District	Districts of British India, Districts of Balochistan (Pakistan), Quetta
Pishin District	Districts of Balochistan (Pakistan)
Purbeck marble	Carbonate rocks, Dorset
Chagai District	Districts of British India, Districts of Balochistan (Pakistan)
Qilla Abdullah District	Districts of Balochistan (Pakistan)
Barkhan District	Districts of Balochistan (Pakistan)
Holy Grail	Containers, Christian religious objects, Christian symbols
St. George's Chapel at Windsor Castle	Churches in England, Buildings and structures in England, Berkshire, Royal Victorian Order
Henry VII Lady Chapel	Churches in England
Bath Abbey	Churches in England, Abbeys, Bath, Somerset, Anglican churches, 7th-century establishments, Establishments in England
Qilla Saifullah District	Districts of Balochistan (Pakistan)
Loralai District	Districts of British India, Districts of Balochistan (Pakistan)
Musakhel District	Districts of Balochistan (Pakistan)
Zhob District	Districts of Balochistan (Pakistan)
Jhal Magsi District	Districts of British India, Districts of Balochistan (Pakistan)
Nushki District	Districts of Balochistan (Pakistan)
Kathua District	Districts of Jammu and Kashmir
South Tibet	Territorial disputes of China, Arunachal Pradesh, Occupied territories
Manorialism	Feudalism, Economic systems
Badin District	Badin District
Dadu District	Districts of British India, Dadu District, Districts of Sindh
Hyderabad District	Districts of British India, Hyderabad District, Districts of Sindh
Thatta District	Districts of British India
Karachi District	Districts of Sindh
Jacobabad District	Jacobabad District, Districts of Sindh
Kirby Super Star	1996 video games, Cooperative video games, Kirby, Nintendo DS games, Video game remakes, Virtual Console games, Platform games, Super Nintendo Entertainment System games
Larkana District	Districts of British India, Larkana District, Districts of Sindh
Mirpur Khas District	Mirpur Khas District
Sanghar District	Districts of British India, Sanghar District
Tharparkar District	Districts of British India
Umerkot District	Districts of Sindh
Ghotki District	Ghotki District, Districts of Sindh
Khairpur District	Khairpur District, Districts of Sindh
Masahiro Sakurai	1970 births, Kirby, Living people, People from Tokyo, Japanese video game designers, Nintendo people
Naushahro Feroze District	Naushahro Feroze District
Nawabshah District	Nawabshah District
Shikarpur District	Districts of Sindh
Sukkur District	Districts of Sindh
Qambar District	Districts of Sindh
Kashmore District	Districts of Sindh
Matiari District	Matiari District
Jamshoro District	Jamshoro District, Districts of Sindh
Tando Muhammad Khan District	Districts of Sindh
Tando Allahyar District	Tando Allahyar District
Keyshia Cole	1981 births, Living people, Singers from California
Western Collegiate Hockey Association	Western Collegiate Hockey Association
Atlantic Hockey	Atlantic Hockey
Central Collegiate Hockey Association	Central Collegiate Hockey Association, 1971 establishments in the United States, 2013 disestablishments in the United States, 2020 establishments
College Hockey America	College Hockey America, 1999 establishments in the United States
ECAC Hockey	ECAC Hockey
Hockey East	Hockey East, 1984 establishments in the United States
Mezquita de Córdoba	12 Treasures of Spain, Cathedrals in Spain, Córdoba, Andalusia, Roman Catholic Cathedrals
Chris Parks	1973 births, American professional wrestlers, Living people, TNA wrestlers, Sportspeople from Washington, D.C.
American Lacrosse Conference	2001 establishments in the United States, 2014 disestablishments in the United States, American Lacrosse Conference
Dante Gabriel Rossetti	1828 births, 1882 deaths, English writers, English poets, English painters, Artists from London, Writers from London, Translators, British illustrators
Mediterranean Ridge	Plate tectonics, Oceanography
Kirby's Adventure	1993 video games, Kirby, Nintendo Entertainment System games, Virtual Console games, Platform games
Freshly-Picked Tingle's Rosy Rupeeland	2006 video games, Nintendo DS games, Nintendo DS-only games, The Legend of Zelda games, Video game spin-offs
Link's Crossbow Training	2007 video games, Nintendo Entertainment Analysis and Development games, The Legend of Zelda games, Video game spin-offs, Wii games, Wii-only games
Princess Zelda	The Legend of Zelda characters, Fictional characters introduced in 1986, Fictional princesses
Free Bird	1973 songs, Rock songs
Ganon	The Legend of Zelda characters, Fictional characters introduced in 1986
Tingle	The Legend of Zelda characters
Born again (Christianity)	Protestant theology, Evangelicalism
Kirby's Dream Land 3	1997 video games, Kirby, Virtual Console games, Nintendo DS games, Platform games, Super Nintendo Entertainment System games
Australian Bureau of Statistics	Government agencies of Australia
Record chart	Record charts
Getica	6th century, Non-fiction books, Germanic peoples
Ned Kelly	Australian murderers, Australian prisoners, Ned Kelly, People executed by hanging, People from Victoria (Australia), 1855 births, 1880 deaths
Ben Hall	1837 births, 1865 deaths, Australian criminals, Bushrangers, Deaths by firearm, People from New South Wales
Ride the Lightning	1984 albums, Metallica albums, Heavy metal albums
Text file	Computer file formats
Virtual Console	Wii, Nintendo 3DS
Provincially Administered Tribal Area	Territories of Pakistan
Local government in Pakistan	Local government of Pakistan
Federally Administered Tribal Areas	Federally Administered Tribal Areas, Territories of Pakistan
Azrael	Angels, Islam
Mangla Dam	Dams, Buildings and structures in Pakistan, Hydropower, 1967 establishments in Asia, 20th century establishments in Pakistan
Exhibition game	Sports words
Enrique Iglesias	Grammy Award winners, Latin singers, Musicians from Madrid, Pop musicians, Singer-songwriters, Spanish movie actors, Spanish singers, Spanish television actors, 1975 births, Living people, Latin Grammy Award winners, American Music Awards
Academy	Types of educational institutions
Sergei Fedorov	1969 births, Columbus Blue Jackets players, Detroit Red Wings players, Hart Memorial Trophy winners, Living people, Mighty Ducks of Anaheim players, Olympic bronze medalists, Olympic silver medalists, Stanley Cup champions, Washington Capitals players, Ice hockey centres
Spartak Tennis Club	Tennis, Sport in Russia
Pavel Bure	1971 births, Calder Trophy winners, Florida Panthers players, Hockey Hall of Fame inductees, Living people, New York Rangers players, Olympic bronze medalists, Olympic silver medalists, Rocket Richard Trophy winners, Russian ice hockey players, Soviet sportspeople, Sportspeople from Moscow, Vancouver Canucks players
FHM	Magazines of the United Kingdom
Monica Seles	Tennis players, Living people, Year of birth missing (living people), 1973 births
Lindsay Davenport	1976 births, American female tennis players, American Olympic gold medalists, Australian Open champions, French Open champions, Living people, Medalists at the 1996 Summer Olympics, Sportspeople from Los Angeles County, California, US Open (tennis) champions, Wimbledon champions, World No. 1 tennis players
Natasha Zvereva	1971 births, Belarusian tennis players, Female tennis players, French Open champions, Living people, Medalists at the 1992 Summer Olympics, US Open (tennis) champions, Wimbledon champions
Max Mirnyi	1977 births, Living people, Belarusian tennis players, Male tennis players, People from Minsk
Filderstadt	Towns in Baden-Württemberg, Esslingen (district)
Berlei	Companies of Australia, 1917 establishments, 1910s establishments in Australia
Lycos	Internet
K-Swiss	American clothing companies, Companies based in Los Angeles, 1966 establishments in California
Gwadar City	Cities in Pakistan
Syed Ahmed Khan	1817 births, 1898 deaths, People of British India, Indian politicians, Knights Companion of the Order of the Star of India, Teachers
United Airlines Flight 93	September 11 attacks, 2001 aviation disasters
Mirza Ghalib	1796 births, 1869 deaths, Indian poets, Urdu poets
Saare Jahan se Achcha	Poems, British India
Atlantic Soccer Conference	Atlantic Soccer Conference
United Soccer Conference	United Soccer Conference
Collegiate Water Polo Association	Collegiate Water Polo Association, Water polo
Western Water Polo Association	NCAA Division I athletics conferences, Water polo
ECAC Lacrosse	1999 establishments in the United States, 2014 disestablishments in the United States, ECAC Lacrosse
Great Western Lacrosse League	Lacrosse, NCAA Division I athletics conferences, 1984 establishments in the United States, 2009 disestablishments in the United States
Nightingale	Passeriformes
We Are the Champions	1977 songs, Queen songs, Rock ballads
British Invasion	American music history, British music
Pokémon	Pokémon, Anime
Pokémon (anime)	Pokémon, Anime, Animated television series, Kids WB series, First run syndicated television programs
Donkey Kong (series)	Donkey Kong, Video game spin-offs
Kirby (series)	Kirby
Ace Attorney	Ace Attorney
Oruchuban Ebichu	Comics, Anime, Animation, Drama television series
Excel Saga	Anime
Haré+Guu	Anime, Manga
Kirby Super Star Ultra	Video game remakes, Kirby, Nintendo DS games, 2008 video games
SummerSlam (2008)	2008 in professional wrestling, SummerSlam, History of Indianapolis, Indiana, 2008 in American television
HAL Laboratory	Video game companies, Kirby, 1980 establishments
Rosario Dawson	1979 births, Living people, American television actors, American movie actors, American musical theatre actors, American comics writers, American political activists, LGBT writers, LGBT actors, LGBT singers, Singers from New York City, LGBT people from New York City, Actors from New York City, Writers from New York City, American voice actors, American stage actors
The Age	Newspapers published in Australia, Melbourne, 1854 establishments, 1850s establishments in Australia
MINIX	Operating systems
Causality	Logic, Causality
Wildhaus	Former municipalities of St. Gallen, Villages in St. Gallen
Muhammad Iqbal	1873 births, 1938 deaths, People of British India, Indian poets, Indian politicians, Pakistani culture, National symbols of Pakistan, Urdu poets
1984–85 NHL season	1984 in the United States, 1985 in Canada, 1985 in the United States, National Hockey League seasons
Grant Fuhr	1962 births, American Hockey League players, Buffalo Sabres players, Calgary Flames players, Canadian adoptees, Canadian ice hockey goaltenders, Edmonton Oilers players, Hockey Hall of Fame inductees, Ice hockey people from Alberta, Living people, Los Angeles Kings players, St. Louis Blues players, Stanley Cup champions, Toronto Maple Leafs players, Vezina Trophy winners, Victoria Cougars (1971–94) players
Ron Hextall	1964 births, American Hockey League players, Brandon Wheat Kings players, Canadian ice hockey goaltenders, Conn Smythe Trophy winners, Ice hockey people from Manitoba, Living people, New York Islanders players, Philadelphia Flyers players, Quebec Nordiques players, Vezina Trophy winners, International Hockey League (1945–2001) players
Brandon Wheat Kings	1967 establishments in North America, Canadian Hockey League teams, Ice hockey teams in Canada, Western Hockey League, 1960s establishments in Sweden
William Riker	Star Trek: The Next Generation characters
Hall church	Churches, Architecture
Saint Thomas Church (Strasbourg)	Gothic architecture, Strasbourg, 1521 establishments, 16th century establishments in France
Aircraft hijacking	Aviation safety, Types of crime, Terrorist attacks
Logan International Airport	Transport in Massachusetts, Buildings and structures in Boston, Massachusetts, Airports in the United States
NHL Entry Draft	National Hockey League
Los Angeles International Airport	Airports in California, Buildings and structures in Los Angeles, California
Cockpit	Aircraft
List of defunct and relocated National Hockey League teams	Defunct National Hockey League teams, Ice hockey related lists
First officer	Titles
Flight attendant	Occupations in aviation, Aircraft
Western Conference (NHL)	National Hockey League
Mohamed Atta	1968 births, 2001 deaths, Al-Qaeda people, Egyptian Muslims, September 11 attacks
Abdulaziz al-Omari	1979 births, 2001 deaths, Al-Qaeda people, Saudi Arabian people, September 11 attacks
Waleed al-Shehri	1979 births, 2001 deaths, Al-Qaeda people, Saudi Arabian people, September 11 attacks
Wail al-Shehri	1975 births, 2001 deaths, Al-Qaeda people, Saudi Arabian people, September 11 attacks
Satam al-Suqami	1976 births, 2001 deaths, Al-Qaeda people, People from Riyadh, September 11 attacks
List of Stanley Cup champions	Ice hockey related lists, Stanley Cup champions
First class (aviation)	Air travel
List of NHL players	Lists of National Hockey League players
History of Pakistan	History of Pakistan
Business class	Travel
Runway	Aviation infrastructure
Air traffic control	Air traffic control
Federal Aviation Administration	Aviation authorities, United States Department of Transportation, United States government agencies
North American Aerospace Defense Command	Military
Lower Manhattan	Manhattan, Neighborhoods of New York City
Jules and Gedeon Naudet	French entertainers, French screenwriters, American screenwriters, French movie producers, French movie directors, American movie directors
Flight recorder	Aviation
Flight number	Aviation
Boeing 757	Boeing aircraft
List of National Hockey League arenas	National Hockey League lists, Indoor arenas
DGamer	Disney video games, DGamer
Eastern Conference (NHL)	National Hockey League
Undrafted sportsperson	Sports words, Lists of sportspeople
John Vanbiesbrouck	1963 births, Central Professional Hockey League players, Florida Panthers players, Living people, New Jersey Devils players, New York Rangers players, Ontario Hockey League players, Philadelphia Flyers players, Sportspeople from Detroit, Michigan, Vezina Trophy winners, American ice hockey goaltenders
Pelle Lindbergh	1959 births, 1985 deaths, American Hockey League players, Olympic bronze medalists, Philadelphia Flyers players, Road accident deaths in New Jersey, Sportspeople from Stockholm, Swedish Hockey League players, Vezina Trophy winners, Swedish ice hockey goaltenders
Wernher von Braun	1912 births, 1977 deaths, Scientists from Virginia, Cancer deaths in Virginia, Deaths from colorectal cancer, German scientists, Naturalized citizens of the United States, Order of Merit of the Federal Republic of Germany, Spaceflight, SS officers, Wernher von Braun
Pete Peeters	1957 births, American Hockey League players, Boston Bruins players, Canadian ice hockey goaltenders, Ice hockey people from Alberta, Living people, Medicine Hat Tigers players, Philadelphia Flyers players, Vezina Trophy winners, Washington Capitals players, International Hockey League (1945–2001) players
National Football League Most Valuable Player Award	American football awards, Most valuable player awards
List of NHL statistical leaders	National Hockey League lists, Lists of sportspeople
Trent Green	1970 births, American football quarterbacks, Kansas City Chiefs players, Living people, Miami Dolphins players, People from Cedar Rapids, Iowa, San Diego Chargers players, Sportspeople from Iowa, Washington Redskins players, St. Louis Rams players
Toy Story 3	2010 comedy movies, 2010 animated movies, 2010 3D movies, Academy Award winning movies, American comedy movies, American sequel movies, Buddy movies, Computer-animated movies, Disney animated movies, Golden Globe Award winning movies, Movies composed by Randy Newman, Movies that won the Best Animated Feature Academy Award, Movies that won the Best Original Song Academy Award, Pixar movies, Toy Story
Cars (movie)	2006 comedy movies, 2006 computer-animated movies, Cars (franchise), Pixar movies, American comedy movies, American family movies, English-language movies, Buena Vista International movies, Movies composed by Randy Newman, Movies set in deserts, Movies directed by John Lasseter
A Bug's Life	1998 animated movies, 1990s computer-animated movies, Pixar movies, Family movies, Movies about animals, Movies composed by Randy Newman, Movies directed by John Lasseter, Movies directed by Andrew Stanton
No Country for Old Men (movie)	2007 movies, English-language movies, Best Picture Oscar, Miramax movies, American movies, Academy Award winning movies, Movies based on books, Multilingual movies, Movies about the illegal drug trade
Council for Christian Colleges and Universities	Council for Christian Colleges and Universities
Oak Ridge Associated Universities	Oak Ridge Associated Universities
Indiana University Bloomington	Big Ten Conference, Colleges and universities in Indiana, Collegiate Water Polo Association, Oak Ridge Associated Universities
Afonso Pena International Airport	Airports in South America, Buildings and structures in Brazil, Curitiba
Universidade Federal do Paraná	Colleges and universities in Brazil, Paraná State, 1912 establishments in Brazil
Twelfth grade	Education
Depth chart	Diagrams, Team sports
Stepfamily	Family
Breeches	Trousers and shorts
Waist	Torso
Aircraft registration	Aviation licenses and certifications
List of medical abbreviations	Medicine, Science-related lists, Glossaries
Paternoster	Elevators
Maremma	Geography of Italy
Hurtova Lhota	Villages in the Czech Republic
Nová Ves u Světlé	Villages in the Czech Republic
Hamilton Academical F.C.	Scottish football clubs
Worf	Star Trek: The Next Generation characters
Azmi Bishara	1956 births, Living people, Christians, Former Members of Knesset, Hebrew University of Jerusalem alumni, Israeli-Palestinian people, People from Nazareth, Social democrats, Socialist politicians
Peterhead F.C.	Scottish Second Division clubs
1983–84 NHL season	1983 in the United States, 1984 in the United States
Northeast Division (NHL)	National Hockey League, 1993 establishments in North America
Northwest Division (NHL)	National Hockey League
Pacific Division (NHL)	National Hockey League
Atlantic Division (NHL)	National Hockey League, 1993 establishments in North America
Central Division (NHL)	National Hockey League, 1993 establishments in North America
Southeast Division (NHL)	National Hockey League
List of members of the Hockey Hall of Fame	Hockey Hall of Fame inductees, Lists of ice hockey players
The Magic Roundabout (movie)	2005 movies, 2000s adventure movies, 2000s fantasy movies, Animated movies, British adventure movies, British family movies, French-language movies, French movies, Multilingual movies
Female ejaculation	Female reproductive system
SummerSlam	SummerSlam
Suina	Even-toed ungulates
Ruminantia	Even-toed ungulates
White Oleander (movie)	2002 drama movies, American teen drama movies, English-language movies, Movies based on books, Movies set in California
Five Colleges (Massachusetts)	Five Colleges, Incorporated
Five Colleges of Ohio	Five Colleges of Ohio
Claremont Colleges	Colleges and universities in California
Great Lakes Colleges Association	Great Lakes Colleges Association
Beverly Crusher	Star Trek: The Next Generation characters
Chakswari Tehsil	Tehsils of Azad Kashmir
Mirpur, Kashmir	Tehsils of Azad Kashmir, Cities in Pakistan, Cities in Jammu and Kashmir
Jalalabad, Punjab	Settlements in Punjab, India, Cities in India
Kupferhof Bauschenberg	Companies of Germany, 17th century establishments in Germany
Zira Tehsil	Punjab, India
Sturgeon	Edible fish, Ray-finned fish, Living fossils
WWE The Great American Bash	World Wrestling Entertainment pay-per-view events
Hy-Vee	Supermarkets of the United States, 1930 establishments in the United States
Liger	Panthera, Animal hybrids
White Oleander	1999 books, 20th century American novels, English-language novels, Los Angeles, California in fiction
Cold Mountain (movie)	2003 drama movies, 2000s romantic drama movies, 2000s war movies, Italian drama movies, Romanian movies, American Civil War, American romantic drama movies, American war movies, English-language movies, Historical movies, Movies set in North Carolina, Buena Vista International movies, Miramax movies, Movies directed by Anthony Minghella
AT&T	Telephone companies, American technology companies, 1983 establishments in the United States, 1980s establishments in Texas
Air-ground radiotelephone service	Aviation, Communication
Heart of Midlothian F.C.	Scottish Premier League clubs, Edinburgh, 1874 establishments in Scotland
Abbey library of St. Gallen	Libraries in Europe, St. Gallen
Pohleď	Villages in the Czech Republic
Hibernian F.C.	Scottish Premier League clubs, Edinburgh, 1875 establishments in the United Kingdom, 1870s establishments in Scotland
Inverness Caledonian Thistle F.C.	Inverness, Scottish Premier League clubs, 1994 establishments in the United Kingdom, 1990s establishments in Scotland
Kilmarnock F.C.	Scottish Premier League clubs, 1869 establishments in the United Kingdom, 19th century establishments in Scotland
Higher education	Education
Aeronautics	Aviation, Science
Rawalpindi	Cities in Pakistan, Former national capitals, Capital of Pakistan
Kachhi District	Districts of Balochistan (Pakistan)
Sopore Tehsil	Tehsils of Jammu and Kashmir
Josip Broz Tito	1892 births, 1980 deaths, Deaths from gangrene, Deaths from heart failure, Deaths from peripheral artery disease, Former dictatorships, Honorary Knights Grand Cross of the Order of the Bath, Order of Merit of the Federal Republic of Germany, Presidents of Yugoslavia, Recipients of the Decoration for Services to the Republic of Austria, People excommunicated by the Catholic Church
Wienerwald	Alps, Forests of Europe, Mountains of Austria, Regions of Austria, Lower Austria, Vienna
Wienerwald, Austria	Cities and towns in Lower Austria
Wienerwald (restaurant)	European restaurants, 1955 establishments in Europe
Barracuda	Perciformes
Pomona, California	Pomona, California
Sin City (movie)	2005 movies, 2000s crime thriller movies, American crime thriller movies, Dark Horse Comics movies, Film noir, Movies directed by Robert Rodriguez
Fantastic Four (2005 movie)	2005 science fiction movies, 2000s superhero movies, Fantastic Four (movie series), American action movies, American fantasy movies, American science fiction movies, English-language movies, Movies based on comic book characters, Movies composed by John Ottman, Movies directed by Tim Story, Movies produced by Avi Arad, Superhero comedy movies, 20th Century Fox movies
Dark Angel (TV series)	2000 American television series debuts, 2002 American television series endings, 2000s American television series, American LGBT television programs, American science fiction television series, Eugenics, Fox television series, Television series set in Seattle, Washington, Television series set in the future, English-language television programs
The Ultimate Fighter	Ultimate Fighting Championship, American reality television series
Good Luck Chuck	2007 comedy movies, 2007 romance movies, 2000s romantic comedy movies, 2000s sex comedy movies, American romantic comedy movies, American sex comedy movies, English-language movies, Lionsgate movies, Movies about dentistry
Maxim (magazine)	Magazines of the United Kingdom
Camp Nowhere	1994 movies, English-language movies
Honey (2003 movie)	2003 movies, English-language movies
The Secret World of Alex Mack	1994 American television series debuts, Nickelodeon television series, 1998 American television series endings, English-language television programs
Atlantic Theater Company	Theater, Companies based in New York City
Beverly Hills, 90210	1990 American television series debuts, 2000 American television series endings, 1990s American television series, 2000s American television series, American drama television series, American teen television series, Beverly Hills, California in fiction, Fox television series, Television series set in Los Angeles County, California, English-language television programs
Teen Choice Awards	Fox Broadcasting Company, Entertainment awards
French Canadians	Ethnic groups in Canada
Mexican Americans	Ethnic groups in the United States, Mexican people
Saturn Award	Television, Science fiction awards, Movie awards
Del Rio, Texas	Cities in Texas, County seats in Texas
Tonsil	Head (body part)
J.C. Penney	American department stores, Companies based in Texas, Plano, Texas
Flipper (1995 TV series)	1995 American television series debuts, English-language television programs
Orient	Asia
Console role-playing game	Role-playing video games, Video game genres
Drew Barrymore	1975 births, Living people, Actors from Culver City, California, American child actors, American movie actors, American stage actors, American television actors, American voice actors, Barrymore family, Bisexual people, Golden Globe Award winning actors, LGBT actors, LGBT people from California, Saturn Award winners, Screen Actors Guild Award winners
Brooklyn South	1997 American television series debuts, Drama television series, CBS network shows, 1998 American television series endings, English-language television programs
Never Been Kissed	1999 comedy movies, 1999 romance movies, 1990s high school movies, 1990s romantic comedy movies, 1990s teen comedy movies, 1990s teen romance movies, American high school movies, American romantic comedy movies, American teen comedy movies, American teen romance movies, English-language movies, Movies directed by Raja Gosnell, Movies set in Chicago, Illinois, Movies shot in Chicago, Illinois, Proms in movies
Idle Hands	1999 comedy movies, 1999 horror movies, 1990s black comedy movies, Supernatural horror movies, 1990s teen comedy movies, 1990s teen horror movies, American black comedy movies, American teen comedy movies, American teen horror movies, Body horror movies, Comedy horror movies, English-language movies, Impact of the Columbine High School massacre
Panic attack	Anxiety disorders
Telepathy	Parapsychology, Pseudoscience
Megabit	Computing
Invisible Woman	Characters created by Stan Lee, Fantastic Four, Fictional characters introduced in 1961, Marvel Comics characters, Marvel Comics mutates
Shigesato Itoi	1948 births, Mother series, Japanese voice actors, Japanese video game designers, Living people, People from Gunma Prefecture
The Eye (2008 movie)	2008 movies, English-language movies, Lionsgate movies
Creatures Inc.	Companies of Japan
Academy of Motion Picture Arts and Sciences	Movie organizations, 1927 establishments in the United States
The Love Guru	2008 comedy movies, 2008 romance movies, 2000s romantic comedy movies, 2000s sports comedy movies, American romantic comedy movies, American sports comedy movies, English-language movies, Paramount movies, Screenplays by Mike Myers, Toronto
GQ	Monthly magazines, American men's magazines
Big Cartoon DataBase	1996 establishments, Entertainment websites
InStyle	American magazines
MTV Movie Awards	Movie awards, MTV
Awake (movie)	2000s crime thriller movies, 2000s psychological movies, American crime thriller movies, American psychological movies, English-language movies, Multilingual movies, Suicide in movies
Tiger shark	Sharks
Frank Miller (comics)	American movie directors, American comics artists, American comics writers, Writers from Maryland, Writers from Vermont, 1957 births, Living people
Robert Rodriguez	1968 births, Living people, American movie directors, American screenwriters, American movie producers, American cinematographers, American editors, Writers from San Antonio, Texas, Musicians from San Antonio, Texas
Michael Weatherly	American television actors, Actors from New York City, 1968 births, Living people
Telegraphy	Postal history, History of technology, Telecommunications
Rheumatism	Rheumatology, Diseases
Gout	Diseases, Rheumatology
Bright's disease	Diseases
National Football League Training Camp	National Football League
Training camp	Training
Sperm whale	Toothed whales
Camp Rock	2008 comedy movies, 2000s musical movies, 2000s teen comedy movies, 2000s television movies, American musical movies, American teen comedy movies, American television movies, Camp Rock, Disney movies, English-language movies, Movies about vacationing
Amani Toomer	1974 births, Living people, Kansas City Chiefs players, New York Giants players, Sportspeople from Berkeley, California
Mega Man 9	Mega Man games, Wii-only games, Capcom games, Video game sequels
Mega Man 8	1996 video games, 1997 video games, Mega Man games, PlayStation games, Sega Saturn games, Video games developed in Japan, Capcom games, Video game sequels
Mega Man 7	Mega Man games, 1995 video games, Video games developed in Japan, Capcom games, Super Nintendo Entertainment System games
Mega Man 6	1993 video games, Mega Man games, Nintendo Entertainment System games, Video games developed in Japan, Capcom games, Video game sequels
Mega Man 5	Mega Man games, Nintendo Entertainment System games, 1992 video games, Video games developed in Japan, Capcom games, Video game sequels
Mega Man 4	1991 video games, Mega Man games, Nintendo Entertainment System games, Video games developed in Japan, Capcom games, Video game sequels
Touchdown	American football, Canadian football, Sports words
Eton, Berkshire	Windsor and Maidenhead, Towns in Berkshire
Mega Man 3	1990 video games, Mega Man games, Nintendo Entertainment System games, Video games developed in Japan, Capcom games
Semitic languages	Semitic languages
Mega Man 2	1988 video games, Mega Man games, Nintendo Entertainment System games, Video games developed in Japan, Virtual Console games, Capcom games, Video game sequels
Mega Man (video game)	1987 video games, Mega Man games, Nintendo Entertainment System games, Virtual Console games, Video games developed in Japan, Capcom games
Mario Kart 64	1996 video games, Mario Kart games, Nintendo 64 games, Nintendo Entertainment Analysis and Development games, Virtual Console games, Virtual Console games for Wii U
Super Mario Kart	1992 video games, Mario Kart games, Nintendo Entertainment Analysis and Development games, Super Nintendo Entertainment System games
Isaac	Patriarchs, Old Testament people, Ancient Israeli people
Sarah	Old Testament people, Ancient Israeli people
Saul	Old Testament people, Kings of ancient Judah
Ecclesiastes	Old Testament books
Judas Iscariot	Twelve Apostles, Jews who committed suicide, Suicides by hanging
Pin stripes	Clothing
Baseball park	Baseball stadiums
Venus Rising	1995 movies, English-language movies
Child soldier	Army, Childhood, Child labour
Paranoid (2000 movie)	2000 movies, English-language movies
The Sleeping Dictionary	2003 movies, English-language movies
DVD Exclusive Awards	Entertainment awards
Mekhi Phifer	1974 births, Living people, American movie actors, American television actors, Actors from New York City
Imagen Awards	Movie awards, 1985 establishments in the United States
The Ten	2007 comedy movies, 2007 movies, English-language movies, Spanish-language movies, Multilingual movies
Meet Bill	2008 movies, 2008 comedy movies, English-language movies
Chicago Hope	1994 American television series debuts, 2000 American television series endings, 1990s American drama television series, 1990s medical television series, 2000s American drama television series, 2000s medical television series, American medical television series, CBS network shows, Television series set in Chicago, Illinois, English-language television programs
After school special	Television programs
ALMA Award	Entertainment awards
Entourage (TV series)	2004 American television series debuts, 2011 American television series endings, 2000s American television series, 2010s American television series, American comedy-drama television series, HBO television series, Emmy Award winning programs, Television series set in Los Angeles, California, English-language television programs
Young Artist Award	Entertainment awards
The Sydney Morning Herald	Newspapers published in Australia
Sandpit	Toys
Encyclopædia Britannica, Inc.	Encyclopædia Britannica, Book publishing companies, 1768 establishments, Publishing companies of the United States, 1760s establishments in the Thirteen Colonies
Brooklyn Dodgers	1883 establishments in the United States, 1880s establishments in New York (state), 1959 disestablishments, 20th-century disestablishments in New York (state), 1950s disestablishments in the United States
Batting order (baseball)	Baseball, Sports words
Hammerhead shark	Sharks
Faline	Bambi characters
1982–83 NHL season	1982 in the United States, 1983 in the United States
Horní Rápotice	Villages in the Czech Republic
Krásná Hora	Villages in the Czech Republic
Telegram	Postal service
Mladé Bříště	Villages in the Czech Republic
Beluga whale	Toothed whales
All-Star Cheer Squad	Music video games, 2008 video games, 2009 video games, Nintendo DS games, Wii games, THQ games
David	Old Testament people, Kings of ancient Israel, Kings of ancient Judah, People from Bethlehem
Crank That (Soulja Boy)	2007 songs
ARIA Charts	Record charts, Australian music
Golden Rooster Awards	Movie awards, Chinese movies, 1981 establishments in Asia, 1980s establishments in China
David (name)	Given names
Viva la Vida	2008 songs, Coldplay songs
The Curse of Curves	2007 songs
Klaxons	English rock bands, English punk bands, Musical groups from London, Musical groups established in 2005, 2005 establishments in England
Ecumenical Patriarch	Eastern Orthodox Church
Assyrian Church of the East	Eastern Christian denominations
Chaldean Catholic Church	Eastern Catholicism
Chaldean Christians	Eastern Catholics, Iraqi people
Status asthmaticus	Autoimmune diseases, Pulmonology
Milwaukee Bucks	National Basketball Association teams, Sports in Milwaukee, Wisconsin, 1968 establishments in the United States, 1960s establishments in Wisconsin
Pidgin (software)	Linux, Software, Instant messaging software
San Diego Padres	San Diego Padres
Drew Carey	1958 births, Actors from Cleveland, Ohio, American game show hosts, American television actors, Comedians from Ohio, Living people, WWE Hall of Fame
Books of Samuel	Old Testament books, Old Testament people, Ancient Israeli people
Sacrilege	Theology
Trousers	Trousers and shorts
Bibliography	Book terminology, Literature
Epistle to the Philippians	New Testament books
Julio Lugo	1975 births, Atlanta Braves players, Baltimore Orioles players, Boston Red Sox players, Dominican Republic sportspeople, Houston Astros players, Living people, Los Angeles Dodgers players, Major League Baseball shortstops, St. Louis Cardinals players, Tampa Bay Devil Rays players
Requiem (Mozart)	Compositions by Wolfgang Amadeus Mozart, Masses (music)
Gregorio Allegri	1582 births, 1652 deaths, Baroque composers, Italian composers, Musicians from Rome, Roman Catholic priests
Chronology	Chronology
Indre River	Rivers of France, Centre-Val de Loire
Oberlin Group of Libraries	Oberlin Group of Libraries
Kurds	Kurds
Pontus (mythology)	Greek gods and goddesses, Greek mythology
Pontus	Ancient Greece, Places of Ancient Rome
Homo floresiensis	Hominins
Goran Ivanišević	1971 births, Croatian sportspeople, Living people, Male tennis players, Medalists at the 1992 Summer Olympics, Wimbledon champions
Pete Sampras	1971 births, American Jews, American male tennis players, Australian Open champions, Living people, Sportspeople from Washington, D.C., US Open (tennis) champions, Wimbledon champions, World No. 1 tennis players
Andre Agassi	1970 births, American autobiographers, American male tennis players, American philanthropists, Australian Open champions, French Open champions, Living people, Medalists at the 1996 Summer Olympics, Sportspeople from Nevada, US Open (tennis) champions, Wimbledon champions, World No. 1 tennis players, Writers from Nevada
Narcissus (genus)	Asparagales
Dajabón Province	Provinces of the Dominican Republic, 1938 establishments in the Dominican Republic
First baseman	Baseball positions
Outfielder	Baseball positions
Sobekhotep VIII	Pharaohs
Albert Spalding	19th century baseball players, Baseball executives, Major League Baseball players, Sports in Chicago, Illinois, 1850 births, 1915 deaths
Charlie Waitt	American baseball players, Sportspeople from Maine, 1853 births, 1912 deaths
Doug Allison	19th century baseball players, American baseball players, Sportspeople from Philadelphia, Pennsylvania, 1846 births, 1916 deaths
Bill Doak	American baseball players, St. Louis Cardinals players, Cincinnati Reds players, Sportspeople from Pittsburgh, Pennsylvania, 1891 births, 1954 deaths
Teasing	Bullying, Human behavior
Pitcher	Baseball positions
Patton (movie)	1970 drama movies, 1970s war movies, American biographical movies, American drama movies, American war movies, Best Picture Oscar, English-language movies, Movies set in the 1940s, United States National Film Registry movies, World War II movies, Movies directed by Franklin J. Schaffner, 20th Century Fox movies
Jafar (Disney)	Aladdin (Disney) characters, Fictional Arabs, Fictional demons and devils, Fictional characters introduced in 1992, Kingdom Hearts characters
The Australian	Newspapers published in Australia
Barbican Arts Centre	Concert halls in London
Harry Morgan	1915 births, 2011 deaths, Deaths from pneumonia, American movie actors, American television actors, American television directors, Writers from Michigan, Actors from Detroit, Michigan, Emmy Award winning actors
Brisbane Times	Websites, Brisbane
District line	London Underground, London Underground lines, 1868 establishments in the United Kingdom, 1860s establishments in England
Kensington	Areas of London, Royal Borough of Kensington and Chelsea
Dew Process	Independent record labels
Books of Chronicles	Old Testament books
George Eliot	1819 births, 1880 deaths, English novelists, Writers from Warwickshire, Pen names
Gerry Anderson	1929 births, 2012 deaths, English movie directors, English movie producers, English screenwriters
Sarah Chalke	1976 births, Canadian television actors, Actors from Ottawa, Living people, Canadian voice actors
AfterMASH	1980s American television series, American sitcoms, CBS network shows, Television spin-offs, English-language television programs
M*A*S*H (TV series)	1972 television series debuts, 1983 disestablishments in the United States, 1970s American comedy television series, 1980s American comedy television series, American comedy-drama television series, American sitcoms, Black comedy, CBS network shows, Korean War, 1972 establishments in the United States, English-language television programs
Loretta Swit	1937 births, Living people, American movie actors, American stage actors, American television actors, Actors from New Jersey, People from Passaic, New Jersey, Emmy Award winners
Larry Linville	1939 births, 2000 deaths, American movie actors, American television actors, Actors from Ventura County, California
Katamari Damacy	2004 video games, PlayStation 2 games, PlayStation 2-only games, Namco video games, Video games developed in Japan
Beautiful Katamari	2007 video games, Namco video games, Xbox 360-only games, Video games developed in Japan
We Love Katamari	2005 video games, PlayStation 2 games, PlayStation 2-only games, Namco video games
Me & My Katamari	2005 video games, PlayStation Portable games, Namco video games
Namco	Namco, 1955 establishments, Video game companies, Santa Clara, California
Nagoya	Nagoya
Manglish	Languages of Asia, English language
The Story of the Kelly Gang	1906 works, Australian biographical movies, Australian crime movies, Ned Kelly, Silent movies, 1900s movies, Movies set in Australia
Steffi Graf	1969 births, Living people, Australian Open champions, Female tennis players, French Open champions, German tennis players, People from Mannheim, Sportspeople from Baden-Württemberg, US Open (tennis) champions, Wimbledon champions, World No. 1 tennis players
Sports Illustrated	Time Warner, 1954 establishments in the United States, Sports media, American magazines, Weekly magazines, Magazines published in New York City
Christian music	Christian music
A. Q. Khan	1936 births, Living people, Pakistani people, Nuclear physicists, Criminals, Bhopal
Interception (football)	American football, Rugby, Sports words
Load (album)	Metallica albums, 1996 albums
The Greatest Show on Turf	St. Louis Rams, 1999 in sports, 2000 in sports, 2001 in sports
The Marriage of Figaro	Compositions by Wolfgang Amadeus Mozart, 1780s operas, 1786
My Neighbor Totoro	1988 movies, Japanese movies, Movies directed by Hayao Miyazaki
Mnemonic	Words
Northrop Frye	1912 births, 1991 deaths, Canadian writers, Order of Canada
Throwback uniform	Sports words, Uniforms, Sports clothing
Backlash (2009)	2009 in professional wrestling, WWE Backlash, 2009 in the United States, 2000s in Rhode Island, April 2009 events, History of Providence, Rhode Island
Down with Love	2003 comedy movies, 2003 romance movies, 2000s parody movies, 2000s romantic comedy movies, 20th Century Fox movies, American parody movies, American romantic comedy movies, English-language movies, Movies set in New York City, Movies set in the 1960s
Celery	Vegetables, Agriculture, Apiaceae, Condiments, Herbs, Least concern species
Kalasha	Containers, Hinduism, Jainism
Pokémon Snap	1999 video games, Nintendo 64 games, Pokémon video games, Virtual Console games
Pokémon Channel	2003 video games, Nintendo GameCube-only games, Pokémon video games
Big Mac	McDonald's, American food, Sandwiches
Don Knotts	1924 births, 2006 deaths, American television actors, American comedians, Emmy Award winners, American movie actors, Actors from West Virginia, Deaths from lung cancer, Deaths from pneumonia
Stormbreaker (movie)	2005 movies, 2010s spy movies, British spy movies, English-language movies, Movies based on books
Serenade	Musical forms
Divertimento	Musical forms
Freemasonry	Freemasonry
Australian Music Online	Entertainment websites, Australian music
Die Entführung aus dem Serail	Compositions by Wolfgang Amadeus Mozart, 1780s operas, 1782
Clydesdale Bank	Banks of the United Kingdom, 1838 establishments in the United Kingdom, 19th century establishments in Scotland
War of the Worlds (2005 movie)	2005 movies, 2000s science fiction movies, American science fiction movies, Movies directed by Steven Spielberg, Movies based on books, Movies set in New Jersey, Movies set in New York, Movies set in Boston, Massachusetts, English-language movies, Apocalyptic movies
Bank of Scotland	1695 establishments, Scotland, Banks of the United Kingdom, 1690s establishments in Europe, 17th century establishments in Scotland
Jimmy Calderwood	1950 births, Living people, Scottish football managers, Scottish footballers, People with Alzheimer's disease
Germany's Next Topmodel	2006 television series debuts, 2000s television series, 2010s television series, German television series, Top Model television series, 2006 establishments in Europe, 2000s establishments in Germany
Kurume, Fukuoka	Cities in Fukuoka Prefecture
Gordon Strachan	1957 births, Living people, People from Edinburgh, Scottish footballers, Scottish football managers
Craig Levein	1964 births, Living people, Scottish footballers, Scottish football managers, People from Dunfermline
John Hughes (footballer born 1964)	1964 births, Living people, Scottish football managers, Scottish footballers
Jennifer Hof	German models, 1991 births, Living people
Partick Thistle F.C.	Scottish football clubs, 1876 establishments in the United Kingdom, 1870s establishments in Scotland
Airdrie United F.C.	Scottish First Division clubs, North Lanarkshire, 2002 establishments in the United Kingdom, 2000s establishments in Scotland
Aalst, Belgium	Municipalities of East Flanders
Aalter	Municipalities of East Flanders
Aarschot	Municipalities of Flemish Brabant
Aartselaar	Municipalities of Antwerp
Affligem	Municipalities of Flemish Brabant
Aiseau-Presles	Municipalities of Hainaut
Alken, Belgium	Municipalities of Limburg
Alveringem	Municipalities of West Flanders
Amay	Municipalities of Liège
Amel	Municipalities of Liège
Andenne	Municipalities of Namur
Anderlecht	Municipalities of Brussels-Capital Region
Anderlues	Municipalities of Hainaut
Anhée	Municipalities of Namur
Ans	Municipalities of Liège
Anthisnes	Municipalities of Liège
Antoing	Municipalities of Hainaut
Anzegem	Municipalities of West Flanders
Ardooie	Municipalities of West Flanders
Arendonk	Municipalities of Antwerp
Arlon	Municipalities of Luxembourg (Belgium), Provincial capitals of Belgium
As, Belgium	Municipalities of Limburg
Asse	Municipalities of Flemish Brabant
Assenede	Municipalities of East Flanders
Assesse	Municipalities of Namur
Ath	Municipalities of Hainaut
Attert	Municipalities of Luxembourg (Belgium)
Aubange	Municipalities of Luxembourg (Belgium)
Aubel	Municipalities of Liège
Avelgem	Municipalities of West Flanders
Awans	Municipalities of Liège
Aywaille	Municipalities of Liège
Baarle-Hertog	Municipalities of Antwerp, Exclaves
Baelen	Municipalities of Liège
Balen	Municipalities of Antwerp
Bassenge	Municipalities of Liège
Bastogne	Municipalities of Luxembourg (Belgium)
Beaumont, Belgium	Municipalities of Hainaut
Beauraing	Municipalities of Namur
Beauvechain	Municipalities of Walloon Brabant
Beernem	Municipalities of West Flanders
Beerse	Municipalities of Antwerp
Beersel	Municipalities of Flemish Brabant
Begijnendijk	Municipalities of Flemish Brabant
Bekkevoort	Municipalities of Flemish Brabant
Belœil	Municipalities of Hainaut
Beringen, Belgium	Municipalities of Limburg
Berlaar	Municipalities of Antwerp
Berlare	Municipalities of East Flanders
Berloz	Municipalities of Liège
Bernissart	Municipalities of Hainaut
Bertem	Municipalities of Flemish Brabant
Bertogne	Municipalities of Luxembourg (Belgium)
Bertrix	Municipalities of Luxembourg (Belgium)
Bever, Belgium	Municipalities of Flemish Brabant
Beveren	Municipalities of East Flanders
Beyne-Heusay	Municipalities of Liège
Bierbeek	Municipalities of Flemish Brabant
Bièvre	Municipalities of Namur
Bilzen	Municipalities of Limburg
Binche	Municipalities of Hainaut
Blankenberge	Municipalities of West Flanders, Port cities and towns of the North Sea
Blegny	Municipalities of Liège
Bocholt, Belgium	Municipalities of Limburg
Boechout	Municipalities of Antwerp
Bonheiden	Municipalities of Antwerp
Boom, Antwerp	Municipalities of Antwerp
Boortmeerbeek	Municipalities of Flemish Brabant
Borgloon	Municipalities of Limburg
Bornem	Municipalities of Antwerp
Borsbeek	Municipalities of Antwerp
John McEnroe	1959 births, American game show hosts, American male tennis players, American television talk show hosts, French Open champions, Living people, People from Wiesbaden, US Open (tennis) champions, Wimbledon champions, World No. 1 tennis players
Bouillon	Municipalities of Luxembourg (Belgium)
Boussu	Municipalities of Hainaut
Boutersem	Municipalities of Flemish Brabant
Braine-l'Alleud	Municipalities of Walloon Brabant
Braine-le-Château	Municipalities of Walloon Brabant
Braine-le-Comte	Municipalities of Hainaut
Braives	Municipalities of Liège
Brakel	Municipalities of East Flanders
Brecht, Belgium	Municipalities of Antwerp
Bredene	Municipalities of West Flanders
Bree, Belgium	Municipalities of Limburg
Brugelette	Municipalities of Hainaut
Brunehaut	Municipalities of Hainaut
Buggenhout	Spa towns in Belgium, Municipalities of East Flanders
Büllingen	Municipalities of Liège
Burdinne	Municipalities of Liège
Burg-Reuland	Municipalities of Liège
Butgenbach	Municipalities of Liège
Celles	Municipalities of Hainaut
Cerfontaine	Municipalities of Namur
Chapelle-lez-Herlaimont	Municipalities of Hainaut
Charleroi	Charleroi
Chastre	Municipalities of Walloon Brabant
Châtelet	Municipalities of Hainaut
Chaudfontaine	Spa towns in Belgium, Municipalities of Liège
Chaumont-Gistoux	Municipalities of Walloon Brabant
Chièvres	Municipalities of Hainaut
Chimay	Municipalities of Hainaut
Chiny	Municipalities of Luxembourg (Belgium)
Ciney	Municipalities of Namur
Clavier	Municipalities of Liège
Colfontaine	Municipalities of Hainaut
Comblain-au-Pont	Municipalities of Liège
Comines-Warneton	Municipalities of Hainaut
Courcelles	Municipalities of Hainaut
Court-Saint-Etienne	Municipalities of Walloon Brabant
Couvin	Municipalities of Namur
Crisnée	Municipalities of Liège
Björn Borg	1956 births, French Open champions, Living people, Male tennis players, Swedish sportspeople, Wimbledon champions, World No. 1 tennis players
Josef Manner & Comp AG	Food companies of Europe, Vienna, Companies of Austria
The Hours (movie)	2002 drama movies, 2000s LGBT movies, Academy Award winning movies, American drama movies, American LGBT movies, Bipolar disorder in fiction, British drama movies, British LGBT movies, Golden Globe Award winning movies, HIV/AIDS in movies, LGBT drama movies, Miramax movies, Movies based on books, Movies set in California, Movies set in New York City, Movies set in the 1920s, Movies set in the 1950s, Paramount movies, Suicide in movies
Linux distribution	Linux distributions
Bajaur Agency	Agencies of Federally Administered Tribal Areas
Khyber Agency	Khyber Agency
Kurram Agency	Agencies of Federally Administered Tribal Areas
Mohmand Agency	Agencies of Federally Administered Tribal Areas
Orakzai Agency	Agencies of Federally Administered Tribal Areas
North Waziristan Agency	Agencies of Federally Administered Tribal Areas
Miran Shah	Capital cities in Pakistan, Federally Administered Tribal Areas
South Waziristan	Agencies of Federally Administered Tribal Areas
National Football League playoffs	National Football League
1981–82 NHL season	1981 in the United States, 1982 in the United States
List of NHL franchise post-season appearance streaks	National Hockey League lists
Franz Xaver Süßmayr	1766 births, 1803 deaths, Austrian composers, Classical era composers
Catch Me If You Can	1980 books, Autobiographies
Maronite Church	Lebanon, Eastern Catholicism
Pantomime	Mimes, Comedy
Michael Collins (astronaut)	1930 births, 2021 deaths, Cancer deaths in Florida, American astronauts, American aviators, Apollo astronauts, Businesspeople from Washington, D.C., Scientists from Washington, D.C., Writers from Washington, D.C., American autobiographers
Saturn V	Apollo program, Rockets, Wernher von Braun
Kajaani	Towns in Finland, Municipalities of Kainuu
Michael Collins (Irish leader)	1890 births, 1922 deaths, Assassinated people, Former members of Dáil Éireann, Government ministers of Ireland, Irish Free State, Irish republicanism, Murders by firearm, People from County Cork, Prisoners of war, Sinn Féin politicians
Sophora davidii	Faboideae, Shrubs
School	Basic English 850 words, Schools
Worthing	Towns in West Sussex
Super Bowl Most Valuable Player Award	Super Bowl, Most valuable player awards
Happy Meal	McDonald's
Dalhem	Municipalities of Liège
Daverdisse	Municipalities of Luxembourg (Belgium)
De Haan, Belgium	Municipalities of West Flanders
De Panne	Municipalities of West Flanders
De Pinte	Municipalities of East Flanders
Deerlijk	Municipalities of West Flanders
Deinze	Municipalities of East Flanders
Denderleeuw	Municipalities of East Flanders
Dendermonde	Municipalities of East Flanders
Dentergem	Municipalities of West Flanders
Dessel	Municipalities of Antwerp
Destelbergen	Municipalities of East Flanders
Diepenbeek	Municipalities of Limburg
Diest	Municipalities of Flemish Brabant
Diksmuide	Municipalities of West Flanders
Dilbeek	Municipalities of Flemish Brabant
Dilsen-Stokkem	Municipalities of Limburg
Dinant	Municipalities of Namur
Dison	Municipalities of Liège
Doische	Municipalities of Namur
Donceel	Municipalities of Liège
Dour	Municipalities of Hainaut
Drogenbos	Municipalities of Flemish Brabant
Duffel	Municipalities of Antwerp
Durbuy	Municipalities of Luxembourg (Belgium)
Ecaussinnes	Municipalities of Hainaut
Edegem	Municipalities of Antwerp
Eeklo	Municipalities of East Flanders
Eghezée	Municipalities of Namur
Ellezelles	Municipalities of Hainaut
Ixelles	Municipalities of Brussels-Capital Region
Enghien	Municipalities of Hainaut
Engis	Municipalities of Liège
Erezée	Municipalities of Luxembourg (Belgium)
Erpe-Mere	Municipalities of East Flanders
Erquelinnes	Municipalities of Hainaut
Esneux	Municipalities of Liège
Essen, Belgium	Municipalities of Antwerp
Estaimpuis	Municipalities of Hainaut
Estinnes	Municipalities of Hainaut
Étalle	Municipalities of Luxembourg (Belgium)
Etterbeek	Municipalities of Brussels-Capital Region
Eupen	Municipalities of Liège
Evere	Municipalities of Brussels-Capital Region
Evergem	Municipalities of East Flanders
Isaac (disambiguation)	Surnames, Given names
Faimes	Municipalities of Liège
Farciennes	Municipalities of Hainaut
Fauvillers	Municipalities of Luxembourg (Belgium)
Fernelmont	Municipalities of Namur
Ferrières	Municipalities of Liège
Fexhe-le-Haut-Clocher	Municipalities of Liège
Flémalle	Municipalities of Liège
Fléron	Municipalities of Liège
Fleurus	Municipalities of Hainaut
Flobecq	Municipalities of Hainaut
Floreffe	Municipalities of Namur
Florennes	Municipalities of Namur
Florenville	Municipalities of Luxembourg (Belgium)
Fontaine-l'Evêque	Municipalities of Hainaut
Fosses-la-Ville	Municipalities of Namur
Frameries	Municipalities of Hainaut
Frasnes-lez-Anvaing	Municipalities of Hainaut
Froidchapelle	Municipalities of Hainaut
Galmaarden	Municipalities of Flemish Brabant
Ganshoren	Municipalities of Brussels-Capital Region
Gavere	Municipalities of East Flanders
Gedinne	Municipalities of Namur
Geel	Municipalities of Antwerp
Geer	Municipalities of Liège
Geetbets	Municipalities of Flemish Brabant
Gembloux	Municipalities of Namur
Genappe	Municipalities of Walloon Brabant
Genk	Municipalities of Limburg
Ghent	Ghent
Geraardsbergen	Municipalities of East Flanders
Gerpinnes	Municipalities of Hainaut
Gesves	Municipalities of Namur
Gingelom	Municipalities of Limburg
Gistel	Municipalities of West Flanders
Glabbeek	Municipalities of Flemish Brabant
Gooik	Municipalities of Flemish Brabant
Gouvy	Municipalities of Luxembourg (Belgium)
Grâce-Hollogne	Municipalities of Liège
Grez-Doiceau	Municipalities of Walloon Brabant
Grimbergen	Municipalities of Flemish Brabant
Grobbendonk	Municipalities of Antwerp
Haacht	Municipalities of Flemish Brabant
Wild card (sports)	Sports words
Haaltert	Municipalities of East Flanders
Habay	Municipalities of Luxembourg (Belgium)
Halen	Municipalities of Limburg
Halle (Belgium)	Municipalities of Flemish Brabant
Ham (Belgium)	Municipalities of Limburg
Ham-sur-Heure-Nalinnes	Municipalities of Hainaut
Hamme	Municipalities of East Flanders
Hamoir	Municipalities of Liège
Hamois	Municipalities of Namur
Hamont-Achel	Municipalities of Limburg
Hannut	Municipalities of Liège
Harelbeke	Municipalities of West Flanders
Hastière	Municipalities of Namur
Havelange	Municipalities of Namur
Hechtel-Eksel	Municipalities of Limburg
Heers	Municipalities of Limburg
Heist-op-den-Berg	Municipalities of Antwerp
Hélécine	Municipalities of Walloon Brabant
Hemiksem	Municipalities of Antwerp
Hensies	Municipalities of Hainaut
Herbeumont	Municipalities of Luxembourg (Belgium)
Herent	Municipalities of Flemish Brabant
Herentals	Municipalities of Antwerp
Herenthout	Municipalities of Antwerp
Herk-de-Stad	Municipalities of Limburg
Herne (Belgium)	Municipalities of Flemish Brabant
Héron	Municipalities of Liège
Herselt	Municipalities of Antwerp
Herstal	Municipalities of Liège
Herstappe	Municipalities of Limburg
Herve	Municipalities of Liège
Herzele	Municipalities of East Flanders
Heusden-Zolder	Municipalities of Limburg
Heuvelland	Municipalities of West Flanders
Hoegaarden	Municipalities of Flemish Brabant
Hoeilaart	Municipalities of Flemish Brabant
Hoeselt	Municipalities of Limburg
Holsbeek	Municipalities of Flemish Brabant
Honnelles	Municipalities of Hainaut
Hooglede	Municipalities of West Flanders
Hoogstraten	Municipalities of Antwerp
Horebeke	Municipalities of East Flanders
Hotton	Municipalities of Luxembourg (Belgium)
Houffalize	Municipalities of Luxembourg (Belgium)
Houthalen-Helchteren	Municipalities of Limburg
Houthulst	Municipalities of West Flanders
Houyet	Municipalities of Namur
Hove	Municipalities of Antwerp
Huldenberg	Municipalities of Flemish Brabant
Hulshout	Municipalities of Antwerp
Huy	Municipalities of Liège
Friedrich Rittelmeyer	1872 births, 1938 deaths, German Lutherans, German theologians, People from Bavaria, Christian ministers
Ichtegem	Municipalities of West Flanders
Ypres	Municipalities of West Flanders
Incourt	Municipalities of Walloon Brabant
Ingelmunster	Municipalities of West Flanders
Ittre	Municipalities of Walloon Brabant
Izegem	Municipalities of West Flanders
Jabbeke	Municipalities of West Flanders
Jalhay	Municipalities of Liège
Jemeppe-sur-Sambre	Municipalities of Namur
Jette	Municipalities of Brussels-Capital Region
Jodoigne	Municipalities of Walloon Brabant
Juprelle	Municipalities of Liège
Jurbise	Municipalities of Hainaut
Kalmthout	Municipalities of Antwerp
Kampenhout	Municipalities of Flemish Brabant
Kapelle-op-den-Bos	Municipalities of Flemish Brabant
Kapellen, Belgium	Municipalities of Antwerp
Kaprijke	Municipalities of East Flanders
Kasterlee	Municipalities of Antwerp
Keerbergen	Municipalities of Flemish Brabant
Kelmis	Municipalities of Liège
Kinrooi	Municipalities of Limburg
Kluisbergen	Municipalities of East Flanders
Knesselare	Former municipalities of Belgium, Municipalities of East Flanders
Knokke-Heist	Municipalities of West Flanders, Port cities and towns of the North Sea
Koekelare	Municipalities of West Flanders
Koekelberg	Municipalities of Brussels-Capital Region
Koksijde	Municipalities of West Flanders
Kontich	Municipalities of Antwerp
Kortemark	Municipalities of West Flanders
Kortenaken	Municipalities of Flemish Brabant
Kortenberg	Municipalities of Flemish Brabant
Kortessem	Municipalities of Limburg
Kortrijk	Municipalities of West Flanders
Kraainem	Municipalities of Flemish Brabant
Kruibeke	Municipalities of East Flanders
Kruishoutem	Former municipalities of Belgium, Municipalities of East Flanders
Kuurne	Municipalities of West Flanders
La Bruyère	Municipalities of Namur
La Hulpe	Municipalities of Walloon Brabant
La Louvière	Municipalities of Hainaut
La Roche-en-Ardenne	Municipalities of Luxembourg (Belgium)
Laakdal	Municipalities of Antwerp
Laarne	Municipalities of East Flanders
Lanaken	Municipalities of Limburg
Landen	Municipalities of Flemish Brabant
Langemark-Poelkapelle	Municipalities of West Flanders
Lasne	Municipalities of Walloon Brabant
Le Rœulx	Municipalities of Hainaut
Lebbeke	Municipalities of East Flanders
Lede	Municipalities of East Flanders
Ledegem	Municipalities of West Flanders
Léglise	Municipalities of Luxembourg (Belgium)
Lendelede	Municipalities of West Flanders
Lennik	Municipalities of Flemish Brabant
Lens (Belgium)	Municipalities of Hainaut
Leopoldsburg	Municipalities of Limburg
Les Bons Villers	Municipalities of Hainaut
Lessines	Municipalities of Hainaut
Leuven	Municipalities of Flemish Brabant, Provincial capitals of Belgium
Leuze-en-Hainaut	Municipalities of Hainaut
Libin	Municipalities of Luxembourg (Belgium)
Libramont-Chevigny	Municipalities of Luxembourg (Belgium)
Lichtervelde	Municipalities of West Flanders
Liedekerke	Municipalities of Flemish Brabant
Karyotype	Chromosomes
Liège	Liège
Lier, Belgium	Municipalities of Antwerp
Lierde	Municipalities of East Flanders
Lierneux	Municipalities of Liège
Lille (Belgium)	Municipalities of Antwerp
Lincent	Municipalities of Liège
Linkebeek	Municipalities of Flemish Brabant
Lint (Belgium)	Municipalities of Antwerp
Linter	Municipalities of Flemish Brabant
Lo-Reninge	Municipalities of West Flanders
Lobbes	Municipalities of Hainaut
Lochristi	Municipalities of East Flanders
Lokeren	Municipalities of East Flanders
Lommel	Municipalities of Limburg
Londerzeel	Municipalities of Flemish Brabant
Idomeneo	Compositions by Wolfgang Amadeus Mozart, 1780s operas, 1781
Lontzen	Municipalities of Liège
Lovendegem	Former municipalities of Belgium, Municipalities of East Flanders
Lubbeek	Municipalities of Flemish Brabant
Lummen	Municipalities of Limburg
Maarkedal	Municipalities of East Flanders
Maaseik	Municipalities of Limburg
Maasmechelen	Municipalities of Limburg
Machelen	Municipalities of Flemish Brabant
Maldegem	Municipalities of East Flanders
Malle	Municipalities of Antwerp
Malmedy	Municipalities of Liège
Manage	Municipalities of Hainaut
Manhay	Municipalities of Luxembourg (Belgium)
Marche-en-Famenne	Municipalities of Luxembourg (Belgium)
Marchin	Municipalities of Liège
Martelange	Municipalities of Luxembourg (Belgium)
Mechelen	Municipalities of Antwerp
Meerhout	Municipalities of Antwerp
Meeuwen-Gruitrode	Former municipalities of Belgium, Municipalities of Limburg
Meise	Municipalities of Flemish Brabant
Meix-devant-Virton	Municipalities of Luxembourg (Belgium)
Melle	Municipalities of East Flanders
Menen	Municipalities of West Flanders
Merbes-le-Château	Municipalities of Hainaut
Merchtem	Municipalities of Flemish Brabant
Merelbeke	Municipalities of East Flanders
Merksplas	Municipalities of Antwerp
Mesen	Municipalities of West Flanders
Messancy	Municipalities of Luxembourg (Belgium)
Mettet	Municipalities of Namur
Meulebeke	Municipalities of West Flanders
Middelkerke	Municipalities of West Flanders
Modave	Municipalities of Liège
Moerbeke	Municipalities of East Flanders
Momignies	Municipalities of Hainaut
Mont-de-l'Enclus	Municipalities of Hainaut
Mont-Saint-Guibert	Municipalities of Walloon Brabant
Montigny-le-Tilleul	Municipalities of Hainaut
Moorslede	Municipalities of West Flanders
Morlanwelz	Municipalities of Hainaut
Mortsel	Municipalities of Antwerp
Mouscron	Municipalities of Hainaut
Musson	Municipalities of Luxembourg (Belgium)
Nandrin	Municipalities of Liège
Nassogne	Municipalities of Luxembourg (Belgium)
Nazareth (Belgium)	Municipalities of East Flanders
Neerpelt	Former municipalities of Belgium, Municipalities of Limburg
Neufchâteau	Municipalities of Luxembourg (Belgium)
Neupré	Municipalities of Liège
Nevele	Former municipalities of Belgium, Municipalities of East Flanders
Niel	Municipalities of Antwerp
Nieuwerkerken	Municipalities of Limburg
Nieuwpoort, Belgium	Municipalities of West Flanders, Port cities and towns of the North Sea
Nijlen	Municipalities of Antwerp
Ninove	Municipalities of East Flanders
Nivelles	Municipalities of Walloon Brabant
Ohey	Municipalities of Namur
Olen	Municipalities of Antwerp
Olne	Municipalities of Liège
Onhaye	Municipalities of Namur
Oosterzele	Municipalities of East Flanders
Oostkamp	Municipalities of West Flanders
Oostrozebeke	Municipalities of West Flanders
Opglabbeek	Former municipalities of Belgium, Municipalities of Limburg
Opwijk	Municipalities of Flemish Brabant
Oreye	Municipalities of Liège
Orp-Jauche	Municipalities of Walloon Brabant
Ottignies-Louvain-la-Neuve	Municipalities of Walloon Brabant
Oud-Heverlee	Municipalities of Flemish Brabant
Oud-Turnhout	Municipalities of Antwerp
Oudenaarde	Municipalities of East Flanders
Oudenburg	Municipalities of West Flanders
Oudergem	Municipalities of Brussels-Capital Region
Ouffet	Municipalities of Liège
Oupeye	Municipalities of Liège
Carbohydrate	Carbohydrates
Overijse	Municipalities of Flemish Brabant
Overpelt	Former municipalities of Belgium, Municipalities of Limburg
Paliseul	Municipalities of Luxembourg (Belgium)
Pecq	Municipalities of Hainaut
Peer, Belgium	Municipalities of Limburg
Pepingen	Municipalities of Flemish Brabant
Pepinster	Municipalities of Liège
Péruwelz	Municipalities of Hainaut
Perwez	Municipalities of Walloon Brabant
Philippeville	Municipalities of Namur
Pittem	Municipalities of West Flanders
Plombières	Municipalities of Liège
Pont-à-Celles	Municipalities of Hainaut
Poperinge	Municipalities of West Flanders
Profondeville	Municipalities of Namur
Putte	Municipalities of Antwerp
Puurs	Former municipalities of Belgium, Municipalities of Antwerp
Quaregnon	Municipalities of Hainaut
Quévy	Municipalities of Hainaut
Quiévrain	Municipalities of Hainaut
Raeren	Municipalities of Liège
Ramillies	Municipalities of Walloon Brabant
Ranst	Municipalities of Antwerp
Ravels	Municipalities of Antwerp
Rebecq	Municipalities of Walloon Brabant
Remicourt	Municipalities of Liège
Rendeux	Municipalities of Luxembourg (Belgium)
Retie	Municipalities of Antwerp
Riemst	Municipalities of Limburg
Rijkevorsel	Municipalities of Antwerp
Rixensart	Municipalities of Walloon Brabant
Rochefort	Municipalities of Namur
Roeselare	Municipalities of West Flanders
Ronse	Municipalities of East Flanders
Roosdaal	Municipalities of Flemish Brabant
Rotselaar	Municipalities of Flemish Brabant
Rouvroy	Municipalities of Luxembourg (Belgium)
Ruiselede	Municipalities of West Flanders
Rumes	Municipalities of Hainaut
Rumst	Municipalities of Antwerp
Saint-Georges-sur-Meuse	Municipalities of Liège
Saint-Ghislain	Municipalities of Hainaut
Saint-Hubert	Municipalities of Luxembourg (Belgium)
Saint-Léger, Belgium	Municipalities of Luxembourg (Belgium)
Saint-Nicolas, Belgium	Municipalities of Liège
Saint-Vith	Municipalities of Liège
Sainte-Ode	Municipalities of Luxembourg (Belgium)
Sambreville	Municipalities of Namur
Schaerbeek	Municipalities of Brussels-Capital Region
Schelle	Municipalities of Antwerp
Scherpenheuvel-Zichem	Municipalities of Flemish Brabant
Schilde	Municipalities of Antwerp
Schoten	Municipalities of Antwerp
Seneffe	Municipalities of Hainaut
Seraing	Municipalities of Liège
Silly, Belgium	Municipalities of Hainaut
Sint-Agatha-Berchem	Municipalities of Brussels-Capital Region
Sint-Amands	Former municipalities of Belgium, Municipalities of Antwerp
Sint-Genesius-Rode	Municipalities of Flemish Brabant
Sint-Gillis-Waas	Municipalities of East Flanders
Sint-Jans-Molenbeek	Municipalities of Brussels-Capital Region
Saint-Josse-ten-Noode	Municipalities of Brussels-Capital Region
Sint-Katelijne-Waver	Municipalities of Antwerp
Woluwe-Saint-Lambert	Municipalities of Brussels-Capital Region
Sint-Laureins	Municipalities of East Flanders
Sint-Lievens-Houtem	Municipalities of East Flanders
Sint-Martens-Latem	Municipalities of East Flanders
Sint-Niklaas	Municipalities of East Flanders
Sint-Pieters-Leeuw	Municipalities of Flemish Brabant
Woluwe-Saint-Pierre	Municipalities of Brussels-Capital Region
Sint-Truiden	Municipalities of Limburg
Sivry-Rance	Municipalities of Hainaut
Soignies	Municipalities of Hainaut
Sombreffe	Municipalities of Namur
Somme-Leuze	Municipalities of Namur
Soumagne	Municipalities of Liège
Spa, Belgium	Spa towns in Belgium, Municipalities of Liège
Spiere-Helkijn	Municipalities of West Flanders
Sprimont	Municipalities of Liège
Stabroek	Municipalities of Antwerp
Staden	Municipalities of West Flanders
Stavelot	Municipalities of Liège
Steenokkerzeel	Municipalities of Flemish Brabant
Stekene	Municipalities of East Flanders
Stoumont	Municipalities of Liège
Tellin	Municipalities of Luxembourg (Belgium)
Temse	Municipalities of East Flanders
Tenneville	Municipalities of Luxembourg (Belgium)
Ternat	Municipalities of Flemish Brabant
Tervuren	Municipalities of Flemish Brabant
Tessenderlo	Municipalities of Limburg
Theux	Municipalities of Liège
Thimister-Clermont	Municipalities of Liège
Thuin	Municipalities of Hainaut
Tielt	Municipalities of West Flanders
Tielt-Winge	Municipalities of Flemish Brabant
Tienen	Municipalities of Flemish Brabant
Tinlot	Municipalities of Liège
Tintigny	Municipalities of Luxembourg (Belgium)
Tongeren	Municipalities of Limburg
Torhout	Municipalities of West Flanders
Tournai	Municipalities of Hainaut
Tremelo	Municipalities of Flemish Brabant
Trois-Ponts	Municipalities of Liège
Trooz	Municipalities of Liège
Tubize	Municipalities of Walloon Brabant
Turnhout	Municipalities of Antwerp
Uccle	Municipalities of Brussels-Capital Region
Vaux-sur-Sûre	Municipalities of Luxembourg (Belgium)
Verlaine	Municipalities of Liège
Verviers	Municipalities of Liège, Cities in Belgium
Veurne	Municipalities of West Flanders
Vielsalm	Municipalities of Luxembourg (Belgium)
Villers-la-Ville	Municipalities of Walloon Brabant
Villers-le-Bouillet	Municipalities of Liège
Vilvoorde	Municipalities of Flemish Brabant
Viroinval	Municipalities of Namur
Virton	Municipalities of Luxembourg (Belgium)
Visé	Municipalities of Liège
Vleteren	Municipalities of West Flanders
Voeren	Municipalities of Limburg
Vorselaar	Municipalities of Antwerp
Forest, Belgium	Municipalities of Brussels-Capital Region
Vosselaar	Municipalities of Antwerp
Vresse-sur-Semois	Municipalities of Namur
Waarschoot	Former municipalities of Belgium, Municipalities of East Flanders
Waasmunster	Municipalities of East Flanders
Wachtebeke	Municipalities of East Flanders
Waimes	Municipalities of Liège
Walcourt	Municipalities of Namur
Walhain	Municipalities of Walloon Brabant
Wanze	Municipalities of Liège
Waregem	Municipalities of West Flanders
Waremme	Municipalities of Liège
Wasseiges	Municipalities of Liège
Wavre	Municipalities of Walloon Brabant, Provincial capitals of Belgium
Welkenraedt	Municipalities of Liège
Wellen	Municipalities of Limburg
Wellin	Municipalities of Luxembourg (Belgium)
Wemmel	Municipalities of Flemish Brabant
Wervik	Municipalities of West Flanders
Westerlo	Municipalities of Antwerp
Wetteren	Municipalities of East Flanders
Wevelgem	Municipalities of West Flanders
Wezembeek-Oppem	Municipalities of Flemish Brabant
Wichelen	Municipalities of East Flanders
Wielsbeke	Municipalities of West Flanders
Wijnegem	Municipalities of Antwerp
Willebroek	Municipalities of Antwerp
Wingene	Municipalities of West Flanders
Wommelgem	Municipalities of Antwerp
Wortegem-Petegem	Municipalities of East Flanders
Wuustwezel	Municipalities of Antwerp
Yvoir	Municipalities of Namur
Zandhoven	Municipalities of Antwerp
Zaventem	Municipalities of Flemish Brabant
Zedelgem	Municipalities of West Flanders
Zele	Municipalities of East Flanders
Zelzate	Municipalities of East Flanders
Zemst	Municipalities of Flemish Brabant
Zingem	Former municipalities of Belgium, Municipalities of East Flanders
Zoersel	Municipalities of Antwerp
Zomergem	Former municipalities of Belgium, Municipalities of East Flanders
Zonhoven	Municipalities of Limburg
Zonnebeke	Municipalities of West Flanders
Zottegem	Municipalities of East Flanders
Zoutleeuw	Municipalities of Flemish Brabant
Zuienkerke	Municipalities of West Flanders
Zulte	Municipalities of East Flanders
Zutendaal	Municipalities of Limburg
Zwalm	Municipalities of East Flanders
Zwevegem	Municipalities of West Flanders
Zwijndrecht, Belgium	Municipalities of Antwerp
Sai Baba of Shirdi	Year of birth unknown, 1918 deaths, Deaths from natural causes, Indian people, Spiritual teachers
Mast-Allah	Spirituality, Islam
Bob Sauvé	1955 births, American Hockey League players, Buffalo Sabres players, Canadian ice hockey goaltenders, Chicago Blackhawks players, Detroit Red Wings players, Ice hockey people from Quebec, Laval National players, Living people, New Jersey Devils players, Sportspeople from Montreal, Verdun Maple Leafs (ice hockey) players, Vezina Trophy winners
Salarzai	Pakistani tribes
Utmankhel	Pakistani tribes, Ethnic groups in Pakistan, Ethnic groups in Khyber Pakhtunkhwa
Bara Tehsil	Khyber Agency
Jamrud	Khyber Agency
Upper Orakzai Tehsil	Tehsils of Khyber Pakhtunkhwa
Ghulam Khan Tehsil	Tehsils of Pakistan
Mir Ali Tehsil	Tehsils of Pakistan
Razmak Tehsil	Tehsils of Pakistan
Sofiensaal	Concert halls
Ordinary language philosophy	Philosophy
Attock Tehsil	Tehsils of Punjab (Pakistan)
Fateh Jang Tehsil	Tehsils of Punjab (Pakistan)
Jand Tehsil	Tehsils of Punjab (Pakistan)
Hazro Tehsil	Tehsils of Punjab (Pakistan)
Jhal Jhao Tehsil	Tehsils of Balochistan
Korak Tehsil	Tehsils of Balochistan
Badin	Cities in Pakistan, Badin District
Ticket	Basic English 850 words
Matli Taluka	Talukas of Sindh, Badin District
Fort Abbas Tehsil	Tehsils of Punjab (Pakistan)
Ahmedpur Sharqia Tehsil	Tehsils of Punjab (Pakistan)
Bahawalpur Tehsil	Tehsils of Punjab (Pakistan)
Hasilpur Tehsil	Tehsils of Punjab (Pakistan)
Christopher Smart	English poets, 1722 births, 1771 deaths, Alumni of the University of Oxford, Christian hymnwriters, English children's writers, English playwrights, English writers, Musicians from Kent
Bhakkar Tehsil	Tehsils of Punjab (Pakistan)
Darya Khan Tehsil	Tehsils of Punjab (Pakistan)
Talagang Tehsil	Tehsils of Punjab (Pakistan)
Tangi Tehsil	Tehsils of Khyber Pakhtunkhwa
Taunsa Tehsil	Tehsils of Punjab (Pakistan)
Kulachi Tehsil	Tehsils of Khyber Pakhtunkhwa
Paharpur Tehsil	Tehsils of Khyber Pakhtunkhwa
Bhaderwah Tehsil	Tehsils of Jammu and Kashmir
Andy Roddick	1982 births, American male tennis players, Living people, Sportspeople from Omaha, Nebraska, US Open (tennis) champions, World No. 1 tennis players
Kishtwar Tehsil	Tehsils of Jammu and Kashmir
Ramban Tehsil	Tehsils of Jammu and Kashmir
La Clemenza di Tito	Operas
Ghotki	Ghotki District
Mirpur Mathelo	Cities in Pakistan, Ghotki District
Kamoki Tehsil	Tehsils of Punjab (Pakistan)
Nowshera Virkan Tehsil	Tehsils of Punjab (Pakistan)
Wazirabad Tehsil	Tehsils of Punjab (Pakistan)
Gujrat Tehsil	Tehsils of Punjab (Pakistan)
Kharian Tehsil	Tehsils of Punjab (Pakistan)
Sarai Alamgir Tehsil	Tehsils of Punjab (Pakistan)
Jiwani Tehsil	Tehsils of Balochistan
Ormara Tehsil	Tehsils of Balochistan
Jacobabad Taluka	Talukas of Sindh, Jacobabad District
Bishnah Tehsil	Tehsils of Jammu and Kashmir
Chiniot Tehsil	Districts of Punjab (Pakistan)
Shorkot Tehsil	Tehsils of Punjab (Pakistan)
Jhelum Tehsil	Tehsils of Punjab (Pakistan)
Sohawa Tehsil	Tehsils of Punjab (Pakistan)
Pind Dadan Khan Tehsil	Tehsils of Punjab (Pakistan)
Dina	Towns in Pakistan
Takht-e-Nasrati Tehsil	Tehsils of Khyber Pakhtunkhwa
Kashmore	Cities in Pakistan
Kasur Tehsil	Tehsils of Punjab (Pakistan)
Pattoki Tehsil	Tehsils of Punjab (Pakistan)
Kabirwala Tehsil	Tehsils of Punjab (Pakistan)
Khanewal Tehsil	Tehsils of Punjab (Pakistan)
Jahanian Tehsil	Tehsils of Punjab (Pakistan)
Mian Channu Tehsil	Tehsils of Punjab (Pakistan)
Kharan, Pakistan	Tehsils of Balochistan
Kohlu Tehsil	Tehsils of Balochistan
Liane de Pougy	1869 births, 1950 deaths, French dancers
Handwara Tehsil	Tehsils of Jammu and Kashmir
Kupwara Tehsil	Tehsils of Jammu and Kashmir
Renala Khurd Tehsil	Tehsils of Punjab (Pakistan)
Hub Tehsil	Tehsils of Balochistan
Sonmiani Tehsil	Tehsils of Balochistan
Uthal Tehsil	Tehsils of Balochistan
Lodhran Tehsil	Tehsils of Punjab (Pakistan)
Mansehra Tehsil	Tehsils of Khyber Pakhtunkhwa
Mardan Tehsil	Tehsils of Khyber Pakhtunkhwa
Takht Bhai Tehsil	Tehsils of Khyber Pakhtunkhwa
Dasht Tehsil	Tehsils of Balochistan
Mastung Tehsil	Tehsils of Balochistan
Hala, Sindh	Settlements in Sindh, Matiari District
Matiari	Settlements in Sindh, Matiari District
Isakhel Tehsil	Tehsils of Punjab (Pakistan)
Mianwali Tehsil	Tehsils of Punjab (Pakistan)
Piplan Tehsil	Tehsils of Punjab (Pakistan)
Mumtazabad Tehsil	Tehsils of Punjab (Pakistan)
Sher Shah	Tehsils of Punjab (Pakistan)
Jatoi Tehsil	Tehsils of Punjab (Pakistan)
Kot Addu Tehsil	Tehsils of Punjab (Pakistan)
Muzaffargarh	Tehsils of Punjab (Pakistan)
Sangla Hill Tehsil	Tehsils of Punjab (Pakistan)
Shahkot Tehsil	Tehsils of Punjab (Pakistan)
Narowal Tehsil	Tehsils of Punjab (Pakistan)
Shakargarh Tehsil	Tehsils of Punjab (Pakistan)
Jhal Magsi Tehsil	Tehsils of Balochistan
Bhiria	Settlements in Sindh, Naushahro Feroze District
Moro	Settlements in Sindh, Naushahro Feroze District
Mehrabpur	Settlements in Sindh, Naushahro Feroze District
Mailsi Tehsil	Tehsils of Punjab (Pakistan)
Vehari Tehsil	Tehsils of Punjab (Pakistan)
The Omen	1976 horror movies, 1970s horror thriller movies, 20th Century Fox movies, Academy Award winning movies, American horror thriller movies, American supernatural movies, Movies composed by Jerry Goldsmith, Movies set in England, Movies set in Rome
Faker	Australian alternative rock bands, Indie bands, Musical groups from Sydney
Pakpattan Tehsil	Tehsils of Punjab (Pakistan)
Panjgur	Tehsils of Balochistan
Pishin	Tehsils of Balochistan
Pampore Tehsil	Tehsils of Jammu and Kashmir
Pulwama Tehsil	Tehsils of Jammu and Kashmir
Tral Tehsil	Tehsils of Jammu and Kashmir
Khanpur Tehsil	Tehsils of Punjab (Pakistan)
Sadiqabad Tehsil	Tehsils of Punjab (Pakistan)
Jampur Tehsil	Tehsils of Punjab (Pakistan)
Rajouri Tehsil	Tehsils of Jammu and Kashmir
Sunderbani Tehsil	Tehsils of Jammu and Kashmir
Thanamandi Tehsil	Tehsils of Jammu and Kashmir, Tehsils of Azad Kashmir
Gujar Khan Tehsil	Tehsils of Punjab (Pakistan)
Kahuta Tehsil	Tehsils of Punjab (Pakistan)
Kotli Sattian Tehsil	Tehsils of Punjab (Pakistan)
Murree Tehsil	Tehsils of Punjab (Pakistan)
Rawalpindi Tehsil	Tehsils of Punjab (Pakistan)
Taxila Tehsil	Tehsils of Punjab (Pakistan)
Jhando Mari	Settlements in Sindh, Tando Allahyar District
Mithi	Cities in Pakistan
Spandau Ballet	1979 establishments in England, 1970s British music groups, 1980s British music groups, 1990s British music groups, 2000s British music groups, 2010s British music groups, English pop music groups, English rock bands, Musical groups established in 1979, Musical groups from London, Musical groups disestablished in 1990, 1990 disestablishments in Europe, 1990s disestablishments in England, Musical groups established in 2009, 2009 establishments in England
Chevrolet Corvette	Chevrolet automobiles, Sports cars, 1950s automobiles, 1960s automobiles, 1970s automobiles, 1980s automobiles, 1990s automobiles, 2000s automobiles, 2010s automobiles, 2020s automobiles
Bhumibol Adulyadej	1927 births, 2016 deaths, Deaths from renal failure, Kings and queens, People from Cambridge, Massachusetts, People with Parkinson's disease, Order of Merit of the Federal Republic of Germany, Thai nobility
Don Edwards (ice hockey)	1955 births, Buffalo Sabres players, Calgary Flames players, Canadian ice hockey goaltenders, Ice hockey people from Ontario, Living people, National Hockey League broadcasters, People from Hamilton, Toronto Maple Leafs players, Vezina Trophy winners, American Hockey League players, Ontario Hockey League players
List of NHL franchise post-season droughts	National Hockey League lists
Eine kleine Nachtmusik	Compositions by Wolfgang Amadeus Mozart
Jam Nawaz Ali Tehsil	Talukas of Sindh
Khipro Tehsil	Talukas of Sindh
Sanghar Taluka	Talukas of Sindh
Shahdadpur Tehsil	Talukas of Sindh
Sinjhoro Tehsil	Talukas of Sindh
Tando Adam Khan Tehsil	Talukas of Sindh
Bhalwal Tehsil	Tehsils of Punjab (Pakistan)
Sargodha Tehsil	Tehsils of Punjab (Pakistan)
Sillanwali Tehsil	Tehsils of Punjab (Pakistan)
Puran Tehsil	Tehsils of Shangla District
Martung	Tehsils of Shangla District
Daska Tehsil	Tehsils of Punjab (Pakistan)
Pasrur Tehsil	Tehsils of Punjab (Pakistan)
Sambrial Tehsil	Tehsils of Punjab (Pakistan)
Lehri Tehsil	Tehsils of Balochistan
Sukkur Taluka	Talukas of Sindh
Rohri Taluka	Talukas of Sindh
The Simpsons (season 1)	1989 in American television, 1990 in American television, The Simpsons seasons, 1990s television seasons
Patrick Rafter	1972 births, 2000 Summer Olympics, Australian male tennis players, Australian of the Year Award winners, Australian Olympians, Australian Open champions, Living people, Sportspeople from Queensland, US Open (tennis) champions, World No. 1 tennis players
Pat Cash	1965 births, Australian male tennis players, Australian Olympians, Living people, Sportspeople from Melbourne, Wimbledon champions
Steve Young	College Football Hall of Fame, Pro Football Hall of Fame, San Francisco 49ers players, Tampa Bay Buccaneers players, 1961 births, Living people, Sportspeople from Salt Lake City, Utah
Pioneer 10	Pioneer program
San Siro	Sports buildings in Italy, 1926 establishments in Italy
The Chronicles of Narnia movie series	The Chronicles of Narnia, Series of movies
2008 in movies	2008 movies, Lists of movies
Super Bowl XXXIV	Super Bowl, Sports in Atlanta, Georgia, 2000 in sports, St. Louis Rams, 2000 in the United States, 20th century in Georgia (U.S. state), History of Atlanta, Georgia
Evangelical Church in Germany	Calvinism, Lutheranism, Protestantism in Germany
Season (sports)	Sports words, Sports seasons
Billy Reid	1963 births, Living people, Scottish football managers, Scottish footballers
Csaba László	1964 births, Living people, Romanian footballers, Romanian football managers, Hungarian footballers, Hungarian football managers
Mixu Paatelainen	1967 births, Living people, Finnish footballers, Football managers, Sportspeople from Helsinki
Craig Brewster	1966 births, Living people, People from Dundee, Scottish football managers, Scottish footballers
Jim Jefferies	1950 births, Living people, Scottish football managers, Scottish footballers
Mark McGhee	1957 births, Living people, Scottish football managers, Scottish footballers, Sportspeople from Glasgow
Walter Smith	1948 births, Living people, Scottish footballers, Scottish football managers
Richard Hamilton (artist)	Companions of Honour, English painters, Artists from London, 1922 births, 2011 deaths
Peter Blake (artist)	1932 births, Living people, English artists, English painters, People from Dartford
Sehwan Sharif Tehsil	Talukas of Sindh
Dokri	Larkana District
Okara Tehsil	Tehsils of Punjab (Pakistan)
Landi Kotal Tehsil	Khyber Agency
Liège (province)	Liège (province)
East Flanders	East Flanders
Flemish Brabant	Flemish Brabant
Network card	Computer networking, Computer hardware
Genogram	Genealogy
Ancestor table	Genealogy
Coupé	Coupes, Automobile body styles
Gus MacPherson	1968 births, Living people, Scottish football managers, Scottish footballers
St. Johnstone F.C.	Scottish Premier League clubs, 1884 establishments in the United Kingdom, 1880s establishments in Scotland
Bookcase	Furniture
Spreadsheet	Spreadsheet software
Bill Anderson	1912 births, Canadian ice hockey defencemen, Boston Bruins players, Ice hockey people from Ontario, 1991 deaths
John Aiken	1932 births, American ice hockey players, Living people, Montreal Canadiens players, Sportspeople from Massachusetts
Sebastien Centomo	1981 births, Canadian ice hockey goaltenders, Living people, Toronto Maple Leafs players, Ice hockey people from Quebec
Alexander Andrievsky	1968 births, Belarusian ice hockey players, Chicago Blackhawks players, Living people, People from Minsk, International Hockey League (1945–2001) players
1931–32 NHL season	1931 in North America, 1932 in North America
Bigpoint GmbH	Online games
Space Invasion	Online games
Stromatolite	Fossils
Newington, London	London Borough of Southwark
Makemake (dwarf planet)	Dwarf planets
Encyclopedia Dramatica	Wikis, Websites
Super Bowl XXXVI	Super Bowl, 2002 in sports, New England Patriots, St. Louis Rams, 2002 in the United States, 2000s in Louisiana
Marc Bulger	1977 births, American football quarterbacks, Atlanta Falcons players, Baltimore Ravens players, Living people, New Orleans Saints players, Sportspeople from Pittsburgh, Pennsylvania, St. Louis Rams players
Pro Bowl	Hawaii, National Football League, 1980 establishments in the United States, 20th-century establishments in Hawaii
Dennis Green	1949 births, 2016 deaths, Deaths from myocardial infarction, National Football League coaches, People from Harrisburg, Pennsylvania, College football coaches
Emmitt Smith	1969 births, Living people, American Christians, Arizona Cardinals players, Dallas Cowboys players, College Football Hall of Fame, Sportspeople from Florida, American football running backs, People from Pensacola, Florida
Moons of Pluto	Pluto's moons
Herbarium	Agricultural buildings, Botany
Slash fiction	Writing, LGBT, Fiction genres
Big Brother 9 (UK)	2008 television seasons, 2000s British television series, Big Brother seasons
Glory (religion)	Christian theology, Judaism
Groin	Body parts
Bart Starr	Green Bay Packers players, Sportspeople from Alabama, Pro Football Hall of Fame, 1934 births, 2019 deaths, People from Montgomery, Alabama
Tom Coughlin	People from New York, 1946 births, Living people, National Football League coaches, College football coaches
Fenway Park	Boston Red Sox, Major League Baseball venues, Sports buildings in the United States, Buildings and structures in Boston, Massachusetts, 1912 establishments in the United States
Medial collateral ligament	Skeletal system
Green Monster (Fenway Park)	Boston Red Sox, Walls
Josh McCown	1979 births, Living people, Sportspeople from Texas, Miami Dolphins players, American football quarterbacks, Chicago Bears players, Tampa Bay Buccaneers players, Cleveland Browns players
Injured reserve list	National Football League, Ice hockey words, National Hockey League
Amendment	Politics, Constitutions
Matt Leinart	1983 births, Living people, Arizona Cardinals players, Houston Texans players, American football quarterbacks, Football players from California, People from Santa Ana, California, Heisman Trophy winners
Puzzle video game	Puzzle video games, Types of video games, Video game genres
Patricia Heaton	1958 births, Living people, American television actors, Actors from Ohio, Emmy Award winning actors
Mike Sweeney	Sportspeople from Los Angeles, California, American baseball players, Kansas City Royals players, Oakland Athletics players, Seattle Mariners players, Philadelphia Phillies players, 1973 births, Living people
James Caviezel	1968 births, Living people, American movie actors, American Christians, Actors from Washington
Human cloning	Genetic engineering, Humans
Jeff Suppan	1975 births, Living people, Sportspeople from Oklahoma, American baseball players, Arizona Diamondbacks players, Boston Red Sox players, Kansas City Royals players, Pittsburgh Pirates players, St. Louis Cardinals players, Milwaukee Brewers players
Donation	Giving
Shake It (Metro Station song)	2008 songs
Constant Lievens	1856 births, 1893 deaths, Belgian priests, Belgian Roman Catholics, Jesuits, Missionaries, People from West Flanders
Precambrian	Geological periods
Presidents' Trophy	National Hockey League trophies and awards
Prince of Wales Trophy	National Hockey League trophies and awards, 1924 establishments in North America
Caorle	Cities in Veneto
Pet Sounds	1966 albums, The Beach Boys albums, Rock albums, Pop albums
Smile (Beach Boys album)	2004 albums, The Beach Boys albums
Colleges and universities in Florida	Colleges and universities in Florida, Lists of colleges and universities
Greek salad	Salads, Greek food
Homo habilis	Hominins, Prehistoric Africa
Avogadro constant	Analytical chemistry, Numbers
Books of Kings	Old Testament books
Under My Skin	Avril Lavigne albums, 2004 albums
World Music Award	Music awards, 1989 establishments
The SpongeBob SquarePants Movie	2004 comedy movies, 2004 animated movies, Movies based on TV series, American comedy movies, American animated movies, SpongeBob SquarePants movies, Movies composed by Harry Gregson-Williams, Movies set in the 2000s
Montecito, California	Census-designated places in California, Settlements in Santa Barbara County, California
Goo Goo Dolls	American punk bands, American rock bands, Grunge bands, Musical groups from New York, Musicians from Buffalo, New York, Warner Bros. Records artists
Radio Disney	Radio stations in the United States, Disney, Dallas, Texas, Companies based in Texas, Defunct companies
Losing Grip	2003 songs, Avril Lavigne songs
Books of the Bible	Books of the Bible
Bambi's Children	Bambi, 1939 books, Children's books
Book of Common Prayer	Christian literature, Protestant Reformation
9X Generation	Cultural anthropology
Littlest Pet Shop (video game)	2008 video games, Wii games, Nintendo DS games, Windows games, Electronic Arts video games
Unforgiven (2008)	2008 in professional wrestling, Sports in Cleveland, Ohio, WWE Unforgiven, 2008 in American television, 2000s in Cleveland, Ohio
WWE Unforgiven	WWE Unforgiven
Fill (music)	Musical terminology
Montevideo Convention	1933 in the United States, International law, Montevideo, 1930s treaties
Gig	Music industry
Folly	Buildings and structures
Littlest Pet Shop	Toys
Pete Seeger	1919 births, 2014 deaths, American activists, American folk musicians, American guitarists, American pianists, Singer-songwriters from New York, American television presenters, Banjo players, Deaths from natural causes, Mandolinists, Musicians from New York City, Singers from New York City, Writers from New York City
Strawberry Fields Forever	1966 songs, The Beatles songs
Lucy (Australopithecus)	Australopithecines
Tom Smothers	1937 births, Living people, American movie actors, American television actors, American stage actors, American composers, American television personalities, Comedians from New York City, Musicians from New York City, Actors from New York City
Dick Smothers	1939 births, Living people, American movie actors, American television actors, American stage actors, American composers, American television personalities, Comedians from New York City, Musicians from New York City, Actors from New York City
Italian Mare Nostrum	World War II, History of Italy
ArenaBowl	Arena Football League
New York Dragons	Arena Football League, Sports in New York, 1995 establishments in the United States
Amsterdam Admirals	American football, Sport in the Netherlands, Amsterdam
The Andy Griffith Show	1960 establishments in the United States, 1968 disestablishments, 1960s American television series, American sitcoms, Black and white television series, CBS network shows, English-language television programs
Happy Days	1960s in fiction, 1974 television series debuts, 1984 television series endings, 1970s American sitcoms, 1980s American sitcoms, ABC network shows, American television spin-offs, Milwaukee County, Wisconsin, Period television series, Television series set in Wisconsin, 1974 establishments in the United States, 1984 disestablishments in the United States, English-language television programs
Archie Bunker's Place	American sitcoms, CBS network shows, Television spin-offs, 1979 American television series debuts, 1983 disestablishments in the United States, English-language television programs
Live Free or Die Hard	2007 movies, 2000s action thriller movies, 2000s crime thriller movies, 2000s sequel movies, 20th Century Fox movies, American sequel movies, Die Hard movies, Movies set in Maryland, Movies set in New York, Movies set in Washington, D.C.
Texas Tech University	Big 12 Conference, Colleges and universities in Texas, Lubbock, Texas, 1923 establishments in the United States, 1920s establishments in Texas
Die Hard with a Vengeance	1995 action movies, 1995 crime movies, 1995 thriller movies, 1990s action thriller movies, 1990s crime thriller movies, 20th Century Fox movies, Die Hard movies, Movies directed by John McTiernan, Movies set in New York City
Die Hard 2	1990 action movies, 1990 crime movies, 1990s action thriller movies, 1990s crime thriller movies, 1990s sequel movies, 20th Century Fox movies, American sequel movies, Die Hard movies, Movies about murderers, Movies based on books, Movies set in Virginia, Movies directed by Renny Harlin
Die Hard	1988 crime movies, 1988 action movies, 1980s crime thriller movies, 20th Century Fox movies, American action thriller movies, American crime thriller movies, American heist movies, Die Hard movies, German-language movies, Movies based on books, Movies directed by John McTiernan, Movies set in Los Angeles, California, Multilingual movies
Street Fighter 2010	1990 video games, Nintendo Entertainment System games, Fighting games
Rayman Raving Rabbids	2006 video games, PlayStation Portable games, Game Boy Advance games, Nintendo DS games, Windows games, PlayStation 2 games, Wii games, Xbox 360 games, Ubisoft games, Video game spin-offs, Party video games, Rayman
Teleportation	Physics, Science fiction, Transport
Capcom	Capcom, Video game companies, 1979 establishments in Asia, 1970s establishments in Japan
Mega Man Star Force 2	2007 video games, Mega Man games, Nintendo DS games, Nintendo DS-only games, Capcom games, Video game sequels
Mega Man Star Force	2006 video games, Nintendo DS games, Nintendo DS-only games, Mega Man games, Capcom games
Mega Man X8	2004 video games, Mega Man games, PlayStation 2 games, Windows games, Capcom games, Video game sequels
Mega Man X7	2003 video games, Mega Man games, PlayStation 2 games, Windows games, Capcom games, Video game sequels
Mega Man X6	2001 video games, Mega Man games, PlayStation games, Windows games, Capcom games, Video game sequels
Pikmin (series)	Pikmin series
Metroid Prime	2002 video games, Cancelled video games, Nintendo GameCube games, Wii games, Metroid Prime
Minnesota Timberwolves	National Basketball Association teams, Sports in Minneapolis, Minnesota, 1989 establishments in the United States, 20th-century establishments in Minnesota
Longsword	Swords
Resident Evil	Resident Evil
Kofi Kingston	1982 births, Living people, Ghanaian people, WWE wrestlers
Red-necked wallaby	Macropods, Marsupials of Australia
Kolo Touré	1981 births, Living people, Ivorian footballers, Manchester City F.C. players
Battle of Baghdad (1258)	1258, Battles, History of Islam, Baghdad, History of Iraq, 13th century in Asia
Credo	Christian prayers
J. D. Salinger	1919 births, 2010 deaths, American novelists, Jewish American writers, Jews who converted to Christianity, Writers from Manhattan
Luca Toni	1977 births, Living people, Italian footballers
Sara Gilbert	1975 births, Living people, Actors from Santa Monica, California, American child actors, LGBT people from California, American movie actors, American television actors, Lesbians, LGBT actors, Vegetarians
Alicia Goranson	1974 births, Living people, American television actors, actors from Illinois, American movie actors, People from Evanston, Illinois
Ape Escape	1999 video games, PlayStation games, PlayStation Portable games
Ken Kesey	1935 births, 2001 deaths, Cancer deaths in the United States, Deaths from liver cancer, Writers from Colorado, Writers from Oregon
Liver cancer	Cancer, Liver disease
One Flew Over the Cuckoo's Nest (novel)	1962 books, 20th century American novels, English-language novels, Oregon, Suicide in fiction, Works about prostitution
Fred Thompson	1942 births, 2015 deaths, Actors from Alabama, American lobbyists, American movie actors, American television actors, Cancer deaths in Tennessee, Deaths from non-Hodgkin lymphoma, People from Sheffield, Alabama, Politicians from Alabama, 2008 United States presidential candidates, United States senators from Tennessee
John Glenn	1921 births, 2016 deaths, American astronauts, American aviators, American military personnel of the Korean War, American military personnel of World War II, American Presbyterians, Burials at Arlington National Cemetery, Colonels, Disease-related deaths in Ohio, 1984 United States presidential candidates, United States senators from Ohio, US Democratic Party politicians, Businesspeople from Columbus, Ohio, Engineers from Ohio, Congressional Gold Medal recipients, Freemasons, Scientists from Columbus, Ohio, Politicians from Columbus, Ohio, Presidential Medal of Freedom recipients, United States Marine Corps personnel
Super OS	Linux software, Ubuntu (operating system) derivatives, Linux distributions, Live CD
Sahelanthropus	Hominins, Prehistoric Africa, Miocene
Remastersys	Live CD, Debian-based Linux distributions
The Unknown Comic	1945 births, Living people, Canadian television actors, Canadian comedians
Australopithecine	Australopithecines, Miocene
Sahara pump theory	Geography, Evolutionary biology, Prehistoric Africa
US Airways	Airlines of the United States, Tempe, Arizona, Star Alliance
Northwest Airlines	Airlines of the United States, 2010 disestablishments
JetBlue Airways	Airlines of the United States, Companies based in New York City, Low-cost airlines
Erich Wasicky	1911 births, 1947 deaths, Austrian people of World War II, Austrian physicians, Austrian war criminals, Executed Austrian people, Executed Nazis, Holocaust perpetrators, Majors, People executed by hanging, Scientists from Vienna, SS officers, Waffen-SS people, Pharmacists
Indie pop	Rock music, Alternative music
Travis	1990 establishments in the United Kingdom, 1990s British music groups, 2000s British music groups, 2010s British music groups, British pop music groups, Indie bands, Musical groups from Glasgow, Scottish rock bands, 1990s establishments in Scotland
The Boy with No Name	2007 albums
Stuttering	Language, Human communication
Life expectancy	Demography, Gerontology
Autrans	Communes in Isère, Former communes in France
Claron McFadden	1961 births, Living people, Singers from New York City, Sopranos, American opera singers
Demosthenes	384 BC births, 322 BC deaths, European politicians, Ancient Greek philosophers
Mexicali	Capital cities in Mexico, Baja California (state)
Mobile (song)	Avril Lavigne songs, 2003 songs
Don't Tell Me	Avril Lavigne songs, 2004 songs
EasyJet	1995 establishments in the United Kingdom, Airlines of the United Kingdom, Low-cost airlines
Joystick	Joysticks, Data input
Nobody's Home	2005 songs, Avril Lavigne songs
Harpo Marx	1888 births, 1964 deaths, Actors from New York City, Comedians from New York City, American movie actors, Deaths from myocardial infarction, Jewish American actors, Mimes
Klaus Barbie	1913 births, 1991 deaths, Cancer deaths in France, Deaths from leukemia, Extradition, German prisoners, German war criminals, Holocaust perpetrators, People from North Rhine-Westphalia, People from Prussia, People who died in prison custody, Prisoners sentenced to life imprisonment, RSHA people, SS officers
Mega Man X2	1995 video games, Mega Man games, Capcom games, Super Nintendo Entertainment System games
Mega Man X (video game)	1994 video games, Windows games, Mega Man games, Capcom games, Super Nintendo Entertainment System games
Animal Crossing (video game)	2001 video games, Nintendo 64 games, Nintendo GameCube games, Nintendo Entertainment Analysis and Development games, Video game remakes, Animal Crossing
Gerd Müller	1945 births, 2021 deaths, 1970 FIFA World Cup players, 1974 FIFA World Cup players, Association football forwards, German footballers, Deaths from Alzheimer's disease
Gebenhofen	Villages in Bavaria
Brassicaceae	Brassicales, Brassicaceae
Amputation	Surgery
Ned Kelly (2003 movie)	Australian biographical movies, Australian crime movies, English-language movies, Movies based on books, Ned Kelly, Western movies, Movies set in Australia
Turban	Headgear, Sikhism, Religious clothing
Ubayd Allah al-Mahdi Billah	Year of birth unknown, 934 deaths, Caliphs
750	750
Amir al-Mu'minin	Islam
Middle Persian	Iranian languages, Extinct languages
Devil's Dyke	Monuments and memorials in England
Scranton, Pennsylvania	County seats in Pennsylvania, Scranton, Pennsylvania, 1856 establishments in the United States, 1850s establishments in Pennsylvania
Umayya ibn Abd Shams	Muslims, Year of birth missing, Year of death missing
Abd Manaf ibn Qusai	History of Islam, Muslims, Year of birth unknown, Year of death unknown
660	660
Ghazi Tehsil	Tehsils of Khyber Pakhtunkhwa
Haripur Tehsil	Tehsils of Khyber Pakhtunkhwa
Lahor	Tehsils of Khyber Pakhtunkhwa
Mandi Bahauddin Tehsil	Tehsils of Punjab (Pakistan)
Necronomicon	Fiction books, Magic (paranormal)
Occult	Occult
Pandemic Studios	Video game companies, Companies based in Los Angeles, Companies of Australia, Brisbane
Ghost town	Ghost towns, Tourism
Rain dance	Ritual dances, Superstitions
Louse	Insects, Parasites
The Adventures of Pinocchio	1883 books, Children's books
Mandi Bahauddin	Cities in Pakistan
Talagang	Cities in Pakistan
Arra, Pakistan	Union Councils of Chakwal District
Balkassar	Union Councils of Chakwal District
Balokassar	Union Councils of Chakwal District
Basharat	Union Councils of Chakwal District
Terry Goodkind	Writers from Omaha, Nebraska, 1948 births, 2020 deaths, American novelists
Begal	Union Councils of Chakwal District, Chakwal District
Bharpur	Union Councils of Chakwal District, Chakwal District
Bheen	Union Councils of Chakwal District
Bhilomar	Union Councils of Chakwal District
Bhoun	Union Councils of Chakwal District
Bidher	Union Councils of Chakwal District
Buchal Kalan	Union Councils of Chakwal District
Budhial	Union Councils of Chakwal District
Chak Malook	Union Councils of Chakwal District
Chak Umra	Union Councils of Chakwal District
Choa Ganj Ali Shah	Union Councils of Chakwal District
Choa Saidanshah	Union Councils of Chakwal District
Dab, Pakistan	Union Councils of Chakwal District
Dalwal	Union Councils of Chakwal District
Dandot	Union Councils of Chakwal District
Dhoular	Union Councils of Chakwal District
Dhudial	Union Councils of Chakwal District
Dhurnal	Union Councils of Chakwal District
Dullah	Union Councils of Chakwal District
Dulmial	Union Councils of Chakwal District
Dumman	Union Councils of Chakwal District
Jabbi Shah Dilawar	Union Councils of Chakwal District
Jand, Chakwal	Union Councils of Chakwal District
Jand Khanzada	Union Councils of Chakwal District
University of Texas at Austin	Association of American Universities, Big 12 Conference, Colleges and universities in Texas, Austin, Texas, 1883 establishments in the United States, 1880s establishments in Texas
Jassial	Union Councils of Chakwal District
Jaswal, Pakistan	Union Councils of Chakwal District
Jhatla	Union Councils of Chakwal District
Kallar Kahar	Union Councils of Chakwal District
Karsal	Union Councils of Chakwal District
Karyala	Union Councils of Chakwal District
Texas A&M University	Association of American Universities, Colleges and universities in Texas, Southeastern Conference, 1871 establishments in the United States, 1870s establishments in Texas
Khairpur, Chakwal	Union Councils of Chakwal District
Khotian	Union Councils of Chakwal District
Kot Choudrain	Union Councils of Chakwal District
Kot Gullah	Union Councils of Chakwal District
Kot Qazi	Union Councils of Chakwal District
Kot Sarang	Union Councils of Chakwal District
Impala	Bovids, Mammals of Africa
Biblical Mount Sinai	Old Testament, Mountains of Asia
Reconstructor	Software
870s	870s
University of the Incarnate Word	Christian colleges and universities in the United States, Colleges and universities in Texas, San Antonio, Texas, 1881 establishments in the United States, 1880s establishments in Texas
Texas State University	Colleges and universities in Texas, Sun Belt Conference, 1899 establishments in the United States, 1890s establishments in Texas
Northeastern State University	Colleges and universities in Oklahoma, 19th-century establishments in Indian Territory
University of Oklahoma	Big 12 Conference, Colleges and universities in Oklahoma, 1890 establishments in Oklahoma Territory, Norman, Oklahoma
Cicada	Hemiptera
Liège Airport	Airports in Belgium, Liège (province), Liège
Object (computer science)	Computer programming
Object-oriented design	Computer science
Konkan	Geography of India
Triple J	Radio stations, Australian culture
Radovan Karadžić	1945 births, Living people, Presidents of Republika Srpska, Crimes against humanity, Fraudsters, Genocide, Montenegrin people, Poets, Prisoners, Psychiatrists, War criminals
Common Language Specification	Software
Cus D'Amato	Sportspeople from New York City, Boxing, People from the Bronx, 1908 births, 1985 deaths
Willi Auerswald	1895 births, 1956 deaths, German prisoners, German war criminals, Holocaust perpetrators, Prisoners sentenced to life imprisonment, SS officers
Baylor University	Big 12 Conference, Colleges and universities in Texas, Christian colleges and universities in the United States, Waco, Texas, 1845 establishments in the United States, 1840s establishments in Texas
Texas Lutheran University	Christian colleges and universities in the United States, Colleges and universities in Texas, 1891 establishments in the United States, 1890s establishments in Texas
The Evergreen State College	Colleges and universities in Washington, Olympia, Washington, 1967 establishments in the United States, 1960s establishments in Washington (state)
Battle of Berlin	1945 in Germany, Battles involving Germany, Battles involving Poland, Battles involving the Soviet Union, European battles of World War II, 1940s in Berlin, April 1945 events, May 1945 events
VMDK	Computer file formats
University of Texas at San Antonio	Colleges and universities in Texas, Conference USA, San Antonio, Texas, 1969 establishments in the United States, 1960s establishments in Texas
NHL All-Star Team	National Hockey League trophies and awards
National Hockey League Players' Association	1967 establishments in North America, National Hockey League, Trade unions in the United States
Role of United States in the Vietnam War	Vietnam War
Johann Altfuldisch	1911 births, 1947 deaths, Executed German people, Executed Nazis, German war criminals, Holocaust perpetrators, People executed by hanging, People from Bavaria, SS officers, Waffen-SS people
Phalanges	Limbs and extremities, Bones
Alpaca	Camelids, Domesticated animals, Mammals of South America
Guy Berryman	Scottish musicians, guitarists, 1978 births, Living people
Mennonites	Anabaptism
Anabaptist	Anabaptism, Christian movements and denominational families, Protestant Reformation
Hutterites	Anabaptism, Protestantism, Christian movements and denominational families
Prairie View A&M University	Colleges and universities in Texas, 1876 establishments in the United States, 1870s establishments in Texas
VMware	American technology companies, 1998 establishments in California, Palo Alto, California, Companies based in the San Francisco Bay Area
VMware ThinApp	Software
MediaFire	Websites, File sharing
University of Houston	Colleges and universities in Texas, American Athletic Conference, Houston, Texas, 1927 establishments in the United States, 1920s establishments in Texas
Acronis	2000 establishments in the United States, Software, American technology companies
Acronis True Image	Software
The Young Ones	1982 television series debuts, 1984 television series endings, 1980s British sitcoms, BBC television sitcoms, 1982 establishments in the United Kingdom, 1984 disestablishments in the United Kingdom, English-language television programs
Napoléon III	1808 births, 1873 deaths, Emperors and empresses, House of Bonaparte, People from Paris, Presidents of France
Charles Perrault	1628 births, 1703 deaths, French writers
Saint Joseph	90s BC births, 10s deaths, Ancient Israeli people, Early Christian saints, New Testament people, People from Bethlehem, People from Nazareth, Carpenters
West Flanders	West Flanders
Oneness Pentecostalism	Pentecostalism, Nontrinitarianism
Roşoşa River	Rivers of Romania
Linux kernel	Linux
Sebastian Vettel	1987 births, Formula One current, Formula One drivers, German racecar drivers, Living people, Sportspeople from Hesse
Sara Evans	1971 births, Living people, Country musicians, American singer-songwriters, Singers from Missouri
Felipe Massa	1981 births, Living people, Brazilian racecar drivers, Formula One current, Formula One drivers, People from São Paulo
Tarsals	Bones, Feet
Georg Cantor	1845 births, 1918 deaths, German academics, German mathematicians, People from Saint Petersburg
Pay-per-view	Television technology
Talus	Bones
Dhaka District	Districts of British India, Districts of East Pakistan, Dhaka Division
Proprietary software	Software
Dhaka Division	Divisions of British India, East Pakistan provincial region, Dhaka Division
Kala Dhaka	Himalayas, Mountain ranges of Pakistan, Khyber Pakhtunkhwa
Muridke Tehsil	Tehsils of Punjab (Pakistan)
Ratodero Taluka	Talukas of Sindh
Swabi Tehsil	Tehsils of Khyber Pakhtunkhwa
Mehrgarh	Archaeological sites in Pakistan, World Heritage Sites in Pakistan
Geography of Romania	Geography of Romania
Mohenjo-daro	Archaeological sites in Pakistan, World Heritage Sites in Pakistan, Pakistani culture
Kot Diji	Archaeological sites in Pakistan
Chanhu-daro	Archaeological sites in Pakistan
List of lakes of Romania	Lakes of Romania, Romania-related lists, Lists of lakes
Harappa	Archaeological sites in Pakistan, Villages in Pakistan, World Heritage Sites in Pakistan
National Hockey League rules	National Hockey League
Gilgit Agency	Gilgit-Baltistan, Divisions of Jammu and Kashmir
Latifabad Tehsil	Talukas of Sindh
Aar	Rivers of Switzerland
Mehar Tehsil	Talukas of Sindh
Qasimabad Tehsil	Talukas of Sindh
Mary	Given names
Asea Brown Boveri	Companies of Switzerland, 1988 establishments in Europe, 1980s establishments in Switzerland
Samaro	Settlements in Sindh, Mirpur Khas District
Fatehpur Thakiala Tehsil	Tehsils of Azad Kashmir
Alamanni	Germanic tribes, Austrian people, German people, French people, Liechtenstein people, Swiss people, Alsace, Baden-Württemberg, Liechtenstein, Swabia, Bavaria, Vorarlberg
Sibi Tehsil	Tehsils of Balochistan
Schloss Lenzburg	Castles
A1 freeway, Switzerland	Roads, Transport in Switzerland
Dera Ismail Khan Tehsil	Tehsils of Khyber Pakhtunkhwa
Gojal Tehsil	Tehsils of Northern Areas (Pakistan)
Gojra Tehsil	Tehsils of Punjab (Pakistan)
Guanaco	Camelids, Mammals of South America
Vicuña	Camelids, Mammals of South America
Nocturnes (Debussy)	Compositions by Claude Debussy
Brooklyn Nets	National Basketball Association teams, Brooklyn, Sports in New York City, 1967 establishments in New York (state)
Cleveland Cavaliers	National Basketball Association teams, Sports in Cleveland, Ohio, 1970 establishments in the United States, 1970s establishments in Ohio
Indiana Pacers	National Basketball Association teams, Indianapolis, Indiana, 1967 establishments in the United States
Fan	Machines
Washington Wizards	National Basketball Association teams
Orlando Magic	National Basketball Association teams, Sports in Orlando, Florida, Richard DeVos, 1989 establishments in the United States, 1980s establishments in Florida
Charlotte Hornets (NBA)	National Basketball Association teams, Sports in Charlotte, North Carolina, 2004 establishments in North Carolina
Denver Nuggets	National Basketball Association teams, Sports in Denver, Colorado
Memphis Grizzlies	National Basketball Association teams, Memphis, Tennessee, 2001 establishments in the United States, 2000s establishments in Tennessee
Los Angeles Clippers	National Basketball Association teams, Sports in Los Angeles, 1970 establishments in the United States, 1970s establishments in California
Texas A&M University–Corpus Christi	Colleges and universities in Texas, Corpus Christi, Texas, 1947 establishments in the United States, 20th-century establishments in Texas
Freedom of the press	Journalism, Freedom
Olympic Flame	Olympic Games
Freedom of assembly	Freedom
First Amendment to the United States Constitution	Freedom, United States Bill of Rights, Amendments to the United States Constitution
Parliamentary procedure	Politics, Law, Systems
Militia	Military
Pictures at an Exhibition	Solo piano pieces, Compositions by Modest Mussorgsky
Wine (software)	Free software, 1993
Carbon-12	Isotopes, Carbon
Art rock	Rock music
MIT License	Software licences, Massachusetts Institute of Technology
Blender (magazine)	Music magazines, American magazines
Discography	Discographies
Euoplocephalus	Ankylosauria
Progressive metal	Heavy metal subgenres
Mamenchisaurus	Sauropods
Knoxville, Tennessee	Former United States state capitals, Knoxville, Tennessee, County seats in Tennessee
Così fan tutte	Compositions by Wolfgang Amadeus Mozart, 1790s operas, 1790
Revolver (magazine)	Music magazines
University of York	Universities in England, York
Magazine circulation	Magazines
Heinrich Cornelius Agrippa	1486 births, 1535 deaths, Astrologers, German esotericists, Occultists, People from Cologne, Writers from North Rhine-Westphalia
Paracelsus	1493 births, 1541 deaths, Astrologers, Austrian physicians, Botanists, Occultists, Swiss chemists, Austrian biologists, Swiss biologists
Morris	1923 births, 2001 deaths
Palos Verdes blue	Endangered species, Lycaenidae
Wingspan	Aviation, Birds
Talent agent	Entertainment occupations
Airbus A319	Airbus aircraft
Félix Houphouët-Boigny	1905 births, 1993 deaths, Deaths from prostate cancer, Prime Ministers of Ivory Coast, Presidents of Ivory Coast, Roman Catholics
University of Cambridge	1231 establishments, University of Cambridge, 13th century establishments in England
Carpals	Bones
Orient Express	Rail transport in Europe
Sleeping car	Trains
List of police forces in the United Kingdom	United Kingdom-related lists, Law enforcement agencies of the United Kingdom
Robert Christgau	American journalists, Writers from New York City, 1942 births, Living people
Texas A&M University–Kingsville	Colleges and universities in Texas, 1925 establishments in the United States, 1920s establishments in Texas
1932–33 NHL season	1932 in North America, 1933
1933–34 NHL season	1930s in North America
Passer rating	American football, Canadian football, College football, National Football League
Postal codes in the United Kingdom	Postal codes, Postal services in the United Kingdom
Chenab River	Rivers of Pakistan, Tributaries of the Indus River
Jhelum River	Rivers of Pakistan, Tributaries of the Indus River
Ravi River	Rivers of Pakistan, Tributaries of the Indus River
Shingo River	Rivers of Pakistan
Iranian women's movement	History of Iran, Islam, Feminism
Tricastin nuclear power plant	Nuclear power plants in Europe
Polly Pocket	Dolls
Juliet Burke	Television characters
Shyok River	Tributaries of the Indus River, Gilgit-Baltistan, Kashmir, Rivers of India, Rivers of Pakistan
Suru River (Indus)	Rivers of Pakistan, Tributaries of the Indus River
Tawi River	Rivers of Pakistan
Zanskar Gorge	Rivers of Pakistan, Tributaries of the Indus River
Gilgit River	Rivers of Pakistan, Tributaries of the Indus River
Gomal River	Rivers of Pakistan, Rivers of Afghanistan
Hub River	Rivers of Pakistan
Hingol River	Rivers of Pakistan
Kundar River	Rivers of Pakistan, Rivers of Afghanistan
Kunhar River	Rivers of Pakistan
Kurrum River	Rivers of Pakistan, Tributaries of the Indus River, Rivers of Afghanistan
Lyari River	Rivers of Pakistan
Malir River	Rivers of Pakistan
Panjkora River	Rivers of Pakistan
Wisent	Bovines, Mammals of Europe
Panjnad River	Rivers of Pakistan, Tributaries of the Indus River
Sutlej	Tributaries of the Indus River, Rivers of India, Rivers of Pakistan
Zhob River	Rivers of Pakistan
Hunza River	Rivers of Pakistan, Tributaries of the Indus River
Kabul River	Rivers of Pakistan, Tributaries of the Indus River, Rivers of Afghanistan
Kunar River	Rivers of Pakistan, Rivers of Afghanistan
Rupal River	Rivers of Pakistan
Soan River	Rivers of Pakistan, Tributaries of the Indus River
The Fox and the Hound 2	2006 movies, American buddy movies, American animated movies, American family movies, American musical movies, Disney animated movies, Disney direct-to-video movies, Movies about dogs
Direct-to-video	Movie terminology
A Perfect Circle	American rock bands, Alternative rock bands, Alternative metal bands
UNetbootin	Linux software
Live USB system creator	Linux software
Fedora Live USB creator	Linux software
University of Texas at Arlington	Colleges and universities in Texas, Sun Belt Conference, Arlington, Texas, 1895 establishments in the United States, 1890s establishments in Texas
Old Persian language	Iranian languages
8 Eyes	1988 video games, Nintendo Entertainment System games, Platform games
Palos Verdes	Settlements in California, Geography of Los Angeles County, California
P.U.N.K.S.	1999 movies, English-language movies
Troy	World Heritage Sites in Turkey, Ancient Greek cities
Federal Information Processing Standard	Standards
Maggot	Flies
Undertow (Tool album)	1993 albums, Debut albums, Heavy metal albums
Princess Beatrice of the United Kingdom	1857 births, 1944 deaths, House of Saxe-Coburg and Gotha, Bailiffs Grand Cross of the Order of St John
Xbox Live	Xbox
Zanskar River	Rivers of Pakistan, Tributaries of the Indus River
Xbox Live Vision	Xbox
Trumpet Concerto (Arutunian)	Concertos
Alexander Arutunian	1920 births, 2012 deaths, Armenian composers, People from Yerevan
Epicurus	Ancient Greek philosophers
The Hundred and One Dalmatians	British novels, English-language novels, 101 Dalmatians, 1956 books, Books about dogs
101 Dalmatians	English-language television programs
Coulomb's law	Electricity, Laws of physics
Leprechaun	Irish culture, Legendary creatures
Greater Middle East	Asia, Middle East
Asian snake-eyed skink	Lizards, Reptiles of Pakistan
Crosswords DS	Nintendo DS games, Nintendo DS-only games, Puzzle video games
Fedora Unity	Websites, Linux
Picross DS	2007 video games, Nintendo DS-only games, Puzzle video games
Text box	Computers, Writing tools
Free agent	Sports words
Out (baseball)	Baseball rules
Run (baseball)	Baseball rules
Maxis	Video game companies
Underwater	Water
Hereford (cattle)	Cattle breeds
Beef cattle	Cattle
Roman army	Ancient Rome, Armies
Tierpark Hagenbeck	Buildings and structures in Hamburg, Zoos in Germany
Ronno	Communes in Rhône
Ultamatix	Linux software
Limit of a function	Mathematics
Marilyn Manson	1969 births, Living people, American rock singers, People from Canton, Ohio, Singers from Ohio, American rock guitarists, American singer-songwriters, Musicians from Ohio, Writers from Ohio, American poets, American keyboard players, American rock drummers, American heavy metal musicians, American heavy metal singers, American painters, American movie actors, American television actors, Actors from Ohio
Move	Basic English 850 words
Arthur Phillip	1738 births, 1814 deaths, Admirals, Governors of New South Wales, Politicians from London, Royal Navy officers
Bill Cowher	National Football League coaches, American football linebackers, Philadelphia Eagles players, Cleveland Browns players, Sportspeople from Pennsylvania, 1957 births, Living people
Halting problem	Mathematics
Largentière	Communes in Ardèche, Subprefectures in France
Tucumcari, New Mexico	Cities in New Mexico, County seats in New Mexico, 1901 establishments in the United States, 20th-century establishments in New Mexico
Tauriers	Communes in Ardèche
Thueyts	Communes in Ardèche
Gibson Les Paul	Guitars
Usclades-et-Rieutord	Communes in Ardèche
Uzer, Ardèche	Communes in Ardèche
Vagnas	Communes in Ardèche
Valgorge	Communes in Ardèche
Vals-les-Bains	Communes in Ardèche
Valvignères	Communes in Ardèche
Vernon, Ardèche	Communes in Ardèche
Vesseaux	Communes in Ardèche
Veyras, Ardèche	Communes in Ardèche
Coucouron	Communes in Ardèche
Scottish Fold	Cat breeds
The Sims 3	The Sims, 2009 video games, Nintendo 3DS games
Brad Delson	1977 births, Living people, American guitarists, Extras, Linkin Park, Musicians from Los Angeles, California
Charlton Heston	1923 births, 2008 deaths, Academy Award winning actors, Actors from Illinois, Presidents of the Screen Actors Guild, American movie actors, American television actors, American voice actors, American radio actors, Deaths from pneumonia, People with Alzheimer's disease, Infectious disease deaths in the United States, Screen Actors Guild Award winners
Ambush marketing	Marketing
Al-Mustansir II of Cairo	Year of birth unknown, 1262 deaths, Cairo, Egyptian Muslims
University of Texas at El Paso	Colleges and universities in Texas, Conference USA, El Paso, Texas, 1914 establishments in the United States, 1910s establishments in Texas
Achaemenid Empire	History of Iran, History of Pakistan, Mesopotamia, Former countries in the Middle East, Empires
Vexilloid	Flags
The Dark Knight (movie)	2008 movies, 2000s crime thriller movies, 2000s superhero movies, Movies shot in Chicago, Illinois, American movies, British movies, British action movies, British crime movies, British thriller movies, American action movies, American crime thriller movies, Batman movies, Movies based on comic book characters, IMAX movies, English-language movies, Movies based on books, Movies composed by Hans Zimmer, Movies composed by James Newton Howard, Movies directed by Christopher Nolan, Movies featuring a Best Supporting Actor Academy Award-winning performance, The Dark Knight Trilogy, American sequel movies, Warner Bros. movies, American superhero movies, United States National Film Registry movies
Gorgon	Greek legendary creatures
As the World Turns	CBS network shows, American drama television series, 2000s American television series, Soap operas, English-language television programs
Mexican wolf	Wolves
Live USB	Storage devices
Traffic collision	Automobiles
Malden, Massachusetts	Cities in Massachusetts, 1640 establishments in the Thirteen Colonies, 1640s establishments in Massachusetts
Gary Bettman	1952 births, Living people, National Hockey League, Businesspeople from New York
Mother (series)	Mother series
Australian Recording Industry Association	Organisations based in Australia, Music industry, Australian music
Microsoft Excel	Microsoft
Villeneuve-de-Berg	Communes in Ardèche
Astro Nusantara	Television
Oxnard, California	Oxnard, California, 1903 establishments in the United States, 1900s establishments in California
List of tools to create Live USB systems	Microsoft lists
Real Madrid Baloncesto	Sport in Spain, Basketball teams, Madrid, 1932 establishments in Europe, 1930s establishments in Spain
Vinezac	Communes in Ardèche
Vogüé	Communes in Ardèche
Chirols	Communes in Ardèche
Chomérac	Communes in Ardèche
Creysseilles	Communes in Ardèche
Cros-de-Géorand	Communes in Ardèche
Duane Allman	American guitarists, Musicians from Nashville, Tennessee, Writers from Nashville, Tennessee, Singers from Nashville, Tennessee, Southern rock musicians, American rock musicians, American soul musicians, American blues musicians, American jazz musicians, 1946 births, 1971 deaths
Saint-Étienne	Cities in France, Communes in Loire, Departmental capitals in France
Darbres	Communes in Ardèche
Saint-Julien-en-Saint-Alban	Communes in Ardèche
Saint-Julien-Labrousse	Former communes in Ardèche
Saint-Julien-le-Roux	Communes in Ardèche
Transport in Melbourne	Transport in Melbourne
Dompnac	Communes in Ardèche
Dunière-sur-Eyrieux	Communes in Ardèche
Fabras	Communes in Ardèche
Faugères, Ardèche	Communes in Ardèche
Flaviac	Communes in Ardèche
History of the National Hockey League	Ice hockey in Canada, Ice hockey in the United States, National Hockey League
Destroy All Humans! (2005 video game)	2005 video games, Destroy All Humans!, PlayStation 2 games, Xbox games, THQ games
Thylacinidae	Dasyuromorphia
Badjcinus	Dasyuromorphia
Thylacinus	Dasyuromorphia, Miocene
Nomenclature of Territorial Units for Statistics	Geocodes, European Union
Fire blight	Gram-negative bacteria, Trees, Rosaceae
Michael E. DeBakey	1908 births, 2008 deaths, American physicians, Burials at Arlington National Cemetery, Scientists from Louisiana, Scientists from Texas
Fire Emblem	Video game series
Caitlin	Given names
12 Angry Men	1957 drama movies, American drama movies, English-language movies, Legal movies, Movies set in New York City, United States National Film Registry movies, Movies directed by Sidney Lumet
BioShock	2007 video games, PlayStation 3 games, Windows games, Xbox 360 games, Shooter video games, Horror video games
Dilemma	Logic
Hapkido	Martial arts
The Royal Society	Research, Royal Society, 1660 establishments, 1660s establishments in England
Fons, Ardèche	Communes in Ardèche
Freyssenet	Communes in Ardèche
Genestelle	Communes in Ardèche
Gilhac-et-Bruzac	Communes in Ardèche
Gluiras	Communes in Ardèche
Gourdon, Ardèche	Communes in Ardèche
You Am I	Australian alternative rock bands, Musical groups from Sydney
Italian Grand Prix	Formula One Grands Prix, Sport in Italy
Vodafone	Mobile phone companies
Bratz	Dolls
Game engine	Video game technology, Software
Mitsubishi Motors	Mitsubishi automobiles, 1970 establishments in Asia, 1970s establishments in Japan
Autodromo Nazionale Monza	Sport in Italy, Formula One circuits, Monza, 1922 establishments in Italy
Abe Vigoda	1921 births, 2016 deaths, Disease-related deaths in New Jersey, American television actors, Actors from New York City, American movie actors, American voice actors
924 Gilman Street	Punk rock, Non-profit organizations of California, Berkeley, California
Big Bird	Sesame Street characters, Muppets
Nimrod (album)	Green Day albums, Reprise Records albums, 1997 albums, Punk albums
Insomniac (album)	Green Day albums, 1995 albums, Reprise Records albums, Punk albums
Grammy Award for Best Alternative Music Album	Grammy Awards, Alternative music
Rock opera	Rock music
Record of the Year	Grammy Awards
Ole Gunnar Solskjær	1973 births, Living people, Manchester United F.C. players, Norwegian footballers
Grammy Award for Best Rock Album	Grammy Awards, Rock albums
Boulevard of Broken Dreams (Green Day song)	2005 songs, Green Day songs
Vallejo, California	Vallejo, California, 1851 establishments in California
George Best	1946 births, 2005 deaths, Deaths from multiple organ failure, Infectious disease deaths in London, Manchester United F.C. players, Northern Irish footballers, Organ transplant recipients, People from Belfast
John Kiffmeyer	1969 births, Living people, Green Day members, American drummers, Musicians from California, American punk musicians
Lookout! Records	American record labels, Companies based in California, Independent record labels, Punk rock, Berkeley, California, 1987 establishments in California
Larry Livermore	1947 births, Living people, American journalists, American record producers, Musicians from Detroit, Michigan, Writers from Michigan
1,000 Hours	1989 albums, Green Day albums
Young Hercules	1998 television series debuts, Fantasy television series, Xenaverse, Fox television series, English-language television programs
Sweet Baby	American punk bands, Musicians from Berkeley, California, Musical groups established in 1986, Pop punk bands
East Bay	San Francisco Bay Area
Liberation theology	Christian theology
Promotion and relegation	Sports words
Scottish Cup	Football competitions, Football in Scotland
Setanta Sports	Sports media, Television networks
America's Next Top Model, Cycle 2	America's Next Top Model
Crissiumal	Cities in Rio Grande do Sul
Emmaus	New Testament, West Bank
Alexander III of Scotland	1241 births, 1286 deaths, Kings and Queens of Scotland
Gras	Communes in Ardèche
Suceava County	Counties of Romania
Gravières	Communes in Ardèche
Grospierres	Communes in Ardèche
Issamoulenc	Communes in Ardèche
Issanlas	Communes in Ardèche
Issarlès	Communes in Ardèche
Joannas	Communes in Ardèche
Juvinas	Communes in Ardèche
La Souche	Communes in Ardèche
Labastide-de-Virac	Communes in Ardèche
Labastide-sur-Bésorgues	Communes in Ardèche
Labeaume	Communes in Ardèche
Greek numerals	Greek language, Numerals
Harlan Ellison	1934 births, 2018 deaths, Deaths from cardiac arrest, Cardiovascular disease deaths in Los Angeles, Nebula Award winning writers, American novelists, American critics, American essayists, American screenwriters, Hugo Award winning writers, American science fiction writers, writers from Cleveland, Ohio
Hebrew numerals	Numerals, Hebrew language
George R. R. Martin	1948 births, Living people, People from Bayonne, New Jersey, Writers from New Jersey, Science fiction writers, American bloggers
Dying of the Light	1977 books, Books by George R. R. Martin, Science fiction books
Windhaven	Books by George R. R. Martin, 1981 books, Science fiction books
Fevre Dream	1982 books, Books by George R. R. Martin
ChatZilla	Mozilla, IRC clients
A Song of Ice and Fire	A Song of Ice and Fire
Great Bernera	Inner and Outer Hebrides
Hercules and the Amazon Women	1994 movies, Television movies, 1990s adventure movies, Xenaverse, Hercules movies
Hercules and the Lost Kingdom	1994 movies, 1990s adventure movies, Television movies, Xenaverse, Hercules movies
Treasure Island	1883 books, Books by Robert Louis Stevenson, British novels, English-language novels
Hercules and the Circle of Fire	1994 movies, 1990s adventure movies, Television movies, Xenaverse, Hercules movies
Eyes Wide Shut	1999 drama movies, 1999 mystery movies, American drama movies, American mystery movies, British drama movies, British mystery movies, English-language movies, Movies based on books, Movies directed by Stanley Kubrick, Movies set in New York City, Warner Bros. movies, 1990s thriller movies
Edna Parker	1893 births, 2008 deaths, American supercentenarians, People from Indiana
39/Smooth	Green Day albums, 1989 albums, Debut albums, Pop rock albums, Pop punk albums
Slappy	Green Day albums
Savate	Martial arts
Sweet Children (EP)	Green Day albums
1,039/Smoothed Out Slappy Hours	Green Day albums
Juan Diego Flórez	1973 births, Living people, Tenors, Opera singers, People from Lima
The Lookouts	American punk bands, Musical groups from California
Kerplunk (album)	Green Day albums, 1992 albums, Punk albums
Cerium	Chemical elements, Metals
Hallux	Feet, Human body features
The Wachowskis	1960s births, Living people, Sibling duos, Movie directors from Chicago, Movie producers from Chicago, Screenwriters from Illinois, Transgender and transsexual people
V for Vendetta	Comic books
Mozilla Foundation	Mozilla, Mountain View, California, 2003 establishments in California
1812 Overture	Compositions by Pyotr Ilyich Tchaikovsky, Overtures, Russian music
Guy Fawkes	British criminals, Criminals who committed suicide, English Roman Catholics, People from York, Suicides by jumping in the United Kingdom, Terrorists, 1570 births, 1606 deaths
Graphic novel	Fiction genres, Fiction books, Comic books, Comics artists
Alan Moore	1953 births, Living people, Comic books, English writers, Hugo Award winning writers, People from Northampton
Islamabad Capital Territory	Federal Capital Territory of Islamabad, Territories of Pakistan
Lablachère	Communes in Ardèche
Laboule	Communes in Ardèche
Lachamp-Raphaël	Communes in Ardèche
Lachapelle-Graillouse	Communes in Ardèche
Official names of India	Languages of India, Government of India
The Matrix Revolutions	2003 movies, Matrix series, Drone movies, IMAX movies, Sequel movies, Warner Bros. movies, English-language movies
Andy Wachowski	1967 births
Larry Wachowski	1965 births
Hercules in the Underworld	1994 movies, 1990s adventure movies, Television movies, Xenaverse, Hercules movies
Lagorce, Ardèche	Communes in Ardèche
Lanarce	Communes in Ardèche
Hercules in the Maze of the Minotaur	1994 movies, 1990s adventure movies, Television movies, Xenaverse, Hercules movies
Lanas	Communes in Ardèche
Larnas	Communes in Ardèche
Laurac-en-Vivarais	Communes in Ardèche
Marzahn	Districts of Berlin
Helicobacter pylori	Gram-negative bacteria
Schöneberg	Districts of Berlin
Uranus in fiction	Uranus (planet)
Kevin Sorbo	1958 births, Living people, American television actors, Xenaverse actors, American movie actors, Actors from Minnesota
Oscar Niemeyer	1907 births, 2012 deaths, Brazilian architects, Centenarians, Communists, Deaths from respiratory tract infection, Deaths from cardiac arrest, People from Rio de Janeiro, Pritzker Prize winners
Royal Ontario Museum	Buildings and structures in Toronto, Museums in Canada, Natural history museums
Centenarian	Centenarians
Laval-d'Aurelle	Former communes in Ardèche
Laveyrune	Communes in Ardèche
Lavillatte	Communes in Ardèche
Laviolle	Communes in Ardèche
Le Lac-d'Issarlès	Communes in Ardèche
Le Plagnal	Communes in Ardèche
Le Roux, Ardèche	Communes in Ardèche
Le Teil	Communes in Ardèche
Lentillères	Communes in Ardèche
Les Ollières-sur-Eyrieux	Communes in Ardèche
Les Salelles, Ardèche	Communes in Ardèche
Les Vans	Communes in Ardèche
Lespéron	Communes in Ardèche
Loubaresse, Ardèche	Communes in Ardèche
Auguste Comte	1798 births, 1857 deaths, French philosophers, Burials at Père Lachaise Cemetery, People from Montpellier, French sociologists, Alumni of the École Polytechnique
George Berkeley	1685 births, 1753 deaths, Irish philosophers
Colombier-le-Vieux	Communes in Ardèche
Sceautres	Communes in Ardèche
Bakot	Union Councils of Abbottabad District
Baldheri	Union Councils of Abbottabad District
Lussas	Communes in Ardèche
Bandi Atti Khan	Union Councils of Abbottabad District
Lyas	Communes in Ardèche
Malarce-sur-la-Thines	Communes in Ardèche
Malbosc	Communes in Ardèche
Beerangali	Union Councils of Abbottabad District
Berote Kalan	Union Councils of Abbottabad District
Boi, Khyber Pakhtunkhwa	Union Councils of Abbottabad District
Chamhad	Union Councils of Abbottabad District
Dalola	Union Councils of Abbottabad District
Dewal Manal	Union Councils of Abbottabad District
Ghari Phulgran	Union Councils of Abbottabad District
Goreeni	Union Councils of Abbottabad District
Haveliani Urban	Union Councils of Abbottabad District
Jarral, Khyber Pakhtunkhwa	Union Councils of Abbottabad District
Marcols-les-Eaux	Communes in Ardèche
Mayres, Ardèche	Communes in Ardèche
Mazan-l'Abbaye	Communes in Ardèche
Meyras	Communes in Ardèche
Meysse	Communes in Ardèche
Mirabel, Ardèche	Communes in Ardèche
Montpezat-sous-Bauzon	Communes in Ardèche
Montréal, Ardèche	Communes in Ardèche
Montselgues	Communes in Ardèche
Sanilhac	Communes in Ardèche
Colombier-le-Cardinal	Communes in Ardèche
Colombier-le-Jeune	Communes in Ardèche
Le Crestet	Communes in Ardèche
Mézilhac	Communes in Ardèche
Sampzon	Communes in Ardèche
Salavas	Communes in Ardèche
Orgnac-l'Aven	Communes in Ardèche
Payzac, Ardèche	Communes in Ardèche
Planzolles	Communes in Ardèche
L'incoronazione di Poppea	Compositions by Claudio Monteverdi, 17th century operas
Queen's Park F.C.	Scottish football clubs
Jhangi	Union Councils of Abbottabad District
Jhangra	Union Councils of Abbottabad District
Kakul	Union Councils of Abbottabad District
Kehal Urban	Union Councils of Abbottabad District
Kukmang	Union Councils of Abbottabad District
Kuthiala	Union Councils of Abbottabad District
Kuthwal	Union Councils of Abbottabad District
Langra, Khyber Pakhtunkhwa	Union Councils of Abbottabad District
Langrial	Union Councils of Abbottabad District
Murree	Cities in Pakistan, Hill Stations in Pakistan
Malikpura Urban	Union Councils of Abbottabad District
Mirpur, Khyber Pakhtunkhwa	Union Councils of Abbottabad District

