West Division (NHL)	National Hockey League divisions
East Division (NHL)	National Hockey League divisions
Acrelândia	Municipalities in Acre (state), 1992 establishments, 1990s establishments in Brazil
Saint Alban	Year of birth unknown, 3rd century births, 304 deaths, British Christians, Christian saints, Converts to Christianity, Executed people, Roman people
Carlos Filipe Ximenes Belo	1948 births, Living people
Pope Innocent VIII	Italian popes, 1432 births, 1492 deaths
Lō'ihi Seamount	Seamounts, Pacific Ocean, Volcanoes of Oceania
Mark Knopfler	1949 births, Living people, British record producers, English rock guitarists, English rock singers, English singer-songwriters, Grammy Award winners, Musicians from Glasgow, People from Northumberland
Vision of Ezra	Religious texts
Chamba district	Himachal Pradesh
Bear worship	Religions
Chet Atkins	American guitarists, Deaths from colorectal cancer, Musicians from Tennessee, American folk musicians, American jazz musicians, Country musicians, American classical musicians, Grammy Award winners, 1924 births, 2001 deaths
Merle Travis	1917 births, 1983 deaths, American guitarists, Grammy Award winners
Clodovil Hernandes	1937 births, 2009 deaths, Brazilian people
Waylon Jennings	American country musicians, American guitarists, American rock musicians, American rock singers, Singer-songwriters from Texas, Deaths from diabetes, Grammy Award winners, 1937 births, 2002 deaths
FIFA 10	2009 video games, FIFA, Sports video games, PlayStation 2 games, PlayStation 3 games, PlayStation Portable games, Wii games, Xbox 360 games, Nintendo DS games, Windows games
NBA 2K10	2009 video games, PlayStation 2 games, PlayStation 3 games, PlayStation Portable games, Wii games, Windows games, Xbox 360 games, Sports video games
NBA Live 10	2009 video games, PlayStation 3 games, PlayStation Portable games, Xbox 360 games
Michael Grabner	1987 births, Arizona Coyotes players, American Hockey League players, Austrian ice hockey players, Living people, New Jersey Devils players, New York Islanders players, New York Rangers players, People from Carinthia (state), Spokane Chiefs players, Toronto Maple Leafs players, Vancouver Canucks players
Nuclear chain-reaction	Nuclear physics
Dargai	Tehsils of Khyber Pakhtunkhwa
Hillsong Church	Churches, Buildings and structures in Sydney
Yoshi Tatsu	1977 births, Boxers, Former WWE wrestlers, Japanese professional wrestlers, Living people, People from Gifu Prefecture
Long John Silver's	American fast food restaurants, Companies based in Kentucky, 1969 establishments in the United States, Louisville, Kentucky, 20th-century establishments in Kentucky
Yoshikiyo Kuboyama	1976 births, Living people, Footballers from Shizuoka Prefecture
Koji Yoshimura	1976 births, Living people, Footballers from Kōchi Prefecture
Jungo Kono	1982 births, Living people, Footballers from Kanagawa Prefecture
Superettan	2000 establishments in Sweden, Football leagues, Football in Sweden
Dakota Wizards	Bismarck, North Dakota, National Basketball Association teams
Patrick Sharp	1981 births, American Hockey League players, Canadian ice hockey centres, Canadian Olympic gold medalists, Chicago Blackhawks players, Dallas Stars players, Ice hockey people from Ontario, Living people, People from Thunder Bay, Sportspeople from Vermont, Stanley Cup champions, United States Hockey League players
Desertification	Environmental issues
Dwayne Johnson	1972 births, Living people, Actors from Alameda County, California, African American actors, African-American sportspeople, American Christians, American movie actors, American television actors, American video game actors, American professional wrestlers, Canadian Christians, Canadian movie actors, Canadian professional wrestlers, Former WWE wrestlers, People from Hayward, California, Sportspeople from California, WWE wrestlers
Shaquille O'Neal	1972 births, Living people, Actors from Newark, New Jersey, African American actors, African-American basketball players, African American musicians, American movie actors, American movie producers, American Muslims, American rap musicians from New Jersey, Musicians from Newark, New Jersey, Sportspeople from Newark, New Jersey, American television personalities, American television producers, Boston Celtics players, Cleveland Cavaliers players, Los Angeles Lakers players, Miami Heat players, Orlando Magic players, Businesspeople from Newark, New Jersey, National Basketball Association players with retired numbers, American basketball players
Left 4 Dead	Xbox 360 games, Windows games, 2008 video games, Shooter video games, Horror video games
Rivers Cuomo	American guitarists, American rock musicians, Musicians from New York City, Harvard University alumni, Living people, 1970 births
Pau Gasol	1980 births, Living people, 2004 Summer Olympics, Chicago Bulls players, Los Angeles Lakers players, Medalists at the 2008 Summer Olympics, Medalists at the 2012 Summer Olympics, Memphis Grizzlies players, Olympic silver medalists, Spanish basketball players, Spanish Olympic medalists, Sportspeople from Barcelona
Mezzaluna	Kitchenware
Cascoplecia	Flies
Sungai Besar	Settlements in Malaysia
Selangor	States of Malaysia
Ichiro Suzuki	1974 births, Living people, Japanese baseball players, New York Yankees players, Seattle Mariners players, People from Aichi Prefecture, Florida Marlins players
SuccessTech Academy shooting	2007 in the United States, 2000s in Cleveland, Ohio, 2000s crimes in the United States, Deaths by firearm, Suicide
Koji Arimura	1976 births, Living people, Footballers from Fukuoka Prefecture
Hideaki Tominaga	1976 births, Living people, Footballers from Fukui Prefecture
Graham Arnold	1963 births, Living people, Australian footballers, Australian football managers, Sportspeople from Sydney
Kurt Angle	1968 births, American Olympic gold medalists, American professional wrestlers, Living people, Sportspeople from Pennsylvania
Boris Balashov	1927 births, 1974 deaths, Soviet writers, Journalists, Philatelists, Philately of the Soviet Union, Editors
1960–61 NHL season	1960 in North America, 1961 in North America
Whitey Bulger	1929 births, 2018 deaths, Deaths by beating, Murdered criminals, American murder victims, People murdered in the United States, People who died in prison custody in the United States, American prisoners sentenced to life imprisonment, American gangsters, American murderers, American prisoners, People from Boston, Massachusetts
Semion Mogilevich	1946 births, Fraudsters, Living people, People from Kiev
Ali Saed Bin Ali El-Hoorie	1965 births, Living people, Muslim terrorists, Saudi Arabian people
Shamil Basayev	1965 births, 2006 deaths, Asian military people, Chechnya, European military people, Muslim terrorists, Russian people
Napredak Krusevac	Serbian football clubs
Zeta Golubovci	Football clubs
Drexel University	Colleges and universities in Pennsylvania, 1891 establishments in the United States, 1890s establishments in Pennsylvania
Eddy Gordo	Tekken characters
Mines of Paris	Paris, Subterranea
Tank Johnson	1981 births, Living people, Chicago Bears players, Cincinnati Bengals players, Dallas Cowboys players
San Cristóbal, Dominican Republic	Settlements in Dominican Republic, 18th-century establishments in the Spanish Empire
I've Got a Secret	Television game shows, CBS network shows, First run syndicated television programs, English-language television programs
Yann Tiersen	Living people, 1970 births, Composers, French musicians
Antônio Carlos Zago	1969 births, Living people, Brazilian footballers, Brazilian football managers
Sandro Chaves de Assis Rosa	1973 births, Living people, Brazilian footballers
Hernán Gaviria	1969 births, 2002 deaths, Colombian footballers
Carrow Road	Football stadiums in England, Norwich, 1935 establishments in Europe, 1930s establishments in England
Five Suns	Mythology
Ages of Man	Greek mythology, Roman mythology
Harvey Keitel	1939 births, Actors from New York City, American movie actors, American stage actors, American television actors, American voice actors, Movie producers from New York, Living people
Tim Roth	1961 births, Living people, Actors from London, BAFTA Award winners, British television producers, English movie actors, English movie directors, English stage actors, English television actors
John McCrae	1872 births, 1918 deaths, Canadian military people, Canadian poets, Military personnel of World War I, People from Guelph
Stan Mikita	1940 births, 2018 deaths, Art Ross Trophy winners, Canadian ice hockey centres, Chicago Blackhawks players, Deaths from dementia with Lewy bodies, Disease-related deaths in Chicago, Illinois, Hart Memorial Trophy winners, Hockey Hall of Fame inductees, Lady Byng Memorial Trophy winners, Slovak ice hockey players, Stanley Cup champions
Left 4 Dead 2	2009 video games, Windows games, Xbox 360 games, Shooter video games, Horror video games
Reservoir Dogs (video game)	2006 video games, PlayStation 2 games, Windows games, Xbox games, Video games based on movies
WWF SmackDown! Just Bring It	2001 video games, PlayStation 2 games, THQ games, WWE video game series
Saint Germaine	People from Occitanie, Christian saints, 1579 births, 1601 deaths
Kricogonia lyside	Pieridae
All That You Can't Leave Behind	U2 albums, 2000 albums, Island Records albums
Wigtownshire	Counties of Scotland
Forza Motorsport 3	Racing video games, Xbox 360 games, 2009 video games
Patau syndrome	Trisomies
Steve Bernier	1985 births, American Hockey League players, Buffalo Sabres players, Canadian ice hockey right wingers, Florida Panthers players, Ice hockey people from Quebec, Living people, Moncton Wildcats players, New Jersey Devils players, People from Quebec City, San Jose Sharks players, Vancouver Canucks players
Henryk Vogelfanger	1904 births, 1990 deaths, Polish movie actors
Dăbuleni	Towns in Romania
Fraternity	Ethics, Philosophy
Rocky Rapids, Alberta	Hamlets in Alberta
Envigado	Cities in Colombia, Geography of Colombia
Jerry Hairston Jr.	1976 births, Living people, African-American baseball players, Baltimore Orioles players, Chicago Cubs players, Cincinnati Reds players, Los Angeles Dodgers players, Milwaukee Brewers players, New York Yankees players, San Diego Padres players, Texas Rangers players, Washington Nationals players, Sportspeople from Des Moines, Iowa
Little Green Bag	1969 songs, Pop songs
Matt Bonner	1980 births, Living people, Sportspeople from New Hampshire, San Antonio Spurs players, Toronto Raptors players, People from Concord, New Hampshire
Luol Deng	1985 births, Living people, Black British sportspeople, Chicago Bulls players, Cleveland Cavaliers players, Los Angeles Lakers players, Miami Heat players, Minnesota Timberwolves players, Naturalised citizens of the United Kingdom, People from Wau, South Sudan
Pedro Troglio	1965 births, Living people, Argentine footballers, Argentine football managers, Sportspeople from Buenos Aires
Marcos Nozomi Munakata	1959 births, Living people, Brazilian footballers
Ademir Santos	1968 births, Living people, Brazilian-Japanese footballers
Abraxas (moth)	Geometridae
Baltoro Kangri	Mountains of Pakistan
Accomack County, Virginia	Virginia counties, 1671 establishments, 1670s establishments in the Thirteen Colonies, 17th-century establishments in Virginia
University of New Hampshire	Colleges and universities in New Hampshire, Hockey East, 1866 establishments in the United States, 19th-century establishments in New Hampshire
University of Vermont	Colleges and universities in Vermont, 1791 establishments in the United States, 18th-century establishments in Vermont
Immunosuppressant drugs	Drugs
Sigur Rós	People from Reykjavík, Rock bands, 1990s music groups, 2000s music groups, 2010s music groups
Millbrook, Southampton	Southampton
Totton and Eling	Towns in Hampshire
List of settlements in Acre	Municipalities in Acre (state), Lists of settlements
Deodoro da Fonseca	Presidents of Brazil, 1827 births, 1892 deaths, Alagoas
Arrondissement of Caen	Arrondissements of France
Băilești	Municipalities of Romania
Filiași	Towns in Romania
Bechet	Towns in Romania
Arrondissement of Lisieux	Arrondissements of France
Northern Rhodesia	Zambia, 1911 establishments, 1964 disestablishments
San Juan de la Maguana	Settlements in Dominican Republic, 1500s establishments in the Spanish Empire
Chess club	Chess
Assis Brasil	Municipalities in Acre (state), 1976 establishments in Brazil
Armageddon (2005)	2005 in professional wrestling, History of Providence, Rhode Island, WWE Armageddon, 2005 in the United States, 2000s in Rhode Island, December events
Nesquehoning, Pennsylvania	Cities in Pennsylvania
Jessica Watson	1993 births, Living people, Sportspeople from Queensland, People from the Sunshine Coast, Queensland, Sailors
Astrolabe	Measuring tools
Electric Avenue (song)	1983 songs, Reggae songs, Songs about London
Queen Latifah	1970 births, Living people, American movie actors, American television actors, American rap musicians from New Jersey, Models from New Jersey, Actors from New Jersey, Singers from New Jersey
Queen + Paul Rodgers	English musical groups, Musical groups established in 2004, 2004 establishments in England, Musical groups disestablished in 2009, 2009 disestablishments in England
The Cosmos Rocks	2008 albums, Queen albums, Rock albums
Kenji Onitake	1939 births, Living people, Footballers from Hiroshima Prefecture, People from Hiroshima
Manabu Nakamura	1977 births, Living people, Footballers from Iwate Prefecture
Edwin Uehara	1969 births, Living people, Peruvian footballers, Japanese footballers, People from Lima
Marián Gáborík	1982 births, Columbus Blue Jackets players, Los Angeles Kings players, Living people, Minnesota Wild players, New York Rangers players, Ottawa Senators players, Slovak ice hockey players, Swedish Hockey League players
MAR	Anime
MyLifeIsAverage	Websites
Chuck Knoblauch	1968 births, Living people, American baseball players, Sportspeople from Houston, Texas, New York Yankees players, Kansas City Royals players, Minnesota Twins players
Romeo Crennel	1947 births, Living people, People from Lynchburg, Virginia
Der Rosenkavalier	Compositions by Richard Strauss, 1910s operas, 1911 works
Dagger	Blades
Ronnie Wood	1947 births, Living people, British bass guitarists, English painters, English rock guitarists, English songwriters, Musicians from Middlesex, The Rolling Stones members
Mick Taylor	1949 births, Living people, English rock guitarists, English songwriters, Musicians from Hertfordshire, The Rolling Stones members
Standing army	Army
Marechal Deodoro	Municipalities in Alagoas
Brian Jones	1942 births, 1969 deaths, Deaths by drowning, English rock guitarists, Musicians from Gloucestershire, The Rolling Stones members
1st millennium	1st millennium, Millennia
Cho Kwi-Jea	1969 births, Living people, South Korean footballers
Aílton Gonçalves da Silva	1973 births, Brazilian footballers, Living people
Landskrona BoIS	Swedish football clubs, 1915 establishments in Sweden
IFK Malmö	Swedish football clubs, Sport in Malmö, 1899 establishments in Sweden
Västerås IK	Swedish football clubs, 1913 establishments in Europe, 1910s establishments in Sweden
Sandvikens IF	1918 establishments in Sweden, Swedish football clubs
Gefle IF	1882 establishments in Europe, Swedish football clubs, 1880s establishments in Sweden
IK Brage	1925 establishments in Sweden, Swedish football clubs
Degerfors IF	1907 establishments in Sweden, Swedish football clubs
Marcelo Trivisonno	1966 births, Living people, Argentine footballers
Fernando Gago	1986 births, Living people, Argentine footballers
Gwak Kyung-Keun	1972 births, Living people, South Korean footballers
Jönköpings Södra IF	1922 establishments in Sweden, Swedish football clubs, Sport in Jönköping
Örebro SK	1908 establishments in Sweden, Swedish football clubs, Örebro
Råå IF	1921 establishments in Sweden, Swedish football clubs
Västerås SK	1904 establishments in Sweden, Swedish football clubs
Takafumi Hori	1967 births, Living people, Footballers from Kanagawa Prefecture
Kim Joo-sung	1966 births, Living people, South Korean footballers
Edmílson Matias	1974 births, Living people, Brazilian footballers
GIF Sundsvall	1903 establishments in Sweden, Swedish football clubs, Sundsvall
IFK Sundsvall	Swedish football clubs, 1895 establishments in Europe, Sundsvall, 1890s establishments in Sweden
Mark Bowen	1963 births, Living people, Welsh footballers
Francisco Molinero	1985 births, Living people, Spanish footballers, People from Toledo, Spain
Swedish Division 1	Football leagues, Football in Sweden
BK Häcken	1940 establishments in Europe, Swedish football clubs, 1940s establishments in Sweden
Trelleborgs FF	1926 establishments in Sweden, Swedish football clubs
Västra Frölunda IF	1930 establishments in Sweden, Swedish football clubs
Kiruna FF	Swedish football clubs, 1970 establishments in Sweden
Umeå FC	1987 establishments in Sweden, Swedish football clubs, Umeå
IK Oddevold	1932 establishments in Sweden, Swedish football clubs
Ljungskile SK	1926 establishments in Sweden, Swedish football clubs
Enköpings SK	1914 establishments in Sweden, Swedish football clubs
Assyriska Föreningen	Swedish football clubs, 1974 establishments in Sweden
Santiago Denia Sánchez	1974 births, Living people, Spanish footballers
Seydou Doumbia	1987 births, Living people, Ivorian footballers
Pedro II of Brazil	Brazilian people, Emperors and empresses, 1825 births, 1891 deaths, People from Rio de Janeiro, House of Braganza
President of Brazil	Presidents of Brazil
Barry Manilow	1943 births, Living people, American pop singers, Gay men, LGBT musicians, LGBT people from New York City, LGBT singers, Musicians from Brooklyn, Singer-songwriters from New York City, Emmy Award winners, Grammy Award winners, Clio Award winners, American Music Awards
Bobby Abreu	Living people, 1974 births, Houston Astros players, Philadelphia Phillies players, New York Yankees players, Los Angeles Dodgers players, National League All-Stars, Venezuelan baseball players, Los Angeles Angels of Anaheim players
Gabriel Zakuani	1986 births, Living people, African footballers, People from Kinshasa
Dubstep	Electronic dance music
Washington Capitols	1946 establishments in the United States, 1950s disestablishments in the United States, 1951 disestablishments, 20th-century establishments in Washington, D.C., Basketball teams
George Ouzounian	1978 births, Living people, American writers, Bloggers, American Internet celebrities
LinuxLive USB Creator	Free software, Microsoft Windows software
Simple machine	Tools, Machines, Physics
List of numbered state highways in New York	Roads in New York, Lists of roads
Sydney, Nova Scotia	Former cities in Canada
Baron Davis	1979 births, Living people, Cleveland Cavaliers players, Golden State Warriors players, Los Angeles Clippers players, New Orleans Hornets players, New York Knicks players, Sportspeople from Los Angeles, California
Song of the South	1946 movies, Movies based on books, Animated movies, Disney movies, Movies that won the Best Original Song Academy Award
Sony Music Entertainment	American record labels, Companies based in New York City, Sony, Columbia Broadcasting System
1970 Bhola cyclone	1970, 1970s in India, Cyclonic storms, North Indian Ocean cyclones, 1970s in Bangladesh
Snake River Plain	Geography of Idaho, Landforms of the United States
North American plate	Tectonic plates, North America
Xinhua News Agency	People's Republic of China, Media in Asia
Wijerd Jelckama	1490 births, 1523 deaths, Dutch military people, People executed by decapitation, People from Friesland, Pirates
The Happiest Millionaire	1967 movies, Disney movies, 1960s musical movies, Movies based on books, English-language movies
Shinji Tanaka	1960 births, Living people, Footballers from Saitama Prefecture, Japan international footballers, Japanese football managers, J1 League players, Japan Soccer League players, Yokohama F. Marinos players, Urawa Red Diamonds players, Kyoto Sanga FC players
Jean-Marie Pfaff	1953 births, Living people, Belgian footballers, Association football goalkeepers, People from East Flanders
IF Sylvia	1922 establishments in Sweden, Swedish football clubs, Norrköping
Qviding FIF	Swedish football clubs, 1987 establishments in Sweden, Sport in Gothenburg
Syrianska FC	Swedish football clubs, 1977 establishments in Sweden
FC Trollhättan	Swedish football clubs, 2001 establishments in Sweden
Edu Marangon	1963 births, Living people, Brazilian footballers, Brazilian football managers
Michael Obiku	1968 births, Living people, Nigerian footballers
Marcelo Silva Ramos	1973 births, Living people, Brazilian footballers, People from Salvador, Bahia
FC Energie Cottbus	1960s establishments in Germany, 1966 establishments in Europe, German football clubs
Battle of Curupaity	Battles, Paraguay, 1866, 19th century in South America, September events
Chronic stress	Mental illnesses
Eustress	Health
Conservative Party (Empire of Brazil)	History of Brazil, Conservative parties, 1836 establishments, 19th-century establishments in Brazil, 1889 disestablishments, Disestablishments in Brazil, 1830s establishments in South America
UK Singles Chart	Record charts, British music
Rotation (music)	Music industry
Rockfield Studios	Monmouthshire, Music industry, Companies of the United Kingdom
Impersonator	Deception, Types of crime
Sergio Rodríguez García	1984 births, Living people, Spanish footballers
Steven Tweed	1972 births, Living people, Scottish footballers, Scottish football managers, Sportspeople from Edinburgh
Dennis Lawrence	1974 births, Living people, Trinidad and Tobago footballers
Igor Akinfeev	1986 births, Living people, Russian footballers, 2014 FIFA World Cup players, 2018 FIFA World Cup players, UEFA Euro 2004 players, UEFA Euro 2008 players, UEFA Euro 2012 players, UEFA Euro 2016 players
Jérémy Menez	1987 births, Living people, French footballers
Andreas Görlitz	1982 births, Living people, German footballers, Sportspeople from Bavaria
Ramón Medina Bello	1966 births, Living people, Argentine footballers
Aurelio Vidmar	1967 births, Living people, Australian footballers, Australian football managers, People from Adelaide, Sportspeople from South Australia
Yellow Pages	Telephone numbers
Luka Modrić	1985 births, Living people, Croatian footballers
Irish Singles Chart	Record charts
Syndicat National de l'Édition Phonographique	Music industry, Copyright
Recorded Music NZ	Music industry, Non-profit organizations, New Zealand
Grammy Award for Best Rock Performance by a Duo or Group with Vocal	Grammy Awards
Grammy Award for Best Rock Song	Grammy Awards, Rock songs
The Cancer Council Australia	Organisations based in Australia, Cancer, Charities
Safety (EP)	Coldplay, 1998 albums
Edisto Beach, South Carolina	Cities in South Carolina, 1500s establishments in North America
Oregon Inlet	Geography of North Carolina, Bodies of water of the United States
Hi-hat	Percussion instruments
Overdubbing	Music technology
Fort Ticonderoga	Buildings and structures in New York, National Register of Historic Places, Forts in the United States, 1750s establishments in the Thirteen Colonies, 18th-century establishments in New York (state)
Chesapeake Bay	Bays of the United States
Surf City, North Carolina	Towns in North Carolina
Wallace and Gromit	Clay animation movies, Animated characters, Movie characters
Marty Wright	1964 births, American professional wrestlers, Former WWE wrestlers, Living people, Sportspeople from Arizona
Baker's dozen	Numbers
Pro Tools	Music technology, Music software
Campus radio	Radio
Loverboy	1970s music groups, 1980s Canadian music groups, 1990s Canadian music groups, 2000s Canadian music groups, 2010s Canadian music groups, Canadian hard rock bands, Musical groups established in 1979, 1979 establishments in Canada, Musical groups disestablished in 1988, 20th century disestablishments in Canada, Musical groups established in 1989, 1989 establishments in North America, 1980s establishments in Canada, Musical groups disestablished in 1989, Musical groups established in 1991, 1991 establishments in Canada, 1980s disestablishments in North America
Beaufort, North Carolina	Towns in North Carolina, County seats in North Carolina, Carteret County, North Carolina, 1722 establishments
North Carolina Highway 12	Roads in the United States, North Carolina
The Independent	1986 establishments in the United Kingdom, Newspapers published in the United Kingdom
Take on Me	1984 songs, Pop songs, Synth-pop
Mockingbird	Passeriformes
Smallville	2001 American television series debuts, 2011 American television series endings, 2000s American television series, 2010s American television series, American teen drama television series, Superman, WB network shows, English-language television programs, The WB original programming
Pieridae	Pieridae
1903 in baseball	History of baseball
Pamela Weston	1921 births, 2009 deaths, British teachers, Clarinetists, Deaths by euthanasia, Drug-related suicides, Musicians from London, Musicians who committed suicide
Jeff Hanneman	American guitarists, American heavy metal musicians, Musicians from Oakland, California, 2013 deaths, 1964 births
Santo Domingo Este	Settlements in Dominican Republic, 2001 establishments in the Dominican Republic
2009 World Series	Major League Baseball World Series, 2009 in sports, 2009 in New York (state), New York Yankees, Philadelphia Phillies, 2009 in Pennsylvania
Closer (movie)	2004 drama movies, 2004 romance movies, 2000s romantic drama movies, American romantic drama movies, BAFTA Award winning movies, English-language movies, Golden Globe Award winning movies, Infidelity in movies, Movies directed by Mike Nichols, Movies set in London, American independent movies
Maryse Ouellet	Beauty pageant winners, Canadian professional wrestlers, Female professional wrestlers, Former WWE wrestlers, Living people, Canadian models, People from Montreal, Sportspeople from Quebec, 1983 births
Misanthropy	Hatred
Cygnus X-1	Binary stars, Black holes
Woodcut	Printmaking
Ivan Boldirev	1949 births, Atlanta Flames players, Boston Bruins players, California Golden Seals players, Chicago Blackhawks players, Detroit Red Wings players, Living people, Ontario Hockey League players, Stanley Cup champions, Vancouver Canucks players, Ice hockey centres
Jose Reginaldo Vital	1976 births, Living people, Brazilian footballers
Peter Bosz	1963 births, Living people, Dutch football managers, Dutch footballers, Eredivisie managers, People from Apeldoorn, Sportspeople from Gelderland
Valeriy Lobanovskyi	1939 births, 2002 deaths, Deaths from stroke, Deaths from surgical complications, Ukrainian football managers, Sportspeople from Kiev, Ukrainian footballers
Blood Brothers	1980s musicals, Broadway musicals, Laurence Olivier Award winning musicals, Plays by Willy Russell, Musicals based on books, West End musicals, Works about brothers
2027	2027, Years in the future
Daniel Edusei	1980 births, Living people, Ghanaian footballers
Dodô	1974 births, Living people, Brazilian footballers
José Róbson do Nascimento	1969 births, Living people, Brazilian footballers
Peterloo Massacre	1819, 1810s in the United Kingdom, Battles, History of Manchester, 19th century in England, August events
Radekhiv	Cities in Ukraine
Richard Arkwright	1733 births, 1792 deaths, English inventors, People from Lancashire
Port of Manchester	Greater Manchester
Manchester Piccadilly station	Railway stations in England
First Greater Manchester	Transport in the United Kingdom, Greater Manchester, 1996 establishments in England
Victorian architecture	Architectural styles
Rotifer	Rotifers, Extremophiles, Horizontal gene transfer
Contemporary architecture	Architecture
Estigmene acrea	Arctiidae
Heliocheilus julia	Noctuidae
Claus von Stauffenberg	1907 births, 1944 deaths, Colonels, Deaths by firearm in Germany, Executed German people, German military personnel of World War II, People from Baden-Württemberg, Victims of Nazism
Führerbunker	Nazi Germany, Buildings and structures in Berlin
Barcelona Metro	Barcelona Metro
Kelenna Azubuike	1983 births, Living people, African-American basketball players, Golden State Warriors players, Sportspeople from London, American basketball players
Harry Catterick	1919 births, 1975 deaths, English football managers, English footballers, Sportspeople from County Durham
Howard Kendall	1946 births, 2015 deaths, English football managers, English footballers, Sportspeople from County Durham
Patrick Henry	1736 births, 1799 deaths, Founding Fathers of the United States
Typhoon Tip	1979 Pacific typhoon season, Pacific typhoons
Pohnpei	Federated States of Micronesia
1979 Pacific typhoon season	1979 Pacific typhoon season
Freighter	Ship types
Common scold	Law
Los Angeles Memorial Coliseum	Sports buildings in Los Angeles, California, 1923 establishments in the United States, 1920s establishments in California
John Miszuk	1940 births, American Hockey League players, Chicago Blackhawks players, Detroit Red Wings players, Ice hockey people from Ontario, Living people, Minnesota North Stars players, Polish ice hockey players, Philadelphia Flyers players, World Hockey Association players, Central Professional Hockey League players, Ice hockey defencemen
Roger Machado Marques	1975 births, Living people, Brazilian footballers, Brazilian football managers, People from Porto Alegre
Álvaro Saborío	1982 births, Living people, Costa Rican footballers
Yoshiyuki Morisaki	1976 births, Living people, Footballers from Chiba Prefecture
S.K. Jugoslavija	Serbian football clubs, Yugoslavia, 1913 establishments in Europe, 1910s establishments in Serbia, 1945 disestablishments in Europe
Tomoaki Ōgami	1970 births, Living people, Footballers from Hiroshima Prefecture, Japanese association football goalkeepers
Ryan Smith	1986 births, Living people, English footballers, Actors from London, Arsenal F.C. players, Crystal Palace F.C. players
Nigel Reo-Coker	1984 births, Living people, English footballers, Sportspeople from London, Premier League players
Baltazar Maria de Morais Júnior	1959 births, Living people, Brazilian footballers, Goiânia
Rubén Paz	1959 births, Living people, Uruguayan footballers
Nelson Luís Kerchner	1962 births, Living people, Brazilian footballers, Brazilian football managers
Yokosuka, Kanagawa	Cities in Kanagawa Prefecture
Chuuk	Federated States of Micronesia
Monsoon trough	Meteorology
Syncytium	Cell biology
Chang Beer	Beer, Thai culture
Tropical Storm Peter (2003)	2003 Atlantic hurricane season, Atlantic tropical storms
Gesamtkunstwerk	Art
Poland, Ohio	Villages in Ohio
Lycée Michel-Rodange	1968 establishments in Europe, Luxembourg City, Schools
Ghost (movie)	1990 drama movies, 1990 romance movies, 1990s fantasy movies, 1990s romantic drama movies, Academy Award winning movies, American fantasy movies, American romantic drama movies, English-language movies, Ghost movies, Golden Globe Award winning movies, Movies about couples, Movies about revenge, Murder in movies, Movies set in New York City, Saturn Award winners
Fox Sports	Fox Broadcasting Company
The Girl and the Robot	2009 songs
Like Toy Soldiers	2004 songs, Eminem songs, Rhythm and blues ballads
Jeff Beck	English guitarists, Grammy Award winners, 1944 births, Living people
Milla Jovovich	American child actors, American models, American movie actors, American television actors, American voice actors, Naturalized citizens of the United States, Ukrainian actors, Ukrainian singers, 1975 births, Living people, People from Kiev
Texas Revolution	1835, 1836, 1830s in Texas, 19th century in Mexico, Wars of independence
Joey Wheeler	Television characters
Max Euwe	1901 births, 1981 deaths, Chess grandmasters, Dutch academics, Dutch computer scientists, Dutch mathematicians, Sportspeople from Amsterdam
Billy the Kid	1859 births, 1881 deaths, American murderers, Deaths by firearm
Luke Donald	British golfers, Sportspeople from Hertfordshire, Living people, 1977 births
Pit bull	Terriers
IAHD	Sports for the disabled, Diving, Non-profit organizations, 1993 establishments
Alex Mineiro	1975 births, Living people, Brazilian footballers, People from Belo Horizonte
Giuseppe Rossi	1987 births, Living people, Italian footballers, People from Teaneck, New Jersey
Nemanja Vidić	1981 births, Living people, Manchester United F.C. players, Serbian footballers
Lino Marzoratti	1986 births, Living people, Italian footballers
OFK Beograd	Serbian football clubs, Belgrade, 1911 establishments in Europe, 1910s establishments in Serbia
Ricardo Rangel	1924 births, 2009 deaths, Mozambican people, Photojournalists
Reverberation	Sound
Regina Moraes	1938 births, 2009 deaths
Adílson Batista	1968 births, Living people, Brazilian footballers, Brazilian football managers, People from Curitiba
José Fábio Santos de Oliveira	1987 births, Living people, Footballers from Maceió
Jia Xiuquan	1963 births, Living people, Chinese footballers
Yoshiaki Ota	1983 births, Living people, Footballers from Shizuoka Prefecture, J1 League players, J2 League players, Júbilo Iwata players, Vegalta Sendai players
Tomasz Frankowski	1974 births, Living people, Polish footballers
Ryoichi Kawakatsu	1958 births, Living people, Footballers from Kyoto Prefecture, Japan international footballers, Japanese football managers, Japan Soccer League players, Hokkaido Consadole Sapporo players, Tokyo Verdy players, Kyoto Sanga FC players, FC Tokyo players
Suplex	Professional wrestling moves
Drake (musician)	Drake (rapper), 1986 births, Living people, Actors from Toronto, Canadian movie actors, Canadian musicians, Canadian rap musicians, Canadian television actors, Singers from Toronto
Sled	Winter sports, Land vehicles, Sports equipment, Animal-powered vehicles, Snow
Telamon	People in Greek mythology
Sol Davis	1979 births, Living people, English footballers, Sportspeople from Gloucestershire
The Three Stooges	American television actors, Comedy
Christine Lieberknecht	1958 births, Living people, Christian ministers, East German politicians, German Lutherans, Ministers-President of Germany, People from Weimar, Politicians from Thuringia, Politicians of the Christian Democratic Union of Germany
Aerodynamics	Fluid mechanics, Aerospace engineering
East Carolina University	Colleges and universities in North Carolina, American Athletic Conference
Kodomo	Anime
Seinen manga	Manga
Josei	Anime
The Marine	2006 movies, English-language movies, 20th Century Fox movies
Harem (genre)	Anime and manga terms
MS-13	Criminals, El Salvador, Gangs
Lois Lane	DC Comics characters, Superman
Woody Austin	American golfers, Sportspeople from Tampa, Florida, 1964 births, Living people
Lex Luthor	Fictional business executives, Fictional characters introduced in 1940, Superman, DC Comics supervillains, Fictional mass murderers
Bones (TV series)	2005 American television series debuts, 2000s American drama television series, 2000s American workplace television series, 2000s crime television series, 2000s mystery television series, 2010s American crime television series, 2010s American drama television series, 2010s American workplace television series, 2010s mystery television series, American crime drama television series, American mystery television series, American police television series, American workplace drama television series, Fox television series, Television series set in Washington, D.C., English-language television programs
69 (sex position)	Sexual acts
Goodfellow's tree-kangaroo	Macropods, Mammals of Asia
Mahamadou Diarra	1981 births, Living people, Malian footballers, People from Bamako
Rodrigo Batata	1977 births, Living people, Brazilian footballers, People from Curitiba
Francisco Arce	1971 births, Living people, Paraguayan footballers
H.Š.K. Concordia	Croatian football clubs, Establishments in Croatia, 1906 establishments in Europe, 1945 disestablishments in Europe
Mirko Hrgović	1979 births, Living people, Bosnia and Herzegovina footballers
Emerson Thome	1972 births, Living people, Brazilian footballers, People from Porto Alegre
Sérgio Ricardo de Jesus Vertello	1975 births, Living people, Brazilian footballers
Michel Pensée	1973 births, Living people, Cameroonian footballers
Rodrigo Nunes de Oliveira	1979 births, Living people, Brazilian footballers
F.K. Vojvodina	Serbian football clubs, 1914 establishments in Europe, 1910s establishments in Serbia
Mike Myers	1963 births, Living people, Actors from Toronto, American game show hosts, American movie actors, American movie producers, American screenwriters, American television actors, American television personalities, American television writers, American voice actors, British game show hosts, British movie actors, British movie producers, British screenwriters, British television actors, British television personalities, British television writers, British voice actors, Canadian movie actors, Canadian movie producers, Canadian screenwriters, Canadian television actors, Canadian television writers, Canadian voice actors, Comedians from Toronto, Naturalised citizens of the United Kingdom, Naturalized citizens of the United States, Order of Canada, Writers from Toronto
Haddaway	1965 births, Living people, Trinidad and Tobago people, German singers
Fine Young Cannibals	1984 establishments in the United Kingdom, 1996 disestablishments in England, English pop music groups, English rock bands, Musical groups disestablished in 1996, Musical groups established in 1984, Musical groups from Birmingham, West Midlands, Soul bands
Pet Sematary (1989 movie)	1980s horror movies, 1989 movies, Movies based on books by Stephen King, English-language movies
Hedy Lamarr	1914 births, 2000 deaths, Actors from Vienna, American autobiographers, American inventors, American movie actors, American television actors, Austrian movie actors, Austrian television actors, Naturalized citizens of the United States
Bowie knife	Blades
Kitarō	1953 births, Living people, Japanese composers, Grammy Award winners, People from Aichi Prefecture
Dick in a Box	2009 songs
Jizz in My Pants	2008 songs, YouTube
Walking Tall	2004 movies, American action movies, Movies set in Washington (U.S. state), English-language movies
Green Goblin	Characters created by Stan Lee, Fictional business executives, Fictional characters introduced in the 1960s, Spider-Man, Marvel Comics supervillains, Marvel Comics mutates
Danaus eresimus	Danaus
New Super Mario Bros. Wii	2009 video games, Wii games
Luigi's Mansion	2001 video games, Mario video games, Nintendo 3DS games, Nintendo GameCube games
Thurberiphaga diffusa	Noctuidae
Glandular fever	Diseases caused by viruses
Hard Rock Stadium	1987 establishments in the United States, Buildings and structures in Miami, Florida, National Football League venues, Sports in Miami, Florida, Miami Marlins, Major League Baseball venues, 1980s establishments in Florida
Greater St. Louis	St. Louis, Missouri, Metropolitan areas of the United States
Ecological niche	Ecology
Ascension of Jesus	Christian theology
Degenerate art	Nazism, Art
Paulo Henrique Miranda	1972 births, Living people, Brazilian footballers
Alexandre Finazzi	1973 births, Living people, Brazilian footballers
Jan Vennegoor of Hesselink	1978 births, Living people, Dutch footballers, Sportspeople from Overijssel
Kuniya Daini	1944 births, Living people, Footballers from Hyōgo Prefecture, Japan international footballers, Japan Soccer League players, Urawa Red Diamonds players
Antonio de la Cruz	1947 births, Living people, Spanish footballers, Spanish football managers
Tomislav Erceg	1971 births, Living people, Croatian footballers, People from Split
Luis Robson	1974 births, Living people, Brazilian footballers
Jadílson	1977 births, Living people, Footballers from Maceió
Wannsee Conference	Nazism, The Holocaust
Rheydt	Boroughs of Germany, Mönchengladbach
Animals of New Zealand	Animals of New Zealand
University of Jena	Colleges and universities in Germany, Jena
Hurricane Grace (1991)	Hurricanes in Bermuda, 1991 Atlantic hurricane season, Category 2 Atlantic hurricanes, 1990s in Bermuda, 1991 in North America
Eli Whitney	1765 births, 1825 deaths, American inventors
Cotton gin	Agricultural machinery
Gale warning	Winds
James Burton	American guitarists, Musicians from Louisiana, American rock musicians, Country musicians, 1939 births, Living people
Jeff Burton	1967 births, Living people, NASCAR drivers, American racecar drivers, Sportspeople from Virginia
LeVar Burton	1957 births, Living people, African-American movie actors, African-American television actors, African-American voice actors, American television directors, Peabody Award winners, People from Rhineland-Palatinate, Grammy Award winners, Emmy Award winners
Beach erosion	Geology, Beaches, Erosion
Indestructible Records	1922 disestablishments, 1900s establishments in New York (state), Albany, New York, American record labels, Radio, 1907 establishments in the United States, 1920s disestablishments in New York (state)
Gonaïves	Cities in Haiti
Britannia	National personifications, United Kingdom
Funhouse	2009 songs, Pink songs
Obsessed	2009 songs, Mariah Carey songs, Hip hop songs, R&B songs
Run This Town	2009 songs, Rihanna songs, Jay-Z songs, Kanye West songs
Nada Surf	American rock bands, Musical groups from New York, Musical groups established in 1992, 1992 establishments in New York (state)
Robben Island	Atlantic islands, Islands of Africa, Geography of South Africa, Prisons, Nelson Mandela
The Taking of Pelham 123 (2009 movie)	2009 crime movies, 2009 thriller movies, 2000s crime thriller movies, American crime thriller movies, American movie remakes, English-language movies, Heist movies, Movies based on books, Movies directed by Tony Scott, Movies set in New York City
Ethernet switch	Computer hardware, Computer networking
Keisuke Ota	1981 births, Living people, Footballers from Shizuoka Prefecture
Frédéric Antonetti	1961 births, Living people, French footballers, French football managers
Sota Nakazawa	1982 births, Living people, Footballers from Tokyo Prefecture
Ryo Kobayashi	1982 births, Living people, Footballers from Saitama Prefecture
Naoya Kondo	1983 births, Living people, Footballers from Tochigi Prefecture, Japan international footballers, J1 League players, J2 League players, Kashiwa Reysol players, JEF United Chiba players, Tokyo Verdy players
Hidekazu Otani	1984 births, Living people, Footballers from Chiba Prefecture
Groove Armada	English dance musicians, Electronic music bands
Ellis Island	Islands of New York, Geography of New York City
Headphones	Audio technology
Processed cheese	Processed cheese
Paraffin	Chemistry
Bahrain Grand Prix	Formula One Grands Prix, Sport in Bahrain, 2004 establishments in Asia
Repetition	Literary terms, Rhetoric, Words
Wende	1989 in Europe, 1990 in Europe, 20th century in Germany, East Germany
Roy Jones Jr.	1969 births, Living people, Sportspeople from Florida, American boxers, American rap musicians from Florida, Singers from Florida
Bobby Labonte	1964 births, Living people, American racecar drivers, NASCAR drivers, Sportspeople from Texas, People from Corpus Christi, Texas
Recreo	Cities in Argentina
Ibuprofen	Analgesics
Senate of Romania	Government of Romania, National upper houses
Armenia, Wisconsin	Juneau County, Wisconsin, Towns in Wisconsin
Beetown, Wisconsin	Towns in Wisconsin, Grant County, Wisconsin
The Cranberries	20th century establishments in the Republic of Ireland, 1980s Irish music groups, 1990s Irish music groups, 2000s Irish music groups, 2010s Irish music groups, County Limerick, Irish rock bands, Musical groups established in 1989, Musical groups disestablished in 2019, Musical quartets
Yuji Unozawa	1983 births, Living people, Footballers from Chiba Prefecture
Yuzo Kobayashi	1985 births, Living people, Footballers from Tokyo Prefecture
Masayuki Ochiai	1981 births, Living people, Footballers from Kumamoto Prefecture
2. Bundesliga	Football leagues, 1974 establishments in Europe, 1970s establishments in Germany
Shinya Tanoue	1980 births, Living people, Footballers from Kagoshima Prefecture
Delio Toledo	1976 births, Living people, Paraguayan footballers
Makoto Sunakawa	1977 births, Living people, Footballers from Chiba Prefecture
Wiener Sport-Club	Austrian football clubs, Football clubs of Vienna
Wiener A.F.	Austrian football clubs, Football clubs of Vienna
Wiener A.C.	Austrian football clubs, Football clubs of Vienna
First Vienna FC	Austrian football clubs, Football clubs of Vienna
Floridsdorfer A.C.	Austrian football clubs, Football clubs of Vienna
FK Austria Wien	Austrian football clubs, Football clubs of Vienna
Eiji Takada	1974 births, Living people, Footballers from Kanagawa Prefecture
Mert Nobre	1980 births, Living people, Brazilian footballers
Watan Hamara Azad Kashmir	Azad Kashmir, National anthems
Voice recorder	Audio technology
Eurytides marcellus	Eurytides
Iphiclides	Papilioninae
Kagyu	Tibetan Buddhism
Brawn GP	Formula One constructors
Cadillac Escalade	1990s automobiles, Cadillac automobiles, Pickup trucks, Sport utility vehicles
Cordillera Septentrional	Geography of the Dominican Republic
Bjørn Skaare	1958 births, 1989 deaths, Detroit Red Wings players, Norwegian ice hockey players, Ontario Hockey League players, Road accident deaths, Sportspeople from Oslo, Swedish Hockey League players, Central Professional Hockey League players, Ice hockey centres
Egg Harbor (town), Wisconsin	Towns in Wisconsin, Door County, Wisconsin
Carlsville, Wisconsin	Unincorporated communities in Wisconsin, Door County, Wisconsin
WWE Superstars	2009 television series debuts, American television series, World Wrestling Entertainment television programs, 2016 television series endings, English-language television programs
Verbenaceae	Verbenaceae
Reinaldo da Cruz Oliveira	1979 births, Living people, Brazilian footballers
Archie Thompson	1978 births, Living people, Australian footballers
Axel Rodrigues de Arruda	Brazilian footballers, 1970 births, Living people
FK Partizan	Serbian football clubs, 1945 establishments in Europe, 20th century establishments in Serbia
Red Star Belgrade	Serbian football clubs, Belgrade, 1945 establishments in Europe, 20th century establishments in Serbia
F.K. Željezničar Sarajevo	Football clubs, Sarajevo, Football in Bosnia and Herzegovina, 1921 establishments in Europe, 20th century establishments in Bosnia and Herzegovina
Fábio Alves Félix	1980 births, Living people, Brazilian footballers
Patrick Zwaanswijk	1975 births, Living people, Dutch footballers, People from Haarlem, Sportspeople from North Holland
Gilberto Ribeiro Gonçalves	1980 births, Living people, Brazilian footballers
FK Sarajevo	Football clubs, Sarajevo, 1946 establishments in Europe, 1940s establishments in Bosnia and Herzegovina
FC Admira Wacker Mödling	Football clubs of Lower Austria
Red Bull Racing	Formula One constructors, Formula One current
Mihailo Petrović	1957 births, Living people, Serbian footballers, Serbian football managers
Yohei Suzuki	1983 births, Living people, Footballers from Shizuoka Prefecture, Japanese association football goalkeepers
Teófilo Cubillas	1949 births, Living people, 1970 FIFA World Cup players, 1978 FIFA World Cup players, 1982 FIFA World Cup players, People from Lima, Peruvian footballers
Dwarfism	Genetic disorders, Growth disorders
Play (album)	1992 albums
Kitchen Debate	1959 in the Soviet Union, 1950s in the United States, International relations, 20th century in Moscow
Poanes zabulon	Hesperiidae
Elmer Keiser Bolton	1886 births, 1968 deaths, American chemists, Scientists from Pennsylvania
Queen Mab	Characters in Shakespeare's plays
Moby-Dick	1850s books, American novels, 1851
Heroes of Newerth	2009 video games, Windows games, Real-time strategy video games
Étienne Geoffroy Saint-Hilaire	1772 births, 1844 deaths, French biologists, French deists, Evolutionary biologists, Naturalists
Gateway Arch	St. Louis, Missouri, Buildings and structures in Missouri
Morgue	Medicine, Death
Marty Robbins	American singer-songwriters, American movie actors, Country musicians, NASCAR drivers, American racecar drivers, Grammy Award winners, Actors from Arizona, Singers from Arizona, Sportspeople from Arizona, 1925 births, 1982 deaths, People from Glendale, Arizona
Literacy test	Discrimination, Tests
Williamstown, Victoria	Melbourne
Cowboy Jimmy Moore	1910 births, 1999 deaths, People from New Mexico
1933 Atlantic hurricane season	Atlantic hurricane seasons, 1933
Tore Pedersen	1969 births, Living people, Norwegian footballers
Sidney Govou	1980 births, Living people, French footballers
Tabla	Drums, Indian culture, Pakistani culture
Tony Rice	American country guitarists, Grammy Award winners, Singers from Virginia, Musicians from Virginia, Singers from Los Angeles, California, Musicians from Los Angeles, California, American bluegrass musicians, American folk musicians, 1951 births, 2020 deaths
Right-hand rule	Mathematics
Gunsmoke	American drama television series, Western television series, CBS network shows, 1950s television series, English-language television programs
Stan Kenton	1911 births, 1979 deaths, American jazz musicians, American pianists, Bandleaders, Musicians from Wichita, Kansas
Haneda Airport Station	Railway stations in Tokyo
Permeability (electromagnetism)	Electromagnetism
Hurricane Agnes	1972 Atlantic hurricane season, Hurricanes in Mexico, Hurricanes in the United States, 1972 in the United States, 1970s in Mexico, 1970s in Cuba, 1970s in Florida, 20th century in Georgia (U.S. state), 20th century in North Carolina, 1970s in Virginia, 20th century in Maryland, 20th century in Pennsylvania, 1970s in New York (state)
Simo Häyhä	1905 births, 2002 deaths, Finnish military people
Hurricane Martha (1969)	1969 Atlantic hurricane season, 20th century in Costa Rica, 20th century in Panama, 1969 in North America
Berlin Sportpalast	Buildings and structures in Berlin
Steam devil	Weather, Winds
Swiss Minaret controversy	2000s in Switzerland, 2009 in Europe, 21st century in Turkey
Barrie Colts	Canadian Hockey League teams, Ice hockey teams in Ontario, Ontario Hockey League
Loganiaceae	Gentianales
School shooting	Educational institutions, Types of crime, School shootings
Halls (cough drop)	Drugs
Paulo Wanchope	1976 births, Living people, Costa Rican footballers
Claudio Reyna	1973 births, Living people, American footballers, Sportspeople from New Jersey
Ippei Watanabe	1969 births, Living people, Footballers from Aichi Prefecture
Andrade Antunes Anderson	1981 births, Living people, Brazilian footballers
Sonny Anderson	1970 births, Living people, Brazilian footballers
Jared Borgetti	1973 births, Living people, Mexican footballers, People from Sinaloa
Hakoah Vienna	Jewish history, Judaism in Austria, Austrian football clubs, Football clubs of Vienna
Joshua Kennedy	1982 births, Living people, Australian footballers, Sportspeople from Victoria (Australia)
Ko Ishikawa	1970 births, Living people, Bolivian footballers, Japanese footballers
Sotaro Yasunaga	1976 births, Living people, Footballers from Yamaguchi Prefecture
Tomáš Galásek	1973 births, Living people, Czech footballers
Satoshi Nakayama	1981 births, Living people, Footballers from Miyazaki Prefecture
Nikolai Khabibulin	American Hockey League players, Chicago Blackhawks players, Edmonton Oilers players, Living people, Phoenix Coyotes players, Stanley Cup champions, Tampa Bay Lightning players, Winnipeg Jets (1979–96) players, 1973 births, International Hockey League (1945–2001) players, Russian ice hockey goaltenders
Sérgio Luís Donizetti	1964 births, Living people, Brazilian footballers
Kim Dae-Eui	1974 births, Living people, South Korean footballers
Arnold Scholten	1962 births, Living people, Dutch footballers, People from 's-Hertogenbosch, Sportspeople from North Brabant
A-side and B-side	Music industry
The Blue Room (EP)	Coldplay, 1999 albums
Brothers & Sisters (song)	1999 songs, Coldplay songs
Groove (music)	Musical forms
Paul Delarue	1889 births, 1956 deaths, French people
Constitution of Romania	20th century in Romania, Constitutions, 1991 in Europe
Parliament of Romania	Government of Romania, National legislatures
Sergej Barbarez	1971 births, Living people, Bosnia and Herzegovina footballers
Xavier Margairaz	1984 births, Living people, Swiss footballers
Satoshi Kajino	1965 births, Living people, Footballers from Aichi Prefecture
Kunio Nagayama	1970 births, Living people, Footballers from Kanagawa Prefecture
Satoshi Okura	1969 births, Living people, Footballers from Kanagawa Prefecture
Philipp Degen	1983 births, Living people, Swiss footballers
Hiroki Mihara	1978 births, Living people, Footballers from Saga Prefecture
David Degen	1983 births, Living people, Swiss footballers
Oceanside, California	Cities in California, Settlements in San Diego County, California
Salt Lake Tabernacle	Mormonism, Churches in the United States, Buildings and structures in Utah, Salt Lake City, 1867 establishments in the United States, 19th-century establishments in Utah
John Prescott	1938 births, Living people, British politicians, Former Labour MPs (UK), Former members of the British House of Commons for English constituencies, People from Cheshire, Politicians from Yorkshire, United Kingdom Life Peers, Deputy Prime Ministers of the United Kingdom
Yamanote Line	Japanese railways, 1909 establishments in Asia, 1900s establishments in Japan, Tokyo
Engelhard, North Carolina	Settlements in North Carolina, Villages in the United States
Luna Park, Melbourne	Buildings and structures in Melbourne, 1912 establishments, 1910s establishments in Australia
Miragoâne	Cities in Haiti
Your Body Is a Wonderland	2001 songs, Pop songs
Brooke Hogan	1988 births, Living people, Actors from Tampa, Florida, Models from Florida, American movie actors, Singers from Tampa, Florida
Kim Do-Kyun	1977 births, Living people, South Korean footballers, 2000 Summer Olympics
Rodrigo Mendes	1975 births, Living people, Brazilian footballers
Rodrigo Tabata	1980 births, Living people, Brazilian footballers
Karim Haggui	1984 births, Living people, Tunisian footballers, People from Tunis
Dong Fangzhuo	1985 births, Living people, Chinese footballers
André the Giant	1946 births, 1993 deaths, Deaths from heart failure, Former WWE wrestlers, French actors, Sportspeople from Auvergne-Rhône-Alpes, People from Grenoble, WWE Hall of Fame
Gura Humorului	Towns in Suceava County
HaNoar HaOved VeHaLomed	Nationalist organizations, Youth organizations, Socialism, Israeli culture, 1924 establishments, 1920s establishments in Israel
Sex chromosome	Biological reproduction, Chromosomes
Cytogenetics	Classical genetics, Cell biology
Somatic cell	Cell biology
Genetic screening	Genetics, Medicine
Haploid	Chromosomes
Malt shop	Shops
Atong language (Sino-Tibetan)	Languages of Bangladesh
Jaywalking	Traffic, Types of crime
Do Ab	Settlements in Afghanistan
Do Ab (Iran)	Geography of Iran
Euptoieta hegesia	Nymphalidae
Kingsway tramway subway	Transport architecture in London, Trams in London, London Borough of Camden, Subterranean London, Grade II listed buildings in London, 1952 disestablishments, 1950s disestablishments in the United Kingdom, 20th century disestablishments in England
University of Heidelberg	1385 establishments, Colleges and universities in Germany, Heidelberg
Eastbourne College	Eastbourne, Schools in England
University of Bonn	1818 establishments, Bonn, Colleges and universities in Germany, Education in North Rhine-Westphalia, 1810s establishments in Germany
University of Würzburg	Colleges and universities in Germany, Würzburg
Carles Rexach	1947 births, Living people, Spanish footballers, Spanish football managers
Frank Lobos	1976 births, Living people, Chilean footballers, People from Santiago
Andriy Rusol	1983 births, Living people, Ukrainian footballers
Ari (footballer, born 1980)	1980 births, Living people, Brazilian footballers, Bahia
MacBook Air	Apple hardware, Laptops
Darijo Srna	1982 births, Living people, Croatian footballers
Donbass Arena	Football stadiums in Europe, Buildings and structures in Ukraine
Mara Manzan	Brazilian actors, 1952 births, 2009 deaths
Madeline Kahn	1942 births, 1999 deaths, Actors from Boston, Massachusetts, Comedians from Massachusetts, American movie actors, American stage actors, American television actors, American voice actors, Deaths from ovarian cancer, Tony Award winning actors
Keihin-Tōhoku Line	Japanese railways
Shin-Yokohama Station	Railway stations in Kanagawa Prefecture
Hachiōji Station	Railway stations in Tokyo
Nuclear football	Nuclear weapons
Hizb-ul-Mujahideen	Kashmir
Kalat (Pakistan)	Former subdivisions of Pakistan, Pakistani princely states
Makran (princely state)	Former subdivisions of Pakistan, Pakistani princely states
Kharan (princely state)	Former subdivisions of Pakistan, Pakistani princely states
Amb (princely state)	Former subdivisions of Pakistan, Pakistani princely states
Phulra	Former subdivisions of Pakistan
Chitral (princely state)	Former subdivisions of Pakistan, Pakistani princely states
Dir (princely state)	Former subdivisions of Pakistan, Pakistani princely states
Hunza (princely state)	Former subdivisions of Pakistan, Pakistani princely states
Nagar (princely state)	Former subdivisions of Pakistan, Pakistani princely states
Polyurethane	Polymers
Violetta Villas	1938 births, 2011 deaths, European opera singers, People from Verviers, Polish actors, Polish singers, Pop musicians, Stage actors
Yutaka Fukufuji	1982 births, American Hockey League players, Japanese sportspeople, Living people, Los Angeles Kings players, People from Hokkaido, ECHL players, Ice hockey goaltenders
XFL	2001 establishments in the United States, 2001 disestablishments in the United States, American football, NBC network shows, UPN network shows, World Wrestling Entertainment television programs
Urban Meyer	1964 births, Living people, Sportspeople from Ohio, College football coaches
Rachael Yamagata	Singers from Virginia, People from Arlington, Virginia, Living people, 1977 births
NCIS (TV series)	American drama television series, CBS network shows, Television spin-offs, 2003 American television series debuts, English-language television programs
Cap-Haïtien	Cities in Haiti, 1670 establishments, Establishments in the French colonial empire
Torrie Wilson	American professional wrestlers, Sportspeople from Idaho, Former WWE wrestlers, 1975 births, Living people, People from Boise, Idaho
Mark Driscoll	1970 births, Living people, American Christians, People from Grand Forks, North Dakota, Writers from North Dakota, Writers from Seattle, Washington
Alun Michael	Welsh politicians, 1943 births, Living people
Vatra Dornei	Municipalities of Romania, Cities in Romania, Spa towns
Long-nosed bandicoot	Marsupials of Australia
Euroa, Victoria	Ned Kelly
Ralph Almas	1924 births, 2001 deaths, American Hockey League players, Canadian ice hockey goaltenders, Chicago Blackhawks players, Detroit Red Wings players, Ice hockey people from Saskatchewan, People from Saskatoon
Craig Anderson (ice hockey)	1981 births, American Hockey League players, Bill Masterton Memorial Trophy winners, Chicago Blackhawks players, Colorado Avalanche players, Florida Panthers players, American ice hockey goaltenders, Living people, Ontario Hockey League players, Ottawa Senators players, People from Park Ridge, Illinois, Sportspeople from Illinois
Dušan Petković	1974 births, Living people, Serbian footballers, People from Belgrade
Paulinho McLaren	1963 births, Living people, Brazilian footballers
Diego Lugano	1980 births, Living people, Uruguayan footballers
KFC Uerdingen 05	German football clubs, Sport in North Rhine-Westphalia
FC St. Pauli	German football clubs, Sport in Hamburg, 1910 establishments in Europe, 1910s establishments in Germany
Arminia Bielefeld	German football clubs, Sport in North Rhine-Westphalia, Bielefeld
Alemannia Aachen	Aachen, German football clubs, Sport in North Rhine-Westphalia, 1900 establishments in Germany
1. FC Saarbrücken	German football clubs, Sport in Saarland
Ataliba	1979 births, Living people, Brazilian footballers
Hiroyuki Ishida	1979 births, Living people, Footballers from Kanagawa Prefecture
Eijun Kiyokumo	1950 births, Living people, Footballers from Yamanashi Prefecture, Japan international footballers, Japanese football managers, Japan Soccer League players, JEF United Chiba players
Tennis Borussia Berlin	1902 establishments in Europe, 1900s establishments in Germany, German football clubs, Sport in Berlin
Bayer 04 Leverkusen	German football clubs, Sport in North Rhine-Westphalia, Leverkusen, 1904 establishments in Europe, 1900s establishments in Germany
FC 08 Homburg	German football clubs, Sport in Saarland
SV Darmstadt 98	Darmstadt, German football clubs, Sport in Hesse, 1898 establishments in Europe, 1890s establishments in Germany
Stuttgarter Kickers	German football clubs, Sport in Baden-Württemberg, Stuttgart
Svealand	Geography of Sweden
Mo Lewis	American football linebackers, New York Jets players, Sportspeople from Atlanta, Georgia, 1969 births, Living people
Goro (Mortal Kombat)	Fictional characters introduced in 1992, Mortal Kombat characters, Video game characters in movies, Video game bosses
Pavle, Serbian Patriarch	1914 births, 2009 deaths, Deaths from cardiac arrest, Patriarchs of the Serbian Orthodox Church
Eurytides	Eurytides
Tōkaidō Shinkansen	Tōkaidō Shinkansen, Shinkansen, 1972 establishments in Asia, 1970s establishments in Japan
Manuel Neuer	1986 births, Living people, 2010 FIFA World Cup players, 2014 FIFA World Cup players, German association football goalkeepers, People from Gelsenkirchen, Sportspeople from North Rhine-Westphalia
Tim Wiese	1981 births, Living people, German association football goalkeepers, People from Bergisch Gladbach, Sportspeople from North Rhine-Westphalia
Andreas Beck	1987 births, Living people, German footballers, Soviet people
King's Men (playing company)	Stage actors, William Shakespeare
Jérôme Boateng	1988 births, Living people, German footballers, Sportspeople from Berlin
Hertha BSC	German football clubs, German Bundesliga, Sport in Berlin, 1892 establishments in Europe, 1890s establishments in Germany
Russell Peters	1970 births, Canadian comedians, Canadian movie actors, Living people, People from Toronto
Miguel Magno	1951 births, 2009 deaths, Brazilian actors
Eddie Hazel	1950 births, 1992 deaths, American guitarists, Musicians from New York City, American funk musicians, American rock musicians
Parliament (band)	soul bands, Funk bands, Musical groups from Detroit, Michigan
Booker T (wrestler)	1965 births, American professional wrestlers, Living people, Sportspeople from Houston, Texas, Total Nonstop Action Wrestling alumni, WWE Hall of Fame, WWE wrestlers
Mandelbrot set	Fractals
Gilbert Arenas	1982 births, Living people, African-American basketball players, Golden State Warriors players, Orlando Magic players, Washington Wizards players, Sportspeople from Los Angeles, California, Sportspeople from Tampa, Florida, American bloggers, American basketball players
Liteni	Towns in Suceava County
Taijutsu	Martial arts, Japanese culture
Wilf Cude	1910 births, 1968 deaths, Boston Bruins players, Chicago Blackhawks players, Detroit Red Wings players, Montreal Canadiens players, Philadelphia Quakers (NHL) players, Sportspeople from Glamorgan, Welsh ice hockey players, Ice hockey goaltenders
Paul Goodman	1909 births, 1959 deaths, Canadian ice hockey goaltenders, Chicago Blackhawks players, Stanley Cup champions, Ice hockey people from Manitoba
United Center	Sports buildings in Chicago, Illinois, 1994 establishments in Illinois
Baqubah, Iraq	Iraq
Four Horsemen (professional wrestling)	WWE people, WWE Hall of Fame
NHL 10	2009 video games, Electronic Arts video games, PlayStation 3 games, Xbox 360 games, Sports video games
I Love Lucy	1950s American television series, 1957 disestablishments, American sitcoms, Black and white television series, Television series set in Connecticut, Television series set in New York City, 1951 establishments in the United States, 1950s disestablishments in the United States, Emmy Award winning programs, CBS network shows, English-language television programs
Kingstown	National capitals in North America, Saint Vincent and the Grenadines
Euphoria	Emotions
Shanxi	Provinces of China
Mi Fei	Chinese poets, Chinese painters, 1051 births, 1107 deaths
Heredity	Classical genetics
Variation	Evolutionary biology, Classical genetics, Ecology
Taiyuan	Cities in China
Danielle Souza	1981 births, Living people, Santa Catarina
Gugu Liberato	1959 births, 2019 deaths, People from São Paulo, Brazilian television presenters, Roman Catholics, Brazilian businesspeople, Accidental deaths from falls in the United States
Clog dance	Dance types
Baba Yaga	Folklore
Red Buttons	1919 births, 2012 deaths, Deaths from hypertension, Cardiovascular disease deaths in Los Angeles, Comedians from New York City, American movie actors, American television actors, Actors from New York City, Academy Award winning actors
Karl Wilhelm von Nägeli	Botanists, Swiss biologists, Cell biology, 1817 births, 1891 deaths
Rudolf Virchow	1821 births, 1902 deaths, German doctors, German biologists
Robert Remak	1815 births, 1865 deaths, Cell biology, Developmental biologists, German biologists, German doctors, Jewish German scientists, Neurologists, People from former German territories, People from Poznań, Physiologists
Oscar Hertwig	1849 births, 1922 deaths, Anatomists, Cell biology, Developmental biologists, German academics, German zoologists, People from Hesse
Igersheim	Cities in Baden-Württemberg
Bihari languages	Indo-Aryan languages, Languages of Bangladesh, Languages of India
Walther Flemming	1843 births, 1905 deaths, Cell biology, Geneticists, German biologists
Eduard Strasburger	1844 births, 1912 deaths, Cell biology, Developmental biologists, German academics, German botanists, People from Warsaw
Edouard van Beneden	1846 births, 1910 deaths, Belgian academics, Belgian biologists, Cell biology, People from Flemish Brabant
Ascaris	Nematodes, Parasites
Free (band)	English rock bands, English hard rock bands
Bacardi	Alcoholic spirits
Mick Jagger	1943 births, Living people, Actors from Kent, English movie actors, English rock singers, English singer-songwriters, Golden Globe Award winning composers, Musicians from Kent, People from Dartford, The Rolling Stones members
Burn It to the Ground	2009 songs
Rădăuţi	Municipalities of Romania, Cities in Romania, Towns in Suceava County
Maria Kanellis	1982 births, Living people, Female professional wrestlers, American professional wrestlers, Sportspeople from Illinois, Former WWE wrestlers
Jillian Hall	1980 births, American professional wrestlers, Female professional wrestlers, Former WWE wrestlers, Living people, Sportspeople from Kentucky
Khufu	Pharaohs
Ajana, Western Australia	Towns in Western Australia
Victor Posa	1966 births, Chicago Blackhawks players, Italian sportspeople, Living people, Ontario Hockey League players, People from Bari, ECHL players, Colonial Hockey League players, Ice hockey defencemen
Genetic linkage	Classical genetics
Barthélemy Dumortier	1797 births, 1878 deaths, Belgian biologists, Belgian Christian democrats, Belgian nobility, Botanists, Cell biology, People from Hainaut (province)
Eddie Van Halen	1955 births, 2020 deaths, American guitarists, American record producers, American songwriters, Cancer deaths in the United States, Deaths from throat cancer, Dutch musicians, Keyboardists, Naturalized citizens of the United States, People from Amsterdam
Eddie Cheever	1958 births, Living people, American racecar drivers, Formula One drivers, Sportspeople from Phoenix, Arizona, IndyCar Series drivers
Eddie Irvine	1965 births, Living people, Formula One drivers
Wilhelm Roux	1850 births, 1924 deaths, Anatomists, Cell biology, Developmental biologists, German academics, German biologists, People from Jena, German zoologists
Tokyo Metro Marunouchi Line	Japanese railways, Tokyo
Poanes	Hesperiidae
Concentric	Geometry
Andreas Hinkel	1982 births, Living people, German footballers, Sportspeople from Baden-Württemberg
Nymphalidae	Nymphalidae
Marcel Schäfer	1984 births, Living people, German footballers, Sportspeople from Bavaria
Dred Scott	Slaves, 1799 births, 1858 deaths
Louis Farrakhan	Writers from Chicago, Writers from the Bronx, Writers from Boston, Massachusetts, American political activists, American political writers, American political commentators, American Muslims, Religious leaders, African-American people, Living people, 1933 births
Synod of Dort	1618, 1619, Calvinism, Dordrecht, History of the Netherlands, Protestantism in the Netherlands, Protestant Reformation
Jacob Arminius	1560 births, 1609 deaths, Christian theologians, Dutch academics, People from Utrecht (province), Remonstrants
Valdeir Vieira	1944 births, Living people, Brazilian footballers
Richart Báez	1973 births, Living people, Paraguayan footballers, People from Asunción
Mustapha Hadji	1971 births, Living people, Moroccan footballers
Alexi Lalas	1970 births, Living people, American footballers
Christian Wilhelmsson	1979 births, Living people, Swedish footballers, People from Malmo
Kei Yamaguchi	1983 births, Living people, Footballers from Kyoto
Ivan Turgenev	1818 births, 1883 deaths, Russian writers
Kim Jung-woo	1982 births, Living people, South Korean footballers
Marek Špilár	1975 births, 2013 deaths, Slovak footballers, Sportspeople who committed suicide, Suicides by jumping
Andrej Panadić	1969 births, 1990 FIFA World Cup players, Croatian footballers, Croatian football managers, Living people, Sportspeople from Zagreb, Yugoslavian sportspeople
Franck Durix	1965 births, Living people, French footballers
Kim Sang-Woo	1987 births, Living people, South Korean footballers
Shigeru Yokotani	1987 births, Living people, Footballers from Hyōgo Prefecture
Michihiro Yasuda	1987 births, Living people, Footballers from Osaka Prefecture, Japan international footballers, J1 League players, J2 League players, Gamba Osaka players, Júbilo Iwata players, Sagan Tosu players, Vissel Kobe players, Nagoya Grampus players, Albirex Niigata players, JEF United Chiba players, Footballers at the 2008 Summer Olympics
Toshihiro Yamaguchi	1971 births, Living people, Footballers from Kumamoto Prefecture, Japan international footballers, J1 League players, Gamba Osaka players, Kyoto Sanga FC players, Sanfrecce Hiroshima players, 1995 King Fahd Cup players
Takuya Kokeguchi	1985 births, Living people, Footballers from Okayama Prefecture, Kataller Toyama players
Hogares CREA	Addiction, 1968 establishments in the United States, Organizations
Photorespiration	Plant physiology
August Weismann	1834 births, 1914 deaths, Cell biology, Geneticists, German academics, German evolutionary biologists, People from Frankfurt
Theodor Boveri	1862 births, 1915 deaths, Geneticists, Cell biology, German biologists
Fred Hoyle	1915 births, 2001 deaths, English astronomers, English science writers, English science fiction writers
Edmund Beecher Wilson	1856 births, 1939 deaths, American academics, American geneticists, American zoologists, Cell biology, Scientists from Illinois, Yale University alumni
Reginald Punnett	1875 births, 1967 deaths, English biologists, English geneticists, English science writers
Canons of Dort	1619, Calvinism, Christian texts, Dordrecht, History of the Netherlands, Protestantism in the Netherlands, Protestant theology
Three Forms of Unity	Calvinism, Christian texts, Protestant theology
Total depravity	Christian theology
Dordrecht Confession of Faith	1632, Anabaptism, Christian creeds, Dordrecht, History of the Netherlands, Protestantism in the Netherlands, Protestant theology, 1630s in Europe
Arthur Antunes Coimbra Junior	1977 births, Living people, Brazilian footballers
Martin Müller	1970 births, Living people, Czech footballers
Pavel Horváth	1975 births, Living people, Czech footballers
Bernard Genghini	1958 births, Living people, French footballers, French football managers
Jun Yanagisawa	1987 births, Living people, Footballers from Ibaraki Prefecture
Anders Svensson	1976 births, Living people, Swedish footballers, People from Gothenburg
John Piper (broadcaster)	Year of birth missing, British television presenters
Xerophyte	Botany
Liga MX	Football leagues, Football in Mexico, 1943 establishments in North America, 1940s establishments in Mexico
Fortuna Düsseldorf	Düsseldorf, German football clubs, Sport in North Rhine-Westphalia, 1895 establishments in Europe, 1890s establishments in Germany
SC Freiburg	German football clubs, Sport in Baden-Württemberg, Freiburg im Breisgau, 1904 establishments in Europe, 1900s establishments in Germany
MSV Duisburg	Duisburg, German football clubs, Sport in North Rhine-Westphalia, 1902 establishments in Europe, 1900s establishments in Germany
Hansa Rostock	German football clubs, Rostock
FC Red Bull Salzburg	Austrian football clubs, Football clubs owned by Red Bull, Football clubs of Salzburg
SK Sturm Graz	Austrian football clubs, Football clubs of Graz, 1909 establishments in Europe, 20th century establishments in Austria
L.A.S.K. Linz	Austrian football clubs, Football clubs of Upper Austria, Linz
F.C. Wacker Innsbruck (2002)	Austrian football clubs, Innsbruck
Grazer AK	Austrian football clubs, Football clubs of Graz
Judge Joe Brown	1998 American television series debuts, First run syndicated television programs
Curt Stern	1902 births, 1981 deaths, American geneticists, American zoologists, German biologists, Jewish American academics, Jewish American scientists, Jewish German scientists, Naturalized citizens of the United States, People from Hamburg, Refugees from Nazism
Thomas Hunt Morgan	1866 births, 1945 deaths, American geneticists, American Nobel Prize winners, Cell biology, Scientists from Kentucky, People from Lexington, Kentucky, Developmental biologists, Columbia University faculty
Alfred Sturtevant	1891 births, 1970 deaths, American geneticists, Cell biology, Scientists from Illinois
H. J. Muller	1890 births, 1967 deaths, American geneticists, American Nobel Prize winners, Scientists from New York City
Little Boy	Nuclear weapons, World War II, Hiroshima
Fat Man	Nuclear weapons, World War II
Geography of Haiti	Geography of Haiti
Mundari language	Languages of India, Languages of Bangladesh, Nepal
Listed building	Listed buildings
Holborn	Areas of London, London Borough of Camden, City of Westminster
Poker Alice	1853 births, 1930 deaths, People from Devon, People from Virginia, Poker players
Strand Underpass	Transport architecture in London
Southampton Row	London Borough of Camden
Victoria Embankment	City of Westminster, City of London, River Thames, Roads in London
Charlton, London	London Borough of Greenwich, Areas of London
Waterloo Bridge	Bridges in the United Kingdom, Buildings and structures in the City of Westminster, Transport in the City of Westminster, Stone bridges, Concrete bridges, Grade II* listed buildings in London
Westminster Bridge	Bridges in the United Kingdom, Buildings and structures in the City of Westminster, Transport in the City of Westminster, Transport in Lambeth, Steel bridges, Grade II* listed buildings in London
Bloomsbury	Areas of London, London Borough of Camden
Hop Exchange	1867 establishments in England, Buildings and structures in London, Grade II listed buildings in London, London Borough of Southwark
River Fleet	Geography of London, Rivers of England
The Angel, Islington	London Borough of Islington, Areas of London
Blackfriars, London	City of London, Areas of London
Kennington	London Borough of Lambeth, Areas of London
Elephant and Castle	London Borough of Southwark, Areas of London, Transport in London
Battersea	Battersea
Wandsworth	Areas of London, London Borough of Wandsworth
Anti-abortion movement	Abortion
Dunning–Kruger effect	Cognition, Experiments
Interferometer	Optical devices
Chris Terreri	1964 births, Chicago Blackhawks players, Living people, New Jersey Devils players, New York Islanders players, Sportspeople from Rhode Island, San Jose Sharks players, Stanley Cup champions, American Hockey League players, International Hockey League (1945–2001) players, People from Warwick, Rhode Island, American ice hockey goaltenders
Tic	Medical signs, Human behavior
Boards of Canada	Scottish musical groups, Musical groups established in 1986, 1986 establishments in the United Kingdom, 20th century establishments in Scotland
Jon Cryer	1965 births, Living people, Actors from New York City, American movie actors, American television actors, American voice actors, Emmy Award winners, Movie producers from New York City
Owl City	2000s in music
William Bateson	1861 births, 1926 deaths, British zoologists, English geneticists, English science writers
Beretta 92	Pistols, Law enforcement equipment
Ice Climbers	Video game series, Nintendo video games
Ray J	1981 births, American R&B singers, American rap musicians from Mississippi, Living people, Singers from Mississippi, Actors from Mississippi, Singers from Los Angeles, California, American movie actors, American television actors, Actors from Los Angeles, California
Wat Phrasri Rattana Sasadaram	Buddhist temples in Thailand, Buildings and structures in Bangkok, Establishments in Thailand, 1784 establishments in Asia
Colossal squid	Cephalopods
James Morrison	1962 births, Living people, Jazz musicians, Musicians from New South Wales, Trumpeters
I'm a Celebrity...Get Me Out of Here!	2002 British television series debuts, 2000s television series, 2010s television series, Reality television competitions, English-language television programs
Crossing over	Chromosomes
Chromatid	Chromosomes
Wat Pho	Buddhist temples in Thailand, Buildings and structures in Bangkok
Habbo	Online games
Kay Jewelers	Jewelry, Companies of the United States, Akron, Ohio
Hugh Trenchard, 1st Viscount Trenchard	British military people, Royal Air Force, Order of Merit, Knights Grand Cross of the Order of the Bath, Knights Grand Cross of the Royal Victorian Order, British aviators
Danaus (genus)	Danaus
Harold Lloyd	1893 births, 1971 deaths, Actors from Nebraska, American movie actors, Cancer deaths in the United States, Deaths from prostate cancer
Marc-Antoine Charpentier	1643 births, 1704 deaths, French composers, Baroque composers
Geneviève Bujold	1942 births, Actors from Montreal, Canadian movie actors, Living people
Andris Nelsons	1978 births, Conductors, Living people, People from Riga
FourCC	Computer file formats
Fred Penner	1946 births, Canadian guitarists, Living people, People from Winnipeg
Frasin	Towns in Suceava County
MyWikiBiz	Wikis
Topiary	Gardening
Aldwych tramway station	Transport architecture in London, Trams in London
1969–70 NHL season	1969 in North America, 1970 in North America
1970–71 NHL season	1970 in North America, 1971
Francis I, Holy Roman Emperor	Holy Roman Emperors, Habsburg Dynasty, 1708 births, 1765 deaths, House of Lorraine, House of Habsburg-Lorraine, Grand Dukes of Tuscany
Alexander Selkirk	1676 births, 1721 deaths, Sailors, Scottish people
Robert Gould Shaw	1837 births, 1863 deaths, Colonels, Military people killed in action, Military personnel of the American Civil War, People from Boston, Massachusetts
Robinson Crusoe Island	Pacific islands, Islands of Chile, Biosphere reserves
Buster Keaton	1895 births, 1966 deaths, Actors from Kansas, American movie actors, American movie directors, American movie producers, American screenwriters, American silent movie actors, American television actors, Cancer deaths in the United States, Deaths from lung cancer
Russian roulette	Games
Nude beach	Beaches, Nudity
Undercroft	Rooms
Buddha Bar	European restaurants, Buildings and structures in Paris
Edwards syndrome	Trisomies
Thames Embankment	Roads in London, River Thames, City of London, City of Westminster
London Transport Executive	1948 establishments in Europe, 1962 disestablishments, 1960s disestablishments in England, Defunct companies of the United Kingdom, Intermodal transport authorities, 1940s establishments in England
The Strand	City of Westminster, Roads in London
Parnassiinae	Papilionidae
Milot	Cities in Haiti
Islam in Austria	Islam by country, Religion in Austria
Clever Hans	Individual animals, Animal communication, Cognition, Experiments
Rick Mercer	Canadian comedians, LGBT broadcasters, LGBT comedians, Canadian LGBT people, 1969 births, Living people
London Passenger Transport Board	Defunct companies of the United Kingdom, Intermodal transport authorities, 1933 establishments, 1948 disestablishments in the United Kingdom
County of London	Local government in London, 1889 establishments in England, 1965 disestablishments in England, 19th century in London, 20th century in London
Brockley	Areas of London, London Borough of Lewisham
Downham	Areas of London
Archway, London	London Borough of Islington, Areas of London
Howie Morenz	1902 births, 1937 deaths, Canadian ice hockey centres, Chicago Blackhawks players, Hart Memorial Trophy winners, Hockey Hall of Fame inductees, Ice hockey people from Ontario, Montreal Canadiens players, New York Rangers players, Stanley Cup champions
Norbury	London Borough of Croydon, Areas of London
Waterloo station	Railway stations in London, London Travelcard zone 1, Bakerloo Line stations, Northern Line stations, Jubilee Line stations
Highbury	London Borough of Islington, Areas of London
Leyton	Areas of London, London Borough of Waltham Forest
Tooting	Tooting
Atomic radius	Nuclear physics
Dale Davis	1969 births, Living people, African-American basketball players, Detroit Pistons players, Golden State Warriors players, Indiana Pacers players, Portland Trail Blazers players, Sportspeople from Georgia (U.S. state)
Underpinning	Construction
Epistasis	Classical genetics
Holborn tramway station	Trams in London, Transport in Camden
Epigenetics	Epigenetics, Cell biology, Developmental biology
Cell differentiation	Genetics, Cell biology, Developmental biology
Morphogenesis	Developmental biology, Cell biology, Plant anatomy
Gastrulation	Developmental biology
Wat Phra-sri Rattana Mahathat	Buddhist temples in Thailand
Jikji	Buddhist texts, Korea, 14th century books
Bibliothèque nationale de France	Buildings and structures in Paris, National libraries in Europe
Fitness	Classical genetics, Evolutionary biology
Cilla Black	1943 births, 2015 deaths, Accidental deaths from falls, Accidental deaths in Spain, Actors from Liverpool, Cardiovascular disease deaths in Spain, Deaths from stroke, Disease-related deaths in Andalusia, English movie actors, English pop musicians, English television actors, English television presenters, Singers from Liverpool
Paulista Avenue	São Paulo
Didcot	South Oxfordshire, Towns in Oxfordshire, 13th century establishments in England
Horsepower	Imperial units, Units of power
Mason Raymond	1985 births, American Hockey League players, Anaheim Ducks players, Calgary Flames players, Canadian ice hockey left wingers, Ice hockey people from Alberta, Living people, Toronto Maple Leafs players, Vancouver Canucks players
Pavol Demitra	1974 births, 2011 deaths, Aviation deaths, Lady Byng Memorial Trophy winners, Los Angeles Kings players, Minnesota Wild players, Ottawa Senators players, Slovak ice hockey players, St. Louis Blues players, Vancouver Canucks players, American Hockey League players, International Hockey League (1945–2001) players, Ice hockey centres
Kevin Bieksa	1981 births, Living people, Canadian ice hockey defencemen, Vancouver Canucks players, Ice hockey people from Ontario, American Hockey League players
1992 United States presidential election	1992 in the United States, 1992 elections, United States presidential elections
Meliaceae	Meliaceae
South Jakarta	Jakarta
Alexandre Bolduc	1985 births, American Hockey League players, Arizona Coyotes players, Canadian ice hockey centres, ECHL players, Ice hockey people from Quebec, Living people, People from Montreal, Phoenix Coyotes players, Rouyn-Noranda Huskies players, Shawinigan Cataractes players, Vancouver Canucks players
Manitoba Moose	1996 establishments in Canada, 2011 disestablishments in Canada, 2015 establishments in North America, American Hockey League teams, Ice hockey teams in Canada, Sport in Manitoba, 2010s establishments in Canada
Stickleback	Teleosts
Mikhail Bulgakov	1891 births, 1940 deaths, Russian writers, People from Kiev
J.B.S. Haldane	1892 births, 1964 deaths, English biologists, English geneticists
Lost Generation	American writers
W.D. Hamilton	1936 births, 2000 deaths, English mathematicians, English geneticists, English evolutionary biologists, Fellows of the Royal Society
John Maynard Smith	1920 births, 2004 deaths, English biologists, English geneticists, British zoologists, English science writers
Kawasaki Station	Railway stations in Kanagawa Prefecture
Mudvayne	1996 establishments in the United States, 1990s American music groups, 1990s establishments in Illinois, 2000s American music groups, 2010s American music groups, 2010 disestablishments in the United States, Alternative metal bands, American heavy metal bands, Musical groups disestablished in 2010, Musical groups established in 1996, Musical groups from Illinois
Alastair Campbell	1957 births, Living people, British atheists, British journalists, British politicians
Cave	Caves
Automobile	Automobiles
Mickey Mouse Clubhouse	2006 American television series debuts, Television series by Disney, Children's television series
Indies	Asia
Asclepias amplexicaulis	Asclepias
Asclepias asperula	Asclepias
Asclepias californica	Asclepias
Alex Burrows	1981 births, Canadian ice hockey left wingers, Ice hockey people from Quebec, Living people, Vancouver Canucks players, American Hockey League players
Winger (ice hockey)	Ice hockey positions
Slovakia men's national ice hockey team	Ice hockey in Europe, National ice hockey teams, Sport in Slovakia
Yucca brevifolia	Agavaceae
1910–11 NHA season	National Hockey Association
Tim Thomas	1974 births, American ice hockey players, Boston Bruins players, Dallas Stars players, Conn Smythe Trophy winners, Florida Panthers players, Living people, Sportspeople from Michigan, Stanley Cup champions, Vezina Trophy winners
Quebec Nordiques	1972 establishments in Canada, 1990s disestablishments in Canada, 1995 disestablishments, Defunct National Hockey League teams, Sport in Quebec City, World Hockey Association teams
1967 NHL expansion	National Hockey League, 1967 in ice hockey, St. Louis Blues, 1967 in North America
Lady Byng Memorial Trophy	National Hockey League trophies and awards
Chris Andersen	1978 births, Basketball players from California, Cleveland Cavaliers players, Denver Nuggets players, Living people, Memphis Grizzlies players, Miami Heat players, New Orleans Hornets players, People from Long Beach, California
Asclepias cordifolia	Asclepias
Asclepias curassavica	Asclepias
Asclepias curtissii	Asclepias
Assassination of Julius Caesar	44 BC, Ancient Rome, Assassinations in Europe, March events
Asclepias eriocarpa	Asclepias
Asclepias erosa	Asclepias
Asclepias exaltata	Asclepias
Asclepias fascicularis	Asclepias
Asclepias humistrata	Asclepias
Asclepias incarnata	Asclepias
Brand New Eyes	Paramore albums, 2009 albums
Asclepias nivea	Asclepias
Asclepias physocarpa	Asclepias
Asclepias purpurascens	Asclepias
Asclepias speciosa	Asclepias
Asclepias subverticillata	Asclepias
Tortuga (Haiti)	Geography of Haiti
Seizure response dog	Working dogs, Service animals
Asclepias syriaca	Asclepias
Guitar chord	Guitars
Asclepias tuberosa	Asclepias
Intel Core i7	Computer processors
Asclepias verticillata	Asclepias
Sacred dance	Ritual dances
Population genetics	Classical genetics, Evolutionary biology, Mathematics, Statistics
Calotropis gigantea	Gentianales
Calotropis procera	Gentianales, Plants of Asia
Cynanchum laeve	Gentianales
Hardy–Weinberg law	Classical genetics, Evolutionary biology
G.H. Hardy	English mathematicians, 1877 births, 1947 deaths
Sarcostemma clausum	Gentianales
Wilhelm Weinberg	Geneticists, German doctors, German scientists, Jewish scientists, People from Stuttgart, 1862 births, 1937 deaths
Centre Georges-Vézina	Indoor arenas, Sports buildings in Canada, 1949 establishments in Canada
Apocynum cannabinum	Gentianales
List of current NHL captains and alternate captains	Lists of National Hockey League players
Outcrossing	Classical genetics
San Francisco Ballet	1933 establishments in the United States, Companies based in San Francisco, 1930s establishments in California
Corner Gas	Sitcoms, Saskatchewan, 2000s Canadian television series, 2004 television series debuts
Spider monkey	New World monkeys
Asian Boyz	American criminals, People from Los Angeles, California
Peleus	People in Greek mythology
Banker horse	Horse breeds
Field research	Biology, Research methods
E. B. Ford	1901 births, 1988 deaths, English evolutionary biologists, English geneticists, Ecology, English science writers
Aster (genus)	Asteraceae
Akihabara Station	Akihabara Station, Railway stations in Tokyo
Borderline (song)	1984 songs, Madonna songs
Takadanobaba Station	Railway stations in Tokyo
Meet Me Halfway	The Black Eyed Peas songs, 2009 songs
Cirsium	Asteraceae
Oblast	Politics, Federal subjects of Russia
Rockford IceHogs	American Hockey League teams, Chicago Blackhawks, Ice hockey teams in the United States, Rockford, Illinois, 2007 establishments in Illinois
Belfast Agreement	1990s treaties, 1998 in the United Kingdom, 1990s in Northern Ireland, Politics of Northern Ireland, Politics of Ireland, Belfast
Democratic Unionist Party	Political parties in Northern Ireland
Tokyo Metro Tōzai Line	Japanese railways, Tokyo
Andrew Ladd	1985 births, American Hockey League players, Atlanta Thrashers players, Canadian ice hockey left wingers, Carolina Hurricanes players, Calgary Hitmen players, Chicago Blackhawks players, Ice hockey people from British Columbia, Living people, New York Islanders players, Stanley Cup champions, Vancouver Giants players, Winnipeg Jets players
Dipsacus fullonum	Dipsacales
Medical illustrator	Illustrators, Scientists
1916 Stanley Cup Finals	Montreal Canadiens, Stanley Cup Finals, 1910s in Canada, 1916 in the United States, History of Portland, Oregon, 20th century in Oregon
Conyza canadensis	Asteraceae
Treaty of Maastricht	1990s treaties, 1992 in Europe, Maastricht, 20th century in the Netherlands, 1992 works
Treaty of Lisbon	European Union, Treaties, 2007 in Europe
President of the European Council	2009 establishments in Europe, European Union, Presidents of the European Council
High Representative of the Union for Foreign Affairs and Security Policy	European Union, European Union politicians
Catherine Ashton	1956 births, Living people, European Union politicians, Politicians from Lancashire
Herman Van Rompuy	1947 births, Living people, Belgian economists, Belgian educators, Belgian nobility, Belgian Roman Catholics, Christelijke Volkspartij politicians, Christen-Democratisch en Vlaams politicians, Flemish politicians, Government ministers of Belgium, Legislative speakers, People from Brussels-Capital Region, Presidents of the European Council, Prime Ministers of Belgium
Treaty of Rome	1950s treaties, 1957 in Europe
Shinhwa	South Korean boy bands, K-pop music groups, 1990s music groups, 1998 establishments in Asia, 1990s establishments in South Korea
Dave Davies	1947 births, Living people, Bisexual people, English LGBT people, English rock guitarists, English singer-songwriters, LGBT songwriters, Musicians from London
Coffee cake	Cakes
Mi Plan	2009 albums, Latin Grammy Award-winning albums
Swahili people	Ethnic groups in Africa, Kenyan people, Tanzania, Mozambique
Tudor period	1480s in England, 1490s in England, 16th century in England, 1600s in England
Andrei Kirilenko	1981 births, Living people, Basketball players, Minnesota Timberwolves players, Russian sportspeople, Utah Jazz players
Bjarne Stroustrup	1950 births, Living people, American computer scientists, Danish scientists, Aarhus
Vanessa Redgrave	1937 births, Living people, Academy Award winning actors, Actors from London, BAFTA Award winning actors, Drama Desk Award winners, Emmy Award winning actors, English activists, English movie actors, English stage actors, English television actors, Golden Globe Award winning actors, Screen Actors Guild Award winners, Tony Award winning actors
WarioWare DIY	Wario, 2009 video games, Nintendo DS games
Phil Keaggy	American guitarists, American singer-songwriters, Singers from Ohio, Musicians from Ohio, Christian music singers, 1951 births, Living people, People from Youngstown, Ohio
Apocynaceae	Apocynaceae
Reaction inhibitor	Biochemistry
Frontier Falcon	Sport in Pakistan
Azad Jammu and Kashmir Regiment	Military of Pakistan
Federal Capital Territory	Former subdivisions of Pakistan
Merlot	Wine
Iconostasis	Eastern Orthodox Church
Charles Bronson	1921 births, 2003 deaths, Deaths from COPD, Deaths from respiratory failure, Deaths from lung cancer, Deaths from congestive heart failure, People with Alzheimer's disease, American movie actors, American television actors, American stage actors, American voice actors, Actors from Pennsylvania, American military people, Purple Heart recipients
Sundance Film Festival	Movie festivals, Park City, Utah, 1978 establishments in the United States
Turner Field	Major League Baseball venues, Sports buildings in Atlanta, Georgia, Atlanta Braves, 1996 establishments in the United States, 1990s establishments in Georgia (U.S. state)
Stevie Nicks	American singer-songwriters, Musicians from Phoenix, Arizona, Living people, 1948 births, American rock singers, Atlantic Records artists, Grammy Award winners
Baloristan	Regions of Pakistan
Michael Waltrip	1963 births, Living people, Daytona 500 winners, Sportspeople from Kentucky, American racecar drivers, People from Owensboro, Kentucky
Jean Simmons	Actors from London, Actors from Los Angeles, California, American child actors, American movie actors, American stage actors, American television actors, American voice actors, British child actors, Cancer deaths in the United States, Deaths from lung cancer, English movie actors, English stage actors, English television actors, English voice actors, Naturalized citizens of the United States, 1929 births, 2010 deaths, Emmy Award winning actors
Ernie Coombs	1927 births, 2001 deaths, Canadian musicians, Canadian television actors, Deaths from stroke, People from Lewiston, Maine, People from Ontario
Pleiotropism	Classical genetics, Evolutionary biology
Empire of the Sun (band)	Australian pop music groups, Electronic music bands, Musical duos, Musical groups from Sydney
Interrobang	Grammar, Punctuation
Altruism	Altruism, Evolution
Visegrád Group	International organizations, Politics of Europe, Czech Republic, History of Hungary, History of Poland, Slovakia, 1991 establishments in Europe
Standard error	Statistics
Really Wild Animals	Children's television series
Adaptive radiation	Evolutionary biology, Paleontology
Ajda Pekkan	1946 births, Living people, Musicians from Istanbul, Pop singers, Turkish movie actors, Turkish singers
The Fabulous Moolah	1923 births, 2007 deaths, American professional wrestlers, Deaths from myocardial infarction, Female professional wrestlers, Former WWE wrestlers, Sportspeople from South Carolina, WWE Hall of Fame
Percentile	Statistics
Grand Coulee	Geography of Washington (U.S. state)
Latent autoimmune diabetes	Diabetes mellitus, Autoimmune diseases
Screwdriver (alcoholic drink)	Alcoholic drink
Antoine Lavoisier	1743 births, 1794 deaths, French chemists, French biologists, People executed by decapitation, Scientists from Paris
Tequila Sunrise	Alcoholic drink
George Gaylord Simpson	1902 births, 1984 deaths, American academics, American autobiographers, American evolutionary biologists, American geologists, American military personnel of World War II, American paleontologists, Foreign Members of the Royal Society, Majors, Scientists from Chicago, Yale University alumni
Daisy Duck	Fictional characters introduced in 1940, Fictional ducks, Mickey Mouse universe characters
List of 100 greatest NHL players by The Hockey News	Lists of ice hockey players
James Norris Memorial Trophy	National Hockey League trophies and awards
Epistle to the Colossians	Pauline epistles, New Testament books
Carousel	Amusement rides
Tony Abbott	1957 births, Living people, Commonwealth Chairpersons-in-Office, Australian Roman Catholics, Leaders of the Opposition (Australia), Liberal Party of Australia politicians, Government ministers of Australia, Members of the Australian House of Representatives, Monarchists, Politicians from London, Politicians from Sydney, Prime Ministers of Australia, Rhodes scholars
Conrad Gessner	1516 births, 1565 deaths, Deaths from infectious disease, Naturalists, Botanists, Swiss scientists
Bernhard Rensch	German evolutionary biologists, Autobiographers, Ornithologists, 1900 births, 1990 deaths
Kinect	Video game technology
G. Ledyard Stebbins	1906 births, 2000 deaths, American botanists, American geneticists, American evolutionary biologists, Scientists from New York
Rusty Wallace	Living people, NASCAR drivers, American racecar drivers, Sportspeople from Missouri, 1956 births
Kevin Clash	1960 births, Living people, American voice actors, Puppeteers
George Mallory	1886 births, 1924 deaths
Atomic clock	Clocks, Physics
Typography	Typography, Graphics, Communication, Book terminology, History of printing
Cape	Clothing
Cab Calloway	1907 births, 1994 deaths, Deaths from stroke, Musicians from New York, Singers from New York, Grammy Award winners, People from Rochester, New York
Korean name	Korean culture
Villette	English novels, Romance novels
The Stranger (novel)	1942 books, French novels, French literature
Toei Asakusa Line	Japanese railways
1080p	Television technology
Teriyaki	Japanese food, Sauces
Dance hall	Entertainment venues
Yaque del Norte River	Rivers of the Dominican Republic
Whip (instrument)	Percussion instruments
First Epistle to the Thessalonians	Pauline epistles, New Testament books
Second Epistle to the Thessalonians	Pauline epistles, New Testament books
First Epistle to Timothy	Pauline epistles, New Testament books
Second Epistle to Timothy	Pauline epistles, New Testament books
Frederick Soddy	1877 births, 1956 deaths, Alumni of the University of Oxford, British Nobel Prize winners, English chemists, English physicists, People from Eastbourne
Epistle to Titus	Pauline epistles, New Testament books
Epistle to Philemon	Pauline epistles, New Testament books
Epistle of James	General Epistles, New Testament books
First Epistle of Peter	New Testament books, General Epistles
Second Epistle of Peter	New Testament books, General Epistles
First Epistle of John	New Testament books, General Epistles
Second Epistle of John	New Testament books, General Epistles
Third Epistle of John	New Testament books, General Epistles
Epistle of Jude	New Testament books, General Epistles
General Epistles	General Epistles
Augustine Volcano	Islands of Alaska, Mountain ranges of Alaska, Volcanoes of the United States
Ace Frehley	1951 births, Living people, American rock guitarists, American songwriters, Musicians from New York City, American heavy metal musicians, Kiss
Sagwa, the Chinese Siamese Cat	Canadian animated television series, Children's television series, Fictional cats, 2001 television series debuts, 2002 television series endings
2009 Pacific hurricane season	Pacific hurricane seasons, 2009 in weather
The Bourne Identity (2002 movie)	2002 movies, American action movies, American spy movies, American thriller movies, English-language movies, Movies based on books, Universal Pictures movies
Antarctic	Antarctic region
Beringia	Geology, Arctic
1917–18 NHL season	1917 in ice hockey, 1918 in ice hockey, National Hockey League seasons, 1917 in North America, 1918
Defenceman	Ice hockey positions
2010 Atlantic hurricane season	Atlantic hurricane seasons, 2010 in weather
Pool (cue sports)	Cue sports
Jason Mraz	1977 births, Living people, American singer-songwriters, Singers from Virginia
Troup County, Georgia	Georgia (U.S. state) counties, 1826 establishments in Georgia (U.S. state)
Whitespace (computer science)	Writing
Carriage return	Control characters
Newline	Control characters
Ardashir I	Persian people, Middle East
Artabanus IV	History of Iran, 216 births, 224 deaths
Helen Mirren	1945 births, Living people, Academy Award winning actors, Actors from Essex, Actors from Middlesex, BAFTA Award winners, British atheists, Emmy Award winning actors, English movie actors, English stage actors, English television actors, English voice actors, Golden Globe Award winning actors, Screen Actors Guild Award winners
Makgeolli	Wine
Sadri language	Languages of Bangladesh
Rohingya language	Languages of Bangladesh
Friedrich Kurt Fiedler	1894 births, 1950 deaths, Designers, German painters, Politicians from Saxony, Politicians of the Social Democratic Party of Germany
Cryosphere	Earth
Jute	Fibers
Bryan Hopkin	1914 births, 2009 deaths, Economists, Welsh people, Civil servants
Denis Healey	1917 births, 2015 deaths, Alumni of the University of Oxford, British military personnel of World War II, Chancellors of the Exchequer, Companions of Honour, Disease-related deaths in Sussex, Former Labour MPs (UK), Former members of the British House of Commons for English constituencies, Majors, Members of the Order of the British Empire, Politicians from Kent, People from West Yorkshire, Politicians from Yorkshire, Privy Councillors (UK), Royal Society of Literature, United Kingdom Life Peers, UK MPs 1951–1955, UK MPs 1955–1959, UK MPs 1959–1964, UK MPs 1964–1966, UK MPs 1966–1970, UK MPs 1970–1974, UK MPs 1974, UK MPs 1974–1979, UK MPs 1979–1983, UK MPs 1983–1987, UK MPs 1987–1992
Plessy v. Ferguson	United States law, United States Supreme Court cases, American civil rights, 19th century in Louisiana, Human rights abuses
Robbinsville Township, New Jersey	Townships in New Jersey
Mercer County, New Jersey	New Jersey counties, 1838 establishments in the United States, 19th-century establishments in New Jersey
Cyrillic numerals	Cyrillic script, Numerals
Gochujang	Korean food
Silliman University	Colleges and universities in the Philippines
Yut	Board games
Sujebi	Korean food, Soups
Kim Gu	1876 births, 1949 deaths, Anti-Communists, Korean educators, Terrorists, South Korean politicians, Murder victims, Autobiographers
Southern California	Geography of California
Chocolate brownie	Cakes
Military strategy	Military
Civilization IV	Civilization series, 2005 video games
Trenton-Robbinsville Airport	Airports in the United States, Buildings and structures in New Jersey, Transport in New Jersey
Jhalawan	Former subdivisions of Pakistan
Sarawan County	Former subdivisions of Pakistan
Swat (princely state)	Former subdivisions of Pakistan, Pakistani princely states
Marri-Bugti County	Former subdivisions of Pakistan
Shirley Jackson	1916 births, 1965 deaths, Writers from San Francisco, Writers from Vermont
Book Off	Books, Companies of Japan, 1990 establishments in Asia, 1990s establishments in Japan
Françoise Hardy	1944 births, Living people, French singers, French songwriters
Baekje	History of Korea, Former monarchies of Asia, Former countries in Asia, 18 BC establishments, 660 disestablishments, 7th century disestablishments in Asia
App Store (iOS)	Apple software
Monsters vs. Aliens	2009 science fiction movies, 2009 animated movies, 2009 3D movies, American animated movies, American science fiction movies, English-language movies, Saturn Award winning movies, Movies about giants, Movies set in California
Saturday Night's Main Event	World Wrestling Entertainment television programs, 1985 American television series debuts, 1992 television series endings, 1992 disestablishments in the United States
Generator (Bad Religion album)	1992 albums, Bad Religion albums, Punk albums
Niklas Hjalmarsson	1987 births, Arizona Coyotes players, Chicago Blackhawks players, Living people, Swedish ice hockey players, Stanley Cup champions, American Hockey League players, Swedish Hockey League players, Ice hockey defencemen
Dustin Byfuglien	1985 births, American Hockey League players, American ice hockey players, Atlanta Thrashers players, Brandon Wheat Kings players, Chicago Blackhawks players, Winnipeg Jets players, Living people, Sportspeople from Minneapolis, Minnesota, Prince George Cougars players, Sportspeople from Minnesota, Stanley Cup champions, Ice hockey defencemen
Ash (band)	British rock bands, Irish rock bands, Pop punk bands
Tomáš Kopecký	1982 births, American Hockey League players, Chicago Blackhawks players, Detroit Red Wings players, Lethbridge Hurricanes players, Living people, Slovak ice hockey players, Stanley Cup champions, Ice hockey centres
Trans woman	Transgender
Pat Sajak	1946 births, Living people, American television presenters, Television personalities from Chicago, American television talk show hosts, American bloggers
Magnum Crimen	Croatia, History, 1948 books
Salcea	Towns in Suceava County
Agra	Agra district, Cities and towns in Uttar Pradesh
Kim Seong-Su	1881 births, 1955 deaths, Anti-Communists, Korean educators, South Korean journalists, Vice Presidents of South Korea
Nuneaton	Towns in Warwickshire
Sarrasani	Entertainment in Germany
War language	Languages of Bangladesh, Languages of India
Supernova (South Korean band)	South Korean boy bands, J-pop bands, K-pop music groups, 2007 establishments in South Korea
Temple of Castor and Pollux	Ancient Rome, Ancient Greek and Roman temples and shrines
Sonic the Hedgehog 3	Sonic the Hedgehog games, 1994 video games, Platform games, Sega Genesis games, Video games developed in Japan, Video game sequels
Sheila Mello	1978 births, Living people, Brazilian actors, Brazilian models
Seattle Sounders FC	2000s establishments in Washington (state), 2007 establishments in the United States, American soccer teams, Sports in Seattle, Washington
Florence Ballard	1943 births, 1976 deaths, Deaths from coronary thrombosis, African American musicians, American R&B musicians, Cardiovascular disease deaths in the United States, Singers from Detroit, Michigan
Amanda Knox	1987 births, Living people, American criminals, People acquitted of murder, Writers from Seattle, Washington
Habilitation	Education
Solca	Towns in Suceava County
Bay of Campeche	Bays, Bodies of water of North America, Geography of Mexico, Campeche, Veracruz
Hi! Seoul Festival	Seoul, Festivals in Asia, 2003 establishments in South Korea
Mandu (dumpling)	Korean food
James Mason	1909 births, 1984 deaths, Actors from Yorkshire, British screenwriters, Cardiovascular disease deaths in Switzerland, Deaths from myocardial infarction, English movie actors, English movie producers, English stage actors, English television actors, Golden Globe Award winners, People from Huddersfield, Writers from Yorkshire
Eternal Sunshine of the Spotless Mind	2004 romance movies, 2004 drama movies, 2000s romantic drama movies, American romantic drama movies, English-language movies, Movies set in New York, American independent movies, Movies directed by Michel Gondry
Cecilia (novel)	English novels, English-language novels, 1782 books
Go-Stop	Card games, Korean culture
Edward Scissorhands	1990 drama movies, 1990 romance movies, 1990s fantasy movies, 1990s romantic drama movies, American fantasy movies, American romantic drama movies, English-language movies, Movies about suburbia, Saturn Award winners, 20th Century Fox movies
Lippstadt	Cities in North Rhine-Westphalia, Soest Rural District
Tteok	Korean food, Rice dishes
Pansori	Korean culture, 1913 establishments in Asia, 20th century establishments in South Korea
Lord of War	2005 movies, American crime thriller movies, English-language movies, Lionsgate movies
Westphalia	Geography of North Rhine-Westphalia, Regions of Germany
Empress Myeongseong	1851 births, 1895 deaths, Emperors and empresses
Callosamia promethea	Saturniidae
F.C. Barcelona	Spanish football clubs, Barcelona, Camp Nou, 1899 establishments in Europe, 1890s establishments in Spain
Negros Oriental	Provinces of the Philippines
Valencia, Negros Oriental	Settlements in the Philippines
Silla	History of Korea, 50s BC establishments, 930s disestablishments in Asia, 935 disestablishments
Ahn Cheol-soo	1962 births, Living people, People from Busan, South Korean businesspeople, Physicians, Computer scientists
Just-World phenomenon	Ethics, Logical fallacies
Chan Ho Park	1973 births, Living people, South Korean baseball players, Los Angeles Dodgers players, Texas Rangers players, San Diego Padres players, New York Mets players, Philadelphia Phillies players, New York Yankees players, Pittsburgh Pirates players, National League All-Stars
Metro Cammell	Defunct companies of the United Kingdom, Rail vehicles manufacturers, Birmingham, 1989 disestablishments in Europe, 1980s disestablishments in the United Kingdom
Ewha Girls' High School	Education in South Korea, Schools
André Segatti	Brazilian actors, Living people, 1972 births
London Underground rolling stock	London Underground electric multiple units, Locomotives, British railway-related lists, United Kingdom rolling stock
Giorgi Latsabidze	1978 births, Living people, Pianists, Composers, People from Tbilisi
Divergent boundary	Geology
Trevor Linden	1970 births, Canadian ice hockey centres, Ice hockey people from Alberta, Living people, Medicine Hat Tigers players, Montreal Canadiens players, New York Islanders players, Vancouver Canucks players, Washington Capitals players, Memorial Cup winners
Vincent Price	1911 births, 1993 deaths, Actors from St. Louis, Missouri, American movie actors, American stage actors, American television actors, American voice actors, Deaths from lung cancer, Yale University alumni
Framingham, Massachusetts	Cities in Massachusetts, 1700 establishments, 18th-century establishments in Massachusetts, 1700s establishments in the Thirteen Colonies
Resonance	Physics, Mechanical vibrations, Earthquake engineering
Satin bowerbird	Birds of Australia, Passeriformes
Kokborok language	Languages of Bangladesh, Languages of India, Tripura
Koch language	Languages of Bangladesh, Languages of India
Pope Gregory XIII	1502 births, 1585 deaths, Italian popes
George Augustine Taylor	1872 births, 1928 deaths, Artists from New South Wales, Aviators, Inventors, People from Sydney, Australian journalists
Carmichael number	Number theory
Richard Burton	1925 births, 1984 deaths, Alumni of the University of Oxford, British movie actors, British movie directors, British movie producers, British stage actors, British television actors, Cardiovascular disease deaths in Switzerland, Deaths from cerebral hemorrhage, Welsh actors, Commanders of the Order of the British Empire
Maple Ridge, British Columbia	Settlements in British Columbia
C.A. Belgrano	Argentine football clubs, Córdoba, Argentina, 1905 establishments in Argentina
Michael Clarke Duncan	Actors from Chicago, African-American movie actors, African-American television actors, African-American voice actors, Cardiovascular disease deaths in the United States, Deaths from myocardial infarction, Saturn Award winners, 1957 births, 2012 deaths
Children's Hearing	Children, Scotland
Papilioninae	Papilioninae
Carmit Bachar	Singers from Los Angeles, California, Pussycat Dolls, 1974 births, Living people
Lock (water transport)	Waterways, Gates
Ahl-e Haqq	Religions, Kurdistan
Trench foot	Diseases
Kutless	American rock bands, American hard rock bands, Grunge bands, Christian rock bands, Musical groups from Oregon, Musical groups established in 2000, 2000 establishments in the United States, 21st-century establishments in Oregon
Leah Remini	1970 births, Living people, American movie actors, American television actors, American voice actors, Actors from New York City
Bobby Allison	1937 births, Living people, American racecar drivers, Daytona 500 winners
Big Joe Turner	1911 births, 1985 deaths, American blues singers, Singers from Kansas City, Missouri, American R&B singers
James Dean	Actors from Indiana, American movie actors, American television actors, Bisexual people, LGBT actors, LGBT people from Indiana, Road accident deaths in California, 1931 births, 1955 deaths
Greg Biffle	1969 births, Living people, NASCAR drivers, American racecar drivers, Sportspeople from Washington
List of Mario series characters	Mario series characters, Lists of fictional characters
Anna Moffo	1932 births, 2006 deaths, Sopranos, Italian opera singers
Entrepreneur	Business
QBasic	Programming languages
Scratch (programming language)	Programming languages
Ponytail	Hairstyles
Volkswagen Passat	Front wheel drive vehicles, 1970s automobiles, 1980s automobiles, 1990s automobiles, 2000s automobiles, 2010s automobiles
Volkswagen Golf Variant	Volkswagen Golf, 1990s automobiles, 2000s automobiles, 2010s automobiles
Northanger Abbey	1810s books, Books by Jane Austen, English novels
Lexeme	Language
Phoneme	Language
History of the alphabet	Alphabet
Jerzy Buzek	1940 births, Living people, MEPs for Poland, Presidents of the European Parliament, Prime Ministers of Poland, Polish scientists
Honorary degree	Academic degrees
President of the European Parliament	Presidents of the European Parliament, European Union
Luigi Cherubini	1760 births, 1842 deaths, Classical era composers, Italian composers, Burials at Père Lachaise Cemetery
Mario Andretti	1940 births, Living people, American racecar drivers, Formula One drivers, IndyCar Series drivers
Maria Edgeworth	1767 births, 1849 deaths, English writers, English novelists
Ubuntu Studio	Software
Faisal Alam	1977 births, Living people, American LGBT people, Gay men, LGBT rights activists, Pakistani Muslims, People from Connecticut
Rick Rypien	1984 births, 2011 deaths, American Hockey League players, Canadian ice hockey centres, Ice hockey people from Alberta, Regina Pats players, Sportspeople who committed suicide, Suicides in Canada, Vancouver Canucks players
Centre (ice hockey)	Ice hockey positions
Glenda Jackson	1936 births, Living people, Academy Award winning actors, Actors from Cheshire, Drama Desk Award winners, Emmy Award winning actors, English movie actors, English politicians, English stage actors, English television actors, Former members of the British House of Commons for English constituencies, Golden Globe Award winning actors, London Borough of Camden, People from Birkenhead, Tony Award winning actors
ZTE	Companies of China, Technology companies of Asia, 1980s establishments in China
SuperCollider	Programming languages
Ryan Newman (racing driver)	NASCAR drivers, 1977 births, Daytona 500 winners, American racecar drivers, Sportspeople from Indiana, People from South Bend, Indiana, Living people
Cuboid	Polyhedra
Lucas Oil Stadium	National Football League venues, Sports buildings in the United States, Indianapolis, Indiana, Buildings and structures in Indiana, 2008 establishments in the United States, 21st-century establishments in Indiana
Lakas–CMD	Politics of the Philippines, Political parties in Asia
Sgt. Frog	Manga
I Vow to Thee, My Country	1920s songs, 20th-century British poems, 1921 works
List of Toronto subway and RT stations	Toronto Transit Commission, Rail transport lists, Rail transport in Canada
The Perfect Fool	1920s operas, 1923 works
Comet Hale–Bopp	Comets, 1997
Tech N9ne	1971 births, Living people, African American musicians, American rap musicians from Missouri, Musicians from Kansas City, Missouri, Singers from Kansas City, Missouri
Alex Wojciechowicz	1915 births, 1992 deaths, American football centers, Detroit Lions players, Philadelphia Eagles players, Sportspeople from New Jersey
Temerin	Settlements in Serbia
Philotheus Boehner	1901 births, 1955 deaths, Franciscans, German Roman Catholics
Selena Gomez	1992 births, Living people, Singers from Texas, Disney actors, American child actors, American movie actors, American television actors, American singers, American songwriters, American dancers, American musicians
Nudibranch	Gastropods
Sea slug	Gastropods
Anatole France	1844 births, 1924 deaths, French critics, French Nobel Prize winners, French novelists, French poets, Members of the Académie française, Pen names, Writers from Paris
Hurricane David	1979 Atlantic hurricane season, Category 5 Atlantic hurricanes, Deadly storms, 20th centuy in Haiti, 20th century in the Dominican Republic, 20th century in Puerto Rico, 1970s in Cuba, 20th century in the Bahamas, 1970s in Florida, 20th century in Georgia (U.S. state), 1979 in North America, Hurricanes in the Dominican Republic
Scaphopoda	Molluscs
Michael Polakovs	1923 births, 2009 deaths, Clowns, People from Riga
Coco the Clown	Clowns
Pipo de Clown	Clowns, Dutch television programmes
Coronel Fabriciano	Cities in Minas Gerais, Vale do Aço metropolitan area, 1948 establishments in South America, 1940s establishments in Brazil
Axillary bud	Plant tissues
Robert Lang	1970 births, Boston Bruins players, Chicago Blackhawks players, Czech ice hockey players, Czechoslovak ice hockey players, Detroit Red Wings players, Living people, Los Angeles Kings players, Montreal Canadiens players, Phoenix Coyotes players, Pittsburgh Penguins players, Washington Capitals players
Joel Quenneville	1958 births, American Hockey League players, Canadian ice hockey coaches, Canadian ice hockey defencemen, Chicago Blackhawks players, Colorado Rockies (NHL) players, Hartford Whalers players, Ice hockey people from Ontario, Jack Adams Award winners, Living people, New Jersey Devils players, Ontario Hockey League players, Stanley Cup champions, Toronto Maple Leafs players, Washington Capitals players
Three Cups of Tea	Autobiographies
Vladimir Teplyakov	Russian physicists, 1925 births, 2009 deaths, Recipients of the Order of Lenin
Donovan McNabb	Philadelphia Eagles players, Washington Redskins players, Minnesota Vikings players, American football quarterbacks, Sportspeople from Chicago, 1976 births, Living people
Fall to Pieces	Avril Lavigne songs, 2005 songs
Moritz Wagner	1813 births, 1887 deaths, Naturalists, German evolutionary biologists, Explorers
Africanized bee	Bees
Ipatinga	Cities in Minas Gerais, Vale do Aço metropolitan area, 1964 establishments in Brazil
Timóteo	Cities in Minas Gerais, Vale do Aço metropolitan area, 1964 establishments in Brazil
Mammal-like reptile	Paleontology, Taxonomy, Therapsids, Mammals
Cleidoic egg	Reptiles, Birds, Zoology, Developmental biology, Evolutionary biology, Biological reproduction
Terrapin	Turtles
Regions of Brazil	Regions of Brazil
Vale do Aço metropolitan area	Vale do Aço metropolitan area
Mantle (mollusc)	Molluscs
Carboniferous	Carboniferous
Mesozoic	Mesozoic
Palaeozoic	Palaeozoic
Blackjack	Card games
Phanerozoic	Phanerozoic
Skip-Bo	Card games
Ordovician	Palaeozoic
Silurian	Palaeozoic, Silurian
Devonian	Palaeozoic, Devonian
Proterozoic	Proterozoic
Cainozoic	Cainozoic
Bill Elliott	NASCAR drivers, American racecar drivers, 1955 births, Living people
Dolhasca	Towns in Suceava County
Siret	Towns in Suceava County
Default gateway	Networks, Computer networking
Token passing	Computing
Carrier sense multiple access	Communication
Archaean	Archaean
Barcelona Metro line 1	Barcelona Metro lines
Hadean	Hadean
Permian	Palaeozoic
Circus	Circuses
Markham, Ontario	Towns in Ontario
Matt Stajan	1983 births, Calgary Flames players, Canadian ice hockey centres, Ice hockey people from Ontario, Living people, Toronto Maple Leafs players, American Hockey League players, Ontario Hockey League players
Cajvana	Towns in Suceava County
Mount Athos	Mountains of Greece
Barcelona Metro line 9	Barcelona Metro lines
Barcelona Metro line 10	Barcelona Metro lines
Barcelona Metro line 2	Barcelona Metro lines
Sam Cooke	African American musicians, American guitarists, American singer-songwriters, American soul musicians, American R&B singers, American gospel musicians, American pop musicians, American soul singers, American pop singers, Musicians from Mississippi, 1931 births, 1964 deaths, American gospel singers
Catherine Morland	Characters in written fiction
Child abuse	Child abuse
Revised Julian calendar	Eastern Orthodox Church, Calendars
Hakha-Chin language	Languages of Bangladesh
Rajbanshi language	Languages of Bangladesh
Teen idol	Celebrities, Fandom
Hachinohe, Aomori	Cities in Japan, Settlements in Aomori Prefecture
Gerbstedt	Towns in Saxony-Anhalt
Miles Davis	1926 births, 1991 deaths, African American musicians, American composers, American jazz musicians, Autobiographers, Bandleaders, Deaths from pneumonia, Jazz composers, Musicians from Illinois, Trumpeters, People from Alton, Illinois, People from East St. Louis, Illinois, Warner Bros. Records artists
Bandleader	Bandleaders, Entertainment occupations
Neglect	Society
Josef Mysliveček	1737 births, 1781 deaths, Classical era composers, Czech composers
Ainaži	Towns in Latvia, 1926 establishments in Latvia
Aizkraukle	Towns in Latvia, 1967 establishments in Europe, 20th century establishments in Latvia
Aizpute	Towns in Latvia, 1370s establishments in Europe, 14th century establishments in Latvia, 1378 establishments
Aknīste	Towns in Latvia, 1991 establishments in Latvia
Aloja, Latvia	Towns in Latvia, 1992 establishments in Latvia
Alūksne	Towns in Latvia, 1920 establishments in Europe, 1920s establishments in Latvia
Ape, Latvia	Towns in Latvia, 1928 establishments in Latvia
Auce	Towns in Latvia, 1924 establishments in Europe, 1920s establishments in Latvia
Baldone	Towns in Latvia, 1991 establishments in Latvia
Baloži	Towns in Latvia, 1991 establishments in Latvia
Balvi	Towns in Latvia, 1928 establishments in Latvia
Bauska	Towns in Latvia, 1600s establishments in Europe, 17th century establishments in Latvia, 1609 establishments
Broceni	Towns in Latvia, 1992 establishments in Latvia
Cēsis	Towns in Latvia, 1206 establishments in Europe, Establishments in Latvia
Cesvaine	Towns in Latvia, 1991 establishments in Latvia
Dagda, Latvia	Towns in Latvia, 1992 establishments in Latvia
Dobele	Towns in Latvia, 1917 establishments in Latvia
Durbe	Towns in Latvia, 1893 establishments in Europe, Establishments in Latvia
Grobiņa	Towns in Latvia, 1695 establishments, 17th century establishments in Latvia, 1690s establishments in Europe
Gulbene	Towns in Latvia, 1928 establishments in Latvia
Ikšķile	Towns in Latvia, 1992 establishments in Latvia
Ilūkste	Towns in Latvia, 1917 establishments in Latvia
Jaunjelgava	Towns in Latvia, 1647 establishments in Europe, 17th century establishments in Latvia
Jēkabpils	Towns in Latvia, 1670 establishments, 17th century establishments in Latvia, 1670s establishments in Europe
Kalnciems	Towns in Latvia, 1991 establishments in Latvia
Kandava	Towns in Latvia, 1917 establishments in Latvia
Kārsava	Towns in Latvia, 1928 establishments in Latvia
Krāslava	Towns in Latvia, 1923 establishments in Europe, 1920s establishments in Latvia
Kuldīga	Kuldīga, Towns in Latvia, 1370s establishments in Europe, 14th century establishments in Latvia, 1378 establishments
Paul-Henri Thiry, Baron d'Holbach	1723 births, 1789 deaths, Philosophers
Ķegums	Towns in Latvia, 1993 establishments in Latvia
Lielvārde	Towns in Latvia, 1992 establishments in Latvia
Līgatne	Towns in Latvia, 1993 establishments in Latvia
Limbaži	Towns in Latvia, 1385 establishments, 14th century establishments in Latvia
Līvāni	Towns in Latvia, 1926 establishments in Latvia
Lubāna	Towns in Latvia, 1992 establishments in Latvia
Ludza	Towns in Latvia, 1777 establishments, Establishments in Latvia, 1770s establishments in Europe
Madona	Towns in Latvia, 1926 establishments in Latvia
Mazsalaca	Towns in Latvia, 1928 establishments in Latvia
Ogre, Latvia	Towns in Latvia, 1929 establishments in Europe, 1920s establishments in Latvia
Olaine	Towns in Latvia, 1967 establishments in Europe, 20th century establishments in Latvia
Pāvilosta	Towns in Latvia, 1991 establishments in Latvia
Piltene	Towns in Latvia, 1550s establishments in Europe, Establishments in Latvia, 1557 establishments
Pļaviņas	Towns in Latvia, 1927 establishments in Europe, 1920s establishments in Latvia
Preiļi	Towns in Latvia, 1928 establishments in Latvia
Priekule, Latvia	Towns in Latvia, 1928 establishments in Latvia
Rūjiena	Towns in Latvia, 1920 establishments in Europe, 1920s establishments in Latvia
Sabile	Towns in Latvia, 1917 establishments in Latvia
Salacgrīva	Towns in Latvia, 1928 establishments in Latvia
Salaspils	Towns in Latvia, 1993 establishments in Latvia
Saldus	Towns in Latvia, 1917 establishments in Latvia
Saulkrasti	Towns in Latvia, 1991 establishments in Latvia
Seda, Latvia	Towns in Latvia, 1991 establishments in Latvia
Sigulda	Towns in Latvia, 1928 establishments in Latvia
Skrunda	Towns in Latvia, 1996 establishments in Europe, 1990s establishments in Latvia
Smiltene	Towns in Latvia, 1920 establishments in Europe, 1920s establishments in Latvia
Staicele	Towns in Latvia, 1992 establishments in Latvia
Stende	Towns in Latvia, 1991 establishments in Latvia
Strenči	Towns in Latvia, 1928 establishments in Latvia
Subate	Towns in Latvia, 1917 establishments in Latvia
Talsi	Towns in Latvia, 1917 establishments in Latvia
Tukums	Towns in Latvia, 1795 establishments, Establishments in Latvia, 1790s establishments in Europe
Valdemārpils	Towns in Latvia, 1917 establishments in Latvia
Valka	Towns in Latvia, 1584 establishments, Establishments in Latvia, 1580s establishments in Europe
Valmiera	Towns in Latvia, 1323 establishments, 14th century establishments in Latvia, 1320s establishments in Europe
Vangaži	Towns in Latvia, 1991 establishments in Latvia
Varakļāni	Towns in Latvia, 1928 establishments in Latvia
Viesīte	Towns in Latvia
Viļaka	Towns in Latvia
Viļāni	Towns in Latvia
Zilupe	Towns in Latvia
Frederick Sanger	1918 births, 2013 deaths, British Nobel Prize winners, Commanders of the Order of the British Empire, Companions of Honour, English biochemists, Fellows of the Royal Society, English molecular biologists, Order of Merit, People from Gloucestershire
List of settlements in Latvia	Settlements in Latvia, Lists of settlements in Europe
Mats Sundin	1971 births, Hockey Hall of Fame inductees, Living people, Olympic gold medalists, Sportspeople from Stockholm, Quebec Nordiques players, Swedish ice hockey players, Toronto Maple Leafs players, Vancouver Canucks players, Swedish Hockey League players, Ice hockey centres
Khorasan Province	Provinces of Iran, 2014 disestablishments
Geoffrey Prior	1896 births, 1972 deaths, People of British India
Ambrose Dundas Flux Dundas	1899 births, 1973 deaths, People of British India, Isle of Man, Knights Commander of the Order of the Indian Empire, Order of the Star of India
Frederick Chalmers Bourne	1891 births, 1977 deaths, People of British India, Order of the Star of India, People from Kent
Francis Mudie	1890 births, 1976 deaths, People of British India, Governors of Bihar
George Cunningham (governor)	1888 births, 1964 deaths, People of British India
1899 Atlantic hurricane season	1899, Atlantic hurricane seasons
1890 Atlantic hurricane season	1890, Atlantic hurricane seasons
Paul Cézanne	1839 births, 1906 deaths, Aix-en-Provence, Deaths from pneumonia, French painters, Infectious disease deaths in France
Alice DeeJay	1990s Dutch music groups, 2000s Dutch music groups, Electronic music bands, Musical groups established in 1999, 1999 establishments in Europe, 1990s establishments in the Netherlands, Musical groups disestablished in 2002, 2002 disestablishments in Europe, Amsterdam
Myriapoda	Myriapods
Transcutaneous electrical nerve stimulation	Medical procedures
Fenwick Island, Delaware	Towns in Delaware
General American	Language
Thomas Linley the younger	1756 births, 1778 deaths, English composers, British violinists
Kaiane Aldorino	1986 births, Living people, British models, Gibraltar, Miss World winners
Thomas Linley the elder	1733 births, 1795 deaths, English composers, Musicians from Gloucestershire
Hypothetical imperative	Philosophy
William Boyce	1711 births, 1779 deaths, Baroque composers, Classical era composers, English composers
The Starry Night	1880s paintings, Dutch paintings, Paintings by Vincent van Gogh
Money Talks	1997 movies, American comedy movies, American action movies, English-language movies
Kalgan River	Rivers of Western Australia
Gas mask	Protective clothing, Headgear
George Whipple	1878 births, 1976 deaths, American academics, American Nobel Prize winners, American physicians, Scientists from New Hampshire, Yale University alumni
Milişăuţi	Towns in Suceava County
Fălticeni	Municipalities of Romania, Cities in Romania
Vicovu de Sus	Towns in Suceava County
George Minot	1885 births, 1950 deaths, American physicians, American Nobel Prize winners, Scientists from Boston, Massachusetts
Tertiary	Cainozoic
Quaternary	Cainozoic
ICal	Apple software, MacOS
Palaeogene	Cainozoic
Neogene	Cainozoic, Miocene
Palaeocene	Cainozoic
Byron Moreno	1969 births, Living people, People from Quito, Ecuadorian footballers
Eocene	Eocene, Cainozoic
Islam in Pakistan	Islam by country, Religion in Pakistan
Kashmir Smast	Kashmir
Lower Cretaceous	Cretaceous
Trio sonata	Musical forms
K/T extinction event	Geology, Dinosaurs, Meteorites, Extinction events, Mesozoic
John Rutter	1945 births, Living people, 20th century composers, 21st century composers, English composers
Danny Bonaduce	1959 births, Living people, Actors from Pennsylvania, Comedians from Pennsylvania, American radio personalities, American television personalities, American movie actors, American television actors, American radio actors, American child actors
Permian–Triassic extinction event	Geology, Meteorites, Extinction events
Camille Pissarro	French painters, 1830 births, 1903 deaths
Snowball Earth	Earth sciences, Climate, Proterozoic, Climate change
Rivallo	History of the United Kingdom
Pat Fenlon	1969 births, Living people, Irish footballers, Irish football managers, Sportspeople from Dublin
Victoria Wood	1953 births, 2016 deaths, Actors from Lancashire, British stand-up comedians, Cancer deaths in London, Comedians from Lancashire, English television actors, English television presenters, English television producers, English television writers, Television personalities from Lancashire, Writers from Lancashire
Niccolò Piccinni	1728 births, 1800 deaths, Italian composers, Classical era composers, People from Bari
William P. Murphy	1892 births, 1987 deaths, American physicians, American Nobel Prize winners, Scientists from Wisconsin
Silent Night	19th century songs, Christmas music
Indonesian Rupiah	Currency of Asia, 20th century establishments in Indonesia, 1946 establishments in Asia
Horseshoes	Games
Hans Spemann	1869 births, 1941 deaths, German doctors, German Nobel Prize winners
Henry Hallett Dale	1875 births, 1968 deaths, English chemists, Pharmacologists, Order of Merit, Knights and Dames Grand Cross of the Order of the British Empire, Fellows of the Royal Society, Presidents of the Royal Society, British Nobel Prize winners
Paul Dukas	1865 births, 1935 deaths, French composers, Burials at Père Lachaise Cemetery
List of extinction events	Extinction events, Science-related lists
Blaise Compaoré	People from Ouagadougou, Presidents of Burkina Faso, 1951 births, Living people
Mossi	Burkina Faso, Ethnic groups in Africa
Cassiopeia (constellation)	Constellations, Constellations listed by Ptolemy
Vikash Dhorasoo	1973 births, Living people, French footballers
Park Kun-Ha	1971 births, Living people, South Korean footballers, South Korean football managers
Willy Sagnol	1977 births, Living people, French footballers
Jathera	Religious buildings, Punjab, India
Ediacaran	Ediacaran
Ediacaran biota	Invertebrates, Lagerstätten, Ediacaran
Antonio de Trueba	1821 births, 1889 deaths, Spanish writers
Arrangement (music)	Musical terminology
Fernando Botero	1932 births, Living people, Colombian people, Painters, Sculptors
Abelian group	Algebra
Homing pigeon	Domesticated animals
Roberto de Assis Moreira	1971 births, Living people, Brazilian footballers, People from Porto Alegre
Rafael Scheidt	1976 births, Living people, Brazilian footballers, People from Porto Alegre
Alex Sandro Santana de Oliveira	1973 births, Living people, Brazilian footballers, People from Salvador, Bahia
David Soria Yoshinari	1977 births, Living people, Peruvian footballers, People from Lima
Mikaël Silvestre	1977 births, Living people, French footballers
Éric Abidal	1979 births, Living people, 2006 FIFA World Cup players, 2010 FIFA World Cup players, French footballers, Sportspeople from Lyon
Pavel Badea	1967 births, Living people, Romanian footballers, Romanian football managers
Julio Hernán Rossi	1977 births, Living people, Argentine footballers, Sportspeople from Buenos Aires
Regis Pitbull	1976 births, Living people, Brazilian footballers
Otto Loewi	1873 births, 1961 deaths, Austrian scientists, German doctors, Neuroscientists
Heinrich Lübke	1894 births, 1972 deaths, Order of Merit of the Federal Republic of Germany, Politicians from North Rhine-Westphalia, Presidents of Germany
Elisha Levy	1957 births, Living people, Israeli football managers, Israeli footballers, Jewish Israeli sportspeople, People from Jerusalem
List of WWE Raw guest hosts	WWE Raw, Sports lists
Transcription (music)	Musical notation
VY Canis Majoris	Red giants, Variable stars, Hypergiants
Royal Swedish Academy of Sciences	18th century establishments in Sweden, 1730s establishments in Europe, 1739 establishments, Sweden, Nobel Prize
Karolinska Institutet	Colleges and universities in Sweden, Nobel Prize, Stockholm
Florent Malouda	1979 births, Living people, French footballers
Wim Jonk	1966 births, Living people, Dutch footballers, Sportspeople from North Holland
Ramon Menezes Hubner	1972 births, Living people, Brazilian footballers
Reinhard Stumpf	1961 births, Living people, German footballers, Sportspeople from Hesse
Fumagalli	1977 births, Living people, Brazilian footballers
Osmar Donizete Cândido	1968 births, Living people, Brazilian footballers
Jan Veenhof	1969 births, Living people, Dutch footballers, People from Leeuwarden, Sportspeople from Friesland
Leonard Henriques da Silva	1982 births, Living people, Brazilian footballers
List of Scottish football stadiums by capacity	Football stadiums in Scotland, Sports lists
Swedish Academy	Language regulators, Nobel Prize, Stockholm, 1786 establishments in Europe, 18th century establishments in Sweden
Norwegian Nobel Committee	Norwegian Nobel Committee
Andaz Apna Apna	Indian movies, 1994 movies, Salman Khan
Karisma Kapoor	1974 births, Living people, Indian actors, People from Mumbai
Parides erithalion	Parides
Ava Gardner	Actors from North Carolina, American movie actors, American television actors, Deaths from pneumonia, Infectious disease deaths in England, 1922 births, 1990 deaths
Oswaldo Sánchez	1973 births, Living people, Mexican footballers, Association football goalkeepers
Costinha	1974 births, Living people, Portuguese footballers, Sportspeople from Lisbon
Shigeru Morioka	1973 births, Living people, Footballers from Ehime Prefecture, J1 League players, Gamba Osaka players, Kyoto Sanga FC players, Vissel Kobe players, Footballers at the 1996 Summer Olympics
Yoann Gourcuff	1986 births, Living people, French footballers
Daniel Sanabria	1977 births, Living people, Paraguayan footballers, People from Asunción
Gláucio de Jesus Carvalho	1975 births, Living people, Brazilian footballers
Ali Boumnijel	1966 births, Living people, Tunisian footballers, Association football goalkeepers, People from Tunis
Takafumi Yoshimoto	1978 births, Living people, Footballers from Kōchi Prefecture
Daishi Hiramatsu	1983 births, Living people, Footballers from Tochigi Prefecture
Oligocene	Cainozoic
Sidney Poitier	1927 births, Living people, Academy Award winning actors, Actors from Miami, Florida, African American actors, Ambassadors to Japan, American autobiographers, American diplomats, American movie actors, American movie directors, American screenwriters, American television actors, BAFTA Award winning actors, Bahamian politicians, Golden Globe Award winning actors, Grammy Award winners, Kennedy Center honorees, Military people from Florida, Politicians from Florida, Presidential Medal of Freedom recipients, Screen Actors Guild Award winners, Writers from Florida, Honorary Knights Grand Cross of the Order of the British Empire
Pliocene	Cainozoic
Grazer	Ecology, Zoology
Fauna	Zoology, Ecology, Reference works
Butterscotch	Candy
Jiffy Lube	Companies based in Houston, American automobile companies, 1971 establishments in the United States
National Endowment for the Arts	United States government agencies, 1965 establishments in the United States
Art Blakey	1919 births, 1990 deaths, African American musicians, American bandleaders, American drummers, American jazz musicians, Cancer deaths in New York City, Deaths from lung cancer, Musicians from Pittsburgh, Pennsylvania
Jethro Tull (agriculturist)	1674 births, 1741 deaths, English scientists
Carrier sense multiple access with collision detection	Computer networking
Crash Test Dummy	Robots
Parides montezuma	Parides
Parides alopius	Parides
Innocence (Avril Lavigne song)	Avril Lavigne songs
Unwanted (Avril Lavigne song)	Avril Lavigne songs, 2004 songs
Angus Drive	Avril Lavigne albums, 2003 albums, Pop albums, Punk albums, Rock albums
Keisuke Mori	1980 births, Living people, Footballers from Saga Prefecture
Silva Jose Reinaldo Fernandes	1967 births, Living people, Brazilian footballers
Thomas Bickel	1963 births, Living people, Swiss footballers
Chris Birchall	1984 births, Living people, Trinidad and Tobago footballers
Sami Al-Jaber	1972 births, Living people, Saudi Arabian footballers, People from Riyadh
Tobias Linderoth	1979 births, Living people, Swedish footballers
Marcus Allbäck	1973 births, Living people, Swedish footballers, People from Gothenburg
Markus Rosenberg	1982 births, Living people, Swedish footballers, People from Malmo
Marcelo Miguel Pelissari	1975 births, Living people, Brazilian footballers
Richard Dutruel	1972 births, Living people, French footballers, Association football goalkeepers
Masahiko Nakagawa	1969 births, Living people, Footballers from Osaka Prefecture, Japanese association football goalkeepers, People from Osaka
Masao Kiba	1974 births, Living people, Footballers from Hyōgo Prefecture
Foraminifera	Fossils, Protista
Take Me Away (Avril Lavigne song)	Avril Lavigne songs, 2004 songs
Strata	Geology, Earth sciences
Live Acoustic (Avril Lavigne EP)	Avril Lavigne songs
Sarah Vaughan	1924 births, 1990 deaths, American jazz singers, Singers from New Jersey
Gish	1991 albums, Debut albums, Rock albums
Maureen Tucker	1944 births, American drummers, American rock musicians, Musicians from New York, Living people
Avatar (2009 movie)	2009 movies, 2009 science fiction movies, 2009 3D movies, 2000s adventure movies, Academy Award winning movies, American adventure movies, American science fiction movies, English-language movies, Golden Globe Award winning movies, Movies composed by James Horner, Movies directed by James Cameron, Movies set in the future, Movies set on fictional planets, Jungle movies, Movies that won the Best Visual Effects Academy Award, Saturn Award winning movies, 20th Century Fox movies
Paramecium	Ciliates
Kingston, Wisconsin	Villages in Wisconsin, Green Lake County, Wisconsin
Canonic Variations on "Vom Himmel hoch da komm' ich her"	Compositions by Johann Sebastian Bach, Christmas music, Solo organ pieces
Voice (polyphony)	Music theory
Elf	Christmas
Sterling Morrison	1942 births, 1995 deaths, American rock guitarists, Musicians from New York, American punk musicians
Vanilla Twilight	2009 songs
Feather Falls	Waterfalls, Landforms of California, Butte County, California
Feather Falls, California	Unincorporated communities in California, Settlements in Butte County, California
Salween River	Rivers of China, Rivers of Myanmar, Rivers of Thailand
Tal Ben Haim	1982 births, Living people, Israeli footballers, Jewish Israeli sportspeople, Rishon LeZion
Hugo Viana	1983 births, Living people, Portuguese footballers
Bruno Vale	1983 births, Living people, Portuguese footballers, Association football goalkeepers
Fábio Santos Romeu	1985 births, Living people, Brazilian footballers
Haminu Draman	1986 births, Living people, Ghanaian footballers, People from Accra
Saša Drakulić	1972 births, Living people, Serbian footballers
Alen Avdić	1977 births, Living people, Bosnia and Herzegovina footballers, People from Sarajevo
Mickaël Landreau	1979 births, Living people, French footballers, Association football goalkeepers
Oleg Pashinin	1974 births, Living people, Uzbekistani people, Asian footballers
Škoda Fabia	Škoda automobiles, 1990s automobiles, 2000s automobiles, 2010s automobiles
Škoda Superb	Škoda automobiles, 2000s automobiles
Škoda Octavia	Škoda automobiles, 1990s automobiles, 2000s automobiles, 2010s automobiles
Volkswagen Vento	Volkswagen automobiles, 1990s automobiles
Akmal Shaikh	1956 births, 2009 deaths, British people convicted of drug offences, Drug dealers, Naturalised citizens of the United Kingdom, Pakistani Muslims, People executed by lethal injection
John Coltrane	1926 births, 1967 deaths, African American musicians, American bandleaders, American jazz musicians, American saxophonists, Cancer deaths in New York, Deaths from liver cancer, Musicians from North Carolina
Fela Kuti	1938 births, 1997 deaths, Deaths from AIDS, Disease-related deaths in Nigeria, Drummers, Guitarists, Deaths from sarcoma, Nigerian singers, Saxophonists, Nigerian musicians, Trumpeters
Requiem for a Dream	2000 drama movies, 2000s psychological movies, American drama movies, American psychological movies, English-language movies, Movies about drugs, Movies about dysfunctional families, Movies directed by Darren Aronofsky, Movies set in Brooklyn, Movies set in New York City, American independent movies
Home Alone 3	1997 comedy movies, 1997 crime movies, 1990s criminal comedy movies, American criminal comedy movies, American family movies, American sequel movies, English-language movies, Movies directed by Raja Gosnell, Movies produced by John Hughes, Movies set in Chicago, Illinois, Screenplays by John Hughes, 20th Century Fox movies
Stripes (movie)	1980s buddy movies, 1981 comedy movies, 1980s war movies, American buddy movies, American comedy movies, American war movies, Buddy comedy movies, English-language movies, Louisville, Kentucky, Movies directed by Ivan Reitman, Movies set in Germany
Justin.tv	Websites, Companies based in Los Angeles
Harvey Milk	1930 births, 1978 deaths, American LGBT rights activists, American murder victims, Gay Jews, Jewish activists, Jewish American LGBT people, Jewish American politicians, LGBT people from California, LGBT politicians, Murders by firearm in the United States, Politicians from New York, Politicians from San Francisco, US Democratic Party politicians, Victims of anti-LGBT hate crimes
John Blow	Baroque composers, English composers, English organists, Musicians from Nottinghamshire, 1649 births, 1708 deaths
Diary	Diaries
Classical economics	Economic theories
Jeff Probst	1962 births, American movie directors, Living people, American television presenters, American television talk show hosts, American game show hosts, Businesspeople from Wichita, Kansas, Emmy Award winners
Survivor (American TV series)	Survivor (U.S. TV series), English-language television programs
Kris Allen	1985 births, Living people, Singers from Arkansas, American songwriters, American Idol winners
PGA Championship	Golf tournaments
Invisible ink	Writing tools
Pee-Wee's Big Adventure	1985 comedy movies, American comedy movies, English-language movies
Bad Kreuznach	Towns in Rhineland-Palatinate, Spa towns in Germany
Asamoah Gyan	1985 births, Living people, Ghanaian footballers, People from Accra
Dean Ashton	1983 births, Living people, English footballers, People from Swindon, Premier League players
Tadanari Lee	1985 births, Living people, Footballers from Tokyo Prefecture, Japan international footballers, J1 League players, J2 League players, FC Tokyo players, Kashiwa Reysol players, Sanfrecce Hiroshima players, Urawa Red Diamonds players, Yokohama F. Marinos players, Kyoto Sanga FC players, Footballers at the 2008 Summer Olympics
Takahiro Shimotaira	1971 births, Living people, Footballers from Aomori Prefecture
Sandro Cardoso dos Santos	1980 births, Living people, Brazilian footballers
Raymond Domenech	1952 births, French footballers, French football managers, Living people, Sportspeople from Lyon
Acritarch	Protista, Fossils
Issey Nakajima-Farran	1984 births, Canadian footballers, Living people, Sportspeople from Calgary
Toshimitsu Asai	1983 births, Living people, Footballers from Shizuoka Prefecture, Japanese association football goalkeepers
Sediment	Sedimentology
Barcelona Metro line 3	Barcelona Metro lines
Albert Szent-Györgyi	1893 births, 1986 deaths, Hungarian people, Pharmacologists, Hungarian Nobel Prize winners
Barcelona Metro line 4	Barcelona Metro lines
Barcelona Metro line 5	Barcelona Metro lines
Barcelona Metro line 6	Barcelona Metro lines
Coccolith	Protista, Algae
Haptophyte	Algae, Protista
Crush 40	American hard rock bands, American heavy metal bands, Japanese rock bands
Macedonia (Greece)	Subdivisions of Greece
Holocene	Cainozoic, Ancient history, Climate change
Benthos	Oceanography, Biomes
Cleidopus gloriamaris	Cleidopus gloriamaris, Ray-finned fish, Fish of Australia
Naousa	Cities in Greece
Polygyros	Cities in Greece
Broşteni, Suceava	Towns in Suceava County
Jack Benny	1894 births, 1974 deaths, Actors from Chicago, American movie actors, American radio actors, American stage actors, American television actors, American television producers, Cancer deaths in the United States, Comedians from Chicago, Deaths from pancreatic cancer, Television personalities from Chicago
Southam	Towns in Warwickshire
Rob Reiner	1947 births, Living people, Actors from the Bronx, People from New Rochelle, New York, American movie actors, American screenwriters, American television actors, American television producers, American television writers, American voice actors, Democrats (United States), Emmy Award winners, Jewish American actors, Movie directors from New York, Movie producers from New York, Writers from the Bronx, American bloggers
Vermont, Wisconsin	Towns in Wisconsin, Dane County, Wisconsin
Rastacap	Headgear
Amphicoelias	Sauropods
Corneille Heymans	1892 births, 1968 deaths, Belgian Nobel Prize winners, Belgian physicians, People from Ghent, Pharmacologists
Christina Applegate	1971 births, Living people, Actors from Hollywood, American movie actors, American stage actors, American television actors, American television producers, American voice actors, Breast cancer survivors, Emmy Award winners
Hayato Yano	1980 births, Living people, Footballers from Osaka Prefecture, People from Osaka
Osmar Aparecido de Azevedo	1980 births, Living people, Brazilian footballers
Kim Dong-Hyun	1984 births, Living people, South Korean footballers
Fábio José dos Santos	1973 births, Living people, Brazilian footballers
Erikson Noguchipinto	1981 births, Living people, Brazilian-Japanese footballers
Toshiaki Haji	1978 births, Living people, Footballers from Osaka Prefecture
Shinichi Muto	1973 births, Living people, Footballers from Miyagi Prefecture
Tatsuya Yazawa	1984 births, Living people, Footballers from Shizuoka Prefecture
Kenji Kikawada	1974 births, Living people, Footballers from Saitama Prefecture
Tomoaki Seino	1981 births, Living people, Footballers from Niigata Prefecture
Mitsunori Yabuta	1976 births, Living people, Footballers from Kanagawa Prefecture
Hiroshi Miyazawa	1970 births, Living people, Footballers from Kanagawa Prefecture
Kunihiko Takizawa	1978 births, Living people, Footballers from Tokyo Prefecture
Aleksandar Živković	1977 births, Living people, Serbian footballers
Barcelona Metro line 8	Barcelona Metro lines
Barcelona Metro line 7	Barcelona Metro lines
Nea Moudania	Cities in Greece
Whyte notation	Rail transport
List of Chicago Blackhawks players	Chicago Blackhawks players, Lists of National Hockey League players
Alexandreia	Towns in Greece
Ptolemaida	Towns in Greece
Aridaia	Towns in Greece
Soft palate	Mouth
Squirrel monkey	New World monkeys
Pelham Humfrey	English composers, Baroque composers, 1647 births, 1674 deaths
William Turner (composer)	Countertenors, English composers, Baroque composers, 1641 births, 1740 deaths
Montehermoso	Municipalities in Extremadura
Jediism	Star Wars, New religious movements
Miley Cyrus	1992 births, Living people, Actors from Tennessee, American child actors, American child singers, American feminists, American movie actors, American pop singers, American television actors, American voice actors, Disney actors, Disney singers, Miley Cyrus, Pansexual people, Singers from Nashville, Tennessee
Cryptoclidus	Plesiosaurs
Goomba	Mario series characters
Thalassomedon	Plesiosaurs
Thomas Kahlenberg	1983 births, Living people, Danish footballers
Ricardo Alexandre dos Santos	1976 births, Living people, Brazilian footballers
Antonio Bezerra Brandão	1977 births, Living people, Brazilian footballers
Fernando Rech	1974 births, Living people, Brazilian footballers
Alberto Acosta	1966 births, Living people, Argentine footballers, Argentine football managers
Gérald Passi	1964 births, Living people, French footballers
Kenichiro Meta	1982 births, Living people, Footballers from Kagoshima Prefecture
Hiromasa Suguri	1976 births, Living people, Footballers from Shizuoka Prefecture
Yosuke Kataoka	1982 births, Living people, Footballers from Saitama Prefecture
Dirty Harry	1970s crime movies, 1971 thriller movies, 1970s serial killer movies, American serial killer movies, Antisocial personality disorder in fiction, Movies about extortion, Movies about police officers, Movies set in San Francisco, Warner Bros. movies, Movies directed by Don Siegel
Lindi Ortega	1980 births, Canadian songwriters, Living people, Singers from Toronto
Ofra Haza	1957 births, 2000 deaths, Deaths from AIDS, Eurovision Song Contest entrants, Israeli pop singers, Israeli singers, Jewish Israeli musicians, People from Tel Aviv
Nestos	Geography of Bulgaria, Rivers of Greece
Monocentridae	Ray-finned fish
Pineapplefish	Fish of Australia
Ultra Series	Japanese television series
Macedonia (region)	Regions of Europe
Patrick Lalime	1974 births, American Hockey League players, Buffalo Sabres players, Canadian ice hockey goaltenders, Chicago Blackhawks players, ECHL players, Ice hockey people from Quebec, International Hockey League (1945–2001) players, Living people, Ottawa Senators players, Pittsburgh Penguins players, Shawinigan Cataractes players, St. Louis Blues players
Giannitsa	Towns in Greece
Clone	Genetics, Cell biology, Developmental biology, Biological reproduction
Scoutcraft	Scouting
Mirante do Vale	Skyscrapers in Brazil, São Paulo, 1960 establishments, 1960s establishments in Brazil
Jean-Baptiste Lully	1632 births, 1687 deaths, Deaths from gangrene, Baroque composers, Bisexual people, French composers, French dancers, French LGBT people, Italian composers, Italian LGBT people, LGBT composers, LGBT dancers, People from Florence
Herrerasaurus	Theropods, Triassic dinosaurs, Dinosaurs of South America
Jason Earles	American television actors, Actors from San Diego, California, Living people, 1977 births
Hayato Hashimoto	1981 births, Living people, Footballers from Fukui Prefecture
Kazuhisa Iijima	1970 births, Living people, Footballers from Tokyo Prefecture
Mikio Manaka	1969 births, Living people, Footballers from Ibaraki Prefecture
Yasuo Manaka	1971 births, Living people, Footballers from Ibaraki Prefecture
Jean-Alain Boumsong	1979 births, Living people, French footballers
Pascal Chimbonda	1979 births, Living people, Guadeloupe, French footballers
Yuji Ito	1965 births, Living people, Footballers from Mie Prefecture, Japanese association football goalkeepers
Hogan Ephraim	1988 births, Living people, English footballers, Sportspeople from London, Premier League players
Nicky Hofs	1983 births, Living people, Dutch footballers, People from Arnhem, Sportspeople from Gelderland
Jasenovac i Gradiška Stara	Songs, Croatia
Motoo Kimura	1924 births, 1994 deaths, Japanese mathematicians, Geneticists, Evolutionary biologists, People from Aichi Prefecture
Mahmoud Ahmadinejad	1956 births, Living people, Iranian Muslims, Mayors, Presidents of Iran
Jesus	0s BC births, 30s deaths, Ancient Israeli people, Carpenters, Christian religious leaders, Executed people, Jesus Christ, New Testament people, People from Bethlehem, People from Nazareth
United States	United States, English-speaking countries, G8 nations, G7 nations, Federations, 1776 establishments in North America
Canada	Canada, Current monarchies, English-speaking countries, French-speaking countries, Commonwealth realms, G8 nations, G7 nations, Federations, 1867 establishments in North America
Islam	Islam, Arabic words and phrases
Judaism	Judaism
Christianity	Christianity
Espoo shopping mall shooting	2009 crimes, 2009 in Europe, 2000s murders in Europe, 21st century in Finland, Attacks on buildings and structures in Europe, Attacks on buildings and structures in the 2000s, Attacks on shops, December events, Espoo, Mass murder in Europe, Mass murder in the 2000s, Mass shootings in Europe, Mass shootings in the 2000s, Murder-suicides in Europe, Murders by firearm in Europe, Suicide in the 2000s
Aquatic	Ecology
Lagoon	Lagoons
Cryogenian	Neoproterozoic
Humphrey Appleby	Fictional British people, Television characters
Ararat, Victoria	Cities in Victoria, 1857 establishments, 1850s establishments in Australia
Great Eastern Railway	Pre-grouping British railway companies, London and North Eastern Railway, Transport in Epping Forest, 1862 establishments in the United Kingdom, 1860s establishments in England, 1923 disestablishments, 1920s disestablishments in England
Ongar railway station	Disused London Underground stations, Transport in Epping Forest, Epping Ongar Railway, Former single platform tube stations, 1865 establishments in the United Kingdom, 1994 disestablishments in the United Kingdom, 1990s disestablishments in England
North Weald railway station	Disused London Underground stations, 1865 establishments in England, 1994 disestablishments in the United Kingdom, Epping Ongar Railway, Former single platform tube stations, 1990s disestablishments in England
Chipping Ongar	Towns in Essex, Epping Forest
Eastern Counties Railway	Pre-grouping British railway companies, Rail transport in London, 1839 establishments in Europe, 1830s establishments in England, 1862 disestablishments, 19th century disestablishments in the United Kingdom, 1860s disestablishments in Europe
Passing loop	Railway track layouts
Epping, Essex	Epping Forest, Towns in Essex, Market towns in England
Loughton	Towns in Essex, Epping Forest
Pascal Zuberbühler	1971 births, Living people, Swiss footballers, Association football goalkeepers
Shin Asahina	1976 births, Living people, Footballers from Shizuoka Prefecture
Manabu Ikeda	1980 births, Living people, Footballers from Osaka Prefecture, People from Osaka
Tim Cahill	1979 births, Living people, Australian footballers, Sportspeople from Sydney
Suguru Ito	1975 births, Living people, Footballers from Akita Prefecture
John van Loen	1965 births, Living people, Dutch footballers, Sportspeople from Utrecht (city)
Andrea Orlandi	1984 births, Living people, Spanish footballers, Sportspeople from Barcelona
Ludovic Sylvestre	1984 births, Living people, French footballers
Satoshi Nagano	1982 births, Living people, Footballers from Fukuoka Prefecture
Railway electrification system	Rail infrastructure, Rail technologies, Electric railways
Single track (rail)	Railway track layouts
English National Opera	1900s establishments in England, Gilbert and Sullivan, Opera companies, London
Air show	Aviation
Green belt	Real estate, Urban planning, Local government
Florence and the Machine	Brit Award winners, English pop music groups, English rock bands
Jacopo Peri	1561 births, 1633 deaths, Baroque composers, Italian composers, Musicians from Rome, Renaissance composers
Blake Hall tube station	Disused London Underground stations, 1865 establishments in the United Kingdom, Epping Ongar Railway, Former single platform tube stations, 1981 disestablishments
M11 motorway	Motorways in England, Transport in Epping Forest
Coopersale Halt railway station	Railway stations in England, Epping Ongar Railway, Epping Forest
London Underground 1960 Stock	London Underground electric multiple units
Martin Bell	1938 births, Living people, Alumni of King's College, Cambridge, British war correspondents, British television presenters, Independent politicians, Politicians from Suffolk
Urban75	Websites, Activism, Protests
Francesco Cavalli	1602 births, 1676 deaths, Italian composers, Baroque composers, People from Lombardy
Santana do Paraíso	Cities in Minas Gerais, Vale do Aço metropolitan area, 1992 establishments, 1990s establishments in Brazil
Ruston (engine builder)	Rail vehicles manufacturers, Ruston & Hornsby locomotives, Lincolnshire, Defunct companies of the United Kingdom, Manufacturing, 1857 establishments in Europe, 1918 disestablishments in Europe, 1850s establishments in the United Kingdom, 20th century disestablishments in the United Kingdom, Locomotive manufacturers
Harsco Corporation	1853 establishments in the United States, Companies listed on the New York Stock Exchange
Brake van	United Kingdom rolling stock, Transport in Australia
Track ballast	Rail infrastructure
Karmapa	Tibetan Buddhist lamas
Permanent way	Rail infrastructure
London Underground 1962 Stock	London Underground electric multiple units
Scrap	Recycling, Waste management
Verismo	Opera genres, Opera terminology, Literature
BBC Introducing	BBC
Eats, Shoots & Leaves	2003 books, Non-fiction books
Germany	Germany, G7 nations, European Union member states, German-speaking countries, G8 nations, Federations
Harry Potter	Harry Potter
Spain	Spain, European Union member states, Current monarchies, Spanish-speaking countries
World War I	Wars involving Australia, Wars involving Belgium, Wars involving the British Empire, Wars involving France, Wars involving Germany, Wars involving Greece, Wars involving Italy, Wars involving Japan, Wars involving New Zealand, Wars involving Portugal, Wars involving Russia, Wars involving South Africa, Wars involving the United States, Wars involving the United Kingdom, World War I
World War II	1939, 1940, 1941, 1942, 1943, 1944, 1945, Wars involving Australia, Wars involving Belgium, Wars involving Canada, Wars involving China, Wars involving France, Wars involving Germany, Wars involving Greece, Wars involving Italy, Wars involving Japan, Wars involving the Netherlands, Wars involving South Africa, Wars involving the Soviet Union, Wars involving the United Kingdom, Wars involving the United States, World War II
Rubeus Hagrid	Fictional characters introduced in 1997, Harry Potter characters
Rodney Stuckey	1986 births, American basketball players, Living people, Sportspeople from Seattle, Washington, Detroit Pistons players
Alou Diarra	1981 births, Living people, French footballers
Gaël Givet	1981 births, Living people, French footballers, Arles
Brad Jones (soccer)	1982 births, Living people, Australian footballers, Association football goalkeepers, Sportspeople from Western Australia, People from Perth, Western Australia
Sebastián Viera	1983 births, Living people, Uruguayan footballers, Association football goalkeepers
Christian Bolaños	1984 births, Living people, Costa Rican footballers
Mido	1983 births, Living people, Egyptian footballers, People from Cairo, Egypt international footballers
Angelo Carlos Pretti	1965 births, Living people, Brazilian footballers
Rudi Vata	1969 births, Living people, Albanian footballers
Zamalek Sporting Club	Football clubs, Cairo, Sport in Egypt, 1911 establishments, 1910s establishments in Africa, 20th-century establishments in Egypt
IK Start	Norwegian football clubs, 1905 establishments in Europe, 20th century establishments in Norway
The Ladykillers (2004 movie)	2004 comedy movies, 2000s criminal comedy movies, American criminal comedy movies, English-language movies, Movie remakes, Movies set in Mississippi
Bill Paxton	1955 births, 2017 deaths, Actors from Fort Worth, Texas, American movie actors, American movie directors, American Roman Catholics, American television actors, American voice actors, Cardiovascular disease deaths in Los Angeles, Deaths from stroke, Deaths from surgical complications, Saturn Award winners
Alias (TV series)	2001 American television series debuts, Spy television series, Television series by Buena Vista Television, 2006 American television series endings, English-language television programs
Fred Willard	1933 births, American movie actors, American television actors, American voice actors, American stage actors, Comedians from Ohio, 2020 deaths, Deaths from cardiac arrest, Writers from Cleveland, Ohio, Actors from Cleveland, Ohio, People from Shaker Heights, Ohio
Oslofjord	Gulfs, Geography of Norway
Bo Outlaw	1971 births, African-American basketball players, Living people, Los Angeles Clippers players, Memphis Grizzlies players, Orlando Magic players, Phoenix Suns players, Sportspeople from San Antonio, Texas, American basketball players
Bill Murray	Emmy Award winning actors, Golden Globe Award winning actors, BAFTA Award winning actors, 1950 births, Living people, American movie actors, American television actors, American voice actors, American stage actors, Actors from Chicago, Television personalities from Chicago, Movie producers from Chicago, Screenwriters from Chicago, Comedians from Chicago
Artificial pacemaker	Heart, Medical equipment
West Macedonia	Peripheries of Greece
Skydra	Towns in Greece
Listen to Your Heart	1988 songs
Gary Jules	1969 births, Living people, American rock guitarists, American rock singers, Singer-songwriters from California, Musicians from San Diego, California, People from Fresno, California, Singers from San Diego, California, Writers from San Diego, California, American folk singers
Brass band	Musical groups, Brass instruments
1st millennium BC	1st millennium BC
Bird nest	Birds
Car bomb	Car and truck bombings
Mancini	1980 births, Living people, Brazilian footballers
Darren Ambrose	1984 births, Living people, English footballers, Sportspeople from Essex, Premier League players, Crystal Palace F.C. players
Mazinho Oliveira	1965 births, Living people, Footballers from Rio de Janeiro
Charles N'Zogbia	1986 births, Living people, French footballers
Karim Benzema	1987 births, Living people, 2014 FIFA World Cup players, French footballers, Sportspeople from Lyon
Lim You-hwan	1983 births, Living people, South Korean footballers
Regillio Simons	1973 births, Living people, Dutch footballers, Sportspeople from Amsterdam
Alemão (born in 1984)	1984 births, 2007 deaths, Brazilian footballers
Paulo Antônio de Oliveira	1982 births, Living people, Brazilian footballers, Mato Grosso
Akhrik Tsveiba	1966 births, Living people, Ukrainian footballers, Russian footballers
Dmitri Radchenko	1970 births, Living people, Russian footballers
Javier Irureta	1948 births, Living people, Spanish footballers, Spanish football managers
Kasper Schmeichel	1986 births, Living people, Danish footballers, Association football goalkeepers
Carlton Cole	1983 births, Living people, Sportspeople from London, Black British sportspeople, English footballers, Premier League players
Ko Jeong-woon	1966 births, Living people, South Korean footballers
Edin Mujčin	1970 births, Living people, Bosnia and Herzegovina footballers
Néstor Gorosito	1964 births, Living people, Argentine footballers, Argentine football managers
Marcelo Lipatín	1977 births, Living people, Uruguayan footballers, Sportspeople from Montevideo
Hennie Meijer	1962 births, Living people, Dutch footballers, People from Paramaribo
Shaka Hislop	1969 births, Living people, Trinidad and Tobago footballers, Association football goalkeepers
Hélder Postiga	1982 births, Living people, Portuguese footballers
Tetsuya Abe	1983 births, Living people, Footballers from Hokkaidō Prefecture
Víctor Fernández	1960 births, Living people, Spanish footballers, People from Zaragoza
Miguel Ángel Lotina	1957 births, Living people, Spanish footballers
NHL Winter Classic	National Hockey League
List of Stanley Cup Finals appearances	National Hockey League lists
Denzel Washington	Actors from New York, African American actors, American movie actors, African American movie directors, African American movie producers, American stage actors, American television actors, American voice actors, Best Actor Academy Award winners, Golden Globe Award winning actors, Tony Award winning actors, 1954 births, Living people, People from Mount Vernon, New York
Filip Vandewal	1981 births, Living people, Belgian filmmakers, Cinematographers
Doddinghurst	Villages in Essex
Railway semaphore signal	Rail technologies
Thecodontosaurus	Sauropodomorphs
Eric Holder	1951 births, Living people, United States Attorneys General, Politicians from New York City, Columbia University alumni, US Democratic Party politicians, African American lawyers, United States Deputy Attorneys General
The Brothers Karamazov	Books by Fyodor Dostoevsky, 1879 books, Russian novels, 1880 books, Crime fiction books, Epic poems, Fictional families, Suicide in fiction, Works about families
Georgetown, Ontario	Towns in Ontario
July Revolution	Revolutions, 19th century in France, 1830
Baja Bug	1960s automobiles, Volkswagen automobiles
Nuno Valente	1974 births, Living people, Portuguese footballers, Sportspeople from Lisbon
Stefano Okaka Chuka	1989 births, Living people, Italian footballers
Chris James	1987 births, Living people, Oceanic footballers, People from Wellington, Sportspeople from North Island
Junnosuke Schneider	1977 births, Living people, Footballers from Tokyo Prefecture, Japanese association football goalkeepers
Liam Rosenior	1984 births, Living people, English footballers, Sportspeople from London, Premier League players
Hiroshi Ochiai	1946 births, Living people, Footballers from Saitama Prefecture, Japan international footballers, Japan Soccer League players, Hokkaido Consadole Sapporo players, Urawa Red Diamonds players
Yoshiyuki Matsuyama	1966 births, Living people, Footballers from Kyoto Prefecture, Japan international footballers, J1 League players, Japan Soccer League players, JEF United Chiba players, Gamba Osaka players, Kyoto Sanga FC players, 1988 AFC Asian Cup players
Quim	1975 births, Living people, Portuguese footballers, Association football goalkeepers
Fernando Meira	1978 births, Living people, Portuguese footballers
Mantorras	1982 births, Living people, African footballers, Angolan people
Nuno Gomes	1976 births, Living people, Portuguese footballers
Nino Bule	1976 births, Living people, Croatian footballers
Vjekoslav Škrinjar	1969 births, Living people, Croatian footballers
José Carlos Garcia Leal	1980 births, Living people, Brazilian footballers
Tiago Mendes	1981 births, Living people, Portuguese footballers, Portuguese football managers
Comparative anatomy	Animal anatomy, Branches of zoology, Taxonomy
Dissection	Anatomy, Zoology
List of animal phyla	Animal phyla, Invertebrates, Lists of animals, Taxonomy, Groups of phyla, Glossaries
Orthoptera	Orthoptera
Chios	Islands of Greece
Corfu	Islands of Greece
Adoram Keisi	1972 births, Living people, Israeli footballers, Jewish Israeli sportspeople
Alfa Romeo	Italian automobile companies, Alfa Romeo automobiles, 1910 establishments in Italy
Gangster	Occupations
Peter Buck	1956 births, Living people, American guitarists, American songwriters, American rock musicians, Musicians from Berkeley, California, Writers from Berkeley, California
Interstate 15	Interstate Highways, 1957 establishments in the United States
Interstate 16	Interstate Highways
Interstate 17	Interstate Highways
Interstate 19	Interstate Highways
Interstate 20	Interstate Highways
Interstate 22	Interstate Highways, Memphis, Tennessee
Interstate 24	Interstate Highways
Interstate 25	Interstate Highways
Interstate 26	Interstate Highways
Interstate 27	Interstate Highways
Interstate 29	Interstate Highways
Interstate 30	Interstate Highways
Interstate 35	Interstate Highways
Interstate 37	Interstate Highways
Interstate 39	Interstate Highways
Interstate 40	Interstate Highways
Interstate 43	Interstate Highways
Interstate 44	Interstate Highways
Interstate 45	Interstate Highways
Interstate 49	Interstate Highways
Interstate 55	Interstate Highways
Interstate 57	Interstate Highways
Interstate 59	Interstate Highways
Interstate 64	Interstate Highways
Interstate 65	Interstate Highways
Interstate 66	Interstate Highways
Interstate 68	Interstate Highways
Interstate 69	Interstate Highways
Interstate 70	Interstate Highways
Interstate 71	Interstate Highways
Interstate 72	Interstate Highways
Interstate 73	Interstate Highways
Interstate 74	Interstate Highways
Interstate 76 (west)	Interstate Highways
Interstate 76 (Ohio–New Jersey)	Interstate Highways
Interstate 77	Interstate Highways
Interstate 78	Interstate Highways
Interstate 79	Interstate Highways
Interstate 80	Interstate Highways
Interstate 83	Interstate Highways
Interstate 84 (east)	Interstate Highways
Interstate 85	Interstate Highways
Interstate 86 (west)	Interstate Highways
Interstate 86 (east)	Interstate Highways
Interstate 87 (New York)	Interstate Highways
Interstate 88 (west)	Things named after Ronald Reagan, Interstate Highways
Interstate 88 (east)	Interstate Highways
Interstate 89	Interstate Highways
Interstate 93	Interstate Highways
Interstate 94	Interstate Highways
Interstate 96	Interstate Highways
2030	2030, Years in the future
Interstate 97	Interstate Highways
Norman Jay Coleman	United States Secretaries of Agriculture, 1827 births, 1911 deaths, Deaths from pneumonia, Politicians from New York, State legislators of the United States, Lieutenant Governors of Missouri
Interstate 99	Interstate Highways
2031	2031, Years in the future
Interstate 238	Interstate Highways
2032	2032, Years in the future
Interstate Highways in Alaska	Interstate Highways
Jeremiah McLain Rusk	1830 births, 1893 deaths, American Civil War generals, Bankers, Governors of Wisconsin, Politicians from Ohio, United States Secretaries of Agriculture, US Republican Party politicians
Na'vi language	Constructed languages
Kentrosaurus	Dinosaurs of Africa, Jurassic dinosaurs, Stegosaurs
Delgadillo's Snow Cap Drive-In	Buildings and structures in Arizona, American fast food restaurants, 1953 establishments in the United States, 20th-century establishments in Arizona
Simão Sabrosa	1979 births, Living people, Portuguese footballers
Marco Donadel	1983 births, Living people, Italian footballers
Henri Camara	1977 births, Living people, Senegalese footballers, People from Dakar
Julio dos Santos	1983 births, Living people, Paraguayan footballers, People from Asunción
Kim Sung-Kil	1983 births, Living people, South Korean footballers
Ziad Tlemcani	1963 births, Living people, Tunisian footballers, People from Tunis
Hideyuki Ujiie	1979 births, Living people, Footballers from Tokyo Prefecture
Matthew Bingley	1971 births, Living people, Australian footballers, Sportspeople from Sydney
Brachiopod	Brachiopods, Fossils
Deaths in 2010	2010 deaths

