2014–15 Eredivisie	2014 in association football, 2015 in association football, Football in the Netherlands, 2014 in Europe, 2015 in Europe, 2010s in the Netherlands
Cathy McMorris Rodgers	1969 births, Living people, People from Salem, Oregon, United States representatives from Washington, US Republican Party politicians
Naviraí	Cities in Mato Grosso do Sul, 1952 establishments, 1950s establishments in Brazil
Jim Gilmore 2016 presidential campaign	2016 United States presidential campaigns
Deaths in August 2015	2015 deaths, August 2015 events
Yakub Memon	1962 births, 2015 deaths, Muslim terrorists, People executed by hanging, People from Mumbai
Jan Kulczyk	1950 births, 2015 deaths, Deaths from surgical complications, Polish businesspeople
List of governors of Arizona	Governors of Arizona
The Winning Team	1952 movies, American biographical movies, Movies directed by Lewis Seiler
Russ Tamblyn	Golden Globe Award winning actors, 1934 births, Living people, American movie actors, American television actors, Actors from Los Angeles, California
George Chakiris	Academy Award winning actors, Golden Globe Award winning actors, 1934 births, Living people, American movie actors, American television actors, American stage actors, American dancers, Actors from Ohio, Singers from Ohio
SHeDAISY	1989 establishments in the United States, 1980s American music groups, 1990s American music groups, 2000s American music groups, 2010s American music groups, Country bands, Musical groups established in 1989, Musical groups from Utah, Musical trios
Extravehicular activity	Spaceflight
Cley Marshes	North Norfolk
Six Flags Over Texas	Six Flags amusement parks, Texas, Theme parks in the United States, Arlington, Texas, 1961 establishments in the United States, 1960s establishments in Texas
John Smoltz	Atlanta Braves players, Year of birth missing (living people), Living people
Independence Hall (Israel)	Museums in Tel Aviv
Route 386 (Israel)	Roads in Israel, Jerusalem
James Hedges	2016 United States presidential candidates, 1938 births, Living people, American political activists, Politicians from Iowa, Politicians from Pennsylvania
Alena Vrzáňová	1931 births, 2015 deaths, Czechoslovak people, Sportspeople from Prague, Figure skaters
Augustin Bubník	1928 births, 2017 deaths, Czech ice hockey players, Sportspeople from Prague
Mario Puzo	1920 births, 1999 deaths, Academy Award winners, American novelists, Cardiovascular disease deaths in New York, Deaths from heart failure, Golden Globe Award winners, Screenwriters from New York City, Writers from Manhattan
Barbara Harris	Tony Award winning actors, 1935 births, 2018 deaths, Deaths from lung cancer, American movie actors, American television actors, American stage actors, Actors from Illinois
Noel Neill	1920 births, 2016 deaths, American movie actors, American television actors, Actors from Minneapolis, Minnesota
Don Murray	1929 births, Living people, American movie actors, American television actors, Actors from Hollywood
Hope Lange	Emmy Award winning actors, 1933 births, 2003 deaths, Infectious disease deaths in California, American movie actors, American television actors, American stage actors, Actors from Connecticut
Alan J. Pakula	1928 births, 1998 deaths, Road accident deaths in the United States, Movie directors from New York City, Movie producers from New York City, Screenwriters from New York City
The Parallax View	1974 thriller movies, American thriller movies
Bubba Franks	Green Bay Packers players, 1978 births, Living people, American football tight ends
Breckland District	Breckland, 1974 establishments in England
River Leam	Rivers of England, Northamptonshire, Warwickshire
Tribute to Jerusalem	Sculptures, Buildings and structures in Jerusalem
Jerusalem Forest	Forests, Geography of Israel, Jerusalem
Cley next the Sea	North Norfolk, Villages in Norfolk
Chesterville	Towns in Maine
Atkinson, Maine	Towns in Maine
North Norfolk	North Norfolk, 1974 establishments in England
Ein Kerem	Neighbourhoods of Jerusalem
Independence Day (Israel)	Israeli culture, Holidays
The Judge (2014 movie)	2014 crime movies, 2014 drama movies, 2010s crime drama movies, 2010s legal movies, American crime drama movies, American legal movies, English-language movies, Indiana in fiction, Movies set in Chicago, Illinois, Warner Bros. movies
Billy Pierce	1927 births, 2015 deaths, Deaths from gallbladder cancer, Cancer deaths in Chicago, Chicago White Sox players, Detroit Tigers players, San Francisco Giants players
Jon Shepodd	1924 births, 2017 deaths, Actors from Birmingham, Alabama, American movie actors, American television actors
David Faber	1928 births, 2015 deaths, Polish educators, Holocaust survivors, Jewish American writers, Naturalized citizens of the United States, Polish Jews
Alan Cheuse	1940 births, 2015 deaths, Deaths from subdural hematoma, Critics, Road accident deaths in California, People from Perth Amboy, New Jersey, Writers from New Jersey
Trey Gowdy	1964 births, Living people, People from Spartanburg, South Carolina, People from Greenville, South Carolina, United States representatives from South Carolina, US Republican Party politicians, South Carolina Republicans
Henry Fairfield Osborn	1857 births, 1935 deaths, American geologists, American paleontologists, Eugenics, People from Connecticut, Princeton University alumni, Fairfield, Connecticut
Canada's Wonderland	Theme parks in North America, Buildings and structures in Ontario
Six Flags America	Six Flags amusement parks, Maryland, 1974 establishments in the United States, Theme parks in the United States, 20th-century establishments in Maryland
Pink elephant	Figures of speech, Literary terms, Fictional animals
Karim Findi	1946 births, Living people, Kurdish people
Unpredictable	2005 albums
Windows 10 Mobile	Microsoft operating systems
Six Flags Discovery Kingdom	Six Flags amusement parks, Theme parks in California, Vallejo, California, 1968 establishments in the United States, 1960s establishments in California
2012 Benghazi attack	2010s murders in Africa, Attacks on buildings and structures in 2012, Attacks on buildings and structures in Africa, Benghazi, History of Libya, Islamic terrorist incidents in Africa, Islamic terrorist incidents in the 2010s, Mass murder in 2012, Mass murder in Africa, September events
Six Flags Fiesta Texas	Texas, Six Flags amusement parks, Theme parks in the United States
Keller	Surnames
Six Flags New England	Six Flags amusement parks, Massachusetts, Theme parks in the United States
Suspect	Crime, Law
La Ronde (amusement park)	Theme parks in North America, Quebec
Stephan Beckenbauer	1968 births, 2015 deaths, Disease-related deaths in Bavaria, German football managers, German footballers, Sportspeople from Munich
Piet Fransen	1936 births, 2015 deaths, Dutch footballers, People from Groningen (city), Sportspeople from Groningen (province)
David H. Koch	1940 births, 2019 deaths, American philanthropists, American political activists, American billionaires, American conservatives, Koch family, Deaths from prostate cancer, Businesspeople from Wichita, Kansas, Cancer deaths in New York, Republicans (United States)
Koch Industries	1940 establishments in the United States, Industries, Wichita, Kansas, 20th-century establishments in Kansas
Fred C. Koch	1900 births, 1967 deaths, Engineers from Utah, Businesspeople from Texas, Deaths from heart failure, Disease-related deaths in Utah, Koch family, Republicans (United States)
Dachau concentration camp	Buildings and structures in Bavaria, Nazi concentration camps in Germany
Bełżec extermination camp	Nazi concentration camps in Poland, 1942 in Europe, 1940s in Germany, 20th century in Poland
My Kind of Town	Songs about Chicago, Illinois, Pop songs, Frank Sinatra songs
Sweet Home Chicago	Blues music, Songs about Chicago, Illinois
Sammy Cahn	1913 births, 1993 deaths, Deaths from heart failure, American songwriters, Musicians from New York City, Writers from New York City, Best Original Song Academy Award-winning songwriters
Jim Rivera	1921 births, Living people, Baltimore Orioles players, Chicago White Sox players, Oakland Athletics players, Sportspeople from New York City
Curt Simmons	1929 births, Living people, Philadelphia Phillies players, St. Louis Cardinals players, Chicago Cubs players, California Angels players, Sportspeople from Pennsylvania
John H. Gibbons (scientist)	1929 births, 2015 deaths, Directors of the Office of Science and Technology Policy, American physicists, Scientists from Virginia
David A. Patterson	1947 births, Living people, American computer scientists, Scientists from Illinois, Scientists from Tennessee, Scientists from Berkeley, California, People from Evergreen Park, Illinois
Howard W. Jones	1910 births, 2015 deaths, American centenarians, American physicians, Deaths from respiratory failure, Disease-related deaths in Virginia, Scientists from Baltimore, Maryland
Jerome Kohlberg, Jr.	1925 births, 2015 deaths, Cancer deaths in Massachusetts, Businesspeople from New York
Amartya Sen	1933 births, 2021 deaths, Indian scientists, American philosophers, American economists, British economists, British philosophers, Scientists from New York, Indian Nobel Prize winners, Ambedkarites
George Stigler	1911 births, 1991 deaths, Deaths from heart failure, Cardiovascular disease deaths in Chicago, American economists, Scientists from Chicago, Scientists from Seattle, Washington
Traunstein (mountain)	Mountains of Austria
Sensory overload	Sensory system
Forrest Bird	1921 births, 2015 deaths, Engineers from Massachusetts, American inventors, Scientists from Massachusetts
Giovanni Conso	1922 births, 2015 deaths, Italian politicians, Italian judges, People from Turin
Alfredo Biondi	1928 births, 2020 deaths, Italian politicians, Italian lawyers, Civil servants
Ciriaco De Mita	1928 births, Living people, Former MEPs, Mayors, MEPs for Italy, Prime Ministers of Italy
2014 Canadian Championship	2014 in Canada, Soccer in Canada, 2014 in association football
2017 FIFA Confederations Cup	FIFA Confederations Cup, 2017 in association football, 2010s in Russia, July 2017 events, June 2017 events, Sport in Russia
Joan Copeland	1922 births, Living people, American stage actors, Actors from New York City
Georg Ratzinger	1924 births, 2020 deaths, German conductors, German Roman Catholics, People from Regensburg, Roman Catholic priests
Wrestling singlet	Wrestling, Sports clothing
Saint Petersburg Stadium	Football stadiums in Europe, Buildings and structures in Saint Petersburg
Away goals rule	Football (soccer) terminology
Football Association of Iceland	1947 establishments in Europe, Football organizations, Football in Iceland, 1940s establishments in Iceland
Úrvalsdeild karla (football)	Football leagues, Football in Iceland, 1912 establishments in Europe, 20th century establishments in Iceland
Chiara Pierobon	1993 births, 2015 deaths, Cardiovascular disease deaths in Germany, Deaths from pulmonary embolism, Italian cyclists, Sportspeople from Veneto
Margot Loyola	1918 births, 2015 deaths, Chilean singers, Musicians
Universal Parks & Resorts	Theme park companies
Les Munro	1919 births, 2015 deaths, Aviators, People from North Island, World War II people
Lamberto Dini	1931 births, Living people, Prime Ministers of Italy, Italian economists, People from Florence
2014 Úrvalsdeild	2014 in association football, Football in Iceland, 2014 in Europe, 21st century in Iceland
Stjarnan	1960 establishments in Europe, Sports clubs, Sport in Iceland, Icelandic football clubs, 20th century establishments in Iceland
Mel Farr	1944 births, 2015 deaths, Deaths from cardiovascular disease, Detroit Lions players, Sportspeople from Texas, Diseases and disorders of the brain
Flory Jagoda	1923 births, 2021 deaths, Deaths from dementia, Naturalized citizens of the United States, Bosnia and Herzegovina writers, American guitarists, American composers, American singer-songwriters, Musicians from Virginia, Singers from Virginia, Bosnia and Herzegovina entertainers
Gary Martin (footballer)	English footballers, Sportspeople from County Durham, 1990 births, Living people
Marlboro Township, New Jersey	Townships in New Jersey, Monmouth County, New Jersey
El Cerrito, California	1917 establishments in the United States, 1910s establishments in California, Cities in California, Settlements in Contra Costa County, California, Cities in the San Francisco Bay Area
Roots rock	Rock music
Campeonato Nacional (Chile)	Football in Chile, Football leagues, 1933 establishments, 1930s establishments in Chile
Stanley Donen	1924 births, 2019 deaths, Deaths from heart failure, Cardiovascular disease deaths in New York City, American movie directors, American choreographers, People from Columbia, South Carolina
Elaine May	Saturn Award winners, BAFTA Award winning writers, 1932 births, Living people, American movie directors, American screenwriters, American movie actors, American television actors, American stage actors, Comedians from Pennsylvania, Screenwriters from Pennsylvania, Actors from Philadelphia, Pennsylvania
NGC 4526	Lenticular galaxies
SN 1994D	Supernovae, 1994
Satellite flare	Satellites, Light, Space telescopes
Wind chill	Weather measurements, Meteorology
West Frisian language	Frisian languages
Melania Trump	1970 births, Trump family, Living people, American models, American Roman Catholics, People from New York City, American philanthropists, American activists, First Ladies of the United States, Naturalized citizens of the United States, Slovenian people
The Trump Organization	1971 establishments in New York (state), Companies based in New York City, Donald Trump
Corey Burton	1955 births, Living people, Actors from Los Angeles, California, American voice actors
Irina Shayk	1986 births, Russian models, Living people, Russian actors
Tim Farron	1970 births, Living people, English Christians, Leaders of the Liberal Democrats (UK), Members of the British House of Commons for English constituencies, People from Preston, Lancashire, Politicians from Lancashire, UK MPs 2005–2010, UK MPs 2010–2015, UK MPs 2015–2017, UK MPs 2017–2019
Ronald Reagan filmography	Filmographies, Ronald Reagan
Içami Tiba	1941 births, 2015 deaths, Brazilian writers, Psychiatrists, People from São Paulo
Templo Mayor	Aztec gods and goddesses, Mexico City, Archaeological sites in Mexico, 14th-century establishments in Mexico, 1521 disestablishments, Disestablishments in Mexico
Kings Dominion	Theme parks in the United States, Buildings and structures in Virginia, 1975 establishments in the United States, 1970s establishments in Virginia
Amy Schumer	1981 births, Living people, Actors from Manhattan, American movie actors, American movie producers, American stand-up comedians, American television actors, American television producers, American television writers, American voice actors, Comedians from New York City, Screenwriters from New York City, Writers from Manhattan
Daryl Hall	1946 births, Living people, American guitarists, American singer-songwriters, Singers from Pennsylvania, Musicians from Pennsylvania, Writers from Pennsylvania
John Oates	1948 births, Living people, American guitarists, American singer-songwriters, Singers from New York City, Musicians from New York City, Writers from New York City
Natalia Molchanova	1962 births, 2015 deaths, Accidental deaths by drowning, Russian sportspeople
Microsoft Edge	Web browsers, Microsoft software
Isabelle Adjani	French movie actors, French television actors, Actors from Paris, French singers, 1955 births, Living people
Everclear (band)	Musical groups from Oregon, Musical groups established in 1991, 1991 establishments in the United States, 20th-century establishments in Oregon
Härryda	Settlements in Vastra Gotaland County
Forced labor	Labor, Ethics
Arrondissements of the Hérault department	Arrondissements of France
Arrondissement of Béziers	Arrondissements of France
Arrondissement of Lodève	Arrondissements of France
Arrondissement of Montpellier	Arrondissements of France
Copa América	CONMEBOL, Copa América tournaments, 1916 establishments, 1910s establishments in South America
1916 South American Championship	Copa América tournaments, 1916, 1910s in sports, 20th century in Argentina, 1910s in South America, July events
1917 South American Championship	Copa América tournaments, 1917 in sports, 1910s in South America, 20th century in Uruguay
1919 South American Championship	Copa América tournaments, 1910s in sports, 1910s in Brazil, 1919, May events
Shep Gordon	1946 births, Living people, Movie producers from New York City, People from Queens
2011 Copa América	Copa América tournaments, 2010s in Argentina, 2011 in association football
Roger Vergé	1930 births, 2015 deaths, Deaths from diabetes, French chefs
2011 Copa América Final	2011 in association football, Copa América tournaments
Palomar Mountain	Mountains of California, San Diego County, California
Marine Corps Base Camp Pendleton	United States Marine Corps
Palomar College (NCTD station)	North County Transit District stations, 2008 establishments in California
Buena Creek (NCTD station)	North County Transit District stations, 2008 establishments in California
San Marcos Civic Center (NCTD station)	North County Transit District stations, 2008 establishments in California
Axur, Re d'Ormus	1780s operas, 1788 works
Sprinter (light rail)	Light rail, Rail transport in the United States, Transport in California
Coast Highway (NCTD station)	North County Transit District stations, 2008 establishments in California
Papillon (dog)	Spaniels
Typhoon Soudelor	2015 in weather, Tropical cyclones in Asia, Tropical cyclones in Oceania, July events, August 2015 events, 2010s in Oceania, 2010s in Taiwan, 2010s in China, 2015 in Asia
Viroid	Virology
The Blue Lagoon (1980 movie)	1980 drama movies, 1980s adventure movies, 1980s coming-of-age movies, 1980s romantic drama movies, 1980s teen drama movies, 1980s teen romance movies, American adventure movies, American coming-of-age movies, American movie remakes, American romantic drama movies, Coming-of-age drama movies, Coming-of-age romance movies, English-language movies, Incest in movies, Movies set in the 19th century, Movies set in islands, Movies with underwater settings, Teenage pregnancy in movies, Works about cousins, Movies directed by Randal Kleiser
Orna Porat	1924 births, 2015 deaths, Actors from North Rhine-Westphalia, Converts to Judaism, German stage actors, Israeli stage actors, Jewish Israeli actors, Naturalized citizens of Israel, People from Cologne
Johanna Quandt	1926 births, 2015 deaths, German billionaires, German businesspeople, People from Berlin
Joe Arpaio	1932 births, Living people, American police officers, Politicians from Massachusetts, Politicians from Phoenix, Arizona, People from Springfield, Massachusetts, US Republican Party politicians
Theo van Els	1936 births, 2015 deaths, Dutch academics, Linguists, People from Limburg (Netherlands)
PyMOL	Free software, Chemistry
Buddy Roemer 2012 presidential campaign	United States presidential campaigns
Tahult	Settlements in Vastra Gotaland County
Konrad Juengling	20th century births, Living people, American LGBT people, American LGBT rights activists, Gay men, LGBT writers, People from Salem, Oregon, Writers from Oregon, Year of birth missing (living people)
Chest x-ray	Medical procedures, Torso
Men of Honor	2000 drama movies, American drama movies, English-language movies, Movies based on real life events, 20th Century Fox movies
Regulate (song)	Hip hop songs, Hip hop soul songs, 1994 songs
Louise Suggs	1923 births, 2015 deaths, American golfers, Sportspeople from Atlanta, Georgia
Manuel Contreras	1929 births, 2015 deaths, Chilean military people, Deaths from multiple organ failure, Disease-related deaths in Chile, Generals, Kidnappers, Murderers, People from Santiago, People who died in prison custody
Mafia III	1960s in fiction, 2016 video games, Adventure games, Louisiana in fiction, New Orleans, Louisiana in fiction, PlayStation 4 games, Video game sequels, Shooter video games, Windows games, Xbox One games
Jovanotti	Italian singers, 1966 births, Living people, Musicians from Rome, Songwriters, Rap musicians
List of football federations	Football-related lists, Football organizations, International organizations
Vladimir Zeldin	1915 births, 2016 deaths, Centenarians, Russian actors
Vladimir Etush	1922 births, 2019 deaths, Deaths from heart failure, Russian actors
Leonid Bronevoy	1928 births, 2017 deaths, Russian actors
Aleksandra Pakhmutova	1929 births, Living people, Russian composers
Terrence Evans	1934 births, 2015 deaths, American movie actors, American television actors, American voice actors, Actors from Pennsylvania, Comedians from Pennsylvania
The Yards	2000 crime movies, 2000 drama movies, 2000s crime drama movies, American crime drama movies, English-language movies, Miramax movies, Movies set in New York City, Movies directed by Matt Reeves
Air Florida Flight 90	1982 in the United States, Aviation disasters in the 1980s, 20th century in Virginia, 1980s in Washington, D.C., Aviation disasters in the United States, January events
Hermitage cats	Art museums, Cats, Saint Petersburg, History of Russia
Northwest Airlines Flight 255	Aviation disasters in the 1980s, 1987 in the United States, 1980s in Michigan, Aviation disasters in the United States
Delta Air Lines Flight 191	1985 disasters, 1985 in the United States, 1980s in Texas, Aviation disasters in the 1980s, Aviation disasters in the United States, August events
United Airlines Flight 232	1989 disasters, 1989 in the United States, Aviation disasters in the 1980s, Aviation disasters in the United States, 20th century in Iowa
Moneron Island	Pacific islands, Islands of Russia
Stapleton International Airport	Airports in the United States
2010 Polish Air Force Tu-154 crash	2010 aviation disasters, 2010 in Europe, 2010s in Russia, Aviation disasters in Europe, April events
Smolensk	Capital cities in Russia
Sean Price	1972 births, 2015 deaths, African-American singers, American rap musicians from New York, Musicians from Brooklyn, Singers from New York City, Unexplained deaths
It's Too Late (Carole King song)	Rock songs, 1971 songs
Bump n' Grind	R&B songs, 1994 songs
Methods of computing square roots	Mathematics
Rules for the Direction of the Mind	18th century books, Works of philosophy, 1701
List of governors of Arkansas	Governors of Arkansas
Governor of New Jersey	Governors of New Jersey
List of governors of Louisiana	Governors of Louisiana
List of governors of Ohio	Governors of Ohio
Governor of New York	1777 establishments in New York (state), Governors of New York
Governor of Texas	Governors of Texas
Governor of Wisconsin	Governors of Wisconsin
Governor of Maryland	Governors of Maryland
List of governors of Rhode Island	Governors of Rhode Island
Warwick, Rhode Island	Cities in Rhode Island
Rarotonga	Cook Islands, Islands of Oceania
The Departed	2006 drama movies, 2000s crime drama movies, 2000s crime thriller movies, 2000s drama thriller movies, American crime drama movies, American crime thriller movies, American drama thriller movies, American gangster movies, Best Picture Oscar, English-language movies, Movies directed by Martin Scorsese, Movies set in Boston, Massachusetts, Warner Bros. movies
Zaslawskaye Reservoir	Lakes of Europe
Kayyar Kinhanna Rai	1915 births, 2015 deaths, Activists, Centenarians, Deaths from pneumonia, Indian writers, Infectious disease deaths in India, Indian journalists
Harkishan Singh Surjeet	1916 births, 2008 deaths, Activists, Communist politicians, Civil servants, Deaths from cardiac arrest, Indian politicians
Madison De La Garza	Living people, 2001 births, Actors from Dallas, Texas, American television actors, American child actors
Cardiovascular disease	Diseases and disorders of the cardiovascular system
Reform Party of the United States of America	1995 establishments in the United States, Political parties in the United States
Frank Gifford	1930 births, 2015 deaths, Deaths from myocardial infarction, American television presenters, Deaths from natural causes, New York Giants players, People from Santa Monica, California, Sportspeople from Los Angeles County, California, Deaths from chronic traumatic encephalopathy
Joyce Jameson	1932 births, 1987 deaths, Actors from Chicago, Actors who committed suicide, American movie actors, American television actors, Drug-related suicides in the United States, Suicides in California
Dottie West	1932 births, 1991 deaths, American country musicians, American singer-songwriters, Road accident deaths in the United States, Singers from Tennessee
Achim Hill	1935 births, 2015 deaths, 1968 Summer Olympics, East German sportspeople, German Olympic silver medalists, Medalists at the 1960 Summer Olympics, Medalists at the 1964 Summer Olympics, Sportspeople from Berlin
Susan Sheridan	1947 births, 2015 deaths, British movie actors, British television actors, British voice actors, People from Newcastle upon Tyne
Chicago Principles	Freedom
2015–16 Premier League	Premier League, 2015 in association football
David Ellefson	1964 births, Living people, American bass guitarists, American Christians, American musicians, Bassists, Megadeth
Super Collider (album)	2013 albums, Megadeth albums
San Marcos, California	Cities in California, Settlements in San Diego County, California, 1963 establishments in California
Trickle-down economics	Satire, Economic policy
Oceanside Municipal Airport	Airports in California, San Diego County, California
Bronx Zoo	Zoos in the United States, The Bronx
2014–15 UEFA Champions League	2014 in association football, 2015 in association football
Pulmonary contusion	Medical emergencies, Respiratory system
Endre Czeizel	1935 births, 2015 deaths, Cancer deaths in Hungary, Deaths from leukemia, Hungarian educators, Hungarian scientists, People from Budapest, Physicians
Chevrolet Tahoe	General Motors vehicles, Sport utility vehicles, Chevrolet automobiles, 1990s automobiles, 2000s automobiles, 2010s automobiles, 2020s automobiles
Bob Frankford	1939 births, 2015 deaths, Politicians from Toronto, Civil servants, People from Nottingham, Politicians from Nottinghamshire
Becky G	1997 births, Living people, American rap musicians from California, Musicians from Los Angeles County, California, Singer-songwriters from California
Eaglehawk	Towns in Victoria (Australia)
Arbiter (Halo)	Fictional characters introduced in 2004, Halo characters, Video game antagonists, Video game protagonists
Typhoon Haitang (2005)	2005 in weather, 2000s in Taiwan, Natural disasters in China, Disasters in Japan, Disasters in the 2000s, 21st century in the Philippines, Pacific typhoons, 2000s in Japan
Typhoon Soulik (2013)	2013 disasters in Asia, 2013 in weather, 2010s in China, 2010s in Japan, 2010s in Taiwan, Disasters in Japan, Disasters in Taiwan, July 2013 events, Natural disasters in China, Pacific typhoons
Gravemind	Fictional characters introduced in 2004, Halo characters, Video game antagonists
By-law	Types of law
Harda twin train derailment	2015 disasters in Asia, 2015 in India, August 2015 events, Madhya Pradesh, Railway accidents in India
Agüero	Surnames
Li Zhanshu	1950 births, Living people, Chinese communist politicians
Port Harcourt	Capital cities in Africa, Cities in Nigeria
Port Harcourt International Airport	Airports in Africa, Transport in Nigeria
Rivers State	States of Nigeria
Red River of the North	Rivers of North Dakota, Rivers of Minnesota, Rivers of Canada
Nour El-Sherif	1946 births, 2015 deaths, Deaths from myocardial infarction, Disease-related deaths in Egypt, Egyptian movie actors, Egyptian television actors, People from Cairo
Fikret Otyam	1926 births, 2015 deaths, Deaths from renal failure, Disease-related deaths in Turkey, Turkish journalists, Painters, Turkish writers
Uhaa Nation	1987 births, American professional wrestlers, African-American wrestlers, Living people, Sportspeople from Oakland, California, WWE wrestlers
Bonsall, California	Cities in California, Settlements in San Diego County, California
Indian reservation	Subdivisions of the United States
Mia Malkova	1992 births, Living people, Actors from Riverside County, California, American pornographic actors, People from Palm Springs, California
Edin Džeko	1986 births, 2014 FIFA World Cup players, Bosnia and Herzegovina footballers, Manchester City F.C. players, Living people
2012–13 Manchester City F.C. season	2012 in association football, 2013 in association football, Sport in Manchester, 2010s in Manchester, 2012 in the United Kingdom, 2013 in England
Principality of the Pindus	20th century in Greece
Demolition	Demolition
Lila Tretikov	1978 births, Living people, People from Moscow, Chief executives
Thomas Plantagenet Bigg-Wither	Writers from Hampshire, 1845 births, 1890 deaths
Fred Eckhardt	1926 births, 2015 deaths, American historians, American critics, Writers from Portland, Oregon
Harald Nielsen	1941 births, 2015 deaths, Danish footballers, Medalists at the 1960 Summer Olympics, Olympic silver medalists
David Nobbs	1935 births, 2015 deaths, Alumni of the University of Cambridge, English television writers, Humanists, Writers from Kent
The Pleasure Principle (song)	1987 songs, Janet Jackson songs, Pop songs
Excavator	Construction
Sheriff Woody	Fictional characters introduced in 1995, Kingdom Hearts characters, Toy Story characters
Ænema	1996 songs, Grammy Award winning songs
Bob Fillion	1920 births, 2015 deaths, Montreal Canadiens players, Sportspeople from Quebec, American Hockey League players
Stephen Lewis (actor)	1926 births, 2015 deaths, English television actors, English television writers, English television directors, English playwrights, Actors from London, Writers from London, Comedians from London
Jaakko Hintikka	1929 births, 2015 deaths, 20th century philosophers, 21st century philosophers, Academics, Finnish scientists, Finnish writers
IND Eighth Avenue Line	1932 establishments in the United States, 1930s establishments in New York (state)
Insolvency	Economics
Wrecking ball	Demolition
Agustín Cejas	1945 births, 2015 deaths, Deaths from Alzheimer's disease, Argentine footballers, People from Buenos Aires
Stella Hackel Sims	1926 births, Living people, Civil servants, Politicians from Vermont, People from Burlington, Vermont
Ben Crane	American golfers, 1976 births, Sportspeople from Portland, Oregon, Living people
Bagdad, Florida	Towns in Florida
Chumuckla, Florida	Towns in Florida
Dixonville, Pennsylvania	Unincorporated communities in Pennsylvania
IND Sixth Avenue Line	1940 establishments in the United States, 1940s establishments in New York (state)
2047 (number)	Integers
Colleges and universities in Hawaii	Colleges and universities in Oceania, Colleges and universities in Hawaii, Lists of colleges and universities, Hawaii-related lists
Wikitravel	MediaWiki websites, Websites established in 2003, Wikis
Chevrolet Uplander	Minivans
Juba II	50s BC births, 23 deaths, Kings and queens, Berber people
Ian Woosnam	1958 births, Living people, British golfers, Sportspeople from Shropshire, Welsh sportspeople, People from Oswestry
Empire of Brazil	Former monarchies of South America, 1822 establishments, 19th-century establishments in Brazil, 19th-century establishments in Uruguay, 1889 disestablishments, Disestablishments in South America, 1820s establishments in South America
2023 Cricket World Cup	2020s in sports, 21st century in Bangladesh, 2020s in India, Cricket World Cup, Cricket in India
Julian Bond	1940 births, 2015 deaths, African American politicians, American civil rights activists, American educators, Cardiovascular disease deaths in Florida, Politicians from Georgia (U.S. state), Politicians from Nashville, Tennessee, US Democratic Party politicians, Writers from Georgia (U.S. state), Writers from Nashville, Tennessee
George E. R. Kinnear II	1928 births, 2015 deaths, American military people, People from Oklahoma
Myrlie Evers-Williams	1933 births, Living people, American civil rights activists, Writers from Mississippi, People from Vicksburg, Mississippi
Robert Fyfe	1925 births, 2021 deaths, Scottish movie actors, Scottish television actors, Scottish stage actors
Number 1's (video)	Mariah Carey albums, Music videos and DVDs, 1999 albums
Chuck Todd	1972 births, Living people, American television presenters
High River	Towns in Alberta, 1901 establishments in North America, 1900s establishments in Canada
Evan Prodromou	Living people, 1968 births, Businesspeople from Cincinnati, Ohio
Bubba Watson	American golfers, Sportspeople from Florida, American Christians, 1978 births, Living people
The Four Horsemen of the Apocalypse (1921 movie)	1921 movies, 1920s drama movies, American silent movies, American drama movies, Historical movies, Movies based on books
Jeep Renegade	Sport utility vehicles, 2010s automobiles
All Night	1918 movies, 1910s comedy movies, 1910s drama movies, American silent movies, American comedy-drama movies
Issaquah	Towns in Washington
Issaquah Alps	Mountain ranges of the United States, Geography of Washington (U.S. state)
Squak Mountain	Geography of Washington (U.S. state), Mountains of the United States
Gangwon Province, South Korea	Provinces of South Korea
Ian Smith	1919 births, 2007 deaths, Anti-Communists, Military personnel of World War II, Prime Ministers of Zimbabwe
Takeo Fukuda	1905 births, 1995 deaths, Prime Ministers of Japan, University of Tokyo alumni
Gangwon FC	South Korean football clubs
Varangian Guard	Byzantine Empire
Samarina	Villages in Greece
Azerbaijan Supercup	Football in Azerbaijan, 1993 establishments, Football competitions, 1990s establishments in Azerbaijan
East Honolulu, Hawaii	Census-designated places in Hawaii
The Naked Truth	2005 albums, Hip hop albums
The Notorious K.I.M.	2000 albums, Hip hop albums
Hydra the Revenge	Steel roller coasters, 2005 establishments in the United States, Roller coasters by name, 2000s establishments in Pennsylvania
Bubba Trammell	1971 births, Living people, New York Yankees players
Mi querida España	1975 songs, Spanish-language songs
Arthur A. Lumsdaine	1913 births, 1989 deaths, American military personnel of World War II, American psychologists, Stanford University alumni
Bedivere	Arthurian legend, Fictional knights
Mile Mrkšić	1947 births, 2015 deaths, Colonels, European military people, People who died in prison custody, Prisoners, Serbian people, War criminals, Yugoslavian people
László Paskai	1927 births, 2015 deaths, Cardinals of the Roman Catholic Church, Hungarian Roman Catholics, Roman Catholic archbishops
Bob Johnston	1932 births, 2015 deaths, People from Hillsboro, Texas, Businesspeople from Texas, Record producers
Arsen Dedić	1938 births, 2015 deaths, Croatian people, Poets, Singer-songwriters
Eduardo Guerrero (rower)	1928 births, 2015 deaths, Argentine sportspeople, Deaths from pneumonia, People from Buenos Aires Province, Rowers
Shuja Khanzada	1943 births, 2015 deaths, Pakistani politicians, Civil servants
103 (number)	Prime numbers, Integers
Suvra Mukherjee	1940 births, 2015 deaths, Deaths from respiratory failure, Indian people
Meshulim Feish Lowy	1921 births, 2015 deaths, Canadian Jews, Deaths from pneumonia, Disease-related deaths in Quebec, Holocaust survivors, Hungarian Jews, Naturalized citizens of Canada, Rabbis
Xanthophyll	Pigments, Botany
The Road to El Dorado	American animated movies, 2000 movies, 2000 animated movies, DreamWorks Animation movies, DreamWorks Pictures movies, Internet memes, Movies set in Spain
Mad Max Beyond Thunderdome	1985 action movies, Australian movies, Warner Bros. movies, Post-apocalyptic movies, Movies directed by George Miller, Movies set in Australia, Movies set in deserts, Dystopian movies
Flagrant foul	Basketball
Joey Essex	1990 births, Living people, English autobiographers, I'm a Celebrity...Get Me Out of Here! contestants, People from Southwark (London borough), Reality show winners, Television personalities from London, The Only Way Is Essex
Brooke Astor	American centenarians, American novelists, American socialites, Businesspeople from New York, Businesspeople from New Hampshire, Deaths from pneumonia, People from Portsmouth, New Hampshire, Infectious disease deaths in New York, Writers from New Hampshire, Writers from New York, 1902 births, 2007 deaths
Jacob Bekenstein	1947 births, 2015 deaths, American physicists, Israeli academics, Israeli Jews, Israeli scientists, Jewish academics, Jewish American scientists, Jewish Wolf Prize winners, Mexican Jews, Naturalized citizens of Israel, Naturalized citizens of the United States, Scientists from Mexico City, Princeton University alumni, Theoretical physicists
Gerhard Mayer-Vorfelder	1933 births, 2015 deaths, People from Mannheim, Politicians from Baden-Württemberg, Politicians of the Christian Democratic Union of Germany, Sportspeople from Baden-Württemberg
Hotter Than July	1980 albums, R&B albums, Soul albums, Funk albums
Killing Me Softly	1973 albums, Blues albums, Soul albums, R&B albums
Dina Carroll	1968 births, Living people, Black British musicians, Brit Award winners, British R&B musicians, British soul musicians, Musicians from Suffolk, Musicians from London
Khaled Asaad	1934 births, 2015 deaths, Archaeologists, Murders by blade weapons, People murdered in Syria, Syrian people
Louis Stokes	1925 births, 2015 deaths, African American politicians, American military personnel of World War II, Cancer deaths in Ohio, Deaths from brain cancer, Deaths from lung cancer, Military people from Ohio, Politicians from Cleveland, Ohio, United States representatives from Ohio, US Democratic Party politicians
El Dorado	Fictional locations, Mythology, History of South America
Mayor of New York City	Mayors of New York City
Lawrence Lessig	2016 United States presidential candidates, 1961 births, Living people, American educators, American political activists, Writers from South Dakota, Politicians from South Dakota, American bloggers
Kosi Zone	Zones of Nepal
Sagarmatha Zone	Zones of Nepal
Geography of Nepal	Geography of Nepal
Janakpur Zone	Zones of Nepal
Bagmati Zone	Zones of Nepal
List of people from Vancouver	People from Vancouver, Lists of Canadian people
Point Grey Secondary School	British Columbia, Schools in Canada
Monmouth County, New Jersey	Monmouth County, New Jersey, 1683 establishments in New Jersey
Santa Clarita, California	Cities in California, Settlements in Los Angeles County, California, 1987 establishments in California
Mission Hills, Los Angeles	Neighborhoods of Los Angeles
Shadow Hills, Los Angeles	Neighborhoods of Los Angeles
Lev Durov	1931 births, 2015 deaths, Actors from Moscow, Russian movie actors, Russian stage actors
Joseph G. Hakobyan	1931 births, Living people, Russian scientists, Golden Idea national award winners
Lina Morgan	1937 births, Actors from Madrid, Spanish movie actors, Spanish stage actors, Spanish television actors
Suharno (footballer)	1959 births, 2015 deaths, Indonesian people, Football managers
LGBT rights in Afghanistan	LGBT rights by country, Afghan society and culture
Wang Dongxing	1916 births, 2015 deaths, Chinese communist politicians, Civil servants
Harry Volkman	Emmy Award winners, 1926 births, 2015 deaths, Deaths from respiratory failure, Scientists from Chicago, Scientists from Massachusetts, Scientists from Oklahoma
Tony Amendola	1944 births, Living people, American movie actors, American television actors, American stage actors, American voice actors, Actors from New Haven, Connecticut
Anger Management (movie)	2003 comedy movies, American comedy movies, Movies set in New York City, Movies directed by Peter Segal
Airbourne	Australian musical groups, People from Victoria (Australia), 2003 establishments, 2000s establishments in Australia, Musical groups established in 2003
Love?	Jennifer Lopez albums, 2011 albums, Dance pop albums, Hip hop albums, R&B albums
Dance Again... the Hits	Jennifer Lopez albums, Greatest hits albums, 2012 albums, Dance albums, Latin pop albums, R&B albums
A.K.A. (album)	2014 albums, Jennifer Lopez albums, Pop albums, Hip hop albums, R&B albums
Baltasound	Villages in Scotland, Shetland
Latin house	Music genres, Latin music, Dance music
Straight Outta Compton (movie)	2015 drama movies, 2010s biographical movies, 2010s crime drama movies, American biographical movies, American crime drama movies, American musical movies, English-language movies, Movies about drugs, Movies set in Los Angeles, California, Movies set in the 1980s, Movies set in the 1990s, Universal Pictures movies, Movies directed by F. Gary Gray
So Close	1993 albums, Debut albums, Dance albums, R&B albums, Soul albums
Only Human	1996 albums, R&B albums, Soul albums
The Female Boss	2012 albums, Debut albums, Tulisa, Dance albums, Hip hop albums, R&B albums
Grime (music)	United Kingdom, Music, Music genres, British music, Electronic dance music
Studio City, Los Angeles	Neighborhoods of Los Angeles
Dancehall	Music genres, Reggae music
Tarzana, Los Angeles	Neighborhoods of Los Angeles
No Me Ames	1999 songs, Jennifer Lopez songs
Waiting for Tonight	1999 songs, Jennifer Lopez songs, Dance songs
Feelin' So Good	1999 songs, Jennifer Lopez songs, Hip hop songs, R&B songs
Granada Hills, Los Angeles	Neighborhoods of Los Angeles
West Hills, Los Angeles	Neighborhoods of Los Angeles
Arleta, Los Angeles	Neighborhoods of Los Angeles
Christian Louboutin	1963 births, People from Paris, French fashion designers, LGBT fashion designers, French LGBT people, Footwear, Living people
Time in Chile	Time by country, Chile
Toluca Lake, Los Angeles	Neighborhoods of Los Angeles
Winnetka, Los Angeles	Neighborhoods of Los Angeles
Canoga Park, Los Angeles	Neighborhoods of Los Angeles
Sir Kay	Arthurian legend, Fictional knights
Heterosociality	Sociology
Annual average daily traffic	Traffic, Measurement
Air draft	Ship building
St. Elmo's fire	Electricity, Weather events
Arthur Morris	1922 births, 2015 deaths, Australian cricketers, Sportspeople from New South Wales
Gerry Steinberg	1945 births, 2015 deaths, British teachers, Durham, Former Labour MPs (UK), Former members of the British House of Commons for English constituencies, People from County Durham, UK MPs 1987–1992, UK MPs 1992–1997, UK MPs 1997–2001, UK MPs 2001–2005
Anna Kashfi	1934 births, 2015 deaths, British movie actors, British television actors, Indian movie actors, Indian television actors, West Bengal
Ieng Thirith	1932 births, 2015 deaths, Asian politicians, Cambodian people, Civil servants, Communist politicians, Deaths from Alzheimer's disease
Brewster, New York	Villages in New York
American Academy of Dramatic Arts	Schools in New York, 1884 establishments in the United States, Schools in California, Performing arts, 1880s establishments in New York (state), 1880s establishments in California
Soundtrack	Movie terminology, Sound
Fear of Flying (album)	2000 albums, R&B albums
Liberation (Mýa album)	2007 albums, Hip hop albums, R&B albums
Sugar & Spice (Mýa album)	2008 albums, Hip hop albums, Reggae albums, R&B albums
Jentina	1984 births, Living people, British rap musicians, English hip hop musicians, English R&B singers, English models, English singer-songwriters, Singers from Surrey, People from Woking, Roma
George Rosenkranz	1916 births, 2019 deaths, Centenarians, Hungarian scientists, Mexican scientists, People from Budapest
Louie (TV series)	American comedy-drama television series, English-language television programs
IRT Lexington Avenue Line	1904 establishments in the United States, 1900s establishments in New York (state)
Vista, California	Settlements in San Diego County, California, Cities in California, 1963 establishments in California
Palomar College	Colleges and universities in California
Cal State San Marcos (NCTD station)	North County Transit District stations, 2008 establishments in California
Jentina (album)	2005 albums, Debut albums, Hip hop albums, R&B albums, Virgin Records albums
Winter Gardens, California	Census-designated places in California, Settlements in San Diego County, California
French Kisses	2004 songs, Jentina songs, Hip hop songs, Electro songs, R&B songs
Ain't It Funny (Murder Remix)	2001 songs, Hip hop songs, Hip hop soul songs, R&B songs
I'm Real (Jennifer Lopez song)	2001 songs, Jennifer Lopez songs, Hip hop songs, Hip hop soul songs, R&B songs, Billboard Rhythmic Songs number-one singles
Blurred Lines	2013 albums, Pop albums, Funk albums, Neo soul albums, Blue-eyed soul albums, R&B albums
This Used to Be My Playground	Madonna songs, 1992 songs
Exclusive (album)	2007 albums, Hip hop albums, R&B albums
Graffiti (album)	2009 albums, Dance albums, Hip hop albums, R&B albums
F.A.M.E. (album)	2011 albums, Dance albums, Hip hop albums, R&B albums
Fortune (album)	2012 albums, Dance albums, Hip hop albums, R&B albums
Hard Core	1996 albums, Debut albums, Hip hop albums
Italian Sign Language	Sign languages
British Sign Language	Sign languages, English language
French Sign Language	Sign languages, French language
Resplendent quetzal	Birds of Central America
California condor	Birds of North America, Vultures
Jörg Schneider	1935 births, 2015 deaths, Cancer deaths in Switzerland, People from Zürich, Radio personalities, Swiss stage actors, Swiss movie actors
Merl Reagle	1950 births, 2015 deaths, Deaths from pancreatitis, American inventors, Writers from New Jersey, Businesspeople from New Jersey
Mariem Hassan	1958 births, 2015 deaths, Deaths from bone cancer, Singers
Erhard Eppler	1926 births, 2019 deaths, German Lutherans, Government ministers of Germany, People from Ulm, Politicians from Baden-Württemberg, Politicians of the Social Democratic Party of Germany
Palm-nut vulture	Birds of Africa, Vultures
White-tailed eagle	Birds of Europe, Birds of Asia
German Sign Language	Sign languages, German language
La Bella Mafia	2003 albums, Hip hop albums
Dance Remixes	2006 albums, Dance albums, Hip hop albums
Ms. G.O.A.T.	2008 albums, Hip hop albums
Black Friday (Lil' Kim mixtape)	2011 albums, Hip hop albums
LGBT rights in the United Kingdom	LGBT politics in the United Kingdom, LGBT rights in the United Kingdom
Hard Core 2	2014 albums, Hip hop albums
Diamonds (song)	2012 songs, Rihanna songs, 2010s ballads, Pop songs, Electronic music, R&B songs
UK garage	Music genres, British music, Dance music
Sweet Female Attitude	R&B bands, Girl groups, English musical groups, People from Manchester, Musical groups established in 1998, 1998 establishments in England, 2002 disestablishments in the United Kingdom, Musical groups disestablished in 2002, 2000s disestablishments in England
Once Upon a Time in Mexico	2003 action movies, 2000s thriller movies, American action movies, American thriller movies, American musical movies, Columbia Pictures movies, English-language movies, Miramax movies, Movies about revenge, Sequel movies, Spanish-language movies, Mexican movies
Dorothy Kilgallen	1913 births, 1965 deaths, Drug-related deaths in the United States, Journalists from Chicago
Martin Ritt	American television actors, American movie actors, American movie directors, Actors from New York City, 1914 births, 1990 deaths
Odd abundant number	Integer sequences
77 (number)	integers
Oriental Turtle Dove	Birds of Asia, Columbiformes, National symbols of the Maldives
Elliot's pheasant	Birds of China, Phasianidae
African green pigeon	Birds of Africa, Columbiformes
Gunnison grouse	Birds of the United States, Galliformes
Greater sage-grouse	Birds of North America, Galliformes, Phasianidae
Omar Souleyman	1966 births, Living people, Syrian people, Singers
Sharon Case	American television actors, American movie actors, Actors from Michigan, 1971 births, Living people
Chatsworth, Los Angeles	Neighborhoods of Los Angeles
Jingle All The Way	1996 movies, Christmas movies, American superhero movies
Supa Dupa Fly	1997 albums, Debut albums, Hip hop albums, Hip hop soul albums, R&B albums
Miss E... So Addictive	2001 albums, Hip hop albums, Dance albums, R&B albums
Under Construction (Missy Elliott album)	2002 albums, Hip hop albums
Allery	Communes in Somme
This Is Not a Test!	2003 albums, Hip hop albums, Funk albums, R&B albums
The Cookbook	2005 albums, Hip hop albums, Soul albums, R&B albums
Respect M.E.	2006 albums, Hip hop albums, Greatest hits albums
Cees van Kooten	1948 births, 2015 deaths, Cancer deaths in the Netherlands, Deaths from esophageal cancer, Dutch footballers, Sportspeople from South Holland
Yosi Piamenta	1951 births, 2015 deaths, Cancer deaths in New York City, Jewish Israeli musicians, People from Jerusalem, Singer-songwriters
Banshee (roller coaster)	2014 establishments in the United States, Steel roller coasters, Roller coasters in Ohio, 21st-century establishments in Ohio
Seasonal breeder	Animals, Reproductive system
Companion dog	Dogs
Opistognathidae	Perciformes
Justin Wilson	1978 births, 2015 deaths, Accidental deaths in Pennsylvania, British racecar drivers, Deaths in sport, Sportspeople from Sheffield
Middlesex County, New Jersey	1683 establishments in New Jersey, Middlesex County, New Jersey
List of people from New Jersey	Lists of people by state in the United States, People from New Jersey, New Jersey-related lists
Sayreville, New Jersey	Boroughs in New Jersey, Middlesex County, New Jersey, 1876 establishments in the United States, 19th-century establishments in New Jersey
List of municipalities in New Jersey	Lists of settlements in the United States, Settlements in New Jersey
Lesser prairie chicken	Birds of the United States
Blanding's turtle	Animals of North America, Turtles
Bog turtle	Reptiles of North America, Turtles, Endangered species
Spotted turtle	Reptiles of North America, Turtles
Pygmy rabbit	Mammals of North America, Lagomorphs
San'yō region	Geography of Japan
Stimulus (psychology)	Psychology
Da Real World	1999 albums, Hip hop albums, R&B albums
Riccardo III	operas
Christina Milian (album)	2001 albums, 2002 albums, Debut albums, Christina Milian albums, Pop albums, Dance albums, R&B albums
It's About Time (Christina Milian album)	2004 albums, Christina Milian albums, R&B albums
So Amazin'	2006 albums, Christina Milian albums, Hip hop soul albums, R&B albums
Francis Sejersted	1936 births, 2015 deaths, Disease-related deaths in Norway, Norwegian academics, Norwegian Nobel Committee, People from Oslo
Ole Danbolt Mjøs	1939 births, 2013 deaths, Norwegian physicians, Norwegian politicians, Norwegian Nobel Committee
Thorbjørn Jagland	1950 births, Living people, Prime Ministers of Norway, University of Oslo alumni, Norwegian Nobel Committee
José María Benegas	1948 births, 2015 deaths, Cancer deaths in Spain, Civil servants, Disease-related deaths in Madrid, People from Caracas, Socialist politicians, Spanish politicians, Spanish socialists
Make America Great Again	Political slogans, Ronald Reagan, Donald Trump
List of people from Los Angeles	People from Los Angeles, California, California-related lists, Lists of people from California
Mexican Canadians	Ethnic groups in Canada
Middlesex, New Jersey	Boroughs in New Jersey, Middlesex County, New Jersey, 1913 establishments in the United States, 20th-century establishments in New Jersey
Itaipu Dam	Dams, Buildings and structures in Brazil, Paraguay, Seven Wonders of the Modern World
La Llorona	Folklore, Mexican culture
Guri Dam	Dams, Venezuela
Mark Twain National Forest	Ozarks
Che'Nelle	1983 births, Living people, Australian singer-songwriters, Entertainers from Perth, Western Australia, Malaysian people, Naturalised citizens of Australia, R&B musicians
Rus' (people)	Russian people, History of Russia
Monarchy of Norway	History of Norway
Old Bridge Township, New Jersey	Townships in New Jersey, Middlesex County, New Jersey
Super Bass	2011 songs, Nicki Minaj songs, Pop songs, Dance songs, Hip hop songs
Phoenix, Sayreville, New Jersey	Neighborhoods in the United States, Settlements in New Jersey, Middlesex County, New Jersey
Dovrefjell	Mountain ranges, Mountains of Norway
Murders of Alison Parker and Adam Ward	2015 murders in the United States, 2010s in Virginia, Murder-suicides in the United States
Conrad Veidt	1893 births, 1943 births, Actors from Berlin, British movie actors, Cardiovascular disease deaths in Los Angeles, Deaths from myocardial infarction, German military personnel of World War I, German movie actors, Naturalised citizens of the United Kingdom, Refugees from Nazism, Silent movie actors
A.D. Grover	Musicians from Boston, Massachusetts, 1865 births, 1927 deaths
Frankie Muse Freeman	1916 births, 2018 deaths, African American lawyers, American centenarians, American civil rights activists, Civil servants, People from Virginia
Charles Evers	1922 births, 2020 deaths, American civil rights activists, American mayors, Politicians from Mississippi, Businesspeople from Mississippi, US Republican Party politicians
Piermario Morosini	1986 births, 2012 deaths, Italian footballers, Sportspeople from Lombardy
Natural fibre	Fibers
Synthetic fabric	Chemical compounds
Threshing	Grains
Temple of All Religions	Buildings and structures in Russia, Tatarstan
Kongesangen	Norwegian royalty, National anthems
Universal City, California	1910s establishments in California, 1915 establishments in the United States, Unincorporated communities in California, Settlements in Los Angeles County, California
Piscataway, New Jersey	Townships in New Jersey, Middlesex County, New Jersey
Atlantic County, New Jersey	1837 establishments in the United States, New Jersey counties, 19th-century establishments in New Jersey
Transfer case	Automotive technologies
Brooke Valentine	1984 births, Living people, African-American singers, American R&B singers, Hip hop musicians, Singers from Houston, Texas
Peter Kern	1949 births, 2015 deaths, Actors from Vienna, Austrian movie actors, Austrian movie directors, Austrian movie producers, Austrian screenwriters, Movie editors, Writers from Vienna
Reign Over Me	2007 comedy-drama movies, American comedy-drama movies, Buddy movies, Columbia Pictures movies, English-language movies, Movies set in New York City
Darryl Dawkins	1957 births, 2015 deaths, African-American basketball players, Cardiovascular disease deaths in the United States, Deaths from myocardial infarction, Detroit Pistons players, Disease-related deaths in Pennsylvania, New Jersey Nets players, Philadelphia 76ers players, Sportspeople from Orlando, Florida, Utah Jazz players, National Basketball Association high school draftees, American basketball players
Brittany Furlan	1986 births, Comedians from Pennsylvania, American Internet celebrities, Living people
Magna Carta Holy Grail	2013 albums, Rap music, Jay Z
Katie Green	1987 births, English models, Living people
1001 (number)	Integers
144 (number)	Integers, Square numbers
Chain Letter (album)	2005 albums, Debut albums, R&B albums, Pop albums, Hip hop albums
Józef Wesołowski	1948 births, 2015 deaths, Ambassadors of Poland, Polish Roman Catholics, Roman Catholic bishops
Al Arbour	1932 births, 2015 deaths, American Hockey League players, Chicago Blackhawks players, Detroit Red Wings players, International Hockey League (1945–2001) players, Jack Adams Award winners, People with Parkinson's disease, Sportspeople from Toronto, Toronto Maple Leafs players, Ontario Hockey League players, Eastern Hockey League players, Ice hockey defencemen
Auld Lang Syne	Poems
Neville Marriner	1924 births, 2016 deaths, English musicians, Conductors, Violinists
Claude LaForge	1936 births, Canadian ice hockey left wingers, Detroit Red Wings players, Ice hockey people from Quebec, Living people, Montreal Canadiens players, Philadelphia Flyers players, American Hockey League players, International Hockey League (1945–2001) players, Central Professional Hockey League players
Joan Garriga	1963 births, 2015 deaths, Drug dealers, Road accident deaths in Spain, Sportspeople from Barcelona
10001 (number)	integers
Universal health care	Health care
Parental leave	Labor
Race and crime in the United States	Crime in the United States
Teresa Gorman	1931 births, 2015 deaths, Former Conservative MPs (UK), Former members of the British House of Commons for English constituencies, Politicians from London, Women politicians
Governor of Vermont	Governors of Vermont
Janet Montgomery	1985 births, English actors, Living people
Botsmark	Settlements in Vasterbotten County
Nödinge Church	Church of Sweden churches, 1727 establishments, 18th century establishments in Sweden, 1720s establishments in Europe
Salem (TV series)	2014 American television series debuts, Drama television series, English-language television programs
Colin Friels	1952 births, Living people, Actors from Melbourne, Australian movie actors, Australian stage actors, Australian television actors, Cancer survivors
Solar Impulse	Aircraft
List of Russian Monarchs	Lists of people, Russian royalty
Dream Street (Janet Jackson album)	1984 albums, Janet Jackson albums, Pop albums, R&B albums
Janet Jackson's Rhythm Nation 1814	1989 albums, Janet Jackson albums, Dance pop albums, New jack swing albums, R&B albums
Janet.	1993 albums, Janet Jackson albums, New jack swing albums, R&B albums
All for You (Janet Jackson album)	2001 albums, Janet Jackson albums, Hip hop albums, R&B albums
Damita Jo	2004 albums, Janet Jackson albums, Hip hop albums, Funk albums, R&B albums
In Person	2001 albums, Debut albums, UK garage albums, R&B albums
North Hollywood, Los Angeles	Neighborhoods of Los Angeles
Ventura County, California	Ventura County, California, 1872 establishments in the United States, 1870s establishments in California
Boomerang (Six Flags St. Louis)	2013 establishments in the United States
Six Flags Hurricane Harbor	Six Flags, 1995 establishments in the United States
Bedford, Texas	Settlements in Tarrant County, Texas, Cities in Texas
Parlin, New Jersey	Neighborhoods in the United States, Unincorporated communities in New Jersey, Middlesex County, New Jersey
Sayreville Station, New Jersey	Neighborhoods in the United States, Settlements in New Jersey, Middlesex County, New Jersey
Sayreville Junction, New Jersey	Neighborhoods in the United States, Settlements in New Jersey, Middlesex County, New Jersey
Bart Cummings	1927 births, 2015 deaths, Horse racing, Order of Australia, People from Adelaide, Sportspeople from South Australia
Kyle Jean-Baptiste	1993 births, 2015 deaths, Accidental deaths from falls in the United States, Accidental deaths in New York City, Actors from New York, African American actors, American stage actors
Edd Byrnes	1932 births, 2020 deaths, Deaths from stroke, Cardiovascular disease deaths in California, American movie actors, American television actors, American stage actors, Actors from New York City, Singers from New York City
Karlie Kloss	1992 births, Living people, Models from Chicago, People from St. Louis, Missouri
LGBT rights in New Zealand	LGBT rights by country
Age Ain't Nothing But a Number	1994 albums, Debut albums, Aaliyah albums, Hip hop albums, New jack swing albums, R&B albums
One in a Million (Aaliyah album)	1996 albums, Aaliyah albums, Hip hop soul albums, R&B albums
Aaliyah (album)	2001 albums, Aaliyah albums, R&B albums
Tewksbury Township, New Jersey	Townships in New Jersey, Hunterdon County, New Jersey
North Hills, Los Angeles	Neighborhoods of Los Angeles
NoHo Arts District, Los Angeles	Neighborhoods of Los Angeles
I Care 4 U	2002 albums, Greatest hits albums, Aaliyah albums, New jack swing albums, Soul albums, R&B albums
Drivetrain	Automotive technologies
Traction (engineering)	Physics
Stockholm Arlanda Airport	1962 establishments in Sweden, Airports in Sweden, Buildings and structures in Sweden
Hal Smith (actor)	1916 births, 1994 deaths, American movie actors, American radio actors, American television actors, American voice actors, Actors from Michigan, American military personnel of World War II, Cardiovascular disease deaths in Los Angeles County, California, Deaths from myocardial infarction
Ghost Stories	Coldplay albums, 2014 albums
Wayne Dyer	1940 births, 2015 deaths, Deaths from leukemia, Writers from Hawaii, Businesspeople from Hawaii, Businesspeople from Detroit, Michigan, People from Maui, Writers from Detroit, Michigan
Nelson Shanks	1937 births, 2015 deaths, American painters, Artists from New York, Cancer deaths in Pennsylvania, Deaths from prostate cancer, People from Rochester, New York
Dance/Mix Show Airplay	Billboard charts
Rhythmic Songs Chart	Billboard charts
Ultimate Aaliyah	2005 albums, Greatest hits albums, Aaliyah albums, Hip hop soul albums, New jack swing albums, R&B albums
Hugo Rasmussen	1941 births, 2015 deaths, Bassists, Danish musicians, Jazz musicians
Edward Fadeley	1929 births, 2015 deaths, Deaths from heart failure, American judges, Politicians from Missouri, Politicians from Oregon
Bone Wars	American paleontologists, Dinosaurs of North America
John Spellman	1926 births, 2018 deaths, Deaths from pneumonia, Disease-related deaths in Washington (state), Accidental deaths from falls in the United States, Governors of Washington, Politicians from Seattle, Washington, US Republican Party politicians
Daniel J. Evans	1925 births, Living people, American Calvinists, Congregationalists, Governors of Washington, Politicians from Seattle, Washington, United States senators from Washington, US Republican Party politicians
Ichnology	Paleontology, Ichnology, Taxonomy
Edward Douglas-Scott-Montagu, 3rd Baron Montagu of Beaulieu	1926 births, 2015 deaths, Bisexual people, British prisoners, Disease-related deaths in Hampshire, English LGBT people, People educated at Eton College, Politicians from London
Bibb Falk	1899 births, 1989 deaths, Chicago White Sox players, Sportspeople from Austin, Texas, American baseball players
Sayre Woods, New Jersey	Neighborhoods in the United States, Settlements in New Jersey, Middlesex County, New Jersey
Sayerwood South, New Jersey	Unincorporated communities in New Jersey, Middlesex County, New Jersey
List of people from Maryland	People from Maryland, Lists of people by state in the United States
List of people from California	Lists of people from California
List of people associated with San Francisco	People from San Francisco, Lists of people from California
List of people from Missouri	Lists of people from Missouri
List of people from St. Louis	People from St. Louis, Missouri, Lists of people from Missouri
List of people from Springfield, Missouri	People from Springfield, Missouri, Lists of people from Missouri
Eureka, Missouri	Cities in Missouri
St. Louis County, Missouri	1812 establishments in Missouri Territory, Missouri counties
List of people from St. Joseph, Missouri	People from St. Joseph, Missouri, Lists of people from Missouri
List of people from Columbia, Missouri	Lists of people from Missouri
List of people from Kansas City, Missouri	Lists of people from Missouri, People from Kansas City, Missouri
List of people from Sedalia, Missouri	Lists of people from Missouri
List of people from Long Beach, California	People from Long Beach, California, Lists of people from California
List of people from Chula Vista, California	Lists of people from California
List of people from Orange County, California	People from Orange County, California, Lists of people from California
List of people from San Diego, California	People from San Diego, California, Lists of people from California
List of people from Teaneck, New Jersey	People from Teaneck, New Jersey
Deaths in September 2015	2015 deaths, September 2015 events
Julián Pastor	1943 births, 2015 deaths, Mexican movie directors, Mexican movie actors, Mexican screenwriters, Photographers, Writers from Mexico City
Gurgen Dalibaltayan	1926 births, 2015 deaths, Armenian people, Generals, Soviet military people
Alan Menken	1949 births, American movie score composers, Living people, Best Original Song Academy Award-winning songwriters, Writers from New York City, Academy Award winning composers, Grammy Award winners, Tony Award winning actors, Emmy Award winners
Playtime Is Over (mixtape)	2007 albums, Hip hop albums, Hip hop soul albums, R&B albums, Mixtape albums, Nicki Minaj albums
Sucka Free	2008 albums, Hip hop albums, Dance albums, R&B albums, Mixtape albums, Nicki Minaj albums
Beam Me Up Scotty (mixtape)	2009 albums, Hip hop albums, Electronica albums, R&B albums, Mixtape albums, Nicki Minaj albums
M. M. Kalburgi	1938 births, 2015 deaths, Indian academics, Indian murder victims, Indian writers, Murders by firearm, People murdered in India
Harry Hughes	1926 births, 2019 deaths, Deaths from pneumonia, Governors of Maryland, US Democratic Party politicians
In My Mind	2006 albums, Debut albums, Hip hop albums, Pharrell Williams, R&B albums
Basic Instinct (album)	2010 albums, Ciara albums, Dance albums, Hip hop albums, R&B albums
List of people from Arizona	Musical groups from Arizona, Lists of people by state in the United States, People from Arizona
List of people from Colorado	Lists of people by state in the United States, People from Colorado
List of people from Texas	Lists of people by state in the United States, People from Texas
Sustainable Development Goals	Sustainability, Development, United Nations
Mylo Xyloto	2011 albums, Coldplay albums
Antonio Nirta	1919 births, 2015 deaths, Mobsters, People from Calabria
Aleksandar Stipčević	1930 births, 2015 deaths, Archaeologists, Croatian writers, Historians, Croatian scientists
Willy Stähle	1954 births, 2015 deaths, Dutch Olympic gold medalists, Dutch Olympic silver medalists, Medalists at the 1972 Summer Olympics, Olympic silver medalists, Sportspeople from Amsterdam
Japandroids	Canadian rock bands, Indie rock bands, Musical duos, Musical groups established in 2006, 2006 establishments in Canada
Opus isodomum	Construction, Architectural elements
Vasto	Settlements in Abruzzo, Towns in Italy
VH1 Storytellers (Kanye West album)	2010 albums, Kanye West albums, Hip hop albums, R&B albums
The Alesha Show	2008 albums, 2009 albums, Alesha Dixon albums, Funk albums, Soul albums, R&B albums
Victor Navasky	1932 births, Living people, American educators, Journalists from New York City, Writers from New York City
Dave Foley	1963 births, Living people, Actors from Ontario, Canadian movie actors, Canadian stand-up comedians, Canadian television actors, Canadian television directors, Canadian television producers, Canadian television writers, Canadian voice actors, Comedians from Ontario
Dean Jones (actor)	1931 births, 2015 deaths, Actors from Alabama, American movie actors, American stage actors, American television actors, American voice actors, Deaths from Parkinson's disease, Disease-related deaths in Los Angeles, Singers from Alabama
Cinderella Man	2005 drama movies, 2000s biographical movies, 2000s sports drama movies, American biographical movies, American sports drama movies, English-language movies, Miramax movies, Movies directed by Ron Howard, Movies set in New Jersey, Movies set in New York City, Movies set in the 1920s, Movies set in the 1930s, Universal Pictures movies
Michael Wenning	1935 births, 2011 deaths, American Presbyterians, Cancer deaths in California, Christian ministers, Deaths from leukemia, Deaths from renal failure, Naturalized citizens of the United States, New York University alumni, People from Cape Town, White South African people
Boomer Castleman	1945 births, 2015 deaths, American country musicians, American guitarists, American pop singers, Cancer deaths in Tennessee, Musicians from Dallas, Texas, Musicians from Los Angeles, California, Singer-songwriters from New York, Singer-songwriters from Texas
Ken Cuccinelli	1968 births, Living people, Politicians from New Jersey, Politicians from Virginia, US Republican Party politicians
George Ariyoshi	1926 births, Living people, Governors of Hawaii, Politicians from Honolulu, US Democratic Party politicians, Lieutenant Governors of Hawaii
Charles Gyamfi	1929 births, 2015 deaths, Football managers, Ghanaian footballers, People from Accra
Aleksander Mandziara	1940 births, 2015 deaths, Polish football managers, Polish footballers
Mis-Teeq	1999 establishments in England, 2005 disestablishments in England, British girl groups, English musical groups, Musical groups established in 1999, Musical groups disestablished in 2005, Musical groups from London, R&B bands
Jeremy Corbyn	1949 births, Living people, Jeremy Corbyn, Animal rights activists, British anti–Iraq War activists, British atheists, British cyclists, British feminists, Chippenham, Democratic socialists, English activists, Environmentalists, Human rights activists, Labour MPs (UK), Leaders of the Labour Party (UK), Leaders of the Opposition (United Kingdom), LGBT rights activists, Members of the British House of Commons for English constituencies, People from Wiltshire, Politicians from London, Privy Councillors (UK), Trade unionists, UK MPs 1983–1987, UK MPs 1987–1992, UK MPs 1992–1997, UK MPs 1997–2001, UK MPs 2001–2005, UK MPs 2005–2010, UK MPs 2010–2015, UK MPs 2015–2017, UK MPs 2017–2019, UK MPs 2019–, Vegetarians
Ashley Madison	Websites established in 2001, Websites
Alejandro Maldonado	1936 births, Living people, Presidents of Guatemala
Simo Salminen	1932 births, 2015 deaths, Finnish movie actors, Comedians
List of people from Montclair, New Jersey	People from Montclair, New Jersey, Lists of American people, New Jersey-related lists
List of people from Union City, New Jersey	Lists of American people, People from Union City, New Jersey, New Jersey-related lists
Ora (Rita Ora album)	2012 albums, Debut albums, Pop albums, Dance albums, R&B albums, Rita Ora
Leon Gorman	2015 deaths, 1934 births, American philanthropists, Cancer deaths in the United States, Disease-related deaths in Maine, Businesspeople from Maine, Businesspeople from New Hampshire, People from Nashua, New Hampshire
Jean-Luc Préel	1940 births, 2015 deaths, French politicians, People from Caen
Graham Brazier	1952 births, 2015 deaths, Deaths from myocardial infarction, Entertainers from North Island, People from Auckland, Pop musicians, Rock musicians, Songwriters
Ancient Egyptian royal titles	Ancient Egypt
Wilfred de Souza	1927 births, 2015 deaths, Disease-related deaths in India, Indian politicians, Roman Catholics
Geoffrey Bolton	1931 births, 2015 deaths, Alumni of the University of Oxford, Australian academics, Australian educators, Australian writers, Australian historians, Order of Australia, People from Perth, Western Australia
Giya Kancheli	1935 births, 2019 deaths, People from Tbilisi, Composers
Lady Saw	1972 births, Jamaican people, Reggae musicians, Living people
Chandra Bahadur Dangi	1939 births, 2015 deaths, Deaths from pneumonia, Infectious disease deaths in the United States, Nepalese people, People with dwarfism, World record holders
Jet d'Eau	Jet d'eau de Genève, Geneva, Fountains
Mr. Freeze (roller coaster)	1998 establishments in the United States, Buildings and structures in Missouri, Roller coasters in Texas, 1990s establishments in Texas
Unbreakable (Janet Jackson album)	2015 albums, Janet Jackson albums, R&B albums
Rico Rodriguez (musician)	1934 births, 2015 deaths, Cuban musicians, People from Havana, People from Kingston, Jamaica
Zhang Zhen (general)	1914 births, 2015 deaths, Chinese generals, Centenarians, Communists
Chi Haotian	1929 births, Living people, Chinese communist politicians, Chinese generals, Government ministers
Li Yuan-tsu	1923 births, 2017 deaths, Deaths from renal failure, Chinese politicians, Vice presidents
Robert Davi	1953 births, Living people, Actors from Queens, Actors who played Bond villains, American movie actors, American television actors, Movie directors from New York City, Movie producers from New York City, Musicians from Queens, Screenwriters from New York City, Singers from New York City, Writers from Queens
Château de Chaumont	Castles in France, 10th century establishments in Europe, Establishments in France
Aadesh Shrivastava	1964 births, 2015 deaths, Cancer deaths in India, Indian singers, Movie score composers, Bollywood playback singers
David Fonseca (politician)	1954 births, 2015 deaths, Belizean politicians, Business people, Mayors, Politicians who committed suicide, Suicides by firearm
Pavel Nakhimov	1802 births, 1855 deaths, Admirals, Russian military people, Order of the Bath, Recipients of the Order of the White Eagle (Poland)
J. T. Walsh	1943 births, 1998 deaths, Actors from San Francisco, American movie actors, American television actors, Cardiovascular disease deaths in California, Deaths from myocardial infarction
Brentor	Villages in Devon, West Devon
Sylvie Joly	1934 births, 2015 deaths, Actors from Paris, Cardiovascular disease deaths in France, Deaths from myocardial infarction, French comedians, French movie actors, People with Parkinson's disease
Wiki farm	Websites, Wikis
Il Guarany	operas
Helvellyn	operas
Alpine climate	Köppen climate classifications
Gliese 667 Cc	Exoplanets
Poison (Rita Ora song)	2015 songs, Dubstep songs, House songs, R&B songs, Rita Ora songs
Alan Steel	1935 births, 2015 deaths, Actors from Rome, Italian movie actors
Philistines	Ethnic groups in Israel, Ancient Israel and Judah, Pejoratives
Brianna Lea Pruett	1983 births, 2015 deaths, American singer-songwriters, American painters, American poets, Singers from Sacramento, California, Writers from Sacramento, California, Musicians from California
Eric Stuart	1967 births, Living people, American voice actors, American guitarists, American singers, American songwriters, Actors from Brooklyn, Musicians from Brooklyn
Billy Bletcher	1894 births, 1979 deaths, Actors from Pennsylvania, American movie actors, American stage actors, American television actors, American voice actors, Vaudeville performers
Christopher Awdry	1940 births, Living people, British children's writers
Ben Kuroki	1917 births, 2015 deaths, American military personnel of World War II, People from Nebraska
Adrian Cadbury	1929 births, 2015 deaths, 1952 Summer Olympics, Alumni of the University of Cambridge, English businesspeople, Olympians, People educated at Eton College, Rowers, Sportspeople from Birmingham
Python molurus	Snakes, Pythons
Radioactive (Rita Ora song)	2012 songs, Dance songs, House songs, R&B songs, Rita Ora songs
Lawrence Lessig 2016 presidential campaign	2016 United States presidential campaigns
Jimmy McMillan	1946 births, Living people, African-American people, American military personnel of the Vietnam War, American political activists, Politicians from Florida, 2012 United States presidential candidates, 2016 United States presidential candidates, US Republican Party politicians, Politicians from New York City
Desert climate	Köppen climate classifications, Climate, Deserts
Ralph Milne	1961 births, 2015 deaths, Deaths from liver disease, Disease-related deaths in Scotland, People from Dundee, Scottish footballers
Judy Carne	1939 births, 2015 deaths, Deaths from pneumonia, English movie actors, English stage actors, English television actors, Entertainers from Northamptonshire, Infectious disease deaths in England, People from Northampton
EBCDIC	Computer file formats
Calvin J. Spann	1924 births, 2015 deaths, American military personnel of World War II, People from New Jersey
Martin Milner	1931 births, 2015 deaths, American movie actors, American television actors, American stage actors, Actors from Detroit, Michigan
Romain Rolland	1866 births, 1944 deaths, French essayists, French Nobel Prize winners, French novelists, French playwrights, People from Bourgogne-Franche-Comté
Shahbazpur Union, Sarail	Settlements in Bangladesh
G. Gordon Liddy	1930 births, 2021 deaths, Deaths from Parkinson's disease, American lawyers, Criminals from New York City
Candida Royalle	1950 births, 2015 deaths, Actors from New York City, American movie directors, American pornographic actors, American sex industry businesspeople, Deaths from ovarian cancer, Movie directors from New York City, Movie producers from New York City, Pornographic movie directors, Pornographic movie producers
UEFA Euro 2016 qualifying Group A	2015 in association football, UEFA Euro 2016
Ziynet Sali	1975 births, Living people, Pop singers
Follow the Leader (Korn album)	1998 albums
Fraggle Rock	1983 television series debuts, 1987 television series endings, 1980s American television series, 1980s British television series, 1980s Canadian television series, American children's television series, British children's television series, Canadian children's television series, English-language television programs
Roger Craig Smith	American voice actors
Human genetics	Genetics, Humans, Physical anthropology
Wadj-wer	Egyptian gods and goddesses
Aida (musical)	Musicals
Preschool	Children, Education
Sanday, Orkney	Orkney
Pieter van den Hoogenband	1978 births, Living people, Dutch Olympic bronze medalists, Dutch Olympic gold medalists, Dutch Olympic silver medalists, Medalists at the 2000 Summer Olympics, Medalists at the 2004 Summer Olympics, People from Maastricht, Sportspeople from Limburg (Netherlands), Swimmers
Andrew Kohut	1942 births, 2015 deaths, Deaths from leukemia, Scientists from New Jersey, People from Jersey City, New Jersey
Joost Zwagerman	1963 births, 2015 deaths, Dutch essayists, Dutch poets, People from Alkmaar, Writers from North Holland, Writers who committed suicide
The Late Show with Stephen Colbert	2015 American television series debuts, 2010s American television series, American comedy television series, American television talk shows, CBS network shows, English-language television programs
Jon Batiste	1986 births, Living people, American educators, Singers from Louisiana, Musicians from Louisiana
List of languages by number of native speakers	Language-related lists
Susan Allen (musician)	1951 births, 2015 deaths, Deaths from brain cancer, Disease-related deaths in the United States, Musicians from California
Edward Upward	English novelists, 1903 births, 2009 deaths, Communists
Revenge	Violence
Richard G. Hewlett	1923 births, 2015 deaths, American historians, American military personnel of World War II, Harvard University alumni, Military people from Ohio, People from Toledo, Ohio, Scientists from Ohio, University of Chicago alumni
Queen Rania of Jordan	1970 births, Living people, Kings and Queens consort of Jordan, Recipients of the Decoration for Services to the Republic of Austria, People from Tulkarm
Will Provine	1942 births, 2015 deaths, American historians, American biologists, Cancer deaths in New York, Deaths from brain cancer, Scientists from Nashville, Tennessee, University of Chicago alumni
List of Jordanian consorts	Kings and Queens consort of Jordan
Dina bint Abdul-Hamid	1929 births, People from Cairo, Kings and Queens consort of Jordan, 2019 deaths
Tasmannia	Spices, Magnoliopsida
Tacuinum sanitatis	Health
Rapa Nui people	Ethnic groups in Oceania, Pacific islands
Humorism	History of medicine
Wrangel Island	Arctic islands, Islands of Russia, World Heritage Sites in Russia
DNA methylation	Cell biology, DNA, Developmental biology, Molecular biology, Epigenetics
Honey bee	Bees
Negev tortoise	Turtles
Diana Ross (1970 album)	1970 albums, Diana Ross, R&B albums, Soul albums
Alanine	Amino acids
Nature reserve	Natural resources, Conservation, Protected areas
University of Chicago sit-ins	Bernie Sanders, 1960s in Chicago, 1962 in the United States
Everything is Everything	1970 albums, Diana Ross, R&B albums, Soul albums
Franco Interlenghi	1931 births, 2015 deaths, Italian movie actors, Italian stage actors, Actors from Rome
Antonella Lualdi	1931 births, Living people, Italian movie actors, Italian singers, People from Beirut
Luchino Visconti	1906 births, 1976 deaths, Cardiovascular disease deaths in Italy, Deaths from stroke, Italian movie directors, Italian screenwriters
Carlo Lizzani	1922 births, 2013 deaths, Actors from Rome, Italian critics, Italian movie actors, Italian movie directors, Italian movie producers, Italian screenwriters, Italian television actors, Suicides by jumping, Writers from Rome
Whitney Dancin' Special	1986 albums, Remix albums, Whitney Houston albums, Disco albums, Dance albums, R&B albums
James E. Proctor, Jr.	1936 births, 2015 deaths, African American politicians, Cardiovascular disease deaths in Washington, D.C., Politicians from Washington, D.C.
George R. Klare	1922 births, 2008 deaths, American military personnel of World War II, American psychologists, Educators, Scientists from Minneapolis, Minnesota
List of presidents of Cuba	Presidents of Cuba, Lists of politicians
Turritopsis dohrnii	Jellyfish, Cnidarians
St. Croix River (Wisconsin–Minnesota)	Waterways, Rivers of Wisconsin, Rivers of Minnesota
Barbara Palvin	1993 births, Living people, People from Budapest, Models
Stillwater, Minnesota	Cities in Minnesota, County seats in Minnesota, 1854 establishments in the United States
Alan Purwin	1962 births, 2015 deaths, Aviation deaths, American philanthropists, People from Los Angeles, California
National Botanic Garden of Israel	Botanical gardens in Israel, Hebrew University of Jerusalem, Mount Scopus
Willi Fuggerer	1941 births, 2015 deaths, German cyclists, German Olympic bronze medalists, Medalists at the 1964 Summer Olympics, People from Nuremberg, Sportspeople from Bavaria
Antoine Lahad	1927 births, 2015 deaths, Cardiovascular disease deaths in France, Deaths from myocardial infarction, Generals, Lebanese Christians, Lebanese military people
Adrian Frutiger	1928 births, 2015 deaths, Swiss writers
Hudson, Wisconsin	Wisconsin, County seats in Wisconsin, 1840 establishments in the United States, 1840s establishments in Wisconsin Territory
River Falls, Wisconsin	Cities in Wisconsin
Doug Sahm	1941 births, 1999 deaths, Grammy Award winners, Musicians from San Antonio, Texas, Singers from San Antonio, Texas, Tejano musicians, American bluegrass musicians, American blues musicians, American guitarists, American keyboard players, American country musicians, Deaths from myocardial infarction
Yamaha DX7	Electronic musical instruments, Keyboard instruments
Kinnickinnic River (St. Croix River)	Waterways, Rivers of Wisconsin
Mecca crane collapse	2015 disasters, Accidental deaths, Mecca, 2010s in Saudi Arabia
William French Smith	1917 births, 1990 deaths, Cancer deaths in Los Angeles, American lawyers, United States Attorneys General, Politicians from New Hampshire
Dick Thornburgh	Governors of Pennsylvania, United States Attorneys General, US Republican Party politicians, 1932 births, 2020 deaths, American lawyers, Politicians from Pittsburgh, Pennsylvania
James G. Watt	1938 births, Living people, American lawyers, United States Secretaries of the Interior, Politicians from Wyoming, US Republican Party politicians
Donald P. Hodel	United States Secretaries of the Interior, United States Secretaries of Energy, US Republican Party politicians, 1935 births, Living people, Businesspeople from Portland, Oregon, Politicians from Portland, Oregon
John Rusling Block	1935 births, Living people, American lobbyists, Politicians from Illinois, United States Secretaries of Agriculture, US Republican Party politicians
Richard Edmund Lyng	1918 births, 2003 deaths, Deaths from Parkinson's disease, United States Secretaries of Agriculture, US Republican Party politicians
Malcolm Baldrige, Jr.	1922 births, 1987 deaths, Deaths in sport, United States Secretaries of Commerce, Businesspeople from Nebraska, Politicians from Nebraska, US Republican Party politicians
William Verity, Jr.	1917 births, 2007 deaths, Deaths from pneumonia, United States Secretaries of Commerce, Politicians from Ohio, US Republican Party politicians
Raymond J. Donovan	1930 births, 2021 deaths, Deaths from congestive heart failure, United States Secretaries of Labor, Politicians from New Jersey, US Republican Party politicians
Ann McLaughlin Korologos	1941 births, Living people, United States Secretaries of Labor, Politicians from New Jersey, US Republican Party politicians
Margaret Heckler	1931 births, 2018 deaths, Deaths from myocardial infarction, Cardiovascular disease deaths in Virginia, United States Secretaries of Health and Human Services, United States representatives from Massachusetts, Ambassadors of the United States to Ireland, US Republican Party politicians, Politicians from New York City
John S. Herrington	1939 births, Living people, United States Secretaries of Energy, US Republican Party politicians, Politicians from California, People from Los Angeles, California
Kenneth Duberstein	1944 births, Living people, American lobbyists, Jewish American politicians, Politicians from Brooklyn, US Republican Party politicians, White House Chiefs of Staff
David Stockman	1946 births, Living people, American Methodists, Businesspeople from Michigan, Directors of the Office of Management and Budget, Harvard University alumni, United States representatives from Michigan, US Republican Party politicians
James C. Miller III	1942 births, Living people, American economists, Directors of the Office of Management and Budget, US Republican Party politicians, Politicians from Virginia
Joseph Robert Wright, Jr.	1938 births, Living people, Directors of the Office of Management and Budget, Politicians from Tulsa, Oklahoma, US Republican Party politicians, Businesspeople from Tulsa, Oklahoma
Clayton Keith Yeutter	1930 births, 2017 deaths, Deaths from colorectal cancer, Cancer deaths in Maryland, United States Secretaries of Agriculture, United States Trade Representatives, Politicians from Nebraska, US Republican Party politicians, Officers of the New Zealand Order of Merit
William Ruckelshaus	Presidential Medal of Freedom recipients, 1932 births, 2019 deaths, US Republican Party politicians, American lawyers, Directors of the Federal Bureau of Investigation, Administrators of the United States Environmental Protection Agency, Politicians from Indianapolis, Indiana, Businesspeople from Indianapolis, Indiana, United States Deputy Attorneys General
Lee M. Thomas	1944 births, Living people, Administrators of the United States Environmental Protection Agency, Politicians from South Carolina, US Republican Party politicians
Anne Gorsuch Burford	1942 births, 2004 deaths, Cancer deaths in Colorado, Politicians from Wyoming, People from Casper, Wyoming, Administrators of the United States Environmental Protection Agency
Beryl Wayne Sprinkel	1923 births, 2009 deaths, Disease-related deaths in Chicago, Illinois, American economists, United States Council of Economic Advisers, Scientists from Chicago, Businesspeople from Chicago
Murray Weidenbaum	1927 births, 2014 deaths, American economists, United States Council of Economic Advisers, Scientists from New York City
Jarryd Hayne	1988 births, Living people, Australian rugby league players, San Francisco 49ers players, Sportspeople from Sydney
Martin Feldstein	1939 births, 2019 deaths, Cancer deaths in Massachusetts, American economists, American educators, United States Council of Economic Advisers, Scientists from New York City, Harvard University faculty
Tabachnik National Garden	Archaeological sites in Israel, Buildings and structures in Jerusalem, Caves, Mount Scopus, Parks in Israel
Background radiation	Physics, Public health
The Preacher's Wife	1996 romance movies, 1996 comedy-drama movies, 1990s romantic comedy movies, 1990s romantic drama movies, American comedy-drama movies, American romantic comedy movies, American romantic drama movies, Christmas movies, Movies directed by Penny Marshall
Lake View Terrace, Los Angeles	Neighborhoods of Los Angeles
List of districts and neighborhoods in Los Angeles	California-related lists, Neighborhoods of Los Angeles
Northern Zazaki	Iranian languages, Zazaki
Southern Zazaki	Iranian languages, Zazaki
Michael Brandon	1945 births, Living people, Actors from Brooklyn, American movie actors, American television actors
Mercury Records	American record labels, 1945 establishments in the United States
Frederick II, Holy Roman Emperor	Holy Roman Emperors, 1194 births, 1250 deaths
Norman Farberow	1918 births, 2015 deaths, American activists, American psychologists, Scientists from Pittsburgh, Pennsylvania
Moses Malone	1955 births, 2015 deaths, Atlanta Hawks players, Cardiovascular disease deaths in Virginia, Houston Rockets players, Milwaukee Bucks players, Philadelphia 76ers players, San Antonio Spurs players, Sportspeople from Virginia, Washington Wizards players, National Basketball Association players with retired numbers
Hamadryas baboon	Old World monkeys
Peter Ueberroth	1937 births, Living people, Sportspeople from Illinois, People from Evanston, Illinois
Andrew Grove	1936 births, 2016 deaths, American chief executives, Engineers from New York, Businesspeople from New York City, Deaths from Parkinson's disease, Disease-related deaths in California, Hungarian scientists, Naturalized citizens of the United States, People from Budapest, Writers from New York City
David Ho (scientist)	1952 births, Living people, Naturalized citizens of the United States, Taiwanese people, Scientists from New York, Medical researchers
Peace makers	Peace
Ted Hartley	1924 births, Living people, American movie actors, American television actors, American stage actors, American television producers, Businesspeople from Omaha, Nebraska, Actors from Omaha, Nebraska
Joint-stock company	Companies
Neutral particle	Subatomic particles
Mark Cuban	1958 births, Living people, American philanthropists, American television personalities, American movie producers, Businesspeople from Pittsburgh, Pennsylvania, Writers from Pittsburgh, Pennsylvania, American bloggers
Corneliu Vadim Tudor	1949 births, 2015 deaths, Civil servants, Deaths from myocardial infarction, Former MEPs, People from Bucharest, Romanian politicians
Brazil at the 2012 Summer Paralympics	Sport in Brazil, 2010s in Brazil, 2012 Summer Paralympics
Adam Deadmarsh	1975 births, American ice hockey players, American Olympic silver medalists, Canadian ice hockey right wingers, Colorado Avalanche players, Ice hockey people from British Columbia, Living people, Los Angeles Kings players, Portland Winterhawks players, Quebec Nordiques players, Stanley Cup champions
Éric Dazé	1975 births, Beauport Harfangs players, Canadian ice hockey left wingers, Chicago Blackhawks players, Hull Olympiques players, Ice hockey people from Quebec, Living people, Sportspeople from Montreal
Echo (Leona Lewis album)	2009 albums, Leona Lewis albums, Dance pop albums, R&B albums
Alpha Phi Alpha	Fraternities and sororities, 1906 establishments in the United States
Grace Jones	1948 births, Living people, Actresses who played Bond girls, Actors who played Bond villains, Electronic musicians, Grace Jones, Jamaican entertainers, Jamaican singers, Reggae musicians, R&B musicians
United States Botanic Garden	Botanical gardens  in the United States, Washington, D.C., 1920 establishments in the United States
Classical period (music)	Periods in music history, Musical movements
Bill Guerin	1970 births, American ice hockey players, American Olympic silver medalists, Boston Bruins players, Dallas Stars players, Edmonton Oilers players, Living people, New Jersey Devils players, New York Islanders players, People from Worcester, Massachusetts, Pittsburgh Penguins players, San Jose Sharks players, Sportspeople from Massachusetts, St. Louis Blues players, Stanley Cup champions, American Hockey League players
John J. Farrell	Businesspeople from Ohio, 1872 births, 1946 deaths, Politicians from Ohio
Bernard Van de Kerckhove	1941 births, 2015 deaths, Belgian cyclists, People from Hainaut (province), Tour de France cyclists
Meir Pa'il	1926 births, 2015 deaths, Colonels, Deaths from Alzheimer's disease, Disease-related deaths in Israel, Former Members of Knesset, Israeli historians, Israeli military people, Jewish Israeli politicians, Jewish Israeli writers, Jewish military people, People from Jerusalem
Mihai Volontir	1934 births, 2015 deaths, European politicians, Moldovan people, Movie actors
John Rodolph Slattery	1877 births, 1932 deaths, Engineers from Ohio
Pam Ferris	1948 births, Living people, Actors from Lower Saxony, People from Hanover, British movie actors, British stage actors, British television actors, British voice actors
Michael X. Mockus	1864 births, 1939 deaths, American atheists, American criminals, Christian ministers, Lithuanian people, Naturalized citizens of the United States
Cornelius, North Carolina	Towns in North Carolina
Anton Chigurh	Characters in written fiction, Fictional murderers, Movie characters
Gallstone	Disorders, Illnesses
Suvigya Sharma	1983 births, Living people, Indian painters
Moscow Pavilion	Buildings and structures in Moscow
Pink Friday	2010 albums, Debut albums, Hip hop albums, Nicki Minaj albums, R&B albums
Blue iguana	Iguania
Alfred Cotton Bedford	1863 births, 1925 deaths, People from Brooklyn
The Pinkprint	2014 albums, Hip hop albums, Nicki Minaj albums
Portfolio (Grace Jones album)	1977 albums, Debut albums, Disco albums, Grace Jones albums, R&B albums
Glassheart	2012 albums, Leona Lewis albums, Pop albums, Dubstep albums, R&B albums
Christmas, with Love	2013 albums, Leona Lewis albums, Christmas albums, Gospel albums, R&B albums
Def Jam Recordings	American record labels
2015 Illapel earthquake	2015 disasters, 2010s in Chile, Earthquakes in the 2010s, Tsunamis, 2015 in South America
Illapel	Cities in Chile
Guy Béart	1930 births, 2015 deaths, Cardiovascular disease deaths in France, Deaths from myocardial infarction, Egyptian Jews, French singers, Jewish French musicians, Musicians from Paris, People from Cairo, Singer-songwriters
Aaron Ekblad	1996 births, Calder Trophy winners, Canadian ice hockey defencemen, Florida Panthers players, Ice hockey people from Ontario, Living people, Sportspeople from Ontario, Ontario Hockey League players
Kim Kielsen	1966 births, Living people, Current national leaders, Prime Ministers of Greenland
Longyearbyen	Geography of Norway
Broad-billed moa	Birds of New Zealand, Flightless birds
Bush moa	Birds of New Zealand, Ratites, Extinct species
Rani Mukherji	1978 births, Living people, Indian movie actors
Agrahari	Surnames
Agrasena	Hindus, Legends
Pokémon Omega Ruby and Alpha Sapphire	2014 video games, Nintendo 3DS games, Pokémon RPGs, Video game remakes, Video games developed in Japan
Wesley Augustus Williams	1897 births, 1984 deaths, African-American people, Firefighters, People from Manhattan
David Willcocks	1919 births, 2015 deaths, British conductors, English composers, Entertainers from Cornwall, Organists
Milo Hamilton	1927 births, 2015 deaths, Deaths from leukemia, Sportspeople from Iowa
Adam Purple	1930 births, 2015 deaths, Deaths from myocardial infarction, American activists, People from Missouri, People from New York City
Harry J. Lipkin	1921 births, 2015 deaths, American physicists, Israeli academics, Israeli Jews, Israeli scientists, Jewish academics, Jewish American scientists, Naturalized citizens of Israel, Scientists from New York City
Miriam Margolyes	1941 births, Living people, Actors from Oxfordshire, Australian Jews, Australian LGBT people, Australian movie actors, Australian stage actors, Australian television actors, Australian voice actors, BAFTA Award winning actors, English LGBT people, English movie actors, English stage actors, English television actors, English voice actors, Jewish British actors, Lesbian Jews, Officers of the Order of the British Empire
Magda Szubanski	1961 births, Living people, Actors from Liverpool, Actors from Melbourne, Australian comedians, Australian LGBT people, Australian movie actors, Australian radio personalities, Australian stage actors, Australian television actors, Australian television presenters, Lesbians, LGBT comedians, Writers from Victoria (Australia)
Chesney Hawkes	1971 births, Living people, Actors from Berkshire, English guitarists, English pop singers, Musicians from Berkshire, Windsor, Berkshire
Øvre Årdal	Settlements in Norway, Geography of Norway
Färila	Settlements in Gavleborg County
William H. Nicholson	1869 births, 1911 deaths, African-American people, Firefighters
Mario Benjamín Menéndez	1930 births, 2015 deaths, Argentine generals, Argentine politicians, People from Buenos Aires
Logan City	Brisbane, Cities in Queensland
Vadim Kuzmin	1937 births, 2015 deaths, Academics, People from Moscow, Russian scientists, Theoretical physicists
Mishael Cheshin	1936 births, 2015 deaths, Civil servants, Israeli Jews, Judges, Naturalized citizens of Israel, People from Beirut
Fired Up (Alesha Dixon album)	2006 albums, 2008 albums, Debut albums, Alesha Dixon albums, Hip hop soul albums, Reggae albums, R&B albums, Soul albums
Anoka, Minnesota	Cities in Minnesota, County seats in Minnesota
The Entertainer (Alesha Dixon album)	2010 albums, Alesha Dixon albums, Dance albums, Hip hop albums, R&B albums
Mauritian Creole	Languages of Africa, Mauritius, Pidgins and creoles
I Am (Leona Lewis album)	2015 albums, Leona Lewis albums, Pop albums, Neo soul albums, R&B albums
Reverend Lovejoy	The Simpsons characters, Fictional characters introduced in 1990
Janet Jackson (album)	1982 albums, Janet Jackson albums, Pop albums, Funk albums, R&B albums
Minnesota Senate	Minnesota, State government in the United States
Aaron B. Rollins	US Democratic Party politicians, Politicians from New York, 1818 births, People from New York City, 1878 deaths
Masajuro Shiokawa	1921 births, 2015 deaths, Deaths from pneumonia, Japanese politicians, Civil servants, People from Osaka Prefecture
Eduardo Bonvallet	1955 births, 2015 deaths, Suicides by hanging, Chilean footballers, People from Santiago
Medical Society of New Jersey	Organizations based in the United States, 1766 establishments, 1760s establishments in the Thirteen Colonies
Bruce Djite	1987 births, Living people, Australian footballers, Sportspeople from Sydney, Sportspeople from Washington, D.C.
Takeshi Onaga	1950 births, 2018 deaths, Deaths from pancreatic cancer, Mayors, Governors of Japanese prefectures, People from Okinawa Prefecture
Peter Varghese	1956 births, Living people, Australian ministers for Foreign Affairs, Civil servants, Australian diplomats, Order of Australia
Rostam Giv	Zoroastrians, 1888 births, 1980 deaths, Iranian politicians
Radio City Cinema	Tehran, Buildings and structures in Iran, Theatres, 1958 establishments in Asia, 1979 disestablishments, 20th century establishments in Iran, 1970s disestablishments in Asia
Keikhosrow Shahrokh	1864 births, 1929 deaths, Zoroastrians, Iranian people
Hippias (tyrant)	Ancient Greeks, Ancient Athens
Strelka Institute for Media, Architecture and Design	Colleges and universities in Russia, Buildings and structures in Moscow, Architecture, Urban planning
United States National Arboretum	Botanical gardens  in the United States, Washington, D.C.
Shadow the Hedgehog	Fictional animals, Fictional characters introduced in 2001, Sonic the Hedgehog characters
Chief Wiggum	The Simpsons characters, Fictional characters introduced in 1990
Abraham Simpson	The Simpsons characters, Fictional characters introduced in 1988
Biological rhythms	Physiology
Rapid eye movement sleep	Physiology, Sleep
Biblical Museum of Natural History	Museums in Israel, 2014 establishments in Israel
Discipline (Janet Jackson album)	2008 albums, Janet Jackson albums, Island Records albums, Dance albums, Hip hop albums, R&B albums
The Monkey's Paw	English literature, Horror and fiction
Eduardo Menichetti	1950s births, 2007 deaths, Chilean businesspeople, Deaths from colorectal cancer, Disease-related deaths in Chile, People from Santiago
Alberto Parodi	Year of birth missing, Year of death missing, Chilean businesspeople
Dedrick D. Gobert	1971 births, 1994 deaths, Actors from Louisiana, American movie actors, Murdered African-American people, Murders by firearm in California, People from Shreveport, Louisiana, People murdered in California
Jack Larson	1928 births, 2015 deaths, Actors from Los Angeles, California, American composers, American movie actors, American playwrights, American television actors, American television producers, Gay men, LGBT actors, LGBT directors, LGBT producers, LGBT screenwriters, LGBT people from Los Angeles, California, Movie producers from Los Angeles, California, People from Pasadena, California, Screenwriters from Los Angeles, California
Fred DeLuca	1947 births, 2015 deaths, American billionaires, Businesspeople from New York City, Cancer deaths in Florida, Deaths from leukemia, People from Brooklyn
Review	Writing media
Survey of Pakistan	National mapping agencies, Pakistan
Fifth Amendment to the United States Constitution	United States Bill of Rights, Amendments to the United States Constitution
The Velvet Rope	1997 albums, Janet Jackson albums, Dance albums, Hip hop soul albums, R&B albums
M. F. Husain	1915 births, 2011 deaths, Cardiovascular disease deaths in London, Deaths from myocardial infarction, Indian painters, Maharashtra, Qatari people
C. K. Williams	1936 births, 2015 deaths, American critics, American poets, Cancer deaths in New Jersey, Deaths from multiple myeloma, Writers from Newark, New Jersey, Pulitzer Prize winners
Dorothea Warren O'Hara	1873 births, 1972 deaths, American artists, Ceramists, People from Kansas City, Missouri
Bill Erwin	1914 births, 2010 deaths, American movie actors, American television actors, American stage actors, Actors from Texas
Cello Suites (Bach)	Compositions by Johann Sebastian Bach, Suites
Suicide Squad (movie)	2016 movies, American action movies, Warner Bros. movies, Batman movies, Movies shot in Chicago, Illinois, Movies that won the Best Makeup Academy Award, DC Extended Universe movies, Supervillain movies, American superhero movies, 2010s superhero movies
Black Mass (movie)	2015 movies, American crime movies, Movies based on books, Movies set in Boston, Massachusetts, Movies set in the 1970s, Movies set in the 1980s
Marcin Wrona	1973 births, 2015 deaths, Polish movie directors, Polish screenwriters, Suicides by hanging, Writers who committed suicide
Farhang Mehr	1923 births, 2018 deaths, American academics, American political scientists, Iranian politicians, Naturalized citizens of the United States, People from Tehran, Zoroastrians
Girl (album)	2014 albums, Funk albums, R&B albums
Number 1 to Infinity	2015 albums, Mariah Carey albums, Pop albums, Gospel albums, R&B albums, Greatest hits albums
Il racconto della nonna	Classical music, Solo piano pieces
Yoram Gross	1926 births, 2015 deaths, Australian Jews, Australian movie directors, Australian movie producers, Holocaust survivors, Israeli businesspeople, Israeli Jews, Jewish businesspeople, Naturalised citizens of Australia, Naturalized citizens of Israel, Order of Australia, People from Kraków, Polish Jews, Television producers
Isaac Isaacs	1855 births, 1948 deaths, Attorneys General of Australia, Australian Jews, Australian judges, Disease-related deaths in Victoria (Australia), Jewish judges, Jewish lawyers, Knights Grand Cross of the Order of the Bath, Knights Grand Cross of the Order of St Michael and St George, Members of the Australian House of Representatives, Politicians from Melbourne
Armen Movsisyan	1962 births, 2015 deaths, Armenian politicians, Cancer deaths in Germany
Ahmed Mohamed clock incident	2015 in the United States, 2010s in Texas, Controversies in the United States, Islam in the United States, Islamophobia, September 2015 events
William Baker Rock	1872 births, 1922 deaths, American dancers, Cancer deaths in Pennsylvania, Comedians from Indiana, Vaudeville performers, People from Evansville, Indiana
Library of Congress Control Number	Publishing
Terry Jones (pastor)	1951 births, Living people, American Evangelicals, Christian ministers, Islamophobia, People from Missouri, 2012 United States presidential candidates, 2016 United States presidential candidates
Bright Lights (Matchbox Twenty song)	2003 songs
Unwell	2003 songs, Rock songs
Phyllis Tickle	1934 births, 2015 deaths, American Christians, American educators, Cancer deaths in Tennessee, Deaths from lung cancer, Writers from Tennessee
Johnson City, Tennessee	Cities in Tennessee
Millington, Tennessee	Cities in Tennessee
Washington Metro	Washington, D.C., 1976 establishments in the United States, Rapid transit systems in the United States, 1970s establishments in Washington, D.C.
Brigham Young University–Idaho	Colleges and universities in Idaho, 1888 establishments in the United States, 1880s establishments in Idaho Territory
Firooz Bahram High School	Buildings and structures in Iran, 1932 establishments in Asia, 20th century establishments in Iran
Pakistan Super League	Pakistan Super League, 2016 establishments in Asia, 2010s establishments in Pakistan
Yogi Berra	1925 births, 2015 deaths, American League All-Stars, American military personnel of World War II, American Roman Catholics, Deaths from natural causes in the United States, New York Mets, Major League Baseball managers, New York Mets players, New York Yankees, New York Yankees players, National Baseball Hall of Fame members, Sportspeople from St. Louis, Missouri
Mike Gibson (sports journalist)	1940 births, 2015 deaths, Australian journalists, Australian radio personalities, Australian television presenters, Columnists, People from Sydney, Suicides in Australia
Hermanns tortoises	Turtles
University of Chieti-Pescara	Colleges and universities in Italy, 1965 establishments in Europe, 1960s establishments in Italy
Odesza	Musical groups from Seattle, Washington, Electronic music bands, 2012 establishments in the United States, Musical groups established in 2012, 21st-century establishments in Washington (state)
James David Santini	1937 births, 2015 deaths, American lawyers, American lobbyists, Deaths from esophageal cancer, United States representatives from Nevada, US Democratic Party politicians
Carlos Álvarez-Nóvoa	Goya Award winners, 1940 births, 2015 deaths, Spanish actors, Spanish writers, Spanish theatre directors
Mind Body & Soul	2004 albums, Joss Stone albums, Funk albums, Soul albums, R&B albums, Virgin Records albums
Peter Stormare	1953 births, Living people, Swedish movie actors, Swedish television actors, Swedish stage actors, Voice actors
Until Dawn	2015 video games, Horror video games
Nancy Bernstein	1960 births, 2015 deaths, American movie producers, Cancer deaths in California, Deaths from colorectal cancer
Cecilia (songwriter)	1948 births, 1976 deaths, Musicians from Madrid, Road accident deaths in Spain, Singer-songwriters, Spanish singers
2015 Hajj stampede	2015 disasters, 2015 in Asia, Accidental deaths, Mecca, 2010s in Saudi Arabia, September 2015 events
Al Seckel	1958 births, 2015 deaths, American atheists, Cancer survivors, Jewish American writers, Writers from New York City, People from New Rochelle, New York
Cecilia (Simon & Garfunkel song)	1970 songs, Rock songs
150 North Riverside	Skyscrapers in Chicago
River Point	Skyscrapers in Chicago
Paul Volcker	1927 births, 2019 deaths, Deaths from prostate cancer, Cancer deaths in New York City, Chairs of the Federal Reserve, People from Teaneck, New Jersey, American economists, Harvard University alumni, Princeton University alumni
James Cross	1921 births, 2021 deaths, British politicians, Civil servants, Deaths from the COVID-19 pandemic in the United Kingdom
Elaine Tanner	1951 births, Canadian Olympic bronze medalists, Canadian Olympic silver medalists, Canadian swimmers, Living people, Sportspeople from Vancouver
Denis Sonet	1926 births, 2015 deaths, French educators, French Roman Catholics, French writers, Roman Catholic priests
Dragan Holcer	1945 births, 2015 deaths, Croatian footballers, Yugoslavian sportspeople
Sannahed	Settlements in Orebro County
Hachikō	1923 births, 1935 deaths, Individual dogs, Japanese culture
Ellis Kaut	1920 births, 2015 deaths, Disease-related deaths in Bavaria, German children's writers, German photographers, People from Munich, People from Stuttgart, Writers from Bavaria
Tony Goldwyn	American movie actors, Living people, Year of birth missing (living people), American television actors
Chemical potential	Energy
Free Speech Flag	DVD, Internet memes, Flags, Freedom
New York State Capitol	1899 establishments in the United States, 1890s establishments in New York (state), Albany, New York, Buildings and structures in New York, National Historic Landmarks of the United States
Maersk	20th century establishments in Denmark, 1904 establishments in Europe, Companies of Europe, Ships, Transport in Denmark, Copenhagen
Moti Kirschenbaum	1939 births, 2015 deaths, Israeli Jews, Israeli television presenters, Jewish entertainers
John Thomas Dooling	1871 births, 1949 deaths, American lawyers, People from Brooklyn
Ellery Cory Stowell	1875 births, 1958 deaths, American educators, People from Lynn, Massachusetts
Kevin McCarthy	1965 births, Living people, United States representatives from California, US Republican Party politicians, State legislators of the United States, Minority leaders of the United States House of Representatives, Majority leaders of the United States House of Representatives
Party leaders of the United States Senate	United States Senate
Party leaders of the United States House of Representatives	United States House of Representatives
Steve Scalise	1965 births, Living people, American crime victims, American Roman Catholics, United States representatives from Louisiana, US Republican Party politicians
Grant Teaff	1933 births, Living people, American football players, American football coaches, Sportspeople from Texas
Alfred E. Mann	1925 births, 2016 deaths, Deaths from myocardial infarction, Businesspeople from Portland, Oregon, American philanthropists
Cave of the Prophets	Mount of Olives, Buildings and structures in Jerusalem, Monuments and memorials in Israel, Burial monuments and structures
Tomb of Pharaoh's daughter	Mount of Olives, Buildings and structures in Jerusalem, Monuments and memorials in Israel, Burial monuments and structures
Bell, Book and Candle	1958 comedy movies, 1950s fantasy movies, 1950s romantic comedy movies, American fantasy movies, American romantic comedy movies, Christmas movies, Columbia Pictures movies, English-language movies, Movies about cats, Movies based on plays, Movies set in Manhattan, Witchcraft, Movies directed by Richard Quine
Richie Sambora	Singers from New Jersey, American composers, American singer-songwriters, American guitarists, Musicians from New Jersey, Writers from New Jersey, 1959 births, American Roman Catholics, People from Perth Amboy, New Jersey
Sonoma, California	Cities in California, Settlements in Sonoma County, California, Cities in the San Francisco Bay Area, 1823 establishments in North America, 19th-century establishments in California
Point Loma, San Diego	Peninsulas
San Diego City Council	Local government in the United States, San Diego, California, 1850 establishments in California
Priyanka Chopra Jonas	1982 births, Indian television actors, Indian singers, Indian movie actors, Indian movie producers, Indian voice actors, Living people, Indian models, Miss World winners
Émile Marie Laurent	1852 births, 1930 deaths, Police officers, People from Brest, France
Homa Rousta	1946 births, 2015 deaths, Cancer deaths in Los Angeles, Iranian actors, Movie actors, People from Tehran, Stage actors
Claudio Baggini	1936 births, 2015 deaths, Italian Roman Catholics, People from Rome, Roman Catholic bishops
Andrzej Duda	1972 births, Living people, Former MEPs, MEPs for Poland, People from Kraków, Polish lawyers, Presidents of Poland
Quantico (TV series)	2015 American television series debuts, 2010s American television series, American drama television series, FBI in fiction, Virginia in fiction, English-language television programs
Offa's Dyke	Anglo-Saxons, Buildings and structures in Wales, Monuments and memorials in England
Manuel Oltra	1922 births, 2015 deaths, Deaths from pneumonia, Infectious disease deaths in Spain, People from Valencia, Spanish composers
Syed Ahmed (politician)	1945 births, 2015 deaths, Cancer deaths in India, Governors of Jharkhand, Governors of Manipur
2014 FIFA World Cup Group A	2014 FIFA World Cup
Brian T. Delaney	1976 births, Living people, American singers, American voice actors, American comedians, American movie actors, American television actors, Actors from Pennsylvania, Actors from Philadelphia, Pennsylvania
Peter Kelamis	1967 births, Living people, Actors from Sydney, Actors from Vancouver, Australian comedians, Australian movie actors, Australian television actors, Australian voice actors, Canadian comedians, Canadian movie actors, Canadian television actors, Canadian voice actors
Nordic model	Socialism
Workplace democracy	Socialism
Student debt	Finance
Tuition payments	Finance
Trans-Pacific Partnership	Trade
Boston Herald	Newspapers in the United States
Politico	Newspapers in the United States, 2007 establishments in the United States
The Hill (newspaper)	Newspapers in the United States
The Burlington Free Press	Newspapers in the United States
The Boston Globe	Newspapers in the United States, 1872 establishments in the United States
Washington Examiner	Newspapers in the United States
Single-payer health care	Health care
LA Law Library	Law, Buildings and structures in Los Angeles, California, Libraries in the United States, 1891 establishments in California
Frank Tyson	1930 births, 2015 deaths, British teachers, Disease-related deaths in Queensland, English cricketers, English journalists, English sports commentators, Sportspeople from Lancashire
Siegfried Gottwald	1943 births, 2015 deaths, German mathematicians, German historians, German scientists, People from Saxony
Ton van de Ven	1944 births, 2015 deaths, Cardiovascular disease deaths in the Netherlands, Deaths from cerebral hemorrhage, Dutch artists, People from Eindhoven
Wilton Felder	1940 births, 2015 deaths, American bass guitarists, American jazz musicians, American R&B musicians, American saxophonists, Cancer deaths in California, Deaths from multiple myeloma, Musicians from Houston, Texas
Sleepless in Seattle	1993 romance movies, 1993 comedy-drama movies, 1990s romantic comedy movies, 1990s romantic drama movies, American comedy-drama movies, American romantic comedy movies, American romantic drama movies, English-language movies, Movies set in Baltimore, Maryland, Movies set in Chicago, Illinois, Movies set in New York City, Movies set in Seattle, Washington
John Sergeant Cram	1851 births, 1936 deaths, Harvard University alumni
Movius Line	Archaeology, Cutting tools, Stone Age
Gullane Entertainment	Companies of the United Kingdom, British television
The Eleventh Commandment (Ronald Reagan)	Ronald Reagan
Ignacio Zoco	1939 births, 2015 deaths, 1966 FIFA World Cup players, Disease-related deaths in Madrid, Spanish footballers
Pushback	Airports
Robin Hood Airport Doncaster Sheffield	Airports in England, South Yorkshire
Frank Martinus Arion	1936 births, 2015 deaths, Curaçao people, Dutch poets, Dutch writers
Lincoln County, South Dakota	South Dakota counties, 1867 establishments in the United States, 1860s establishments in Dakota Territory
Kallen Pokkudan	1937 births, 2015 deaths, Disease-related deaths in India, Indian politicians, Indian writers, Environmentalists
Michael Burgess (singer)	1945 births, 2015 deaths, Canadian pop singers, Canadian stage actors, Canadian television actors, Cancer deaths in Ontario, People from Regina, Saskatchewan, Singers from Toronto, Tenors
Kidron Valley necropolis	Mount of Olives, Buildings and structures in Jerusalem, Monuments and memorials
Kendall Gill	1968 births, Living people, African-American basketball players, Sportspeople from Chicago, American television presenters, People from Olympia Fields, Illinois, American basketball players
Stacey Augmon	1968 births, African-American basketball players, Basketball players from California, People from Pasadena, California, Atlanta Hawks players, Living people, Detroit Pistons players, Portland Trail Blazers players, New Orleans Hornets players, Orlando Magic players, American basketball players
20 Y.O.	2006 albums, Janet Jackson albums, Hip hop albums, Electro albums, R&B albums
Spirit (Leona Lewis album)	2007 albums, 2008 albums, Debut albums, Leona Lewis albums, Pop albums, R&B albums, Soul albums
2008 Detroit Lions season	Detroit Lions, 2008 in sports, National Football League seasons, 2008 in the United States, 2000s in Detroit, Michigan
Calvin Johnson	African American players of American football, Detroit Lions players, 1985 births, American football wide receivers
Alphabet Inc.	2015 establishments in California, 2010s establishments in California, Companies based in the San Francisco Bay Area, Companies listed on NASDAQ, Google, Multinational technology companies, Mountain View, California
Hellmuth Karasek	1934 births, 2015 deaths, Disease-related deaths in Germany, German critics, German journalists, German novelists, Literary critics, People from Brno
Frankie Ford	1939 births, 2015 deaths, American adoptees, American R&B singers, American rock singers, American pop singers, Deaths from natural causes, Singers from Louisiana
Think of the children	Figures of speech, Politics, Emotions
Húsavík	Towns in Iceland, 850s establishments, Establishments in Iceland, 9th century establishments in Europe
Lofsöngur	National anthems, Iceland
Charles Gibson	1943 births, Living people, Journalists from Illinois, People from Evanston, Illinois, Princeton University alumni, American television news anchors, Writers from Washington, D.C., Television personalities from Illinois
Regions of Iceland	Regions of Iceland
Bathory (band)	Swedish musical groups, Black metal bands, 1983 establishments in Sweden
Denise Lor	1929 births, 2015 deaths, Actors from Los Angeles, California, Actors from New York, American comedians, American movie actors, American pop singers, American radio actors, American stage actors, American television actors, Entertainers from New York, Singers from Los Angeles, California, Singers from New York
Deaths in October 2015	2015 deaths, October 2015 events
9½ Weeks	1986 drama movies, 1986 romance movies, 1980s erotic movies, 1980s romantic drama movies, American erotic movies, American romantic drama movies, BDSM in movies, English-language movies, Movies based on books, Movies directed by Adrian Lyne, Movies set in New York City
Introducing Joss Stone	2007 albums, Joss Stone albums, Hip hop albums, Soul albums, R&B albums, Virgin Records albums
David Ashby (speedway rider)	1949 births, 2015 deaths, Cancer deaths in England, Speedway riders, People from Wiltshire
Maternal insult	Slang, Cultural anthropology, Humor
Origins of the blues	Blues music
Mürwik	Flensburg
Naval Academy Mürwik	Marineschule Muerwik, Flensburg, Military schools
John Galvin (general)	1929 births, 2015 deaths, American military people, People from Massachusetts
Claude Dauphin (businessman)	1951 births, 2015 deaths, Deaths from cancer, French businesspeople
Kelly Gissendaner	1968 births, 2015 deaths, American criminals, People from Georgia (U.S. state)
Ernest Moniz	1944 births, Living people, American physicists, Politicians from Massachusetts, Scientists from Massachusetts, United States Secretaries of Energy, US Democratic Party politicians
Arrowhead Stadium	National Football League venues, Sports in Kansas City, Missouri, Kansas City Chiefs
Lieutenant governor	Government occupations
James D. Watkins	1927 births, 2012 deaths, Deaths from congestive heart failure, United States Secretaries of Energy, American military people, Scientists from California, Politicians from California, US Republican Party politicians
Deadly Relations	American crime drama movies, 1993 movies, Movies based on real life events
No Child of Mine	1997 movies, Television movies, British drama movies
Hurricane Joaquin	Hurricanes, 2015 in weather
Hadi Norouzi	1985 births, 2015 deaths, Deaths from myocardial infarction, Disease-related deaths in Iran, Iranian footballers, Mazandaran Province
Cape Fear (1962 movie)	1962 movies, 1960s thriller movies, American legal movies, American thriller movies, English-language movies, Movies about families, Movies about murderers, Movies about revenge, Movies about stalking, Movies based on books, Rape in movies, Universal Pictures movies, Movies directed by J. Lee Thompson
Pinto Colvig	1892 births, 1967 deaths, Actors from Oregon, American voice actors, Cancer deaths in Los Angeles, Deaths from lung cancer, Vaudeville performers
Cape Fear (1991 movie)	1991 crime movies, 1991 thriller movies, 1990s crime thriller movies, 1990s legal movies, American crime thriller movies, American legal movies, American movie remakes, Antisocial personality disorder in fiction, English-language movies, Movies about murderers, Movies about revenge, Movies about stalking, Movies based on books, Movies directed by Martin Scorsese, Rape in movies, Universal Pictures movies
Edith Claire Bryce	1880 births, 1960 deaths, American activists, Nonviolence advocates
Bye (sports)	Sports words
Ptolemaic dynasty	Pharaohs, Ancient Egypt
Hedjet	Ancient Egypt
Rose Livingston	1885 births, Year of death unknown, American human rights activists, American prostitutes, Slavery
Joe Wark	1947 births, 2015 deaths, Disease-related deaths in Scotland, Scottish footballers, Sportspeople from Glasgow
Jacob Pressman	1919 births, 2015 deaths, American columnists, American rabbis, Jewish American writers, Writers from Philadelphia, Pennsylvania
Max Keeping	1942 births, 2015 deaths, Canadian journalists, Canadian television presenters, Cancer deaths in Ontario, Order of Canada, People from Newfoundland and Labrador
Usnija Redžepova	1946 births, 2015 deaths, Deaths from lung cancer, Movie actors, People from Skopje, Singers, Television actors, Roma
Ricky Talan	1960 births, 2015 deaths, Cancer deaths in the Netherlands, Deaths from brain cancer, Dutch footballers, People from Katwijk, Sportspeople from South Holland
Saqqara Tablet	Ancient Egypt
Hovsta	Settlements in Orebro County
Richard W. Mallary	1929 births, 2015 deaths, Deaths from prostate cancer, United States representatives from Vermont, US Republican Party politicians, Politicians from Massachusetts, People from Springfield, Massachusetts, Cancer deaths in Vermont
Coronel Suárez	Towns in Argentina, 1882 establishments, 1880s establishments in Argentina
Eugene V. Debs	1855 births, 1926 deaths, Deaths from heart failure, Socialist politicians, Democratic socialists, Politicians from Indiana
Holly Madison	Living people, 1979 births, Models from Nevada
Ernest Deane	1887 births, 1915 deaths
Doo-wop	Music genres, R&B music
Elder High School	Schools in Ohio, Cincinnati, Ohio
Guido Altarelli	1941 births, 2015 deaths, Italian physicists, People from Rome
Lubomír Lipský	1923 births, 2015 deaths, Czech movie actors, Czech television actors
Eric Arturo Delvalle	1937 births, 2015 deaths, Jewish politicians, North American Jews, People from Panama City, Presidents (government)
Compurgation	Trials
Javid Iqbal	1924 births, 2015 deaths, Alumni of the University of Cambridge, Deaths from cancer, Pakistani judges, Pakistani people
Tyrus Wong	1910 births, 2016 deaths, Naturalized citizens of the United States, Chinese people, American artists, American centenarians
Director of the Federal Bureau of Investigation	Directors of the Federal Bureau of Investigation
Mabel Boll	1949 deaths, 1893 births, American socialites, Cardiovascular disease deaths in New York City, Deaths from stroke, American aviators
Co-education	Schools, Education
Colour Me Free!	2009 albums, Joss Stone albums, Soul albums, R&B albums, Virgin Records albums
The Temple Institute	Nationalist organizations, Judaism in Israel, Museums in Jerusalem, Temple Mount
Nordland I	2002 albums
Blood Fire Death	1988 albums, Heavy metal albums
Quorthon	Swedish musicians, 1966 births, 2004 deaths
Black Magic (Little Mix song)	2015 songs, Pop songs
Diodorus Siculus	90s BC births, 30s BC deaths, Ancient Greek historians
Multi-party system	Democracy
List of political parties in Iceland	Lists of political parties, Politics of Iceland
Reykjanesbær	Municipalities of Iceland
Thinis	Cities in Egypt, Ancient Egypt
Khayu	Predynastic Pharaohs
Božo Bakota	1950 births, 2015 deaths, Croatian footballers, Sportspeople from Zagreb, Yugoslavian sportspeople
Cartouche	Ancient Egypt, Writing systems
Amarna period	Ancient Egypt
Kirsten Holmstedt	Living people, American feminist writers, American journalists, Writers from Connecticut, Year of birth missing (living people)
Donna Shalala	1941 births, Living people, United States representatives from Florida, United States Secretaries of Health and Human Services, Politicians from Cleveland, Ohio, Politicians from Miami, Florida, US Democratic Party politicians
J. Whyatt Mondesire	1949 births, 2015 deaths, Deaths from intracranial aneurysm, American journalists, American civil rights activists, Writers from Pennsylvania
Rusty Staub	1944 births, 2018 deaths, Deaths from multiple organ failure, Deaths from pneumonia, Deaths from respiratory tract infection, Disease-related deaths in Florida, American philanthropists, Houston Astros players, Montreal Expos players, New York Mets players, Detroit Tigers players, Texas Rangers players, Sportspeople from New Orleans, Louisiana
Whitney Houston (album)	1985 albums, Debut albums, Whitney Houston albums, Dance pop albums, Soul albums, R&B albums, Whitney Houston
LP1 (Joss Stone album)	2011 albums, Joss Stone albums, Quiet storm albums, Soul albums, R&B albums
Betty Williams (peace activist)	1943 births, 2020 deaths, Nobel Peace Prize winners, People from Belfast
Edward Sims Van Zile	1863 births, 1931 deaths, People from Troy, New York, Writers from New York, Deaths from stroke, American inventors
Second Dynasty of Egypt	Ancient Egypt
Emilia Clarke	English television actors, English stage actors, English movie actors, Actors from London, 1986 births, Living people
Water for Your Soul	2015 albums, Joss Stone albums, Reggae albums, Soul albums, R&B albums
Control (Janet Jackson album)	1986 albums, Janet Jackson albums, Funk albums, New jack swing albums, R&B albums
Janet Remixed	1995 albums, Remix albums, Janet Jackson albums, Dance albums, House albums, R&B albums
Hereditary haemochromatosis	Genetic disorders
The Soul Sessions	2003 albums, Debut albums, Joss Stone albums, Blues albums, Soul albums, R&B albums, Virgin Records albums
Vyasa	Hindu saints, Mahabharata
The Best of Joss Stone 2003–2009	2011 albums, Greatest hits albums, Joss Stone albums, Jazz albums, Funk albums, Soul albums, R&B albums, Virgin Records albums
The Soul Sessions Vol. 2	2012 albums, Joss Stone albums, Jazz albums, Soul albums, R&B albums
Jos Vandeloo	1925 births, 2015 deaths, Belgian novelists, Belgian poets, People from Limburg (Belgium)
José Eduardo Dutra	1957 births, 2015 deaths, Brazilian politicians, Brazilian businesspeople, Deaths from cancer, Disease-related deaths in Brazil
Will H. Hays	1879 births, 1954 deaths, United States Postmasters General, American activists, Politicians from Indiana, US Republican Party politicians
Kevin Owens	1984 births, Canadian professional wrestlers, Living people, Sportspeople from Quebec, WWE wrestlers
Nordland II	2003 albums
Bathory (album)	1984 albums
Mantle (geology)	Plate tectonics, Structure of the Earth
Moroccan Amazigh	Afroasiatic languages
Hellingly	East Sussex, Villages in England
Coleridge Goode	1914 births, 2015 deaths, Bassists, British centenarians, British musicians, Jamaican entertainers, Jazz musicians, People from Kingston, Jamaica
Chantal Akerman	1950 births, 2015 deaths, Actors from Brussels, Actors who committed suicide, Artists from Brussels, Artists who committed suicide, Belgian Jews, Belgian LGBT people, Belgian movie actors, Belgian movie directors, Belgian screenwriters, Cinematographers, Feminist writers, Jewish actors, Jewish artists, Jewish feminists, Jewish screenwriters, Lesbian feminists, Lesbian Jews, LGBT actors, LGBT artists, LGBT directors, LGBT screenwriters, Movie editors, Belgian movie producers, Writers from Brussels
Johnny Van Zant	1959 births, Living people, American country singers, American rock singers, Singers from Jacksonville, Florida
Barrow County, Georgia	1914 establishments in Georgia (U.S. state), Georgia (U.S. state) counties
Wilford Horace Smith	1863 births, 1926 deaths, African-American people, American civil rights activists, American lawyers
Roquelaure-Saint-Aubin	Communes in Gers
Environmental geology	Geology
Planetary geology	geology
Anthony Nesty	1967 births, Living people, 1984 Summer Olympics, Medalists at the 1988 Summer Olympics, Medalists at the 1992 Summer Olympics, Olympic bronze medalists, Olympic gold medalists, Surinamese sportspeople, Swimmers, Trinidad and Tobago people
Scout Taylor-Compton	American television actors, American movie actors, Actors from Long Beach, California, 1989 births, Living people
Fame (Grace Jones album)	1978 albums, Disco albums, Grace Jones albums, R&B albums
Elimination Chamber (2015)	2015 in professional wrestling, 2015 in the United States, Corpus Christi, Texas, Elimination Chamber, 2010s in Texas, May 2015 events
Raúl Grijalva	1948 births, American Roman Catholics, People from Tucson, Arizona, United States representatives from Arizona, US Democratic Party politicians, 21st-century American politicians
Dominique Dropsy	1951 births, 2015 deaths, 1978 FIFA World Cup players, Cancer deaths in France, Deaths from leukemia, French footballers
Elena Lucena	1914 births, 2015 deaths, Argentine actors, Centenarians, People from Buenos Aires
Billy Joe Royal	1942 births, 2015 deaths, American country musicians, American pop singers, Singers from Georgia (U.S. state)
Henry DeWitt Hamilton	1863 births, 1942 deaths, People from Illinois, People from Barrington, Rhode Island, People from Brooklyn, Burials at Arlington National Cemetery, American lawyers
Hotepsekhemwy	Pharaohs
The Love of Captain Brando	Spanish movies, 1974 movies, Drama movies
Tomas Lindahl	1938 births, Living people, Swedish scientists
Bullet cluster	Galaxy clusters
Skyros	Islands of Greece
Garden of the Sanhedrin Tombs	Buildings and structures in Jerusalem, Archaeological sites in Israel, Burial monuments and structures, Cemeteries in Israel
Emídio Brasileiro	1962 births, Living people, Brazilian writers, Brazilian lawyers, Teachers
Anti (album)	2016 albums, Rihanna albums, Hip hop soul albums, Reggae albums, R&B albums
Artemi Panarin	1991 births, Calder Trophy winners, Chicago Blackhawks players, Columbus Blue Jackets players, Living people, Russian ice hockey players
Harry Gallatin	1927 births, 2015 deaths, Deaths from surgical complications, New York Knicks players, Detroit Pistons players, Sportspeople from Illinois
W. R. Mitchell	1928 births, 2015 deaths, People from North Yorkshire, Writers from Yorkshire
The Reptile Room	A Series of Unfortunate Events, 1999 books
Christine Arnothy	1930 births, 2015 deaths, French writers, Hungarian writers, People from Budapest
Home (soundtrack)	2015 albums, Rihanna albums, Pop albums, House albums, R&B albums
Paul Prudhomme	1940 births, 2015 deaths, Businesspeople from New Orleans, Louisiana, American chefs, Disease-related deaths in Louisiana, Writers from New Orleans, Louisiana
Daniel Webster (Florida politician)	1949 births, Living people, People from Charleston, West Virginia, Politicians from West Virginia, United States representatives from Florida, US Republican Party politicians
Jason Chaffetz	1967 births, Living people, American Latter Day Saints, Politicians from California, United States representatives from Utah, US Republican Party politicians
The Last Voyage of the Starship Enterprise	Star Trek, Comedy
Gehenna	Jerusalem, Valleys
Do It for Love	2015 albums, Alesha Dixon albums, UK garage albums, Dance albums, R&B albums
Vatican Radio	1931 establishments in Europe, Radio stations in Europe, Vatican City
Lake County, California	Lake County, California, 1861 establishments in California
Get Rich or Die Tryin'	2003 albums, 50 Cent, Debut albums, Hip hop albums
Ravindra Jain	1944 births, 2015 deaths, Composers, Deaths from multiple organ failure, Disease-related deaths in India, Indian musicians, Bollywood playback singers
Du Runsheng	1913 births, 2015 deaths, Centenarians, Chinese communist politicians, Chinese military people, Chinese economists
Chop suey	Foods
Hot chicken	Chicken as food, Nashville, Tennessee
Spacetoon	2000 establishments in Asia, Television stations
Richard F. Heck	1931 births, 2015 deaths, American chemists, Scientists from Massachusetts, People from Springfield, Massachusetts
Jim Diamond	1951 births, 2015 deaths, Musicians from Glasgow, Scottish singer-songwriters
Polish People's Republic	20th century in Poland, 1944 establishments in Europe, 1989 disestablishments in Europe
(There's) Always Something There to Remind Me	Pop songs, 1960s songs
Bill Flores	1954 births, Living people, United States representatives from Texas, Politicians from Wyoming, US Republican Party politicians
Darrell Issa	1953 births, Living people, United States representatives from California, Politicians from Cleveland, Ohio, US Republican Party politicians, Businesspeople from Cleveland, Ohio, Businesspeople from San Diego, California, Politicians from San Diego, California
Lynn Westmoreland	1950 births, Living people, United States representatives from Georgia, Politicians from Atlanta, Georgia, US Republican Party politicians
Mike Conaway	1948 births, Living people, United States representatives from Texas, US Republican Party politicians
Dave Reichert	1950 births, Living people, American Lutherans, Politicians from Minnesota, United States representatives from Washington, US Republican Party politicians
October 2015 Speaker of the United States House of Representatives election	2015 elections, 2015 in the United States, Elections in the United States, October 2015 events
James Corden	1978 births, Living people, Actors from Buckinghamshire, Actors from London, BAFTA Award winning actors, British television talk show hosts, Comedians from London, Drama Desk Award winners, English movie actors, English television actors, English television presenters, English television producers, English television writers, English voice actors, Naturalized citizens of the United States, People from Hillingdon (London borough), Television personalities from London, Tony Award winning actors, Writers from Buckinghamshire, Writers from London
John Kline	1947 births, Living people, United States representatives from Minnesota, Politicians from Pennsylvania, People from Allentown, Pennsylvania, US Republican Party politicians
Shaggy (singer)	1968 births, Living people, Jamaican singers, Reggae musicians
Pure Pleasure	1993 albums, Debut albums, Dancehall albums, Reggae albums
American Oxygen	2015 songs, Rihanna songs, Dubstep songs, R&B songs
Wait Your Turn	2009 songs, Rihanna songs, Dubstep songs, Hip hop songs, R&B songs
Uncle B	2008 albums, Debut albums, N-Dubz albums, Hip hop albums, Grime albums, R&B albums
David Perron	1988 births, Anaheim Ducks players, Edmonton Oilers players, Ice hockey people from Quebec, Lewiston Maineiacs players, Living people, Pittsburgh Penguins players, St. Louis Blues players
Me. I Am Mariah... The Elusive Chanteuse	2014 albums, Mariah Carey albums, Hip hop albums, Gospel albums, Soul albums, R&B albums
Amelia Bence	1914 births, 2016 deaths, Deaths from congestive heart failure, Argentine movie actors, Centenarians, Actors from Buenos Aires
Guido Gorgatti	1919 births, Living people, Argentine movie actors, Argentine television actors, Italian movie actors, Italian television actors, People from Veneto, People from Buenos Aires
Tony Rafty	1915 births, 2015 deaths, Artists from New South Wales, Deaths from pneumonia, Disease-related deaths in Sydney, Infectious disease deaths in Australia, People from Sydney
Steve Mackay	1949 births, 2015 deaths, American saxophonists, Deaths from sepsis, Infectious disease deaths in California, Musicians from Grand Rapids, Michigan
The Land of Gorch	Comedy, Television
Gareth	Arthurian legend, Fictional knights
Yabby	Crustaceans
The Return (Bathory album)	1985 albums
Plant hormone	Plant physiology
Auxin	Plant physiology, Organic compounds
Muse (Grace Jones album)	1979 albums, Grace Jones albums, Disco albums, R&B albums
Warm Leatherette (Grace Jones album)	1980 albums, Grace Jones albums, Electronica albums, Reggae albums, R&B albums
Nightclubbing (Grace Jones album)	1981 albums, Grace Jones albums, Electronica albums, Reggae albums, R&B albums
Living My Life (Grace Jones album)	1982 albums, Grace Jones albums, Electronica albums, Reggae albums, R&B albums
Release (music)	Music industry
Diane Black	1951 births, Living people, United States representatives from Tennessee, Politicians from Baltimore, Maryland, US Republican Party politicians
Marsha Blackburn	1952 births, Living people, United States senators from Tennessee, State legislators of the United States, United States representatives from Tennessee, Politicians from Mississippi, US Republican Party politicians, American Presbyterians
Peter Roskam	1961 births, Living people, United States representatives from Illinois, US Republican Party politicians, People from Hinsdale, Illinois, State legislators of the United States
Benjamin A. Gilman	1922 births, 2016 deaths, Deaths from surgical complications, United States representatives from New York, US Republican Party politicians, People from Poughkeepsie, New York
Levent Kırca	1948 births, 2015 deaths, Comedians, Deaths from liver cancer, Disease-related deaths in Turkey, Turkish actors, Turkish politicians, Turkish writers
Abdallah Kigoda	1953 births, 2015 deaths, Cancer deaths in India, Tanzanian people, Civil servants
Sarepta, Louisiana	Towns in Louisiana
Homer, Louisiana	Parish seats in Louisiana, Towns in Louisiana
Columbia, Louisiana	Parish seats in Louisiana, Towns in Louisiana
Cameron, Louisiana	Parish seats in Louisiana, Census-designated places in Louisiana
Russia men's national volleyball team	National volleyball teams, Sport in Russia
Thibodaux, Louisiana	Cities in Louisiana, Parish seats in Louisiana, 1830 establishments in the United States, 1830s establishments in Louisiana
Asterisk	Punctuation, Typography
Typeface	Typography, Fonts
Amleto	operas
Hinglish	Language
Sorry I'm Late (album)	2014 albums
Lamar Odom	1979 births, Living people, African-American basketball players, Dallas Mavericks players, Los Angeles Clippers players, Los Angeles Lakers players, Miami Heat players, Sportspeople from Queens, American basketball players
Ebba Busch Thor	1987 births, Living people, Swedish politicians
Christian Democrats (Sweden)	1960s establishments in Sweden, 1964 establishments in Europe, Christian democratic parties, Political parties in Sweden
Fashion week	Fashion
Bluehenge	Henges, Stone circles, World Heritage Sites in the United Kingdom, Archaeological sites in Wiltshire, Neolithic, Buildings and structures in England, Wiltshire
2014 FIFA World Cup Group B	2014 FIFA World Cup
Anna Pendleton Schenck	1874 births, 1915 deaths, Columbia University alumni, American architects
Eloise Blaine Cram	1896 births, 1957 deaths, People from Davenport, Iowa, Scientists from Iowa, Scientists from San Diego, California
Mary Margaret O'Reilly	1865 births, 1949 deaths, Civil servants, People from Springfield, Massachusetts
Judy Lee Klemesrud	1939 births, 1985 deaths, Writers from Iowa
Adam Kinzinger	1978 births, Living people, American military people, Majors, United States representatives from Illinois, US Republican Party politicians
Sue Lloyd-Roberts	1950 births, 2015 deaths, Alumni of the University of Oxford, Cancer deaths in London, Deaths from leukemia, English television presenters, Journalists from London, People from the City of Westminster, Writers from London
Nurlan Balgimbayev	1947 births, 2015 deaths, Prime Ministers of Kazakhstan, Deaths from cancer
Ryan Zinke	1961 births, Living people, American military people, Businesspeople from Montana, United States representatives from Montana, United States Secretaries of the Interior, People from Bozeman, Montana, People from Whitefish, Montana, US Republican Party politicians
Clare Tree Major	1880 births, 1954 deaths, English stage actors, English theatre directors
Gleipnir	Norse mythology
Eliseo Arredondo	1870 births, 1923 deaths, Mexican lawyers, Mexican politicians, Diplomats
End zone	American football, Canadian football
Chris Knight	1960 births, Living people, American country musicians, American singer-songwriters, Singers from Kentucky
Red-and-green macaw	True parrots
Baku Zoo	Zoos, 1928 establishments, Buildings and structures in Baku, 20th century establishments in Azerbaijan
Kenneth D. Taylor	1934 births, 2015 deaths, Ambassadors of Canada, Canadian businesspeople, Canadian educators, Canadian politicians, Cancer deaths in New York City, Congressional Gold Medal recipients, Deaths from colorectal cancer, People from Calgary
Robert M. White	1923 births, 2015 deaths, Deaths from dementia, Disease-related deaths in Maryland, Harvard University alumni, Massachusetts Institute of Technology alumni, Politicians from Boston, Massachusetts, Scientists from Boston, Massachusetts
Nate Huffman	1975 births, 2015 deaths, Cancer deaths in Michigan, Deaths from bladder cancer, People from Battle Creek, Michigan, Sportspeople from Michigan, Toronto Raptors players
Michael McCaul	1962 births, Living people, United States representatives from Texas, Politicians from Dallas, Texas, US Republican Party politicians
Elbert Glover	Living people, American academics, American physicians
Dither fish	Ethology, Aquarium fish
Obsidian Entertainment	Video game companies
LucasArts	Video game companies
Lake County, Illinois	Illinois counties
Slave to the Rhythm (Grace Jones album)	1985 albums, Grace Jones albums, Funk albums, R&B albums
Burning of Parliament	1834, 1830s in the United Kingdom, 19th century in London, Fires in the United Kingdom, October events
John Soane	English architects, 1753 births, 1837 deaths, Fellows of the Royal Society, Knights Bachelor, People from Reading, Berkshire
Goring-on-Thames	Oxfordshire, Villages in England
South Oxfordshire	South Oxfordshire, 1974 establishments in England
William Whitelaw (Perth MP)	Scottish politicians, 1868 births, 1946 deaths
William Whitelaw, 1st Viscount Whitelaw	English politicians, 1918 births, 1999 deaths, Secretaries of State for the Home Department
Angus Deaton	Economists, People from Edinburgh, 1945 births, Living people, Nobel Prize in Economics winners
Elizabeth Ramsey	Filipino singers, Comedians, Filipino television actors, 1931 births, 2015 deaths
Skhid	Journals, 1995 establishments, Ukraine
Island Life (Grace Jones album)	1985 albums, Greatest hits albums, Grace Jones albums, Disco albums, Reggae albums, R&B albums
Inside Story (Grace Jones album)	1986 albums, Grace Jones albums, Funk albums, R&B albums
Stella Glow	Nintendo 3DS games, 2015 video games, Video games developed in Japan
Bulletproof Heart (Grace Jones album)	1989 albums, Grace Jones albums, Funk albums, R&B albums
The Ultimate (Grace Jones album)	1993 albums, Greatest hits albums, Grace Jones albums, Disco albums, Reggae albums, R&B albums
Edward the Exile	1016 births, 1050s deaths, Kings and Queens of England
Arabian tribes	Ancient history, Arabia
I'll Remember	1994 songs, Pop songs, Madonna songs, 1990s ballads, Pop ballads
2014-15 Kentucky Wildcats men's basketball	2014 in sports, 2015 in sports, Southeastern Conference, Lexington, Kentucky, 2010s in Kentucky, 2014 in the United States, 2015 in the United States
Max Domi	1995 births, Arizona Coyotes players, Columbus Blue Jackets players, Montreal Canadiens players, Canadian ice hockey centres, Ice hockey people from Manitoba, New York Rangers players, Living people, Sportspeople from Toronto, Sportspeople from Winnipeg, Ontario Hockey League players
Presumption of innocence	Law, Legal terms
Grey-crested finch	Passeri
Saving All My Love for You	1985 songs
All at Once (Whitney Houston song)	1980s ballads, 1985 songs, Pop ballads, Rhythm and blues ballads, Whitney Houston songs
Legal burden of proof	United States law, Law, Legal terms
Clinton, Louisiana	Parish seats in Louisiana, Towns in Louisiana
Rebecca Shelley	1887 births, 1984 deaths, Nonviolence advocates
Doctor of Letters	Education, Academia
Dodge Caliber	Dodge automobiles
Anne-Marie Lizin	1949 births, 2015 deaths, Alderman of Belgium, Belgian mayors, Former MEPs, MEPs for Belgium, Parti socialiste (Belgium) politicians, People from Huy, Walloon politicians, Women politicians
Ralph Andrews	1927 births, 2015 deaths, American television producers, Deaths from Alzheimer's disease, Disease-related deaths in California
Neill Sheridan	1921 births, 2015 deaths, Boston Red Sox players, Deaths from pneumonia, Infectious disease deaths in California, Sportspeople from Sacramento, California
Mike Pompeo	1963 births, Living people, United States Secretaries of State, Directors of the Central Intelligence Agency, Harvard University alumni, People from Orange, California, Politicians from California, United States representatives from Kansas, US Republican Party politicians, Kansas Republicans
Luciano García Alén	1928 births, 2015 deaths, Deaths from pneumonia, Infectious disease deaths in Spain, People from Pontevedra, Spanish physicians, Spanish scientists
Sergei Filippenkov	1971 births, 2015 deaths, Cardiovascular disease deaths in Russia, Deaths from myocardial infarction, Russian footballers, Russian football managers
Francesc de Paula Burguera	1928 births, 2015 deaths, Deaths from heart failure, Spanish journalists, Spanish writers, Spanish politicians, People from Valencia, Cardiovascular disease deaths in Spain
Pontevedra	Capital cities in Spain, Cities in Galicia, Municipalities in Galicia
Larry N. Vanderhoef	1941 births, 2015 deaths, American biochemists, American educators, Cardiovascular disease deaths in California, Deaths from stroke, Scientists from Minnesota
MV Derbyshire	Ships
Jordi Miralles	1962 births, 2015 deaths, Civil servants, Deaths from meningitis, Infectious disease deaths in Spain, Politicians from Barcelona
Phil Lesh	1940 births, Living people, American bass guitarists, American rock guitarists, Musicians from Berkeley, California, Writers from Berkeley, California, People with cancer
Non-denominational Muslim	Islamic denominations
Public good	Economics
Common good (economics)	Economics
Corona	Stars, Light sources
Motal	Settlements in Belarus
Oulad Ziane	Ethnic groups in Africa
Henriette Reker	1956 births, Living people, Deputy mayors, German crime victims, German mayors, People from Cologne, Politicians from North Rhine-Westphalia
Gamal El-Ghitani	1945 births, 2015 deaths, Deaths from myocardial infarction, Disease-related deaths in Egypt, Egyptian writers, Egyptian journalists
Carrie (2002 movie)	2002 movies, 2002 horror movies, 2000s teen movies, American movie remakes, Supernatural horror movies, American teen horror movies, American television movies, Carrie, English-language movies, High school movies, Movies about bullying, Movies about revenge, Telekinesis in movies
Northwestern State University	Colleges and universities in Louisiana, 1884 establishments in the United States, 19th-century establishments in Louisiana
Murfreesboro, Tennessee	Former United States state capitals, Cities in Tennessee, County seats in Tennessee
Washington, Arkansas	Former United States state capitals, Cities in Arkansas
Donaldsonville, Louisiana	Former United States state capitals, Cities in Louisiana, Parish seats in Louisiana
Takaka	Towns in New Zealand
Morgan Rielly	1995 births, American Hockey League players, Canadian ice hockey defencemen, Ice hockey people from British Columbia, Living people, Moose Jaw Warriors players, Sportspeople from Vancouver, Toronto Maple Leafs players
Shawn Mendes	Canadian singer-songwriters, 1998 births, Living people
Mdakra	Moroccan tribes
Benedetta Cappa	1897 births, 1977 deaths, Italian artists, People from Rome
Harriet Sylvia Ann Howland Green Wilks	1871 births, 1951 deaths, People from Hoboken, New Jersey
Tom Smith (Pennsylvania politician)	1947 births, 2015 deaths, Politicians from Pennsylvania, US Republican Party politicians
Ore-bulk-oil carrier	Ships
Ex post facto law	Legal terms, Law
Spanish conquest of the Aztec Empire	Aztec, Colonialism, 16th century in Spain, History of North America
Hero (Mariah Carey song)	1993 songs, Mariah Carey songs, Pop songs, R&B songs
Bob Houbregs	1932 births, 2014 deaths, Boston Celtics players, Canadian basketball players, Detroit Pistons players, Sportspeople from Vancouver
Cosham	Portsmouth
Stuxnet	Computer networking
King Kong (character)	American adventure movies, Monster movies, Fictional animals, Fictional characters introduced in the 1930s, King Kong, Monsters, Horror movie characters
Hurricane (Grace Jones album)	2008 albums, Grace Jones albums, Dance albums, Reggae albums, R&B albums
Hassan El Fad	1962 births, Living people, Comedians, Moroccan actors, People from Casablanca
The Ultimate Collection (Grace Jones album)	2006 albums, Greatest hits albums, Grace Jones albums, Disco albums, Reggae albums, R&B albums
The Grace Jones Story	2006 albums, Greatest hits albums, Grace Jones albums, Funk albums, Reggae albums, R&B albums
The Collection (Grace Jones album)	2004 albums, Greatest hits albums, Grace Jones albums, Disco albums, Reggae albums, R&B albums
The Universal Masters Collection (Grace Jones album)	2003 albums, Greatest hits albums, Grace Jones albums, Reggae albums, R&B albums
X (Chris Brown album)	2014 albums, Hip hop albums, R&B albums
Bleed Like Me	2005 albums
Bob Casey Jr.	1960 births, Living people, United States senators from Pennsylvania, US Democratic Party politicians, People from Scranton, Pennsylvania
Ali Treki	1938 births, 2015 deaths, Government ministers, Libyan politicians, Presidents of the United Nations General Assembly
VivaColombia	Airlines of South America
Cayman Airways	1968 establishments, Airlines of the United Kingdom, Cayman Islands
Indian summer	Seasons
Edgefield, Louisiana	Villages in Red River Parish, Louisiana
Martin, Louisiana	Villages in Red River Parish, Louisiana
Hall Summit, Louisiana	Villages in Red River Parish, Louisiana
White Ship	Ships, 1120s
Boat positions	Terminology, Ships
Reasonable doubt	Law, Legal terms
List of lakes of Azerbaijan	Lakes of Azerbaijan, Lists of lakes, Azerbaijan-related lists
Adversarial system	Law, Legal terms
France Bučar	1923 births, 2015 deaths, Slovenian politicians, Slovenian writers
Michael Meacher	1939 births, 2015 deaths, Alumni of the London School of Economics, Alumni of the University of Oxford, Former members of the British House of Commons for English constituencies, Civil servants, Politicians from Hertfordshire, UK MPs 1970–1974, UK MPs 1974, UK MPs 1974–1979, UK MPs 1979–1983, UK MPs 1983–1987, UK MPs 1987–1992, UK MPs 1992–1997, UK MPs 1997–2001, UK MPs 2001–2005, UK MPs 2005–2010, UK MPs 2010–2015, UK MPs 2015–2017
Lake Sarysu	Lakes of Azerbaijan
Statute of limitations	Law, Legal terms
Mike Kelly (politician)	1948 births, Living people, United States representatives from Pennsylvania, Politicians from Pittsburgh, Pennsylvania, US Republican Party politicians
Cory Wells	1941 births, 2015 deaths, Singers from Buffalo, New York
Cause of action	Law, Legal terms
Narayani Zone	Zones of Nepal
Marion County, Indiana	Indiana counties, 1822 establishments in Indiana
Nederland, Texas	Cities in Texas, 1897 establishments in the United States, 1890s establishments in Texas
Frank Watkins	1968 births, 2015 deaths, American bass guitarists, American heavy metal musicians, American rock guitarists, Deaths from cancer
Disney Television Animation	Disney companies, American animation studios, 1984 establishments in California
East of England (European Parliament constituency)	MEPs for the United Kingdom, 1999 establishments in England, Constituencies in the United Kingdom, East of England
French Americans	Ethnic groups in the United States
Toni Brunner	1974 births, Swiss politicians, Living people
Sand Hills, South Brunswick, New Jersey	Neighborhoods in the United States, Settlements in New Jersey, Middlesex County, New Jersey
South Brunswick, New Jersey	Townships in New Jersey, Middlesex County, New Jersey, 1798 establishments in the United States, 1790s establishments in New Jersey
List of people from New Hampshire	People from New Hampshire, Lists of people by state in the United States, Lists about U.S. states
List of people from Nevada	People from Nevada, Lists of people by state in the United States, Lists about U.S. states
List of people from New York	People from New York, Lists of people by state in the United States, New York-related lists
List of people from Ohio	Lists of people by state in the United States, People from Ohio
Mini Estadi	Football stadiums in Spain, Buildings and structures in Barcelona
Criminal procedure	Law, Legal terms
Jamesburg, New Jersey	Boroughs in New Jersey, Middlesex County, New Jersey, 1887 establishments in the United States, 19th-century establishments in New Jersey
South Amboy, New Jersey	Cities in New Jersey, Middlesex County, New Jersey, 1798 establishments in the United States, 1790s establishments in New Jersey
South Plainfield, New Jersey	Boroughs in New Jersey, Middlesex County, New Jersey
Lake Balboa, Los Angeles	Neighborhoods of Los Angeles
List of people from Santa Monica, California	People from Santa Monica, California, Lists of people from California
West Los Angeles	Los Angeles County, California
I'm a Believer	Rock songs, Pop songs, 1966 songs, Shrek music
Garfield (character)	Animated characters, Fictional cats
Insanity defense	Law, Legal terms, Mental illnesses
List of Canadian actors	Lists of entertainers, Canadian actors, Lists of Canadian people
Harbor City, Los Angeles	Neighborhoods of Los Angeles
Alfredo di Stéfano Stadium	Stadiums in Europe, Buildings and structures in Spain, 2006 establishments in Europe, 2000s establishments in Spain
Arbitration	Law, Legal terms
Algebraic topology	Mathematics
Kazimierz Łaski	1921 births, 2015 deaths, Austrian scientists, Economists, People from Warsaw, Polish academics, Polish scientists
Marty Ingels	1936 births, 2015 deaths, Actors from Brooklyn, American movie actors, American stage actors, American television actors, Cardiovascular disease deaths in Los Angeles, Comedians from New York City, Deaths from stroke
Mark Murphy	1932 births, 2015 deaths, American jazz singers, American jazz musicians, Singers from New York, Musicians from New York, Singers from New Jersey, Musicians from New Jersey, People from Syracuse, New York
Willem Aantjes	1923 births, 2015 deaths, Anti-Revolutionary Party politicians, Christian Democratic Appeal politicians, Dutch Calvinists, Dutch civil servants, Dutch jurists, Dutch people of World War II, Dutch trade unionists, Former leaders of political parties in the Netherlands, Former members of the House of Representatives of the Netherlands, Politicians from South Holland, SS people
Marshawn Lynch	1986 births, Buffalo Bills players, Seattle Seahawks players, African American players of American football, American football running backs, Sportspeople from Oakland, California, Sportspeople from Berkeley, California, Living people
Mario Beccaria	1920 births, 2003 deaths, Civil servants, People from Lombardy, Politicians from Lombardy
Hurricane Patricia	Hurricanes in Mexico, 2015 in weather, 2010s in Mexico
Typhoon Vera	1959, Tropical cyclones in Asia, 1950s in Asia, 20th century in Japan
Ricardo Dolz y Arango	1861 births, 1937 deaths, Judges, Chancellors
Damages	Law, Legal terms
Equity (law)	Legal terms
Commoners	English language, Social sciences
Lateral sulcus	Anatomy of the brain
Principal Skinner	The Simpsons characters, Fictional characters introduced in 1989
Leon Bibb	1922 births, 2015 deaths, African-American singers, American folk singers, American folk musicians, Musicians from Louisville, Kentucky, Singers from Louisville, Kentucky
Krunoslav Hulak	1951 births, 2015 deaths, Croatian sportspeople, Chess grandmasters
Speedway, Indiana	Towns in Indiana
National Informatics Centre	Government of India
1959 Mexico hurricane	1959 in North America, 1950s in Mexico, Hurricanes in Mexico, October events
Shel Dorf	1933 births, 2009 deaths, Deaths from diabetes, American comics artists, People from Detroit, Michigan
Amancio Ortega	1936 births, Living people, Billionaires, Spanish businesspeople
Brayden McNabb	1991 births, American Hockey League players, Buffalo Sabres players, Canadian ice hockey defencemen, Ice hockey people from Saskatchewan, Kootenay Ice players, Living people, Los Angeles Kings players, Vegas Golden Knights
Pseudogene	DNA
Vigo County, Indiana	Indiana counties, 1818 establishments in Indiana
Ján Chryzostom Korec	1924 births, 2015 deaths, Anti-Communists, Cardinals of the Roman Catholic Church, Roman Catholic bishops, Slovakian people
Pseudepigrapha	Bible versions, Words
Defense (legal)	Law, Legal terms
Drama (Jamelia album)	2000 albums, Debut albums, Jamelia albums, Hip hop albums, R&B albums
Thank You (Jamelia album)	2003 albums, 2004 albums, Jamelia albums, Hip hop albums, Hip hop soul albums, R&B albums
Colin Gubbins	British Army generals
Military Cross	Military honors
Walk with Me (Jamelia album)	2006 albums, 2007 albums, Jamelia albums, Hip hop albums, Dance albums, R&B albums
Bad Ass Strippa	2004 songs, Debut singles, Jentina songs, Hip hop songs, R&B songs
Mysterious (song)	2005 songs, Jentina songs, Hip hop songs, Dance songs
Ashland, Concordia Parish, Louisiana	Settlements in Concordia Parish, Louisiana, Unincorporated communities in Louisiana
Ashland, Natchitoches Parish, Louisiana	1963 establishments in the United States, Villages in Natchitoches Parish, Louisiana, 20th-century establishments in Louisiana
Defence in depth	Military terminology
Defense (sports)	Sports
Cody Eakin	1991 births, American Hockey League players, Buffalo Sabres players, Canadian ice hockey centres, Dallas Stars players, Ice hockey people from Manitoba, Kootenay Ice players, Living people, Sportspeople from Winnipeg, Swift Current Broncos players, Vegas Golden Knights players, Washington Capitals players, Winnipeg Jets players
Nigella sativa	Spices
2007 New York Giants season	New York Giants, National Football League seasons, 2007 in sports, 2007 in New Jersey
Superstar - The Hits	2007 albums, Greatest hits albums, Jamelia albums, Hip hop soul albums, Dance albums, R&B albums
Jamelia - The Collection	2009 albums, Greatest hits albums, Jamelia albums, Hip hop soul albums, R&B albums
Serbo-Croatian Wikipedia	Wikipedias
Minangkabau Wikipedia	Wikipedias
Gene family	Genetics
2007 New England Patriots season	2007 in sports, 2007 in Massachusetts, National Football League seasons, New England Patriots
Myrna Loy	1905 births, 1993 deaths, Deaths from surgical complications, American movie actors, American television actors, American stage actors, People from Helena, Montana, Actors from Montana
Dick Bavetta	1939 births, Living people, Sportspeople from New York City
Flip Saunders	1955 births, 2015 deaths, American basketball players, Cancer deaths in Minnesota, Deaths from Hodgkin's lymphoma, National Basketball Association coaches, Sportspeople from Cleveland, Ohio, Sportspeople from Minneapolis, Minnesota
Roman Polák	1986 births, American Hockey League players, Czech ice hockey players, Dallas Stars players, Kootenay Ice players, Living people, San Jose Sharks players, St. Louis Blues players, Toronto Maple Leafs players, Ice hockey defencemen
Evidence (law)	Legal terms
Gourd	Vegetables, Cucurbitaceae
Impartiality	Law, Legal terms
Charles Russell	Bushrangers
Vivian Dandridge	1921 births, 1991 deaths, Actors from Cleveland, Ohio, American movie actors, Cardiovascular disease deaths in Washington (state), Deaths from stroke, Singers from Cleveland, Ohio
Moda Domani Institute	Education in France
Shigeru Yoshida	Prime Ministers of Japan, 1878 births, 1967 deaths, Politicians from Kanagawa Prefecture, University of Tokyo alumni
Andy Dalton	1987 births, Living people, American Christians, American football quarterbacks, Cincinnati Bengals players, Sportspeople from Texas
Lisa Jardine	1944 births, 2015 deaths, Deaths from cancer, English historians, People from Oxford, Writers from Oxfordshire
Ed Walker (radio personality)	1932 births, 2015 deaths, Cancer deaths in Maryland, American radio personalities, People from Illinois, People from Washington, D.C.
Marsha Hunt	1917 births, Living people, American movie actors, American television actors, American stage actors, American centenarians, Actors from Chicago
Ann Blyth	1928 births, Living people, American movie actors, American television actors, American stage actors, Actors from New York, Singers from New York, People from Mount Kisco, New York
Janis Paige	1922 births, Living people, American stage actors, American television actors, Actors from Washington, People from Tacoma, Washington
Barbara Hale	Emmy Award winning actors, 1922 births, 2017 deaths, Deaths from COPD, American movie actors, American television actors, American stage actors, Actors from Illinois
Zwolle, Louisiana	Settlements in Sabine Parish, Louisiana, Towns in Louisiana
Ringgold, Louisiana	Towns in Bienville Parish, Louisiana
Gibsland, Louisiana	Towns in Bienville Parish, Louisiana
Injunction	Law, Legal terms
Tullos, Louisiana	Towns in Louisiana, Settlements in Winn Parish, Louisiana
Abita Springs, Louisiana	Towns in Louisiana
Colville, Washington	Cities in Washington (U.S. state), County seats in Washington
Vivian, Louisiana	Towns in Caddo Parish, Louisiana
Scott Barr	1916 births, 2015 deaths, Civil servants, Politicians from Washington, People from Spokane, Washington, US Republican Party politicians
Coushatta, Louisiana	Towns in Louisiana, Settlements in Red River Parish, Louisiana, Parish seats in Louisiana

