Tha Carter II	2005 albums, Lil Wayne albums
Dolla (rapper)	1988 births, 2009 deaths, African American musicians, American murder victims, American rap musicians from Illinois, Murdered musicians, Murders by firearm in California, Musicians from Chicago, People murdered in California
Akechi Mitsuhide	Japanese people, 1528 births, 1582 deaths, Samurai, People from Gifu Prefecture
Andalusian nationalism	Politics of Spain, Nationalism, Andalusia
Bavaria Party	Political parties in Germany, 1946 establishments in Germany
Respect Party	2004 establishments in the United Kingdom, 2010s disestablishments in the United Kingdom, 2016 disestablishments in Europe, Former political parties in the United Kingdom
Plaid Cymru	Nationalist organisations in the United Kingdom, Social democratic parties, Political parties in Wales
Scottish National Party	1934 establishments in Europe, Nationalist organisations in the United Kingdom, Social democratic parties, Political parties in Scotland, 1930s establishments in the United Kingdom, 20th century establishments in Scotland
Semi-postal	Postage stamps
Clovis, New Mexico	County seats in New Mexico, Cities in New Mexico, 1909 establishments in the United States, 20th-century establishments in New Mexico
Internazionale F.C. Torino	Italian football clubs, Turin, 1891 establishments in Europe, 1900s disestablishments in Italy
F.B.C. Torinese	Italian football clubs, Turin, 1894 establishments in Europe, 1900s disestablishments in Italy, 1890s establishments in Italy
R.S. Ginnastica Torino	Italian football clubs
Venezia F.C.	Italian football clubs, Venice, 1907 establishments in Italy
L.R. Vicenza Virtus	Italian football clubs, 1902 establishments in Italy
Novara Calcio	Italian football clubs, Novara, 1908 establishments in Italy
Modena F.C. 2018	Italian football clubs, Modena, 1912 establishments in Italy
A.S. Livorno Calcio	Italian football clubs, Livorno
A.C. Pisa 1909 S.S.D.	Italian football clubs, Pisa, 1909 establishments in Italy
U.S. Alessandria Calcio 1912	Italian football clubs, Alessandria, 1912 establishments in Italy
Como 1907	Italian football clubs, Como, 1907 establishments in Italy
Brescia Calcio	Italian football clubs, Brescia, 1911 establishments in Italy
Udinese Calcio	Italian football clubs, Udine, 1896 establishments in Europe, 1890s establishments in Italy
S.S.D. Lucchese 1905	1905 establishments in Italy, Italian football clubs, Lucca
U.S. Cremonese	Italian football clubs, Cremona, 1900s establishments in Italy, 1903 establishments in Europe
Calcio Padova	Italian football clubs, 1910 establishments in Italy
Atalanta B.C.	Italian football clubs, 1907 establishments in Italy
A.C. Legnano	Italian football clubs, 1913 establishments in Italy
Varese Calcio S.S.D.	Italian football clubs, 1910 establishments in Italy
A.S.D. Mantova F.C.	Italian football clubs, Mantua, 1911 establishments in Italy, 2010s in Italy
Parma Calcio 1913	Italian football clubs, Parma, 1913 establishments in Italy
Piacenza Calcio	Italian football clubs, 1919 establishments in Italy
A.C. Reggiana 1919	1919 establishments in Italy, Italian football clubs, Emilia-Romagna
S.P.A.L.	1907 establishments in Italy, Ferrara, Italian football clubs
U.S. Salernitana 1919	Italian football clubs, 1919 establishments in Italy
A.S. Bari	Italian football clubs, Bari, 1908 establishments in Italy
Palermo F.C.	Italian football clubs, Palermo
A.C.R. Messina	Italian football clubs, 1900 establishments in Italy
U.S. Lecce	1908 establishments in Italy, Italian football clubs, Lecce
Calcio Foggia 1920	Italian football clubs
F.C. Savoia 1908	Italian football clubs, 1908 establishments in Italy
U.S. Triestina Calcio	Italian football clubs, Trieste, 1918 establishments in Europe, 1910s establishments in Italy
A.C. Cesena	Italian football clubs, 1940 establishments in Europe, 1940s establishments in Italy
Delfino Pescara 1936	Italian football clubs
Robur Siena	1904 establishments in Europe, 1900s establishments in Italy, Italian football clubs, Sienna
Zoosk	Websites
Calcio Catania	Italian football clubs, 1908 establishments in Italy
Calcio Lecco 1912	Italian football clubs, 1912 establishments in Italy
U.S. Catanzaro 1929	Italian football clubs
Ternana Calcio	Italian football clubs, 1925 establishments in Europe, 1920s establishments in Italy
Ascoli Calcio 1898	Italian football clubs, 1898 establishments in Italy
A.C. Perugia Calcio	Italian football clubs, 1905 establishments in Italy
Empoli F.C.	Italian football clubs, 1920 establishments in Italy
A.C. ChievoVerona	Italian football clubs, Verona, 1929 establishments in Italy
Pussycat Dolls	2003 establishments in the United States, 2010 disestablishments in the United States, 2000s American music groups, 2010s American music groups, American girl groups, American pop music groups, American R&B bands, Dance music groups, Musical groups disestablished in 2010, Musical groups established in 2003, Musical groups from Los Angeles, California, Pussycat Dolls
Robert Kovač	1974 births, Living people, Croatian footballers
Yūzō Tashiro	1982 births, Living people, Footballers from Fukuoka Prefecture, Japan international footballers, J1 League players, J2 League players, J3 League players, Oita Trinita players, Sagan Tosu players, Kashima Antlers players, Montedio Yamagata players, Vissel Kobe players, Cerezo Osaka players, Cerezo Osaka U-23 players
Asier del Horno	1981 births, Living people, Spanish footballers
Marcelo Zalayeta	1978 births, Living people, Uruguayan footballers, Sportspeople from Montevideo
Montigny-lès-Metz	Communes in Moselle
Tokyo Station	Railway stations in Tokyo, 1914 establishments, 1910s establishments in Japan
Shimbashi Station	Railway stations in Tokyo, 1909 establishments in Asia, 1900s establishments in Japan
Pedro Munitis	1975 births, Living people, Spanish footballers
Feni River	Territorial disputes of India, Rivers of Bangladesh
Gumti River	Rivers of India, Rivers of Bangladesh
Keeranur	Settlements in Tamil Nadu
Birefringence	Optics, Geochemistry, Light
Shinagawa Station	Railway stations in Tokyo
Polymer banknote	Currency
Australian pound	Former currencies, Currency of Australia, 1910 establishments, 1910s establishments in Australia, 1966 disestablishments, 1960s disestablishments in Australia
Peruvian Airlines	Airlines of South America, Lima, 2007 establishments, Establishments in Peru, 2000s establishments in South America
Altadena, California	Unincorporated communities in California, Census-designated places in California, Settlements in Los Angeles County, California, 1887 establishments in California
Shingo Nejime	1984 births, Living people, Footballers from Tokyo Prefecture
Jun Tamano	1984 births, Living people, Footballers from Tokyo Prefecture
Yuhei Ono	1985 births, Living people, Footballers from Osaka Prefecture, People from Osaka
Kazuki Hiramoto	1981 births, Living people, Footballers from Tokyo Prefecture, FC Machida Zelvia players
Al-Arabi Doha	Sports clubs, Qatari football clubs
Octane rating	Chemistry, Everyday life
Post-disco	Electronic dance music, New wave, R&B music
List of post-disco artists	Musicians, Music-related lists
D. Train	Musical groups from New York City, Disco groups, Soul bands, American R&B bands
Culture Club	1981 establishments in England, 1980s British music groups, 1990s British music groups, 2000s British music groups, 2010s British music groups, English pop music groups, English rock bands, LGBT-themed musical groups, Musical groups established in 1981, New wave bands, Soul bands
Kool & The Gang	Jazz bands, Disco groups, Soul bands, American R&B bands, Musical groups from Jersey City, New Jersey, Musical groups established in 1969, 1969 establishments in the United States, 1960s establishments in New Jersey
John Ensign	1958 births, Living people, American physicians, Politicians from California, United States representatives from Nevada, United States senators from Nevada, US Republican Party politicians, Veterinarians
Vampirefreaks.com	1999 establishments in the United States, American websites, Social networking
Pascal's Wager	Philosophy
Pig (dice)	Dice games
Lightstorm Entertainment	Movie studios
Scott Free Productions	Movie studios, Movie industry
Women's National Basketball Association	Basketball leagues, 1997 establishments in the United States
Tamworth, New South Wales	Cities in New South Wales
New Zealand Dollar	Currency of Oceania, New Zealand, 1967 establishments in Oceania, 1960s establishments in New Zealand
Romeo Castelen	1983 births, Living people, Dutch footballers, People from Paramaribo
Al-Wakrah S.C.	Qatari football clubs
Al-Gharafa S.C.	Qatari football clubs
Hebephilia	Sexuality
Alan Smith	1980 births, Living people, English footballers, People from Leeds
Hebe	Greek gods and goddesses
Ephebophilia	Sexuality
The Bash (2009)	World Wrestling Entertainment pay-per-view events, History of Sacramento, California, 2009 in professional wrestling, 2009 in California
Oblate spheroid	Three-dimensional shapes, Astrophysics, Geodesy
Venice and Dalmatia	History of Italy, Venice, Dalmatia
Movia	Rail transport
Derby Carriage and Wagon Works	Rail transport in England
Sujoy Ghosh	Living people, 1966 births, Indian movie directors, People from Kolkata
Viscosity index	Fuel
WWE Breaking Point	2009 in professional wrestling, Sport in Montreal, World Wrestling Entertainment pay-per-view events, 2009 in Canada, 2000s in Montreal, September events
WrestleMania	WrestleMania
WWF Capital Carnage	World Wrestling Entertainment pay-per-view events
Vengeance (2005)	2005 in professional wrestling, Las Vegas, Nevada, WWE Vengeance, 2005 in the United States, 2000s in Nevada
Extreme Rules (2009)	2009 in professional wrestling, WWE Extreme Rules, Sports in New Orleans, Louisiana, 2009 in American television, 2000s in Louisiana, 21st century in New Orleans, Louisiana
In Your House	World Wrestling Entertainment pay-per-view events
Matthew West	1977 births, Living people, American guitarists, Musicians from Illinois, American pop musicians, Musicians from Nashville, Tennessee
Moshi Monsters	Online games
Golden Brown	1981 songs, Songs about drugs
ATB	1973 births, Living people, DJs, German musicians
Albania veneta	History of Italy, Venice
Professional Developers Conference	Microsoft
Heliantheae	Asteraceae
Levir Culpi	1953 births, People from Curitiba, Brazilian footballers, Brazilian football managers
Hiroshi Sowa	1956 births, Living people, Footballers from Hiroshima Prefecture, People from Hiroshima
Tadashi Nakamura	1971 births, Living people, Footballers from Tokyo Prefecture, Japan international footballers, Japanese football managers, J1 League players, J2 League players, Japan Soccer League players, Tokyo Verdy players, Urawa Red Diamonds players, Kyoto Sanga FC players
Kensaku Omori	1975 births, Living people, Footballers from Ehime Prefecture
René Desayere	1947 births, Living people, Belgian footballers, People from Antwerp
Romanian Land Forces	Romania, 1860 establishments in Europe, 19th century establishments in Romania
Zé Mario	1949 births, Living people, Footballers from Rio de Janeiro
Takayoshi Toda	1979 births, Living people, Footballers from Miyazaki Prefecture
Shinya Yoshihara	1978 births, Living people, Footballers from Ibaraki Prefecture
Takashi Aizawa	1982 births, Living people, Footballers from Niigata Prefecture
Shuhei Terada	1975 births, Living people, Footballers from Mie Prefecture, Japan international footballers, J1 League players, J2 League players, Kawasaki Frontale players
Hiroyuki Taniguchi	1985 births, Living people, Footballers from Kanagawa Prefecture, J1 League players, J2 League players, Kawasaki Frontale players, Yokohama F. Marinos players, Kashiwa Reysol players, Sagan Tosu players, Footballers at the 2008 Summer Olympics
Dâmboviţa River	Rivers of Romania
Dâmbovița County	Counties of Romania, States and territories established in 1968
Argeș River	Tributaries of the Danube
Kengo Nakamura	1980 births, Living people, Footballers from Tokyo Prefecture, Japan international footballers, J1 League players, J2 League players, Kawasaki Frontale players, 2010 FIFA World Cup players, 2013 FIFA Confederations Cup players
Yasuhiro Nagahashi	1975 births, Living people, Footballers from Shizuoka Prefecture
Ialomiţa River	Tributaries of the Danube
Gentry	Society
Nassau, Bahamas	National capitals in North America, Cities in the Caribbean, The Bahamas, 1695 establishments, 1690s establishments in North America, Establishments in the Bahamas
Wade Redden	1977 births, American Hockey League players, Brandon Wheat Kings players, Canadian ice hockey defencemen, Ice hockey people from Saskatchewan, Living people, New York Rangers players, Ottawa Senators players
Marty Murray	1975 births, American Hockey League players, Brandon Wheat Kings players, Calgary Flames players, Canadian ice hockey centres, Carolina Hurricanes players, Ice hockey people from Manitoba, Living people, Los Angeles Kings players, Philadelphia Flyers players
Ekwerazu	Settlements in Nigeria, Towns in Africa
Borderline personality disorder	Borderline personality disorder
Personality disorder	Personality disorders
Mood disorder	Mood disorders
Mood	Emotions
Appetite	Endocrinology
Fatigue	Health
Guy Carbonneau	1960 births, American Hockey League players, Canadian ice hockey coaches, Canadian ice hockey centres, Chicoutimi Saguenéens (QMJHL) players, Dallas Stars players, Ice hockey people from Quebec, Living people, Montreal Canadiens players, St. Louis Blues players, Stanley Cup champions
Reg Abbott	1930 births, American Hockey League players, Brandon Wheat Kings players, Canadian ice hockey centres, Ice hockey people from Manitoba, Living people, Montreal Canadiens players, Sportspeople from Winnipeg, Eastern Hockey League players
Doug Bentley	1916 births, 1972 deaths, Canadian ice hockey left wingers, Chicago Blackhawks players, Hockey Hall of Fame inductees, Ice hockey people from Saskatchewan, New York Rangers players
Eric Staal	1984 births, American Hockey League players, Buffalo Sabres players, Canadian ice hockey centres, Canadian Olympic gold medalists, Carolina Hurricanes players, Ice hockey people from Ontario, Living people, People from Thunder Bay, Stanley Cup champions, Ontario Hockey League players
List of Quebec Nordiques head coaches	National Hockey League lists, Lists of sportspeople
Peter Schaefer	1977 births, Boston Bruins players, Brandon Wheat Kings players, Canadian ice hockey left wingers, Ice hockey people from Saskatchewan, Living people, Ottawa Senators players, Vancouver Canucks players
Parliament of Australia	Parliament of Australia
Mathematics Subject Classification	Mathematics
American Mathematical Society	Mathematics, Non-profit organizations of the United States
Mathematical Reviews	Mathematics journals, Databases, Science websites
Arthur Sarkissian	1960 births, Painters, Living people
Largest known prime number	Prime numbers
Northern League (baseball)	1993 establishments in North America, Baseball leagues
Carey Price	1987 births, American Hockey League players, Canadian ice hockey goaltenders, Canadian Olympic gold medalists, Hart Memorial Trophy winners, Ice hockey people from British Columbia, Living people, Medalists at the 2014 Winter Olympics, Montreal Canadiens players, Sportspeople from Vancouver, Tri-City Americans players, Vezina Trophy winners
Las Meninas	17th century paintings, Spanish paintings, Paintings by Diego Velazquez
Walt Poddubny	1960 births, 2009 deaths, American Hockey League players, Brandon Wheat Kings players, Canadian ice hockey left wingers, Deaths from myocardial infarction, Edmonton Oilers players, Ice hockey people from Ontario, New Jersey Devils players, New York Rangers players, People from Thunder Bay, Quebec Nordiques players, Toronto Maple Leafs players, International Hockey League (1945–2001) players, Ontario Hockey League players, Central Professional Hockey League players
Bertie Ahern	1951 births, Living people, Taoisigh of Ireland, Members of Dáil Éireann, People from Dublin
Nonkilling	Virtues, Ethics, Civil disobedience
Bonao	Settlements in Dominican Republic, 1495 establishments, 14th-century establishments in North America
Lewis and Clark Expedition	1804 in the United States, 1805 in the United States, 1806
Baia Mare	Municipalities of Romania, 1142 establishments, County capitals of Romania, 1140s establishments in Europe
Umm Kulthum	Contraltos, Egyptian singers, 1904 births, 1975 deaths, Songwriters, Egyptian actors
Craig Parker	1970 births, Living people, New Zealand movie actors, New Zealand television actors, New Zealand voice actors, New Zealand stage actors
Moon landing conspiracy theories	Conspiracy theories, Apollo program
Illinois General Assembly	Government of Illinois, State legislatures of the United States
Whig Party (United States)	Political parties in the United States, Whig party (US) politicians, 1850s disestablishments in the United States, 1833 establishments in the United States, 1856 disestablishments
Metronet	London Underground
Coriaria nepalensis	Cucurbitales, Shrubs
Leishmania	Protista
Neil Kinnock	1942 births, Living people, European Commissioners, Former Labour MPs (UK), Former members of the British House of Commons for Welsh constituencies, Leaders of the Labour Party (UK), Leaders of the Opposition (United Kingdom), Members of the House of Lords, Privy Councillors (UK), UK MPs 1970–1974, UK MPs 1974, UK MPs 1974–1979, UK MPs 1979–1983, UK MPs 1983–1987, UK MPs 1987–1992, UK MPs 1992–1997
South Talpatti Island	Islands of India, Uninhabited islands
50000 Quaoar	Kuiper belt objects, Dwarf planets
Make It or Break It	2009 American television series debuts, 2012 American television series endings, 2000s American television series, 2010s American television series, ABC Family series, American teen drama television series, Boulder, Colorado, Television series set in Colorado, English-language television programs
Samlesbury witches	Witchcraft, People from Lancashire, 17th century in England
Guernica (painting)	20th century paintings, Spanish paintings
List of vice presidents of the United States	Vice Presidents of the United States, Lists of politicians from the United States
Guernica (town)	Towns in Spain, Municipalities in the Basque Country
Flat Earth Society	Earth
John Birmingham	1964 births, Living people, Australian novelists, Australian science fiction writers, Writers from Liverpool, Writers from Queensland
Balibo (movie)	Australian movies, 2009 movies, English-language movies, Movies set in Asia
Nagoya University of Foreign Studies	Colleges and universities in Japan, 1988 establishments in Japan
Al Wasl SC	Sports clubs, Sport in Dubai
Cork City F.C.	Irish football clubs, Cork (city)
Discogs	Entertainment websites
Watch the Ride	Compilation albums, 2007 albums
Wedgie	Bullying
Med Hondo	1936 births, 2019 deaths, Mauritanian people, Movie actors, Movie directors, Movie producers, Screenwriters, Television actors, Voice actors
Happy Hardcore	Music genres
Log cabin	Houses
Basmati rice	Rice
Sarah Thyre	1968 births, Living people, American television actors
Antidepressant	Drugs used in psychiatry
Dirty bomb	Nuclear weapons
Jude the Apostle	Early Christian saints, Twelve Apostles, 1st century births, 1st century deaths
Pitcher plant	Flowering plants, Carnivorous plants
Fried Green Tomatoes (movie)	1991 drama movies, 1990s LGBT movies, American drama movies, American LGBT movies, Birmingham, Alabama, English-language movies, Movies based on books, Movies set in Alabama, Movies set in the 1920s, Movies set in the 1980s, Universal Pictures movies, Movies directed by Jon Avnet
Ischemic colitis	Diseases and disorders of the digestive system
Hypotension	Diseases and disorders of the cardiovascular system
Race condition	Computer hardware
Mary-Louise Parker	1964 births, Living people, American movie actors, American television actors, Actors from South Carolina
Gay & Lesbian Alliance Against Defamation	LGBT in the United States, Organizations in New York City, 1985 establishments in New York (state), Civil rights organizations
Don Carlos	Operas set in Spain, Compositions by Giuseppe Verdi
Carlos, Prince of Asturias	1545 births, 1568 deaths, Princes and Princesses of Asturias, People from Valladolid
Don Carlos (play)	Plays
Gloria Stuart	1910 births, 2010 deaths, Deaths from respiratory failure, Deaths from lung cancer, Actors from Santa Monica, California, American centenarians, American silent movie actors, American movie actors, American television actors, American stage actors, American radio actors
Spanish Inquisition	Discrimination, Courts (law), Catholicism, 1478 establishments, 1470s establishments in Europe, Establishments in Spain, 1834 disestablishments, 19th century disestablishments in Europe, 15th century in Spain, 16th century in Spain, 17th century in Spain, 18th century in Spain, 19th century in Spain
George B. McClellan	1826 births, 1885 deaths, American Civil War generals, Politicians from Pennsylvania, Governors of New Jersey, US Democratic Party politicians
Richard Lugar	1932 births, 2019 deaths, Alumni of the University of Oxford, American mayors, Deaths from neurodegenerative disease, American Methodists, 1996 United States presidential candidates, Disease-related deaths in Virginia, United States senators from Indiana, US Republican Party politicians
Jesse Helms	1921 births, 2008 deaths, American activists, American Baptists, American conservatives, Anti-Communists, Anti-LGBT rights activists, Deaths from vascular dementia, Disease-related deaths in North Carolina, Politicians from Raleigh, North Carolina, United States senators from North Carolina, US Republican Party politicians, Writers from Raleigh, North Carolina
Rita Mae Brown	1944 births, Living people, American autobiographers, American LGBT rights activists, American novelists, American screenwriters, Lesbian feminists, LGBT people from Florida, LGBT people from Pennsylvania, LGBT writers, Writers from Florida, Writers from Pennsylvania
Gobi Desert	Deserts of Asia
Diamantinasaurus	Dinosaurs of Australia
Wintonotitan	Dinosaurs of Australia
Mozilla Add-ons	Mozilla
Vladimir Vysotsky	1938 births, 1980 deaths, Deaths from myocardial infarction, Actors from Moscow, Musicians from Moscow, Russian actors, Russian poets, Russian singers, Russian television actors, Soviet actors, Soviet singers
Tomoaki Kuno	1973 births, Living people, Footballers from Shizuoka Prefecture
Ricardo Oliveira	1980 births, Living people, Brazilian footballers
Atsuhiko Mori	1972 births, Living people, Footballers from Hyōgo Prefecture
Tatsunori Arai	1983 births, Living people, Footballers from Hokkaidō Prefecture
S.L. Benfica	Portuguese football clubs, Lisbon, 1904 establishments in Europe, 1900s establishments in Portugal
C.F. Os Belenenses	Portuguese football clubs, Lisbon, 1919 establishments in Europe, 20th century establishments in Portugal
Boavista F.C.	Portuguese football clubs, Porto, 1903 establishments in Europe, 1900s establishments in Portugal
Tatsuya Furuhashi	1980 births, Living people, Footballers from Shizuoka Prefecture
Alexsandro de Souza	1977 births, Living people, Brazilian footballers, People from Curitiba, Coritiba Foot Ball Club players
Hideki Uchidate	1974 births, Living people, Footballers from Saitama Prefecture
Ricardo Pereira	1976 births, Living people, Portuguese footballers
Paolo Montero	1971 births, Living people, Uruguayan footballers, Sportspeople from Montevideo
Benedicto Antoninho	1939 births, Living people, Brazilian footballers
Steve Perryman	1951 births, Living people, English footballers, English football managers, Sportspeople from London
Kojiro Kaimoto	1977 births, Living people, Footballers from Osaka Prefecture, People from Osaka
Fabrizio Ravanelli	1968 births, Living people, Italian footballers
Giampiero Boniperti	1928 births, 2021 deaths, Deaths from heart failure, Italian footballers, Former MEPs, MEPs for Italy
Aruna Dindane	1980 births, Living people, Ivorian footballers
Idriss Carlos Kameni	1984 births, Living people, Cameroonian footballers, Association football goalkeepers
Nobuki Hara	1979 births, Living people, Footballers from Kagoshima Prefecture
Márcio Amoroso	1974 births, Living people, Brazilian footballers, People from Brasília
Joel Santana	1948 births, Living people, Footballers from Rio de Janeiro, Brazilian football managers
Biofuel	Biofuels
Hisashi Kurosaki	1968 births, Living people, Footballers from Tochigi Prefecture, Japan international footballers, Japanese football managers, J1 League players, J2 League players, Japan Soccer League players, Honda FC players, Kashima Antlers players, Kyoto Sanga FC players, Vissel Kobe players, Albirex Niigata players, Omiya Ardija players, 1988 AFC Asian Cup players
Michelangelo Rampulla	1962 births, Living people, Italian association football goalkeepers
Igor Tudor	1978 births, Living people, Croatian footballers, Croatian football managers, People from Split
Marek Jankulovski	1977 births, Living people, Czech footballers
Tomáš Ujfaluši	1978 births, Living people, Czech footballers
Valeri Bojinov	1986 births, Living people, Bulgarian footballers
Robert Jarni	1968 births, Living people, Croatian footballers, Croatian football managers
Hiroyuki Shirai	1974 births, Living people, Footballers from Shizuoka Prefecture, J1 League players, J2 League players, Shimizu S-Pulse players, Tokyo Verdy players, Cerezo Osaka players, Shonan Bellmare players, Vegalta Sendai players, FC Ryukyu players, Footballers at the 1996 Summer Olympics
Harutaka Ono	1978 births, Living people, Footballers from Saitama Prefecture
Masahiro Ohashi	1981 births, Living people, Footballers from Kanagawa Prefecture
Shigenori Hagimura	1976 births, Living people, Footballers from Mie Prefecture
Masahiro Fukasawa	1977 births, Living people, Footballers from Shizuoka Prefecture
Jesper Grønkjær	1977 births, Living people, Danish footballers, Greenlandic people, North American footballers
Motohiro Yoshida	1974 births, Living people, Footballers from Osaka Prefecture, People from Osaka
Daniel Agger	1984 births, Living people, Danish footballers
Iván Córdoba	1976 births, Living people, Colombian footballers
Nozomi Hiroyama	1977 births, Living people, Footballers from Chiba Prefecture, Japan international footballers, J1 League players, J2 League players, JEF United Chiba players, Tokyo Verdy players, Cerezo Osaka players, Thespakusatsu Gunma players
Naoki Mihara	1987 births, Living people, Footballers from Tokyo Prefecture, YSCC Yokohama players
Kento Tsurumaki	1987 births, Living people, Footballers from Niigata Prefecture
Kohei Kiyama	1988 births, Living people, Footballers from Tokyo Prefecture
Kazunori Iio	1982 births, Living people, Footballers from Kanagawa Prefecture
Yugo Ichiyanagi	1985 births, Living people, Footballers from Tokyo Prefecture
Yoshiyuki Hasegawa	1969 births, Living people, Footballers from Kyoto Prefecture, Japan international footballers, J1 League players, Japan Soccer League players, Honda FC players, Kashima Antlers players
Trevor Kell	1986 births, Canadian ice hockey right wingers, Ice hockey people from Ontario, Living people, People from Thunder Bay, American Hockey League players
Malcolm MacMillan	1982 births, Living people, Canadian ice hockey centres, Ice hockey people from Ontario, People from Thunder Bay
Bobby Bolt	1987 births, Living people, Canadian ice hockey left wingers, Ice hockey people from Ontario, People from Thunder Bay, American Hockey League players
Maleficium (sorcery)	Latin phrases, Magic (paranormal)
Komodo (island)	Islands of Indonesia
Ella Fitzgerald	1917 births, 1996 deaths, American jazz singers, Deaths from diabetes, Kennedy Center honorees, People from Newport News, Virginia, Singers from New York, Singers from Virginia, Deaths from stroke, Cardiovascular disease deaths in Los Angeles
Billie Holiday	1915 births, 1959 deaths, African American musicians, American autobiographers, American jazz musicians, American people convicted of drug offenses, American Roman Catholics, American singer-songwriters, Deaths from cirrhosis, Disease-related deaths in New York
Grafite	1979 births, Living people, Brazilian footballers
York City F.C.	English football clubs, York, 1922 establishments in the United Kingdom, 1920s establishments in England
Nina Simone	1933 births, 2003 deaths, African American musicians, American autobiographers, American civil rights activists, American jazz musicians, American pianists, American singer-songwriters, Deaths from breast cancer, Singers from North Carolina, People with bipolar disorder
Star cluster	Star clusters
Giant armadillo	Endangered species, Mammals of South America, Xenarthrans
Island Def Jam Music Group	American record labels, 1999 establishments in the United States
Genie in a Bottle	1999 songs, Christina Aguilera songs
Arista Records	American record labels, 1974 establishments in the United States
Bessie Smith	1892 births, 1937 deaths, African American musicians, American LGBT people, American jazz musicians, American jazz singers, Bisexual people, LGBT African Americans, American blues singers, LGBT singers, People from Chattanooga, Tennessee, Road accident deaths in Mississippi, Singers from Tennessee
Brian Molko	1972 births, Living people, Bisexual people, British rock guitarists, LGBT musicians, Musicians from Brussels, Scottish LGBT people, Scottish rock musicians, Scottish rock singers, Scottish singer-songwriters
Roe deer	Deer
Wapiti	Deer, Mammals of North America
Lockheed SR-71 Blackbird	United States Air Force aircraft, Lockheed & Lockheed-Martin aircraft
Keith Allen (actor)	1953 births, Living people, British comedians, British television directors, British television presenters, British television writers, People from Swansea, Welsh movie actors, Welsh musicians, Welsh television actors, Welsh writers
Doctor Yellow	High-speed rail, Trains, Rail transport in Japan
Fabrício de Souza	1982 births, Living people, Brazilian footballers
Yasuto Honda	1969 births, Living people, Footballers from Fukuoka Prefecture, Japan international footballers, J1 League players, Japan Soccer League players, Honda FC players, Kashima Antlers players, 1996 AFC Asian Cup players
Ken Fujita	1979 births, Living people, Footballers from Shizuoka Prefecture
Magrão	1978 births, Living people, Brazilian footballers
Fábio Júnior Pereira	1977 births, Living people, Brazilian footballers
Marco Zanchi	1977 births, Living people, Italian footballers
Main sequence	Astrophysics, Types of stars
Kennedy family	Kennedy family, John F. Kennedy
Disney Channel Portugal	Television series by Disney, Television lists
Independent Democrat	Politics
Classes of United States senators	United States Senate
Nvidia	American technology companies, 1993 establishments in California
Lipizzaner	Horse breeds
Franklin Towers	Portland, Maine, Buildings and structures in Maine
Survivor Series (2008)	2008 in American television, 2008 in professional wrestling, Sports in Boston, Massachusetts, Survivor Series, 2008 in Massachusetts, 2000s in Boston, Massachusetts
Cyber Sunday (2008)	2008 in professional wrestling, 2008 in the United States, 2000s in Phoenix, October 2008 events
Bragging Rights (2009)	World Wrestling Entertainment pay-per-view events, 2009 in professional wrestling, 2009 in Pennsylvania, 21st century in Pittsburgh, October 2009 events
Hell in a Cell (2009)	World Wrestling Entertainment pay-per-view events, Newark, New Jersey, 2009 in professional wrestling, 2000s in New Jersey, 2009 in the United States
Astrometry	Astronomy
Hardelot Castle	Castles in France, Hauts-de-France, 12th century establishments in Europe, 1222 establishments, 1220s establishments in Europe, Establishments in France
Christian Manfredini	1975 births, Living people, Ivorian footballers
Koji Sakamoto	1978 births, Living people, Footballers from Shiga Prefecture
Satoru Yamagishi	1983 births, Living people, Footballers from Chiba Prefecture, Japan international footballers, J1 League players, J2 League players, J3 League players, JEF United Chiba players, Kawasaki Frontale players, Sanfrecce Hiroshima players, Oita Trinita players
Hiroki Mizuhara	1975 births, Living people, Footballers from Nara Prefecture, Kamatamare Sanuki players
Satoshi Tokizawa	1985 births, Living people, Footballers from Gunma Prefecture
Takaya Kurokawa	1981 births, Living people, Footballers from Ehime Prefecture, J1 League players, J2 League players, Shimizu S-Pulse players, Tokyo Verdy players, JEF United Chiba players, Albirex Niigata players, Footballers at the 2004 Summer Olympics
Giuliano Giannichedda	1974 births, Living people, Italian footballers
Yukihiro Aoba	1979 births, Living people, Footballers from Saitama Prefecture
Takaki Shigemitsu	1983 births, Living people, Footballers from Fukuoka Prefecture
Masatomo Kuba	1984 births, Living people, Footballers from Kanagawa Prefecture
Masafumi Maeda	1983 births, Living people, Footballers from Shiga Prefecture
Bunji Kimura	1944 births, Living people, Footballers from Kyoto
Pim Verbeek	1956 births, 2019 deaths, Deaths from cancer, Dutch football managers, Dutch footballers, Sportspeople from Rotterdam
Earl Grey tea	Tea
Count Basie	American jazz musicians, Kennedy Center honorees, Autobiographers, Musicians from New Jersey, 1904 births, 1984 deaths
Formula Three	Auto racing
Formula Ford	Auto racing
Jackie Stewart	1939 births, Living people, Formula One drivers, Scottish racecar drivers
List of Formula One World Constructors' Champions	Formula One constructors, Formula One current, Formula One lists, 1958 establishments
Techniques d'Avant Garde	Formula One engine manufacturers, Luxembourg City
Repco	Formula One engine manufacturers, Companies of Australia
Mitsubishi Lancer	Mitsubishi automobiles
Mitsubishi Mirage	Mitsubishi automobiles
Mitsubishi Colt	Mitsubishi automobiles
Mitsubishi Galant	Mitsubishi automobiles
Frank Williams	1942 births, Living people, Formula One people
Patrick Head	Formula One people, Living people, 1945 births, English sportspeople
Frank Williams Racing Cars	Formula One constructors
Alfreton	Towns in Derbyshire
International Hotel Management Institute	Schools in Switzerland
Heavy machine gun	Heavy machine guns
The West Wing	1999 American television series debuts, 2006 American television series endings, 1990s American drama television series, 1990s American workplace television series, 2000s American drama television series, 2000s American workplace television series, American workplace drama television series, Golden Globe Award winning programs, NBC network shows, Peabody Award winners, Television series set in Washington, D.C., Emmy Award winning programs, English-language television programs
Servite College	Schools in Australia, Perth, Western Australia, 1958 establishments in Australia
1139	1139
Afonso I of Portugal	1109 births, 1185 deaths, Kings and Queens of Portugal
Amália Rodrigues	1920 births, 1999 deaths, Deaths from myocardial infarction, Portuguese singers, Portuguese movie actors, Guitarists
Ted Kaufman	Living people, 1939 births, United States senators from Delaware, Politicians from Philadelphia, Pennsylvania, US Democratic Party politicians
Orrin Hatch	Living people, 1934 births, Presidential Medal of Freedom recipients, American Latter Day Saints, Politicians from Pittsburgh, Pennsylvania, Presidents pro tempore of the United States Senate, United States senators from Utah, US Republican Party politicians, 2000 United States presidential candidates
Committees of the United States Senate	Committees of the United States Senate, United States Senate
Johnny Rozsa	Year of birth missing (living people), Living people, African Jews, American Jews, American photographers, British Jews, British photographers, Jewish artists, Naturalised citizens of the United Kingdom, Naturalized citizens of the United States, People from Nairobi
Lichen	Fungi, Botany, Bacteria, Algae, Extremophiles, Non-vascular plants, Symbiosis
History of the Earth	Earth, Moon, Earth sciences
Tomo Sugawara	1976 births, Living people, Footballers from Hokkaidō Prefecture
Shin Kanazawa	1983 births, Living people, Footballers from Saitama Prefecture
Donizete Francisco de Oliveira	1968 births, Living people, Brazilian footballers
Harrow School	Schools in London, London Borough of Harrow
Roger Wicker	1951 births, Living people, American lawyers, American military people, Colonels, People from Pontotoc, Mississippi, State legislators of the United States, United States representatives from Mississippi, United States senators from Mississippi, US Republican Party politicians, 20th-century American politicians, 21st-century American politicians
The Return of Jafar	1994 movies, Aladdin (Disney), Disney animated movies, Disney direct-to-video movies, English-language movies
Aladdin and the King of Thieves	1996 movies, Aladdin (Disney), Disney animated movies, English-language movies
Ja, vi elsker dette landet	Norway, National anthems
Mass number	Chemistry
J. Caleb Boggs	1909 births, 1993 deaths, Governors of Delaware, United States representatives from Delaware, United States senators from Delaware, US Republican Party politicians
LazyTown	Children's television series, 2004 television series debuts, 2014 television series endings
Blockland	2007 video games, Windows games
Tarzan II	2000 movies, Sequel movies, Disney animated movies, Disney direct-to-video movies, Tarzan (Disney), Tarzan movies, Jungle movies
Tactical victory	War
Terminal velocity	Velocity
Babe (movie)	1995 comedy-drama movies, 1990s family movies, American drama movies, American family movies, Australian comedy movies, Australian drama movies, English-language movies, Movies about animals, Movies based on books, Movies set in Australia, Universal Pictures movies
Swedish Empire	Former empires
Mountain View, California	Mountain View, California
Estonians	Estonian people, Ethnic groups in Europe
Menlo Park, California	Menlo Park, California
Estonian Soviet Socialist Republic	1940 establishments, 1941 disestablishments, 1944 establishments in the Soviet Union, 1991 disestablishments in the Soviet Union, 1940s establishments in Europe, Former countries in Europe, Republics of the Soviet Union, States and territories disestablished in the 1990s
National Film and Sound Archive	National archives, Museums in Australia, Libraries in Australia, Government agencies of Australia, Buildings and structures in Canberra, 1935 establishments, 1930s establishments in Australia
Ice Cube	1969 births, Living people, Actors from Los Angeles, California, African American actors, African American movie producers, African American musicians, American movie actors, American rap musicians from California, American screenwriters, American television actors, American television producers, American voice actors, American Muslims, Movie producers from Los Angeles, California, Screenwriters from Los Angeles, California, Singers from Los Angeles, California
West Coast hip hop	Hip hop genres
Gangsta rap	Hip hop genres, 1980s in music, 1990s in music, 2000s in music, Pronunciation, Obscenity controversies
Political hip hop	Hip hop genres
Waltzing Matilda	Australian music, Australian folklore
Wolfgang Paul	1913 births, 1993 deaths, German physicists, German Nobel Prize winners
Rod Barajas	1975 births, Living people, Arizona Diamondbacks players, Texas Rangers players, Philadelphia Phillies players, Toronto Blue Jays players
Norway, Maine	Towns in Maine
Westbrook, Maine	Towns in Maine
John Rocker	American baseball players, Atlanta Braves players, Cleveland Indians players, Sportspeople from Georgia (U.S. state), Tampa Bay Devil Rays players, Texas Rangers players, 1974 births, Living people
Belkin	Companies based in Los Angeles, American technology companies
Dell Curry	1964 births, Living people, Cleveland Cavaliers players, Milwaukee Bucks players, Toronto Raptors players, Utah Jazz players
Adriano Gerlin da Silva	1974 births, Living people, Brazilian footballers
Andrzej Kubica	1972 births, Living people, Polish footballers
Fernando Picun	1972 births, Living people, Uruguayan footballers, Sportspeople from Montevideo
Campeonato Brasileiro Série B	Campeonato Brasileiro, 1971 establishments, 1970s establishments in Brazil
Bangu Atlético Clube	Football clubs in Rio de Janeiro, 1904 establishments in South America, 1900s establishments in Brazil
Esporte Clube Vitória	Brazilian football clubs, Salvador, Bahia, 1899 establishments, 1890s establishments in Brazil
Rubén Olivera	1983 births, Living people, Uruguayan footballers, Sportspeople from Montevideo
Mike Havenaar	1987 births, Living people, Footballers from Hiroshima Prefecture, Japan international footballers, J1 League players, J2 League players, Yokohama F. Marinos players, Avispa Fukuoka players, Sagan Tosu players, Ventforet Kofu players, Vissel Kobe players, Vegalta Sendai players, 2013 FIFA Confederations Cup players
Red Bull Bragantino	Football clubs in São Paulo (state), 1928 establishments, 1920s establishments in Brazil
Associação Portuguesa de Desportos	Football clubs in São Paulo (state), 1920 establishments in South America, 1920s establishments in Brazil
Associação Desportiva São Caetano	Football clubs in São Paulo (state), 1989 establishments in Brazil
Jorge Pereira da Silva	1985 births, Living people, Brazilian footballers, People from Salvador, Bahia
Ryosuke Kijima	1979 births, Living people, Footballers from Chiba Prefecture, Kamatamare Sanuki players
Željko Milinovič	1976 births, Living people, Slovenian footballers, Sportspeople from Ljubljana
Days of Thunder	1990 movies, 1990s romantic drama movies, American romantic drama movies, American sports movies, English-language movies, Movies directed by Tony Scott
Robber	Robbers
1965 Atlantic hurricane season	1965 Atlantic hurricane season
1964 Atlantic hurricane season	Atlantic hurricane seasons, 1964
Carnegie Hall Tower	Skyscrapers in New York City, 1991 establishments in New York (state), Buildings and structures in Manhattan
Josep Samitier	1902 births, 1972 deaths, Spanish footballers, Spanish football managers, Sportspeople from Barcelona
László Kubala	1927 births, 2002 deaths, Slovak footballers, Hungarian footballers, Hungarian football managers, Spanish footballers
Ricardo Zamora	1901 births, 1978 deaths, Spanish association football goalkeepers, Spanish football managers, Sportspeople from Barcelona
Morgan De Sanctis	1977 births, Living people, Italian footballers
Hips Don't Lie	Shakira songs, 2006 songs
She Wolf (song)	2009 songs, Shakira songs
Federation of Australia	Government of Australia
Royal Exhibition Building	World Heritage Sites in Australia, Buildings and structures in Victoria, Australia, 1880 establishments, 1880s establishments in Australia
Tetsuya Ito	1970 births, Living people, Footballers from Chiba Prefecture
Giuseppe Zappella	1973 births, Living people, Italian footballers, Sportspeople from Milan
Alfred Nijhuis	1966 births, Living people, Dutch footballers, Sportspeople from Utrecht (city)
Luis del Sol	1935 births, 2021 deaths, Spanish footballers
Alessandro Birindelli	1974 births, Living people, Italian footballers
Jun Uruno	1979 births, Living people, Footballers from Saitama Prefecture
Nicola Legrottaglie	1976 births, Living people, Italian footballers
Hwang Sun-hong	1968 births, Living people, South Korean footballers, South Korean football managers
Koji Tanaka	1955 births, Living people, Footballers from Saitama Prefecture, Japan international footballers, Japanese football managers, Japan Soccer League players, NKK SC players
Mitsuru Komaeda	1950 births, Living people, Footballers from Iwate Prefecture, Japan international footballers, Japanese football managers, Japan Soccer League players, Shonan Bellmare players
Ryo Nurishi	1986 births, Living people, Footballers from Kanagawa Prefecture
Aaron Lennon	1987 births, Living people, Black British sportspeople, English footballers, People from Leeds, Tottenham Hotspur F.C. players, Premier League players
Lee Young-pyo	1977 births, Living people, South Korean footballers
Siege of Fort Zeelandia	History of Taiwan, Sieges
Koxinga	History of Taiwan, 1624 births, 1662 deaths, History of China, Chinese people
Fujian	Provinces of China
Cotuí	Settlements in Dominican Republic, 1500s establishments in the Spanish Empire
Costume	Clothing, Theater
Oolite (computer game)	2013 video games, MacOS games, Linux software, Windows games
Kaskade	1971 births, Living people, American DJs, Techno music
Lost Ones	Rap music, Jay-Z songs
FrostWire	Software
Jeezy	Singers from South Carolina, American rap musicians, 1977 births, Living people, People from Columbia, South Carolina, Gangsta rappers, African American musicians
Kutná Hora	Cities in the Czech Republic
Maine Public Broadcasting Network	Public Broadcasting Service, Lewiston, Maine
Kidzania Jakarta	Theme parks in Asia, Jakarta, Buildings and structures in Indonesia
Stone Cold Steve Austin	1964 births, Living people, American agnostics, American movie actors, American professional wrestlers, Former WWE wrestlers, Actors from Austin, Texas, Sportspeople from Austin, Texas, WWE Hall of Fame
Chyna	1970 births, 2016 deaths, Actors from New York, American pornographic actors, American professional wrestlers, Female professional wrestlers, Former WWE wrestlers, Sportspeople from New York, Television personalities from New York
Vengeance (2004)	2004 in professional wrestling, Sports in Hartford, Connecticut, WWE Vengeance, 2000s in Connecticut, 2004 in the United States, History of Hartford, Connecticut
Vengeance (2003)	2003 in professional wrestling, Sports in Denver, Colorado, WWE Vengeance, History of Colorado, 2003 in the United States, July events
Vengeance (2002)	2002 in professional wrestling, Sports in Detroit, Michigan, WWE Vengeance, 2002 in the United States, 2000s in Detroit, Michigan
Stealth aircraft	Military aircraft
Stealth ship	Ship types
Vengeance (2001)	2001 in professional wrestling, Sports in San Diego, California, WWE Vengeance, 2001 in California, 21st century in San Diego, California
Long integer	Integers, Computers
R101	1930, 1930s in France, Airships, Aviation disasters in Europe, Disasters in the 20th century
The Mars Volta	2001 establishments in the United States, 2012 disestablishments in the United States, American rock bands, Musical groups established in 2001, Musical groups disestablished in 2012, Musical groups from Texas, People from El Paso, Texas
Santa Cruz del Seibo	Settlements in Dominican Republic, 1500s establishments in the Spanish Empire
Juan de Esquivel	1480s births, 1510s deaths, History of Jamaica, Spanish military people
Daishiro Yoshimura	1947 births, 2003 deaths, Brazilian-Japanese footballers, Japan international footballers, Japan Soccer League players, Cerezo Osaka players, Deaths from intracranial hemorrhage
Boban Babunski	1968 births, Living people, People from North Macedonia, European footballers
Yutaka Takahashi	1980 births, Living people, Footballers from Tokyo Prefecture, Avispa Fukuoka players
Yuichi Yoda	1977 births, Living people, Footballers from Hyōgo Prefecture
Hwangbo Kwan	1965 births, Living people, South Korean footballers, South Korean football managers
Edmilson Carlos Abel	1974 births, Living people, Brazilian footballers
Indian Standard Time	Time zones
Robert de Pinho de Souza	1981 births, Living people, Brazilian footballers, People from Salvador, Bahia
Antônio Benedito da Silva	1965 births, Living people, Brazilian footballers
Villa Nova Atlético Clube	Brazilian football clubs, Minas Gerais, 1908 establishments in South America, 1900s establishments in Brazil
Sampaio Corrêa Futebol Clube	Brazilian football clubs, Maranhão, 1923 establishments, 1920s establishments in Brazil
Tuna Luso Brasileira	Brazilian football clubs, Belém, 1903 establishments in South America, 1900s establishments in Brazil
Paysandu Sport Club	Brazilian football clubs, Belém, 1914 establishments in Brazil
Michael Rummenigge	1964 births, Living people, German footballers, Sportspeople from North Rhine-Westphalia
Bora Milutinović	1944 births, Living people, Serbian footballers, Serbian football managers
Chikara Fujimoto	1977 births, Living people, Footballers from Yamaguchi Prefecture, Japan international footballers, J1 League players, J2 League players, Avispa Fukuoka players, Sanfrecce Hiroshima players, Nagoya Grampus players, Vissel Kobe players, Omiya Ardija players, Roasso Kumamoto players
Takuya Nozawa	1981 births, Living people, Footballers from Ibaraki Prefecture
Kozo Yuki	1979 births, Living people, Footballers from Kanagawa Prefecture
Goiás Esporte Clube	Brazilian football clubs, Goiânia, 1943 establishments, 1940s establishments in Brazil
Uberlândia Esporte Clube	Brazilian football clubs, Minas Gerais, 1922 establishments, 1920s establishments in Brazil
América Futebol Clube (MG)	Brazilian football clubs, Belo Horizonte, 1912 establishments in Brazil
Associação Atlética Internacional (Limeira)	Football clubs in São Paulo (state), 1913 establishments in Brazil
Campo Grande Atlético Clube	Football clubs in Rio de Janeiro, 1940 establishments in South America, 1940s establishments in Brazil
Clube Atlético Juventus	Football clubs in São Paulo (state), 1924 establishments in South America, 1920s establishments in Brazil
Londrina Esporte Clube	Brazilian football clubs, Paraná State, 1956 establishments in South America, 1950s establishments in Brazil
Esporte Clube Juventude	Brazilian football clubs, Rio Grande do Sul, 1913 establishments in Brazil
Criciúma Esporte Clube	Brazilian football clubs, Santa Catarina, 1947 establishments in South America, 1940s establishments in Brazil
Craps	Dice games
Bookkeeping	Finance
Philology	Writing
Party in the U.S.A.	2009 songs, Miley Cyrus songs
ECW December to Dismember	World Wrestling Entertainment pay-per-view events
December to Dismember (1995)	1995 in professional wrestling, Extreme Championship Wrestling, Sports in Philadelphia, 1995 in the United States, 1990s in Philadelphia
December to Dismember (2006)	2006 in professional wrestling, Augusta, Georgia, World Wrestling Entertainment pay-per-view events, 2000s in Georgia (U.S. state), 2006 in the United States
Basile Boli	1967 births, Living people, French footballers
Michael Baur	1969 births, Living people, Austrian footballers, Austrian football managers, Players of the Austrian national football team, Innsbruck
Brian Steen Nielsen	1968 births, Living people, Danish footballers
Ministry of Public Enlightenment and Propaganda	Nazi Germany, Ministries, 1933 establishments, 1930s establishments in Germany, 1945 disestablishments in Germany
Al-Ghazali	1058 births, 1111 deaths, Persian scientists, Muslims, Asian Sufis, Theologians, Philosophers, Psychologists
Girl Scouts of the USA	Scouting
Big band	Musical groups
Duke Ellington	African American musicians, American composers, American jazz musicians, American pianists, Bandleaders, Deaths from pneumonia, Cancer deaths in New York City, Deaths from lung cancer, Jazz composers, Musicians from Washington, D.C., 1899 births, 1974 deaths
List of Slipknot band members	Slipknot, Lists of entertainers, Music-related lists
Little River (Withlacoochee River)	Rivers of Georgia (U.S. state)
Queen Elizabeth School	Education in Hong Kong
Tasman Bridge	Bridges in Australia, Concrete bridges, Hobart, Buildings and structures in Tasmania, 1964 establishments, 1960s establishments in Australia
Marcos Bonifacio da Rocha	1976 births, Living people, Brazilian footballers
Kazuo Imanishi	1941 births, Living people, Footballers from Hiroshima Prefecture, Japan international footballers, Japan Soccer League players, Sanfrecce Hiroshima players
Humberlito Borges	1980 births, Living people, Brazilian footballers, People from Salvador, Bahia
Welington Nogueira Lopes	1979 births, Living people, Brazilian footballers
Thiago Neves	1985 births, Living people, Brazilian footballers, People from Curitiba
Makoto Teguramori	1967 births, Living people, Footballers from Aomori Prefecture, Japanese football managers, J1 League players, Japan Soccer League players, Kashima Antlers players, Montedio Yamagata players
Pauli exclusion principle	Quantum mechanics
Anthropic principle	Cosmology
United States Environmental Protection Agency	United States government agencies, Environmental organizations, 1970 establishments in the United States
Nagua	Settlements in Dominican Republic, 1938 establishments in the Dominican Republic
Chris Carter	1956 births, Living people, American movie directors, Writers from California
Cultural Revolution	History of China
Alex Antônio de Melo Santos	1983 births, Living people, Brazilian footballers
Paulo Autuori	1956 births, Living people, Footballers from Rio de Janeiro
Kentaro Sawada	1970 births, Living people, Footballers from Kanagawa Prefecture, Japan international footballers, J1 League players, J2 League players, Kashiwa Reysol players, Sanfrecce Hiroshima players
Paraná Clube	Brazilian football clubs, Curitiba, 1989 establishments in Brazil
Great Leap Forward	1958, 1959, 1960, 1961, 1950s in China, 1960s in China
Sociedade Esportiva do Gama	Brazilian football clubs, Brazilian Federal District, 1975 establishments, 1970s establishments in Brazil
União São João Esporte Clube	Brazilian football clubs, Football clubs in São Paulo (state), 1981 establishments in South America, 1980s establishments in Brazil
Brasiliense FC	Brazilian football clubs, Brazilian Federal District, 2000 establishments, 20th-century establishments in Brazil
Savona 1907 F.B.C.	Italian football clubs
A.C. Prato	Italian football clubs, 1908 establishments in Italy
Aurora Pro Patria 1919	Italian football clubs, 1919 establishments in Italy
A.C. Pavia	Italian football clubs, Pavia, 1911 establishments in Italy
Treviso F.B.C. 1993	Italian football clubs, 1909 establishments in Italy
A.C. Monza	Italian football clubs, Monza, 1912 establishments in Italy
A.C. Ancona	Italian football clubs, Ancona, 1905 establishments in Italy, 2010 disestablishments in Europe, 21st century disestablishments in Italy, 2010s in Italy
S.S. Juve Stabia	Italian football clubs, 1907 establishments in Italy
Taranto Sport	Italian football clubs, 1906 establishments in Europe, 1900s establishments in Italy
S.S. Cavese 1919	Italian football clubs, 1919 establishments in Italy
A.C. Maceratese	Italian football clubs, 1922 establishments in Italy
HNK Rijeka	Establishments in Croatia, 1946 establishments in Europe, Croatian football clubs
A.C. Fanfulla 1874	Italian football clubs, Lodi, 1974 establishments in Europe, 1970s establishments in Italy
A.S.D. Mestrina 1929	Italian football clubs, Venice, 1929 establishments in Italy
A.C. Nuova Valdagno	Italian football clubs, 1926 establishments in Italy
A.S. Pro Gorizia	Italian football clubs, 1919 establishments in Italy
Ravenna Calcio	Italian football clubs, Ravenna, 1913 establishments in Italy
Reggina 1914	Italian football clubs, 1914 establishments in Italy
David Platt	1966 births, Living people, English footballers, English football managers, Sportspeople from Lancashire
Choi In-young	1962 births, Living people, South Korean association football goalkeepers
Jun Aoyama	1988 births, Living people, Footballers from Miyagi Prefecture
Magno Alves	1976 births, Living people, Brazilian footballers
Marcos Gomes de Araujo	1976 births, Living people, Brazilian footballers
Uniform Resource Identifier	Internet
Dream of the Red Chamber	Chinese novels, 18th century books
Downfall (movie)	1945, 2004 drama movies, 2000s biographical movies, 2000s war movies, Berlin, German-language movies, German drama movies, Internet memes, Italian drama movies, Austrian movies, Movies set in Germany, Movies set in the 1940s, Multilingual movies, World War II movies, Movies directed by Oliver Hirschbiegel
Bubble wrap	Materials
Chester City F.C.	English football clubs, Chester
Ordnance Survey National Grid	Geography of the United Kingdom, Geodesy
The Legacy (professional wrestling)	WWE teams and stables
Ezekiel Jackson	1978 births, Living people, Former WWE wrestlers, Guyanese people, Professional wrestlers, Sport in Guyana
Daniel Passarella	1953 births, Living people, Argentine footballers, Argentine football managers
Gadzhi Gadzhiev	1945 births, Living people, Russian footballers
Takahiro Kimura	1957 births, Living people, Footballers from Hiroshima Prefecture, People from Hiroshima
Hiroyuki Omichi	1987 births, Living people, Footballers from Ibaraki Prefecture
Hiroshi Teguramori	1967 births, Living people, Footballers from Aomori Prefecture
Takumi Hayama	1978 births, Living people, Footballers from Kanagawa Prefecture
Masaki Saito	1980 births, Living people, Footballers from Saitama Prefecture
Valdeci Basílio da Silva	1972 births, Living people, Brazilian footballers, Coritiba Foot Ball Club players
Anaílson Brito Noleto	1978 births, Living people, Brazilian footballers
Dedimar	1976 births, Living people, Brazilian footballers
Satoshi Yamaguchi (footballer, born 1978)	1978 births, Living people, Footballers from Kōchi Prefecture, Japan international footballers, J1 League players, J2 League players, JEF United Chiba players, Gamba Osaka players, Kyoto Sanga FC players
Moon Je-Chun	1987 births, Living people, South Korean footballers, People from Seoul
Takuya Sato	1978 births, Living people, Footballers from Chiba Prefecture
Naoki Ishihara	1984 births, Living people, Footballers from Gunma Prefecture
Satoshi Yoshioka	1987 births, Living people, Footballers from Gunma Prefecture
Elivélton	1971 births, Living people, Brazilian footballers
Ivica Vastić	1969 births, Living people, Austrian footballers, Players of the Austrian national football team, Austrian football managers, People from Split
Tomonori Hirayama	1973 births, Living people, Footballers from Shizuoka Prefecture
Tomoaki Makino	1987 births, Living people, Footballers from Hiroshima Prefecture, Japan international footballers, J1 League players, J2 League players, Sanfrecce Hiroshima players, Urawa Red Diamonds players, 2018 FIFA World Cup players
Kim Jin-kyu	1985 births, Living people, South Korean footballers
Hideto Suzuki	1974 births, Living people, Footballers from Shizuoka Prefecture, Japan international footballers, Japanese football managers, J1 League players, Júbilo Iwata players, Footballers at the 1996 Summer Olympics
Takayuki Chano	1976 births, Living people, Footballers from Chiba Prefecture, Japan international footballers, J1 League players, J2 League players, JEF United Chiba players, Júbilo Iwata players, 2005 FIFA Confederations Cup players
Kentaro Ohi	1984 births, Living people, Footballers from Shizuoka Prefecture
Toshihiro Hattori	1973 births, Living people, Footballers from Shizuoka Prefecture, Japan international footballers, J1 League players, J2 League players, Júbilo Iwata players, Tokyo Verdy players, Gainare Tottori players, FC Gifu players, 1998 FIFA World Cup players, 2002 FIFA World Cup players, 2001 FIFA Confederations Cup players, 2003 FIFA Confederations Cup players, Footballers at the 1996 Summer Olympics, 1996 AFC Asian Cup players, 2000 AFC Asian Cup players, AFC Asian Cup-winning players
Tetsuhiro Kina	1976 births, Living people, Footballers from Okinawa Prefecture
Intercropping	Agriculture
Samuel de Champlain	1560s births, 1635 deaths, Explorers, French people, Quebec City
Danegeld	History of England, Taxation
John Doggett	FBI in fiction, Fictional American people, Television characters
Brian Lara	1969 births, Living people, West Indies cricketers, Trinidad and Tobago sportspeople
Jean-Baptiste de Lamarck	1744 births, 1829 deaths, Evolutionary biologists, French academics, French scientists, Naturalists
WWE Vintage Collection	World Wrestling Entertainment television programs, 2008 television series debuts
Patrick Swayze	1952 births, 2012 deaths, Actors from Houston, Texas, American dancers, American movie actors, American singers, American songwriters, American television actors, Cancer deaths in Los Angeles, Deaths from pancreatic cancer
Fox Mulder	FBI in fiction, Fictional American people, Television characters
Traudl Junge	1920 births, 2002 deaths, Deaths from lung cancer, People from Munich
Dana Scully	FBI in fiction, Fictional American people, Television characters
May Coup	1926, 1920s in Europe, 20th century in Poland
Fritz Müller	1821 births, 1897 deaths, Naturalists, German evolutionary biologists, Explorers
John Hope, 1st Marquess of Linlithgow	Australian Governors-General, Scottish Earls, United Kingdom Marquesses, Knights of the Thistle, Knights Grand Cross of the Order of St Michael and St George, Knights Grand Cross of the Royal Victorian Order, Privy Councillors (UK), Governors of Victoria (Australia)
Henry Walter Bates	1825 births, 1892 deaths, English evolutionary biologists, English naturalists, English explorers, Brazil, English science writers
Alfred Russel Wallace	1823 births, 1913 deaths, British naturalists, British evolutionary biologists, British explorers, Spirituality, Order of Merit, Fellows of the Royal Society, Science writers
Nikolai Vavilov	1887 births, 1943 deaths, Evolutionary biologists, Geneticists, Russian botanists
Gilbert White	1720 births, 1793 deaths, Christian clergy, Ecologists, English science writers, Naturalists, People from Hampshire
Charles Lyell	1797 births, 1875 deaths, British naturalists, British geologists, Scottish scientists, Knights Bachelor, Baronets, English science writers
John Ray	1627 births, 1705 deaths, English naturalists, English botanists, English science writers
WWE Diva Search	WWE, 2003 establishments, 2007 disestablishments
Vladimir Horowitz	1903 births, 1989 deaths, 20th century composers, American composers, American pianists, Cardiovascular disease deaths in the United States, Deaths from myocardial infarction, Grammy Award winners, Jewish American musicians, Naturalized citizens of the United States, People from Kiev, Russian composers, Russian Jews, Russian pianists, Soviet Jews, Soviet musicians, Ukrainian entertainers, Ukrainian Jews
Thomas Henry Huxley	1825 births, 1895 deaths, Anatomists, British zoologists, English evolutionary biologists, English science writers, Huxley family, People from Ealing, Presidents of the Royal Society, Privy Councillors (UK), Writers from Middlesex, Scientists from London
Theodosius Dobzhansky	1900 births, 1975 deaths, American evolutionary biologists, American zoologists, Ukrainian people, American geneticists, Naturalized citizens of the United States
Julian Huxley	1887 births, 1975 deaths, British zoologists, English evolutionary biologists, English science writers, Fellows of the Royal Society, Huxley family, Knights Bachelor, Scientists from London
Gertrude Baines	1894 births, 2009 deaths, African-American supercentenarians, People from Georgia (U.S. state)
Reel Big Fish	American punk bands, Musical groups from Huntington Beach, California
Hate group	Organizations
Sulfur trioxide	Sulfur compounds, Oxides
Cape Tribulation	Towns in Queensland, Capes
Up (2009 movie)	2009 movies, Academy Award winning movies, BAFTA Award winning movies, Golden Globe Award winning movies, Movies about animals, Jungle movies, Movies composed by Michael Giacchino, Movies set in South America, Movies that won the Best Animated Feature Academy Award, Pixar movies, Venezuela
Sansevieria trifasciata	Asparagales
Schefflera actinophylla	Asterids, Trees
Joshua Reynolds	1723 births, 1792 deaths, English painters, People from Devon, Fellows of the Royal Society, Royal Society of Arts, Knights Bachelor, Royal Academicians
Fumiya Iwamaru	1981 births, Living people, Footballers from Gunma Prefecture
Yuzo Tamura	1982 births, Living people, Footballers from Gunma Prefecture
Takuya Kobayashi	1981 births, Living people, Footballers from Gunma Prefecture
Rimini Calcio F.C.	Italian football clubs, Rimini, 1912 establishments in Italy
U.S.D. 1913 Seregno Calcio	Italian football clubs, 1913 establishments in Italy
U.S. Sanremese Calcio	Italian football clubs
Benevento Calcio	Italian football clubs, 1929 establishments in Italy
Cosenza Calcio 1914	Italian football clubs, 1914 establishments in Italy
U.S. Fermana	Italian football clubs
Hajime Hosogai	1986 births, Living people, Footballers from Gunma Prefecture, Japan international footballers, J1 League players, Urawa Red Diamonds players, Kashiwa Reysol players, 2013 FIFA Confederations Cup players, Footballers at the 2008 Summer Olympics
Shunichi Nakajima	1982 births, Living people, Footballers from Gunma Prefecture
Hiroki Hattori	1971 births, Living people, Footballers from Gunma Prefecture
Vigevano Calcio	Italian football clubs, 1921 establishments in Italy
Atletico Piombino	Italian football clubs, 1921 establishments in Italy
U.S. Grosseto F.C.	Italian football clubs, 1912 establishments in Italy
Nobuhito Toriizuka	1972 births, Living people, Footballers from Gunma Prefecture
Sotaro Sada	1984 births, Living people, Footballers from Gunma Prefecture
Ryo Goto	1986 births, Living people, Footballers from Saitama Prefecture
Masami Sato	1981 births, Living people, Footballers from Kanagawa Prefecture
Kazuki Sato	1974 births, Living people, Footballers from Gunma Prefecture
Norihisa Shimizu	1976 births, Living people, Footballers from Gunma Prefecture
A.C. Arezzo	Italian football clubs, 1923 establishments in Europe, 1920s establishments in Italy
S.S. Sambenedettese Calcio	Italian football clubs, 1923 establishments in Europe, 1920s establishments in Italy
Pirituba	São Paulo
Mycorrhiza	Fungi, Plants, Botany
Makoto Yonekura	1970 births, Living people, Footballers from Gunma Prefecture
Mitsunori Fujiguchi	1949 births, Living people, Footballers from Gunma Prefecture, Japan international footballers, Japan Soccer League players, Urawa Red Diamonds players
Jun Kokubo	1980 births, Living people, Footballers from Gunma Prefecture
A.C. Ponte San Pietro Isola S.S.D.	Italian football clubs, 1910 establishments in Italy
Keishi Otani	1983 births, Living people, Footballers from Gunma Prefecture
Shusuke Tsubouchi	1983 births, Living people, Footballers from Gunma Prefecture
Daiju Matsumoto	1977 births, Living people, Footballers from Gunma Prefecture
Yuki Matsushita	1981 births, Living people, Footballers from Gunma Prefecture
Shintaro Harada	1980 births, Living people, Footballers from Saitama Prefecture
Naoki Ishibashi	1981 births, Living people, Footballers from Saitama Prefecture
A.S. Fortis Trani	1929 establishments in Italy, Italian football clubs
F.B. Brindisi 1912	Italian football clubs, 1912 establishments in Italy
Karl Michael Ziehrer	1843 births, 1922 deaths, Austrian composers
Metre per second squared	Physics, Units of measurement, SI units
Cartazini Biennial Art Award	Art awards, 1999 establishments in France
Stadelheim Prison	1894 establishments in Europe, Buildings and structures in Munich, Prisons in Germany, 1890s establishments in Germany
Deutsche Bank	Companies listed on the DAX, Banks of Germany
Germaine Greer	1939 births, Living people, Alumni of the University of Cambridge, Anarchist communists, Australian academics, Australian activists, Australian feminists, Australian journalists, Feminist writers, Marxism, Radical feminists, University of Melbourne alumni, University of Sydney alumni, University of Sydney faculty, Writers from Melbourne
Grisy-Suisnes	Communes in Seine-et-Marne
William Whewell	English philosophers, Christian ministers, British historians, People from Lancashire, 1794 births, 1866 deaths
Mandello del Lario	Settlements in Lombardy
Trampoline	Gymnastics, Leisure
Issei Takayanagi	1986 births, Living people, Footballers from Kanagawa Prefecture
Akihiro Sato	1986 births, Living people, Footballers from Mie Prefecture
Shinichiro Kuwada	1986 births, Living people, Footballers from Hiroshima Prefecture
Super League Greece	Football leagues
Ryota Moriwaki	1986 births, Living people, Footballers from Hiroshima Prefecture, Japan international footballers, J1 League players, J2 League players, Sanfrecce Hiroshima players, Ehime FC players, Urawa Red Diamonds players, Kyoto Sanga FC players
Naoto Kono	1985 births, Living people, Footballers from Kanagawa Prefecture
Osvaldo José Martins Júnior	1982 births, Living people, Brazilian footballers
A.S.G. Nocerina	Italian football clubs, 1910 establishments in Italy
Avellino Calcio 12 S.S.D.	Italian football clubs, Avellino, 1912 establishments in Italy
F.C. Crotone	Italian football clubs, 1910 establishments in Italy
Kazuma Irifune	1986 births, Living people, Footballers from Miyazaki Prefecture
Mana Nakao	1983 births, Living people, Footballers from Kyoto
Yuya Hashiuchi	1987 births, Living people, Footballers from Shiga Prefecture
A.S.D.C. Magenta	Italian football clubs
F.C. Bolzano 1996	Italian football clubs, 1931 establishments in Europe, 1930s establishments in Italy
U.S. Centese A.S.D. 1986	Italian football clubs
U.S. Massese 1919	Italian football clubs, 1919 establishments in Italy
Kosuke Yatsuda	1982 births, Living people, Footballers from Fukuoka Prefecture
Mitsuyuki Yoshihiro	1985 births, Living people, Footballers from Yamaguchi Prefecture, Renofa Yamaguchi FC players
Yojiro Takahagi	1986 births, Living people, Footballers from Fukushima Prefecture, Japan international footballers, J1 League players, J2 League players, Sanfrecce Hiroshima players, Ehime FC players, FC Tokyo players
Yoshitaka Ohashi	1983 births, Living people, Footballers from Saitama Prefecture
Shimpei Sayama	1987 births, Living people, Footballers from Hiroshima Prefecture, People from Hiroshima
U.S. Sestri Levante	Italian football clubs
A.S. Biellese 1902	Italian football clubs, Piedmont, 1902 establishments in Italy
A.C. Parabiago	Italian football clubs, 1943 establishments in Europe, 1940s establishments in Italy
A.C. Palazzolo 1913	Italian football clubs, 1913 establishments in Italy
Rovigo Calcio	Italian football clubs, 1893 establishments in Italy
A.S. Edera	Italian football clubs
A.S.D. Stuoie Baracca Lugo	Italian football clubs
S.S.D. Tivoli Calcio 1919	Italian football clubs, 1919 establishments in Italy
Shinji Kaneko	1987 births, Living people, Footballers from Chiba Prefecture
Kei Mikuriya	1977 births, Living people, Footballers from Chiba Prefecture
Ken Ishikawa	1970 births, Living people, Footballers from Okinawa Prefecture
Shinichiro Tani	1968 births, Living people, Footballers from Aichi Prefecture, Japan international footballers, J1 League players, Japan Soccer League players, Kashiwa Reysol players
Mutsuhiko Nomura	1940 births, Living people, Footballers from Hiroshima Prefecture, People from Hiroshima
Peter Mandelson	1953 births, Living people, English LGBT people, European Commissioners, Former Labour MPs (UK), Former members of the British House of Commons for English constituencies, Gay men, LGBT politicians, Politicians from London, UK MPs 1992–1997, UK MPs 1997–2001, UK MPs 2001–2005, United Kingdom Life Peers
Kazuya Iio	1980 births, Living people, Footballers from Tokyo Prefecture
Nobuhiro Kato	1984 births, Living people, Footballers from Saitama Prefecture
A.S.D. Casertana Calcio	Italian football clubs
Tetsushi Kondo	1986 births, Living people, Footballers from Fukuoka Prefecture
Yuzo Minami	1983 births, Living people, Footballers from Saitama Prefecture
Takafumi Akahoshi	1986 births, Living people, Footballers from Shizuoka Prefecture
Huelgoat	Communes in Finistère
Tarnish	Metals, Chemical reactions
St. Bernard (dog)	Dog breeds
Kyle MacLachlan	1959 births, Living people, American movie actors, American stage actors, American television actors, Actors from Washington, Golden Globe Award winning actors
Battery Park City	Manhattan
Carol Thatcher	1953 births, Living people, English journalists, I'm a Celebrity...Get Me Out of Here! contestants, Margaret Thatcher, Television personalities from London, Twin people from England, Writers from London
Halifax Town A.F.C.	English football clubs, 2008 disestablishments in England
Jefferson Davis	1808 births, 1889 deaths, American military people, Colonels, Confederate States of America, Deaths from bronchitis, Episcopalians, Politicians from Kentucky, Politicians from Louisiana, United States representatives from Mississippi, United States Secretaries of War, United States senators from Mississippi, US Democratic Party politicians
Meet the Robinsons	2007 movies, 2007 animated movies, 2000s 3D movies, 2007 computer-animated movies, American family movies, Disney animated movies, English-language movies, Movies based on books, Movies composed by Danny Elfman, Movies set in the 1990s, Movies set in the future, Buena Vista International movies, Time travel movies
Vanilla Ninja (album)	2003 albums, Debut albums, Vanilla Ninja albums, Pop rock albums
List of U.S. Open Men's Singles champions	Lists of sportspeople, US Open (tennis) champions
Traces of Sadness	2004 albums, Vanilla Ninja albums, Pop rock albums
Blue Tattoo (album)	2005 albums, Vanilla Ninja albums, Pop rock albums
Douglas C-47 Skytrain	Douglas aircraft, World War II American aircraft
Best Of (Vanilla Ninja album)	2005 albums, Vanilla Ninja albums
Love Is War	2006 albums, Vanilla Ninja albums, Pop rock albums
Piret Järvis	1984 births, Living people, Estonian singers, Vanilla Ninja, People from Tallinn
Lenna Kuurmaa	1985 births, Living people, Vanilla Ninja, Singer-songwriters, Actors, Estonian singers, People from Tallinn
Sven Lõhmus	1972 births, Living people, Estonian people, Record producers, Vanilla Ninja
Hurricane Frederic	1979 Atlantic hurricane season, Category 4 Atlantic hurricanes, Hurricanes in the United States, 1979 in the United States, 1970s in Cuba, 1970s in Florida, 20th century in Alabama, 20th century in Mississippi
Grains of Selim	Spices
Croatian Wikipedia	Wikipedias, Websites established in 2003
Estonian Wikipedia	Wikipedias, Websites established in 2002
Indonesian Wikipedia	Wikipedias
Iván Rodríguez	1971 births, American League All-Stars, Detroit Tigers players, Florida Marlins players, Houston Astros players, Living people, National Baseball Hall of Fame members, New York Yankees players, Sportspeople from Puerto Rico, Texas Rangers players, Washington Nationals players
Freeport, Maine	Towns in Maine
Bazooka	Weapons
Teruki Miyamoto	1940 births, 2000 deaths, Footballers from Hiroshima Prefecture, Japan international footballers, Japan Soccer League players, Nippon Steel Yawata SC players, Footballers at the 1964 Summer Olympics, Footballers at the 1968 Summer Olympics, Olympic medalists in football, Japanese Olympic bronze medalists, Medalists at the 1968 Summer Olympics
Ibrahim Ba	1973 births, Living people, French footballers, People from Dakar
Hokuto Nakamura	1985 births, Living people, Footballers from Nagasaki Prefecture
Masashi Watanabe	1936 births, 1995 deaths, Footballers from Hiroshima Prefecture, Japan international footballers, Japanese football managers, Japan Soccer League players, Nippon Steel Yawata SC players, Japan national football team managers, Footballers at the 1964 Summer Olympics, Footballers at the 1968 Summer Olympics, Olympic medalists in football, Japanese Olympic bronze medalists, Medalists at the 1968 Summer Olympics
Shin Tanada	1969 births, Living people, Footballers from Hiroshima Prefecture, People from Hiroshima
Kensaku Abe	1980 births, Living people, Footballers from Kanagawa Prefecture
Alair de Souza Camargo Junior	1982 births, Living people, Brazilian footballers
Kazuki Kuranuki	1978 births, Living people, Footballers from Shiga Prefecture
Katsuya Ishihara	1978 births, Living people, Footballers from Yamanashi Prefecture
Michitaka Akimoto	1982 births, Living people, Footballers from Shizuoka Prefecture
Takuma Tsuda	1980 births, Living people, Footballers from Saitama Prefecture
Uzbek League	Football leagues
Maarja Kivi	1986 births, Living people, Heavy metal singers, Vanilla Ninja, Estonian singers, People from Tallinn
Katrin Siska	1983 births, Living people, Vanilla Ninja, Estonian singers, People from Tallinn
David Brandes	1968 births, Living people, German composers, Record producers, Songwriters, Vanilla Ninja
Evangelical Christian Church in Canada	Evangelicalism, Religion in Canada, 1804 establishments, 1800s establishments in Canada
Key Largo, Florida	Census-designated places in Florida
Tommy Dreamer	1971 births, American professional wrestlers, Former WWE wrestlers, Living people, People from Yonkers, New York, Sportspeople from New York City
Planoise	Settlements in France, Bourgogne-Franche-Comté
Incubus (band)	American rock bands, American heavy metal bands, Musical groups from California
Lomonosov, Russia	Towns in Russia
Lomonosov	Russian-language surnames
Hideomi Yamamoto	1980 births, Living people, Footballers from Chiba Prefecture
Yuki Inoue	1977 births, Living people, Footballers from Kanagawa Prefecture
Marques Batista de Abreu	1973 births, Living people, Brazilian footballers
Panathinaikos F.C.	Greek football clubs, 1908 establishments in Europe, 20th century establishments in Greece
PAOK FC	Greek football clubs, Thessaloniki, 1926 establishments in Greece
F.C. Pakhtakor Tashkent	Uzbekistani football clubs
F.K. Neftchi Farg'ona	Uzbekistani football clubs
Navbahor Namangan	Uzbekistani football clubs
M.H.S.K. Tashkent	Uzbekistani football clubs
Makoto Sugiyama	1960 births, Living people, Footballers from Shizuoka Prefecture
Daiki Iwamasa	1982 births, Living people, Footballers from Yamaguchi Prefecture, Japan international footballers, J1 League players, J2 League players, Kashima Antlers players, Fagiano Okayama players, 2010 FIFA World Cup players
Andre Luiz de Souza Silva	1974 births, Living people, Footballers from Rio de Janeiro
Dustlik Tashkent	Uzbekistani football clubs
Valdney Freitas da Matta	1971 births, Living people, Brazilian footballers
Pablo Maqueda	1971 births, Living people, Spanish footballers, Sportspeople from Barcelona
Julio César Baldivieso	1971 births, Living people, Bolivian footballers
Akira Ito	1972 births, Living people, Footballers from Saitama Prefecture
Tatsuya Tsuruta	1982 births, Living people, Footballers from Shizuoka Prefecture
Koji Noguchi	1970 births, Living people, Footballers from Chiba Prefecture, Japan international footballers, J1 League players, J2 League players, Japan Soccer League players, Shonan Bellmare players, Kawasaki Frontale players, Nagoya Grampus players, Omiya Ardija players
Yusuke Nakatani	1978 births, Living people, Footballers from Kyoto
Shingo Suzuki	1978 births, Living people, Footballers from Saitama Prefecture, Giravanz Kitakyushu players
Katsuyuki Miyazawa	1976 births, Living people, Footballers from Chiba Prefecture
Naoto Sakurai	1975 births, Living people, Footballers from Saitama Prefecture
Yutaka Tahara	1982 births, Living people, Footballers from Kagoshima Prefecture
Masahiro Koga	1978 births, Living people, Footballers from Fukuoka Prefecture
Kazuma Watanabe	1986 births, Living people, Footballers from Nagasaki Prefecture, Japan international footballers, J1 League players, Yokohama F. Marinos players, FC Tokyo players, Vissel Kobe players, Gamba Osaka players, Yokohama FC players
Keita Sugimoto	1982 births, Living people, Footballers from Ibaraki Prefecture
Earplug	Protective clothing, Hearing, Headgear
Rhodes Scholarship	Education
Joseph Dalton Hooker	1817 births, 1911 deaths, English botanists, English explorers, English evolutionary biologists, Order of Merit, Knights Bachelor, Fellows of the Royal Society, Presidents of the Royal Society, English physicians, Knights Grand Commander of the Order of the Star of India, Companions of the Bath, People from Suffolk
Joseph Hooker	American Civil War generals, 1814 births, 1879 deaths
Uremia	Blood
Ballets Russes	Ballets Russes, 1909 establishments in Europe, 1929 disestablishments
Impresario	Music, Opera, Ballet, Theater, Entertainment occupations
Rest mass	Relativity
Sergei Diaghilev	Ballets Russes, Russian businesspeople, Deaths from diabetes, Russian LGBT people, Gay men, 1872 births, 1929 deaths
Bedford, Massachusetts	Towns in Massachusetts
Irving Kristol	1920 births, 2009 deaths, Deaths from lung cancer, American conservatives, American political writers, American political commentators, American critics, American philosophers, Journalists from New York City
2009 US Open (tennis)	2009 US Open (tennis), 2009 in tennis, 2009 in New York (state)
Papyrus 46	New Testament
Santiago de los Caballeros	Settlements in Dominican Republic, 1495 establishments
Sylvia Plath	American novelists, American poets, People with bipolar disorder, Suicides by poison, Suicides in the United Kingdom, Writers from Boston, Massachusetts, 1932 births, 1963 deaths, Deaths from carbon monoxide poisoning
Maasai	Ethnic groups in Africa, Kenyan people, Tanzanian people
Aritatsu Ogi	1942 births, Living people, Footballers from Hiroshima Prefecture, Japan international footballers, Japan Soccer League players, Sanfrecce Hiroshima players, Footballers at the 1964 Summer Olympics, Footballers at the 1968 Summer Olympics, Olympic medalists in football, Japanese Olympic bronze medalists, Medalists at the 1968 Summer Olympics
Carlos Bianchi	1949 births, Living people, Argentine footballers, Argentine football managers, Sportspeople from Buenos Aires
Masanaga Kageyama	1967 births, Living people, Footballers from Fukushima Prefecture
Akira Konno	1974 births, Living people, Footballers from Iwate Prefecture
Toru Oniki	1974 births, Living people, Footballers from Chiba Prefecture
Toshihiro Aoyama	1986 births, Living people, Footballers from Okayama Prefecture, Japan international footballers, J1 League players, J2 League players, Sanfrecce Hiroshima players, 2014 FIFA World Cup players
Yosuke Kashiwagi	1987 births, Living people, Footballers from Hyōgo Prefecture, Japan international footballers, J1 League players, J2 League players, Sanfrecce Hiroshima players, Urawa Red Diamonds players
Koji Nakazato	1982 births, Living people, Footballers from Kanagawa Prefecture
Yaw Preko	1974 births, Living people, Ghanaian footballers
Masahiko Inoha	1985 births, Living people, Footballers from Miyazaki Prefecture, Japan international footballers, J1 League players, J2 League players, FC Tokyo players, Kashima Antlers players, Vissel Kobe players, Júbilo Iwata players, Yokohama FC players, 2014 FIFA World Cup players, 2013 FIFA Confederations Cup players
Giuliano Tadeo Aranda	1974 births, Living people, Brazilian footballers
Nebojša Krupniković	1973 births, Living people, Serbian footballers
Klaas-Jan Huntelaar	1983 births, Living people, Dutch footballers, Sportspeople from Gelderland
Atsuto Uchida	1988 births, Living people, Footballers from Shizuoka Prefecture, Japan international footballers, J1 League players, Kashima Antlers players, 2010 FIFA World Cup players, 2014 FIFA World Cup players, 2013 FIFA Confederations Cup players, Footballers at the 2008 Summer Olympics
Yuzo Kurihara	1983 births, Living people, Footballers from Kanagawa Prefecture, Japan international footballers, J1 League players, Yokohama F. Marinos players, 2013 FIFA Confederations Cup players
Gianluca Curci	1985 births, Living people, Italian association football goalkeepers, Sportspeople from Rome
Philippe Mexès	1982 births, Living people, French footballers
Napoleon II of France	1811 births, 1832 deaths, French people, Princes of Andorra, House of Bonaparte
Cristian Chivu	1980 births, Living people, Romanian footballers
Cesare Bovo	1983 births, Living people, Italian footballers, Sportspeople from Rome
Edgar Álvarez	1980 births, Living people, Honduran footballers
Shosuke Katayama	1983 births, Living people, Footballers from Nara Prefecture
Eusebio Sacristán	1964 births, Living people, Spanish footballers, Spanish football managers
Naoki Urata	1974 births, Living people, Footballers from Saitama Prefecture
Maximilian I of Mexico	Emperors and empresses, History of Mexico, House of Habsburg-Lorraine, People executed by firearm, 1832 births, 1867 deaths
Initiation	Culture
Bar and Bat Mitzvah	Judaism
Joseph Bonaparte	1768 births, 1844 deaths, Kings and Queens of Spain, House of Bonaparte
Marcos Alberto Skavinski	1975 births, Living people, Brazilian footballers, People from Curitiba
Ferydoon Zandi	1979 births, Living people, German football managers, German footballers, Iranian footballers, People from Emden, Sportspeople from Lower Saxony
Hiroshi Aso	1974 births, Living people, Footballers from Gunma Prefecture
F.C. Matera	Italian football clubs, 1930 establishments in Europe, 1930s establishments in Italy
Jun Sunaga	1975 births, Living people, Footballers from Gunma Prefecture
Takeshi Suda	1983 births, Living people, Footballers from Gunma Prefecture
Sota Kasahara	1976 births, Living people, Footballers from Gunma Prefecture
Keita Kasahara	1973 births, Living people, Footballers from Gunma Prefecture
Yusaku Ueno	1973 births, Living people, Footballers from Tochigi Prefecture
Sorrento Calcio	Italian football clubs, 1945 establishments in Italy
Takayoshi Ono	1978 births, Living people, Footballers from Fukushima Prefecture
Larissa F.C.	Greek football clubs, 1964 establishments in Europe, 20th century establishments in Greece
Swing vote	Voting
Volgograd	Volgograd, Capital cities in Russia
Problem of evil	Theology, Logical fallacies, Philosophy
Argument from inconsistent revelations	Religion, Critical thinking
Deadlock	Computer science
Dido	English pop musicians, English singer-songwriters, Brit Award winners, Musicians from London, 1971 births, Living people
False analogy	Logical fallacies
Lord Berners	1883 births, 1950 deaths, 20th century composers, English composers, English Barons, Entertainers from Shropshire, Gay men, LGBT composers, LGBT novelists
Ang Lee	Academy Award winning directors, Taiwanese people, Movie directors, 1954 births, Living people
Gustav Klimt	1862 births, 1918 deaths, Austrian painters, Deaths from infectious disease
Spike Lee	1957 births, Living people, Actors from Atlanta, Georgia, Actors from New York City, African American actors, African American movie directors, African American movie producers, African-American screenwriters, American movie actors, American television directors, American television producers, Movie directors from Georgia (U.S. state), Movie directors from New York City, Movie producers from New York City, Screenwriters from New York City, Spike Lee, Writers from Georgia (U.S. state)
Cuba Gooding, Jr.	Actors from Los Angeles, California, Actors from New York City, African American actors, American movie actors, Movie producers from Los Angeles, California, Movie producers from New York City, American television actors, American voice actors, Screen Actors Guild Award winners, Academy Award winning actors, Satellite Award winners, 1968 births, Living people
Swift Current, Saskatchewan	Cities in Saskatchewan
Richard Feynman	1918 births, 1988 deaths, American Nobel Prize winners, American people of World War II, American physicists, Cancer deaths in Los Angeles, Deaths from liposarcoma, Jewish American scientists, Jewish Nobel Prize winners, Scientists from Queens, Theoretical physicists
Louis XVIII	1755 births, 1824 deaths, People from Versailles, Kings and Queens of France, Princes of Andorra
Louis XVII	Kings and Queens of France, House of Bourbon, 1785 births, 1795 deaths, People from Versailles, Dauphins and Dauphines of France
Race (sociology)	Migration, World War II, History, Biology, Nazism, Anthropology, Sociology
Ford Laser	Ford automobiles
Pixie Lott	1991 births, Living people, Actors from Essex, Actors from London, English movie actors, English pop musicians, Musicians from Essex, People from Brentwood, Essex, People from Bromley (London borough), Singers from London, Strictly Come Dancing participants
Rube Goldberg machine	Phrases, Mechanics
Renato Dirnei Florêncio	1979 births, Living people, Brazilian footballers
Ulises de la Cruz	1974 births, Living people, Ecuadorian footballers, People from Quito
Iván Hurtado	1974 births, Living people, Ecuadorian footballers, People from Quito
F.C. Bunyodkor	Uzbekistani football clubs
Naoya Ohashi	1987 births, Living people, Footballers from Ibaraki Prefecture
Jaromír Blažek	1972 births, Living people, Czech footballers, Association football goalkeepers, People from Brno
Tomáš Jun	1983 births, Living people, Czech footballers, Sportspeople from Prague
Ukrainian Premier League	Football leagues
Susumu Oki	1976 births, Living people, Footballers from Ehime Prefecture
Cho Woo-Jin	1987 births, Living people, South Korean footballers
Tatsuro Kimura	1984 births, Living people, Footballers from Hiroshima Prefecture, People from Hiroshima
Neva, Wisconsin	Towns in Wisconsin, Langlade County, Wisconsin
Albanian Wikipedia	Wikipedias, Websites established in 2003
Resignation	Politics, Employment
Jerome Bettis	1972 births, American football running backs, Bowling broadcasters, Living people, Los Angeles Rams players, Pittsburgh Steelers players, Sportspeople from Michigan, St. Louis Rams players
Plinian eruption	Volcanology
Crater (constellation)	Constellations, Constellations listed by Ptolemy
1973 Atlantic hurricane season	Atlantic hurricane seasons, 1973
1975 Atlantic hurricane season	Atlantic hurricane seasons, 1975
Elmer Fudd	Looney Tunes characters, Fictional characters introduced in 1937, Fictional characters introduced in 1940
Diane Sawyer	1945 births, Living people, American journalists, Writers from Kentucky, American television news anchors
Mark Harmon	1951 births, Living people, American movie actors, American television actors, Actors from Burbank, California
Ľubomír Luhový	1967 births, Living people, People from Bratislava, Slovak footballers
Kenji Oshiba	1973 births, Living people, Footballers from Yamanashi Prefecture
Yuya Iwadate	1985 births, Living people, Footballers from Tokyo Prefecture
U.S. Sassuolo Calcio	Italian football clubs, Modena, 1922 establishments in Italy
Gallipoli Calcio	Italian football clubs, 1946 establishments in Italy
Hideki Maeda	1954 births, Living people, Footballers from Kyoto Prefecture, Japan international footballers, Japanese football managers, Japan Soccer League players, JEF United Chiba players
Jiří Štajner	1976 births, Living people, Czech footballers
Vratislav Lokvenc	1973 births, Living people, Czech footballers
A.S. Andria BAT	Italian football clubs
Gwar	American punk bands, Musical groups from Virginia, People from Richmond, Virginia
S.S.D. Licata 1931	Italian football clubs, 1931 establishments in Europe, 1930s establishments in Italy
F.C. AlzanoCene 1909	Italian football clubs, 2007 establishments in Europe, 2000s establishments in Italy
Giuseppe Mazzini	1805 births, 1872 deaths, Freemasons, Italian esotericists, Italian politicians, Italian writers
Jean Auguste Dominique Ingres	1780 births, 1867 deaths, French painters
Charles X	1757 births, 1836 deaths, Kings and Queens of France, House of Bourbon, Princes of Andorra
Foghat	British rock bands, Hard rock bands
NBA Jam	1993 video games, Sports video games, Atari Jaguar games, Game Boy games, Game Gear games, Sega Genesis games, Sega CD games, Super Nintendo Entertainment System games
Irkutsk	Capital cities in Russia, 1661 establishments, Siberia
Fleetwood	Towns in Lancashire, Wyre, Ports and harbours of the United Kingdom
The Fylde	Peninsulas, Lancashire
Muslim League (Pakistan)	Muslim League
Leon Redbone	1949 births, 2019 deaths, Deaths from dementia, Disease-related deaths in Pennsylvania, Cypriot people, American singer-songwriters, American jazz singers, American blues singers, American jazz musicians, American blues musicians, American guitarists, Singers from Pennsylvania, Writers from Pennsylvania, Musicians from Pennsylvania, Warner Bros. Records artists
Yarmouth Clam Festival	Festivals in the United States, Maine, 1965 establishments in the United States, 20th-century establishments in Maine, July events
Fireflies (song)	2009 songs
Steve Kerr	1965 births, American basketball players, Chicago Bulls players, Cleveland Cavaliers players, Orlando Magic players, Phoenix Suns players, Portland Trail Blazers players, San Antonio Spurs players, Living people
Mark Oliver Everett	American drummers, American pianists, American rock guitarists, Musicians from Virginia, Singers from Virginia, 1963 births, Living people
Grendel	Monsters, Epic poems
List of Category 5 Atlantic hurricanes	Category 5 Atlantic hurricanes, Weather lists
Jump River (town), Wisconsin	Towns in Wisconsin, Taylor County, Wisconsin
Bulletproof Monk	2003 action movies, American superhero movies
La Roux	English pop music groups, Electronic music bands
Granny Smith	Apples
Metal detector	Archaeology, Measuring tools
Yom Kippur	Jewish festivals and holidays
Subsolar point	Astronomy, Earth
Hurricane Dennis	2005 Atlantic hurricane season, History of Grenada, 2000s in Haiti, 2000s in Jamaica, 2005 in Cuba, 2005 in Florida, 2005 in Alabama, 2005 in Mississippi, 2000s in Tennessee
Black dwarf	Types of stars
Hurricane Frances	2004 Atlantic hurricane season, Category 4 Atlantic hurricanes, 2004 in Florida
Patent troll	Intellectual property law
Marek Heinz	1977 births, Living people, Czech footballers
Gakuya Horii	1975 births, Living people, Footballers from Yamanashi Prefecture
House of Bonaparte	House of Bonaparte, 19th century in France, 1804 establishments in Europe, 1815 disestablishments, 1852 establishments, 1870 disestablishments, 1850s establishments in Europe, 1870s disestablishments in Europe, 1810s disestablishments in Europe
Jet Li	1963 births, Living people, Chinese movie actors, Chinese television actors, Chinese voice actors, People who lost Chinese citizenship
Neotropical Pygmy Squirrel	Squirrels, Mammals of South America
I'm Breathless	1990 albums, Madonna albums, Pop albums, Jazz albums
Burnout Legends	2005 video games, Racing video games, PlayStation Portable games, Nintendo DS games
Like a Virgin	1984 albums, Madonna albums, Dance pop albums, Disco albums, Synth-pop
Blue, Arizona	Unincorporated communities in Arizona
Ricardo Zonta	1976 births, Living people, Brazilian sportspeople, Formula One drivers, People from Curitiba
Jenson Button	1980 births, Living people, English racecar drivers, Formula One current, Formula One drivers, People from Somerset
British American Racing	Formula One constructors
Bruce McLaren	1937 births, 1970 deaths, Deaths in sport, Formula One drivers, Sportspeople from Auckland
Stirling Moss	1929 births, 2020 deaths, Disease-related deaths in London, Sportspeople from London, English racecar drivers, Formula One drivers
Christijan Albers	1979 births, Living people, Formula One drivers, People from Eindhoven, Sportspeople from North Brabant
Michele Alboreto	1956 births, 2001 deaths, Deaths in sport, Formula One drivers, Italian racecar drivers, Sportspeople from Milan
Satoru Nakajima	1953 births, Living people, Japanese racecar drivers, Formula One drivers, People from Aichi Prefecture
James Blunt	1974 births, Living people, British military people, English rock musicians, English singer-songwriters, People from Wiltshire, Atlantic Records artists
Gerhard Berger	1959 births, Living people, Austrian sportspeople, Formula One drivers
Monarch butterfly	Danaus
Naturalism (philosophy)	Epistemology, Philosophy of science, Philosophical movements and positions
Heinz Sielmann	1917 births, 2006 deaths, German photographers, People from Mönchengladbach
Green Screen	Movie festivals, Festivals in Europe, 2007 establishments in Germany, Schleswig-Holstein
Lars Petrus	1960 births, Living people, Swedish people
The Rite of Spring	Compositions by Igor Stravinsky, Ballets Russes productions, Ballets choreographed by Nijinsky
Recapitulation theory	Evolutionary biology, Developmental biology
Mount Tambora	Volcanoes of Indonesia, Calderas
Louis, Grand Dauphin	1661 births, 1711 deaths, House of Bourbon, Heirs apparent who never acceded, Dauphins and Dauphines of France
Northern pintail	Ducks
Donington Park	Formula One circuits, 1931 establishments in Europe, 1930s establishments in England
European Grand Prix	Formula One Grands Prix
Omote-sando Station	Railway stations in Tokyo
Toyota Racing	Formula One constructors, Formula One engine manufacturers
Phil Hill	1927 births, 2008 deaths, American racecar drivers, Formula One drivers
Jacques Villeneuve	1971 births, Living people, Formula One drivers, Sportspeople from Quebec
Tony Stewart	NASCAR drivers, American racecar drivers, 1971 births, Living people, Sportspeople from Indiana, IndyCar Series drivers
Wantage	Towns in Oxfordshire
A Haunting	English-language television programs
Sage	Literature, Mythology, Psychology
Władysław I Herman	1040s births, 1102 deaths, Polish dukes
Felipe González	1942 births, Living people, People from Seville, Prime Ministers of Spain, Social democrats
The Game (rapper)	1979 births, Living people, African American musicians, American rap musicians from California, Singers from Los Angeles, California, People from Compton, California
Karen Blixen	1885 births, 1962 deaths, Danish writers, Novelists
Hackleton	Villages in Northamptonshire
Euptoieta	Nymphalidae
Cinnamon Toast Crunch	Breakfast cereals
Jerry Orbach	1935 births, 2004 deaths, Actors from New York City, American movie actors, American musical theatre actors, American television actors, American voice actors, Deaths from prostate cancer, Tony Award winning actors
Raúl Mondesí	1971 births, Arizona Diamondbacks players, Atlanta Braves players, Dominican Republic sportspeople, Living people, Los Angeles Dodgers players, Mayors, National League All-Stars, New York Yankees players, Pittsburgh Pirates players, Toronto Blue Jays players
Cliff Floyd	1972 births, Living people, African-American baseball players, Boston Red Sox players, Chicago Cubs players, Florida Marlins players, Montreal Expos players, New York Mets players, San Diego Padres players, Tampa Bay Rays players, National League All-Stars, Sportspeople from Chicago
Freegle	Organisations based in the United Kingdom
My Generation	1965 albums, Debut albums, Rock albums
John Entwistle	1944 births, 2002 deaths, Bassists, Drug-related accidental deaths in the United States, English rock musicians, Musicians from Middlesex, People from Chiswick
Roger Daltrey	1944 births, Living people, English rock singers, English singer-songwriters, Singers from London
Keith Moon	1946 births, 1978 deaths, Drug-related accidental deaths in the United Kingdom, English rock drummers, Musicians from Middlesex
Humble Pie	English rock bands, hard rock bands, blues bands
Tomoyoshi Tsurumi	1979 births, Living people, Footballers from Yamanashi Prefecture
Yuya Satō	1986 births, Living people, Footballers from Chiba Prefecture
Daisuke Matsushita	1981 births, Living people, Footballers from Shizuoka Prefecture
Yosuke Ikehata	1979 births, Living people, Footballers from Shizuoka Prefecture
Yukio Shimomura	1932 births, Living people, Footballers from Hiroshima Prefecture, Japan international footballers, Japanese football managers, Sanfrecce Hiroshima players, Japan national football team managers, Footballers at the 1956 Summer Olympics
Masaaki Takada	1973 births, Living people, Footballers from Chiba Prefecture
Boom Boom Pow	The Black Eyed Peas songs, 2009 songs
Mullah Omar	1959 births, 2013 deaths, Deaths from tuberculosis, Pashtun people, Taliban, Heads of the Islamic Emirate of Afghanistan
Cutler, Maine	Cities in Maine
Irish Setter	Dog breeds
Alan Jones	1946 births, Living people, Australian racecar drivers, Formula One drivers, Members of the Order of the British Empire, Sportspeople from Melbourne
Carlos Reutemann	1942 births, 2021 deaths, Argentine sportspeople, Formula One drivers, People from Santa Fe, Argentina, Deaths from cerebral hemorrhage
Euptoieta claudia	Nymphalidae
Mullah	Islamic law, Islamic theology
José María de Pereda	1833 births, 1906 deaths, Spanish writers
Dusty Rhodes	1945 births, American professional wrestlers, 2015 deaths, Deaths from renal failure, Sportspeople from Georgia (U.S. state), WWE Hall of Fame
Carom billiards	Cue sports, Indoor sports
Calibrachoa	Nightshades
Tetrahydrocannabinol	Cannabis, Organic compounds
James Haggarty	1914 births, 1998 deaths, Canadian ice hockey forwards, Ice hockey people from Ontario, Montreal Canadiens players, People from Thunder Bay
Narcotic	Drugs
Boletus	Fungi
Doubletree	1969 establishments in the United States, Hotel chains, Companies of the United States
Banana peel	Waste, Humor
Selsun Blue	Hair
Axl Rotten	1971 births, 2016 deaths, Deaths from cardiac arrest, American professional wrestlers, Sportspeople from Baltimore, Maryland
Set construction	Theater
FTSE 100 Index	1984 establishments in the United Kingdom, London, Stock market
Judgment	Trials, Psychology, Theology
HSBC	Banks of the United Kingdom, 1865 establishments in the United Kingdom
Sweet Dreams	2009 songs, Beyoncé songs
Justin Bieber	1994 births, Living people, Canadian Christians, Canadian drummers, Canadian pop singers, Child singers, People from London, Ontario, Singers from Ontario
One More Time	2000 songs
Cornish, Maine	Towns in Maine, Settlements established in the 18th century, 1794 establishments, 1790s establishments in Maine
Sweet Dreams (Are Made of This)	1983 songs
Mazzy Star	Musical groups from California, People from Santa Monica, California, 1988 establishments in California, Musical groups established in 1988
Balls Mahoney	1972 births, 2016 deaths, Deaths from cardiac arrest, Former WWE wrestlers, Sportspeople from New Jersey
Tree hollow	Trees
Jeff Sessions	1946 births, Living people, United States Attorneys General, United States senators from Alabama, People from Selma, Alabama, US Republican Party politicians
Ademar Pereira Marinho	1954 births, Living people, Brazilian footballers
Masashi Hachuda	1964 births, Living people, Footballers from Yamanashi Prefecture, Japanese football managers
Yuki Tamura	1985 births, Living people, Footballers from Hiroshima Prefecture, People from Hiroshima
Tsuyoshi Kaneko	1983 births, Living people, Footballers from Tochigi Prefecture
Taijiro Kurita	1975 births, Living people, Footballers from Shizuoka Prefecture
Masashi Owada	1981 births, Living people, Footballers from Ibaraki Prefecture
SC Tavriya Simferopol	Ukrainian football clubs, 1958 establishments in Europe, 20th century establishments in Ukraine
F.C. Dynamo Kyiv	Ukrainian football clubs, Kiev, 1927 establishments in Europe, 1920s establishments in Ukraine
Tsutomu Matsuda	1983 births, Living people, Footballers from Aichi Prefecture
Masahiro Endo	1970 births, Living people, Footballers from Tokyo Prefecture, Japan international footballers, J1 League players, Júbilo Iwata players, Yokohama FC players, Tokyo Verdy players, Shimizu S-Pulse players
Takashi Watari	1972 births, Living people, Footballers from Okayama Prefecture
Hideo Hashimoto	1979 births, Living people, Footballers from Osaka Prefecture, Japan international footballers, J1 League players, J2 League players, Gamba Osaka players, Vissel Kobe players, Cerezo Osaka players, Cerezo Osaka U-23 players, AC Nagano Parceiro players, Tokyo Verdy players, FC Imabari players
Masaki Fukai	1980 births, Living people, Footballers from Yamanashi Prefecture
Montgolfier brothers	1740s births, French aviators, Sibling duos
Nazan Öncel	1956 births, Living people, Turkish singers
John Otto (drummer)	1977 births, Living people, American rock drummers, Musicians from Jacksonville, Florida
The Firebird	Compositions by Igor Stravinsky, Ballets Russes productions, Ballets choreographed by Michel Fokine, Fictional birds
Giuseppe Farina	1906 births, 1966 deaths, Accidental deaths in France, Formula One drivers, Italian racecar drivers, People from Turin, Road accident deaths, Sportspeople from Piedmont
Alberto Ascari	1918 births, 1955 deaths, Accidental deaths in Italy, Deaths in sport, Formula One drivers, Italian racecar drivers, Sportspeople from Milan
Enzo Ferrari	1898 births, 1988 deaths, Italian businesspeople, People from Modena, Racecar drivers
Charlotte's Web (2006 movie)	2006 movies, American family movies, Movies about spiders, Movies based on books
Portable application	Computing
Portable application creators	Computing
Shia LaBeouf	1989 births, Living people, American movie actors, American television actors, American voice actors, Actors from Los Angeles, California
Instinct	Psychology, Ethology
Step Brothers (movie)	2008 comedy movies, American comedy movies, Columbia Pictures movies, English-language movies, Movies about dysfunctional families, Movies about marriage, Movies directed by Adam McKay, Multilingual movies
Naples, Maine	Towns in Maine
Manchester, New Hampshire	Settlements established in the 18th century, 1751 establishments, Manchester, New Hampshire, County seats in New Hampshire, 1750s establishments in the Thirteen Colonies, 18th-century establishments in New Hampshire
Netflix	Entertainment websites, Movie industry, 1997 establishments in California, Companies based in the San Francisco Bay Area
Petrushka	Ballets choreographed by Michel Fokine, Ballets Russes productions, Ballets starring Nijinsky, Compositions by Igor Stravinsky
Blackbody radiation	Astrophysics, Thermodynamics, Electromagnetic radiation, Heat transfer, Infrared
Sputnik 1	Soviet spacecraft, Satellites, 1950s in the Soviet Union, 1957
Plummet	Electronic music bands, Musical groups from Orlando, Florida
Perfect Dark	2000 video games, Cooperative video games, Nintendo 64 games, Shooter video games
Matthias Sindelar	1903 births, 1939 deaths, Austrian footballers, Austrian football managers, Players of the Austrian national football team
Eugene Killoran	1987 births, Living people, Irish footballers, Japanese footballers, Sportspeople from Dublin
Yoshio Kitagawa	1978 births, Living people, Footballers from Kyoto
Uruguayan Primera Division	Football leagues
Bruno Metsu	1954 births, 2013 deaths, Deaths from colorectal cancer, Cancer deaths in France, French footballers, French football managers
Sergio Claudio dos Santos	1971 births, Living people, Brazilian footballers
Akihiro Ienaga	1986 births, Living people, Footballers from Hyōgo Prefecture, Japan international footballers, J1 League players, J2 League players, Gamba Osaka players, Oita Trinita players, Cerezo Osaka players, Omiya Ardija players, Kawasaki Frontale players
Shingo Morita	1978 births, Living people, Footballers from Kōchi Prefecture
Kentaro Hayashi	1972 births, Living people, Footballers from Tokyo Prefecture, Japan international footballers, Japanese football managers, J1 League players, J2 League players, Tokyo Verdy players, Vissel Kobe players, Ventforet Kofu players
Arata Sugiyama	1980 births, Living people, Footballers from Saitama Prefecture
Shinya Nasu	1978 births, Living people, Footballers from Osaka Prefecture, People from Osaka
Daiki Tamori	1983 births, Living people, Footballers from Hiroshima Prefecture
Yohei Onishi	1982 births, Living people, Footballers from Okayama Prefecture
Kenta Suzuki	1985 births, Living people, Footballers from Kanagawa Prefecture
Kazunari Hosaka	1983 births, Living people, Footballers from Tokyo Prefecture
Toshiki Chino	1985 births, Living people, Footballers from Yamanashi Prefecture
Daisuke Sudo	1977 births, Living people, Footballers from Kanagawa Prefecture
Taro Hasegawa	1979 births, Living people, Footballers from Tokyo Prefecture
Netley Hospital	Hospitals in the United Kingdom, Hampshire, Buildings and structures in England
Kotaro Yamazaki	1978 births, Living people, Footballers from Shizuoka Prefecture
Toru Kamikawa	1963 births, Living people, Footballers from Kagoshima Prefecture
Yusuke Kawakita	1978 births, Living people, Footballers from Osaka Prefecture, People from Osaka
Torashi Shimazu	1978 births, Living people, Footballers from Shizuoka Prefecture
Shunzo Ono	1965 births, Living people, Footballers from Chiba Prefecture
Scottish Football League Second Division	Scottish Football League, 1893 establishments in the United Kingdom, 1890s establishments in Scotland
Scottish Football League Third Division	Scottish Football League, 1923 establishments in the United Kingdom, 1920s establishments in Scotland
Jan Kromkamp	1980 births, Living people, Dutch footballers, Sportspeople from Friesland
Jérôme Rothen	1978 births, Living people, French footballers
Takehiro Hayashi	1976 births, Living people, Footballers from Chiba Prefecture
Peñarol	Uruguayan football clubs, 1891 establishments, 19th-century establishments in Uruguay
Johnny Rep	1951 births, Living people, Dutch football managers, Dutch footballers, People from Zaanstad, Sportspeople from North Holland
Steve Sidwell	1982 births, Living people, English footballers, Sportspeople from London, Premier League players
Nathan Delfouneso	1991 births, Living people, Black British sportspeople, English footballers, Sportspeople from Birmingham, Premier League players
Kingdom of Croatia (medieval)	Former countries in Europe, Former monarchies of Europe, 10th century establishments in Europe, 12th century disestablishments in Europe
Mickey Rourke	Actors from New York, American boxers, American movie actors, American Roman Catholics, American screenwriters, Sportspeople from New York, BAFTA Award winning actors, Golden Globe Award winning actors, People from Schenectady, New York, Writers from New York City, 1952 births, Living people
Benny Hill	Actors from Hampshire, British screenwriters, British television writers, Cardiovascular disease deaths in England, Comedians from Hampshire, English movie actors, English singers, English television actors, English writers, Musicians from Hampshire, People from Southampton, Writers from Hampshire, Deaths from coronary thrombosis, 1924 births, 1992 deaths
Whitey Ford	1928 births, 2020 deaths, Deaths from dementia, American baseball players, New York Yankees players, Sportspeople from Queens, National Baseball Hall of Fame members
Cass Fox	Singers from London, Living people, Year of birth missing (living people)
WGME-TV	Portland, Maine, American television stations
Sugar Island, Maine	Islands of the United States, Geography of Maine
Brown recluse spider	Spiders
4 Strings	Techno music, Dutch musical groups
Lefty Grove	1900 births, 1975 deaths, Boston Red Sox players
Lefty Gomez	1908 births, 1989 deaths, New York Yankees players
Koko B. Ware	1957 births, American professional wrestlers, Living people, Sportspeople from Tennessee, WWE Hall of Fame
Owen Hart	Hart family members, 1965 births, 1999 deaths, Canadian professional wrestlers, Deaths in sport, Former WWE wrestlers, Sportspeople from Calgary
Ken Shamrock	1964 births, Living people, American professional wrestlers, American mixed martial artists, American Christians, Sportspeople from Georgia (U.S. state)
Cage Match	Professional wrestling
Lake McDonald	Geography of Montana, Lakes of the United States
Resident Evil 4	2005 video games, PlayStation 2 games, Resident Evil, Wii games, Windows games, Video game sequels
Leszek Kołakowski	1927 births, 2009 deaths, 20th century philosophers, 21st century philosophers, Polish people
John Paul II Catholic University of Lublin	Colleges and universities in Poland, Christian colleges and universities, 20th century establishments in Poland, 1918 establishments in Europe
Nazarene (title)	Jesus Christ
Madawaska, Maine	Towns in Maine
Grawp	Harry Potter characters
Tsarevich Alexei Petrovich of Russia	1690 births, 1718 deaths, Russian nobility, Princes and princesses, House of Romanov
Billy Gunn	1963 births, American professional wrestlers, Living people, Sportspeople from Orlando, Florida, Total Nonstop Action Wrestling alumni
Meander	Rivers
Peach Girl	Manga
Thames Valley	Regions of England
Manchukuo yuan	Former currencies, Currency of Asia
Alonzo Mourning	1970 births, Living people, African-American basketball players, Miami Heat players, New Jersey Nets players, Sportspeople from Virginia, People from Hampton Roads, Virginia, National Basketball Association players with retired numbers, American basketball players
Independence Day (1996 movie)	1996 action movies, 1990s disaster movies, 1990s science fiction movies, 20th Century Fox movies, American action movies, American disaster movies, American science fiction movies, Movies set in Washington, D.C., Movies set in New York City, Movies set in Los Angeles, California, Movies set in Las Vegas, Movies set in Nevada, Movies set in Texas, Movies set in Asia, English-language movies, Movies directed by Roland Emmerich
Love's Philosophy	19th-century British poems
Penny Hardaway	African-American basketball players, American Olympic gold medalists, Miami Heat players, New York Knicks players, Orlando Magic players, Phoenix Suns players, Sportspeople from Memphis, Tennessee, 1971 births, Living people, American basketball players
Tim Hardaway	1966 births, African-American basketball players, Living people, Dallas Mavericks players, Denver Nuggets players, Golden State Warriors players, Indiana Pacers players, Miami Heat players, Sportspeople from Chicago, National Basketball Association players with retired numbers, American basketball players
Ben Wallace	1974 births, Living people, American basketball players, Chicago Bulls players, Cleveland Cavaliers players, Detroit Pistons players, Orlando Magic players, Washington Wizards players, Sportspeople from Alabama, National Basketball Association players with retired numbers
Tropical Storm Jerry (1995)	1995 Atlantic hurricane season, August events, 1995 in Florida, 1990s in Georgia (U.S. state), 20th century in South Carolina, 1990s in North Carolina
Jewel of the Seas	Cruise ships
Norwegian Cruise Line	Cruise ships, Miami, Florida, Transport in Florida
Wyclef Jean	Actors from New Jersey, African American musicians, American movie actors, American R&B singers, American television actors, Haitian people, Hip hop musicians, Reggae musicians, Singers from New Jersey, 1969 births, Living people
Ja Rule	1976 births, Living people, American movie actors, American rap musicians from New York, Actors from New York City, Singers from New York City
1 Giant Leap	Musical groups from London, Electronic music bands, Musical groups established in 2001, 2001 establishments in England
Yusaku Tanioku	1978 births, Living people, Footballers from Mie Prefecture
Michiharu Otagiri	1978 births, Living people, Footballers from Toyama Prefecture
Fabrizio Miccoli	1979 births, Living people, Italian footballers
Club Nacional de Football	Uruguayan football clubs
Georges-Louis Leclerc, Comte de Buffon	1707 births, 1788 deaths, Naturalists, French biologists, French mathematicians, French writers
Malky Mackay	Living people, 1972 births, Scottish football managers, Scottish footballers
The Postal Service	Musical groups from Los Angeles, California
Toryglen	Towns in Scotland
Nitride	Nitrogen compounds
Rail gauge	Rail transport
Skittles	Candy
Moon River	1961 songs, Best Original Song Academy Award-winning songs
Isleworth Ait	Islands of England, London Borough of Hounslow
Hurricane Anita	1977 Atlantic hurricane season, Hurricanes in Mexico, 1970s in Mexico
Oldsmobile Cutlass	Automobiles, General Motors vehicles
Nissan Skyline	Nissan automobiles, 1950s automobiles, 1960s automobiles, 1970s automobiles, 1980s automobiles, 1990s automobiles, 2000s automobiles, 2010s automobiles
1976 Atlantic hurricane season	Atlantic hurricane seasons, 1976
Vasa (ship)	Transport in Sweden, Warships
Tropical Storm Bilis	Tropical cyclones in Asia, 2006 in weather, 2006 in Asia, 2000s in China
Liebeck v. McDonald's Restaurants	United States law, 1994 in the United States, 1990s in law
Tamarind	Trees, Fabaceae
Federico Balzaretti	1981 births, Living people, Italian footballers
Marek Mintál	1977 births, Living people, Slovak footballers
Takuro Yajima	1984 births, Living people, Footballers from Shiga Prefecture
White Cliffs of Dover	White Cliffs of Dover, Geography of England, Areas of Outstanding Natural Beauty
Yuki onna	Japanese mythology
One-inch boy	Fairy tales
Pollen tube	Botany
Kuchisake onna	Japanese mythology
Murderdolls	2000s music groups, Musical groups from Los Angeles, California, American punk bands
Filey	Towns in North Yorkshire
Faizabad	Cities and towns in Uttar Pradesh
Alex Wright	1975 births, Living people, German sportspeople, People from Nuremberg, Professional wrestlers, Sportspeople from Bavaria
Ricky Steamboat	1953 births, Living people, American professional wrestlers, Sportspeople from Charlotte, North Carolina, WWE Hall of Fame
NHL 2K10	PlayStation 2 games, PlayStation 3 games, Wii games, Xbox 360 games, 2009 video games
George Acosta	American DJs, Living people, 1972 births, Musicians from Miami, Florida, Cuban people
Delfín Quishpe	1977 births, Living people, Ecuadorian entertainers, Singers
Rook	Corvids
Blackpool Transport	Tram transport in the United Kingdom, Lancashire
Starr Gate	Electric railways, Tram transport in the United Kingdom, Lancashire
Ernst Werner von Siemens	German scientists, German inventors, German nobility, 1816 births, 1892 deaths
Lee Chun-soo	1981 births, Living people, South Korean footballers, People from Incheon
Silvio Piola	1913 births, 1996 deaths, Italian footballers, Italian football managers
Roberto Soldado	1985 births, Living people, Spanish footballers, People from Valencia
South Shore, Blackpool	Lancashire
Montevideo Wanderers F.C.	Uruguayan football clubs, Montevideo, 20th-century establishments in Uruguay
South Pier, Blackpool	Buildings and structures in England, 19th century architecture
Rafael Sóbis	1985 births, Living people, Brazilian footballers
Takahiro Masukawa	1979 births, Living people, Footballers from Hyōgo Prefecture
Sergio Agüero	1988 births, Living people, 2014 FIFA World Cup players, Argentine footballers, Manchester City F.C. players, 2018 FIFA World Cup players, 2010 FIFA World Cup players, Sportspeople from Buenos Aires
Layton, Lancashire	Lancashire
Pleasure Beach Blackpool	1896 establishments in England, Blackpool
Hideaki Ozawa	1974 births, Living people, Footballers from Ibaraki Prefecture
Masaru Kurotsu	1982 births, Living people, Footballers from Ibaraki Prefecture
Hirokazu Ninomiya	1917 births, 2000 deaths, Footballers from Hyōgo Prefecture, Japan international footballers, Japanese football managers, Japan national football team managers
Esplanade	Infrastructure
Tatsunori Hisanaga	1977 births, Living people, Footballers from Kagoshima Prefecture
River Plate F.C.	Uruguayan football clubs, 1904 establishments in South America, 20th-century establishments in Uruguay, 1929 disestablishments
Process	Planning, Thought, Science
Günzburg (district)	Günzburg Rural District
Martin Keown	1966 births, English footballers, Living people, People from Oxford, Premier League players
Krumbach, Bavaria	Günzburg Rural District
Krumbach, Swabia (district)	Günzburg Rural District
Neiba	Settlements in Dominican Republic, 1735 establishments, 18th-century establishments in the Spanish Empire, 1730s establishments in North America
Lindau (district)	Lindau (district)
Donau-Ries	Donau-Ries
Dillingen (district)	Rural Districts in Swabia, Bavaria
Aichach-Friedberg	Aichach-Friedberg
Augsburg (district)	Augsburg, Rural Districts in Swabia, Bavaria
Neu-Ulm (district)	Rural Districts in Swabia, Bavaria
Oberallgäu	Oberallgäu
Ostallgäu	Rural Districts in Swabia, Bavaria
Unterallgäu	Rural Districts in Swabia, Bavaria
Swabia (Government Region)	Swabia, Bavaria
Carapachibey, Cuba	Cities in Cuba
Caleta Grande, Cuba	Cities in Cuba
Crowheart, Wyoming	Census-designated places in Wyoming, Freemont County, Wyoming
Run-on sentence	Punctuation, Sentences
Oscar (fish)	Teleosts, Freshwater fish, Aquarium fish
Mount Abram	Geography of Maine, Mountains of the United States
Swan Lake	Compositions by Pyotr Ilyich Tchaikovsky, Ballets by Marius Petipa, Ballets by Lev Ivanov, Ballets
Knock-knock joke	Humor
Landsberg (district)	Rural Districts in Upper Bavaria
Adriaen Coorte	1660s births, 1707 deaths, Dutch painters, People from Zeeland
Weilheim in Oberbayern	Towns in Bavaria, Weilheim-Schongau
Still life	Art
Computing platform	Computers, Operating systems
Iller-Lech Plateau	Geography of Bavaria, Swabia, Bavaria
Natural regions of Germany	Geography of Germany
Masato Saito	1975 births, Living people, Footballers from Saitama Prefecture
Yasuhiro Hato	1976 births, Living people, Footballers from Hyōgo Prefecture, Japan international footballers, J1 League players, Yokohama Flügels players, Yokohama F. Marinos players, Kashiwa Reysol players, Omiya Ardija players, 2001 FIFA Confederations Cup players
Takuro Nishimura	1977 births, Living people, Footballers from Tokyo Prefecture
Hiroshi Morita	1978 births, Living people, Footballers from Kumamoto Prefecture
Daisuke Tomita	1977 births, Living people, Footballers from Yamaguchi Prefecture
Seiichiro Okuno	1974 births, Living people, Footballers from Fukui Prefecture
Central Español F.C.	Uruguayan football clubs, Montevideo, 1905 establishments in South America, 20th-century establishments in Uruguay
Jan Zweyer	German writers, 1953 births, Living people
Portland Police Bureau (Oregon)	Law enforcement agencies of the United States, Portland, Oregon, 1870 establishments in the United States, 19th-century establishments in Oregon
Mitterteich	Towns in Bavaria
List of retired Pacific hurricane names	Hurricanes, Weather lists
Homo rhodesiensis	Hominins
Homo georgicus	Hominins
Chicxulub crater	Extinction events, Impact craters, Geology, Geography of Mexico
Ruslan Ponomariov	Ukrainian chess players, 1983 births, Living people, Chess grandmasters
WWE Bad Blood	World Wrestling Entertainment pay-per-view events
Hideaki Kitajima	1978 births, Living people, Footballers from Chiba Prefecture, Japan international footballers, J1 League players, J2 League players, Kashiwa Reysol players, Shimizu S-Pulse players, Roasso Kumamoto players, 2000 AFC Asian Cup players, AFC Asian Cup-winning players
Shigemaru Takenokoshi	1906 births, 1980 deaths, Footballers from Oita Prefecture, Japan international footballers, Japanese football managers, Japan national football team managers
Paulo Ferreira	1979 births, Living people, Portuguese footballers
Dumbarton F.C.	Scottish football clubs, 1872 establishments in the United Kingdom, 1870s establishments in Scotland
Third Lanark A.C.	Scottish football clubs
Abercorn F.C.	Scottish football clubs, 1877 establishments in Scotland, 1920 disestablishments in Europe, 1920s disestablishments in the United Kingdom
Vale of Leven F.C.	Scottish football clubs
Cowlairs F.C.	Scottish football clubs, 1876 establishments in the United Kingdom, 1870s establishments in Scotland, 1896 disestablishments, 1890s disestablishments in Europe, 19th century disestablishments in the United Kingdom
Allsvenskan	1924 establishments in Sweden, Football leagues, Football in Sweden
French lavender	Lamiaceae
Andreas Herzog	1968 births, Living people, Austrian footballers, Players of the Austrian national football team, Austrian football managers
Takayoshi Yamano	1955 births, Living people, Footballers from Osaka Prefecture, Japan international footballers, Japan Soccer League players, Cerezo Osaka players
Zoigl	Beer
Leith Athletic F.C.	Scottish football clubs
Osteoporosis	Diseases and disorders of bones
Taizo Kawamoto	1914 births, 1985 deaths, Footballers from Aichi Prefecture, Japan international footballers, Japanese football managers, Japan national football team managers, Footballers at the 1936 Summer Olympics, Footballers at the 1956 Summer Olympics
Steve Corica	1973 births, Living people, Australian footballers, Sportspeople from Queensland
Miguel Simão	1973 births, Living people, Portuguese footballers, People from Porto
Taketo Shiokawa	1977 births, Living people, Footballers from Shizuoka Prefecture
Hedwiges Maduro	1985 births, Living people, Dutch footballers, People from Flevoland
Mitsuhisa Taguchi	1955 births, 2019 deaths, Footballers from Akita Prefecture, Japan international footballers, Japan Soccer League players, Urawa Red Diamonds players, Deaths from respiratory failure
St. Bernard's F.C.	Scottish football clubs
Port Glasgow Athletic F.C.	Scottish football clubs
Red Stripe	Beer
Molson	Beer
Foster's Lager	Beer, Economy of Australia
Issler's Orchestra	American musical groups, 1888 establishments in the United States
WWE New Year's Revolution	World Wrestling Entertainment pay-per-view events, 2005 establishments, January events
Bash at the Beach	World Championship Wrestling
Sea eagle	Accipitriformes
Bank of Korea Museum	Museums in South Korea
Megatherium	Extinct species, Megafauna, Xenarthrans, Mammals of South America
Éclair	Desserts
Eggs Benedict	Egg dishes, Dishes named after people
Hideki Sahara	1978 births, Living people, Footballers from Kanagawa Prefecture
Takahisa Nishiyama	1985 births, Living people, Footballers from Miyagi Prefecture
Takeshi Urakami	1969 births, Living people, Footballers from Tokyo Prefecture
Airdrieonians F.C. (1878)	Scottish football clubs, North Lanarkshire, 1878 establishments in Scotland
Hulk (footballer)	1986 births, Living people, Brazilian footballers
Hiroyuki Kobayashi	1980 births, Living people, Footballers from Hokkaidō Prefecture
Yoshiro Moriyama	1967 births, Living people, Footballers from Kumamoto Prefecture, Japan international footballers, J1 League players, Japan Soccer League players, Sanfrecce Hiroshima players, Yokohama Flügels players, Júbilo Iwata players, Shonan Bellmare players
Defensor Sporting	Uruguayan football clubs, Montevideo, 1913 establishments in South America, 20th-century establishments in Uruguay
Kazuyori Mochizuki	1961 births, Living people, Footballers from Shizuoka Prefecture
Kota Aoki	1987 births, Living people, Footballers from Shiga Prefecture
Ayr United F.C.	Scottish football clubs, 1910 establishments in Europe, 1910s establishments in the United Kingdom, 20th century establishments in Scotland
Encyclopaedia Hebraica	Israeli culture, Encyclopedias, Hebrew language
Milkweed	Asclepias
Chaim Weizmann	1874 births, 1952 deaths, Autobiographers, Belarusian Jews, British chemists, Israeli academics, Israeli scientists, Jewish academics, Jewish British academics, Jewish British scientists, Jewish Israeli politicians, Jewish scientists, Naturalized citizens of Israel, Naturalised citizens of the United Kingdom, Presidents of Israel, Russian Jews, Zionists
Natural History Museum	Museums in London, National museums, Natural history museums
Bracha Peli	1892 births, 1986 deaths, Israeli businesspeople, Israeli Jews, Jewish businesspeople, Naturalized citizens of Israel, People from Kiev, Publishers, Soviet Jews, Teachers, Ukrainian Jews
San Francisco de Macorís	Settlements in Dominican Republic, 1778 establishments in North America, 18th-century establishments in the Spanish Empire
2008 Pacific hurricane season	2008 Pacific hurricane season
Hurricane Juan	2003 Atlantic hurricane season
Edaphosaurus	Pelycosaurs
Declan Galbraith	1991 births, Living people, English singers
Dettmar Cramer	1925 births, 2015 deaths, German football managers, German footballers, German military personnel of World War II, People from Dortmund, Sportspeople from North Rhine-Westphalia
Atsushi Mio	1983 births, Living people, Footballers from Kanagawa Prefecture
Daisuke Hoshi	1980 births, Living people, Footballers from Tokyo Prefecture
Havelian	Cities in Pakistan, Abbottabad District
Dassu	Cities in Pakistan
Takayoshi Amma	1969 births, Living people, Footballers from Shizuoka Prefecture
Brian Labone	1940 births, 2006 deaths, English footballers, People from Liverpool
Keiji Yoshimura	1979 births, Living people, Footballers from Kōchi Prefecture
Rodrigo Gral	1977 births, Living people, Brazilian footballers
Andradina	1974 births, Living people, Brazilian footballers
East Stirlingshire F.C.	Scottish football clubs, 1881 establishments in the United Kingdom, 1880s establishments in Scotland
Claudio Luiz Assuncao de Freitas	1972 births, Living people, Brazilian footballers
Naoya Kikuchi	1984 births, Living people, Footballers from Shizuoka Prefecture, Japan international footballers, J1 League players, J2 League players, Júbilo Iwata players, Albirex Niigata players, Oita Trinita players, Sagan Tosu players, Hokkaido Consadole Sapporo players, Avispa Fukuoka players, Footballers at the 2004 Summer Olympics
Arthurlie F.C.	Scottish football clubs, 1874 establishments in Scotland
Seiji Koga	1979 births, Living people, Footballers from Fukuoka Prefecture
Takayuki Yoshida	1977 births, Living people, Footballers from Hyōgo Prefecture
Rampla Juniors F.C.	Uruguayan football clubs, Montevideo, 1914 establishments
Raith Rovers F.C.	Scottish football clubs
Jorge Campos	1966 births, Living people, Mexican footballers, Association football goalkeepers
Emmanuel Adebayor	1984 births, Living people, Sport in Togo, African footballers, Arsenal F.C. players, Crystal Palace F.C. players, Manchester City F.C. players, Tottenham Hotspur F.C. players
Jan Wouters	1960 births, Living people, Dutch football managers, Dutch footballers, Eredivisie managers, Sportspeople from Utrecht (city)
C.A. Bella Vista	Uruguayan football clubs, Montevideo, 1920 establishments in South America
Albion Rovers F.C.	Scottish football clubs, 1882 establishments in the United Kingdom, 1880s establishments in Scotland
Bispham, Blackpool	Villages in Lancashire
Xevious	Apple II games, MSX games, Commodore 64 games, Nintendo Entertainment System games
Niederraunau	Günzburg Rural District, Villages in Bavaria
Transverse wave	Wave physics
Serbian Wikipedia	Wikipedias, Serbian language
Mesonychid	Mesonychids
Andrewsarchus	Mesonychids
Eurolang	Constructed languages
Molar conductivity	Physical chemistry
Mingora	Cities in Pakistan
Katsuyoshi Shinto	1960 births, Living people, Footballers from Hiroshima Prefecture, Japan international footballers, Japanese football managers, J1 League players, Japan Soccer League players, Sanfrecce Hiroshima players, Urawa Red Diamonds players, Shonan Bellmare players
Gaël Clichy	1985 births, Living people, French footballers, Manchester City F.C. players
George Yonashiro	1950 births, Living people, People from São Paulo, Brazilian-Japanese footballers, Japan international footballers, Japanese football managers, Japan Soccer League players, Tokyo Verdy players
Brain cell	Brain, Neurology, Cells
Texas Blind Snake	Snakes
Snake worship	Snakes, Worship
Glass lizard	Anguids
Tequesta, Florida	Villages in Florida, Palm Beach County, Florida
Jupiter Inlet Colony, Florida	Towns in Florida, Palm Beach County, Florida
Juno Beach, Florida	Towns in Florida, Palm Beach County, Florida
North Palm Beach, Florida	Villages in Florida, Palm Beach County, Florida
Lake Park, Florida	Towns in Florida, Palm Beach County, Florida
Palm Beach Shores, Florida	Towns in Florida, Palm Beach County, Florida
Mangonia Park, Florida	Towns in Florida, Palm Beach County, Florida
Palm Beach, Florida	Towns in Florida, Palm Beach County, Florida
Haverhill, Florida	Towns in Florida, Palm Beach County, Florida
Glen Ridge, Florida	Towns in Florida, Palm Beach County, Florida
Cloud Lake, Florida	Towns in Florida, Palm Beach County, Florida
Palm Springs, Florida	Villages in Florida, Palm Beach County, Florida
Homosociality	Sociology
1971 Atlantic hurricane season	Atlantic hurricane seasons, 1971
Argument from nonbelief	Philosophy, Religion, Critical thinking
Nociceptive trigeminal inhibition tension suppression system	Dentistry, Migraine
Ministry of National Defense (Romania)	Government of Romania, 1858 establishments in Europe, 19th century establishments in Romania
United States Secretary of Veterans Affairs	United States Secretaries of Veterans Affairs, 1989 establishments in the United States
Girls' Generation	K-pop music groups, Musical groups established in 2007, South Korean girl groups, 2007 establishments in South Korea
Basilosaurus	Cetaceans
Eric Shinseki	1942 births, Living people, United States Secretaries of Veterans Affairs, American military people, Politicians from Hawaii, Purple Heart recipients
Pakicetus	Cetaceans
Ed Derwinski	United States Secretaries of Veterans Affairs, US Republican Party politicians, Politicians from Chicago, Military people from Chicago, Deaths from Merkel-cell carcinoma, 1926 births, 2012 deaths
Metamorphism	Geology
National Museum of Korea	Buildings and structures in Seoul, National museums in South Korea, 1909 establishments in Asia, 20th century establishments in South Korea
Embassy of Russia in Copenhagen	Copenhagen, Russia, 19th century architecture, Buildings and structures in Denmark, International relations, 1899 establishments in Europe, 19th century establishments in Denmark
Parthenogenesis	Methods of reproduction, Insects
Lawrence Durrell	1912 births, 1990 deaths, British writers
Georges Clemenceau	1841 births, 1929 deaths, French people of World War I, Prime Ministers of France
Rikarudo Higa	1973 births, Living people, Brazilian footballers
Marcelo Mattos	1984 births, Living people, Brazilian footballers
Hans Gillhaus	1963 births, Living people, Dutch footballers, People from Helmond, Sportspeople from North Brabant
Ricardo Aparecido Tavares	1987 births, Living people, Brazilian footballers
Emmanuel Eboué	1983 births, Living people, Ivorian footballers
Sebastian Larsson	1985 births, Living people, Swedish footballers
Cowdenbeath F.C.	Scottish football clubs, 1881 establishments in the United Kingdom, 1880s establishments in Scotland
Adrian Năstase	Prime Ministers of Romania, 1950 births, Living people, People from Bucharest, Presidents of the Chamber of Deputies (Romania)
Kingsnake	Colubrids
Mikhail Vasilyevich Alekseyev	1857 births, 1918 deaths, Russian politicians
Nenad Maslovar	1967 births, Living people, Montenegrin footballers
Ha Seok-ju	1968 births, Living people, South Korean footballers, South Korean football managers
Alexandre Torres	1966 births, Living people, Footballers from Rio de Janeiro
Luiz Carlos Guarnieri	1971 births, Living people, Brazilian footballers
Richard Witschge	1969 births, Living people, Dutch footballers, Sportspeople from Amsterdam
Carlos Alberto Santos	1960 births, Living people, Brazilian footballers
Philippe Senderos	1985 births, Living people, Swiss footballers, People from Geneva
Stanisław Wojciechowski	1869 births, 1953 deaths
Aleksey Alekseyevich Brusilov	1853 births, 1926 deaths, Military personnel of World War I, Russian generals
Jesse Brown	United States Secretaries of Veterans Affairs, Politicians from Chicago, Politicians from Michigan, Deaths from motor neurone disease, 1944 births, 2002 deaths
Dryfe Water	Rivers of Scotland
Togo D. West Jr.	1942 births, 2018 deaths, Deaths from myocardial infarction, African American lawyers, African-American military personnel, African American politicians, People from Winston-Salem, North Carolina, Politicians from North Carolina, United States Secretaries of the Army, United States Secretaries of Veterans Affairs
Anton Ivanovich Denikin	1872 births, 1947 deaths
Sea of Azov	Seas of the Atlantic Ocean, Geography of Ukraine, Geography of Russia
Bellingshausen Sea	Antarctic region, Seas of the Southern Ocean
Flathead Lake	Lakes of the United States, Geography of Montana
James Peake	1944 births, Living people, American generals, American military personnel of the Vietnam War, American physicians, Cornell University alumni, Purple Heart recipients, Politicians from St. Louis, Missouri, Scientists from St. Louis, Missouri, United States Secretaries of Veterans Affairs
Neva River	Rivers of Russia
Kariba Dam	Dams, 1950s establishments in Africa, 1959 establishments
Antonio Villaraigosa	Mayors of Los Angeles, 1953 births, Living people, American Roman Catholics, US Democratic Party politicians, Legislative speakers, State legislators of the United States
Santa Monica Mountains	Mountains of California, Geography of Los Angeles County, California, Ventura County, California
Juan Crespi	1721 births, 1782 deaths, Spanish explorers, Spanish Roman Catholics, Roman Catholic priests, Missionaries, People from Palma de Mallorca, Franciscans
Find a Grave	Websites, Cemeteries
Jim Nicholson (U.S. politician)	1938 births, Living people, Real estate developers, Politicians from Iowa, Columbia University alumni, United States Secretaries of Veterans Affairs, US Republican Party politicians, American lawyers
Anthony Principi	1944 births, Living people, American lobbyists, American military personnel of the Vietnam War, Politicians from New York City, United States Secretaries of Veterans Affairs, People from Teaneck, New Jersey
Entelodont	Even-toed ungulates
Abou Diaby	1986 births, Living people, French footballers, Sportspeople from Paris
Tranquillo Barnetta	1985 births, Living people, Swiss footballers
Cha-cha-cha	Dance music, Latin dances
Parlour	Rooms
Celluloid	Chemical compounds
Kingdom Hearts	Mass media franchises introduced in 2002, Kingdom Hearts series
Cuban music	Cuban music
Dune (novel)	1965 books, Dune universe, Hugo Award winning books, Series of books, American novels, English-language novels
Jim Crow laws	African-American history, Discrimination, United States federal legislation, History of the United States
Cavalier King Charles Spaniel	Spaniels
Sturm und Drang	German literature
Flag of Angola	Angola, National flags
Joe Thornton	1979 births, Art Ross Trophy winners, Boston Bruins players, Canadian ice hockey centres, Hart Memorial Trophy winners, Ice hockey people from Ontario, Living people, San Jose Sharks players, Ontario Hockey League players
Oleg Kononenko	1964 births, Living people, Cosmonauts
Ville Peltonen	1973 births, American Hockey League players, Finnish ice hockey players, International Hockey League (1945–2001) players, Living people, Swedish Hockey League players, Vantaa
Alexei Yashin	1973 births, Ice hockey centres, International Hockey League (1945–2001) players, Living people, New York Islanders players, Ottawa Senators players, Russian ice hockey players
Tochigi Prefecture	Tochigi Prefecture, Prefectures of Japan
Hato Mayor del Rey	Settlements in Dominican Republic, 1520s establishments in North America, 16th-century establishments in the Spanish Empire
3 World Trade Center	Skyscrapers in New York City, September 11 attacks, Buildings and structures in Manhattan
4 World Trade Center	Skyscrapers in New York City, September 11 attacks, 2014 establishments in New York (state), 2010s establishments in New York (state), Buildings and structures in Manhattan
5 World Trade Center	Skyscrapers in New York City, September 11 attacks, Buildings and structures in Manhattan
John Tavares	1990 births, Canadian ice hockey centres, Canadian Olympic gold medalists, Ice hockey people from Ontario, Living people, New York Islanders players, Ontario Hockey League players, Toronto Maple Leafs players
Ralph Fletcher	1953 births, American novelists, American poets, Living people, Columbia University alumni, writers from Massachusetts
Werner Naumann	1909 births, 1982 deaths, Government ministers of Nazi Germany, People from former German territories, Politicians of the Nazi Party, Sturmabteilung people, SS officers, Waffen-SS people
Gauleiter	Gauleiters
Hedingen	Municipalities of Zürich
Typhus	Diseases caused by bacteria
Troglodytae	Ancient history
Hershel W. Gober	United States Secretaries of Veterans Affairs, Politicians from Arkansas, 1936 births, Living people, Purple Heart recipients
Hazel R. O'Leary	1937 births, Living people, US Democratic Party politicians, United States Secretaries of Energy, Politicians from Virginia, People from Newport News, Virginia
Mount Whitney	Mountains of California, Inyo County, California, Tulare County, California
Federico Peña	1947 births, Living people, Mayors of Denver, People from Laredo, Texas, US Democratic Party politicians, United States Secretaries of Energy, United States Secretaries of Transportation, Politicians from Texas, 20th-century American politicians
Cynognathus	Theriodonts
Natural units	Physics
Fulacunda	Guinea-Bissau, Towns in Africa
Fur seal	Pinnipeds
Hugh A. Robertson	1932 births, 1988 deaths, American movie directors
Mike Rodríguez	1989 births, Living people, Ecuadorian footballers
Morlaix	Communes in Finistère, Subprefectures in France
Bristol Filton Airport	Airports in England
22171 Choi	Asteroids
Hólmar Örn Eyjólfsson	1990 births, Living people, Icelandic footballers
Žigmund Pálffy	1972 births, Living people
Greg Egan	1961 births, Australian science fiction writers, Living people, People from Perth, Western Australia, Australian novelists
Billy Abercromby	1958 births, Living people, Scottish footballers
Jürgen Seeberger	1965 births, Living people, German footballers, Sportspeople from Baden-Württemberg, People from Konstanz
Caroline van Dommelen	1874 births, 1957 deaths, Dutch movie actors, People from Rotterdam, Silent movie actors
Sam Shepard	Screenwriters from Illinois, American movie directors, American television directors, American movie actors, American television actors, Actors from Illinois, American playwrights, Deaths from motor neurone disease, 1943 births, 2017 deaths
Terry Ellis	Singers from Houston, Texas, 1963 births, Living people
Jan Åge Fjørtoft	1967 births, Living people, Norwegian footballers
Bob's Full House	1984 television series debuts, 1990 television series endings, 1980s British television series, 1990s British television series, BBC Television programmes, British television game shows
Mathieu Flamini	1984 births, Living people, French footballers
Theo Walcott	1989 births, Living people, 2006 FIFA World Cup players, Arsenal F.C. players, Black British sportspeople, English footballers, People from Berkshire, Sportspeople from London, UEFA Euro 2012 players, Premier League players
Eriz	Municipalities of Bern
GAIS	1897 establishments in Sweden, Swedish football clubs, Sport in Gothenburg
IFK Göteborg	Swedish football clubs, 1904 establishments in Sweden, Sport in Gothenburg
Örgryte IS	Swedish football clubs, 1887 establishments in Europe, Sport in Gothenburg, 1880s establishments in Sweden
Helsingborgs IF	Swedish football clubs, Helsingborg, 1907 establishments in Sweden
AIK Solna	Swedish football clubs, 1891 establishments in Sweden
IFK Norrköping	Swedish football clubs, Norrköping, 1897 establishments in Sweden
IFK Eskilstuna	Swedish football clubs, 1897 establishments in Sweden
Hammarby IF	1915 establishments in Sweden, Swedish football clubs, Sport in Stockholm
Jungo Fujimoto	1984 births, Living people, Footballers from Kanagawa Prefecture, Japan international footballers, J1 League players, J2 League players, J3 League players, Shimizu S-Pulse players, Nagoya Grampus players, Yokohama F. Marinos players, Gamba Osaka players, Gamba Osaka U-23 players, Kyoto Sanga　FC players, SC Sagamihara players
Akihiro Hyodo	1982 births, Living people, Footballers from Chiba Prefecture
Naoaki Aoyama	1986 births, Living people, Footballers from Aichi Prefecture
Sarayu	Rivers of India
Nashik	Cities in India, Settlements in Maharashtra
Alexis Herman	1947 births, Living people, United States Secretaries of Labor, Politicians from Alabama, People from Mobile, Alabama
Conjugate variables	Quantum mechanics, Physics
Rail yard	Rail transport
Salcedo, Hermanas Mirabal	Settlements in Dominican Republic, 1905 establishments in North America, 20th-century establishments in the Dominican Republic
Andrew of Cornwall	English philosophers
Landry Bonnefoi	1983 births, Living people, French footballers, Association football goalkeepers
Hossein Kaebi	1985 births, Living people, Iranian footballers
IF Elfsborg	1904 establishments in Sweden, Swedish football clubs
Daisuke Fujii	1986 births, Living people, Footballers from Osaka Prefecture
Yoshiki Takahashi	1985 births, Living people, Footballers from Nagano Prefecture
Valon Behrami	1985 births, Living people, Swiss footballers
Djurgårdens I.F.	Swedish football clubs, Sport in Stockholm, 1899 establishments in Sweden
Zlatko Kranjčar	1956 births, 2021 deaths, Croatian footballers, Croatian football managers, Sportspeople from Zagreb
Raúl Vicente Amarilla	1960 births, Living people, Paraguayan footballers
Ariel Ibagaza	1976 births, Living people, Argentine footballers, Sportspeople from Buenos Aires
Luis Amaranto Perea	1979 births, Living people, Colombian footballers
Igor Lediakhov	1968 births, Living people, Russian footballers, Russian football managers, Sochi
Yosuke Nishi	1983 births, Living people, Footballers from Miyagi Prefecture
Twilight Comes Twice	Children's books, Works by Ralph Fletcher, 1997 books, 20th-century American poems
Free verse	Poetry forms
Salva Ballesta	1975 births, Living people, Spanish footballers, People from Zaragoza
Toshihiro Yahata	1980 births, Living people, Footballers from Ibaraki Prefecture
Javier Chevantón	1980 births, Living people, Uruguayan footballers
Takashi Hirano	1974 births, Living people, Footballers from Shizuoka Prefecture, Japan international footballers, J1 League players, Nagoya Grampus players, Kyoto Sanga FC players, Júbilo Iwata players, Vissel Kobe players, Tokyo Verdy players, Yokohama F. Marinos players, Omiya Ardija players, 1998 FIFA World Cup players
Tadatoshi Masuda	1973 births, Living people, Footballers from Shizuoka Prefecture, Japan international footballers, J1 League players, Kashima Antlers players, FC Tokyo players, JEF United Chiba players, Kashiwa Reysol players, Oita Trinita players
Hiroshige Yanagimoto	1972 births, Living people, Footballers from Osaka Prefecture, Japan international footballers, J1 League players, Japan Soccer League players, Sanfrecce Hiroshima players, Gamba Osaka players, Cerezo Osaka players, 1995 King Fahd Cup players, 1996 AFC Asian Cup players
Miroslav Mentel	1962 births, Living people, Slovak footballers, Association football goalkeepers
Keiji Kaimoto	1972 births, Living people, Footballers from Osaka Prefecture, Japan international footballers, J1 League players, Vissel Kobe players, Nagoya Grampus players, Albirex Niigata players, 2000 AFC Asian Cup players, AFC Asian Cup-winning players
Norihiro Nishi	1980 births, Living people, Footballers from Osaka Prefecture, Japan international footballers, J1 League players, J2 League players, Júbilo Iwata players, Tokyo Verdy players, Footballers at the 2000 Summer Olympics
Theory	Philosophy of science
Fingering (sexual act)	Sexual acts
Bogon filtering	Internet protocols
John Rolfe	English explorers, Colonial Americans, 1580s births, 1622 deaths
Watts Riots	1965 in the United States, 1960s in Los Angeles, California, 1960s riots, African-American history, Civil rights, Crime in California, Riots in the United States, August events
Dodger Stadium	Los Angeles Dodgers, Major League Baseball venues, Sports buildings in Los Angeles, California, 1962 establishments in the United States, 1960s establishments in California
Venice, Los Angeles	Neighborhoods of Los Angeles
Hollywood Walk of Fame	Buildings and structures in Los Angeles, California
Playboy Mansion	Buildings and structures in Los Angeles, California, 1927 establishments in the United States, 1920s establishments in California
University of Southern California	1880 establishments in the United States, Association of American Universities, Pac-12 Conference, Colleges and universities in Los Angeles, California, 1880s establishments in California
Endoplasmic reticulum	Organelles
Jimaní	Settlements in Dominican Republic, 1504 establishments in the Spanish Empire
MouseHunt	Games
Zhoukoudian	Caves
Morant Bay rebellion	History of Jamaica, Rebellions in North America, 19th century rebellions, Slave rebellions, 1865 in North America
Herta Müller	1953 births, Living people, German essayists, German Nobel Prize winners, German novelists, German poets, German writers, Romanian writers
1138 Aleppo earthquake	1138, Aleppo, Earthquakes in Asia, History of Syria, Articles on pre-1900 earthquakes
Filippa Reinfeldt	1967 births, Living people, Swedish politicians
Karl Wilhelm Scheibler	1820 births, 1881 deaths, Polish people, German people
Sarah Silverman	Actors from New Hampshire, Singers from New Hampshire, Musicians from New Hampshire, American comedians, Webby Award winners, American movie actors, American television actors, American voice actors, 1970 births, Living people, Emmy Award winners
Coat of arms of Australia	National coats of arms, Australia
Dinnerladies	1998 British television series debuts, 2000 disestablishments in Europe, 1990s British sitcoms, 1990s British workplace television series, 2000s British sitcoms, 2000s British workplace television series, 2000s disestablishments in the United Kingdom, 2000s television series endings, 2000s workplace comedy television series, BBC television sitcoms, British workplace comedy television series, Television series set in Manchester, English-language television programs
Jeroen Boere	1967 births, 2007 deaths, Dutch footballers, People from Arnhem, Sportspeople from Gelderland
Jorge Luiz de Amorim Silva	1979 births, Living people, Brazilian footballers
Ryang Kyu-Sa	1978 births, Living people, North Korean footballers
Halmstads BK	Swedish football clubs, 1914 establishments in Sweden
Diego de Souza Gama Silva	1984 births, Living people, Brazilian footballers
Marcelinho Carioca	1971 births, Living people, Footballers from Rio de Janeiro
Johan Djourou	1987 births, Living people, Swiss footballers
North Korea national football team	National football teams, Sport in North Korea
Cape Verde national football team	National football teams, Cape Verde
Cook Islands national football team	National football teams, Cook Islands
Fiji national football team	National football teams, Sport in Fiji
Kiribati national football team	National football teams, Kiribati
Federated States of Micronesia national football team	National football teams, Federated States of Micronesia
Niue national football team	National football teams, Niue
Northern Mariana Islands national football team	National football teams, Northern Mariana Islands
Palau national football team	National football teams, Palau
Papua New Guinea national football team	National football teams, Sport in Papua New Guinea
Samoa national football team	National football teams
Solomon Islands national football team	National football teams, Solomon Islands
Tahiti national football team	National football teams, French Polynesia
Tonga national football team	National football teams
Tuvalu national football team	National football teams
Vanuatu national football team	National football teams, Vanuatu
Yuji Sakakura	1967 births, Living people, Footballers from Mie Prefecture, Japan international footballers, Japanese football managers, J1 League players, Japan Soccer League players, JEF United Chiba players, Nagoya Grampus players, Vegalta Sendai players, 1988 AFC Asian Cup players, 1992 AFC Asian Cup players, AFC Asian Cup-winning players
Shingi Ono	1974 births, Living people, Footballers from Tokyo Prefecture
Sergei Aleinikov	1961 births, Living people, Belarusian footballers, People from Minsk
Alloa Athletic F.C.	Scottish football clubs, 1878 establishments in Scotland
East Fife F.C.	Scottish football clubs, 1903 establishments in Scotland
Forfar Athletic F.C.	Scottish football clubs, 1885 establishments in the United Kingdom, 1880s establishments in Scotland
Arbroath F.C.	Scottish football clubs, 1878 establishments in Scotland
Arturo Lupoli	1987 births, Living people, Italian footballers, Sportspeople from Lombardy, People from Brescia
Lauren Etame Mayer	1977 births, Living people, Cameroonian footballers
Tomoya Uchida	1983 births, Living people, Footballers from Mie Prefecture
Kenichi Shimokawa	1970 births, Living people, Footballers from Gifu Prefecture, Japan international footballers, J1 League players, Japan Soccer League players, JEF United Chiba players, Yokohama F. Marinos players, 1996 AFC Asian Cup players
Kunie Kitamoto	1981 births, Living people, Footballers from Nara Prefecture
Tadahiro Akiba	1975 births, Living people, Footballers from Chiba Prefecture, Japanese football managers, J1 League players, J2 League players, JEF United Chiba players, Avispa Fukuoka players, Cerezo Osaka players, Albirex Niigata players, Tokushima Vortis players, Thespakusatsu Gunma players, SC Sagamihara players, Footballers at the 1996 Summer Olympics
Montrose F.C.	Scottish football clubs
Brechin City F.C.	Scottish football clubs, 1906 establishments in the United Kingdom, 1900s establishments in Scotland
Yuji Hironaga	1975 births, Living people, Footballers from Osaka Prefecture, J1 League players, J2 League players, Tokyo Verdy players, Gamba Osaka players, Yokohama FC players, Cerezo Osaka players, Footballers at the 1996 Summer Olympics
Kiyokazu Kudo	1974 births, Living people, Footballers from Hyōgo Prefecture, Avispa Fukuoka players
Karel Brückner	1939 births, Living people, Czech footballers, Austria national football team managers
Nithsdale Wanderers F.C.	Scottish football clubs
Helensburgh F.C.	Scottish football clubs
Ryuji Michiki	1973 births, Living people, Footballers from Nagasaki Prefecture, Japan international footballers, J1 League players, J2 League players, Sanfrecce Hiroshima players, Yokohama F. Marinos players, Urawa Red Diamonds players, Vissel Kobe players, Oita Trinita players, Footballers at the 1996 Summer Olympics, 1996 AFC Asian Cup players
Norihiro Satsukawa	1972 births, Living people, Footballers from Shizuoka Prefecture
C.A. Progreso	Uruguayan football clubs, Montevideo, 1917 establishments, 20th-century establishments in Uruguay
Tetsuya Enomoto	1983 births, Living people, Footballers from Kanagawa Prefecture
Makoto Kakegawa	1973 births, Living people, Footballers from Saitama Prefecture
Naoto Otake	1968 births, Living people, Footballers from Shizuoka Prefecture, Japan international footballers, J1 League players, J2 League players, Japan Soccer League players, Yokohama Flügels players, Kyoto Sanga FC players, 1988 AFC Asian Cup players, 1992 AFC Asian Cup players, AFC Asian Cup-winning players
Latino moderne	Constructed languages
Downtown São Paulo	São Paulo
Grandpa Never Lies	Children's books, 2000 books
BookCrossing	Websites, Books
Bukit Timah	Geography of Singapore, Places in Singapore, Hills
Rossall	Settlements in Lancashire
Armenia-Turkey relations	History of Turkey, History of Armenia, 2009
Lytham St Annes	Towns in Lancashire, Beaches of Europe
Poulton-le-Fylde	Towns in Lancashire, Wyre
Coppa Italia	Football in Italy, Football competitions
Anna Anka	American models, American movie actors, American television actors, American television personalities, Polish movie actors, Polish television actors, Swedish models, Swedish movie actors, Swedish television actors, 1971 births, Living people
Stacy Schiff	1961 births, Living people, Biographers, American historians, American journalists, Writers from Massachusetts, Pulitzer Prize winners
Tenure	Employment
Toshinobu Katsuya	1961 births, Living people, Footballers from Nagasaki Prefecture, Japan international footballers, J1 League players, Japan Soccer League players, Honda FC players, Yokohama F. Marinos players, Júbilo Iwata players, Cerezo Osaka players, 1992 AFC Asian Cup players, AFC Asian Cup-winning players
Mitsunori Yoshida	1962 births, Living people, Footballers from Aichi Prefecture, Japan international footballers, J1 League players, Japan Soccer League players, Júbilo Iwata players, 1992 AFC Asian Cup players, AFC Asian Cup-winning players
Anthony Vanden Borre	1987 births, Living people, Belgian footballers
Danubio F.C.	Uruguayan football clubs, Montevideo, 1932 establishments in South America
Thornton, Lancashire	Towns in Lancashire, Wyre
Lancashire County Council	Lancashire
Central Pier, Blackpool	19th century architecture
Stefan Ishizaki	1982 births, Living people, Swedish footballers, Sportspeople from Stockholm
Atsuhiro Iwai	1967 births, Living people, Footballers from Saitama Prefecture
Tatsuru Mukojima	1966 births, Living people, Footballers from Shizuoka Prefecture
Junji Nishizawa	1974 births, Living people, Footballers from Tokyo Prefecture
Masanori Sanada	1968 births, 2011 deaths, Footballers from Shizuoka Prefecture, J1 League players, Japan Soccer League players, Yokohama Flügels players, Shimizu S-Pulse players, 1988 AFC Asian Cup players
José Ignacio Zahínos	1977 births, Living people, Spanish footballers, Sportspeople from Madrid
Hiromi Kojima	1977 births, Living people, Footballers from Fukuoka Prefecture, Japan international footballers, J1 League players, J2 League players, Gamba Osaka players, Hokkaido Consadole Sapporo players, Omiya Ardija players, Oita Trinita players, Vissel Kobe players, FC Gifu players
Makoto Kakuda	1983 births, Living people, Footballers from Kyoto, V-Varen Nagasaki players
Ram Narayan	1927 births, Living people, Indian musicians
Takuma Edamura	1986 births, Living people, Footballers from Shizuoka Prefecture
Riki Takasaki	1970 births, Living people, Footballers from Fukuoka Prefecture, Japanese association football goalkeepers
Euller	1971 births, Living people, Brazilian footballers
Luiz Carlos Pereira	1960 births, Living people, Brazilian footballers
Dan Calichman	1968 births, Living people, American footballers
Kerrea Gilbert	1987 births, Living people, English footballers, Sportspeople from London, Premier League players
Vikings	History of Europe, Germanic tribes, Nordic people
Cleveleys	Towns in Lancashire, Wyre
Bank holiday	British culture, Holidays
Blackpool Illuminations	1879 establishments in England, Blackpool, Festivals in the United Kingdom
Blackpool Gazette	19th century establishments in the United Kingdom, Blackpool, Newspapers published in the United Kingdom
Fleetwood Weekly News	Newspapers published in the United Kingdom
Standard gauge	Rail transport
The Circus Surprise	Children's books, 2001 books, Books by Ralph Fletcher, 20th century American novels, Books with circus settings, English-language novels
Dark Floors	2008 horror movies, Finnish movies, Icelandic movies, Movies about autism
Sonic Boom	Kiss albums, 2009 albums
Hello, Harvest Moon	2003 books, Books by Ralph Fletcher, English-language picture books
The Sandman (book)	Children's books, 2008 books
I Am Wings	1994 books, Works by Ralph Fletcher, 20th-century American poems
Ordinary Things	1997 books, Works by Ralph Fletcher, 20th-century American poems
Buried Alive (book)	1996 books, Poetry
Relatively Speaking (book)	1999 books, Works by Ralph Fletcher, 20th-century American poems
Salvaleón de Higüey	Settlements in Dominican Republic, 1500s establishments in the Spanish Empire
Have You Been to the Beach Lately?	2001 books, Works by Ralph Fletcher, 20th-century American poems
Piracy	Organized crime, Piracy, Robbery
Langkawi	Islands of Malaysia
Mawlid an-Nabi	Islam, Holidays
Kedah	States of Malaysia
Elizabeth Blackburn	1948 births, Living people, Australian biologists, Australian Nobel Prize winners, Order of Australia, People from Hobart, Female scientists, Molecular biologists
IK Sleipner	1903 establishments in Sweden, Swedish football clubs, Norrköping
Palm reading	Magic (paranormal)
Live Free or Die	State mottos of the United States, New Hampshire, 1945 establishments in the United States, 20th-century establishments in New Hampshire
Chopped (TV series)	American reality television series, Food Network, 2009 television series debuts, English-language television programs
Food Network	Food Network, 1993 establishments in the United States, Cable television, 1990s establishments in New York (state)
Appetizer	Appetizers
Entrée	Meals
A Writing Kind of Day	2005 books, Works by Ralph Fletcher, 20th-century American poems
Moving Day (book)	2006 books, Works by Ralph Fletcher, 20th-century American poems
Marshfield Dreams	2005 books
La Romana, Dominican Republic	Settlements in Dominican Republic
Thomas Keneally	1935 births, Living people, Australian novelists, Writers from Sydney, Booker Prize winners
Digital media	Media
Sitka, Alaska	Cities in Alaska, Alaska boroughs, 1799 establishments, 18th-century establishments in the Russian Empire
Wales football team	National football teams, Football in Wales
Loves Park, Illinois	Cities in Illinois
Montezuma, Iowa	Cities in Iowa, County seats in Iowa
Waverly, Kentucky	Cities in Kentucky
Riverton, Iowa	Cities in Iowa
John Obi Mikel	1987 births, Living people, Nigerian footballers
Masaaki Furukawa	1968 births, Living people, Footballers from Chiba Prefecture
Seigo Shimokawa	1975 births, Living people, Footballers from Hyōgo Prefecture, Japanese association football goalkeepers
Stab proof vest	Protective clothing
Young-adult fiction	Genres
Jalal Dabagh	1939 births, Living people, Journalists, Kurdish politicians, Writers
Crystal Cave, Bermuda	Bermuda
Fig Pudding	1995 books, Young adult novels
Rod Laver	1938 births, Australian male tennis players, Australian Open champions, French Open champions, Living people, Sportspeople from Queensland, US Open (tennis) champions, Wimbledon champions, World No. 1 tennis players
Ilta-Sanomat	Newspapers published in Finland
Canadian Women's Hockey League	Ice hockey leagues in Canada
Bread (band)	American rock bands, Folk music groups, Musical groups from Los Angeles, California
Solar panel	Solar energy, Electricity
Hiroki Aratani	1975 births, Living people, Footballers from Toyama Prefecture
Shigetoshi Hasebe	1971 births, Living people, Footballers from Kanagawa Prefecture
Takahiro Yamanishi	1976 births, Living people, Footballers from Shizuoka Prefecture
René Higuita	1966 births, Living people, Colombian footballers, Association football goalkeepers
Masanori Kizawa	1969 births, Living people, Footballers from Ibaraki Prefecture
Takanori Sugeno	1984 births, Living people, Footballers from Saitama Prefecture
Kalmar FF	Swedish football clubs, 1910 establishments in Sweden
Emperor's Cup	Football in Japan, Football competitions
J.League Cup	Football in Japan, Football competitions
Sef Vergoossen	1947 births, Living people, Dutch football managers, Eredivisie managers, Sportspeople from Limburg (Netherlands)
Kazumichi Takagi	1980 births, Living people, Footballers from Shiga Prefecture, Japan international footballers, J1 League players, J2 League players, Shimizu S-Pulse players, Vissel Kobe players, Gamba Osaka players, Oita Trinita players, FC Gifu players, Júbilo Iwata players
Peter Luccin	1979 births, Living people, French footballers, Sportspeople from Marseille
Horim Museum	Museums in South Korea, Buildings and structures in Seoul
Elinor Ostrom	1933 births, 2012 deaths, American economists, American Nobel Prize winners, Cancer deaths in the United States, Deaths from pancreatic cancer, Disease-related deaths in Indiana, Scientists from Los Angeles, California
Spider Boy (novel)	1997 books, Young adult novels
Sugababes	1998 establishments in England, 1990s British music groups, 2000s British music groups, 2010s British music groups, British girl groups, English R&B bands, English pop music groups, Musical groups established in 1998, Musical groups from London
John Allen Muhammad	1960 births, 2009 deaths, African-American military personnel, American Muslims, American spree killers, American terrorists, Executed American serial killers, Muslim terrorists, People executed by lethal injection, People from Louisiana
Victor Silvester	1900 births, 1978 deaths, Dance music, English autobiographers, English dancers, Musicians from Middlesex
Vaginoplasty	Female reproductive system, Surgery, LGBT
World Dance Council	Dance
Luciano Galletti	1980 births, Living people, Argentine footballers
Mastectomy	Cancer treatment, Breasts
Keisuke Ota (born in 1979)	1979 births, Living people, Footballers from Shizuoka Prefecture
Tomoji Eguchi	1977 births, Living people, Footballers from Hyōgo Prefecture
Blackpool Dance Festival	Dance
Åtvidabergs FF	1907 establishments in Sweden, Swedish football clubs
Raúl García	1986 births, Living people, Spanish footballers, People from Pamplona
Yoshifumi Yamada	1981 births, Living people, Footballers from Fukuoka Prefecture
Michiaki Kakimoto	1977 births, Living people, Footballers from Fukuoka Prefecture
Hiroyuki Ishida (born in 1981)	1981 births, Living people, Footballers from Fukuoka Prefecture
Yoon Jong-hwan	1973 births, Living people, South Korean footballers, South Korean football managers
Oleh Protasov	1964 births, Living people, Ukrainian footballers, Ukrainian football managers
Stirling Albion F.C.	Scottish football clubs, 1945 establishments, 1940s establishments in Scotland
Bloody Mary (folklore)	Folklore, American folklore
Ludwig Beck	1880 births, 1944 deaths, Executed German people, German generals of World War II, People executed by firearm, People from Wiesbaden, Victims of Nazism
Otto Liman von Sanders	1855 births, 1929 deaths, German generals, German military personnel of World War I
Scissor Sisters	Musical groups established in 2001, 2000s American music groups, 2010s American music groups, American pop music groups, American rock bands, Brit Award winners, LGBT-themed musical groups, Musical groups from New York City
Flying Solo	1998 books, Young adult novels
Gothika	2003 horror movies, 2000s supernatural movies, 2000s thriller movies, American horror movies, American supernatural movies, American thriller movies, English-language movies, Ghost movies
SPIHT	Algorithms
Korean barbecue	Korean food
Stede Bonnet	1680s births, 1718 deaths, Barbadian people, People executed by hanging, Pirates
Tommy Trouble and the Magic Marble	2000 books, Children's books, Books by Ralph Fletcher, 20th century American novels, English-language novels
Hwajeong Museum	Museums in South Korea
National Palace Museum of Korea	National museums in South Korea
National Folk Museum of Korea	National museums in South Korea
Rutherford College	Schools in New Zealand, Auckland, 1961 establishments, 1960s establishments in New Zealand
New Japan Pro Wrestling	1972 establishments in Asia, Professional wrestling promotions, Sport in Japan, 1970s establishments in Japan
Patrick Kane	1988 births, American ice hockey players, Art Ross Trophy winners, Calder Trophy winners, Chicago Blackhawks players, Conn Smythe Trophy winners, Hart Memorial Trophy winners, Living people, Medalists at the 2010 Winter Olympics, Sportspeople from Buffalo, New York, Stanley Cup champions, United States Hockey League players, Ontario Hockey League players
Ichthyophthirius multifiliis	Fish, Parasites
Kazuyoshi Matsunaga	1977 births, Living people, Footballers from Oita Prefecture
Adhemar (footballer)	1972 births, Living people, Brazilian footballers
Arno van Zwam	1969 births, Living people, Association football goalkeepers, Dutch footballers, Sportspeople from Gelderland
José Antonio García Calvo	1975 births, Living people, Spanish footballers, Sportspeople from Madrid
Juan Velasco Damas	1977 births, Living people, Spanish footballers
Aflac	American financial companies, Insurance companies, Companies listed on the New York Stock Exchange, Columbus, Georgia
State Farm Insurance	1922 establishments in the United States, American financial companies, Insurance companies
La Vega, Dominican Republic	Settlements in Dominican Republic, 14th-century establishments in North America, 1494 establishments
Arkansas Razorbacks	Sports in the United States, Fayetteville, Arkansas
Uncle Daddy	2001 books, Young adult novels
The One O'Clock Chop	2007 books, Young adult novels
Walking Trees	1990 books
Union County, Florida	Florida counties, 1921 establishments in Florida
Pneumothorax	Medical emergencies, Respiratory system
Electroluminescence	Electricity
Daughter of the Forest	1999 books, Fantasy books
Sonic Adventure	1998 video games, 3D platform games, Windows games, Dreamcast games, Sonic the Hedgehog games
Hyracotherium	Eocene, Horses
Hurricane Keith	2000 Atlantic hurricane season, 2000s disasters in North America, 2000s in Belize, 2000s in Mexico, 2000 in North America, Category 4 Atlantic hurricanes
Degree (mathematics)	Mathematics
Polynomial root	Algebra
Monster group	Mathematics
Iowa Hawkeyes	Colleges and universities in Iowa, Big Ten Conference
The Supremes	1959 establishments in the United States, 1977 disestablishments in the United States, 1950s American music groups, 1960s American music groups, 1970s American music groups, African-American musical groups, American girl groups, American R&B bands, Soul bands, Disco groups, Musical groups disestablished in the 1970s, Musical groups established in 1959, Musical groups from Detroit, Michigan, Musical trios, 1950s establishments in Michigan, 20th-century disestablishments in Michigan
Yvon of the Yukon	Canadian animated television series, 1999 television series debuts, 2005 television series endings, 1999 establishments in Canada, 2000s disestablishments in Canada
List of Museums in Seoul	Lists of museums, Buildings and structures in Seoul, South Korea-related lists
Shigemu Ueda	1965 births, Living people, Footballers from Kyoto, Japanese football managers
Daiki Fukagawa	1980 births, Living people, Footballers from Fukuoka Prefecture
Yu Kawamura	1980 births, Living people, Footballers from Shizuoka Prefecture
Stranraer F.C.	Scottish football clubs
Nozomu Kato	1969 births, Living people, Footballers from Miyagi Prefecture
Masayuki Omori	1976 births, Living people, Footballers from Saitama Prefecture
Mitsuru Nagata	1983 births, Living people, Footballers from Shizuoka Prefecture, Japan international footballers, J1 League players, J2 League players, Kashiwa Reysol players, Albirex Niigata players, Urawa Red Diamonds players, Tokyo Verdy players
Berwick Rangers F.C.	Scottish football clubs, 1881 establishments in the United Kingdom, 1880s establishments in Scotland
Paper Mario	Mario roleplaying games, 2000 video games, 2001 video games, Nintendo 64 games, Virtual Console games
I'm Not Alone	2009 songs, Calvin Harris songs, Dance songs, Pop songs
Check and checkmate	Chess
Tacoma, Washington	Tacoma, Washington, County seats in Washington, 1875 establishments in the United States, 19th-century establishments in Washington (state)
Mixed government	Forms of government
Marguerite daisy	Asteraceae
Son of the Shadows	2000 books, Fantasy books
Axis of rotation	Celestial mechanics, Geometry
Orbital plane (astronomy)	Orbits
Guadalajara	Guadalajara, Capital cities in Mexico, 1540s establishments in Mexico, 1542 establishments
Grouper	Perciformes
Orion's Belt	Constellations
Malcolm Turnbull	1954 births, Living people, Alumni of the University of Oxford, Australian Roman Catholics, Australian lawyers, Leaders of the Opposition (Australia), Liberal Party of Australia politicians, Politicians from Sydney, Prime Ministers of Australia, Republicans
The Green Mile (movie)	1999 crime movies, 1999 drama movies, 1990s crime drama movies, 1990s fantasy movies, American crime drama movies, American fantasy movies, American prison movies, English-language movies, Movies based on books, Movies set in Louisiana, Movies set in the 1930s, People's Choice Award winners, Warner Bros. movies
Billy Mays	American television personalities, Cardiovascular disease deaths in Florida, Deaths from myocardial infarction, People from Pennsylvania, People from Tampa, Florida, 1958 births, 2009 deaths
E-Type	Swedish musicians, 1965 births, Living people
Jason Derulo	1989 births, Living people, African-American singers, American R&B musicians, Singers from Florida, People from Miramar, Florida
Segarcea	Towns in Romania
Tender is the Night	20th century American novels, 1934 books, English-language novels, Books by F. Scott Fitzgerald
Under the Volcano	Novels, 1947 books
Yuichi Mizutani	1980 births, Living people, Footballers from Tokyo Prefecture
Yoshito Terakawa	1974 births, Living people, Footballers from Hyōgo Prefecture
Yohei Sato	1972 births, Living people, Footballers from Miyagi Prefecture
Yosuke Nozawa	1979 births, Living people, Footballers from Shizuoka Prefecture, Matsumoto Yamaga FC players
Yosuke Fujigaya	1981 births, Living people, Footballers from Shizuoka Prefecture
Naoki Matsuyo	1974 births, Living people, Footballers from Nara Prefecture
This Side of Paradise	20th century American novels, 1920s books, Books by F. Scott Fitzgerald
Manute Bol	Sudanese people, 1962 births, 2010 deaths, Deaths from renal failure, Golden State Warriors players, Miami Heat players, Philadelphia 76ers players, Washington Bullets players
Deep Dish	Iranian entertainers, Musical groups from Washington, D.C., Electronic music bands, DJs, Musical groups established in 1992, 1992 establishments in the United States, 1990s establishments in Washington, D.C.
Head scarf	Headgear, Islamic dress
Fishing trawler	Ship types
Venetia Burney	1918 births, 2009 deaths, British people
United Kingdom Climate Change Programme	Environmental organizations, Organisations based in the United Kingdom, Climate change, 2000 establishments in the United Kingdom
Clyde Tombaugh	1906 births, 1997 deaths, American astronomers, Scientists from Illinois
Venera	Soviet spacecraft, Venus (planet)
Luna 2	Soviet spacecraft, Moon, 1959 in the Soviet Union
Cadet Forces Medal	Orders, decorations, and medals of the United Kingdom
Jean Chrétien	1934 births, Living people, Order of Canada, Order of Merit, Politicians from Quebec, Members of the House of Commons of Canada from Quebec, Privy Councillors (Canada), Deputy Prime Ministers of Canada, Leaders of the Opposition (Canada), Canadian Queen's Counsel
Rakesh Sharma	1949 births, Living people, Indian scientists, Cosmonauts
Jonathan Toews	1988 births, Canadian ice hockey centres, Canadian Olympic gold medalists, Chicago Blackhawks players, Conn Smythe Trophy winners, Ice hockey people from Manitoba, Living people, Sportspeople from Winnipeg, Stanley Cup champions
Sport coat	Tops (clothing)
Monorail	Rail transport
Zellers	1931 establishments in North America, Companies of Canada, Department stores, 1930s establishments in Canada
Lora, Khyber Pakhtunkhwa	Union Councils of Abbottabad District
Toru Irie	1977 births, Living people, Footballers from Shizuoka Prefecture
Mitsuteru Watanabe	1974 births, Living people, Footballers from Shizuoka Prefecture
Kenji Koyama	1972 births, Living people, Footballers from Hiroshima Prefecture, Japanese association football goalkeepers, People from Hiroshima
Yasunori Takada	1979 births, Living people, Footballers from Kanagawa Prefecture
Tetsuro Uki	1971 births, Living people, Footballers from Chiba Prefecture
Keisuke Kurihara	1973 births, Living people, Footballers from Tokyo Prefecture
Kjell Bratli	1948 births, Living people, European military people, Norwegian writers
Remembrance of Things Past	French novels, 20th century books
David Mellor	1949 births, Living people, Former Conservative MPs (UK), Former members of the British House of Commons for English constituencies
Thomas Raber	1972 births, Living people, Austrian composers, Songwriters, Austrian musicians
Wait Until Dark	1967 thriller movies, American thriller movies, English-language movies, Movies based on plays, Movies directed by Terence Young
Indian Air Force	Military of India, Military aviation, 1932 establishments in India, 1932 establishments in the United Kingdom, 1950 disestablishments, 1950s disestablishments in India, 1950s disestablishments in the United Kingdom
Patiala	Settlements in Punjab, India, Cities in India
Don Walsh	Oceanographers, 1931 births, Living people, Scientists from Berkeley, California, American explorers
Laika	Spaceflight, Dogs, Animal rights, Individual dogs, 1950s in the Soviet Union
Jim Lovell	1928 births, Living people, American astronauts, Time People of the Year, Apollo astronauts
Mahavira	6th century BC births, 527 BC deaths, Indian religious leaders, Nonviolence advocates
Civil law	Types of law, Legal terms
Hurricane Klaus	Category 1 Atlantic hurricanes
I'm from Barcelona	Indie rock bands, Swedish musical groups
Sherwood Anderson	Writers from Ohio, 1876 births, 1941 deaths
Selectivity (electronic)	Electricity
Push It to the Limit	1983 songs
We Are All Made of Stars	2002 songs
Castles in the Sky	2001 songs
3 A.M.	2009 songs, Eminem songs
Dieter Rams	1932 births, Living people, German architects, People from Wiesbaden
Seamus Heaney	1939 births, 2013 deaths, Deaths from stroke, Irish poets, Irish  Nobel Prize winners
Tomoyuki Yoshino	1980 births, Living people, Footballers from Tokyo Prefecture
Takuya Jinno	1970 births, Living people, Footballers from Saitama Prefecture, J1 League players, J2 League players, Japan Soccer League players, Yokohama F. Marinos players, Vissel Kobe players, Oita Trinita players, FC Tokyo players, Yokohama FC players, 1992 AFC Asian Cup players, AFC Asian Cup-winning players
Keiji Ishizuka	1974 births, Living people, Footballers from Kyoto
Anton-Babinski syndrome	Neurology
Half-staff	Flags
Palm Springs, California	Spa towns in the United States, Cities in California, Settlements in Riverside County, California
Navier–Stokes equations	Partial differential equations
List of surnames in Russia	Russian-language surnames, Russia-related lists
Mary Toft	1700s births, 1763 deaths, People from Surrey, Hoaxes
San Fernando de Monte Cristi	Settlements in Dominican Republic, 1530s establishments in North America, 1500s establishments in the Spanish Empire, 1533 establishments
Belarusians	Slavic peoples, Belarusian people
Douglas MacArthur	1880 births, 1964 deaths, American military personnel of the Korean War, American military personnel of World War I, American military personnel of World War II, Deaths from cirrhosis, Disease-related deaths in Washington, D.C., Honorary Knights Grand Cross of the Order of the Bath, People from Little Rock, Arkansas, United States Army Medal of Honor recipients
Twitter	2006 establishments in the United States, Companies based in San Francisco, Social networking, Technology, Companies of the United States, Websites
Microblog	Internet
Clarkson University	Colleges and universities in New York, 1896 establishments in the United States, 1890s establishments in New York (state)
Omegle	2009 establishments, Social networking
Kowloon Walled City	Hong Kong, Shanty towns
Lunch	Meals
Yoshihiro Nishida	1973 births, Living people, Footballers from Ehime Prefecture
Koji Maeda	1969 births, Living people, Footballers from Kagoshima Prefecture
Vincent Kompany	1986 births, Living people, Belgian footballers, Belgian football managers, People from Brussels-Capital Region, Manchester City F.C. players
Takeo Harada	1971 births, Living people, Footballers from Saga Prefecture
Gerard Piqué	1987 births, Living people, Manchester United F.C. players, Spanish footballers, Sportspeople from Barcelona
Osamu Umeyama	1973 births, Living people, Footballers from Saitama Prefecture
Takanori Nunobe	1973 births, Living people, Footballers from Osaka Prefecture, People from Osaka
Pauleta	1973 births, Living people, Portuguese footballers
Tomoaki Komorida	1981 births, Living people, Footballers from Kumamoto Prefecture
Milan Kundera	Czechoslovak writers, 1929 births, Living people
Trisomy	Trisomies
Toshiro Tomochika	1975 births, Living people, Footballers from Ehime Prefecture
Makoto Segawa	1974 births, Living people, Footballers from Miyagi Prefecture
Yoshihito Yamaji	1971 births, Living people, Footballers from Miyagi Prefecture
Östers IF	1930 establishments in Sweden, Swedish football clubs, Växjö
Yasunobu Chiba	1971 births, Living people, Footballers from Miyagi Prefecture
Lorenzo Staelens	1964 births, Living people, Belgian footballers, Belgian football managers
True Blood	2008 American television series debuts, 2014 American television series endings, 2000s American television series, 2010s American television series, American drama television series, American horror television series, HBO television series, Louisiana in fiction, English-language television programs
Eyal Berkovic	1972 births, Living people, Israeli football managers, Israeli footballers, Jewish Israeli sportspeople
Alexander Skarsgård	1976 births, Living people, Child actors, Actors from Stockholm, Swedish movie actors, Swedish television actors, Swedish voice actors
Ian Wallace	1919 births, 2009 deaths, Actors from London, Bass-baritones, British autobiographers, English stage actors, Singers from London
Bass-baritone	Vocal ranges, Opera terminology, Bass-baritones
Photopsin	Physiology
Telus	Telephone companies, Technology companies of Canada
Brandon Roy	1984 births, African-American basketball players, Living people, Portland Trail Blazers players, Sportspeople from Seattle, Washington, American basketball players
Alexander Ovechkin	1985 births, Art Ross Trophy winners, Calder Trophy winners, Conn Smythe Trophy winners, Hart Memorial Trophy winners, Living people, Rocket Richard Trophy winners, Russian ice hockey players, Sportspeople from Moscow, Stanley Cup champions, Washington Capitals players
WWE SmackDown vs. Raw 2010	2009 video games, PlayStation 2 games, PlayStation 3 games, PlayStation Portable games, Nintendo DS games, Wii games, Xbox 360 games, WWE video game series, Mobile games, THQ games
Minimum spanning tree	Combinatorial optimization
WWE European Championship	World Wrestling Entertainment championships, 1997 establishments, 2002 disestablishments
Transgender Pride flag	Transgender, Flags
Christian Corrêa Dionisio	1975 births, Living people, Brazilian footballers, People from Porto Alegre
Kohei Hayashi	1978 births, Living people, Footballers from Yamaguchi Prefecture
Haruki Seto	1978 births, Living people, Footballers from Toyama Prefecture
Yukihiro Yamase	1984 births, Living people, Footballers from Hokkaidō Prefecture
Kenta Tokushige	1984 births, Living people, Footballers from Kagoshima Prefecture
Tomoyasu Ando	1974 births, Living people, Footballers from Shizuoka Prefecture
Cop Killer (song)	1992 songs, Obscenity controversies, Police misconduct, Rap songs
Insane Clown Posse	Musical groups established in 1991, Insane Clown Posse, Musical groups from Detroit, Michigan, Hip hop bands
Attic	Construction
6teen	2004 American television series debuts, 2010 television series endings, American animated television series, Canadian animated television series, French television series, Sitcoms, 2004 Canadian television series debuts, 2004 establishments in France, 2010 disestablishments in the United States, 2010s disestablishments in Canada, 2010 disestablishments in Europe, 21st century disestablishments in France, English-language television programs
Airline (UK TV series)	1998 British television series debuts, 2006 British television series endings, 1990s British television series, 2000s British television series, British documentaries, English-language television programs
Telepopmusik	Musical groups
Wavelet	Algebra
Rodney Anoa'i	1966 births, 2000 deaths, American professional wrestlers, Former WWE wrestlers, Sportspeople from San Francisco, WWE Hall of Fame, Actors, Deaths from myocardial infarction
Minnesota North Stars	Defunct National Hockey League teams, 1967 establishments in the United States, 1960s establishments in Minnesota, 1993 disestablishments in the United States
Superfluidity	Physics
Princely state	British India, Indian princely states, Pakistani princely states
Wookiee	Fictional animals, Fictional characters introduced in 1977, Star Wars species
Monte Plata	Settlements in Dominican Republic, 1606 establishments, 1600s establishments in North America, 17th-century establishments in the Spanish Empire
Epistulae morales ad Lucillium	Works of philosophy
Yaniv Katan	1981 births, Living people, Israeli footballers, Jewish Israeli sportspeople
Sorbet	Desserts, Azerbaijani food, Iranian food, Middle Eastern foods
Ken Nelson (British record producer)	1959 births, British record producers, Grammy Award winners, Living people, Musicians from Liverpool
Homecoming (Kanye West song)	Kanye West songs, 2008 songs
Instrumentation (music)	Musical terminology
Lead single	Songs
Jonny Buckland	1977 births, Living people, Alumni of University College London, Coldplay, English guitarists, Rock musicians
Will Champion	1978 births, Living people, Coldplay, English drummers, People from Southampton
Trouble (Coldplay song)	2000 songs, Coldplay songs
Epping tube station	Central Line stations, Transport in Epping Forest, London Travelcard zone 6, 1865 establishments in the United Kingdom
Trichome	Plant anatomy
Shawn Daivari	1984 births, American professional wrestlers, Former WWE wrestlers, Living people, People from Katy, Texas, Sportspeople from Detroit, Michigan, Professional wrestlers, Sportspeople from Minneapolis, Minnesota, Sportspeople from Texas, Total Nonstop Action Wrestling alumni
Shinji Jojo	1977 births, Living people, Footballers from Tokyo Prefecture
James Vaughan	1988 births, Living people, Black British sportspeople, English footballers, Sportspeople from Birmingham
Yusuke Sato	1977 births, Living people, Footballers from Saitama Prefecture
Satoshi Yokoyama	1980 births, Living people, Footballers from Yamaguchi Prefecture
Yoshiyuki Takemoto	1973 births, Living people, Footballers from Kanagawa Prefecture
Saúl Martínez	1976 births, Living people, Honduran footballers
Pedro Rocha	1942 births, 2013 deaths, Deaths from stomach cancer, Uruguayan footballers, Uruguayan football managers, Coritiba Foot Ball Club players
Hapoel Tel Aviv F.C.	Israeli football clubs, Tel Aviv, 1926 establishments in Asia, 1920s establishments in Israel
Hugo de León	1958 births, Living people, Uruguayan footballers
Quantum computer	Computers, Quantum mechanics
Israeli Premier League	Football leagues, Football in Israel, 1999 establishments in Asia, 1990s establishments in Israel
British Rail Class 379	British Rail electric multiple units, Bombardier multiple units, Future British rail vehicles
Shuta Takahashi	1983 births, Living people, Footballers from Tokyo Prefecture
Nixon Perea	1973 births, Living people, Colombian footballers
Hiroyuki Tazawa	1978 births, Living people, Footballers from Kanagawa Prefecture
Brynäs IF FK	Swedish football clubs, 1912 establishments in Sweden
Kazuyoshi Mikami	1975 births, Living people, Footballers from Saitama Prefecture
Yasunari Hiraoka	1972 births, Living people, Footballers from Tochigi Prefecture
Naoya Saeki	1977 births, Living people, Footballers from Tokyo Prefecture
Wavelet transform	Calculus
Gladys Knight	1944 births, Living people, Actors from Atlanta, Georgia, African American actors, African-American singers, American movie actors, American soul musicians, American television actors, Grammy Award winners, Singers from Atlanta, Georgia
Prank phone call	Pranks
Push (movie)	2009 science fiction movies, 2009 thriller movies, 2000s action movies, American action movies, American science fiction movies, American thriller movies, English-language movies, American superhero movies
Roman Urdu	Urdu language
Koji Ezumi	1978 births, Living people, Footballers from Shimane Prefecture
Tatsuma Yoshida	1974 births, Living people, Footballers from Chiba Prefecture
Toru Araiba	1979 births, Living people, Footballers from Osaka Prefecture
Shinya Kato	1980 births, Living people, Footballers from Ibaraki Prefecture, Japanese association football goalkeepers
Yuzo Funakoshi	1977 births, Living people, Footballers from Hyōgo Prefecture
Masanobu Matsunami	1974 births, Living people, Footballers from Gifu Prefecture
Arata Kodama	1982 births, Living people, Footballers from Osaka Prefecture, People from Osaka
Hitoshi Morishita	1972 births, Living people, Footballers from Wakayama Prefecture
Takahiro Endo	1968 births, Living people, Footballers from Shizuoka Prefecture
Naoki Hiraoka	1973 births, Living people, Footballers from Osaka Prefecture, People from Osaka
Teppei Nishiyama	1975 births, Living people, Footballers from Chiba Prefecture
Takashi Miki	1978 births, Living people, Footballers from Kanagawa Prefecture
Quadrature mirror filter	Digital signal processing, Computer science
Neil Aspinall	1941 births, 2008 deaths, British businesspeople, Cancer deaths in New York City, Deaths from lung cancer, People from Liverpool, The Beatles
Jean Balukas	1959 births, Living people, Sportspeople from New York
New York State Route 308	Roads in New York
Grand Central Terminal	1871 establishments in the United States, 1870s establishments in New York (state), Rail transport in the United States, Transport in New York City, Railway stations in the United States, Buildings and structures in Manhattan, New York City Designated Landmarks
Samuel P. Taylor State Park	State parks in the United States, Marin County, California, 1945 establishments in the United States, 1940s establishments in California
Pedernales, Dominican Republic	Settlements in Dominican Republic, 1927 establishments in North America, 20th-century establishments in the Dominican Republic
Mohican	Native American
Heaviside Function	Mathematics
Yasushi Kita	1978 births, Living people, Footballers from Osaka Prefecture, People from Osaka
Hiroki Kobayashi	1977 births, Living people, Footballers from Shizuoka Prefecture
Tomohiko Ito	1978 births, Living people, Footballers from Osaka Prefecture, Japanese association football goalkeepers, People from Osaka
Descriptive statistics	Statistics
Inference (statistics)	Statistics
Ânderson Lima	1973 births, Living people, Brazilian footballers
Silvio Spann	1981 births, Living people, Trinidad and Tobago footballers
Amir Karič	1973 births, Living people, Slovenian footballers, Crystal Palace F.C. players
2007 United Kingdom floods	2007 in the United Kingdom, Floods, Disasters in the United Kingdom
Anto Drobnjak	1968 births, Living people, Yugoslavian people, European footballers, Montenegrin footballers, Serbian footballers
Ryuichi Sugiyama	1941 births, Living people, Footballers from Shizuoka Prefecture, Japan international footballers, Japan Soccer League players, Urawa Red Diamonds players, Footballers at the 1964 Summer Olympics, Footballers at the 1968 Summer Olympics, Olympic medalists in football, Japanese Olympic bronze medalists, Medalists at the 1968 Summer Olympics
Gallup's List of Widely Admired People	Lists of people
Flynn effect	Intelligence
Billy Graham	1918 births, 2018 deaths, American Baptists, Christian ministers, Christian religious leaders, Christian writers, Deaths from Parkinson's disease, Gospel Music Hall of Fame inductees, Honorary Knights Commander of the Order of the British Empire, People with cancer, Southern Baptist Convention, Television evangelists, Writers from Charlotte, North Carolina
Daubechies wavelet	Mathematics, Computer science
Straight pool	Cue sports
General intelligence factor	Intelligence
White-tailed spider	Araneomorphae
Misa Telefoni Retzlaff	1952 births, Living people, Oceanic politicians, Samoan people
Machine Shop Recordings	American record labels
U.S. Route 9	U.S. Highways
Southampton Common	Southampton
Thomas Quasthoff	Bass-baritones, Grammy Award winners, 1959 births, Living people, Autobiographers, German singers
Humanitarianism	Ethics, Society, Altruism
Tony Atlas	1969 births, American professional wrestlers, Former WWE wrestlers, Living people, People from Roanoke, Virginia, Sportspeople from Virginia, WWE Hall of Fame
Lester B. Pearson	1897 births, 1972 deaths, Deaths from liver cancer, Canadian ice hockey players, Presidents of the United Nations General Assembly, Canadian Nobel Prize winners, Ice hockey people from Ontario, Officers of the Order of the British Empire, Order of Canada, People from Toronto, Privy Councillors (Canada), Leaders of the Opposition (Canada)
Red Bellied Black Snake	Elapidae
Fun with Dick and Jane (2005 movie)	2005 comedy movies, 2005 crime movies, 2000s criminal comedy movies, American criminal comedy movies, American movie remakes, English-language movies, Movies directed by Dean Parisot
Luc Bourdon	1987 births, 2008 deaths, American Hockey League players, Canadian ice hockey defencemen, Cape Breton Screaming Eagles players, Ice hockey people from New Brunswick, Moncton Wildcats players, Road accident deaths, Val-d'Or Foreurs players, Vancouver Canucks players
Liu Xiang	Chinese sportspeople, 1983 births, Living people, Olympic gold medalists
Yoshiaki Sato	1969 births, Living people, Footballers from Osaka Prefecture, Japan international footballers, J1 League players, Gamba Osaka players, Urawa Red Diamonds players, Kyoto Sanga FC players
Giovani dos Santos	1989 births, Living people, Mexican footballers, People from Monterrey
Yugoslav First League	Football leagues, Yugoslavia, Defunct sports leagues, 1923 establishments in Europe, 1992 disestablishments in Europe
Johan Vonlanthen	1986 births, Living people, Swiss footballers
John Aloisi	1976 births, Living people, Australian footballers, People from Adelaide, Sportspeople from South Australia
Masakazu Washida	1978 births, Living people, Footballers from Fukui Prefecture
Drosophila	Drosophila
Masatoshi Matsuda	1980 births, Living people, Footballers from Chiba Prefecture
Anderson Luís de Abreu Oliveira	1988 births, Living people, Brazilian footballers, People from Porto Alegre
Gabriel Fernández	1983 births, Living people, Spanish footballers, Sportspeople from Madrid
Kyohei Yamagata	1981 births, Living people, Footballers from Fukuoka Prefecture
Tatsunori Yamagata	1983 births, Living people, Footballers from Fukuoka Prefecture, Avispa Fukuoka players
Urby Emanuelson	1986 births, Living people, Dutch footballers, Sportspeople from Amsterdam
Tetsuya Okayama	1973 births, Living people, Footballers from Aichi Prefecture
Kisho Yano	1984 births, Living people, Footballers from Shizuoka Prefecture, Japan international footballers, J1 League players, J2 League players, Kashiwa Reysol players, Albirex Niigata players, Nagoya Grampus players, Tochigi SC players, 2010 FIFA World Cup players
Tomohiro Wanami	1980 births, Living people, Footballers from Mie Prefecture
Takeshi Watanabe	1972 births, Living people, Footballers from Shizuoka Prefecture, Japan international footballers, J1 League players, Kashiwa Reysol players
Tetsuya Yamazaki	1978 births, Living people, Footballers from Shizuoka Prefecture
Takaaki Tokushige	1975 births, Living people, Footballers from Kagoshima Prefecture
Vasily Jakovlevich Zinger	Vasily Zinger, Russian mathematicians, Russian philosophers, Russian botanists, 1836 births, 1907 deaths
1967–68 NHL season	1967 in North America, 1968 in North America

