Sealed lead acid battery	Batteries
Lead acid battery	Batteries
Nicole Jung	1991 births, Living people, South Korean singers, K-pop singers, People from Glendale, California
Nickel cadmium battery	Batteries
Nickel(III) oxide	Nickel compounds, Oxides
Lead(IV) oxide	Lead compounds
Nickel-metal hydride battery	Batteries
Hydrogen chloride	Chlorine compounds
Chemical burn	Medical emergencies, Dermatology
March (music)	Music genres
Roll with It (Oasis song)	1995 songs, Oasis (band) songs
Potassium chlorate	Potassium compounds, Chlorine compounds
The Masterplan (song)	Oasis (band) songs, 1995 songs
Hypochlorite	Chlorine compounds
Chlorate	Chlorine compounds
Armstrong's mixture	Chemicals
Pop gun	Toys
Detonation	Explosives
Perchlorate	Chlorine compounds
Iodide	Iodine compounds
Potassium iodide	Potassium compounds, Iodine compounds
Ammonium perchlorate	Nitrogen compounds, Chlorine compounds
Perchloric acid	Acids, Chlorine compounds
List of number-one singles in 1996 (New Zealand)	Record charts, New Zealand culture, 1996 in music, Lists of songs
Wonderwall (movie)	1968 drama movies, British drama movies
Shareholder	Finance
Straight-eight engine	Motors
Harmonic damper	Motors
Tyndale Bible	Bible versions
Serena Deeb	1986 births, Living people, Female professional wrestlers, American professional wrestlers, Sportspeople from Virginia
The Expendables (2010 movie)	2010 movies, 2010s action movies, American action movies, German movies, Bulgarian movies, Spanish movies, Lionsgate movies, Movies directed by Sylvester Stallone
Charlie St. Cloud (movie)	2010 romance movies, American fantasy movies, American romance movies, English-language movies, Movies based on books
Elephant bird	Flightless birds, Ratites, Fossils, Megafauna
Sami Salo	1974 births, Finnish ice hockey players, Living people, Ottawa Senators players, Vancouver Canucks players, American Hockey League players, Tampa Bay Lightning players, Turku, International Hockey League (1945–2001) players, Swedish Hockey League players, Ice hockey defencemen
Anal bleaching	Cosmetics
Renault R 312	Renault automobiles, 1980s automobiles, 1990s automobiles
Flower (Soundgarden song)	1989 songs
Black Hole Sun	Soundgarden, 1994 songs, Grammy Award winning songs
Jesus Christ Pose	Soundgarden, 1991 songs
165659 Michaelhicks	Asteroids
212929 Satovski	Asteroids
189930 Jeanneherbert	Asteroids
Hunted Down	Soundgarden, 1987 songs
Loud Love	Soundgarden, 1989 songs
Nick Boynton	1974 births, Anaheim Ducks players, Boston Bruins players, Canadian ice hockey defencemen, Chicago Blackhawks players, Ice hockey people from Ontario, Florida Panthers players, Living people, Philadelphia Flyers players, Phoenix Coyotes players, Stanley Cup champions, American Hockey League players, Ontario Hockey League players, Memorial Cup winners
Lennox Lewis	1965 births, Sportspeople from London, Black British sportspeople, British boxers, Canadian boxers, Canadian Olympic gold medalists, English sportspeople, Living people
Renault Grand Prix results	Formula One constructor results, Formula One current
Canadian Tire	Companies of Canada, Companies listed on the Toronto Stock Exchange, 1922 establishments in North America, 1920s establishments in Canada
Tony Hawk's Pro Skater 3	2001 video games, Xbox games, Nintendo GameCube games, PlayStation games, PlayStation 2 games, Windows games, Game Boy Advance games, Tony Hawk video games
Felix Hernandez	1986 births, Living people, Venezuelan baseball players, Seattle Mariners players
Faust (opera)	Operas, Faust
Lucia di Lammermoor	Compositions by Gaetano Donizetti, Operas
Who Feels Love?	2000 songs, Oasis (band) songs
Rigoletto	Operas, Compositions by Giuseppe Verdi
Terror birds	Fossils, Flightless birds
Phorusrhacos	Fossils, Flightless birds
Alessandro Santos	1977 births, Living people, Brazilian-Japanese footballers, Japan international footballers, J1 League players, J2 League players, Shimizu S-Pulse players, Urawa Red Diamonds players, Nagoya Grampus players, Tochigi SC players, FC Gifu players, 2002 FIFA World Cup players, 2006 FIFA World Cup players, 2003 FIFA Confederations Cup players, 2005 FIFA Confederations Cup players
Morning Glory (Oasis song)	1995 songs, Oasis (band) songs, Songs about drugs
The Importance of Being Idle	2005 songs, Oasis (band) songs
List of Oasis band members	Lists of entertainers, Oasis (band), Music-related lists
List of songs recorded by Oasis	Oasis (band) songs, Lists of songs
José Bonaparte	1928 births, 2020 deaths, Paleontologists, Argentine people
Drowning Pool	Alternative metal bands, American heavy metal bands, Post-grunge bands, Musical groups from Texas
Manon	Operas
Desensitized (Drowning Pool album)	Drowning Pool albums, 2004 albums
Achillobator	Dromaeosauridae, Cretaceous dinosaurs
Full Circle (Drowning Pool album)	Drowning Pool albums, 2007 albums
Sinner (Drowning Pool album)	Drowning Pool albums, Debut albums, 2001 albums, Heavy metal albums
Drowning Pool (album)	Drowning Pool albums, 2010 albums
Turn So Cold	2010 songs
Noel Gallagher	1967 births, English rock guitarists, English rock singers, English singer-songwriters, Living people, Musicians from Manchester, Oasis (band)
Future of the Earth	Earth, Geology, Earth sciences
American Library Association	1876 establishments in the United States, Educational organizations, Libraries in the United States, Non-profit organizations of the United States
B.o.B	American rap musicians from North Carolina, Singers from North Carolina, 1988 births, Living people
Pontiac Firebird	1960s automobiles, 1970s automobiles, 1980s automobiles, 1990s automobiles, 2000s automobiles, Pontiac automobiles
Craig Newmark	1952 births, Living people, American Jews, People from New Jersey, American bloggers
Dromornis	Fossils, Flightless birds, Anseriformes
Beatrix Potter	1866 births, 1943 deaths, Beatrix Potter, British children's writers, British illustrators, Cardiovascular disease deaths in England, Deaths from pneumonia, Infectious disease deaths in England, Writers from London
Justin Gabriel	1981 births, Living people, People from Cape Town, South African sportspeople, White South African people
Gastornis	Fossils, Flightless birds
Lead(II) oxide	Lead compounds, Oxides
Yoshihiro Tajiri	1970 births, Living people, Former WWE wrestlers, Japanese professional wrestlers, People from Kumamoto Prefecture
Lead(II,IV) oxide	Lead compounds, Oxides
Flightless birds	Flightless birds
Monster Energy	Drinks
Peter Rabbit	Beatrix Potter, Characters in written fiction, Fictional hares and rabbits
Bouldering	Rock climbing
The Tale of Peter Rabbit	Beatrix Potter, 1900s books, 1902 works, Children's books, Children's literature, Children's picture books, English-language picture books, Fantasy books
1979 (song)	1996 songs
Peugeot 407	Peugeot automobiles, 2000s automobiles, 2010s automobiles
Volkswagen Caddy	Vans
SummerSlam (2010)	2010 in professional wrestling, SummerSlam, Sports in Los Angeles, 2010 in American television, 2010s in Los Angeles, California, August events
Two of Us (song)	The Beatles songs, 1970 songs
Dig a Pony	The Beatles songs, 1970 songs
Not Afraid	2010 songs, Eminem songs
Recovery	2010 albums, Eminem albums
Joan Sutherland	Australian singers, Musicians from Sydney, Sopranos, Opera singers, Deaths from heart failure, 1926 births, 2010 deaths, Australian of the Year Award winners, Cardiovascular disease deaths in Switzerland, Grammy Award winners, Knights and Dames Commander of the Order of the British Empire, Order of Australia, Order of Merit
Love the Way You Lie	2010 songs, Eminem songs, Rihanna songs, Hip hop songs, R&B songs
Han Seung-yeon	1988 births, Living people, K-pop singers, South Korean singers, People from Seoul
Time Flies... 1994–2009	Oasis (band) albums, 2010 albums
Chicken Huntin'	Insane Clown Posse songs, 1995 songs
Halls of Illusions	Insane Clown Posse songs, 1997 songs
Little ground squirrel	Squirrels, Mammals of Asia, Mammals of Europe
Montserrat Caballé	1933 births, 2018 deaths, Infectious disease deaths in Spain, Musicians from Barcelona, Spanish opera singers, Order of Merit of the Federal Republic of Germany, Sopranos, Spanish singers
Maria Callas	1923 births, 1977 deaths, Cardiovascular disease deaths in France, Deaths from myocardial infarction, Greek singers, Italian opera singers, Singers from New York City, Sopranos
Ultramarine	Pigments, Materials
The Last Airbender (video game)	Avatar: The Last Airbender games, Nintendo DS games, Wii games, THQ games, Video games based on movies
Nicktoons Nitro	2009 video games, Arcade games, Avatar: The Last Airbender games
Lead carbonate	Lead compounds, Carbonates
Lead nitrate	Nitrogen compounds, Lead compounds
Lead(II) acetate	Lead compounds
Acetate	Chemicals
Beverly Sills	1929 births, 2007 deaths, Sopranos, Singers from New York City, American opera singers
Car battery	Physical chemistry, Auto parts, Batteries
Barium sulfate	Sulfur compounds, Barium compounds
Jetix	Disney
PBS Kids	PBS Kids
Anne of the Thousand Days	1969 movies, Historical movies, British movies, Movies based on plays, Academy Award winning movies, Universal Pictures movies, Movies directed by Charles Jarrott
Dpkg	Debian
Package management system	Computers, Software
Molde FK	Norwegian football clubs, 1911 establishments in Europe, 1910s establishments in Norway
Christian Gauseth	1984 births, Living people, Norwegian footballers
Invasive species	Ecology, Pests
Habitat destruction	Habitats
Torpsbruk	Settlements in Kronoberg County
Divorce (movie)	1945 movies, 1940s drama movies, American drama movies, English-language movies, Movies about divorce, Movies directed by William Nigh
Shame (Alvtegen novel)	2005 books
Japanese Grand Prix	Formula One Grands Prix
James Maritato	1972 births, Living people, Former WWE wrestlers, American professional wrestlers, People from Sicily
The Legend of Korra	Nickelodeon television series, Avatar: The Last Airbender, English-language television programs, 2012 television series debuts, 2014 television series endings
Marley & Me (movie)	2008 comedy-drama movies, Boca Raton, Florida, American comedy-drama movies, English-language movies, Movies about animals, Movies based on books, Movies set in Florida, 20th Century Fox movies
Gordon Campbell	1948 births, Premiers of British Columbia, Living people, Mayors of Vancouver
Dev Patel	Actors from London, English movie actors, English television actors, 1990 births, Living people
Noah Ringer	American movie actors, actors from Dallas, Texas, 1996 births, Living people
Nicola Peltz	American movie actors, American voice actors, Actors from New York, 1995 births, Living people, People from Rye, New York
Norma (opera)	Operas, Compositions by Vincenzo Bellini
Impact crater	Impact craters, Earth sciences
Pihlajavesi (Saimaa)	Lakes of Finland
All My Loving	The Beatles songs, 1963 songs
Scott McLeod	Living people, Year of birth missing (living people), British rock musicians
(What's the Story) Morning Glory?	Pop songs, 1960s songs, 1995 albums, Oasis (band) albums
Ö3 Austria Top 40	Record charts, Austrian culture, Radio programs, 1968 establishments in Europe, 20th century establishments in Austria
Liam Gallagher	1972 births, English rock singers, English singer-songwriters, Living people, Musicians from Manchester, Oasis (band)
12-inch single	Audio disc
Korean Grand Prix	Formula One Grands Prix
Sodium sulfate	Sodium compounds, Sulfur compounds
Sulfite	Chemistry
Sulfurous acid	Acids, Sulfur compounds
Sodium sulfite	Sodium compounds, Sulfur compounds
Bargh Shiraz F.C.	Iranian football clubs, 1946 establishments in Asia, 1940s establishments in Iran
Brazilian Grand Prix	Formula One Grands Prix
Abu Dhabi Grand Prix	Formula One Grands Prix
Universal design	Design
Hermann Tilke	1954 births, Living people, German people, Formula One people, Formula One circuits
Zach Tyler Eisen	1993 births, Living people, American voice actors, Actors from Stamford, Connecticut
Jack DeSena	1987 births, Living people, American movie actors, American television actors, American voice actors, Actors from Boston, Massachusetts, Actors from San Francisco, People from Irvine, California
Dante Basco	1975 births, Living people, American movie actors, American television actors, American voice actors, Actors from Contra Costa County, California
Mako Iwamatsu	Actors from California, American movie actors, American television actors, American voice actors, Deaths from esophageal cancer, 1933 births, 2006 deaths, Naturalized citizens of the United States
Chevrolet Astro	Chevrolet automobiles, Minivans, 1980s automobiles, 1990s automobiles, 2000s automobiles
Jason Isaacs	Actors from Liverpool, British Jews, English movie actors, English stage actors, English television actors, English voice actors, Jewish actors, 1963 births, Living people
Dodge Durango	Dodge automobiles, Green vehicles, Sport utility vehicles, 1990s automobiles, 2000s automobiles
Dee Bradley Baker	1962 births, Living people, American voice actors, American television actors, American movie actors, Actors from Indiana, People from Bloomington, Indiana
Crawford Wilson	1990 births, Living people, American movie actors, American television actors, American voice actors, Actors from Memphis, Tennessee
Ford Explorer	Ford automobiles, Sport utility vehicles, 1990s automobiles, 2000s automobiles, 2010s automobiles
Dave Filoni	American animators, American movie directors, American screenwriters, writers from Pennsylvania
Lauren MacMullan	1971 births, Living people, Entertainers from London, Annie Award winners
Vera Lynn	People buried in Westminster Abbey, 1917 births, English centenarians, English pop singers, English singers, English singer-songwriters, Knights and Dames Commander of the Order of the British Empire, Living people, Musicians from Essex, 2020 deaths
Matt Hubbard	Year of birth missing (living people), Living people
Chevrolet Malibu	Chevrolet automobiles, 1960s automobiles, 1970s automobiles, 1980s automobiles, 1990s automobiles, 2000s automobiles, 2010s automobiles, Sedans, Coupes
Buick Enclave	Buick automobiles, Sport utility vehicles, 1990s automobiles, 2000s automobiles, 2010s automobiles
Ringmaster (album)	1994 albums, Insane Clown Posse albums
Maserati GranTurismo	Maserati automobiles, Coupes, 2000s automobiles, 2010s automobiles
Mount Fure	Mountains of Japan
Bugatti Veyron	Coupes, 2000s automobiles, 2010s automobiles
Spiderbait	1980s music groups, 1990s music groups, 2000s music groups, 2010s music groups, Australian hard rock bands, Post-hardcore bands, Punk bands, Australian alternative rock bands, Musical groups from New South Wales
Sverigetopplistan	Swedish music, Record charts
Bernie Ecclestone	English businesspeople, Formula One people, Sportspeople from Suffolk, 1930 births, Living people
Mitsuharu Misawa	1962 births, 2009 deaths, Deaths in sport, Japanese professional wrestlers, People from Hokkaido
Satoru Sayama	1957 births, Living people, Japanese professional wrestlers, People from Yamaguchi Prefecture
Jumbo Tsuruta	1951 births, 2000 deaths, Japanese professional wrestlers, People from Yamanashi Prefecture
Shohei Baba	1938 births, 1999 deaths, Deaths from cancer, Disease-related deaths in Japan, Japanese professional wrestlers, People from Niigata Prefecture
Rikidōzan	1924 births, 1963 deaths, Japanese professional wrestlers
Owen Morris	Oasis (band), Living people, 1968 births, British record producers
Scott Pilgrim vs. the World	2010 comedy movies, 2010s action comedy movies, American action comedy movies, British action movies, British comedy movies, Canadian comedy movies, Japanese movies
Yas Marina Circuit	Formula One circuits
Syncopation	Music
VG-lista	Record charts, Norwegian culture
Austin Powers in Goldmember	2000 comedy movies, 2000s parody movies, 2000s sequel movies, 2000s spy movies, American parody movies, American sequel movies, American spy movies, Austin Powers, English-language movies, Guam, Histrionic personality disorder in fiction, Movies directed by Jay Roach, Movies set in Japan, Movies set in London, Movies set in the 1970s, Movies set in the 2000s, Screenplays by Michael McCullers, Screenplays by Mike Myers, Self-reflexive movies, Spy comedy movies, Time travel movies, Tokyo
Marina Bay Street Circuit	Formula One circuits
ABS-CBN Corporation	Philippine television networks, Quezon City
I Me Mine	The Beatles songs, 1970 songs
Happiness (movie)	1998 comedy-drama movies, American comedy-drama movies, English-language movies, Movies about dysfunctional families, Movies about suburbia, Movies set in New Jersey, Multilingual movies, American independent movies, Movies about pedophilia, Movies about child sexual abuse
Charlie Whiting	1952 births, 2019 deaths, Deaths from pulmonary embolism, Disease-related deaths in Victoria (Australia), English businesspeople, Formula One people, People from Kent
Cyprinus rubrofuscus	Ray-finned fish
Negimaki	Japanese food, Meat dishes
Virgin Radio	Radio, Virgin Group
2011 Formula One World Championship	Formula One seasons, Formula One current, 2011 in sports
Holocene extinction	Earth, Animals, Extinction events
Glaciation	Earth
Tsunami	Earthquakes, Tsunamis
The Wall	Pink Floyd albums, Concept albums, Progressive rock albums
Al Snow	1963 births, Living people, Former WWE wrestlers, American professional wrestlers, Sportspeople from Ohio, People from Lima, Ohio
Parma, Ohio	Cities in Ohio
American Gothic	20th century paintings, American paintings
Keith Urban (1991 album)	1991 albums, Debut albums, Keith Urban albums, Country albums
Keith Urban (album)	1999 albums, Keith Urban albums
Golden Road (album)	2002 albums, Keith Urban albums
Be Here	2004 albums, Keith Urban albums
Suzuka Circuit	Formula One circuits, NASCAR tracks
Love, Pain & the Whole Crazy Thing	2006 albums, Keith Urban albums
Defying Gravity (Keith Urban album)	2009 albums, Keith Urban albums
Fuck the World (Insane Clown Posse song)	Insane Clown Posse songs, 1999 songs
Santa Fe de Antioquia	Cities in Colombia, 1541 establishments
Superstar (movie)	1999 comedy movies, American comedy movies, Movies based on TV series, Paramount movies
Jessie Flower	1994 births, Living people, American voice actors
Daniel Hudson (baseball)	1987 births, Living people, American baseball players, Sportspeople from Virginia, Arizona Diamondbacks players, Chicago White Sox players, People from Lynchburg, Virginia
Ethan Spaulding	American television directors, Year of birth missing (living people), Living people
Greg Baldwin	1960 births, Living people, American voice actors, American stage actors
Jeremy Zuckerman	Living people, Year of birth missing (living people), American composers, Emmy Award winners
Cricket Leigh	American movie actors, American voice actors, Year of birth missing (living people), Living people, Actors from Chicago, Actors from Michigan
Olivia Hack	1983 births, Living people, American voice actors, People from Beverly Hills, California
Joaquim Dos Santos	Living people, Year of birth missing (living people), American movie directors
DVD Talk	Websites
36th Annie Awards	Annie Awards
Cliff Curtis	1968 births, Living people, New Zealand Māori people, New Zealand movie actors, New Zealand television actors
BuddyTV	Entertainment websites, Seattle, Washington
Annecy International Animated Film Festival	Movie festivals, Festivals in Europe, French movies, Annecy, 1960 establishments in Europe, 1960s establishments in France
Motion Picture Sound Editors	Movie organizations, 1953 establishments
Ampthill	Towns in Bedfordshire, Civil parishes in Bedfordshire
Ozai	Characters of Avatar: The Last Airbender, Animated characters
Appa	Animated characters, Characters of Avatar: The Last Airbender, Fictional characters introduced in 2005
Melbourne Grand Prix Circuit	Formula One circuits
Semiramide	Operas
Clancy Brown	1959 births, Living people, American movie actors, American television actors, American voice actors, Actors from Ohio
TV Guide (magazine)	American magazines, Television, Weekly magazines, Magazines published in New York City
Body temperature	Physiology
Annie Awards	Annie Awards
34th Annie Awards	Annie Awards, Glendale, California, February events, 2007 in entertainment, 2007 in California
59th Primetime Emmy Awards	Primetime Emmy Awards
The Cheeky Girls	2002 establishments in the United Kingdom, 2010s music groups, British girl groups, Musical groups established in 2002, Pop music groups, Romanian musical entertainers, Sibling musical duos, Transylvania, Twin people
Junior Seau	1969 births, 2012 deaths, American football linebackers, Sportspeople from San Diego, California, Sportspeople who committed suicide, Miami Dolphins players, New England Patriots players, San Diego Chargers players, Suicides by firearm in the United States
Autódromo José Carlos Pace	Formula One circuits, 1940 establishments in South America, 1940s establishments in Brazil
Pewter	Alloys
Tin(II) chloride	Chlorine compounds, Tin compounds
Tin(II) sulfate	Sulfur compounds, Tin compounds
Tin(IV) chloride	Chlorine compounds, Tin compounds
Caesium-137	Isotopes
Tin(IV) oxide	Tin compounds
Strontium-90	Isotopes
Tin(II) oxide	Tin compounds, Oxides
Chemical stability	Physical chemistry, Materials science
Pisces (astrology)	Astrological signs
James Wilson	1742 births, 1798 deaths, Politicians from Pennsylvania
Ultratop 40 Singles	Record charts
Ultratop 50 Singles	Record charts
Valencia Street Circuit	Formula One circuits, Sport in Spain, Valencia
Circuit Ricardo Tormo	Formula One circuits, Valencia (autonomous community), 1999 establishments in Europe, 1990s establishments in Spain
Velvet Sky	1981 births, Living people, Female professional wrestlers, American professional wrestlers, Sportspeople from Connecticut
Sydney funnel-web spider	Spiders
Circuit Gilles Villeneuve	Formula One circuits, NASCAR tracks, 1978 establishments in Canada
The Last Airbender	2010 movies, 2010 3D movies, 2010s action movies, 2010s adventure movies, 2010s fantasy movies, American action movies, American adventure movies, American fantasy movies, Avatar: The Last Airbender, Movies set in Antarctica, English-language movies, Movies composed by James Newton Howard, Movies directed by M. Night Shyamalan, Screenplays by M. Night Shyamalan
Season finale	Television series
Season premiere	Television series
Madison Rayne	1986 births, Living people, Female professional wrestlers, American professional wrestlers, Sportspeople from Ohio, Total Nonstop Action Wrestling alumni
Tony Orlando	1944 births, Living people, Singers from New York City, Actors from New York City, American television actors
Rocky Mountain Douglas-fir	Conifers, Trees
A1 road (Great Britain)	Roads in the United Kingdom
Roman roads in Britain	Roman roads in Britain
Cam'ron	1988 births, Living people, American rap musicians from New York, Singers from New York City
Kaihin-Makuhari Station	Railway stations in Chiba Prefecture
Nihombashi Station	Railway stations in Tokyo, 1932 establishments in Asia, 1930s establishments in Japan
Drew Brees	American football quarterbacks, New Orleans Saints players, San Diego Chargers players, Sportspeople from Austin, Texas, 1979 births, Living people
Mariano Rivera	1969 births, American Christians, American League All-Stars, Living people, New York Yankees players
Taco truck	Mexican food, Trucks
Silky shark	Sharks
Hairpin turn	Roads, Railway track layouts
Sepang International Circuit	Formula One circuits
Phoronida	Minor phyla
Shanghai International Circuit	Formula One circuits
Endeavour River National Park	National parks in Australia, Protected areas of Queensland
Nobuko Yoshiya	1896 births, 1973 deaths, Japanese novelists, People from Niigata Prefecture
Radioisotope heater unit	Physics
Circuit de Catalunya	Formula One circuits, 1991 establishments in Europe, 1990s establishments in Spain
Juan Manuel Santos	Living people, People from Bogotá, 1951 births, Presidents of Colombia
Ross Island	Ross Island, Islands, Geography of Antarctica
Excretion	Physiology
Vibration isolation	Mechanics, Mechanical vibrations
Murder of Megan Kanka	1994 deaths, 1990s in New Jersey, 1990s murders in the United States, Murdered children, American children, Deaths by strangulation, Kidnapped American people, Rape, Children victims of violence
Ueno Station	Ueno Station, Railway stations in Tokyo
Yuniesky Betancourt	1982 births, Living people, Cuban sportspeople, Kansas City Royals players, Seattle Mariners players
Saitama-Shintoshin Station	Railway stations in Saitama Prefecture
Tarawih	Ramadan
Ferrari Grand Prix results	Formula One constructor results, Formula One current, Formula Two, Transport lists
Let's Go All the Way (song)	Insane Clown Posse songs, 1986 songs
Riddle Box	1995 albums, Insane Clown Posse albums
Privateer (motorsport)	Sports words
Factory-backed	Sports words
Meriwether Lewis	1774 births, 1809 deaths, Suicides by firearm, American explorers, Politicians from Virginia
William Clark	1770 births, 1838 deaths, American explorers, Businesspeople from Virginia, Governors of Missouri, Politicians from Virginia
Concorde Agreement	Formula One
Tokyopop	American entertainment companies, Publishing companies of the United States
Film comic	Anime, Manga
List of Futurama episodes	Lists of animated television series episodes, Lists of comedy television series episodes
Roerich’s Pact	1930s treaties, Society, Culture, Ethics, 1935 in the United States
M. Night Shyamalan	Actors from Philadelphia, Pennsylvania, American movie actors, American movie directors, American movie producers, American screenwriters, Indian actors, Indian movie directors, Indian writers, 1970 births, Living people, Tamil people
Neijia	Martial arts
Brahmajala Sutta (Theravada)	Buddhist texts
Baguazhang	Martial arts
Grace Slick	1939 births, Living people, People from Evanston, Illinois, singers from Illinois, Jefferson Airplane members, People from Highland Park, Illinois
The Daily Pennsylvanian	Newspapers in the United States, Philadelphia, Pennsylvania, 1885 establishments in the United States, 1880s establishments in Pennsylvania
Pomeranian (dog)	Pomeranian (dog), Dog breeds
Io9	Websites
Jake Dowell	1985 births, American ice hockey players, Chicago Blackhawks players, Dallas Stars players, Living people, Sportspeople from Wisconsin, American Hockey League players, United States Hockey League players, Ice hockey centres
Brian David Josephson	1940 births, Living people, British Nobel Prize winners, British physicists, Fellows of the Royal Society, Jewish British academics, Jewish British scientists, Jewish Nobel Prize winners, Parapsychologists, People from Cardiff
Head-Smashed-In Buffalo Jump	Alberta, World Heritage Sites in Canada
Michael Thalbourne	1955 births, 2010 deaths, People from Adelaide, Psychologists, Australian academics, Scientists from South Australia, Australian social scientists, Parapsychologists, University of Adelaide alumni
Damping	Mechanics, Mechanical vibrations, Earthquake engineering
Dale Webster	Year of birth missing (living people), Living people, Sportspeople from California
Toyosu Station	Railway stations in Tokyo
Jeanne Moreau	1928 births, 2017 deaths, French movie actors, French movie directors, French movie producers, French screenwriters, French television actors, Actors from Paris
V12 engine	Motors
Gawker Media	Media in the United States, Companies based in New York City
The Philadelphia Inquirer	Newspapers in the United States, 1829 establishments in the United States, Pulitzer Prize winners, Philadelphia, Pennsylvania, 1820s establishments in Pennsylvania
Chinese martial arts	Martial arts
Series finale	Television series
Mazdak	Year of birth unknown, 520s deaths, Religions, Eastern philosophers
Box Car Racer	2001 establishments in California, 2000s disestablishments in California, 2003 disestablishments in the United States, Musical groups from San Diego, California, Post-hardcore bands, American punk bands, Pop punk bands, American rock bands, 2000s American music groups
Tatshenshini-Alsek Provincial Park	British Columbia, Alaska, Parks, World Heritage Sites in Canada
List of best-selling albums worldwide	Albums, Music-related lists
Nanaimo	Cities in British Columbia
Shibuya Station	Shibuya Station, Railway stations in Tokyo
Oakland Tribune	Newspapers in California, Oakland, California, 1874 establishments in California
Loving County, Texas	Texas counties
I'm Outta Time	Oasis (band) songs, 2008 songs
Nick.com	Nickelodeon, Entertainment websites, 1995 establishments
Corey Crawford	1984 births, American Hockey League players, Canadian ice hockey goaltenders, Chicago Blackhawks players, Ice hockey people from Quebec, Living people, Moncton Wildcats players, People from Montreal, Stanley Cup champions
Oasis discography	Oasis (band), Discographies
Hemichordata	Invertebrates
CraveOnline	Entertainment websites, Companies based in Los Angeles
Wibbling Rivalry	Oasis (band) songs, 1995 songs
William Lloyd Garrison	1805 births, 1879 deaths, American journalists, writers from Massachusetts, American abolitionists, Libertarians
Animation Magazine	American magazines, Animation
Nielsen Media Research	Media in the United States
Deus ex machina	Theater, Latin words and phrases
Dig It (Beatles song)	The Beatles songs, 1970 songs
Length of day	Days, Earth sciences
Woman Haters	Comedy television series
WAZE-TV	American television stations, Evansville, Indiana
WAAY-TV	American television stations, American Broadcasting Company
KTUU	American television stations, Anchorage, Alaska
KPXI	American television stations, Minnesota
Adam Birch	1979 births, Living people, American professional wrestlers, Former WWE wrestlers, Sportspeople from Virginia
Independent circuit	Professional wrestling
White-crested cockatoo	Birds of Indonesia, Pets, Cockatoos, Birds of Australia
Roraiman Barbtail	Passeriformes
Fuckin' in the Bushes	Oasis (band) songs, 2000 songs
Sauber Grand Prix results	Formula One constructor results, Formula One current
Quaker Oats Company	1901 establishments in the United States, 1900s establishments in Illinois, American food companies, Companies based in Chicago, Illinois
Toyota Sienna	Toyota automobiles, Minivans, 1990s automobiles, 2000s automobiles, 2010s automobiles
Cloister	Architectural elements, Gothic architecture
Chevrolet Lumina	Chevrolet automobiles, Sedans, Coupes, Minivans, 1980s automobiles, 1990s automobiles, 2000s automobiles, 2010s automobiles
Vyatskoye, Khabarovsk Krai	Settlements in Russia
Scaffold	Buildings and structures
David Legwand	1980 births, American Hockey League players, American ice hockey players, Detroit Red Wings players, Living people, Nashville Predators players, Ottawa Senators players, Sportspeople from Detroit, Michigan, Ontario Hockey League players, Ice hockey centres
Precinct	Buildings and structures
Tim Lincecum	1984 births, Living people, San Francisco Giants players, Sportspeople from Washington, National League All-Stars
Jack Nicklaus	1940 births, Living people, American golfers, Sportspeople from Columbus, Ohio
Syfy	American television channels, Companies based in New York City, 1992 establishments, Cable television
Art of East Asia	Art
Matthew McConaughey	Academy Award winning actors, Satellite Award winners, Screen Actors Guild Award winners, Actors from Texas, American movie actors, Golden Globe Award winning actors, 1969 births, Living people
Hung Ga	Martial arts
Jesse Eisenberg	Actors from New York City, American movie actors, American television actors, American voice actors, Jewish American actors, 1983 births, Living people
Southern Praying Mantis (martial art)	Martial arts
Northern Shaolin (martial art)	Martial arts
Tai chi chuan	Martial arts, Meditation
TVShowsOnDVD.com	Entertainment websites
Play.com	Websites
JB Hi-Fi	Companies of Australia, 1974 establishments in Australia
Charlie Sands (ice hockey)	1911 births, 1953 deaths, Boston Bruins players, Canadian ice hockey right wingers, Ice hockey people from Ontario, Montreal Canadiens players, New York Rangers players, People from Thunder Bay, Toronto Maple Leafs players
EzyDVD	Companies of Australia
Steve Rucchin	1971 births, Atlanta Thrashers players, Canadian ice hockey centres, Ice hockey people from Ontario, Living people, Mighty Ducks of Anaheim players, New York Rangers players, People from Thunder Bay, International Hockey League (1945–2001) players
The Hollywood Reporter	Media in the United States, Companies based in Los Angeles, 1930 establishments in the United States, 1930s establishments in California
NTSC	Television technology
Saku Koivu	1974 births, Anaheim Ducks players, Bill Masterton Memorial Trophy winners, Cancer survivors, Finnish ice hockey players, Living people, Montreal Canadiens players, Olympic bronze medalists, Olympic silver medalists, Turku, Ice hockey centres
Helium.com	Websites
Cliff Barton	1907 births, 1969 deaths, American Hockey Association (1926–42) players, American Hockey League players, American ice hockey players, New York Rangers players, Philadelphia Quakers (NHL) players, Pittsburgh Pirates (NHL) players, Sportspeople from Michigan
Edmond Bouchard	1892 births, 1955 deaths, Canadian ice hockey left wingers, Hamilton Tigers players, Ice hockey people from Quebec, Montreal Canadiens players, New York Americans players, Pittsburgh Pirates (NHL) players
Inorganic chemistry	Chemistry
DVD region code	Technology
Jake Forbes	1897 births, 1985 deaths, Canadian ice hockey goaltenders, Hamilton Tigers players, Ice hockey people from Ontario, New York Americans players, Sportspeople from Toronto, Philadelphia Quakers (NHL) players, Toronto St. Pats players
Amos Arbour	1895 births, 1943 deaths, Canadian ice hockey left wingers, Hamilton Tigers players, Montreal Canadiens players, Toronto St. Pats players, Stanley Cup champions, Ice hockey people from Ontario, Montreal Canadiens (NHA) players
Harry Cameron	1890 births, 1953 deaths, Canadian ice hockey defencemen, Hockey Hall of Fame inductees, Ice hockey people from Ontario, Montreal Canadiens players, Montreal Wanderers (NHA) players, Ottawa Senators (original) players, Stanley Cup champions, Toronto Arenas players, Toronto Blueshirts players, Toronto St. Pats players
Rusty Crawford	1885 births, 1971 deaths, Canadian ice hockey forwards, Hockey Hall of Fame inductees, Ice hockey people from Ontario, Ottawa Senators (original) players, Toronto Arenas players, Stanley Cup champions, Quebec Bulldogs (NHA) players
Eddie Carpenter	1890 births, 1963 deaths, Canadian ice hockey defencemen, Hamilton Tigers players, Quebec Bulldogs players, Stanley Cup champions, Toronto Blueshirts players
Alex Wellington	1893 births, 1967 deaths, Canadian ice hockey right wingers, Ice hockey people from Ontario, People from Thunder Bay, Quebec Bulldogs players
Barry Boughner	1948 births, California Golden Seals players, Canadian ice hockey right wingers, Ice hockey people from Ontario, Living people, Oakland Seals players, American Hockey League players, International Hockey League (1945–2001) players, Central Professional Hockey League players
Lyle Bradley	1943 births, California Golden Seals players, Cleveland Barons (NHL) players, Ice hockey people from Saskatchewan, Living people, Canadian ice hockey centres
Gary Croteau	1946 births, California Golden Seals players, Colorado Rockies (NHL) players, Detroit Red Wings players, Kansas City Scouts players, Living people, Los Angeles Kings players, Oakland Seals players
Chuck Arnason	1951 births, Atlanta Flames players, Canadian ice hockey right wingers, Cleveland Barons (NHL) players, Colorado Rockies (NHL) players, Flin Flon Bombers players, Ice hockey people from Manitoba, Kansas City Scouts players, Living people, Minnesota North Stars players, Montreal Canadiens players, Pittsburgh Penguins players, Washington Capitals players
Rick Adduono	1955 births, American Hockey League players, Atlanta Flames players, Boston Bruins players, Canadian ice hockey centres, Ice hockey people from Ontario, Living people, Ontario Hockey League players, People from Thunder Bay, World Hockey Association players, Central Professional Hockey League players, Binghamton Dusters players
Len Frig	1950 births, People from Lethbridge, California Golden Seals players, Canadian ice hockey defencemen, Chicago Blackhawks players, Cleveland Barons (NHL) players, Living people, Oakland Seals players, St. Louis Blues players, Ice hockey people from Alberta, Central Professional Hockey League players
Dan Bouchard	1950 births, Atlanta Flames players, Calgary Flames players, Canadian ice hockey goaltenders, Living people, Quebec Nordiques players, Winnipeg Jets (1979–96) players, Ice hockey people from Quebec, American Hockey League players, Quebec Major Junior Hockey League players, Ontario Hockey League players, Central Professional Hockey League players
Taylor Pyatt	1981 births, American Hockey League players, Buffalo Sabres players, Canadian ice hockey left wingers, Ice hockey people from Ontario, Living people, New York Islanders players, New York Rangers players, Ontario Hockey League players, People from Thunder Bay, Phoenix Coyotes players, Swedish Hockey League players, Vancouver Canucks players
Leslie Caron	1931 births, Living people, French movie actors, French television actors, French stage actors, French voice actors, Naturalized citizens of the United States, Ballet dancers, Ballerinas, American movie actors, American television actors, American stage actors, American voice actors, Emmy Award winning actors, BAFTA Award winning actors, Golden Globe Award winning actors
Where Did It All Go Wrong?	2000 songs, Oasis (band) songs
Jackson Rathbone	1984 births, Living people, American movie actors, American television actors, Actors from Texas, Singers from Texas
Casnate con Bernate	Settlements in Lombardy
The Only Easy Day Was Yesterday	2010 songs
Tom Felton	1987 births, Living people, Actors from Surrey, British child actors, English movie actors, English television actors, English voice actors
Persistent vegetative state	Symptoms, Medical signs
Daniel Bryan	1981 births, American professional wrestlers, Living people, People from Aberdeen, Washington, Sportspeople from Washington
Michael Tarver	1977 births, Living people, Former WWE wrestlers, American professional wrestlers, Sportspeople from Akron, Ohio
Ryback	1981 births, Living people, WWE wrestlers, American professional wrestlers, People from Las Vegas, Nevada, Sportspeople from Nevada
Greg Johnson (ice hockey)	1971 births, 2019 deaths, American Hockey League players, Canadian ice hockey centres, Canadian Olympic silver medalists, Chicago Blackhawks players, Detroit Red Wings players, Ice hockey people from Ontario, Living people, Nashville Predators players, People from Thunder Bay, Sportspeople from North Dakota, Pittsburgh Penguins players, United States Hockey League players
Bill Houlder	1967 births, Canadian ice hockey defencemen, Buffalo Sabres players, Ice hockey people from Ontario, Living people, Mighty Ducks of Anaheim players, Nashville Predators players, People from Thunder Bay, San Jose Sharks players, St. Louis Blues players, Tampa Bay Lightning players, Washington Capitals players, American Hockey League players, International Hockey League (1945–2001) players, Ontario Hockey League players
Hurricane Marilyn	Hurricanes in the United States, 1995 Atlantic hurricane season, History of Barbados, 1995 in North America, 20th century in Puerto Rico, 1990s in Bermuda
Heath Slater	1983 births, American professional wrestlers, Living people, Sportspeople from West Virginia, WWE wrestlers
Tomáš Kaberle	1978 births, Czech ice hockey players, Boston Bruins players, Carolina Hurricanes players, Living people, Montreal Canadiens players, Stanley Cup champions, Toronto Maple Leafs players, American Hockey League players, Ice hockey defencemen
Margot Frank	1926 births, 1945 deaths, Anne Frank, Deaths from typhus, German Jews, Holocaust victims, Infectious disease deaths in Germany, People from Amsterdam, People from Frankfurt, Refugees from Nazism
The American (2010 movie)	2010 crime movies, 2010 drama movies, 2010 thriller movies, 2010s crime drama movies, 2010s crime thriller movies, 2010s drama thriller movies, American crime drama movies, American crime thriller movies, American drama thriller movies, English-language movies, Movies based on books, Movies set in Italy
Easy A	2010 comedy movies, 2010 romance movies, 2010s LGBT movies, 2010s romantic comedy movies, 2010s sex comedy movies, 2010s teen romance movies, American LGBT movies, American sex comedy movies, American teen comedy movies, American teen romance movies, English-language movies, High school movies, LGBT comedy movies, LGBT romance movies, Movies about virginity, Movies set in California, Teen LGBT movies, Ventura County, California, American independent movies, Movies directed by Will Gluck
Joe Flacco	1987 births, Living people, American football quarterbacks, Baltimore Ravens players, Denver Broncos players, Sportspeople from New Jersey
Troy Smith	1987 births, Living people, Baltimore Ravens players, American football quarterbacks, Sportspeople from Cleveland, Ohio, Heisman Trophy winners
Kyle Boller	1981 births, Living people, Baltimore Ravens players, Oakland Raiders players, American football quarterbacks, Football players from California, People from Burbank, California, San Diego Chargers players, St. Louis Rams players
St Albans Cathedral	Anglican Cathedrals, Cathedrals in England, St Albans
Frank Marshall (movie producer)	American movie directors, American movie producers, People from Los Angeles, California, 1946 births, Living people
Kathleen Kennedy (producer)	1953 births, Living people, American movie producers, Businesspeople from Berkeley, California
Sam Mercer	Living people, Year of birth missing (living people), American movie producers
Parish	Religion, Parishes
Kao Corporation	Companies of the United States, Cincinnati, Ohio
Monkfish	Teleosts
Nickelodeon Movies	Companies based in Los Angeles, 1995 establishments in California
Minotaur	Greek legendary creatures
Bruno Senna	1983 births, Living people, Brazilian racecar drivers, Formula One current, Formula One drivers, GP2 Series drivers
Runnymede	Surrey, Tourism, National Trust properties
Eoin Colfer	1965 births, Living people, Irish novelists, People from County Wexford
Donté Stallworth	1980 births, Living people, Baltimore Ravens players, Cleveland Browns players, New England Patriots players, New Orleans Saints players, Philadelphia Eagles players, Washington Redskins players, American football wide receivers, Football players from California, Sportspeople from Sacramento, California
Ed Reed	1978 births, Living people, Baltimore Ravens players, American football safeties, Sportspeople from Louisiana
Nelson Pyatt	1953 births, American Hockey League players, Canadian ice hockey centres, Central Professional Hockey League players, Colorado Rockies (NHL) players, Detroit Red Wings players, Ice hockey people from Ontario, Living people, Ontario Hockey League players, People from Thunder Bay, Washington Capitals players
Twyford Bathrooms	Companies of the United Kingdom, 1849 establishments in the United Kingdom
Adrian Sutil	1983 births, Living people, Formula One current, Formula One drivers, German racecar drivers, Sportspeople from Bavaria
Sean Pronger	1972 births, American Hockey League players, Boston Bruins players, Canadian ice hockey centres, Columbus Blue Jackets players, Ice hockey people from Ontario, Living people, Los Angeles Kings players, Mighty Ducks of Anaheim players, New York Rangers players, People from Thunder Bay, Pittsburgh Penguins players, United States Hockey League players, Vancouver Canucks players, ECHL players, International Hockey League (1945–2001) players
Darren Young	1983 births, Living people, American professional wrestlers, Gay men, LGBT African Americans, LGBT sportspeople, People from Union City, New Jersey, Sportspeople from New Jersey, WWE wrestlers
Trevor Letowski	1977 births, Canadian ice hockey right wingers, Carolina Hurricanes players, Columbus Blue Jackets players, Ice hockey people from Ontario, Living people, People from Thunder Bay, Phoenix Coyotes players, Vancouver Canucks players, American Hockey League players, Ontario Hockey League players
Fred Brathwaite	1972 births, Calgary Flames players, Canadian ice hockey goaltenders, Columbus Blue Jackets players, Edmonton Oilers players, Ice hockey people from Ontario, Living people, People from Ottawa, St. Louis Blues players, American Hockey League players, International Hockey League (1945–2001) players, Ontario Hockey League players, Memorial Cup winners
Prescott Burgess	1987 births, Living people, Baltimore Ravens players, New England Patriots players, American football linebackers, Sportspeople from Ohio
Evacuation slide	Aviation safety
Extended periodic table	Periodic table, Chemical elements, Nuclear physics
Chris Columbus (filmmaker)	1958 births, Living people, Movie directors from Ohio, Movie directors from Pennsylvania, Movie producers from Ohio, Movie producers from Pennsylvania, Screenwriters from Ohio, Screenwriters from Pennsylvania, People from Youngstown, Ohio
Iron sulfide	Iron compounds
Ferric	Iron compounds
Jaime Alguersuari	1990 births, Living people, Formula One current, Formula One drivers, Sportspeople from Barcelona
Le'Ron McClain	1984 births, Baltimore Ravens players, American football fullbacks, American football running backs, Kansas City Chiefs players, Living people, People from Tuscaloosa, Alabama, San Diego Chargers players, Sportspeople from Alabama
Willis McGahee	1981 births, Living people, Baltimore Ravens players, Buffalo Bills players, American football running backs, Sportspeople from Miami, Florida, Denver Broncos players, Cleveland Browns players
Lucas di Grassi	1984 births, Living people, Brazilian sportspeople, Formula One drivers, Formula One current, GP2 Series drivers
Horrorcore	Hip hop genres, Music genres
Stephen Lynch (musician)	1971 births, Living people, Comedians from Pennsylvania, Actors from Pennsylvania, Musicians from Pennsylvania, American movie actors, American musical theatre actors
Helm of Darkness	Greek mythology
Nico Rosberg	1985 births, Living people, Finnish racecar drivers, Formula One current, Formula One drivers, German racecar drivers, GP2 Series drivers, People from Wiesbaden, Sportspeople from Hesse
Nico Hülkenberg	1987 births, Living people, Formula One current, Formula One drivers, German racecar drivers, GP2 Series drivers, Sportspeople from North Rhine-Westphalia
Diocese	Christian terminology, Church organization
Peugeot 306	Peugeot automobiles, 1990s automobiles, 2000s automobiles
Ammonium dichromate	Nitrogen compounds
Potassium dichromate	Potassium compounds, Chromium compounds
Reagent	Chemicals
Chromic acid	Chromium compounds
Chromium(VI) oxide	Chromium compounds
Chromyl chloride	Chlorine compounds, Chromium compounds, Oxides
Sodium iodide	Sodium compounds, Iodine compounds
Sodium fluoride	Sodium compounds, Fluorine compounds
Todd Heap	1980 births, Living people, Baltimore Ravens players, American football tight ends, Sportspeople from Arizona, People from Mesa, Arizona
List of governors of Alabama	Governors of Alabama, Lists of politicians from the United States
Volkswagen Tiguan	Volkswagen automobiles, Sport utility vehicles, 2000s automobiles, 2010s automobiles
Obaman oppivuosi	2010 books, Barack Obama
Rover 25	Rover automobiles, 1990s automobiles, 2000s automobiles, Front wheel drive vehicles, Sedans
SEAT Toledo	SEAT automobiles, 1990s automobiles, 2000s automobiles
Alfa Romeo 145	Alfa Romeo automobiles, 1990s automobiles, 2000s automobiles
Renault Safrane	Renault automobiles, 1990s automobiles, 2000s automobiles
Renault 21	Renault automobiles, 1980s automobiles, 1990s automobiles
Rover 45	Rover automobiles, 1990s automobiles, 2000s automobiles
Derrick Mason	1974 births, Living people, Baltimore Ravens players, Houston Texans players, New York Jets players, Tennessee Titans players, American football wide receivers, Sportspeople from Detroit, Michigan
John Madden	1936 births, Living people, National Football League coaches, Sportspeople from Minnesota
Medicine Hat	Towns in Alberta
Massachusetts General Hospital	Hospitals in the United States, Buildings and structures in Massachusetts
You're Cut Off!	American reality television series, English-language television programs
Life After Life	Death, Psychiatry, Non-fiction books, 1975 books
Raymond Moody	1944 births, Living people, American psychiatrists, American psychologists
Golden, British Columbia	Cities in British Columbia
Saint Croix, U.S. Virgin Islands	US Virgin Islands
Taryn Terrell	1984 births, American models, American movie actors, American professional wrestlers, American television actors, Living people, Sportspeople from Louisiana, Stuntmen, TNA wrestlers
The Usos	1985 births, American professional wrestlers, Living people, Sportspeople from San Francisco, Twin people from the United States, WWE teams and stables, WWE wrestlers
City for Conquest	1940 movies, 1940s drama movies, American drama movies, English-language movies, Movies based on books, Movies directed by Jean Negulesco, Movies directed by Anatole Litvak
Hattie McDaniel	1895 births, 1952 deaths, Academy Award winning actors, African American actors, African American musicians, American movie actors, American singer-songwriters, American television actors, Cancer deaths in the United States, Deaths from breast cancer, Actors from Wichita, Kansas
Pedro de la Rosa	1971 births, Living people, Spanish sportspeople, Formula One drivers, Formula One current
John Bellamy Foster	1953 births, Living people, socialists, American sociologists
Sébastien Buemi	1988 births, Living people, Swiss sportspeople, Formula One drivers, Formula One current
Boy with the Blues (EP)	2009 albums, Oasis (band) albums
Vitaly Petrov	1984 births, Living people, Russian sportspeople, Formula One drivers, Formula One current, GP2 Series drivers
Chamomile	Herbs, Asteraceae
Sam Koch	1982 births, Living people, Baltimore Ravens players, American football punters, Sportspeople from Nebraska
Vitantonio Liuzzi	1981 births, Living people, Formula One current, Formula One drivers, Italian racecar drivers, People from Apulia
Billy Cundiff	1980 births, Living people, Baltimore Ravens players, Dallas Cowboys players, Cleveland Browns players, New Orleans Saints players, American football placekickers, Sportspeople from Phoenix, Arizona
Kyle Richardson	1973 births, Living people, Sportspeople from Missouri, Baltimore Ravens players, Miami Dolphins players, Seattle Seahawks players, Minnesota Vikings players, Cincinnati Bengals players, Cleveland Browns players, American football punters
Book frontispiece	Art
Sakon Yamamoto	1982 births, Living people, Japanese racecar drivers, Formula One drivers, Formula One current, GP2 Series drivers, People from Aichi Prefecture
Muscle atrophy	Physiology
33rd Annie Awards	Annie Awards, Glendale, California, February 2006 events, 2006 in entertainment, 2006 in the United States, 2000s in California
Genesis Award	Awards, Animal rights
Karun Chandhok	1984 births, Living people, Indian sportspeople, Formula One drivers, Formula One current, GP2 Series drivers, People from Chennai
Primetime Emmy Awards	Primetime Emmy Awards
Chromium(II) oxide	Chromium compounds, Oxides
Chromium(IV) oxide	Chromium compounds, Oxides
Disproportionation	Chemical reactions, Chemical processes, Organic reactions, Biochemistry
Sodium chlorate	Sodium compounds, Chlorine compounds
Hypophosphite	Phosphorus compounds
Nigel Short	1965 births, Living people, British chess players, Chess grandmasters
Sodium hypophosphite	Phosphorus compounds, Sodium compounds
Steve Yzerman	1965 births, Bill Masterton Memorial Trophy winners, Canadian ice hockey centres, Canadian Olympic gold medalists, Conn Smythe Trophy winners, Detroit Red Wings players, Hockey Hall of Fame inductees, Ice hockey people from British Columbia, Living people, Ontario Hockey League, Stanley Cup champions, Ontario Hockey League players
Union City, California	Cities in California, Cities in the San Francisco Bay Area, Settlements in Alameda County, California
Shayne Graham	1977 births, Living people, Baltimore Ravens players, Buffalo Bills players, Carolina Panthers players, Cincinnati Bengals players, American football placekickers, Sportspeople from Virginia
Fiat 500	Fiat automobiles, 1950s automobiles, 1960s automobiles, 1970s automobiles
Fiat Marea	Fiat automobiles, 1990s automobiles, 2000s automobiles
Phosphite	Phosphorus compounds
Hypophosphorous acid	Phosphorus compounds
Sodium phosphite	Phosphorus compounds, Sodium compounds
Phosphorous acid	Phosphorus compounds
Phosphorus(V) oxide	Phosphorus compounds
Phosphorus(III) oxide	Phosphorus compounds
Phosphorus trichloride	Phosphorus compounds, Chlorine compounds
Phosphoric acid	Phosphorus compounds
Nickelodeon Kids' Choice Awards	Entertainment awards, Nickelodeon
Sodium phosphate	Phosphorus compounds, Sodium compounds
San Marino Grand Prix	Formula One Grands Prix
Leopold von Sacher-Masoch	1836 births, 1895 deaths, Austrian writers
Chris Kuper	1982 births, Living people, Denver Broncos players, American football offensive guards, Sportspeople from Alaska, People from Anchorage, Alaska, Sportspeople from North Dakota
The Blackout (band)	Post-hardcore bands, Welsh musical groups, Musical groups established in 2003, 2003 establishments in the United Kingdom, 2000s establishments in Wales
Sunshine Coast, Queensland	Sunshine Coast, Queensland
Kia Stevens	1977 births, American professional wrestlers, Female professional wrestlers, Former WWE wrestlers, Living people, Sportspeople from Los Angeles, California, Total Nonstop Action Wrestling alumni
Robert Frost	1874 births, 1963 deaths, Deaths from surgical complications, American poets, Pulitzer Prize winners, Writers from San Francisco, Deaths from myocardial infarction, People from Lawrence, Massachusetts
Kevin Harvick	1975 births, Living people, Daytona 500 winners, American racecar drivers, NASCAR drivers
Autodromo Enzo e Dino Ferrari	Formula One circuits
1220s	1220s
Constitutional Union Party	Political parties in the United States
Ya Boy	1984 births, Living people, American rap musicians from California, Singers from California, Musicians from San Francisco
Miniseries	Miniseries
Elastic collision	Physics, Elasticity (physics)
Eastern Kentucky University	Colleges and universities in Kentucky, Ohio Valley Conference, 1906 establishments in the United States, 20th-century establishments in Kentucky
Shaun Toub	1963 births, Living people, American movie actors, American television actors, Iranian actors, People from Tehran
Nicktoons Network	2002 American television series debuts, Nicktoons, Companies based in New York City, 2000s establishments in New York (state)
Michael Adams	1971 births, Living people, British chess players, People from Cornwall, Chess grandmasters
Sodium carbonate	Sodium compounds, Carbonates
Solvay process	Chemical reactions
Potassium carbonate	Potassium compounds, Carbonates
Bicarbonate	Chemicals
Yokohama Station	Yokohama Station, Railway stations in Kanagawa Prefecture
Minatomirai Station	Minatomirai Station, Railway stations in Kanagawa Prefecture
Motomachi-Chūkagai Station	Motomachi-Chūkagai Station, Railway stations in Kanagawa Prefecture
KFAX	Radio stations in the United States, San Francisco, 1925 establishments in the United States, 1920s establishments in California
Don't Bother Me	The Beatles songs, 1963 songs
Negotiation	Dispute resolution, Documents, Words
Eupeodes lapponicus	Flies
Josh Bidwell	1976 births, Living people, Green Bay Packers players, Tampa Bay Buccaneers players, Washington Redskins players, American football punters, Sportspeople from Oregon
Peabody River State Fish and Wildlife Area	State parks in the United States, Illinois
Dick Irvin	1892 births, 1957 deaths, Canadian ice hockey centres, Chicago Blackhawks players, Ice hockey people from Ontario, People from Hamilton, Stanley Cup champions
East Jensens Island	Atlantic islands, Islands of North America, Geography of Greenland, Uninhabited islands
Tony Miles	1955 births, 2001 deaths, British chess players, Cardiovascular disease deaths in England, Deaths from diabetes, Deaths from heart failure, People from Birmingham, Chess grandmasters
Bobby Roode	1977 births, Living people, Canadian professional wrestlers, Sportspeople from Ontario
The Great Milenko	1997 albums, Insane Clown Posse albums
Emmaste Parish	Emmaste Parish
Encyclopedia Americana	Encyclopedias
Deepwater Horizon oil spill	2010 disasters, 2010 in the United States, 2010s in Louisiana, Explosions in the United States
Lithium hydroxide	Lithium compounds
Great tit	Passeriformes
Al Bayda	Cities in Libya
Shin-Takashima Station	Shin-Takashima Station, Railway stations in Kanagawa Prefecture
Booby	Seabirds, Pelecaniformes
Sakuragichō Station	Yokohama Station, Railway stations in Kanagawa Prefecture
Chicken turtle	Turtles
Pink fairy armadillo	Xenarthrans
Nova Scotia Duck Tolling Retriever	Dog breeds
The Four Stages of Cruelty	1751, Animal rights, 18th century works
Getting Things Done	2000s books, Management
Uncle Sam	Symbols of the United States, National personifications
Frederic William Henry Myers	1843 births, 1901 deaths, English poets, Parapsychologists
Joseph Blackburne	1841 births, 1924 deaths, British chess players, People from Greater Manchester
Stile	Agriculture, Gates
Behaviorism	Psychology
Bushehr Nuclear Power Plant	Nuclear power plants
Border Collie	Dog breeds
Pyrolusite	Minerals
Manganese(II) oxide	Manganese compounds, Oxides
Manganese carbonate	Manganese compounds
Manganese(II) chloride	Chlorine compounds, Manganese compounds
Minardi	Formula One constructors
Samuel Reshevsky	1911 births, 1992 deaths, Accountants, Chess grandmasters, Jewish American sportspeople, Naturalized citizens of the United States, Polish chess players, Polish Jews
London Bridge	Bridges in the United Kingdom, Bridges and tunnels in London, Concrete bridges, Steel bridges
Bull Terrier	Terriers
Bullmastiff	Dog breeds, Molossers
Chow Chow	Dog breeds
Chad Johnson	1978 births, Living people, Cincinnati Bengals players, American football wide receivers, Sportspeople from Miami, Florida, New England Patriots players
Kevin McKidd	1973 births, Living people, Scottish movie actors, Scottish television actors
Meqabyan	Religious texts
Bloodhound	Dog breeds
Celosia	Celosia, Amaranthaceae
Chris Kluwe	1981 births, Living people, American football punters, American LGBT rights activists, Minnesota Vikings players, Sportspeople from Philadelphia, Pennsylvania, American bloggers
The Hangover (movie)	2009 buddy movies, 2009 comedy movies, 2000s black comedy movies, American black comedy movies, German comedy movies, Buddy comedy movies, English-language movies, Movies about drugs, Movies set in Las Vegas, Warner Bros. movies, Movies directed by Todd Phillips
Wheel theory	Mathematics
Fundamental theorem of calculus	Calculus
Brent Bowden	1987 births, Living people, Tampa Bay Buccaneers players, American football punters, Sportspeople from Huntsville, Alabama
Mafia II	2010 video games, Windows games, PlayStation 3 games, Xbox 360 games, Adventure games, Video game sequels, Shooter video games
The Amazing Jeckel Brothers	1999 albums, Insane Clown Posse albums
Thomas Morstead	1986 births, Living people, New Orleans Saints players, American football punters, Sportspeople from Texas
Southwark	London Borough of Southwark
London Bridge station	London Travelcard zone 1, Railway stations in London, Jubilee Line stations, Railway stations opened in 1863, 1863 establishments in England
Watling Street	Roman roads in Britain
Kia Picanto	Kia automobiles, 2000s automobiles, 2010s automobiles
Southwark Cathedral	Anglican Cathedrals, Buildings and structures in London, London Borough of Southwark
4Lyn	German rock bands, Nu metal bands
Volkswagen Sharan	Volkswagen automobiles, 1990s automobiles, 2000s automobiles, 2010s automobiles
Cannon Street station	Railway stations in London, Circle Line stations, District Line stations, 1866 establishments in the United Kingdom, 1860s establishments in England
Farringdon station	Railway stations in London, Circle Line stations, Hammersmith & City Line stations, Metropolitan Line stations, Tube stations in Islington, 1863 establishments in England, Railway stations opened in 1863
St Pancras station	Railway stations in London, 1868 establishments in the United Kingdom, 1860s establishments in England, Railway stations opened in 1868
Blackfriars station	Railway stations in London, 1886 establishments in England, 2009 disestablishments in England, 2011 establishments in England
Doctor (title)	Titles
Newfoundland (dog)	Dog breeds
PlayStation Store	PlayStation
Literary genre	Genres
Boys Don't Cry (movie)	1999 drama movies, 1999 romance movies, 1990s biographical movies, 1999 LGBT movies, 1990s romantic drama movies, 20th Century Fox movies, Academy Award winning movies, American biographical movies, American LGBT movies, American romantic drama movies, English-language movies, Golden Globe Award winning movies, LGBT drama movies, LGBT romance movies, Movies based on real life events, Movies set in Nebraska, Murder in movies, Rape in movies, Transgender in movies, American independent movies
Rubidium hydroxide	Rubidium compounds
Rubidium oxide	Rubidium compounds, Oxides
Rubidium nitrate	Nitrogen compounds, Rubidium compounds
Rubidium hydride	Rubidium compounds
Jane Addams	1860 births, 1935 deaths, American activists, American Nobel Prize winners, American sociologists, Lesbians, LGBT Nobel Prize winners, LGBT people from Chicago, LGBT scientists, Nonviolence advocates, Scientists from Chicago
Hurricane Audrey	Hurricanes in the United States, 1957 in the United States, 20th century in Louisiana, 20th century in Texas, June events
Calcium phosphate	Phosphorus compounds, Calcium compounds
Hurricane Joan–Miriam	Hurricanes, Hurricanes in Mexico, 1988
Richard Rusczyk	Living people, 1971 births, American mathematicians
Hereford Cathedral	Anglican Cathedrals, Hereford
Unfinished building	Construction
Pierre Pilote	1931 births, 2017 deaths, Cancer deaths in Ontario, Canadian ice hockey defencemen, Chicago Blackhawks players, Hockey Hall of Fame inductees, Ice hockey people from Quebec, James Norris Memorial Trophy winners, Stanley Cup champions, Toronto Maple Leafs players, American Hockey League players
Twinkie the Kid	Advertising, Mascots, Fictional characters, Animated characters
Un medico in famiglia	1998 television series debuts, Italian television
Chris Chelios	1962 births, American ice hockey players, Atlanta Thrashers players, Chicago Blackhawks players, Detroit Red Wings players, Montreal Canadiens players, James Norris Memorial Trophy winners, Sportspeople from Chicago, Stanley Cup champions, Living people, American Hockey League players, Ice hockey defencemen
Milk chocolate	Food ingredients, Chocolate
Ed Litzenberger	1932 births, 2010 deaths, Calder Trophy winners, Canadian ice hockey right wingers, Chicago Blackhawks players, Detroit Red Wings players, Ice hockey people from Saskatchewan, Montreal Canadiens players, Toronto Maple Leafs players, Regina Pats players, Stanley Cup champions
7 World Trade Center	Buildings and structures completed in the 21st century, Skyscrapers in New York City, September 11 attacks, 2006 establishments in New York (state), Buildings and structures in Manhattan
Matt Birk	1976 births, Living people, Baltimore Ravens players, American football centers, Sportspeople from Saint Paul, Minnesota
Claude Lemieux	1965 births, American Hockey League players, Canadian ice hockey right wingers, Colorado Avalanche players, Conn Smythe Trophy winners, Dallas Stars players, Ice hockey people from Quebec, Living people, Montreal Canadiens players, New Jersey Devils players, Phoenix Coyotes players, San Jose Sharks players, Stanley Cup champions, Trois-Rivières Draveurs players, Verdun Junior Canadiens players, Verdun Juniors players
Zune	Microsoft gaming consoles
Xbox Live Marketplace	Microsoft
Georgi Markov	1929 births, 1978 deaths, People from Sofia, People murdered in London, Unsolved murders in the United Kingdom, Bulgarian writers
Jennie Kwan	1973 births, Living people, American television actors, Actors from Los Angeles, California
André Sogliuzzo	1966 births, Living people, Actors from New York City, American voice actors
SoundtrackNet	Entertainment websites
Avatar Airbender	Avatar: The Last Airbender, Roller coasters
Hungerford Bridge and Golden Jubilee Bridges	Bridges in the United Kingdom, Steel bridges
Upper Deck Company	1988 establishments in the United States, Companies based in California, Publishing companies of the United States
Car of the Century	Automobiles
Albert Bridge, London	Bridges in the United Kingdom, Bridges and tunnels in London, Concrete bridges, Steel bridges, Grade II* listed buildings in London, Suspension bridges
Action figure	Dolls
Ring of Steel (London)	London infrastructure, Law enforcement in the United Kingdom
10 Downing Street	Buildings and structures in London, Government buildings
Alfa Romeo 164	Alfa Romeo automobiles, 1980s automobiles, 1990s automobiles
Snog Marry Avoid?	2008 British television series debuts, 2000s British television series, 2000s reality television series, 2010s British television series, 2010s reality television series, BBC Television programmes, British reality television series, English-language television programs
Romy and Michele's High School Reunion	1997 comedy movies, 1990s buddy movies, American buddy movies, American comedy movies, Buddy comedy movies, English-language movies, Female buddy movies, Movies set in Arizona, Movies set in Los Angeles, California, Tucson, Arizona
Millennium Bridge	Steel bridges, Suspension bridges
Where the Truth Lies	2005 crime movies, 2005 drama movies, 2000s crime drama movies, 2000s LGBT movies, 2005 mystery movies, British crime drama movies, British mystery movies, British LGBT movies, Canadian drama movies, English-language movies, Movies set in the 1950s, Movies set in the 1970s, NC-17 rated movies, Movies directed by Atom Egoyan
Rubidium chloride	Chlorine compounds, Rubidium compounds
Warren G	1970 births, Living people, American rap musicians from California, Singers from California, People from Long Beach, California
Tomb Raider (video game)	1996 video games, Sega Saturn games, PlayStation games, Action video games
List of Formula One constructors	Formula One constructors, Formula One current, Formula One lists
Genesis creation narrative	Creation myths, Old Testament
Nave	Architectural elements, Church architecture
Hexham Abbey	Churches in England, Northumberland, Abbeys, Anglican churches
Edward Adelbert Doisy	American biochemists, American Nobel Prize winners, Scientists from Illinois, 1893 births, 1986 deaths
Biochemist	Biochemistry, Science occupations
List of church architecture terms	Religion-related lists, Glossaries, Church architecture
Tomb Raider II	1997 video games
Hydrogen sulfate	Sulfur compounds
Sodium bisulfate	Sodium compounds, Sulfur compounds
Potassium sulfate	Potassium compounds
Oleum	Sulfur compounds, Acids
Ammonium sulfate	Sulfur compounds, Nitrogen compounds
Smokey and the Bandit	1970s action movies, 1977 comedy movies, American action movies, American comedy movies, Universal Pictures movies, Trucker movies, Movies set in Texas
Amor Prohibido (song)	1994 songs, Selena songs, Songs written by A.B. Quintanilla, Spanish-language songs
Chapter house	Church architecture, Gothic architecture
Canon (official)	Christian religious occupations
Shane Lechler	1976 births, Living people, Oakland Raiders players, American football punters, Sportspeople from Texas
Dean	Occupations
Cover (combat technique)	Martial art techniques
Manipuri dance	Jagoi, Manipur, Dance types
Database administrator	Databases, Computers
Megan Fox	Actors from Florida, Actors from Tennessee, American child actors, American movie actors, American television actors, Bisexual people, LGBT actors, LGBT models, LGBT people from Florida, LGBT people from Tennessee, Models from Florida, Native American people, 1986 births, Living people, People from St. Petersburg, Florida
2009–10 FC Barcelona season	Football in Spain, Football seasons, 2009 in association football, 2010 in association football, 2000s in Spain, 2010s in Barcelona
Trams in Szczecin	Transport in Poland, Tram transport, 1875 establishments in Europe, Establishments in Poland
2010–11 FC Barcelona season	Football in Spain, 2011 in association football, 2010 in association football, 2010 in Europe, 2011 in Europe, 2010s in Barcelona
Elimination Chamber (2010)	2010 in American television, 2010 in professional wrestling, Elimination Chamber, 2010s in St. Louis, Missouri, February 2010 events, 2010 in Missouri
San José Chinantequilla	Settlements in Oaxaca
Yamatai	History of Japan
Himiko	Japanese people, Kings and queens, 175 births, 248 deaths
Harlequin duck	Ducks
Press-up	Fitness
Peabody Award	Television, Radio, Entertainment awards
Mae Whitman	American movie actors, American television actors, American voice actors, Actors from Los Angeles, California, 1988 births, Living people
Team Umizoomi	Nickelodeon television series, Children's television series, 2010 British television series debuts, 2010 American television series debuts, English-language television programs
88 Minutes	2007 drama movies, 2000s crime drama movies, 2000s mystery movies, 2000s crime thriller movies, 2000s drama thriller movies, American crime drama movies, American crime thriller movies, American drama thriller movies, American serial killer movies, Canadian drama movies, Canadian thriller movies, German drama movies, English-language movies, Movies set in Washington (U.S. state), Seattle, Washington in fiction, Movies directed by Jon Avnet
Alvarezsaurus	Cretaceous dinosaurs
Aucasaurus	Cretaceous dinosaurs, Abelisauridae
Conservation biology	Biology, Conservation
Fandango (wrestler)	Living people, 1981 births, American professional wrestlers, Sportspeople from Boston, Massachusetts
Tornado drill	Safety
Android (robot)	Robots
Manuel Lanzini	1993 births, Living people, Argentine footballers
ISO 21482	Symbols
Banchan	Korean food
Hanja	Korea, Writing systems, 1440s establishments, 15th century establishments in Asia, Korean language
Jjigae	Korean food
The Fame Monster	2009 albums, Lady Gaga albums, Pop albums, Electropop albums, Dance pop albums
Traffic Cops	2003 British television series debuts, 2000s British television series, 2010s British television series, BBC Television programmes, British reality television series
Fumigation	Chemicals
List of oxides	Oxides, Chemistry lists
Exit (system call)	Computing
Kip Winger	1961 births, Living people, Writers from Denver, Colorado, Singers from Denver, Colorado, Musicians from Denver, Colorado
Winger (band)	1980s American music groups, 1990s American music groups, 2000s American music groups, 2010s American music groups, American heavy metal bands, American hard rock bands, Glam metal bands, musical groups from New York City
Nadia Petrova	1982 births, Female tennis players, Living people, Medalists at the 2012 Summer Olympics, Russian tennis players, Sportspeople from Moscow
Ipswich, Queensland	Cities in Queensland
Gypsum	Minerals, Calcium compounds
Rick Rude	1958 births, 1999 deaths, American professional wrestlers, Sportspeople from Minnesota, Former WWE wrestlers
Scholastic Corporation	Publishing companies of the United States, Companies based in New York City, 1920 establishments in the United States
Johnny Bravo	Cartoon Network series, English-language television programs, 1997 television series debuts, 2004 television series endings
Randy Couture	People from Everett, Washington, Sportspeople from Washington, American mixed martial artists, 1963 births, Living people
Jason Lee	1970 births, Living people, American singers, American skateboarders, American voice actors, American comedians, American movie actors, American television actors, American stage actors, American video game actors, Scientologists, People from Orange, California, Actors from Santa Ana, California, Sportspeople from California
B.J. Penn	Sportspeople from Hawaii, American mixed martial artists, 1978 births, Living people, Hilo, Hawaii
Constitutional economics	Law, Economics, Government, Politics, Constitutions
FIA Super Licence	Formula One
Kijiji	Advertising, Websites
Struggle for existence	Metaphors referring to nature, Evolutionary biology
Chris Huhne	1954 births, Living people, Alumni of the University of Oxford, British columnists, Criminals from London, English prisoners, Former Liberal Democrats MPs (UK), Former members of the British House of Commons for English constituencies, Former MEPs, Journalists from London, MEPs for the United Kingdom, Politicians from London, Privy Councillors (UK), Secretaries of State of the United Kingdom, Social Democratic Party (UK) people, UK MPs 2005–2010, UK MPs 2010–2015
Malcolm in the Middle	2000 American television series debuts, 2006 American television series endings, 2000s American sitcoms, Emmy Award winning programs, Grammy Award winners, Peabody Award winners, Television series about brothers, Television series about dysfunctional families, Television series about suburbia, English-language television programs
Shays' Rebellion	18th century in Massachusetts, 1787 in the United States, 1786 in the United States, 18th century rebellions, Rebellions in North America
Burnout Revenge	Racing video games, PlayStation 2 games, Xbox games, 2005 video games
Jarvis Green	1979 births, Living people, American football defensive ends, Sportspeople from Louisiana, New England Patriots players, Denver Broncos players, Houston Texans players
Cooking Channel	American television networks, Cable television, 2010 establishments in the United States, Knoxville, Tennessee, 21st-century establishments in Tennessee
Social Security	Human rights, Economy of the United States
Yorktown, Virginia	Cities in Virginia, County seats in Virginia
The Pretty Reckless	American rock bands, Post-grunge bands, Musical groups from New York City
Romy Schneider	1938 births, 1982 deaths, Actors from Vienna, French movie actors, French stage actors, French television actors, German movie actors, German stage actors, German television actors
Angri	Towns in Italy, Settlements in Campania
Palm Island (Florida)	Islands of Florida
The Mystery of Al Capone's Vault	Al Capone, 1986 in entertainment, Television programs
Johnny Torrio	1882 births, 1957 deaths, Chicago Outfit mobsters, Al Capone, American crime victims, Cardiovascular disease deaths in the United States, Criminals from Chicago, Deaths from myocardial infarction, Italian crime victims
John Alcock (bishop)	1430s births, 1500 deaths, Christian religious leaders, English Roman Catholics, Lord Chancellors, People from Yorkshire, Roman Catholic bishops
Lord Chancellor	Lord Chancellors, Politics of the United Kingdom, 1707 establishments
2006 Copiapó mining accident	2006, 21st century in Chile, Disasters in the 2000s, 2000s in South America, January events
Copiapó	Cities in Chile
Glenn Beck	American conservatives, American radio personalities, American television presenters, People from Everett, Washington, 1964 births, Living people
Haruki Nakamura	1986 births, Living people, American football safeties, Sportspeople from Ohio, Baltimore Ravens players, Carolina Panthers players
Thomas Robert Malthus	1766 births, 1834 deaths, Academics of the University of Cambridge, Alumni of the University of Cambridge, British economists, Demography, English Anglicans, English priests, English scientists, Writers from Surrey
Littoral zone	Oceanography, Habitats
Collective animal behaviour	Zoology, Ethology
Chromium(II) chloride	Chlorine compounds, Chromium compounds
Sodium dichromate	Sodium compounds, Chromium compounds
Chrome plating	Physical chemistry
Mount Carmel Cemetery (Hillside)	Cemeteries in the United States, Buildings and structures in Chicago, Illinois, Al Capone
Mercury(II) chloride	Mercury compounds, Chlorine compounds
Mercury(I) chloride	Mercury compounds, Chlorine compounds
Mercury(I) nitrate	Nitrogen compounds, Mercury compounds
Amalgam	Chemicals
Mercury(II) nitrate	Nitrogen compounds, Mercury compounds
Mercury(II) iodide	Mercury compounds, Iodine compounds
Mercury(I) iodide	Mercury compounds, Iodine compounds
Stroopwafel	Sweet breads, Gouda, Dutch food
Inline-four engine	Motors
Anthony Rolfe Johnson	1940 births, 2010 deaths, Tenors, Commanders of the Order of the British Empire, English opera singers
Guildhall School of Music and Drama	Music schools, Colleges and universities in London
Mercury-vapor lamp	Lamps
Sodium vapor lamp	Lamps
Streetlight	Light sources
Aluminium oxide	Aluminium compounds, Oxides
Abrasive	Construction
Sandpaper	Construction
Corundum	Minerals
Aluminium chloride	Chlorine compounds, Aluminium compounds
The Salt Lake Tribune	Newspapers in the United States, Salt Lake City, 1871 establishments in the United States, 19th-century establishments in Utah
Joey Ramone	1951 births, 2001 deaths, American drummers, American punk musicians, American rock guitarists, Singer-songwriters from New York, Deaths from lymphoma, Musicians from New York City, Singers from New York City
Rashad Evans	Sportspeople from New York, American mixed martial artists, 1979 births, Living people
Georges St-Pierre	1981 births, Living people, Mixed martial artists, Sportspeople from Quebec
Trish Stratus	1975 births, Canadian models, Canadian professional wrestlers, Female professional wrestlers, Living people, People from Ontario, WWE Hall of Fame
Alberto Del Rio	1977 births, Living people, Mexican professional wrestlers, Mixed martial artists, San Luis Potosí, Former WWE wrestlers
Chris Masters	1983 births, American professional wrestlers, Living people, Sportspeople from California, People from Santa Monica, California
Starling	Passeri
Mirko Filipović	1974 births, Living people, Croatian sportspeople, Mixed martial artists, People from Zagreb
Giancarlo Volpe	American animators, 1974 births, Living people, People from Tacoma, Washington
Paramount Parks	Viacom, 1994 establishments in the United States, Companies of the United States, Theme park companies
Burbank, California	Burbank, California
NHS Alliance	Medical and health organizations in the United Kingdom
Cryolite	Minerals, Sodium compounds, Fluorine compounds
Aluminium fluoride	Fluorine compounds, Aluminium compounds
Hydrofluoric acid	Acids, Fluorine compounds
DR Movie	Anime
New York Comic Con	Entertainment in New York City, Festivals in the United States, Comics
Hexafluorosilicic acid	Acids
San Diego Comic-Con	Comics
Hydrogen fluoride	Fluorine compounds, Catalysts
Hydrogen halide	Hydrogen compounds
Hydrobromic acid	Acids, Bromine compounds
Hydrogen bromide	Bromine compounds
Hydrogen iodide	Acids, Iodine compounds
Seal script	Writing systems, Chinese language
Clerical script	Clerical script, Writing systems, Chinese language
Guzheng	Chinese music
Pipa	Chinese music
Royal charter	Law, Monarchy, Documents
Aluminium sulfate	Sulfur compounds, Aluminium compounds
George Grove	Musicologists, 1820 births, 1900 deaths
Thurston Dart	1921 births, 1971 deaths, Harpsichordists, Musicologists
Lend-Lease	Government of the United States, World War II
Huey Long	1893 births, 1935 deaths, American murder victims, American progressives, Deaths by firearm, Governors of Louisiana, Murders by firearm in the United States, United States senators from Louisiana, US Democratic Party politicians
Teapot Dome	History of Wyoming, Political scandals in the United States, Warren G. Harding, 1921 in the United States, 1922, 20th century in California
Air door	Temperature, Heat transfer
Phosphor	Light
Neon lamp	Lamps
Turbocharger	Motors, Aircraft engines
Lee Beom-seok (Prime Minister)	1900 births, 1972 deaths, People of the Korean War, Prime Ministers of South Korea
Sanat Naft F.C.	Iranian football clubs, 1972 establishments in Asia, 1970s establishments in Iran
Irreducible Mind	Non-fiction books, Parapsychology, Spiritual books, 2007 books
Aluminium Hormozgan F.C.	Iranian football clubs, 2006 establishments in Asia, 2000s establishments in Iran
Steel Azin F.C.	Iranian football clubs, Tehran, 2007 establishments in Asia, 2000s establishments in Iran
Saipa F.C.	Iranian football clubs, 1989 establishments in Asia, 1980s establishments in Iran
Persepolis F.C.	Iranian football clubs, Tehran, 1963 establishments in Asia, 1960s establishments in Iran
Persian Gulf Pro League	Football in Iran, Football leagues, 1970 establishments in Asia, 1970s establishments in Iran
Esteghlal F.C.	Iranian football clubs, Tehran, 1945 establishments in Asia, 1940s establishments in Iran
Disney Mickey's Magix	Breakfast cereals, Disney
Country Store	Breakfast cereals
Alum	Sulfur compounds
Budweiser Budvar	Beer, Czech culture
Song thrush	Thrushes
Potassium aluminium sulfate	Potassium compounds, Aluminium compounds
Ray Adduono	1947 births, Canadian ice hockey centres, Ice hockey people from Ontario, Living people, People from Thunder Bay, World Hockey Association players, American Hockey League players, Eastern Hockey League players
Turmeric	Zingiberales
Peter Bakovic	1965 births, Canadian ice hockey left wingers, Ice hockey people from Ontario, Living people, People from Thunder Bay, Vancouver Canucks players, American Hockey League players, International Hockey League (1945–2001) players, Ontario Hockey League players
Chrome alum	Potassium compounds, Sulfur compounds, Chromium compounds
Chromium(III) sulfate	Sulfur compounds, Chromium compounds
Gustavo Dudamel	1981 births, Living people, Conductors
William James	1842 births, 1910 deaths, American philosophers, American psychologists, Writers from New York City
Headlamp	Light sources
Shawn Horcoff	1978 births, Canadian ice hockey centres, Edmonton Oilers players, Ice hockey people from British Columbia, Living people, Swedish Hockey League players
Dan Hamhuis	1982 births, American Hockey League players, Canadian ice hockey defencemen, Canadian Olympic gold medalists, Dallas Stars players, Ice hockey people from British Columbia, Living people, Medalists at the 2014 Winter Olympics, Nashville Predators players, Prince George Cougars players, Vancouver Canucks players
V6 engine	Motors
Valtteri Filppula	1984 births, American Hockey League players, Detroit Red Wings players, Finnish ice hockey players, Living people, Olympic bronze medalists, Stanley Cup champions, Tampa Bay Lightning players, Vantaa, Ice hockey centres
Foolad F.C.	Iranian football clubs, 1973 establishments in Asia, 1970s establishments in Iran
Rah Ahan F.C.	Iranian football clubs, 1937 establishments in Asia, 20th century establishments in Iran
Saba Qom F.C.	Iranian football clubs, 2002 establishments in Asia, 2000s establishments in Iran
Sepahan Esfahan FC	Iranian football clubs, 1953 establishments in Asia, 20th century establishments in Iran
Mes Kerman F.C.	Iranian football clubs, 1998 establishments in Asia, 20th century establishments in Iran
Cam Neely	1965 births, Bill Masterton Memorial Trophy winners, Boston Bruins players, Canadian ice hockey right wingers, Ice hockey people from British Columbia, Living people, Portland Winterhawks players, Vancouver Canucks players, Memorial Cup winners
Notochord	Chordates, Animal anatomy, Developmental biology
Hurricane Diana	Hurricanes in Mexico
Hurricane Erin (1995)	Hurricanes in the United States, Hurricanes in Florida, 1995 Atlantic hurricane season, 1990s in Alabama, 1995 in Florida
Tropical Storm Alberto (1994)	Hurricanes in the United States, 1994 Atlantic hurricane season, 1994 in the United States, 1990s in Florida, 1990s in Georgia (U.S. state), 1990s in Alabama
Menai Strait	Anglesey, Geography of Wales, Straits
Zob Ahan Isfahan FC	Iranian football clubs, 1969 establishments in Asia, 1960s establishments in Iran
Paykan F.C.	Iranian football clubs, 1967 establishments in Asia, 1960s establishments in Iran
List of Team Umizoomi episodes	Lists of animated television series episodes
Hamish MacCunn	1868 births, 1916 deaths, 20th century composers, Romantic composers, British composers, Scottish people
List of herbs	Herbs, Food-related lists, Lists of plants
The Yogi Bear Show	Animated television series, Television shows about bears, English-language television programs, 1961 television series debuts, 1962 television series endings
REN21	Energy
Transverse engine	Automotive technologies
Longitudinal engine	Automotive technologies
Stawki (Toruń)	Toruń
Orange County, Florida	Florida counties, 1824 establishments in Florida Territory
Monroe County, Florida	Florida counties, 1823 establishments in the United States, 1820s establishments in Florida Territory
Indian River County, Florida	Florida counties, 1925 establishments in Florida
Gilchrist County, Florida	Florida counties, 1925 establishments in Florida
Santa Rosa County, Florida	Florida counties, 1842 establishments in the United States, 1840s establishments in Florida Territory
Escambia County, Florida	Florida counties, 1821 establishments in the United States, 1820s establishments in Florida Territory
Kauai County, Hawaii	Hawaii counties, 1905 establishments in Hawaii
Dimethylmercury	Mercury compounds
Ken Watanabe	1959 births, Living people, People with cancer, Cancer survivors, Japanese movie actors, Japanese television actors, Japanese stage actors, Japanese voice actors, People from Niigata Prefecture
Methyl	Biochemistry, Genetics
Inception	2010s action movies, 2010 crime movies, 2010 science fiction movies, American action movies, American crime movies, American science fiction movies, British action movies, British crime movies, British science fiction movies, Warner Bros. movies, IMAX movies, Movies composed by Hans Zimmer, Movies directed by Christopher Nolan, Movies about dreams, Movies set in California
Methyl iodide	Iodine compounds
Phosphorus(III) iodide	Phosphorus compounds, Iodine compounds
Carbon disulfide	Organic compounds, Sulfur compounds
Donovan Patton	1978 births, Living people, American voice actors, People from Guam
Gilded Age	19th century in the United States
Chemiluminescence	Chemical reactions, Light sources
Thilo Sarrazin	1945 births, Living people, Bankers, Civil servants, German politicians, German writers, Politicians from Thuringia, Politicians of the Social Democratic Party of Germany
The Turn of the Screw (opera)	Compositions by Benjamin Britten, 1950s operas, 1954
Demonic possession	Demons, Occult, Christian terminology
PAS Hamedan F.C.	Iranian football clubs, 2007 establishments in Asia, 2000s establishments in Iran
Malavan F.C.	Iranian football clubs, 1969 establishments in Asia, 1960s establishments in Iran
Cosworth	Ford, Formula One engine manufacturers, Formula One constructors, Formula One current, 1958 establishments in the United Kingdom
Carbon tetrachloride	Chlorine compounds, Greenhouse gases
Freon	Chemicals
Refrigerant	Chemicals
2010 Canterbury earthquake	2010s in New Zealand, Earthquakes in New Zealand, 2010 earthquakes, September 2010 events
William Langland	1330s births, 1380s deaths, English poets
Alexandra David-Néel	1868 births, 1969 deaths
Christ Church Cathedral, Oxford	Anglican Cathedrals, Cathedrals in England, Oxfordshire
Tattva	Hinduism, Sanskrit, Reality
Mahābhūta	Buddhism, Hinduism
Cyma Zarghami	1960s births, Living people, Nickelodeon
Coccyx	Bones
Småland	Provinces of Sweden
Åryd, Växjö municipality	Settlements in Kronoberg County
Typhoon Kompasu (2010)	2010 disasters in Asia, 2010 in weather, 2010s in Japan, 2010s in North Korea, 2010s in South Korea, August events, Disasters in Japan, Natural disasters in Asia, September 2010 events
Yu Myung-hwan	1946 births, Living people, South Korean politicians
Kosovo national football team	National football teams, Kosovo
Greenland national football team	Greenland, National football teams
Gibraltar national football team	National football teams, Gibraltar
The Vicar of Dibley	1994 British television series debuts, 2007 British television series endings, 1990s British sitcoms, 2000s British sitcoms, BBC television sitcoms, Oxfordshire, English-language television programs
Alphaville	New wave bands, Electronic music bands, German pop music groups, Münster
Emerald Coast	Geography of Florida
List of people from Florida	People from Florida, Lists of people by state in the United States, Florida-related lists
Iberian Cup	Football competitions
Chula Vista, California	Cities in California, Settlements in San Diego County, California
Supercalifragilisticexpialidocious	Linguistics, Long words
Nogales, Arizona	Cities in Arizona, County seats in Arizona
Mount Olivet Cemetery (Chicago)	Cemeteries in Chicago
Dominici	American heavy metal bands, Progressive rock bands, Musical groups from New York City
Pinball	Arcade games, Pinball video games
Avebury	Wiltshire, Buildings and structures in England, Archaeological sites in Wiltshire, World Heritage Sites in the United Kingdom, National Trust properties, Stone circles, Henges, Neolithic
Henge	Buildings and structures in Europe, Archaeological sites, Henges
Carnac stones	Prehistoric buildings and structures, Buildings and structures in France, Archaeological sites in France
Mike Douglas	1920 births, 2006 deaths, Television talk show hosts, Television personalities from Chicago
Muckrakers	American writers, American journalists
Renata Tebaldi	1922 births, 2004 deaths, Sopranos, Italian opera singers
Lincoln Heights Jail	Buildings and structures in Los Angeles, California, 1954 disestablishments, 1950s disestablishments in the United States, 20th-century disestablishments in California
Br'er Rabbit	Fictional hares and rabbits
Madison County, Florida	Florida counties, 1827 establishments in Florida Territory
Flag of Sweden	National flags, Sweden
Hisingen	Islands of Sweden
Göteborg City Airport	Airports in Sweden, Buildings and structures in Gothenburg
Nebraska Cornhuskers football	College football
Over-the-counter drug	Drugs
Fabian Washington	1982 births, Living people, Baltimore Ravens players, Oakland Raiders players, American football cornerbacks, Sportspeople from Florida
Heart of Neolithic Orkney	Prehistoric buildings and structures, Buildings and structures in Scotland, Archaeological sites in Scotland, World Heritage Sites in the United Kingdom, Orkney, Neolithic
Acrostic	Literary terms
List of literary terms	Literary terms, Glossaries
Stan Baluik	1935 births, Boston Bruins players, Canadian ice hockey centres, Golfers, Ice hockey people from Ontario, Living people, People from Thunder Bay, American Hockey League players
St Kilda	Inner and Outer Hebrides, World Heritage Sites in the United Kingdom, Biosphere reserves, Uninhabited regions
Barton Bradley	1930 births, 2006 deaths, Canadian ice hockey centres, Boston Bruins players, Ice hockey people from Ontario, People from Thunder Bay, American Hockey League players
Rick Bragnalo	1951 births, Living people, Canadian ice hockey centres, Ice hockey people from Ontario, People from Thunder Bay, Washington Capitals players, American Hockey League players, Ice hockey defencemen
Celestial navigation	Navigation, Astronomy
Bizaar	2000 albums, Insane Clown Posse albums
Hokus Pokus (Insane Clown Posse song)	Insane Clown Posse songs, 1997 songs
Ken Brown	1948 births, Canadian ice hockey goaltenders, Chicago Blackhawks players, Ice hockey people from Ontario, Living people, People from Thunder Bay, World Hockey Association players
David Bruce	1964 births, Canadian ice hockey left wingers, Ice hockey people from Ontario, Living people, People from Thunder Bay, San Jose Sharks players, St. Louis Blues players, Vancouver Canucks players
Vindolanda	Writing, Northumberland, Ancient Rome, Archaeological sites in England
Reincarnation research	Psychology, Psychiatry
Jim B. Tucker	Parapsychologists, American psychiatrists, American physicians, Living people, Year of birth missing (living people)
Twenty Cases Suggestive of Reincarnation	Non-fiction books, Parapsychology, 1974 books
Angiography	Medical imaging
Monk parakeet	Parakeets
Jean Cocteau	1889 births, 1963 deaths, Bisexual people, Cardiovascular disease deaths in France, Deaths from myocardial infarction, French artists, French LGBT people, French movie actors, French movie directors, French novelists, French poets, French playwrights, French screenwriters, LGBT actors, LGBT artists, LGBT directors, LGBT novelists, LGBT poets, LGBT playwrights, LGBT screenwriters, Librettists, Members of the Académie française
Ron Busniuk	1948 births, Buffalo Sabres players, Canadian ice hockey centres, Ice hockey people from Ontario, Living people, People from Thunder Bay, World Hockey Association players, American Hockey League players
Samantha Cameron	Businesspeople from London, British philanthropists, Spouses of Prime Ministers of the United Kingdom, 1971 births, Living people
Larry Cahan	1933 births, 1992 deaths, Canadian ice hockey defencemen, Ice hockey people from Ontario, Los Angeles Kings players, New York Rangers players, Oakland Seals players, People from Thunder Bay, Toronto Maple Leafs players, World Hockey Association players, American Hockey League players
Şehrazat	1952 births, Living people, Turkish singers, Songwriters, People from Ankara
Sodium azide	Sodium compounds, Nitrogen compounds
Hydrazine	Nitrogen compounds
Azide	Nitrogen compounds
Hydrazoic acid	Acids, Nitrogen compounds
Sodium nitrite	Sodium compounds, Nitrogen compounds
Nitrite	Nitrogen compounds
Lithium nitride	Lithium compounds, Nitrogen compounds
Nitrous acid	Acids, Nitrogen compounds
Arteriosclerosis	Diseases and disorders of the cardiovascular system
Indian Grand Prix	Formula One Grands Prix
Georges Braque	1882 births, 1963 deaths, French painters, French sculptors
Vaslav Nijinsky	1890 births, 1950 deaths, Ballet dancers, Ballets Russes, Bisexual people, Burials at Montmartre Cemetery, Paris, LGBT choreographers, LGBT dancers, People from Kiev, People with schizophrenia, Russian LGBT people
Nitric oxide	Nitrogen compounds, Oxides
Nitrogen dioxide	Nitrogen compounds, Oxides
Kansas City, Kansas	County seats in Kansas, Kansas City, Kansas, 1868 establishments in Kansas
Dinitrogen tetroxide	Nitrogen compounds, Oxides
Dinitrogen pentoxide	Nitrogen compounds, Oxides
Nitrogen trichloride	Nitrogen compounds, Chlorine compounds
Hypochlorous acid	Acids, Chlorine compounds
Sodium amide	Sodium compounds, Nitrogen compounds
Amide	Nitrogen compounds, Functional groups
Sodium nitrate	Sodium compounds, Nitrogen compounds
Lead azide	Chemical compounds
History of Iran	History of Iran
Cobalt(II) chloride	Chlorine compounds, Cobalt compounds
Man of the match	FIFA World Cup
Prohibition Era	1920 establishments in the United States, 1933 disestablishments, 1920s in the United States, 1930s in the United States, Alcohol drinking habits, United States law, 1930s disestablishments in the United States
Cobalt(II) oxide	Cobalt compounds, Oxides
Cobalt(II) hydroxide	Cobalt compounds
Cobalt(III) oxide	Cobalt compounds, Oxides
Cobalt(II) sulfate	Sulfur compounds, Cobalt compounds
Meccano	Toys
Monoclonius	Ceratopsids
Gordini	Formula One constructors, Formula One engine manufacturers
Popish Plot	17th century in England, 1678, 1679, 1680, 1681, 1680s in Europe
Cobalt(II,III) oxide	Cobalt compounds, Oxides
Ramsar Convention	Treaties and Conventions, Ramsar sites
Cobalt(II) fluoride	Cobalt compounds, Fluorine compounds
Cobalt(III) fluoride	Cobalt compounds, Fluorine compounds
Eyeborg	Vision
Christian Dior	1905 births, 1957 deaths, French fashion designers, French fashion houses
Baluchistan Agency	British India
Ferromanganese	Alloys
Manganese(VII) oxide	Manganese compounds
Manganese(II) sulfate	Sulfur compounds, Manganese compounds
Poolsbrook	Towns in Derbyshire
Food and Drug Administration	United States government agencies
Homalocephale	Pachycephalosauria
Pachyrhinosaurus	Ceratopsids
Arnhem Land	Geography of the Northern Territory, Indigenous peoples of Australia, Regions of Australia
Rubinkowo	Toruń
Motorola DynaTAC	Telephone
Kaszczorek	Toruń
Joseph Banks	1743 births, 1820 deaths, English naturalists, English botanists, English explorers, Fellows of the Royal Society, Presidents of the Royal Society, Knights Grand Cross of the Order of the Bath, Baronets
Church of Christ with the Elijah Message	Mormonism
Petticoat	Underwear
Paul the Octopus	Cephalopods, Individual animals, FIFA World Cup, Oberhausen
St. Xavier High School (Cincinnati)	Cincinnati, Ohio, Schools in Ohio, 1831 establishments in Ohio
Gianni Versace	1946 births, 1997 deaths, Gay men, Italian businesspeople, Italian fashion designers, Italian LGBT people, Italian murder victims, LGBT fashion designers, Murders by firearm in Florida, People from Calabria
Comilla District	Districts of British India, Districts of East Pakistan, Districts of Bangladesh
Mymensingh District	Districts of British India, Districts of East Pakistan, Districts of Bangladesh
Jessore District	Districts of East Pakistan, Districts of Bangladesh
Khulna District	Districts of British India, Districts of East Pakistan, Districts of Bangladesh
Bogra District	Districts of East Pakistan, Districts of Bangladesh
Dinajpur District	Districts of East Pakistan, Districts of Bangladesh
Rajshahi District	Districts of British India, Districts of East Pakistan, Districts of Bangladesh
Rangpur District	Districts of Bangladesh
Sylhet District	Districts of Bangladesh
Variations on a Rococo Theme	Compositions by Pyotr Ilyich Tchaikovsky, Concertos, Variations (music)
Gravity assist	Physics
Heliosphere	Solar System
Pakistani nationalism	Pakistani culture, Nationalism
Blest Pair of Sirens	Compositions by Hubert Parry, Choral compositions
Albany, Oregon	Cities in Oregon, County seats in Oregon
Kutchi people	Ethnic groups in Sindh
Uruk	Mesopotamia, History of Iraq
Tennis elbow	Tennis
Non-steroidal anti-inflammatory drug	Analgesics
Night of Champions (2010)	2010 in professional wrestling, WWE Night of Champions, Sports in Chicago, Illinois, 2010 in Illinois, September 2010 events
Diclofenac	Analgesics
Bullpup	Bullpup rifles
Nippur	Archaeological sites in Iraq, Mesopotamia
Bhirdana	Villages in India, Settlements in Haryana
Vassily Ivanchuk	1969 births, Living people, Ukrainian chess players, Chess grandmasters
Dmitry Jakovenko	1983 births, Living people, Russian chess players, Chess grandmasters
Vladimir Malakhov	1980 births, Living people, Russian chess players, Chess grandmasters
David Guetta	1967 births, Living people, DJs, French businesspeople, French pop singers, Grammy Award winners, Jewish businesspeople, Jewish French musicians, Musicians from Paris, Record producers
Kevin Durant	1988 births, African-American basketball players, Living people, Seattle SuperSonics players, Oklahoma City Thunder players, Golden State Warriors players, Sportspeople from Washington, D.C., Brooklyn Nets Players, American basketball players
Manganese(III) oxide	Manganese compounds, Oxides
Manganese(III) fluoride	Manganese compounds, Fluorine compounds
Manganese(II) fluoride	Manganese compounds, Fluorine compounds
Manganese(IV) fluoride	Manganese compounds, Fluorine compounds
Res Gestae Divi Augusti	History books, Autobiographies
Potassium fluoride	Potassium compounds, Fluorine compounds
Goy	Words
Sodium permanganate	Sodium compounds, Manganese compounds
Manganate	Manganates
Battle of the Catalaunian Plains	Battles of the Ancient World, 451, History of France
Greek fire	Incendiary weapons
Siphonophore	Cnidarians
Potassium manganate	Potassium compounds, Manganese compounds, Manganates
Sodium manganate	Sodium compounds, Manganese compounds, Manganates
Hypomanganate	Manganese compounds
Potassium hypomanganate	Potassium compounds, Manganese compounds, Manganates
Potassium sulfite	Potassium compounds, Sulfur compounds
Ray Ceresino	1929 births, 2015 deaths, Canadian ice hockey left wingers, Ice hockey people from Ontario, People from Thunder Bay, Toronto Maple Leafs players
Tom Cook	1907 births, 1961 deaths, American Hockey Association (1926–42) players, American Hockey League players, Canadian ice hockey centres, Chicago Blackhawks players, Ice hockey people from Ontario, Montreal Maroons players, People from Thunder Bay, Stanley Cup champions
Dave Creighton	1930 births, 2017 deaths, Boston Bruins players, Canadian ice hockey forwards, Chicago Blackhawks players, Ice hockey people from Ontario, New York Rangers players, People from Thunder Bay, Toronto Maple Leafs players, American Hockey League players, Ice hockey centres
Frank Daley	1909 births, 1968 deaths, Canadian ice hockey left wingers, Detroit Cougars players, Ice hockey people from Ontario, People from Thunder Bay, Ice hockey centres
Reg Noble	1896 births, 1962 deaths, Canadian ice hockey centres, Detroit Cougars players, Detroit Falcons players, Detroit Red Wings players, Hockey Hall of Fame inductees, Montreal Canadiens (NHA) players, Montreal Maroons players, Ice hockey people from Ontario, Stanley Cup champions, Toronto Arenas players, Toronto Blueshirts players, Toronto St. Pats players, Ontario Hockey League players
Larry Aurie	1905 births, 1952 deaths, American Hockey League players, Canadian ice hockey right wingers, Detroit Cougars players, Detroit Falcons players, Detroit Red Wings players, Ice hockey people from Ontario, Ontario Hockey League players, Stanley Cup champions
Hurricane Gloria	1985 in the United States, Hurricanes in New York, Hurricanes in New England, Hurricanes in North Carolina, Hurricanes in Virginia, 1980s in North Carolina, 1980s in New York (state), 1985 in Canada
Amherst, Nova Scotia	Towns in Nova Scotia
Immune system	Immunology
Sulfur hexafluoride	Sulfur compounds, Fluorine compounds, Greenhouse gases
Disulfur decafluoride	Sulfur compounds, Fluorine compounds
List of Formula One Grand Prix winners	Formula One current, Formula One lists
Turdidae	Thrushes, Passeriformes
Paridae	Passeriformes
Sulfur tetrafluoride	Sulfur compounds, Fluorine compounds
Sulfur dichloride	Sulfur compounds, Chlorine compounds
Disulfur dichloride	Sulfur compounds, Chlorine compounds
Tetrasulfur tetranitride	Sulfur compounds, Nitrogen compounds
Disulfur dinitride	Sulfur compounds, Nitrogen compounds
I puritani	Operas, Compositions by Vincenzo Bellini
La sonnambula	Operas, Compositions by Vincenzo Bellini
Mary Quant	British fashion designers, Members of the Order of the British Empire, People from London, 1934 births, Living people
Roméo et Juliette	Operas
Roberta Peters	1930 births, 2017 deaths, American opera singers, Deaths from Parkinson's disease, Disease-related deaths in New York, Singers from New York City, Sopranos
Hannibal Alkhas	1930 births, 2010 deaths, Assyrian people, Iranian people
Blue tit	Passeriformes
Crow	Corvids
Silver(I) sulfide	Sulfur compounds, Silver compounds
Silver nitrate	Silver compounds, Nitrogen compounds
Smokey Bear	Safety, Mascots, Forestry
Burt Munro	1899 births, 1978 deaths, New Zealand sportspeople
Lilongwe River	Rivers of Africa, Geography of Malawi
Finch	Finches
Third way	Political philosophy
Silver(II) fluoride	Fluorine compounds, Silver compounds
Katrina cottage	Houses in the United States, Hurricane Katrina
Silver(I) fluoride	Fluorine compounds, Silver compounds
Silver(I) carbonate	Silver compounds
Silver chloride	Silver compounds, Chlorine compounds
Silver bromide	Silver compounds, Bromine compounds
Potassium bromide	Potassium compounds, Bromine compounds
Silver iodide	Silver compounds
Kasana	Ethnic groups in Asia, Ethnic groups in Afghanistan, Ethnic groups in India, Ethnic groups in Pakistan
Drosera regia	Caryophyllales
Traction motor	Motors, Locomotives, Vehicles, Electricity
Green tree python	Pythons
Ohm	SI units, Electricity
Cathedral Prep Events Center	Buildings and structures in Pennsylvania, Stadiums in the United States, Erie, Pennsylvania, 2010 establishments in the United States, 2010s establishments in Pennsylvania
Quotation mark	Punctuation, Typography
Haute couture	Fashion, Paris
Joanna Newsom	1982 births, Living people, Singers from California, Musicians from California
When Night Is Falling	1995 LGBT movies, 1995 romance movies, 1995 drama movies, 1990s romantic drama movies, Canadian romance movies, Canadian drama movies, English-language movies, Canadian LGBT movies
Hurricane Bob	Hurricanes in New York, 1991 in the United States, 1991 in Canada, 1990s in North Carolina, Hurricanes in New England, Hurricanes in North Carolina
Nithing pole	Magic (paranormal)
Imber	Villages in Wiltshire
Emoticon	Internet culture, Internet slang, Symbols
Trough (geology)	Landforms
Innuendo	Comedy, Rhetoric
Wikiatlas	Cartography, Wikis, Wikimedia Foundation
Copper(II) nitrate	Copper compounds, Nitrogen compounds
Orogeny	Earth sciences, Orogenies
Ethnic groups of the United States	Ethnic groups in the United States
List of Formula One Grand Prix winners (constructors)	Formula One current, Formula One lists
Maylene and the Sons of Disaster	2000s American music groups, 2010s American music groups, American heavy metal bands, Christian rock bands, Nu metal bands, Post-hardcore bands, Metalcore bands, Musical groups from Alabama, Entertainers from Birmingham, Alabama
South African Grand Prix	Formula One Grands Prix
Seaside Heights, New Jersey	Boroughs in New Jersey, Ocean County, New Jersey
Tumblr	2007 establishments in the United States, Organizations in New York City, Websites
Meg Whitman	1956 births, Living people, Republicans (United States), American billionaires, People from California
Nicki Minaj	Nicki Minaj, 1982 births, Living people, American rap musicians from New York, American R&B singers, Musicians from Queens, Singers from New York City, Trinidad and Tobago people
Red billed Quelea	Quelea quelea, Passeriformes
Portuguese Grand Prix	Formula One Grands Prix
Argentine Grand Prix	Formula One Grands Prix
Sort (typesetting)	Typography, Typesetting
Bayes' theorem	Mathematics
Salisbury Plain	Wiltshire, Plateaus
Hot pants	1960s, Trousers and shorts
Mini-skirt	1960s, Clothing
Austrian Grand Prix	Formula One Grands Prix
Lucretia Mott	1793 births, 1880 deaths, People from Massachusetts, Quakers
Luxembourg Grand Prix	Formula One Grands Prix
Mexican Grand Prix	Formula One Grands Prix, 1962 establishments in North America, 1960s establishments in Mexico, 1992 disestablishments, 1990s disestablishments in North America, 20th century disestablishments in Mexico
Moroccan Grand Prix	Formula One Grands Prix, Casablanca, 1925 establishments, 20th-century establishments in Morocco, 1958 disestablishments, 20th-century disestablishments in Africa
Typesetting	Typography, Typesetting
Swinging London	1960s in the United Kingdom, British culture, Fashion, London
Tosca	Compositions by Giacomo Puccini, operas
Manon Lescaut	operas
Caesars Palace Grand Prix	Formula One Grands Prix, 1981 in sports, 1982 in sports, 1981 in the United States, 1982 in the United States, 20th century in Nevada
Kakadu National Park	Protected areas of the Northern Territory, Ramsar sites, Australian National Heritage List, World Heritage Sites in Australia, National parks in Australia, 1979 establishments in Australia
Detroit Grand Prix	Formula One Grands Prix, Detroit, Michigan, 1982 establishments in the United States, 1980s establishments in Michigan, 1988 disestablishments in the United States, 20th-century disestablishments in Michigan
Dallas Grand Prix	Formula One Grands Prix
United States Grand Prix West	Formula One Grands Prix, Long Beach, California, 1976 establishments in California, 1983 disestablishments in the United States, 1980s disestablishments in California
Pilsner Urquell	Beer, Czech culture
Swiss Grand Prix	Formula One Grands Prix
Swedish Grand Prix	Formula One Grands Prix
Coppa Acerbo	Formula One Grands Prix
Pacific Grand Prix	Formula One Grands Prix
Anna Bolena	Compositions by Gaetano Donizetti, Operas
Copper(II) carbonate	Copper compounds, Carbonates
Copper(II) hydroxide	Copper compounds
Copper(II) oxide	Copper compounds, Oxides
Copper(II) sulfate	Sulfur compounds, Copper compounds
Cooper Tire & Rubber Company	Companies of the United States, Automobiles, 1926 establishments in the United States, 20th-century establishments in Ohio
Copper(I) chloride	Chlorine compounds
Alex Delvecchio	1931 births, Canadian ice hockey centres, Detroit Red Wings players, Hockey Hall of Fame inductees, Ice hockey people from Ontario, Lady Byng Memorial Trophy winners, Living people, People from Thunder Bay, Stanley Cup champions, Ontario Hockey League players
Copper(II) chloride	Copper compounds, Chlorine compounds
Copper(I) oxide	Copper compounds, Oxides
Copper(I) acetylide	Copper compounds
Illinois State University	Colleges and universities in Illinois, Missouri Valley Conference, Missouri Valley Football Conference, 1857 establishments in the United States, 1850s establishments in Illinois
Acetylide	Chemical compounds
Bridgestone	Companies of Japan, Tire manufacturers, 1931 establishments in Asia, 1930s establishments in Japan
Abstraction	Thought, Problem solving, Creativity
Eye makeup	Cosmetics, Body art
Indy Racing League	IndyCar Series
Open wheel car	Auto racing
Speech and language therapist	Healthcare occupations
Semi-automatic shotgun	Shotguns
Macintosh Classic	Computers, Apple hardware
IndyCar Series	1996 establishments, IndyCar Series
Clint Bowyer	1979 births, Living people, American racecar drivers, NASCAR drivers
Space opera	Science fiction
Inland taipan	Elapidae
Cosmological argument	Theology
Charles Worth	1825 births, 1895 deaths, British fashion designers, People from Lincolnshire, Paris, French fashion houses, English businesspeople
Stagecoach	Public transport, Animal-powered vehicles
Firestone Tire and Rubber Company	Tire manufacturers, Nashville, Tennessee, 1900 establishments in the United States, 20th-century establishments in Tennessee
Conservatives in the United States	Lists of American people, Lists of politicians from the United States, Conservatism
High heels	Footwear
Garage Days Re-Revisited	Metallica albums
Leontyne Price	Sopranos, Kennedy Center honorees, American opera singers, Singers from Mississippi, 1927 births, Living people
Il trovatore	Operas, Operas set in Spain, Compositions by Giuseppe Verdi
Gangrene	Symptoms, Medical signs
Dirk Hartog	1580 births, 1621 deaths, History of Australia, Exploration of Australia, Dutch explorers, People from Amsterdam
Hair follicle	Hair, Skin
Pirelli	Companies of Italy, Tire manufacturers
Ball (dance)	Dance, Social events
Robin Warren	1937 births, Living people, Australian medical doctors, Australian educators, Australian medical researchers, People from Adelaide, Scientists from South Australia, Australian Nobel Prize winners, Nobel Prize in Physiology or Medicine winners, Order of Australia, University of Adelaide alumni
University of Western Australia	Colleges and universities in Australia, Buildings and structures in Perth, Western Australia, 1911 establishments, 1910s establishments in Australia
Nobel Foundation	Nobel Prize, 1900 establishments
Gastritis	Diseases, Diseases and disorders of the digestive system
Susan Greenfield	1950 births, Living people, Commanders of the Order of the British Empire, Legion of Honour, Scientists from London, Writers from London, United Kingdom Life Peers, Pharmacologists, Members of the House of Lords
Sébastien Bourdais	1979 births, Living people, French sportspeople, Formula One drivers, 24 Hours of Le Mans drivers, IndyCar Series drivers
W. Edwards Deming	1900 births, 1993 deaths, American academics, American engineers, People from Sioux City, Iowa, Scientists from Iowa, Yale University alumni
Yo-yo	Toys
Government of Australia	Government of Australia
Met Office	Government agencies of the United Kingdom, Weather services
Statistical process control	Management
Consultant	Occupations
The Lesser Polish Way of Saint James	Poland
Carnarvon, Western Australia	Towns in Western Australia
Postcodes in Australia	Transport in Australia, Postal codes
The Medical Journal of Australia	Medicine, Newspapers published in Australia, Journals
Statistician	Occupations
Kung Fu Panda 2	2011 animated movies, 2011 comedy movies, 2010s 3D movies, 2010s action comedy movies, American animated movies, American action comedy movies, Computer-animated movies, Movies composed by Hans Zimmer, Kung Fu Panda
Christian Klien	Living people, 1983 births, Austrian sportspeople, Formula One drivers, Formula One current, 24 Hours of Le Mans drivers
Doabi	Languages of India, Punjabi language
Alan Rickman	1946 births, 2016 deaths, Actors from London, BAFTA Award winning actors, Cancer deaths in London, Deaths from pancreatic cancer, Emmy Award winning actors, English movie actors, English stage actors, English television actors, English voice actors, Golden Globe Award winning actors
Aram Khachaturian	1903 births, 1978 deaths, Russian composers, People from Tbilisi
Stanford prison experiment	Psychology, Imprisonment and detention, Experiments
Alvin and the Chipmunks	Animated characters, 1950s American music groups, Children's musical groups, Grammy Award winners, Musical groups from California, 1958 establishments in the United States, Musical groups established in 1958, Musical groups disestablished in the 1970s, 1972 disestablishments in the United States, Musical groups established in 1979, 1979 establishments in California, 1950s establishments in California, 1970s disestablishments in California, American Music Awards, Alvin and the Chipmunks (franchise)
Alvin and the Chipmunks (movie series)	Alvin and the Chipmunks movies, English-language movies, 20th Century Fox movies, Series of movies
Acanthaceae	Acanthaceae
Gesneriaceae	Lamiales
Novella	Literature
Bignoniaceae	Bignoniaceae
Super Aguri F1	Formula One constructors
Compromise	Communication
Visionary	Spirituality
Ted Nelson	American sociologists, American philosophers, People from New York City, 1937 births, Harvard University alumni, Living people
Gunnysacking	Dispute resolution, Metaphors
Conflict resolution	Dispute resolution, Conflicts, War
Bent Larsen	1935 births, 2010 deaths, Chess grandmasters, Danish people
Google Search	Google, Search engines
Fade (audio engineering)	Sound
Centenary Medal	Orders, decorations, and medals of Australia, 2001, 2000s in Australia
Backspace	Computers, Control characters
Australian Sports Medal	Sport in Australia, Orders, decorations, and medals of Australia, 2000 in Australia
Marin Mersenne	1588 births, 1648 deaths, French mathematicians, French Roman Catholics, French theologians
Land Transport Authority	Transport in Singapore
Usage share of web browsers	Web browsers
Quatour pour la fin du temps	Chamber music compositions
National parks of New Zealand	National parks by country, National parks in Oceania, Geography of New Zealand, Lists of national parks, Oceania-related lists
Plumbaginaceae	Caryophyllales
Polygonaceae	Caryophyllales
Eschborn	Towns in Hesse
Rudy Rucker	1946 births, American science fiction writers, Living people, American computer scientists, Writers from Louisville, Kentucky, Scientists from Kentucky
Tinamou	Ratites, Birds
Gaussian distribution	Probability distributions
List of Latin phrases	Latin words and phrases, Language-related lists
Musette	Woodwind instruments
Gram-Schmidt process	Algebra
List of Latin phrases (I)	Latin words and phrases, Language-related lists
List of Latin phrases (A)	Latin words and phrases, Language-related lists
Pigeonhole principle	Computer science, Mathematics
Nickel (coin)	Currency of the United States
Federal Deposit Insurance Corporation	Government of the United States
Vehicle insurance	Insurance
Umbrella insurance	Insurance, Business
Argument from false premises	Deception, Logical fallacies
Nichrome	Alloys
Cupronickel	Alloys
List of Latin phrases (B)	Latin words and phrases, Language-related lists
List of Latin phrases (C)	Latin words and phrases, Language-related lists
Nickel(II) oxide	Nickel compounds, Oxides
Margaret Cho	Actors from San Francisco, LGBT people from California, American movie actors, American television actors, American television producers, American television writers, American voice actors, Bisexual people, Comedians from California, LGBT actors, LGBT comedians, LGBT writers, Writers from San Francisco, 1968 births, Living people
Goodluck Jonathan	1957 births, Living people, Presidents of Nigeria
List of Latin phrases (D)	Latin words and phrases, Language-related lists
Nicaraguan Sign Language	Nicaragua, Sign languages
Nickel(II) nitrate	Nitrogen compounds, Nickel compounds
Nickel(II) chloride	Chlorine compounds, Nickel compounds
Facial composite	Criminal justice, Law enforcement techniques
Nickel(II) hydroxide	Nickel compounds
Baitul Futuh Mosque	2003 establishments in England, Buildings and structures in London, London Borough of Merton, Mosques
Nickel(II) carbonate	Nickel compounds, Carbonates
Nickel(II) sulfate	Sulfur compounds, Nickel compounds
Frogger	1981 video games, Sega arcade games
São Carlos Futebol Clube	Football clubs in São Paulo (state), 2004 establishments, 2000s establishments in Brazil
Grêmio Esportivo Sãocarlense	Football clubs in São Paulo (state), 1976 establishments in Brazil
Johann Strauss III	1866 births, 1939 deaths, Austrian composers
Carlos Slim	Billionaires, Mexican businesspeople, Christians, People from Mexico City, 1940 births, Living people
Pandanales	Monocots
Nymphaeales	Nymphaeales
List of Latin phrases (E)	Latin words and phrases, Language-related lists
Crossroads	2002 movies, American drama movies, Britney Spears, English-language movies
John Bednarski	1952 births, American Hockey League players, Canadian ice hockey defencemen, Edmonton Oilers players, Ice hockey people from Ontario, Living people, New York Rangers players, People from Thunder Bay
Lee Fogolin, Sr.	1926 births, 2000 deaths, Canadian ice hockey defencemen, Chicago Blackhawks players, Detroit Red Wings players, Ice hockey people from Ontario, People from Thunder Bay, Stanley Cup champions
Dave Gatherum	1932 births, American Hockey League players, Canadian ice hockey goaltenders, Detroit Red Wings players, Ice hockey people from Ontario, Living people, People from Thunder Bay, Stanley Cup champions
Pete Goegan	1934 births, 2008 deaths, Canadian ice hockey defencemen, Detroit Red Wings players, Ice hockey people from Ontario, New York Rangers players, Minnesota North Stars players, People from Thunder Bay, American Hockey League players
Haijima Station	Railway stations in Tokyo, 1894 establishments, 1890s establishments in Asia, 19th century establishments in Japan
Nagareyama-ōtakanomori Station	Railway stations in Chiba Prefecture
European Coal and Steel Community	History of Europe, 1957 establishments in Europe, 2002 disestablishments in Europe
Toner	Printers
Three Choirs Festival	Music festivals in England, 18th century establishments in England, August events
Worcester Cathedral	Anglican Cathedrals, Cathedrals in England, Worcester, Benedictine abbeys
Formula One Grand Prix	Formula One Grands Prix
Harpy eagle	Accipitriformes
Quadrivium	Liberal arts, Cultural history
Croke Park	Stadiums in Europe, Buildings and structures in Dublin, Irish War of Independence, Sport in Dublin, 1870 establishments in Europe, 19th century establishments in the Republic of Ireland
Iron(III) nitrate	Nitrogen compounds, Iron compounds
Ain-Diab Circuit	Formula One circuits, 1957 establishments in Africa, 20th-century establishments in Morocco
Beau Brummell	1778 births, 1840 deaths, People from London, Fashion
John Nash (architect)	English architects, 1752 births, 1835 deaths
Right to education	Human rights, Education
Global Hunger Index	Hunger
The School of Athens	16th century paintings
GP2 Series	GP2
Hacavitz	Death metal bands, Mexican musical groups, 2003 in music, Musical groups established in 2003, 2000s establishments in Mexico, Musical groups disestablished in 2010, 2010 disestablishments in Mexico, Musical groups established in 2011, 2010s establishments in Mexico
Patient	Medicine
Grouse	Galliformes
Abhisit Vejjajiva	1964 births, Living people, Alumni of the University of Oxford, Economists, Prime Ministers of Thailand
Formula Two	Formula Two, 1967 establishments
Lechites	Slavic peoples
Zinc hydroxide	Zinc compounds
Zinc phosphate	Phosphorus compounds, Zinc compounds
Zinc bromide	Zinc compounds
Barium bromide	Barium compounds
Zinc iodide	Zinc compounds, Iodine compounds
Zinc fluoride	Zinc compounds, Fluorine compounds
Zinc nitrate	Nitrogen compounds, Zinc compounds
Smithsonite	Minerals, Zinc compounds, Carbonates
Zinc sulfate	Sulfur compounds, Zinc compounds
Zinc sulfide	Sulfur compounds, Zinc compounds
Zinc oxide	Zinc compounds, Oxides
Kazuki Nakajima	1985 births, Living people, Japanese racecar drivers, Formula One drivers, GP2 Series drivers, People from Aichi Prefecture
Melissa Etheridge	1961 births, Living people, American feminists, American LGBT people, American LGBT rights activists, American rock singers, Singers from Kansas, Best Original Song Academy Award-winning songwriters, Breast cancer survivors, Grammy Award winners, Lesbian feminists, LGBT singers, People from Leavenworth, Kansas, LGBT songwriters, Musicians from Kansas
List of The Fairly OddParents episodes	Lists of animated television series episodes
Helen Reddy	1941 births, 2020 deaths, Deaths from dementia, Australian movie actors, Australian voice actors, Australian television actors, Australian singers, Actors from Melbourne, Musicians from Melbourne, Australian pop musicians
Tropical Storm Allison (1989)	Hurricanes in Texas, 1989 in Texas, 1980s in Louisiana, Hurricanes in Louisiana
Hurricane Celia	Hurricanes in the United States, 1970 in the United States, 1970s in Texas
Carole King	1942 births, Living people, American pianists, American rock musicians, American rock singers, Grammy Award winners, Musicians from Brooklyn, Musicians from Manhattan, Rock and Roll Hall of Fame inductees, Singers from New York City, Singer-songwriters from New York City
Hurricane Connie	Hurricanes in the United States
Rhenock	Towns in India, Settlements in Sikkim
Deekshabhoomi	Buddhism, Hinduism, B. R. Ambedkar, Maharashtra, Buddhist temples
Gamestar	Video game magazines, Germany
Rhinoceros hornbill	Coraciiformes
Oystercatcher	Charadriiformes
Kart racing	Auto racing
Deutsche Mark	Former currencies of Europe, Economy of Germany, 1948 establishments in Germany, 2002 disestablishments in Europe, 2000s disestablishments in Germany
Blue Byte Software	Video game companies, Düsseldorf, Companies of Germany, 1988 establishments in Europe, 1980s establishments in Germany
Bristlemouth	Ray-finned fish
Black-headed Weaver	Passeriformes
Rufous Hornero	Passeriformes
Scarlet tanager	Passeri
Western Grebe	Podicipediformes
Messier catalogue	Astronomical catalogues
Barium sulfide	Sulfur compounds, Barium compounds
Plasmodium	Protozoa, Parasites
Barium peroxide	Barium compounds
Peroxide	Chemical compounds
Barium oxide	Barium compounds, Oxides
Barium nitrate	Nitrogen compounds, Barium compounds
Barium hydroxide	Barium compounds
Barium carbonate	Barium compounds, Carbonates
Barry Goldwater	American conservatives, Cardiovascular disease deaths in Arizona, Deaths from stroke, People with Alzheimer's disease, People from Prescott, Arizona, Politicians from Phoenix, Arizona, 1960 United States presidential candidates, 1964 United States presidential candidates, United States senators from Arizona, US Republican Party politicians, 1909 births, 1998 deaths
Chris Ivory	1988 births, Living people, New Orleans Saints players, American football running backs, Sportspeople from Texas
Ad Council	Advertising, Non-profit organizations of the United States, 1941 establishments in the United States
Mobile Suit Gundam 00	2008 anime television series, Manga
Jean Piaget	Swiss psychologists, Swiss scientists, 1896 births, 1980 deaths
Dale Winton	1955 births, 2018 deaths, Actors from London, BBC radio presenters, BBC television presenters, British radio personalities, English LGBT people, English television actors, English television presenters, Gay men, LGBT actors, LGBT broadcasters, ITV presenters, Radio personalities from London
Shikoku	Islands of Japan, Shikoku region
Naruto, Tokushima	Cities in Shikoku, Settlements in Tokushima Prefecture
Alxasaurus	Coelurosaurs
Spiral galaxy	Spiral galaxies
Terry Buck	Accidental deaths in Australia, Sportspeople from Sydney, 1943 births, 2005 deaths
Edwin Hubble	1889 births, 1953 deaths, Cosmology, American astronomers, Scientists from Missouri
Act (drama)	Performing arts
Nationalization	Government, Commerce
Starfighter	Spacecraft, Science fiction
Intellivision	Video game consoles
Empire State of Mind	2009 songs, Alicia Keys, Jay-Z songs, New York City
Indianapolis Motor Speedway	NASCAR tracks, Formula One circuits, Buildings and structures in Indiana, 1909 establishments in the United States, 20th-century establishments in Indiana, IndyCar Series tracks
Kōchi Prefecture	Kōchi Prefecture, Prefectures of Japan
First person (video games)	Video game design
One-child policy	People's Republic of China, Population
2010 Commonwealth Games	2010 in India, Commonwealth Games, Delhi, October 2010 events
Dad's Army	1968 television series debuts, 1977 disestablishments in Europe, 1960s British television series, 1960s sitcoms, 1970s British sitcoms, BBC television sitcoms, 1970s disestablishments in the United Kingdom, English-language television programs
Card game	Card games
Kelantan	States of Malaysia
Malacca	States of Malaysia
Negeri Sembilan	States of Malaysia
Pahang	States of Malaysia
Perak	States of Malaysia
Perlis	States of Malaysia
Sabah	States of Malaysia
Sarawak	States of Malaysia
Terengganu	States of Malaysia
Labuan	Geography of Malaysia, Federal Territories of Malaysia
Putrajaya	Cities in Malaysia, Federal Territories of Malaysia
Counter-terrorism	Security, Terrorism, Police
Boraginaceae	Boraginaceae
Capparaceae	Capparaceae
History of astronomy	Astronomy
Six Feet Under	2001 American television series debuts, 2005 American television series endings, 2000s American television series, American comedy-drama television series, Golden Globe Award winning programs, HBO television series, Screen Actors Guild Award winners, Television series set in California, English-language television programs
Uppercut	Martial art techniques, Boxing
Chlorite	Chlorine compounds
Chlorous acid	Acids, Chlorine compounds
Sodium chlorite	Sodium compounds, Chlorine compounds
Chloric acid	Acids, Chlorine compounds
Barium chlorate	Chlorine compounds, Barium compounds
Ammonium chlorate	Nitrogen compounds, Chlorine compounds
Ammonium carbonate	Nitrogen compounds, Carbonates
Ammonium nitrate	Nitrogen compounds
Chlorine dioxide	Chlorine compounds, Oxides
Potassium perchlorate	Potassium compounds, Chlorine compounds
Fashion accessory	Accessories
Corrymeela Community	Northern Ireland
Trip hop	Trip hop, Electronic music, Electronic dance music
Big beat	Dance music
Pact of Steel	1930s treaties, Nazi Germany, 1930s in Italy, 1939
Firing squad	Capital punishment
Client state	International relations
Panties	Underwear
Alan Jackson	1958 births, Living people, Singers from Georgia (U.S. state), American country musicians
Scott Speed	American racecar drivers, Formula One drivers, GP2 Series drivers, NASCAR drivers, Sportspeople from California, 1983 births, Living people
CeBIT	Computers, Hanover
Robert Edwards	1925 births, 2013 deaths, British military personnel of World War II, British Nobel Prize winners, Disease-related deaths in England, Nobel Prize in Physiology or Medicine winners, People from Yorkshire
Theodore Sturgeon	1918 births, 1985 deaths, Deaths from pulmonary fibrosis, American autobiographers, American science fiction writers, Disease-related deaths in Oregon, Hugo Award winning writers, Nebula Award winning writers, People from Staten Island, Writers from New York City
Battle of Britain	1940 in Europe, 1940s in the United Kingdom, Battles involving Canada, Battles involving Germany, Battles involving Italy, Battles involving the United Kingdom, European battles of World War II
Thermite	Fire, Chemistry
Boulder, Colorado	Boulder, Colorado, County seats in Colorado
Meta-Wiki	Wikimedia
Osteoarthritis	Diseases and disorders of joints, Diseases
Sergio Pérez	1990 births, Living people, People from Guadalajara, Mexican sportspeople, GP2 Series drivers, Formula One current
Nimatullah Kassab Al-Hardini	1808 births, 1858 deaths, Christian saints, Lebanese Christians, Maronites
Dos Equis	Beer, Mexican food, 1897 establishments, 19th-century establishments in Mexico
Berriew	Villages in Powys
Roy Halladay	1977 births, 2017 deaths, Aviation deaths in the United States, Philadelphia Phillies players, Toronto Blue Jays players, National League All-Stars, Sportspeople from Denver, Colorado
Pacifism	Peace, Politics
Microvenator	Oviraptorosauria
A1 Grand Prix	Auto racing
Prince of Persia	Disney movies, Video game series
Adelaide Football Club	Australian Football League, Adelaide, 1991 establishments in Australia
Carlton Football Club	Australian Football League
Essendon Football Club	Australian Football League
James Naismith	Basketball, 1861 births, 1939 deaths, Coaches, Naturalized citizens of the United States, People from Lawrence, Kansas
First Indochina War	Wars of independence, Insurgencies, 20th century rebellions, Wars involving France, History of Cambodia, 20th century in Vietnam, History of Laos, Rebellions in Asia, 1940s in Asia, 1950s in Asia
Nelson Piquet, Jr.	1985 births, Living people, Brazilian sportspeople, 24 Hours of Le Mans drivers, GP2 Series drivers, Formula One drivers, NASCAR drivers
Hoy	Islands of Scotland
Battle of Pharsalus	Wars and battles of Ancient Rome, Battles of the Ancient World, 48 BC, August events
Battle of Philippi	Wars and battles of Ancient Rome, Battles of the Ancient World, 42 BC, October events
Healthy lifestyle	Healthy lifestyle
Galileo thermometer	Temperature, Weather instruments, Measuring tools
Aristotle Onassis	1906 births, 1975 deaths, Deaths from pneumonia, Deaths from myasthenia gravis, Disease-related deaths in France, Greek businesspeople
Private equity	Finance
The Heartbreakers	American punk bands, Musical groups from New York, Musical groups established in 1975, 1975 establishments in New York (state), 1990 disestablishments in the United States, 1990s disestablishments in New York (state), Musical groups disestablished in 1990
Battle of Actium	Wars and battles of Ancient Rome, Battles of the Ancient World, September events, 31 BC
Rebecca St. James	Christian music singers, 1977 births, Living people, Musicians from Sydney, Australian singer-songwriters, Australian pop musicians, Australian rock musicians
Metalloid	Semimetals
Photodetector	Electronic components
Selenium dioxide	Selenium compounds, Oxides
Selenium trioxide	Chemical compounds, Oxides
Selenide	Selenium compounds
Hydroselenide	Chemicals
Hydrogen selenide	Acids, Selenium compounds
Aluminium selenide	Selenium compounds, Aluminium compounds
Sodium selenide	Selenium compounds, Sodium compounds
Selenium monochloride	Selenium compounds, Chlorine compounds
Selenite	Selenium compounds
Selenate	Selenium compounds
Selenic acid	Acids, Selenium compounds
Selenous acid	Acids, Selenium compounds
Sodium selenate	Selenium compounds, Sodium compounds
Sodium selenite	Selenium compounds, Sodium compounds
Selenium hexafluoride	Selenium compounds, Fluorine compounds
Selenium tetrafluoride	Selenium compounds, Fluorine compounds
Art Deco	Art Deco
Eydie Gormé	1928 births, 2013 deaths, Disease-related deaths in the United States, American musicians, Singers from New York City
The Andrews Sisters	1950s American music groups, 1960s American music groups, 1967 disestablishments, American girl groups, American movie actors, American radio actors, Musical trios, Musicians from Minneapolis, Minnesota, Actors from Minneapolis, Minnesota, 1925 establishments in the United States, 20th-century establishments in Minnesota, Musical groups established in the 1950s, 1951 disestablishments, 1950s disestablishments in the United States, 1956 establishments in the United States, 1960s disestablishments in the United States, 20th-century disestablishments in Minnesota
Intellectual disability	Psychiatry, Psychology, Symptoms, Pervasive developmental disorders
Selenium tetrachloride	Selenium compounds, Chlorine compounds
Selenium disulfide	Selenium compounds, Sulfur compounds
Gaius Cassius Longinus	Roman generals
Braided river	Rivers
Marcus Junius Brutus	80s BC births, 42 BC deaths, Roman generals
Khaled Hosseini	1965 births, Living people, Writers from California, Afghan writers, People from Kabul
Mohsin Hamid	1971 births, Living people, Pakistani writers, People from Lahore
Police Camera Action!	1994 British television series debuts, 2010 British television series endings, 1990s British television series, 2000s British television series, 2010s British television series, British documentaries, English-language television programs
Panchayati raj	Government of India, Politics of India
Indian rupee	Currency of Asia, Economy of India
ISO 4217	Currency, ISO standards
Calcium nitride	Nitrogen compounds, Calcium compounds
Uthman ibn Affan	Sahaba, Muslims, Caliphs, 570s births, 656 deaths
Calcium permanganate	Manganese compounds, Calcium compounds
Calcium nitrate	Nitrogen compounds, Calcium compounds
Bray Wyatt	1987 births, American professional wrestlers, Living people, Sportspeople from Florida, WWE wrestlers
Terrestrial locomotion	Zoology
Strong acid	Acids
Hamilton, New Zealand	Cities in New Zealand
Liu Xiaobo	1955 births, 2017 deaths, Deaths from multiple organ failure, Deaths from liver cancer, Chinese writers, Activists, Chinese educators, Chinese Nobel Prize winners
Beijing Normal University	Colleges and universities in Beijing, 1902 establishments in Asia, 20th century establishments in China
University of Oslo	Oslo, Education in Norway, Colleges and universities in Europe, 1811 establishments, 1810s establishments in Europe, 19th century establishments in Norway
Central Region, Singapore	Geography of Singapore, Places in Singapore
Tuas	Geography of Singapore
Orchard Road	Transport in Singapore
NewsBank	Mass media
Bonnie Wright	English movie actors, English television actors, English voice actors, People from London, 1991 births, Living people
William Calley	Living people, 1943 births, Vietnam War, American spree killers, People from Miami, Florida
Weak acid	Acids
Second Amendment to the United States Constitution	United States Bill of Rights, Amendments to the United States Constitution
Cuscus	Marsupials, Papua New Guinea
Couscous	Middle Eastern foods, Algeria, Libya, Mauritania, Moroccan culture, Tunisian culture
2010 Copiapó mining accident	2010 disasters, 2010 in Chile, Mining
Qualitative analysis	Analytical chemistry
Cherkasy	Cities in Ukraine, 1286 establishments, Establishments in Ukraine, 13th century establishments in Europe
Dnieper	Rivers of Belarus, Rivers of Russia, Rivers of Ukraine
Synod of Hippo	Councils, 390s
State Electoral District	Government of Australia
Elephant gun	Elephants, Firearms
Charter 08	Human rights, Politics of the People's Republic of China
Sedan, Ardennes	Communes in Ardennes, Subprefectures in France, 1424 establishments, 1420s establishments in Europe, Establishments in France
KNVB Cup	Football competitions
Tadeus Reichstein	1897 births, 1996 deaths, Botanists, Jewish academics, Jewish Nobel Prize winners, Jewish scientists, Polish Jews, Polish Nobel Prize winners, Swiss chemists, Swiss Jews
Everglades National Park	World Heritage Sites in the United States, Geography of Florida, National parks in the United States
Manú National Park	Peru, National parks in South America, World Heritage Sites in South America, Biosphere reserves
Plane Stupid	Environmental organizations, Organisations based in the United Kingdom, 2005 establishments in the United Kingdom
Nissan Pathfinder	Nissan automobiles, Sport utility vehicles, 1980s automobiles, 1990s automobiles, 2000s automobiles, 2010s automobiles
Controlled drugs in the United Kingdom	Illegal drugs, United Kingdom law
Lose Yourself	2002 songs, Eminem songs, Best Original Song Academy Award-winning songs
Geomorphology	Earth sciences, Geology, Branches of geography
George Marshall	1880 births, 1959 deaths, American people of World War II, Politicians from Pennsylvania, Time People of the Year, American Nobel Prize winners, United States Secretaries of State, United States Secretaries of Defense, Honorary Knights Grand Cross of the Order of the Bath
John Isner	1985 births, Living people, American male tennis players, People from Greensboro, North Carolina, Sportspeople from North Carolina
Steve Keirn	1951 births, American professional wrestlers, Living people
Jubilees	Old Testament
Fuji Speedway	Formula One circuits
2010 US Open (tennis)	2010 US Open (tennis), 2010 in tennis, 2010 in New York (state)
2010 US Open – Men's Singles Qualifying	2010 US Open (tennis)
Christianity and alcohol	Alcohol drinking habits

