DuckDuckGo	2008 establishments in the United States, Companies of the United States, Internet-related organizations, Search engines
Popular sovereignty	Politics
American Red Cross	Organizations in Washington, D.C., Red Cross
Daniel Woodson	Governors of Kansas Territory, 19th-century American politicians
Kansas Democratic Party	1857 establishments in the United States, Kansas Democrats, Government of Kansas
Kansas Republican Party	Government of Kansas, 1859 establishments in the United States, Kansas Republicans
Scorched earth	Military, War
Dissected Till Plains	Geography of the United States
List of University of Kansas people	University of Kansas
The Immortals (Gunn novel)	1964 books, Lawrence, Kansas
Lüterkofen-Ichertswil	Municipalities of the canton of Solothurn
Seewen	Municipalities of the canton of Solothurn
Himmelried	Municipalities of the canton of Solothurn
Samuel J. Jones	Bleeding Kansas
Élie Brousse	1921 births, 2019 deaths, French sportspeople, People from Occitanie, Rugby league players
W. Thomas Molloy	1940 births, 2019 deaths, Deaths from pancreatic cancer, Canadian educators, Canadian lawyers, Canadian politicians, People from Saskatoon, Canadian Queen's Counsel
Gladys Berejiklian	1970 births, Living people, Premiers of New South Wales, Politicians from Sydney
Supervillain	Comics characters, Fictional characters, Fictional criminals, Literature
Daniel Andrews	1972 births, Living people, Premiers of Victoria
Night game	Sports
Homecoming	Sports
Will Hodgman	1969 births, Living people, Premiers of Tasmania, Liberal Party of Australia politicians, People from Hobart
Chief Minister of the Australian Capital Territory	Chief Ministers of the Australian Capital Territory
Andrew Barr	1973 births, Living people, Chief Ministers of the Australian Capital Territory
Gary Humphries	1958 births, Living people, Chief Ministers of the Australian Capital Territory
Chief Minister of the Northern Territory	Chief Ministers of the Northern Territory
Kansas Jayhawks football	College football, University of Kansas
Michael Gunner	1976 births, Living people, Chief Ministers of the Northern Territory
David Binder (journalist)	1931 births, 2019 deaths, Deaths from kidney disease, Disease-related deaths in Illinois, American political writers, American educators, Journalists from London, Writers from Illinois, People from Evanston, Illinois
Kansas Sports Hall of Fame	20th-century establishments in Kansas, 1961 establishments in the United States, Sports halls of fame, Museums in the United States, Wichita, Kansas
Chris Zylka	1985 births, Actors from Ohio, American models, American movie actors, American television actors, Living people
Tony Revolori	1996 births
Betty Buckley	Tony Award winning actors, American television actors, American stage actors, American movie actors, Actors from Texas, 1947 births, Living people
Ursula von der Leyen	1958 births, Living people, European Commissioners, German politicians
Hein & Oss	1927 births, 2016 deaths, 2019 deaths, German singers, German writers, Songwriters, Duos
Gerald McCann	1931 births, 2019 deaths, Designers, British artists
Richard L. Berkley	1931 births, Living people, Mayors of Kansas City, Missouri, US Republican Party politicians
Sly James	1951 births, Living people, American lawyers, Mayors of Kansas City, Missouri, US Democratic Party politicians
Mark Funkhouser	1949 births, Living people, Mayors of Kansas City, Missouri, American political writers, Politicians from West Virginia, Writers from West Virginia, Writers from Missouri, US Democratic Party politicians
Paden City, West Virginia	Cities in West Virginia
Emanuel Cleaver	1944 births, Living people, United States representatives from Missouri, Mayors of Kansas City, Missouri, American Methodists, Politicians from Texas, US Democratic Party politicians, People from Waxahachie, Texas
President of the Senate (Australia)	Parliament of Australia, Presidents of the Australian Senate
Scott Ryan (Australian politician)	1973 births, Living people, Presidents of the Australian Senate, Politicians from Melbourne
Doug McClelland	1926 births, Living people, Presidents of the Australian Senate, Politicians from New South Wales
Margaret Reid (politician)	1935 births, Living people, Presidents of the Australian Senate, Politicians from South Australia
Lina Wertmüller	1928 births, Living people, Italian screenwriters, Italian movie directors, Writers from Rome
Wes Studi	1947 births, Living people, American movie actors, American television actors, American stage actors, American voice actors, American movie producers, Actors from Oklahoma
Scott Adkins	1976 births, Living people, English movie actors, English television actors, English voice actors, Martial artists, Stuntmen, Actors from Birmingham
Sid Ramin	Academy Award winning composers, Grammy Award winners, Emmy Award winners, 1919 births, 2019 deaths, Deaths from natural causes, Disease-related deaths in New York City, American centenarians, American composers, Musicians from Boston, Massachusetts
James F. Sirmons	1917 births, 2018 deaths, American centenarians, Businesspeople from Florida, People from St. Petersburg, Florida
Keiran Lee	1984 births, Living people, British movie actors, British movie directors, British movie producers, British sex industry people, Pornographic actors, Pornographic movie directors, Pornographic movie producers
Basant Kumar Birla	1921 births, 2019 deaths, Indian businesspeople, People from Kolkata, Indian philanthropists
Baranagar	Cities in India, Baranagar
Mitchell Feigenbaum	1944 births, 2019 deaths, American educators, American physicists, Jewish American academics, Jewish American scientists, Scientists from Brooklyn, Scientists from Philadelphia, Pennsylvania
List of presidents of Guinea-Bissau	Presidents of Guinea-Bissau, Lists of heads of state
List of governors of Portuguese Guinea	Guinea-Bissau
Kansas National Guard	Kansas, United States Army
David Sassoli	1956 births, Living people, Italian journalists, MEPs for Italy, People from Florence, Politicians from Tuscany, Presidents of the European Parliament, Writers from Tuscany
Sudarshan Agarwal	1931 births, 2019 deaths, Disease-related deaths in India, Governors of Uttarakhand, Governors of Sikkim, Governors of Uttar Pradesh
Costa Cordalis	1944 births, Living people, German pop singers, German skiers, Greek singers, Reality show winners
Lewis Cass	19th-century American politicians
Lüsslingen-Nennigkofen	2013 establishments in Switzerland, Municipalities of the canton of Solothurn
Unterramsern	Municipalities of the canton of Solothurn
Tscheppach	Former municipalities of Solothurn
The Eldridge Hotel	Lawrence, Kansas, National Register of Historic Places in Douglas County, Kansas, Buildings and structures in Lawrence, Kansas, Hotels
Cross Canadian Ragweed	American musical groups
Mission California	2007 albums
Golden Age of Radio (album)	Albums
Robert J. Dole Institute of Politics	University of Kansas, 2003 establishments in the United States, Political organizations based in the United States
Spencer Museum of Art	University of Kansas, Art museums in the United States, Buildings and structures in Kansas, 1928 establishments in the United States, Lawrence, Kansas
University of Kansas Natural History Museum	University of Kansas, Natural history museums, Museums in the United States, 1901 establishments in the United States, National Register of Historic Places in Douglas County, Kansas
Monte Águila	Cities in Chile
John Clute	1940 births, Living people, British science fiction writers, Canadian science fiction writers, British critics, Canadian critics
Benton Harbor, Michigan	Cities in Michigan
Koldo Aguirre	1939 births, 2019 deaths, Spanish footballers, Spanish football managers
Jared Lorenzen	1981 births, 2019 deaths, Infectious disease deaths in the United States, Deaths from heart failure, Deaths from renal failure, American football quarterbacks, Indianapolis Colts players, New York Giants players, Sportspeople from Kentucky, People from Lexington, Kentucky
Joel Lebowitz	1930 births, Living people, Naturalized citizens of the United States, Holocaust survivors, American mathematicians, American physicians, American Jews, Ukrainian scientists, Ukrainian Jews
Arseny Mironov	1917 births, 2019 deaths, Centenarians, Russian physicists, Russian engineers, Aviators
The Bourne Legacy (movie)	2012 movies, American action movies, American spy movies, American thriller movies, English-language movies, Movies based on books, Drone movies
José Luis Álvarez	1930 births, Living people, Mayors of Madrid
Max Collins (actress)	1992 births, Living people, American movie actors, American television actors, Filipino actors, Models from California, Actors from California
Arturo Fernández Rodríguez	1929 births, 2019 deaths, Accidental deaths from falls, Spanish movie actors, Spanish television actors, Spanish stage actors, Spanish voice actors
DZOZ-DTV	Filipino television stations, Metro Manila
Dinghy sailing	Boats, Sailing, Water transport
Oberramsern	Former municipalities of Solothurn
Lüterswil-Gächliwil	Municipalities of the canton of Solothurn
Bibern, Solothurn	Former municipalities of Solothurn
Gossliwil	Former municipalities of Solothurn
Hessigkofen	Former municipalities of Solothurn
Kyburg-Buchegg	Former municipalities of Solothurn
Nuglar-St. Pantaleon	Municipalities of the canton of Solothurn
Witterswil	Municipalities of the canton of Solothurn
Drei Höfe	2013 establishments in Switzerland, Municipalities of the canton of Solothurn
Hersiwil	Former municipalities of Solothurn
Hauenstein-Ifenthal	Municipalities of the canton of Solothurn
Raggal	Cities and towns in Vorarlberg
List of zoos in the United States	Zoos in the United States, Lists
Bruce Wallrodt	1951 births, 2019 deaths, Australian athletes, Sportspeople from Western Australia
Eva Mozes Kor	1934 births, 2019 deaths, Jewish American writers, American human rights activists, American educators, Holocaust survivors, Romanian Jews, Romanian writers, Writers from Indiana, Naturalized citizens of the United States, People from Terre Haute, Indiana
Super Mario Maker 2	2019 video games, Mario platform games, Mario video games, Nintendo Switch games, Nintendo video games, Platform games, Video games developed in Japan
Chris Cline	1958 births, 2019 deaths, Accidental deaths, Aviation deaths, American billionaires, American philanthropists, Businesspeople from West Virginia
Ilkka Nummisto	1944 births, 2019 deaths, 1964 Summer Olympics, 1968 Summer Olympics, 1972 Summer Olympics, 1976 Summer Olympics, Finnish Olympians
Boat keel	Ship building
Johnny Briceño	1960 births, Living people, Prime Ministers of Belize, Current national leaders
Jeet Gannguli	Living people, 1977 births, Movie score composers, People from Baranagar, Baranagore Ramakrishna Mission Ashrama High School alumni
Lost Lake (Santiam Pass, Linn County, Oregon)	Geography of Oregon, Lakes of the United States
Bebearia ashantina	Nymphalidae
Numberjacks	BBC Television programmes
Lawrence Journal-World	Lawrence, Kansas, Newspapers
Sankt Gallenkirch	Cities and towns in Vorarlberg
Bürs	Cities and towns in Vorarlberg
Stüsslingen	Municipalities of the canton of Solothurn
Kammersrohr	Municipalities of the canton of Solothurn
Selzach	Municipalities of the canton of Solothurn
Holderbank, Solothurn	Municipalities of the canton of Solothurn
Welschenrohr	Municipalities of the canton of Solothurn
Zullwil	Municipalities of the canton of Solothurn
Street newspaper	Newspapers
Change of Heart (street paper)	Lawrence, Kansas, Newspapers
Heinrichswil-Winistorf	Former municipalities of Solothurn
Haskell-Baker Wetlands	Lawrence, Kansas, Wetlands
Horriwil	Municipalities of the canton of Solothurn
Baker University	Colleges and universities in Kansas, 1858 establishments in Kansas Territory
Hüniken	Municipalities of the canton of Solothurn
Steinhof	Former municipalities of Solothurn
Subingen	Municipalities of the canton of Solothurn
Niedererlinsbach	Former municipalities of Solothurn, Villages in Switzerland
Obererlinsbach	Former municipalities of Solothurn, Villages in Switzerland
Norman Geisler	1932 births, 2019 deaths, Deaths from cerebral thrombosis, American theologians, American Christians, Writers from Michigan
Warren, Michigan	Cities in Michigan
Malva Landa	1918 births, 2019 deaths, Ukrainian writers, Russian writers, Centenarians, Human rights activists, Geologists
Pierre Lhomme	1930 births, 2019 deaths, Cinematographers, French movie directors, French screenwriters
Ugo Gregoretti	1930 births, 2019 deaths, Italian movie directors, Italian movie actors, Italian screenwriters, Television directors, Italian television presenters, Actors from Rome
Paolo Vinaccia	1954 births, 2019 deaths, Deaths from pancreatic cancer, Italian musicians, Italian composers, Drummers, Jazz musicians, People from Rome, People from Oslo
Kazuhiro Kiyohara	1967 births, Japanese baseball players, People from Osaka Prefecture, Living people
Midco	Internet service providers of the United States
Lawrence station (Kansas)	Lawrence, Kansas, National Register of Historic Places in Douglas County, Kansas, Buildings and structures in Lawrence, Kansas, Railway stations in the United States
Rail freight transport	Rail transport
BNSF Railway	Rail transport in the United States, American transport companies
Union Pacific Railroad	Trains, American transport companies, 1862 establishments in the United States
Lawrence Transit	Lawrence, Kansas, Transport in the United States
Kevin McAleenan	1971 births, Living people, United States Secretaries of Homeland Security, People from Honolulu
Hewing	Woodworking, Forestry
Zach Neal	1988 births, American baseball players, Los Angeles Dodgers players, Oakland Athletics players, Sportspeople from South Carolina, People from Columbia, South Carolina, Living people
Dynamics	Basic physics ideas
Mitsuo Itoh	1937 births, 2019 deaths, Japanese sportspeople, Motorcycle racers
Vivian Perlis	1928 births, 2019 deaths, American historians, Disease-related deaths in Connecticut, Musicologists, Writers from Brooklyn
Shiboprosad Mukherjee	1974 births, Living people, Indian movie directors, People from Baranagar, Baranagore Ramakrishna Mission Ashrama High School alumni
List of Salman Khan's awards and nominations	Lists of awards and nominations, Salman Khan
Marguerite Pindling	1932 births, Living people, Governors-General of the Bahamas
Cornelius A. Smith	1937 births, Living people, Governors-General of the Bahamas, Ambassadors to the United States
Abhishek Chatterjee	Living people, 1964 births, Indian actors, Indian movie actors, Indian television actors, People from Baranagar, Baranagore Ramakrishna Mission Ashrama High School alumni, India-related lists
Center for Immigration Studies	Think tanks, 1986 establishments in the United States, Washington, D.C., Immigration
Tathagata Mukherjee	Living people, 1985 births, Indian actors, Indian movie actors, Indian television actors, Baranagore Ramakrishna Mission Ashrama High School alumni
List of presidents of Rwanda	Presidents (government), African politicians, Rwanda
Centron Corporation	Lawrence, Kansas, Movie studios, 1947 establishments in the United States
Herk Harvey	1924 births, 1996 deaths, American actors
Carnival of Souls	American movies, American independent movies
Cult following	Popular culture
Cult movie	Popular culture, Movies
Takeover	Business
Extracurricular activity	Education
Student publication	Education, Media
Ovillers-la-Boisselle	Communes in Somme
Nenzing	Cities and towns in Vorarlberg
João Gilberto	1931 births, 2019 deaths, Brazilian musicians, Brazilian singers, Guitarists, Grammy Award winners, Singer-songwriters
Arman Kirakossian	2019 deaths, 1956 births, Ambassadors to the United States, Armenian politicians, Armenian historians, Ambassadors to the United Kingdom
Parviz Jalayer	1939 births, 2019 deaths, 1964 Summer Olympics, 1968 Summer Olympics, Olympians, People from Tehran, Weightlifters
Tribune Publishing	Publishing companies of the United States
Federal Highway Administration	United States Department of Transportation, 1967 establishments in the United States
Pearson plc	Publishing companies
General Dynamics	Companies of the United States
Osawatomie, Kansas	Cities in Miami County, Kansas
Kansas City Public Library	Libraries in the United States, Kansas City, Missouri, 1873 establishments in the United States
The Cat Returns	2000s adventure movies, 2000s drama movies, 2000s fantasy movies, 2000s manga, 2002 movies, English-language movies, Japanese movies, Japanese-language movies, Manga series, Movies about animals, Movies about cats, Movies based on comics, Studio Ghibli
Rocco Siffredi	1964 births, Living people, Italian movie actors, Italian movie directors, Italian movie producers, Pornographic actors, Pornographic movie directors, Pornographic movie producers
List of awards and nominations received by Rocco Siffredi	Lists of awards and nominations
Ashurst LLP	Companies of the United Kingdom, Law, 1822 establishments
King of Lesotho	Kings and queens, African politicians, Lesotho
Cameron Boyce	1999 births, 2019 deaths, Actors from Los Angeles, California, American child actors, American movie actors, American dancers, American television actors, Jewish American actors, African American actors, American voice actors, Deaths from epilepsy, Deaths from seizure
List of prime ministers of Lesotho	Lists of prime ministers, Prime Ministers of Lesotho
Antonio Alonso Martinez	1963 births, Living people
Ryan Driller	1982 births, Living people, American adult models, American LGBT sex industry people, American movie directors, American pornographic actors, Bisexual people, Former Christians, LGBT pornographic actors, Pornographic movie directors
Donetsk	Cities in Ukraine
Ora Namir	1930 births, 2019 deaths, Ambassadors of Israel, Former Members of Knesset, Government ministers of Israel, HaAvoda politicians, Israeli military people, Jewish Israeli politicians, Jewish military people, Jewish women politicians
List of awards and nominations received by Ryan Driller	Lists of awards and nominations
2008 Lincolnshire earthquake	Earthquakes in the 2000s, 2008 in England, West Lindsey, February events
Tom Thabane	1939 births, Prime Ministers of Lesotho, Living people
Bartholomäberg	Cities and towns in Vorarlberg
Sutopo Purwo Nugroho	1969 births, 2019 deaths, Civil servants, Deaths from lung cancer, Indonesian educators, Indonesian politicians
Sardis	Achaemenid Empire, Ancient Greek cities, Former national capitals, History of Turkey, History of Persia, Roman Empire, Turkey, World Heritage Sites in Turkey
Randy Bass	1954 births, 21st-century American politicians, American baseball players, Democrats (United States), Kansas City Royals players, Living people, Minnesota Twins players, Montreal Expos players, People from Lawton, Oklahoma, San Diego Padres players, Texas Rangers players
Consumer	Economics, Business
U.S. Route 24	U.S. Highways
Wilco	Musical groups from Chicago
Kansas Department of Wildlife, Parks and Tourism	Government of Kansas
Kansas State Cabinet	Government of Kansas
King of Cambodia	Cambodian monarchs
List of unincorporated communities in Kansas	Unincorporated communities in Kansas, Kansas-related lists
Frederick, Kansas	Cities in Rice County, Kansas
New Democrats	United States Democratic Party
Patricia Gallerneau	1954 births, 2019 deaths, Cancer deaths in France, Politicians from Paris
Kyriakos Mitsotakis	1968 births, Living people, People from Athens, Harvard University alumni, Stanford University alumni, Bankers, Government ministers of Greece, Prime Ministers of Greece, Leaders of political parties, Current national leaders
List of prime ministers of Guinea	Prime Ministers of Guinea
List of heads of state of Afghanistan	Lists of heads of state, Monarchs of Afghanistan, Presidents of Afghanistan, Asia-related lists
Herman Boone	1935 births, 2019 deaths, Deaths from lung cancer, Cancer deaths in Virginia, African-American sportspeople, American football coaches, Sportspeople from North Carolina, People from Rocky Mount, North Carolina
R.I.P.D.	2013 action movies, 2013 comedy movies, 2013 science fiction movies, 2010s action comedy movies, American science fiction movies, American action comedy movies, Movies directed by Robert Schwentke
List of Old World monkey species	Old World monkeys
List of New World monkey species	New World monkeys
List of heads of state of Niger	Lists of heads of state, Presidents of Niger
List of presidents of Burundi	Presidents of Burundi, Lists of heads of state
List of presidents of Guinea	Presidents of Guinea
List of colonial governors of Ruanda-Urundi	Ruanda-Urundi
Drimys winteri	Magnoliopsida
President of the United Arab Emirates	Presidents of the United Arab Emirates, Lists of heads of state
Port Arthur Marrs	Ice hockey teams in Ontario, Thunder Bay
Gary Duncan	1946 births, 2019 deaths, Accidental deaths from falls in the United States, American rock guitarists, American rock singers, Deaths from seizure, Musicians from San Diego, California, Singers from San Diego, California
Baldwin City, Kansas	Cities in Douglas County, Kansas, Santa Fe Trail
Namesake	Names
Jefferson, North Carolina	Cities in North Carolina, County seats in North Carolina
Gretna, Louisiana	Cities in Louisiana, Parish seats in Louisiana
Collier's Encyclopedia	Encyclopedias
Tongue-in-cheek	Figures of speech
Political party strength in Kansas	Government of Kansas
Republican In Name Only	Republicans (United States)
Baddeck, Nova Scotia	Villages in Nova Scotia
Arthur Ryan	1935 births, 2019 deaths, Irish businesspeople, People from Dublin
CSX	1986 establishments in North America, American transport companies, Companies listed on NASDAQ, Companies of the United States, Rail transport in Canada
Emory, Texas	Cities in Texas, County seats in Texas
Sanderson, Texas	1880s establishments in Texas, 1882 establishments in the United States, Census-designated places in Texas, County seats in Texas
Farwell, Texas	Cities in Texas, County seats in Texas
Yusei Kikuchi	1991 births, Japanese baseball players, Seattle Mariners players, People from Iwate Prefecture, Living people
Allan Octavian Hume	1829 births, 1912 deaths, British botanists, British ornithologists, British politicians, Order of the Bath
Jeet Gannguli discography	Discographies
List of monarchs of Eswatini	Eswatini, Lists of heads of state
Steve Perry	American singers, American songwriters, 1949 births, Living people
Survivor (Israeli TV series)	Mass media in Israel, Television game shows, Reality television series, 2007 television series debuts
Kidney bean	Beans
List of heads of state of Ivory Coast	Presidents of Ivory Coast
Tai languages	Languages of Asia, Tonal languages
Kra-Dai languages	Tonal languages, Sino-Austronesian languages
Clint Black	1962 births, American country guitarists, American country singers, American record producers, Living people, People from Katy, Texas, Musicians from Houston, Texas
Tom Steyer 2020 presidential campaign	2020 United States presidential campaigns
Mary E. Barkworth	1941 births, Living people, Botanists
Kansas City International Airport	Airports in the United States, Kansas City, Missouri
Jeffrey Epstein	Jeffrey Epstein, 1953 births, 2019 deaths, American philanthropists, American sex offenders, Businesspeople from New York City, Child sexual abusers, Criminals from New York City, Criminals who committed suicide, Jewish American criminals, Jewish businesspeople, Jewish philanthropists, Jews who committed suicide, People who died in prison custody, Suicides by hanging in the United States
J. T. Realmuto	1991 births, American baseball players, Living people, National League All-Stars, Sportspeople from Oklahoma, Philadelphia Phillies players
Pacinko	Indonesian people
Dejan Lovren	1989 births, Living people, Croatian footballers, 2018 FIFA World Cup players, Liverpool F.C. players
Scream Queens	2010s American comedy television series, 2010s American television series, 2010s television series, 2015 American television series debuts, 2015 television series debuts, 2016 television series endings, American comedy television series, American comedy-drama television series, American drama television series, American horror television series, American medical television series, American sitcoms, American television series, Black comedy television series, College television series, Comedy television series, Fox Broadcasting Company, Fox television series, Horror television series, Satirical television series, Television series set in Los Angeles, California, English-language television programs
Zoolander 2	Movies set in Rome
Lakeville, Connecticut	Census-designated places in Connecticut
Robert F. Marx	1936 births, 2019 deaths, People from Florida
Indialantic, Florida	Towns in Florida
Philip Freelon	1952 births, 2019 deaths, Deaths from motor neurone disease, American architects, American educators, Businesspeople from Philadelphia, Pennsylvania
Megan Rapinoe	1985 births, Living people, Lesbians, American footballers, LGBT people from California, Sportspeople from California
Steve Cannon (writer)	1935 births, 2019 deaths, Deaths from sepsis, American novelists, American playwrights, Writers from New Orleans, Louisiana
Ekaterina Koroleva	1998 births, 2019 deaths, Accidental deaths by drowning, Deaths in sport, Russian sportspeople
2019 Tajoura migrant center airstrike	History of Libya, 2019 in Africa, July 2019 events
One-design dinghy	Boats, Sailing, Water transport
Eddie Gerard	1890 births, 1937 deaths, Canadian ice hockey left wingers, Deaths from oral cancer, Hockey Hall of Fame inductees, Ice hockey people from Ontario, Ottawa Senators (original) players, People from Ottawa, Stanley Cup champions, Toronto St. Pats players, Ottawa Senators (NHA) players
Bible Hill, Nova Scotia	Villages in Nova Scotia
Canning, Nova Scotia	Villages in Nova Scotia
Chester, Nova Scotia	Villages in Nova Scotia
I Love New York	1977 songs, Advertising, American culture, Madonna songs, New York City, Tourism, 1977 establishments, Music in New York City, United States state songs
1952 Indian presidential election	India
Swindle	2013 movies, American comedy movies, American television movies, English-language movies, Nickelodeon, Teen movies
Dysalotosaurus	Iguanodonts
Tokyo Bay	Tokyo, Bays, Bodies of water of Japan
Eudora, Kansas	Cities in Douglas County, Kansas
Abel	Biblical people, Old Testament people
KFC Index	Economics, KFC
Formal verification	Mathematics
Aaron Rosand	1927 births, 2019 deaths, American violinists, Musicians from Indiana, People from Hammond, Indiana
Paulo Henrique Amorim	Brazilian writers, Brazilian journalists, 1942 births, 2019 deaths, People from Rio de Janeiro, Deaths from myocardial infarction
Cerebral amyloid angiopathy	Diseases
Jim Bouton	1939 births, 2019 deaths, Deaths from brain disease, Disease-related deaths in Massachusetts, New York Yankees players, Milwaukee Brewers players, Houston Astros players, Atlanta Braves players, American movie actors, American inventors, American activists, People from Teaneck, New Jersey, Actors from New Jersey, Sportspeople from New Jersey, Writers from New Jersey
Great Barrington, Massachusetts	Towns in Massachusetts, Berkshire County, Massachusetts
Motto McLean	1925 births, 2019 deaths, American Hockey Association (1926–42) players, Canadian ice hockey players, Scottish sportspeople
Brendan Grace	1951 births, 2019 deaths, Deaths from lung cancer, Irish comedians, Irish television actors, Irish movie actors, Singers from Dublin, Actors from Dublin
Antony Acland	1930 births, 2021 deaths, Ambassadors of the United Kingdom
Capital districts and territories	Capital cities, Districts, Political subdivisions
2006–07 New York Rangers season	National Hockey League team seasons
2018 Memorial Cup	2018 in ice hockey, Memorial Cup
Golmaal 3	2010 comedy movies, 2010s action comedy movies, Indian movies, Movies directed by Rohit Shetty
Auxiliary sciences of history	History
Sigillography	History
Ron Estes	21st-century American politicians, Kansas Republicans
Kansas State Treasurer	Government of Kansas
Secretary of State of Kansas	Government of Kansas, 1861 establishments in Kansas
Kansas Insurance Commissioner	Government of Kansas
The Signpost	Wikipedia Signpost, Works about Wikipedia
Keke Palmer	1993 births, Living people, Actors from Illinois, Singers from Illinois, Television personalities from Illinois
Jason Bay	1978 births, American League All-Stars, American baseball players, Boston Red Sox players, Canadian baseball players, Living people, National League All-Stars, Naturalized citizens of the United States, New York Mets players, Pittsburgh Pirates players, San Diego Padres players, Seattle Mariners players, Sportspeople from British Columbia
Giannis Antetokounmpo	1994 births, Greek sportspeople, Milwaukee Bucks players, People from Athens, Living people
Bechuanaland	Colonialism, History of South Africa
Great Flood of 1951	Floods
Fort Riley, Kansas	Forts in Kansas
Larry J. Hopkins	1933 births, Living people, United States representatives from Kentucky, Politicians from Detroit, Michigan, US Republican Party politicians
Walt Michaels	1929 births, 2019 deaths, American football linebackers, American football coaches, New York Jets players, Green Bay Packers players, Cleveland Browns players, Sportspeople from Pennsylvania, People from Wilkes-Barre, Pennsylvania
Swoyersville, Pennsylvania	Boroughs in Pennsylvania
Luzerne County, Pennsylvania	1780s establishments in Pennsylvania, 1786 establishments in the United States, Pennsylvania counties
Rebecca Nagan	1968 births, Living people, Actors, Puppeteers
Naval ship	Military
Naval base	Military
Rex Wood	Australian artists, 1909 births, 1970 deaths
Big League Chew	1980 establishments in the United States, Candy, Baseball
Dengir Mir Mehmet Fırat	1943 births, 2019 deaths, Deaths from lung cancer, Turkish politicians
Eastern Ghats	Mountain ranges of India, Landforms of India
She-Hulk	Marvel Comics superheroes
Crayford	Areas of London, London Borough of Bexley
Jungkook	BTS members, South Korean singers, Living people
Tongatapu	Tonga
Richard and Mary Parker	Spider-Man, Fictional characters introduced in the 1960s, Marvel Comics characters
Derby, Kansas	Cities in Sedgwick County, Kansas
Great Bend, Kansas	Cities in Kansas, County seats in Kansas, Barton County, Kansas
Red Hills (Kansas)	Geography of Kansas
Crime in Kansas	Crime in the United States, Kansas
Pittsburg, Kansas	Cities in Crawford County, Kansas, 1876 establishments in Kansas
Falfurrias, Texas	Cities in Texas, County seats in Texas
Floresville, Texas	Cities in Texas, County seats in Texas
Gardner, Kansas	Cities in Kansas, 1857 establishments in Kansas Territory
Winfield, Kansas	Cities in Cowley County, Kansas, County seats in Kansas
Lansing, Kansas	Cities in Kansas, 1959 establishments in the United States
Haysville, Kansas	Cities in Sedgwick County, Kansas
Bongkel	Indonesian culture, Musical instruments
Rif Dimashq Governorate	Rif Dimashq Governorate, Governorates of Syria
Damascus Governorate	Damascus Governorate, Governorates of Syria
Typhoon Wutip (2019)	February 2019 events, March 2019 events, 2019 Pacific typhoon season
2019 Atlantic hurricane season	Atlantic hurricane seasons, 2019 in weather
Des Coleman	1965 births, Living people, Cancer survivors, English movie actors, English television actors, English stage actors, English singers, English television presenters, BBC people, People from Derby, Actors from Derbyshire
2003 Cricket World Cup	Cricket World Cup
Dieter Enders	1946 births, 2019 deaths, German chemists
Astrid North	1973 births, 2019 deaths, Deaths from pancreatic cancer, German singers, Songwriters, Writers from Berlin
M. J. Radhakrishnan	1950s births, 2019 deaths, Deaths from cardiac arrest, Indian cinematographers
Claudio Naranjo	1932 births, 2019 deaths, Chilean scientists, American psychiatrists
Thousand Palms, California	Census-designated places in California, Settlements in Riverside County, California
Rumen Surdzhiyski	1943 births, 2019 deaths, Bulgarian writers, Screenwriters, Movie directors
Asasey hotel attack	2019 in Africa, 2019 mass shootings, 2010s explosions in Africa, 2010s murders in Africa, 21st century in Somalia, Al-Shabaab (militant group), Attacks on buildings and structures in 2019, Attacks on hotels, Building bombings in Africa, Islamic terrorist incidents in 2019, Islamic terrorist incidents in Africa, July 2019 events, Mass murder in 2019, Mass murder in Africa, Mass shootings in Africa, Suicide bombings in 2019, Suicide bombings in Africa, Suicide car and truck bombings, Terrorist incidents in Africa in the 2010s
Hodan Nalayeh	1976 births, 2019 deaths, Murder victims, Television producers, Activists, Canadian philanthropists, Canadian businesspeople, Somali people, People from Toronto
Plains, Pennsylvania	Census-designated places in Pennsylvania
Lackawanna County, Pennsylvania	19th-century establishments in Pennsylvania, 1878 establishments in the United States, Pennsylvania counties
Joseph Edward Kurtz	1946 births, Living people, American Roman Catholics, Bishops, People with cancer, People from Scranton, Pennsylvania, People from Knoxville, Tennessee, People from Louisville, Kentucky
Mahanoy City, Pennsylvania	Boroughs in Pennsylvania
Social gadfly	Words
Georgian Bay Islands National Park	National parks in Canada, 1920s establishments in Canada, 1929 establishments in North America, Geography of Ontario
Orlando Pride	2015 establishments
Chandrayaan-2	India, Planetary rovers, September 2019 events
Kanchi Natarajan Gandhi	Botanists
Cisco Systems	American technology companies, 1984 establishments in California, Companies based  in the San Francisco Bay Area, Multinational technology companies
Ratchaburi Province	Provinces of Thailand
Sunninghill Park	Royal residences in the United Kingdom, Berkshire
SkyTeam Cargo	Airline alliances
2019 Audi Cup	July 2019 events, 2019 in association football, 2019 in Europe, 2010s in Munich, Audi Cup
Aranyaka	Hindu texts
Time in India	Time zones, Time by country
Eurovision Song Contest 2020	2020s in the Netherlands, 2020 in Europe, 2020 in entertainment, Eurovision Song Contest, Rotterdam
Brian Giles	1971 births, Baseball players from California, Cleveland Indians players, Living people, Pittsburgh Pirates players, San Diego Padres players
Benito Santiago	1965 births, Chicago Cubs players, Cincinnati Reds players, Florida Marlins players, Kansas City Royals players, Living people, National League All-Stars, Philadelphia Phillies players, Pittsburgh Pirates players, San Diego Padres players, San Francisco Giants players, Toronto Blue Jays players
Jason Kendall	1974 births, Baseball players from California, Chicago Cubs players, Kansas City Royals players, Living people, Milwaukee Brewers players, National League All-Stars, Oakland Athletics players, Pittsburgh Pirates players, Sportspeople from San Diego, California
Mike Matheny	1970 births, Milwaukee Brewers players, San Francisco Giants players, St. Louis Cardinals players, Toronto Blue Jays players, Sportspeople from Columbus, Ohio, Living people
Torii Hunter	1975 births, African-American baseball players, American League All-Stars, American baseball players, Detroit Tigers players, Living people, Los Angeles Angels of Anaheim players, Los Angeles Angels players, Minnesota Twins players, Sportspeople from Arkansas
Escort agency	Sex industry, Security
Tracy Edwards	1962 births, Living people, Members of the Order of the British Empire
Oak Hill Cemetery (Lawrence, Kansas)	Buildings and structures in Kansas, Cemeteries in the United States, Lawrence, Kansas, National Register of Historic Places in Douglas County, Kansas, 1866 establishments in Kansas
Adriano Andreani	1879 births, 1960 deaths, Italian Olympians, Gymnasts
William Bonin	1947 births, 1996 deaths, 20th century crimes, American criminals, American military personnel of the Vietnam War, American people convicted of murder, American prisoners sentenced to death, American rapists, American serial killers, Child sexual abusers, Executed American serial killers, Gay men, People executed by lethal injection, People with antisocial personality disorder, Rapists, Serial killers
Manu Ginóbili	1977 births, Argentine people, Competitors at the 2012 Summer Olympics, Competitors at the 2016 Summer Olympics, Living people, Medalists at the 2004 Summer Olympics, Medalists at the 2008 Summer Olympics, Olympic bronze medalists, Olympic gold medalists, San Antonio Spurs players, National Basketball Association players with retired numbers
Sonic Team	Sega divisions and subsidiaries
Jason Richardson	1981 births, African-American basketball players, Charlotte Bobcats players, Golden State Warriors players, Orlando Magic players, Philadelphia 76ers players, Phoenix Suns players, Sportspeople from Michigan, People from Saginaw, Michigan, Living people, American basketball players
Kemba Walker	1990 births, African-American basketball players, Boston Celtics players, Charlotte Bobcats players, Sportspeople from New York City, People from the Bronx, Living people, American basketball players
Chauncey Billups	1976 births, African-American basketball players, Boston Celtics players, Denver Nuggets players, Detroit Pistons players, Los Angeles Clippers players, Minnesota Timberwolves players, New York Knicks players, Orlando Magic players, Toronto Raptors players, National Basketball Association players with retired numbers, Sportspeople from Denver, Colorado, Living people, American basketball players
Fausto Sozzini	1539 births, 1604 deaths, Christian theologians, Italian philosophers, Nontrinitarianism, People from Siena, Protestant Reformation, Protestantism, Protestants, Unitarianism, Unitarians
Glen Davis	1986 births, African-American basketball players, Boston Celtics players, Los Angeles Clippers players, Orlando Magic players, Sportspeople from Louisiana, People from Baton Rouge, Louisiana, Living people
Emeka Okafor	1982 births, African-American basketball players, New Orleans Hornets players, New Orleans Pelicans players, Philadelphia 76ers players, Washington Wizards players, American Olympic bronze medalists, American Olympic medalists, Medalists at the 2004 Summer Olympics, Charlotte Bobcats players, Sportspeople from Houston, Texas, Living people, American basketball players
Boris Diaw	1982 births, French Olympians, Atlanta Hawks players, Charlotte Bobcats players, Phoenix Suns players, San Antonio Spurs players, Utah Jazz players, Competitors at the 2012 Summer Olympics, Competitors at the 2016 Summer Olympics, Living people
Amar'e Stoudemire	1982 births, African-American basketball players, American Olympic bronze medalists, American Olympic gold medalists, Dallas Mavericks players, Jewish American sportspeople, Jewish Israeli sportspeople, Living people, Medalists at the 2004 Summer Olympics, Miami Heat players, National Basketball Association high school draftees, Naturalized citizens of Israel, New York Knicks players, Phoenix Suns players, Sportspeople from Orlando, Florida, American basketball players
Shawn Marion	1978 births, African-American basketball players, American Olympic bronze medalists, Medalists at the 2004 Summer Olympics, Cleveland Cavaliers players, Dallas Mavericks players, Miami Heat players, Phoenix Suns players, Toronto Raptors players, Sportspeople from Illinois, People from Waukegan, Illinois, Living people, American basketball players
Leandro Barbosa	1982 births, Boston Celtics players, Brazilian Olympians, Competitors at the 2012 Summer Olympics, Competitors at the 2016 Summer Olympics, Golden State Warriors players, Indiana Pacers players, Living people, People from São Paulo, Phoenix Suns players, Toronto Raptors players, Washington Wizards players
Robert Horry	1970 births, African-American basketball players, American basketball players, Houston Rockets players, Living people, Los Angeles Lakers players, National Basketball Association broadcasters, People from Maryland, Phoenix Suns players, San Antonio Spurs players
Brent Barry	1971 births, Basketball players from California, Chicago Bulls players, Denver Nuggets players, Houston Rockets players, Living people, Los Angeles Clippers players, Miami Heat players, San Antonio Spurs players, Seattle SuperSonics players, People from Concord, California
Charles Levin (actor)	1949 births, 2019 deaths, American movie actors, American television actors, American stage actors, Actors from Chicago
Selma, Oregon	Unincorporated communities in Oregon, Census-designated places in Oregon
Gerald Weissmann	1930 births, 2019 deaths, Austrian scientists, American physicians, American educators, Naturalized citizens of the United States, American essayists, Writers from Vienna, Writers from Massachusetts, Scientists from Massachusetts
Jean-Pierre Worms	1934 births, 2019 deaths, French politicians, European sociologists
Augusto Fantozzi	1940 births, 2019 deaths, Italian businesspeople, Italian lawyers, Politicians from Rome
Sadashiv Vasantrao Gorakshkar	1933 births, 2019 deaths, Indian critics, Art critics
Rod Richards	1947 births, 2019 deaths, Deaths from cancer, Welsh politicians
Terry Hodgkinson	1949 births, 2019 deaths, British businesspeople
Nereo Laroni	1942 births, 2019 deaths, Deaths from surgical complications, Former MEPs, Italian politicians, Mayors, People from Venice
Richard Carter (actor)	1953 births, 2019 deaths, Australian movie actors, Australian television actors, Australian stage actors, Australian voice actors, Actors from Sydney
Greg Daniels	1963 births, Living people, American television producers, American television writers, American television directors, Emmy Award winners, Harvard University alumni, Writers from New York City
Bahasa Jawa Indramayu	Regional languages in Indonesia
Bennett's tree-kangaroo	Macropods
Kameda College of Health Sciences	Colleges and universities in Japan
M-185 (Michigan highway)	Transport in Michigan, Roads in the United States
Monowi, Nebraska	Cities in Nebraska
People-watching	Anthropology
Cherokee Strip (Kansas)	Regions of Kansas
Southeast Kansas	Regions of Kansas
East-Central Kansas	Regions of Kansas
North Central Kansas	Regions of Kansas
Double agent	Espionage
Jacksboro, Texas	Cities in Texas, County seats in Texas
Morton, Texas	Cities in Texas, County seats in Texas
Moderate	Politics
Education in Kansas	Kansas, Education
Milhouse Van Houten	The Simpsons characters, Fictional characters introduced in 1988
Nerd	1980s, 1990s, 2000s, American culture, Anthropology, Internet culture, Lifestyles, Pejoratives, Slang, Society, Subculture, Video games
Parsons, Kansas	Cities in Labette County, Kansas
Coffeyville, Kansas	Cities in Montgomery County, Kansas, 1869 establishments in Kansas
Mission, Kansas	Cities in Kansas
Takenoshin Nakai	Botanists, Japanese biologists
Harry Osborn	Animated characters, Fictional characters introduced in the 1960s, Fictional criminals, Marvel Comics superheroes, Movie characters, Spider-Man
Ousmane Tanor Dieng	1947 births, 2019 deaths, Disease-related deaths in France, Senegalese politicians, Socialist politicians, Socialist International
Paul Albert Zipfel	1935 births, 2019 deaths, Deaths from dementia, Disease-related deaths in Missouri, American Roman Catholics, Bishops, People from St. Louis, Missouri, People from Bismarck, North Dakota
Normandy, Missouri	Cities in Missouri
Pernell Whitaker	1964 births, 2019 deaths, Road accident deaths in the United States, American boxers, American Olympic gold medalists, Sportspeople from St. Louis, Missouri
Paul F. Markham	1930 births, 2019 deaths, American lawyers, Politicians from Boston, Massachusetts, US Democratic Party politicians
Janet Gaynor	Academy Award winning actors, 1906 births, 1984 deaths, Road accident deaths in California, American painters, American silent movie actors, American movie actors, American television actors, American stage actors, Actors from Philadelphia, Pennsylvania
Simone Signoret	Academy Award winning actors, Emmy Award winning actors, BAFTA Award winning actors, 1921 births, 1985 deaths, French movie actors, French television actors, French stage actors, Deaths from pancreatic cancer
Roberto Benigni	Academy Award winning actors, BAFTA Award winning actors, 1952 births, Living people, Italian movie actors, Italian television actors, Italian stage actors, Italian voice actors, Comedians, Italian screenwriters, Italian movie directors
Paul Lukas	Academy Award winning actors, Golden Globe Award winning actors, 1894 births, 1971 deaths, Hungarian movie actors, Hungarian television actors, Hungarian stage actors, Actors from Budapest
Robert Donat	Academy Award winning actors, 1905 births, 1958 deaths, Deaths from cerebral thrombosis, Deaths from brain cancer, English movie actors, English television actors, English stage actors, Actors from London
Paul Muni	Academy Award winning actors, Tony Award winning actors, 1895 births, 1967 deaths, American movie actors, American television actors, American stage actors, Actors from Chicago, Cardiovascular disease deaths in California
Victor McLaglen	1886 births, 1959 deaths, Deaths from myocardial infarction, Naturalized citizens of the United States, British movie actors, British television actors, British stage actors, British activists, American activists, American movie actors, American television actors, American stage actors, Actors from London
Wallace Beery	Academy Award winning actors, 1885 births, 1949 deaths, Deaths from myocardial infarction, Cardiovascular disease deaths in California, American silent movie actors, American movie actors, American television actors, American stage actors, Actors from Missouri
George Arliss	1868 births, 1946 deaths, Deaths from bronchopneumonia, English playwrights, English autobiographers, Academy Award winning actors, English movie actors, English stage actors, Actors from London, Movie directors from London, Writers from London
Warner Baxter	Academy Award winning actors, 1889 births, 1951 deaths, Deaths from pneumonia, Disease-related deaths in Los Angeles, American silent movie actors, American stage actors, American movie actors, Actors from Columbus, Ohio
Emil Jannings	1884 births, 1950 deaths, German movie actors, German television actors, German stage actors, Deaths from liver cancer, Academy Award winning actors
Jorge Aguado	1925 births, 2019 deaths, Argentine politicians, People from Buenos Aires
Werner Müller (politician)	1946 births, 2019 deaths, Cancer deaths in Germany, German businesspeople, German politicians, People from Essen
Flipbook	Paper, Books
Rommel Roberts	South African people, Theologians, Human rights activists, 1949 births, Living people
Wikipedia Arbitration Committee	Wikimedia
Temperance movement	History
Woman's Christian Temperance Union	Organizations
Hot Springs County, Wyoming	1911 establishments in Wyoming, Wyoming counties
Hempstead, Texas	Cities in Texas, County seats in Texas
Independence, Kansas	Cities in Montgomery County, Kansas, County seats in Kansas, 1869 establishments in Kansas
Ghiyas ud din Balban	13th century births, Delhi Sultanate, History of India, History of Pakistan, Indian monarchs, Year of birth unknown, Year of death unknown
Augusta, Kansas	Cities in Butler County, Kansas
Chanute, Kansas	Cities in Kansas
Wellington, Kansas	Cities in Sumner County, Kansas, County seats in Kansas
Craig Fallon	1982 births, 2019 deaths, British sportspeople, Judoka, People from Wolverhampton
Park City, Kansas	Cities in Kansas
A Ghost Story	2017 drama movies, American independent movies, American drama movies
Jane the Virgin	Telenovelas, 2014 television series debuts
Molly of Denali	2010s television series, 2019 television series debuts, American animated movies, American television series, Animated television series, Canadian animated television series, Canadian television series, PBS Kids shows, Television series about families, Television series about friendship
Death Eater	Harry Potter characters
Declension	Linguistics, Grammar, Language
Grammatical gender	Gender, Grammar
Edith Irby Jones	1927 births, 2019 deaths, American physicians, American educators, Scientists from Arkansas
Raja Dhale	1940 births, 2019 deaths, Accidental deaths from falls, Indian writers, Political activists, Indian politicians, Ambedkarites
Andrea Camilleri	1925 births, 2019 deaths, Deaths from myocardial infarction, Italian writers, Novelists, Television writers
Centreboard	Sailing, Ship building
Obituary	Death customs
Cadillac Records	2000s biographical movies, 2008 drama movies, 2000s musical movies, American biographical movies, American drama movies, American musical movies, English-language movies, Movies based on real life events, Movies set in Chicago, Illinois, Movies set in Mississippi, Movies set in the 1950s
Hustlers (movie)	2019 comedy-drama movies, American comedy-drama movies
Being Mary Jane	2010s American television series, 2013 television series debuts, English-language television programs
Yas Island	Geography of the United Arab Emirates, Islands of Asia
John Graves Simcoe	British politicians, British generals
Robert L. Johnson	Company founders, Living people, 1946 births, Businesspeople from Mississippi
Stewart Butterfield	Living people, 1973 births, Canadian businesspeople
William Allen White	1868 births, 1944 deaths, Kansas Republicans
Bonner Springs, Kansas	Cities in Johnson County, Kansas, Cities in Leavenworth County, Kansas
Valley Center, Kansas	Cities in Sedgwick County, Kansas
Pratt, Kansas	Cities in Pratt County, Kansas, County seats in Kansas
Bel Aire, Kansas	Cities in Sedgwick County, Kansas
Roeland Park, Kansas	Cities in Johnson County, Kansas
Yana Rhinoceros Horn Site	Siberia
Laramie County, Wyoming	1860s establishments in Wyoming Territory, 1867 establishments in the United States, Wyoming counties
Lincoln County, Wyoming	Wyoming counties, Lincoln County, Wyoming, 1911 establishments in Wyoming
Kemmerer, Wyoming	Cities in Wyoming, County seats in Wyoming, Lincoln County, Wyoming
Alpine, Wyoming	Towns in Wyoming, Lincoln County, Wyoming
Karnes City, Texas	Cities in Texas, County seats in Texas
Kaufman, Texas	Cities in Texas, County seats in Texas
Franklin, Texas	Cities in Texas, County seats in Texas
Bremond, Texas	Cities in Texas
Battle of Aqaba	World War I
Arab Revolt	Ottoman Empire, World War I
Pahumara	Rivers of Assam
Allied Powers of World War I	World War I
Calvert, Texas	Cities in Texas
Hearne, Texas	Cities in Texas
Hondo, Texas	Cities in Texas, County seats in Texas
Floydada, Texas	Cities in Texas, County seats in Texas
Dodd City, Texas	Towns in Texas
Ottawa Dragon Boat festival	Ottawa, Festivals in Canada, China, 1993 establishments in Canada
Tower of Babel	Old Testament
Standard German	German language
Standard German phonology	German language
Abyssinia Crisis	20th century in Italy, History of Italy, History of the United Kingdom, World War II
Yehud Medinata	Ancient Israel and Judah, Autonomous areas, Coordinates on Wikidata
Culper spy ring	American Revolutionary War, Espionage, George Washington, History of New York City, Secret societies, United States intelligence agencies
Upper Canada	1790s in North America, 1791 establishments, 1841 disestablishments, 19th century in North America, British Empire, Colonialism, Former British colonies, Former countries in North America, History of Canada, Ontario, Provinces and territories of Canada, Regions of Canada
Constitutional Act of 1791	British Empire, History of Canada
Lower Canada	Historical territories of Canada, British Empire, 1790s establishments in North America, 1791 establishments, 19th century disestablishments in North America, 1841 disestablishments
Evergy	20th-century establishments in Kansas, 1909 establishments in the United States, Companies of the United States, Electric power companies, Kansas City, Missouri
David Peck	Pages created with the Article Wizard from 2019
Jimi system	History of China
Arab Winter	History of the Middle East, 2010s in Asia, 2010s in Africa, Pages using deprecated image syntax
Julian year	Units of time
Isekai	Anime, Anime and manga terms, Fantasy, Fiction genres, Manga, Movie genres, Television genres
Greek government-debt crisis	Financial crises, Pages using deprecated image syntax, European Union, Politics of Greece
Austerity	Macroeconomics
Swadeshi movement	Indian independence movement
Lawrence University	1840s establishments in Wisconsin Territory, 1847 establishments in the United States, Colleges and universities in Wisconsin
Gadfly	Parasites, Flies
Botfly	Flies
Extraterrestrial sky	Astronomy
Warble fly	Flies, Parasites
Ford County, Kansas	Kansas counties, 1867 establishments in Kansas
Riley County, Kansas	Kansas counties, 1855 establishments in Kansas Territory
Geary County, Kansas	Kansas counties, 1855 establishments in Kansas Territory
Kara Swisher	American journalists
Niobrara County, Wyoming	1911 establishments in Wyoming, Wyoming counties
Platte County, Wyoming	1911 establishments in Wyoming, Wyoming counties
Sheridan County, Wyoming	1880s establishments in Wyoming Territory, 1888 establishments in the United States, Wyoming counties
Atchison County, Kansas	1855 establishments in Kansas Territory, Atchison County, Kansas
Sublette County, Wyoming	20th-century establishments in Wyoming, 1923 establishments in the United States, Wyoming counties
Sheridan, Wyoming	Cities in Wyoming, County seats in Wyoming
Sweetwater County, Wyoming	1860s establishments in Wyoming Territory, 1867 establishments in the United States, Wyoming counties
Uinta County, Wyoming	1860s establishments in Wyoming Territory, 1869 establishments in the United States, Wyoming counties
Washakie County, Wyoming	1911 establishments in Wyoming, Wyoming counties
Cherokee County, Kansas	Cherokee County, Kansas, 1860 establishments in Kansas Territory
Weston County, Wyoming	19th-century establishments in Wyoming, 1890 establishments in the United States, Wyoming counties
Henrietta, Texas	Cities in Texas, County seats in Texas
Pottawatomie County, Kansas	1857 establishments in Kansas Territory, Pottawatomie County, Kansas
Edward Shotter	1933 births, 2019 deaths, Educators, English writers
Lisa Lu	1927 births, Living people, Naturalized citizens of the United States, Chinese movie actors, Chinese television actors, Chinese stage actors, Chinese voice actors, Chinese singers, American movie actors, American television actors, American stage actors, American voice actors, Actors from California, Singers from California
Bruce Laingen	1922 births, 2019 deaths, Deaths from Parkinson's disease, Disease-related deaths in Maryland, American military personnel of World War II, Ambassadors of the United States, American crime victims, Politicians from Minnesota
Butterfield, Minnesota	Towns in Minnesota
John Tanton	1934 births, 2019 deaths, Deaths from Parkinson's disease, Disease-related deaths in Michigan, American political activists, American conservatives, American physicians, American political writers, Writers from Detroit, Michigan
Petoskey, Michigan	Cities in Michigan, County seats in Michigan
Ernie Broglio	1935 births, 2019 deaths, Cancer deaths in California, Chicago Cubs players, St. Louis Cardinals players, Sportspeople from Berkeley, California
Howard Engel	1931 births, 2019 deaths, Deaths from pneumonia, Television producers, Writers from Ontario
Pumpsie Green	1933 births, 2019 deaths, Boston Red Sox players, New York Mets players, Sportspeople from Oklahoma
Boley, Oklahoma	Towns in Oklahoma, 1903 establishments in the United States
Ian Chappell	1943 births, Living people, People with cancer, Australian cricketers, Australian journalists, Australian sports commentators, Sportspeople from South Australia
Wesley Pruden	1935 births, 2019 deaths, American journalists, Writers from Arkansas, Writers from Washington, D.C., People from Little Rock, Arkansas
Husaini Abdullahi	1939 births, 2019 deaths, Military people, Nigerian politicians
Nikola Hajdin	1923 births, 2019 deaths, Serbian people, Engineers, Educators
Charles Ceccaldi-Raynaud	1925 births, 2019 deaths, French lawyers, French mayors, French politicians, French writers
Algerian War	Wars involving France, 1950s in Europe, 1960s in Europe
Luciano De Crescenzo	1928 births, 2019 deaths, Deaths from pneumonia, Italian movie directors, Italian screenwriters, Italian movie actors, People from Naples
Yao Lee	1922 births, 2019 deaths, Chinese singers, People from Shanghai
Bob Beckwith	Living people, People from New York City, 1933 births
Eduardo Cojuangco Jr.	1935 births, 2020 deaths, Deaths from cancer, Deaths from heart failure, Deaths from pneumonia, Filipino politicians, Filipino businesspeople
Jose Cojuangco Jr.	1934 births, Living people, Filipino politicians
Marly Sarney	1932 births, Living people, Brazilian people, South American philanthropists, Socialites
Anacrusis	Musical terminology
Pramod Kharel	1979 births, Living people
Pontotoc County, Mississippi	1836 establishments in Mississippi, Mississippi counties
Amite County, Mississippi	1800s establishments in Mississippi Territory, 1809 establishments in the United States, Mississippi counties
Fort Stockton, Texas	Cities in Texas, County seats in Texas
Giddings, Texas	Cities in Texas, County seats in Texas
Kerrville, Texas	Cities in Texas, County seats in Texas
Adams County, Mississippi	1799 establishments in the United States, 18th-century establishments in Mississippi Territory, Mississippi counties
Alcorn County, Mississippi	1870 establishments in Mississippi, Mississippi counties
Springerville, Arizona	Towns in Arizona
Leavenworth County, Kansas	1855 establishments in Kansas Territory, Leavenworth County, Kansas
Crowding out (economics)	Economic policy, Economic theories, Macroeconomics
Butler County, Kansas	Butler County, Kansas, 1855 establishments in Kansas Territory
Jefferson County, Kansas	Kansas counties, 1855 establishments in Kansas Territory
Slack (software)	Microsoft Windows software, Linux software
Peter Thiel	1967 births, Living people, American billionaires, American Christians, American LGBT people, Gay men, LGBT businesspeople, LGBT Christians, Naturalized citizens of the United States, New Zealand businesspeople, People from Frankfurt, Stanford University alumni, Pages with unreviewed translations
Jackson County, Kansas	Kansas counties, 1859 establishments in Kansas Territory
Crawford County, Kansas	1867 establishments in Kansas, Crawford County, Kansas
Neomercantilism	Economic history, Economic policy, Economic systems
Middle income trap	Economics
Cowley County, Kansas	1867 establishments in Kansas, Cowley County, Kansas
Wichita, KS Metropolitan Statistical Area	Kansas, Sedgwick County, Kansas
Finney County, Kansas	Kansas counties, 1883 establishments in Kansas, Santa Fe Trail
Zion	Zionism, Jerusalem
Levite	Jewish people
Promised Land	Zionism, Pages with unreviewed translations
Greater Israel	Arab–Israeli conflict, Pages with unreviewed translations
Beitar Illit	Cities in Palestine, Cities in Israel
Fiery flying serpent	Pages with unreviewed translations
Nehushtan	Pages with unreviewed translations
McPherson County, Kansas	1867 establishments in Kansas, Kansas counties
Wendelin Werner	Living people, Fields Medalists, 1968 births, Pages with unreviewed translations
Harvey County, Kansas	Kansas counties, 1872 establishments in Kansas
Greeley County, Kansas	Kansas counties, 1873 establishments in Kansas
Allen County, Kansas	Allen County, Kansas, 1855 establishments in Kansas Territory
Barton County, Kansas	Barton County, Kansas, 1867 establishments in Kansas
Franklin County, Kansas	Kansas counties, 1855 establishments in Kansas Territory
Dickinson County, Kansas	1857 establishments in Kansas Territory, Dickinson County, Kansas
Chief Ahan	1865 deaths, First Nations people, Executed people, History of Canada
Józefa Joteyko	1866 births, 1928 deaths, Polish psychologists, Polish academics, Polish physicians, Physiologists, People from Warsaw
Industrial society	Society
Savills	1850s establishments in the United Kingdom, 1855 establishments in Europe, Companies listed on the London Stock Exchange, London
Hurricane Barry (2019)	Atlantic tropical storms, Category 1 Atlantic hurricanes, Hurricanes in Louisiana
Holland's schema theorem	Algorithms
Chinese economic reform	Pages with unreviewed translations, History of the People's Republic of China
Round-bottom flask	Glass, Laboratory equipment
Roelof Nelissen	1931 births, 2019 deaths, Bankers, Catholic People's Party politicians, Deputy Prime Ministers of the Netherlands, Dutch businesspeople, Dutch Roman Catholics, Former members of the House of Representatives of the Netherlands, Government ministers of the Netherlands, Politicians from Zeeland
Jan Terlouw	1931 births, Living people, Democrats 66 politicians, Deputy Prime Ministers of the Netherlands, Dutch children's writers, Dutch former Christians, Dutch physicists, Dutch provincial politicians, Former leaders of political parties in the Netherlands, Former members of the House of Representatives of the Netherlands, Government ministers of the Netherlands, Members of the Senate of the Netherlands, Nuclear physicists, Politicians from Overijssel, Writers from Overijssel
Ágnes Heller	1929 births, 2019 deaths, Accidental deaths by drowning, Philosophers, Political scientists, Political writers, Hungarian educators, Hungarian writers, People from Budapest
Masha Gessen	1967 births, Living people, American LGBT rights activists, American political commentators, Jewish activists, Jewish American writers, Journalists from New York City, Lesbian Jews, LGBT journalists, LGBT people from New York City, Naturalized citizens of the United States, Russian Jews, Russian LGBT people, Translators, Writers from Moscow
Sheila Dikshit	1938 births, 2019 deaths, Deaths from cardiac arrest, Governors of Kerala
R. L. Bhatia	1921 births, 2021 deaths, Governors of Bihar, Governors of Kerala, Deaths from the COVID-19 pandemic in India
Rama Jois	1931 births, 2021 deaths, Governors of Bihar, Governors of Jharkhand, Indian writers, Indian activists, Deaths from cardiac arrest
S. M. Krishna	1932 births, Living people, Governors of Maharashtra
S. C. Jamir	1931 births, Living people, Governors of Goa, Governors of Gujarat, Governors of Maharashtra, Governors of Odisha
K. Sankaranarayanan	1932 births, Living people, Governors of Arunachal Pradesh, Governors of Assam, Governors of Goa, Governors of Jharkhand, Governors of Maharashtra, Governors of Nagaland
R. D. Pradhan	1928 births, 2020 deaths, Governors of Arunachal Pradesh
Jagannath Pahadia	1932 births, 2021 deaths, Deaths from the COVID-19 pandemic in India, Governors of Bihar, Governors of Haryana
Axial Age	History of religion, Ancient history, CS1 German-language sources (de), Pages with unreviewed translations
Attala County, Mississippi	1833 establishments in Mississippi, Mississippi counties
Franklin County, Mississippi	1800s establishments in Mississippi Territory, 1809 establishments in the United States, Mississippi counties
Jefferson County, Mississippi	1799 establishments in the United States, 18th-century establishments in Mississippi Territory, Mississippi counties
Luminous intensity	Astronomy, Light, Measurement, Optics, Physical quantity, Physics, Physiology, SI units
Benton County, Mississippi	1870 establishments in Mississippi, Mississippi counties
Bolivar County, Mississippi	1836 establishments in Mississippi, Mississippi counties
Robie Creek, Idaho	Census-designated places in Idaho
Smiths Ferry, Idaho	Census-designated places in Idaho
Yellow Pine, Idaho	Unincorporated communities in Idaho, Census-designated places in Idaho
Garfield, Washington	Towns in Washington
Leakey, Texas	Cities in Texas, County seats in Texas
Chickasaw County, Mississippi	1836 establishments in Mississippi, Mississippi counties
Japonic languages	Japonic languages
Hakuna matata	The Lion King
Baltimore oriole	Passeriformes, Maryland, Birds of North America
Cosmogony	Universe, Creation myths, Pages with unreviewed translations
History of Russia	History of Russia, Pages with unreviewed translations
Glauber dynamics	Physics
Tropical Storm Danas (2019)	2019 Pacific typhoon season
Fort William (India)	British India, Kolkata
Tuvan People's Republic	1921 establishments in Asia, 1944 disestablishments, 1940s disestablishments in Asia, Former countries in Asia, Former countries of the Interwar period, Former republics, Former socialist republics, Geography of Russia, 20th century in Mongolia, 20th century in Russia, History of the Soviet Union, Siberia, Socialism, States and territories disestablished in the 20th century
Grizzy and the Lemmings	Animated television series
Mark Sanford	1960 births, Living people, 2020 United States presidential candidates, United States representatives from South Carolina, Governors of South Carolina, American educators, Politicians from Florida, People from Fort Lauderdale, Florida, US Republican Party politicians, South Carolina Republicans
Word (computer architecture)	Computing measurement
Raffaele La Capria	1922 births, Living people, Novelists, Italian screenwriters, People from Naples
Gurbanguly Berdimuhamedow	1957 births, Living people, Presidents of Turkmenistan, Current national leaders, Asian politicians
President of Turkmenistan	Presidents of Turkmenistan
Raşit Meredow	1959 births, Living people, Turkmenistan politicians, Vice presidents, People from Ashgabat
Eberhard Kummer	1940 births, 2019 deaths, Austrian singers, Austrian lawyers
Rosa María Britton	1936 births, 2019 deaths, Panamanian people, Novelists, Physicians
Daniel Callahan	1930 births, 2019 deaths, American philosophers, Writers from New York City, Writers from Washington, D.C.
John Elya	1928 births, 2019 deaths, Lebanese people
Bert Rechichar	1930 births, 2019 deaths, Disease-related deaths in Pennsylvania, Indianapolis Colts players, Cleveland Browns players, Pittsburgh Steelers players, Sportspeople from Pennsylvania
Belle Vernon, Pennsylvania	Boroughs in Pennsylvania
Ilaria Occhini	1934 births, 2019 deaths, Italian movie actors, Italian television actors, Italian stage actors, People from Florence
José Manuel Estepa Llaurens	1926 births, 2019 deaths, Cardinals of the Roman Catholic Church, People from Madrid
Louis Lansana Beavogui	1923 births, 1984 deaths, Prime Ministers of Guinea, Presidents of Guinea, Mayors, Diplomats, Deaths from diabetes, Order of Merit of the Federal Republic of Germany
Choctaw County, Mississippi	1833 establishments in Mississippi, Mississippi counties
Claiborne County, Mississippi	1800s establishments in Mississippi Territory, 1802 establishments in the United States, Mississippi counties
Clarke County, Mississippi	1833 establishments in Mississippi, Mississippi counties
Neshoba County, Mississippi	1833 establishments in Mississippi, Mississippi counties
Copiah County, Mississippi	1820s establishments in Mississippi, 1823 establishments in the United States, Mississippi counties
Covington County, Mississippi	1810s establishments in Mississippi, 1819 establishments in the United States, Mississippi counties
Forrest County, Mississippi	1900s establishments in Mississippi, 1908 establishments in the United States, Mississippi counties
DeSoto County, Mississippi	1836 establishments in Mississippi, Mississippi counties
George County, Mississippi	20th-century establishments in Mississippi, 1910 establishments in the United States, Mississippi counties
Ryukyu Kingdom	Okinawa Prefecture, History of Japan, Former monarchies of Asia, Ryukyu Islands, Ryukyu Kingdom
Shurijo	Okinawa Prefecture
Grenada County, Mississippi	1870 establishments in Mississippi, Mississippi counties
Sweetwater, Texas	Cities in Texas, County seats in Texas
Shuri	Okinawa Prefecture
Mamady Youla	1961 births, Prime Ministers of Guinea, African businesspeople, Living people
Okinawa Urban Monorail	Okinawa Prefecture, Japanese railways
Social commentary	Sociology
Low comedy	Comedy, Satire
High Comedy	Comedy, Satire
Hyde Park and Regent's Park bombings	1982 in the United Kingdom, 1980s crimes in the United Kingdom, 1980s explosions in Europe, 1980s in London, 1980s murders in Europe, Attacks on buildings and structures in London, Attacks on buildings and structures in the 1980s, Car and truck bombings in Europe, Explosions in London, July events, Mass murder in London, Mass murder in the 1980s, Provisional Irish Republican Army, Terrorist incidents in London, Terrorist incidents in the United Kingdom in the 1980s
Mainland Japan	Japan
Japanese knotweed	Plants of Asia
Outer Mongolian Revolution of 1911	20th century in Mongolia
Korean Empire	History of Korea, 1897 establishments, 1910 disestablishments, Empires
Japanese annexation of Korea	History of Korea, Pages with unreviewed translations, 1910, 20th century in Japan
Ellsworth County, Kansas	Kansas counties, 1867 establishments in Kansas
Hot pot	Foods
Birmingham pub bombings	1974 in Europe, 1970s crimes in Europe, 1970s disasters in Europe, 1970s explosions, 1970s in the United Kingdom, Attacks on bars, Attacks on buildings and structures in the 1970s, Birmingham, Building bombings in England, Mass murder in England, Mass murder in the 1970s, November events, Provisional Irish Republican Army, Terrorist incidents in the 1970s
List of heads of state of India	Lists of heads of state, Politics of India
Gravitino	Cosmology, Elementary particles, Quantum mechanics
Louisiana Territory	Midwestern United States, Louisiana
Guo Shoujing	1314 deaths, Pages with unreviewed translations
Grand Canal (China)	World Heritage Sites in China, Pages with unreviewed translations, Canals, Bodies of water of Asia
Slavery in the United States	Slavery, History of the United States, African-American history
Primatologist	Branches of zoology, Evolutionary biology, Primates, Psychology, Zoology
Nebraska Territory	Nebraska
Hancock County, Mississippi	1810s establishments in Mississippi Territory, 1812 establishments in the United States, Mississippi counties
Holmes County, Mississippi	1833 establishments in Mississippi, Mississippi counties
Humphreys County, Mississippi	20th-century establishments in Mississippi, 1918 establishments in the United States, Mississippi counties
Issaquena County, Mississippi	1840s establishments in Mississippi, 1844 establishments in the United States, Mississippi counties
Itawamba County, Mississippi	1836 establishments in Mississippi, Mississippi counties
Jackson County, Mississippi	1810s establishments in Mississippi Territory, 1812 establishments in the United States, Mississippi counties
Jasper County, Mississippi	1833 establishments in Mississippi, Mississippi counties
Jefferson Davis County, Mississippi	1900s establishments in Mississippi, 1906 establishments in the United States, Mississippi counties
Kemper County, Mississippi	1833 establishments in Mississippi, Mississippi counties
Lafayette County, Mississippi	1836 establishments in Mississippi, Mississippi counties
Union County, Mississippi	1870 establishments in Mississippi, Mississippi counties
Lamar County, Mississippi	1900s establishments in Mississippi, 1904 establishments in the United States, Mississippi counties
Smith County, Mississippi	1833 establishments in Mississippi, Mississippi counties
Raleigh, Mississippi	Towns in Mississippi, County seats in Mississippi
Gainesville, Texas	Cities in Texas, County seats in Texas
Lauderdale County, Mississippi	1833 establishments in Mississippi, Mississippi counties
Songtsen Gampo	Year of birth unknown, 649 deaths, 7th century births, Pages with unreviewed translations
2019 North Indian Ocean cyclone season	North Indian Ocean cyclones, 2019 in weather
Deal barracks bombing	1989 in Europe, 1980s explosions in Europe, 1980s murders in the United Kingdom, Attacks on buildings and structures in the 1980s, British Army, Building bombings in England, Kent, Mass murder in England, Mass murder in the 1980s, Provisional Irish Republican Army, September events, Terrorist incidents in the United Kingdom in the 1980s
Tropical Storm Pabuk (2019)	2019 Pacific typhoon season
Mobility as a service	Public transport
Khazars	618 establishments, Caucasus, Ethnic groups in Asia, Ethnic groups in Europe, Former countries in Asia, Former countries in Europe, Former monarchies of Asia, Former monarchies of Europe, Nomadic people, Russia, Turkic peoples
Eminem singles discography	Eminem songs
Batam	Cities in Indonesia
Republic of Upper Volta	1958 establishments, 1950s establishments in Africa, French-speaking countries, 1984 disestablishments
Spaceship Earth	Earth, Sustainability
Mutesa II of Buganda	1924 births, 1969 deaths, African politicians, Alumni of the University of Cambridge, Kings and queens, Members of the Order of the British Empire, Presidents of Uganda, Ugandan politicians
Er Wang San Ke	History of China
NEC	19th century establishments in Japan, 1890s establishments in Asia, 1899 establishments, Companies listed on the Tokyo Stock Exchange, Technology companies of Japan, Electronics companies, Mobile phone companies, Multinational technology companies, Tokyo
Neoconservatism	Conservatism, Articles with dead external links from May 2017, All articles with dead external links
Yuji Naka	1965 births, Sega people, Living people
American exceptionalism	Ethnocentrism, American culture
Cartigny, Switzerland	Municipalities of Geneva
Neoconservatism (Japan)	Politics of Japan
Gy, Switzerland	Municipalities of Geneva
Su Dingfang	Pages with unreviewed translations, Chinese military people
Sonic the Hedgehog 2 (8-bit)	Sonic the Hedgehog games, Video game sequels, Master System games, Game Gear games
Zhongyuan	People's Republic of China, Plains
Cuphead	Video games
Polygon (website)	Video games
Slavic paganism	Paganism, Religions, Slavic mythology
Daphne du Maurier	1907 births, 1989 deaths, Bisexual people, British LGBT people, British novelists, British playwrights, British screenwriters, British writers, LGBT novelists, LGBT writers, Members of the Order of the British Empire, People from Cornwall
Yukiya Amano	1947 births, 2019 deaths, Japanese politicians
Don Mossi	1929 births, 2019 deaths, Cleveland Indians players, Detroit Tigers players, Chicago White Sox players, Kansas City Athletics players, Sportspeople from California
St. Helena, California	Cities in California, Napa County, California
Peter McNamara	1955 births, 2019 deaths, Australian Open champions, Australian tennis players, Cancer deaths in Germany, Deaths from prostate cancer, Sportspeople from Melbourne, Wimbledon champions
Chicago Daily News	Newspapers in Chicago
Hugo Cóccaro	1954 births, 2019 deaths, Deaths from cancer, Argentine politicians
Antonino Cuffaro	1932 births, 2019 deaths, Italian politicians, Communists
Paul Krassner	1932 births, 2019 deaths, American political writers, American political activists, Writers from New York City, Comedians from New York City, Journalists from New York City
Desert Hot Springs, California	Cities in California, Settlements in Riverside County, California
Lois Wille	1931 births, 2019 deaths, Deaths from stroke, Cardiovascular disease deaths in Chicago, Pulitzer Prize winners, Journalists from Chicago
Republic of China (1912–1949)	Former polities of the Cold War, 20th century in China, Pages with unreviewed translations
Varieties of Chinese	Pages with unreviewed translations, Chinese language
Peter Hamm	1937 births, 2019 deaths, German poets, German journalists, German critics, People from Munich
Marianne Koch	1931 births, Living people, German movie actors, German television actors, German stage actors, German doctors, Television presenters, People from Munich
Francisco Grau	1947 births, 2019 deaths, Spanish musicians
Bologna massacre	1980 in Europe, 1980s explosions in Europe, 1980s in Italy, 1980s murders in Europe, Attacks on buildings and structures in the 1980s, August events, Bologna, Building bombings in Europe, Disasters in Italy, Mass murder in Europe, Mass murder in the 1980s, Terrorist incidents in Europe in the 1980s
Art Neville	1937 births, 2019 deaths, American singer-songwriters, American soul singers, American R&B singers, American funk musicians, American soul musicians, American R&B musicians, American pianists, Singers from New Orleans, Louisiana, Musicians from New Orleans, Louisiana, Writers from New Orleans, Louisiana
Hans Lagerqvist	1940 births, 2019 deaths, Swedish Olympians, Competitors in athletics, Deaths from brain cancer
Brigitte Kronauer	German writers, People from Essen, 1940 births, 2019 deaths
Maxim Dadashev	1990 births, 2019 deaths, Deaths in sport, Russian sportspeople, Boxers
Oxon Hill, Maryland	Unincorporated communities in Maryland, Census-designated places in Maryland
Cheverly, Maryland	Towns in Maryland
Storm Area 51	June 2019 events, Internet memes
Arcadia Group	Companies of the United Kingdom
SABMiller	1895 establishments in the United Kingdom, 2010s disestablishments in the United Kingdom, 2016 disestablishments in Europe, Defunct companies of the United Kingdom, Beer, London
Home Retail Group	2006 establishments in the United Kingdom, 2010s disestablishments in the United Kingdom, 2016 disestablishments in Europe, Companies of the United Kingdom, Retail markets, Companies listed on the London Stock Exchange, Milton Keynes
Veles (god)	Slavic gods and goddesses
Marzanna	Slavic gods and goddesses
Gerovit	Slavic gods and goddesses
Zhangzhung	Pages with unreviewed translations, History of China, History of India, Former countries in Asia
Video assistant referee	2018, 2018 FIFA World Cup, Football (soccer) terminology, Referees
Nir, Iran	Cities in Iran
Slavic Native Faith	Paganism, Religion, Slavic mythology
Tōyō Bunko	Libraries in Asia, Buildings and structures in Tokyo
Toyo University	Pages with unreviewed translations, 1880s establishments in Japan, 1887 establishments, Colleges and universities in Tokyo
Oyanagi Shigeta	1940 deaths, 1870 births
Epigraphy	CS1 German-language sources (de), CS1 Spanish-language sources (es), CS1 Italian-language sources (it), Writing media, Writing
Mokosh	Slavic gods and goddesses
Luo Zhenyu	1940 deaths, 1866 births, Pages with unreviewed translations
Silesian language	Languages of Europe, Languages with ISO 639-2 code, Poland, Slavic languages
Cen Chunxuan	1933 deaths, 1861 births, Chinese politicians
List of prime ministers of Queen Victoria	Commonwealth realms
Suzhou High School	Pages with unreviewed translations, Schools, China
Taibei Imperial University	Colleges and universities in Taipei, Colleges and universities in Asia, 1928 establishments
Fujita Toyohachi	1929 deaths, 1869 births, People from Tokushima Prefecture, Waseda University faculty
Western Regions	Asia, Pages with unreviewed translations
Weilüe	Pages with unreviewed translations, Books, 3rd century
Cologny	Municipalities of Geneva
Emperor Ming of Han	Pages with unreviewed translations, Emperors and Empresses of China, 20s births, 70s deaths
Kalman filter	Algorithms
An Shigao	Buddhists, Translators, Monks, 140s births, 180s deaths
Thônex	Municipalities of Geneva, Cities in Switzerland
American Indian Wars	Wars
Yao Qian Shu	Luck
Dry county	Local government in the United States
Parliament of Finland	Finland
Kucha	Pages with unreviewed translations, History of China
Jeremy Kemp	1935 births, 2019 deaths, English movie actors, English television actors, English stage actors, Actors from Derbyshire
Michael English (politician)	1930 births, 2019 deaths, Former Labour MPs (UK), UK MPs 1964–1966, UK MPs 1970–1974, UK MPs 1974, UK MPs 1974–1979, UK MPs 1979–1983, Politicians from Nottinghamshire, People from Nottingham, People from Liverpool
Nicodemus, Kansas	Unincorporated communities in Kansas, Graham County, Kansas
Lengger	Dances, Java
Ragged school	19th century, Education in England
Fedio	Villages in Asia, Syria
Pinyin for other languages	Romanization
Latakia Governorate	Governorates of Syria
Wanda Vázquez Garced	1959 births, 1960 births, Governors of Puerto Rico, American lawyers, US Republican Party politicians, People from San Juan, Puerto Rico
Suffern, New York	Villages in New York
Youssef Chahed	1975 births, Living people, Prime Ministers of Tunisia
Napoleon, Ohio	County seats in Ohio, Cities in Ohio
Bloomfield, Connecticut	Towns in Connecticut
Eliel Saarinen	1873 births, 1950 deaths, Naturalized citizens of the United States, Finnish people, Architects from Chicago, People from Michigan
Maumee River	Ohio, Rivers of Indiana
Grand Rapids, Ohio	Villages in Ohio
Henry County, Ohio	1830s establishments in Ohio, 1834 establishments in the United States, Ohio counties
Blue Hills, Connecticut	Census-designated places in Connecticut
Dikembe Mutombo	1966 births, Living people, Naturalized citizens of the United States, American philanthropists, People from the Democratic Republic of the Congo, Denver Nuggets players, Atlanta Hawks players, Philadelphia 76ers players, New Jersey Nets players, New York Knicks players, Houston Rockets players, National Basketball Association players with retired numbers
Bloomberg News	News, Michael Bloomberg
Revenge of the Nerds	1984 movies, 1980s sex comedy movies, 1980s teen comedy movies, 20th Century Fox movies, American movies, American sex comedy movies, American teen comedy movies, English-language movies, Movies about bullying
Vaibhav Chhaya	1987 births, Indian writers, Maharashtra, Poets, Living people, Ambedkarites
If I Ran the Zoo	Books by Dr. Seuss
Céligny	Municipalities of Geneva
Nemesis	Greek gods and goddesses
Chancy	Municipalities of Geneva
Battle of Black Jack	Bleeding Kansas
Viry, Haute-Savoie	Communes in Haute-Savoie
Ungersheim	Communes in Haut-Rhin
Urbès	Communes in Haut-Rhin
Vieux-Ferrette	Communes in Haut-Rhin
Vieux-Thann	Communes in Haut-Rhin
Lawrence County, Mississippi	1810s establishments in Mississippi Territory, 1814 establishments in the United States, Mississippi counties
Black Jack, Kansas	Unincorporated communities in Douglas County, Kansas
Brown County, Kansas	1855 establishments in Kansas Territory, Brown County, Kansas
Anderson County, Kansas	Anderson County, Kansas, 1855 establishments in Kansas Territory
Mohamed Ennaceur	1934 births, Living people, Presidents of Tunisia, Speakers of the Assembly of the Representatives of the People
Mohamed Ghannouchi	1941 births, Living people, Presidents of Tunisia, Prime Ministers of Tunisia
Progressive Party (United States, 1912)	Political parties in the United States
Khakassia	Central Asia, Siberia, Republics of Russia, Coordinates on Wikidata, Federal subjects of Russia
My Neighbors the Yamadas	1990s comedy movies, 1999 movies, Animated movies, Fictional families, Japanese movies, Japanese-language movies, Movies about dysfunctional families, Movies based on comics, Studio Ghibli
Terry Fallis	Canadian novelists, Living people, Year of birth missing (living people)
Stephen Leacock	1869 births, 1944 deaths, Canadian comedians, Canadian novelists, Canadian writers, Cancer deaths in Canada, Deaths from oral cancer, People from Hampshire, Canadian political scientists, University of Chicago alumni
Zhangxun Restoration	Pages with unreviewed translations
Honing oil	Oils
Robert Plutchik	American psychologists, 1927 births, 2006 deaths
Liane Russell	1923 births, 2019 deaths, Naturalized citizens of the United States, Austrian scientists, American geneticists, American activists, American environmentalists, Female scientists, Scientists from Vienna, Scientists from Tennessee, Scientists from Chicago
Ruth Gotlieb	1920s births, 2019 deaths, British politicians, New Zealand politicians, People from Wellington, People from Cork (city)
Barney Smith (museum curator)	1921 births, 2019 deaths, American artists, People from San Antonio, Texas
Ferdinand von Bismarck	1930 births, 2019 deaths, German businesspeople, German lawyers, Princes and princesses, Businesspeople from London
Cathy Inglese	1958 births, 2019 deaths, Accidental deaths from falls in the United States, Sportspeople from Connecticut
Wallingford, Connecticut	Towns in Connecticut
Yankee Candle	1960s establishments in Massachusetts, 1969 establishments in the United States, Companies based in Massachusetts
South Deerfield, Massachusetts	Census-designated places in Massachusetts
Jesper Juul	1948 births, 2019 deaths, Deaths from pneumonia, Danish scientists, Danish writers
Pierre Péan	1938 births, 2019 deaths, French journalists, French historians
Rose Franco	1934 births, Living people, American military people, Puerto Rican people
Gary Ray Bowles	1962 births, 2019 deaths, Executed American serial killers, People executed by lethal injection, American sex offenders, People from Virginia, American people convicted of assault
Graham Freudenberg	1934 births, 2019 deaths, Political writers, Writers from Queensland, People from Brisbane
725 West Randolph	Buildings and structures in Chicago, Illinois
One Chicago Square	Buildings and structures in Chicago, Illinois
400 Lake Shore Drive	Buildings and structures in Chicago, Illinois
Tribune East Tower	Proposed skyscrapers in the United States
Conchata Ferrell	Drama Desk Award winners, 1943 births, 2020 deaths, Deaths from cardiac arrest, American movie actors, American stage actors, American television actors, American voice actors, Actors from West Virginia, People from Charleston, West Virginia
Loudendale, West Virginia	Unincorporated communities in West Virginia
Kanawha County, West Virginia	West Virginia counties
Óscar Enrique Sánchez	1955 births, 2019 deaths, Deaths from surgical complications, People from Guatemala City, Olympians, Guatemalan footballers
Kyoto Animation arson attack	2019 disasters in Asia, 2010s crimes in Asia, 2010s fires, 2010s in Japan, Arson, Attacks on buildings and structures in 2019, Attacks on buildings and structures in Asia, Building and structure fires in Asia, Disasters in Japan, July 2019 events, Kyoto
John Nott	1932 births, Living people, UK MPs 1966–1970, UK MPs 1970–1974, UK MPs 1974, UK MPs 1974–1979, UK MPs 1979–1983, People from Devon, Former Conservative MPs (UK)
Tom King, Baron King of Bridgwater	1933 births, Living people, UK MPs 1966–1970, UK MPs 1970–1974, UK MPs 1974, UK MPs 1974–1979, UK MPs 1979–1983, UK MPs 1983–1987, UK MPs 1987–1992, UK MPs 1992–1997, UK MPs 1997–2001, Former Conservative MPs (UK), People from Warwickshire
Punggol	Places in Singapore
The Reverend William Thornton (1830-1916)	1830 births, 1916 deaths
Yankee	New England
Plymouth Congregational Church (Lawrence, Kansas)	1854 establishments in Kansas Territory, Churches in the United States, Buildings and structures in Lawrence, Kansas, Lawrence, Kansas, National Register of Historic Places in Douglas County, Kansas
Achille, Oklahoma	Towns in Oklahoma
Disney, Oklahoma	Towns in Oklahoma
Barber County, Kansas	1867 establishments in Kansas, Barber County, Kansas
Adair, Oklahoma	Towns in Oklahoma
Addington, Oklahoma	Towns in Oklahoma
Agra, Oklahoma	Towns in Oklahoma
Albion, Oklahoma	Towns in Oklahoma
Alderson, Oklahoma	Towns in Oklahoma
Alex, Oklahoma	Towns in Oklahoma
Bourbon County, Kansas	Bourbon County, Kansas, 1855 establishments in Kansas Territory
Allen, Oklahoma	Towns in Oklahoma
Amber, Oklahoma	Towns in Oklahoma
Decatur County, Kansas	Kansas counties, 1873 establishments in Kansas
Ames, Oklahoma	Towns in Oklahoma
Cleo Springs, Oklahoma	Towns in Oklahoma
Chêne-Bourg	Municipalities of Geneva
Jewell County, Kansas	1887 establishments in Kansas, Jewell County, Kansas
Scott County, Kansas	1873 establishments in Kansas, Kansas counties
Seward County, Kansas	Seward County, Kansas, 1873 establishments in Kansas
Sumner County, Kansas	1870s establishments in Kansas, 1870 establishments in the United States, Sumner County, Kansas
Reno County, Kansas	1867 establishments in Kansas, Reno County, Kansas
Miami County, Kansas	Miami County, Kansas, 1855 establishments in Kansas Territory
Republic County, Kansas	Kansas counties, 1860 establishments in Kansas Territory
McGurk's Bar bombing	1971 in Europe, 1970s crimes in Europe, 1970s disasters in Europe, 1970s explosions, Attacks on bars, Attacks on buildings and structures in Northern Ireland, Attacks on buildings and structures in the 1970s, Belfast, Building bombings in the United Kingdom, December events, Explosions in Northern Ireland, Mass murder in Northern Ireland, Mass murder in the 1970s, Terrorist incidents in the 1970s, The Troubles
Fort Rouge (fortification)	1738 establishments, Winnipeg
Rice County, Kansas	Rice County, Kansas, 1867 establishments in Kansas
Pratt County, Kansas	Pratt County, Kansas, 1867 establishments in Kansas
Rawlins County, Kansas	Kansas counties, 1873 establishments in Kansas
Meade County, Kansas	Meade County, Kansas, 1873 establishments in Kansas
Mitchell County, Kansas	1867 establishments in Kansas, Mitchell County, Kansas
Russell County, Kansas	Russell County, Kansas, 1867 establishments in Kansas
Rush County, Kansas	Rush County, Kansas, 1867 establishments in Kansas
Ruanruan	Languages of China, Pages with unreviewed translations
Phillips County, Kansas	Phillips County, Kansas, 1867 establishments in Kansas
Pawnee County, Kansas	1867 establishments in Kansas, Pawnee County, Kansas
Chautauqua County, Kansas	1875 establishments in Kansas, Chautauqua County, Kansas
Chase County, Kansas	1859 establishments in Kansas Territory, Chase County, Kansas
Cheyenne County, Kansas	Cheyenne County, Kansas, 1873 establishments in Kansas
Heqin	Marriage, Chinese culture
Rouran	Eurasian nomads, History of Mongolia, Pages with unreviewed translations
Eurasian Steppe	History of Pakistan, Eastern Europe, Central Asia
Otuken	History of Mongolia, Pages with unreviewed translations
Chu River	Coordinates on Wikidata, Rivers of Asia, Geography of Kyrgyzstan, Geography of Kazakhstan
Lake Balqash	Lakes of Asia, Coordinates on Wikidata
North–South Corridor, Singapore	Transport in Singapore
Expressways of Singapore	Lists of roads, Transport in Singapore
Pentium 4	Computer processors
Lee-Enfield	Rifles
Mosin-Nagant	Rifles
7.62 x 54mmR	Pistol and rifle cartridges, Military cartridges
Bai people	Ethnic groups in China
Tubo	618 establishments, Former countries in Central Asia, History of Asia, Former monarchies of Asia, All articles with dead external links, All articles with unsourced statements
Bamar	Pages using deprecated image syntax, Pages with unreviewed translations
Nanzhao	Former monarchies of Asia
Rosé (singer)	1997 births, Living people, K-pop singers, Blackpink members, New Zealand singers
G98 Mauser rifle	Rifles
M1903 Springfield rifle	Rifles
.30-06 Springfield	Ammunition
Effective range	Ballistics, Ammunition
Muzzle velocity	Ballistics, Ammunition
Shirley Williams	1930 births, 2021 deaths, Academics of the University of Cambridge, Academics of the University of Oxford, Alumni of the University of Oxford, Columbia University alumni, English Roman Catholics, Former Labour MPs (UK), Former Liberal Democrats MPs (UK), Former members of the British House of Commons for English constituencies, Harvard University faculty, Journalists from London, Members of the House of Lords, Secretaries of State of the United Kingdom, Social Democratic Party MPs (UK), UK MPs 1964–1966, UK MPs 1966–1970, UK MPs 1970–1974, UK MPs 1974, UK MPs 1974–1979, UK MPs 1979–1983, Politicians from London, Women politicians
Antonia Fraser	1932 births, Living people, British writers
Evelyn Glennie	British musicians, 1965 births, Living people, Knights and Dames Commander of the Order of the British Empire
Terajoule	Units of measurement, Energy
Hipercor bombing	1987 in Europe, 1980s explosions in Europe, 1980s murders in Europe, Attacks on buildings and structures in the 1980s, Building bombings in Europe, Car and truck bombings in Europe, Crime in Spain, History of Barcelona, June events, Terrorist incidents in Europe in the 1980s
Mary Peters	1939 births, Living people, British athletes
Kathleen Lonsdale	1903 births, 1971 deaths, British scientists
Tropical Storm Nari	2019 Pacific typhoon season
Leake County, Mississippi	1833 establishments in Mississippi, Mississippi counties
Simpson County, Mississippi	1820s establishments in Mississippi, 1824 establishments in the United States, Mississippi counties
Amorita, Oklahoma	Towns in Oklahoma
Apache, Oklahoma	Towns in Oklahoma
Arapaho, Oklahoma	Towns in Oklahoma, County seats in Oklahoma
Congressional caucus	Politics
Nelson Muntz	Fictional criminals, The Simpsons characters, Fictional characters introduced in 1990
Hendrix, Oklahoma	Towns in Oklahoma
Arkoma, Oklahoma	Towns in Oklahoma
Armstrong, Oklahoma	Towns in Oklahoma
Avant, Oklahoma	Towns in Oklahoma
Arnett, Oklahoma	Towns in Oklahoma, County seats in Oklahoma
Ashland, Oklahoma	Towns in Oklahoma
Mannford, Oklahoma	Cities in Oklahoma
Atwood, Oklahoma	Towns in Oklahoma
Bearden, Oklahoma	Towns in Oklahoma
Bennington, Oklahoma	Towns in Oklahoma
Bernice, Oklahoma	Towns in Oklahoma
Bessie, Oklahoma	Cities in Oklahoma
Bethel Acres, Oklahoma	Towns in Oklahoma
Big Cabin, Oklahoma	Towns in Oklahoma
Billings, Oklahoma	Cities in Oklahoma
Binger, Oklahoma	Towns in Oklahoma
Carmen, Oklahoma	Towns in Oklahoma
Blackburn, Oklahoma	Towns in Oklahoma
Blair, Oklahoma	Towns in Oklahoma
Fallis, Oklahoma	Towns in Oklahoma
Bradley, Oklahoma	Towns in Oklahoma
Hank Stuever	1968 births, Living people
Dublin and Monaghan bombings	1974 in Europe, 1970s crimes in Europe, 1970s disasters in Europe, 1970s explosions, 20th century in Dublin, Attacks on buildings and structures in the 1970s, Building bombings in Europe, Car and truck bombings in Europe, Mass murder in Europe, Mass murder in the 1970s, May events, Terrorist incidents in the 1970s, The Troubles
Jack Ü	American DJs
Hexadecene	Alkenes
President of Gabon	Presidents of Gabon
301 Deansgate	Manchester, Buildings and structures in England
Blake Camp	1983 births, American footballers, Sportspeople from Georgia (U.S. state), Living people
E-book reader	Books, Computer science, Electronics
Zhongli District	Counties of Taiwan
Acastus	People in Greek mythology
Presidential Commission of Uganda	Uganda
Enniskillen bombing	1987 in Europe, 1980s explosions in Europe, 1980s murders in the United Kingdom, Attacks on buildings and structures in Northern Ireland, Attacks on buildings and structures in the 1980s, Building bombings in the United Kingdom, Explosions in Northern Ireland, Mass murder in Northern Ireland, November events, Provisional Irish Republican Army, Terrorist incidents in the United Kingdom in the 1980s
Atchison, Topeka and Santa Fe Railway	Rail transport in the United States, Companies of the United States
List of monarchs of the Netherlands	Lists of heads of state, Kings and Queens of the Netherlands
CIS Tower	Buildings and structures in England, Skyscrapers
1983 Cricket World Cup	1983 in sports, Cricket World Cup, Cricket in India, History of England, History of Wales, Sport in the United Kingdom
Kyle Korver	1981 births, American basketball players, American Christians, Atlanta Hawks players, Chicago Bulls players, Cleveland Cavaliers players, Milwaukee Bucks players, Philadelphia 76ers players, Utah Jazz players, Basketball players from California, Sportspeople from Los Angeles County, California, Living people
Bluejacket, Oklahoma	Towns in Oklahoma
Bokchito, Oklahoma	Towns in Oklahoma
Caddo, Oklahoma	Towns in Oklahoma
Bokoshe, Oklahoma	Towns in Oklahoma
Boswell, Oklahoma	Towns in Oklahoma
Boynton, Oklahoma	Towns in Oklahoma
Braggs, Oklahoma	Towns in Oklahoma
Braman, Oklahoma	Towns in Oklahoma
Kildare, Oklahoma	Towns in Oklahoma
Bray, Oklahoma	Towns in Oklahoma
Breckenridge, Oklahoma	Towns in Oklahoma
Calera, Oklahoma	Towns in Oklahoma
Colbert, Oklahoma	Towns in Oklahoma
Kemp, Oklahoma	Towns in Oklahoma
Kenefic, Oklahoma	Towns in Oklahoma
Mead, Oklahoma	Towns in Oklahoma
Silo, Oklahoma	Towns in Oklahoma
Burbank, Oklahoma	Towns in Oklahoma
Bromide, Oklahoma	Cities in Oklahoma
Calumet, Oklahoma	Towns in Oklahoma
Brooksville, Oklahoma	Towns in Oklahoma
Byron, Oklahoma	Towns in Oklahoma
Jet, Oklahoma	Towns in Oklahoma
Colony, Oklahoma	Cities in Oklahoma
Calvin, Oklahoma	Towns in Oklahoma
Clark County, Kansas	Kansas counties, 1867 establishments in Kansas
Marion County, Kansas	Marion County, Kansas, 1855 establishments in Kansas Territory
Marshall County, Kansas	1855 establishments in Kansas Territory, Marshall County, Kansas
Hodgeman County, Kansas	Kansas counties, 1867 establishments in Kansas
Haskell County, Kansas	Kansas counties, 1887 establishments in Kansas
Harper County, Kansas	Harper County, Kansas, 1867 establishments in Kansas
Hamilton County, Kansas	Kansas counties, 1873 establishments in Kansas
Greenwood County, Kansas	Greenwood County, Kansas, 1855 establishments in Kansas Territory
Sheridan County, Kansas	Kansas counties, 1873 establishments in Kansas
Sherman County, Kansas	Kansas counties, 1886 establishments in Kansas
Kurdistan Vegans	Animal rights
Vizianagaram district	1970s establishments in India, 1979 establishments in Asia, Districts of Andhra Pradesh
Jacques Necker	18th century in France, Finance
Léon M'ba	1902 births, 1967 deaths, Presidents of Gabon, Prime Ministers of Gabon, Roman Catholics, Cancer deaths in France
Camargo, Oklahoma	Towns in Oklahoma
Leedey, Oklahoma	Towns in Oklahoma
Oakwood, Oklahoma	Towns in Oklahoma
Putnam, Oklahoma	Towns in Oklahoma
Vici, Oklahoma	Towns in Oklahoma
Etowah, Oklahoma	Towns in Oklahoma
Byng, Oklahoma	Towns in Oklahoma
Omar Bongo	1935 births, 2009 deaths, African politicians, Converts to Islam, Deaths from myocardial infarction, Former Christians, Muslims, Freemasons, Presidents of Gabon, Vice presidents
Fitzhugh, Oklahoma	Towns in Oklahoma
Francis, Oklahoma	Towns in Oklahoma
IXL, Oklahoma	Towns in Oklahoma
Castle, Oklahoma	Towns in Oklahoma
Norge, Oklahoma	Towns in Oklahoma
Buffalo, Oklahoma	Towns in Oklahoma, County seats in Oklahoma
Cole, Oklahoma	Towns in Oklahoma
Byars, Oklahoma	Towns in Oklahoma
Burlington, Oklahoma	Towns in Oklahoma
Burns Flat, Oklahoma	Towns in Oklahoma
Butler, Oklahoma	Towns in Oklahoma
Terral, Oklahoma	Towns in Oklahoma
Cornish, Oklahoma	Towns in Oklahoma
WASP	Social groups, United States
Osborne County, Kansas	Osborne County, Kansas, 1867 establishments in Kansas
Osage County, Kansas	Osage County, Kansas, 1859 establishments in Kansas Territory
Comanche County, Kansas	1867 establishments in Kansas, Comanche County, Kansas
Gracemont, Oklahoma	Towns in Oklahoma
Eakly, Oklahoma	Towns in Oklahoma
Cloud County, Kansas	1867 establishments in Kansas, Cloud County, Kansas
Coffey County, Kansas	Kansas counties, 1855 establishments in Kansas Territory
Kearny County, Kansas	Kearny County, Kansas, 1873 establishments in Kansas
Cameron, Oklahoma	Towns in Oklahoma
Fort Coffee, Oklahoma	Towns in Oklahoma
Clayton, Oklahoma	Towns in Oklahoma
Kingman County, Kansas	Kansas counties, 1872 establishments in Kansas
Kiowa County, Kansas	Kiowa County, Kansas, 1867 establishments in Kansas, Kansas counties
Woodson County, Kansas	Kansas counties, 1855 establishments in Kansas Territory
Washington County, Kansas	Washington County, Kansas, 1857 establishments in Kansas Territory
Wabaunsee County, Kansas	Wabaunsee County, Kansas, 1859 establishments in Kansas Territory
Wallace County, Kansas	Kansas counties, 1868 establishments in Kansas
Morris County, Kansas	Kansas counties, 1859 establishments in Kansas Territory
Morton County, Kansas	Kansas counties, 1886 establishments in Kansas
Nemaha County, Kansas	Nemaha County, Kansas, 1855 establishments in Kansas Territory
Wilson County, Kansas	1855 establishments in Kansas Territory, Wilson County, Kansas
John Minto	1950s births, Living people
Fukuiraptor	Dinosaurs of Asia, Theropods, Cretaceous dinosaurs
Dot Island	Islands, South Georgia and the South Sandwich Islands
2015 Ankara bombings	2015 in Asia, 2010s explosions in Asia, Ankara, Crime in Turkey, Explosions in 2015, Islamic State, Islamic terrorist incidents in 2015, Islamic terrorist incidents in Asia, Mass murder in 2015, Mass murder in Asia, October 2015 events, Suicide bombings in Asia, Suicide bombings in the 2010s, Terrorist incidents in Asia in the 2010s
Yogi Adityanath	1972 births, Living people, Indian Hindus, Bharatiya Janata Party politicians, Monks, Politicians from Uttar Pradesh
Fatsia	Asterids
Trivendra Singh Rawat	Indian politicians
Qatna	Archaeological sites in Syria, Assyria, Cities in Syria, Former monarchies of Asia
Wichita County, Kansas	Kansas counties, 1886 establishments in Kansas
Trego County, Kansas	Kansas counties, 1879 establishments in Kansas
Thomas County, Kansas	Thomas County, Kansas, 1885 establishments in Kansas
Stanton County, Kansas	Kansas counties, 1887 establishments in Kansas
Stafford County, Kansas	Kansas counties, 1879 establishments in Kansas
Harish Rawat	Indian politicians, 1948 births, Living people
Smith County, Kansas	1872 establishments in Kansas, Smith County, Kansas
Labette County, Kansas	1867 establishments in Kansas, Labette County, Kansas
Lane County, Kansas	Kansas counties, 1873 establishments in Kansas
Lincoln County, Kansas	Lincoln County, Kansas, 1867 establishments in Kansas
Devika Singh	Living people, Year of birth missing (living people)
Bipin Rawat	Indian military people, 1958 births, Living people, Uttarakhand
Linn County, Kansas	Linn County, Kansas, 1867 establishments in Kansas
Logan County, Kansas	Kansas counties, 1887 establishments in Kansas
Unmukt Chand	1993 births, Living people, Indian cricketers, People from New Delhi
Lyon County, Kansas	1862 establishments in Kansas, Lyon County, Kansas
Neosho County, Kansas	Kansas counties, 1861 establishments in Kansas
Ness County, Kansas	Ness County, Kansas, 1867 establishments in Kansas
Norton County, Kansas	Kansas counties, 1867 establishments in Kansas
Gray County, Kansas	Gray County, Kansas, 1881 establishments in Kansas
Grant County, Kansas	Kansas counties, 1873 establishments in Kansas
Graham County, Kansas	Graham County, Kansas, 1887 establishments in Kansas
Gove County, Kansas	Kansas counties, 1868 establishments in Kansas
Elk County, Kansas	Kansas counties, 1875 establishments in Kansas
Edwards County, Kansas	Kansas counties, 1874 establishments in Kansas
Doniphan County, Kansas	Doniphan County, Kansas, 1855 establishments in Kansas Territory
Elizabeth Lane	1905 births, 1988 deaths
Rose Heilbron	1914 births, 2005 deaths, British lawyers, Knights and Dames Commander of the Order of the British Empire, Deaths from pneumonia, Infectious disease deaths in England
Helena Normanton	1882 births, 1957 deaths
Right of survivorship	Property
College town	Colleges and universities, Settlements
John Trumbull	1756 births, 1843 deaths, American artists
Sousaphone	Brass instruments
British .303	Ammunition, Military cartridges, Pistol and rifle cartridges
Lisa (rapper)	1997 births, Living people, K-pop singers, Blackpink members, Thai singers, Models, Rap musicians
Istanbul nightclub shooting	2017 mass shootings, 2017 murders in Europe, 2010s in Turkey, 2010s mass shootings in Europe, Attacks on buildings and structures in 2017, Attacks on buildings and structures in Europe, Attacks on nightclubs, Crime in Turkey, Islamic State, Islamic terrorist incidents in 2017, Istanbul, January 2017 events, Mass murder in 2017, Mass murder in Europe, Terrorist incidents in Europe in 2017
Eric Prydz	DJs, Swedish people, Living people, Year of birth missing (living people)
Negroland	History of Africa
Canton, Oklahoma	Towns in Oklahoma
Hydro, Oklahoma	Towns in Oklahoma
Okeene, Oklahoma	Towns in Oklahoma
Helena, Oklahoma	Towns in Oklahoma
Clearview, Oklahoma	Towns in Oklahoma
Paden, Oklahoma	Towns in Oklahoma
Weleetka, Oklahoma	Towns in Oklahoma
Canadian, Oklahoma	Towns in Oklahoma
Caney, Oklahoma	Towns in Oklahoma
Stringtown, Oklahoma	Towns in Oklahoma
Tushka, Oklahoma	Towns in Oklahoma
Lane, Oklahoma	Census-designated places in Oklahoma, Unincorporated communities in Oklahoma
Dotyville, Oklahoma	Census-designated places in Oklahoma
Sunflower County, Mississippi	1840s establishments in Mississippi, 1844 establishments in the United States, Mississippi counties
Colby, Kansas	Cities in Thomas County, Kansas, County seats in Kansas, 1885 establishments in Kansas
Ulysses, Kansas	Cities in Kansas, County seats in Kansas
Paola, Kansas	Cities in Miami County, Kansas, County seats in Kansas, 1855 establishments in Kansas Territory
Iola, Kansas	County seats in Kansas, 1859 establishments in Kansas Territory, Cities in Allen County, Kansas
Canute, Oklahoma	Towns in Oklahoma
Capron, Oklahoma	Towns in Oklahoma
Dacoma, Oklahoma	Towns in Oklahoma
Carney, Oklahoma	Towns in Oklahoma
Lee County, Mississippi	19th-century establishments in Mississippi, 1866 establishments in the United States, Mississippi counties
Aladdin al-Ayyubi	1958 births
Glasgow, West Virginia	Towns in West Virginia
Cairo, West Virginia	Towns in West Virginia
Cement, Oklahoma	Towns in Oklahoma
Carrier, Oklahoma	Towns in Oklahoma
Douglas, Oklahoma	Towns in Oklahoma
Carter, Oklahoma	Towns in Oklahoma
Sweetwater, Oklahoma	Towns in Oklahoma
Texola, Oklahoma	Towns in Oklahoma
Kansas, Oklahoma	Towns in Oklahoma
West Siloam Springs, Oklahoma	Towns in Oklahoma
Armistead, Louisiana	Unincorporated communities in Red River Parish, Louisiana
Cimarron City, Oklahoma	Towns in Oklahoma
Hardesty, Oklahoma	Towns in Oklahoma
Goodwell, Oklahoma	Towns in Oklahoma
Grainola, Oklahoma	Towns in Oklahoma
Osage, Oklahoma	Towns in Oklahoma
Fairfax, Oklahoma	Towns in Oklahoma
El Segundo, California	Cities in California, Settlements in Los Angeles County, California
Greenville, Texas	Cities in Texas, County seats in Texas
Haskell, Oklahoma	Towns in Oklahoma
Lincoln County, Mississippi	1870 establishments in Mississippi, Mississippi counties
Cyril, Oklahoma	Towns in Oklahoma
Lincoln County, New Mexico	New Mexico counties
Lincoln County, Georgia	1796 establishments in Georgia (U.S. state), Georgia (U.S. state) counties
Cashion, Oklahoma	Towns in Oklahoma
Sevastopol Naval Base	Military of Russia, History of the Soviet Union, Establishments in Russia, 21st century in Ukraine, Ports and harbours of Europe
Node of Ranvier	Nervous system
14 October 2017 Mogadishu bombings	2017 in Africa, 2010s explosions in Africa, 2010s murders in Africa, 21st century in Somalia, Al-Shabaab (militant group), Attacks on buildings and structures in 2017, Building bombings in Africa, Explosions in 2017, Islamic terrorist incidents in 2017, Islamic terrorist incidents in Africa, Mass murder in 2017, Mass murder in Africa, October 2017 events, Suicide bombings in Africa, Suicide bombings in the 2010s, Suicide car and truck bombings, Terrorist incidents in Africa in the 2010s
Yang di-Pertuan Agong	History of Malaysia
Brian Westbrook	1979 births, American football running backs, Living people, Sportspeople from Washington, D.C., Philadelphia Eagles players, San Francisco 49ers players
Koy Detmer	1973 births, American football quarterbacks, Living people, Sportspeople from San Antonio, Texas, Philadelphia Eagles players
List of Sultans of Brunei	Sultans, Brunei
Jeff Garcia	1970 births, American football quarterbacks, Cleveland Browns players, Detroit Lions players, Houston Texans players, Oakland Raiders players, Philadelphia Eagles players, San Francisco 49ers players, Tampa Bay Buccaneers players, Sportspeople from California, Living people
David Carr (American football)	1979 births, American football quarterbacks, Carolina Panthers players, Houston Texans players, New York Giants players, San Francisco 49ers players, Sportspeople from California, People from Bakersfield, California, Living people
Big Blue River (Kansas)	Rivers of Kansas, Rivers of Nebraska
Guam rail	Flightless birds
Pacific Data Images	American animation studios, 1980 establishments in the United States, 2015 disestablishments in the United States, Defunct companies of the United States
Antz	1990s adventure movies, 1990s computer-animated movies, 1990s fantasy movies, 1998 comedy movies, 1998 animated movies, American adventure movies, American animated movies, American comedy movies, American family movies, American fantasy movies, Turkish movies, DreamWorks Animation movies, DreamWorks Pictures movies, English-language movies, Movies about animals, Movies composed by Harry Gregson-Williams, Movies composed by John Powell, Movies set in the United States
The Paul Daniels Magic Show	1970s British television series, 1980s British television series, 1990s British television series, BBC Television programmes
Argentine National Museum of History	Museums, Buenos Aires
Allegro	Classical music
Libby Lane	1966 births, Living people, Alumni of the University of Oxford, Anglican bishops, Anglican priests, English Anglicans, English priests, People from Buckinghamshire
FATCA agreement between Canada and the United States	Canada, United States federal legislation, Finance, Taxation, International law, Banks
Home Nations	Geography of the United Kingdom, Political geography, Politics of the United Kingdom, Sport in England, Sport in Ireland, Sport in Northern Ireland, Sport in Scotland, Sport in Wales, Sport in the Republic of Ireland, Sport in the United Kingdom, Subdivisions of the United Kingdom
Cambroraster	Fossils, Cambrian
Chouteau, Oklahoma	Towns in Oklahoma
Sportsmen Acres, Oklahoma	Towns in Oklahoma
Spavinaw, Oklahoma	Towns in Oklahoma
Langley, Oklahoma	Towns in Oklahoma
Grand Lake Towne, Oklahoma	Towns in Oklahoma
Fort Cobb, Oklahoma	Towns in Oklahoma
Lookeba, Oklahoma	Towns in Oklahoma
Sterling, Oklahoma	Cities in Oklahoma
Academy of Science and Arts of Bosnia and Herzegovina	1951 establishments in Europe, National academies of sciences, Sarajevo
Geronimo, Oklahoma	Towns in Oklahoma
Fletcher, Oklahoma	Towns in Oklahoma
Salina, Oklahoma	Towns in Oklahoma
Sams Corner, Oklahoma	Census-designated places in Oklahoma
Hinton, Oklahoma	Towns in Oklahoma
Lima, Oklahoma	Towns in Oklahoma
Earlsboro, Oklahoma	Towns in Oklahoma
Pink, Oklahoma	Towns in Oklahoma
Pittsburg, Oklahoma	Towns in Oklahoma
Indianola, Oklahoma	Towns in Oklahoma
Savanna, Oklahoma	Towns in Oklahoma
Crowder, Oklahoma	Towns in Oklahoma
Colcord, Oklahoma	Towns in Oklahoma
Oaks, Oklahoma	Towns in Oklahoma
Hulbert, Oklahoma	Towns in Oklahoma
Carnegie, Oklahoma	Cities in Oklahoma
Panama, Oklahoma	Towns in Oklahoma
Saiga-12	Shotguns
7.62×51mm NATO	Ammunition, Military cartridges, NATO, Pistol and rifle cartridges
Hiroshi Hara	Botanists, Japanese biologists
7.62 x 39mm	7.62 mm firearms, Military cartridges, Pistol and rifle cartridges
Penetration power	Ballistics, Ammunition
Intermediate cartridge	Ammunition
5.45 x 39mm	Pistol and rifle cartridges, Military cartridges
Type-99 light machine gun	Light machine guns
M1919 Browning machine gun	7.62 mm firearms, Medium machine guns, Machine guns of the United States, Light machine guns
Arisaka rifle	History of Japan, Japanese weapons, Rifles
Type 92 machine gun	Machine guns
Urap	Salads, Indonesian culture, Asian foods
Denmark Place fire	1980 in Europe, 1980s disasters in Europe, 1980s fires, 1980s murders in the United Kingdom, Arson, Attacks on buildings and structures in London, Attacks on buildings and structures in the 1980s, August events, Building and structure fires in the United Kingdom, Fires in London, Mass murder in London, Mass murder in the 1980s
President of Vanuatu	Presidents of Vanuatu, Heads of state
Central High, Oklahoma	Towns in Oklahoma
Chattanooga, Oklahoma	Towns in Oklahoma
Cooperton, Oklahoma	Towns in Oklahoma
Copan, Oklahoma	Towns in Oklahoma
Council Hill, Oklahoma	Cities in Oklahoma
Covington, Oklahoma	Towns in Oklahoma
Cowlington, Oklahoma	Towns in Oklahoma
Coyle, Oklahoma	Towns in Oklahoma
Custer City, Oklahoma	Towns in Oklahoma
Hammon, Oklahoma	Towns in Oklahoma
Reydon, Oklahoma	Towns in Oklahoma
Strong City, Oklahoma	Towns in Oklahoma
Texhoma, Oklahoma	Towns in Oklahoma
Okay, Oklahoma	Towns in Oklahoma
Fair Oaks, Oklahoma	Towns in Oklahoma
Oologah, Oklahoma	Towns in Oklahoma
Davenport, Oklahoma	Towns in Oklahoma
Sparks, Oklahoma	Cities in Oklahoma
King of the Monsters (video game)	1991 video games, Arcade games, Fighting games, Video game series, Video games developed in Japan, Virtual Console games, Sega Genesis games, Super Nintendo Entertainment System games
You Gotta Be	1994 songs, Soul songs
Sandbox (computer security)	Computer security
2019 El Paso shooting	2019 crimes in the United States, 2019 mass shootings, 2010s crimes in Texas, 2010s mass shootings in the United States, Attacks on buildings and structures in 2019, Attacks on buildings and structures in the United States, Attacks on shops, August 2019 events, Deaths by firearm in Texas, El Paso, Texas, Mass shootings in Texas
2019 Dayton shooting	2019 crimes in the United States, 2019 mass shootings, 2010s in Ohio, 2010s mass shootings in the United States, 2019 murders in the United States, Attacks on bars, Attacks on buildings and structures in the United States, August 2019 events, Dayton, Ohio, Mass murder in 2019, Mass murder in the United States, Murders by firearm in the United States
Deaths in August 2019	2019 deaths, August 2019 events
Rivet	Objects, Manufacturing, Iron
Kristina Tremasova	Figure skaters, Living people, 1995 births, Bulgarian sportspeople
Church Street, Pretoria bombing	1983, 1980s explosions, 20th century in South Africa, Car and truck bombings, Explosions in Africa, Mass murder in Africa, Mass murder in the 1980s, May events, Pretoria, Terrorist incidents in Africa, Terrorist incidents in the 1980s
List of flags by country	Lists of flags
Sajid Javid	1969 births, Living people, Alumni of the University of Exeter, Bankers, Chancellors of the Exchequer, Conservative MPs (UK), Members of the British House of Commons for English constituencies, People from Bristol, Politicians from Lancashire, Privy Councillors (UK), Secretaries of State for the Home Department, UK MPs 2010–2015, UK MPs 2015–2017, UK MPs 2017–2019, UK MPs 2019–
Gopikrishnan Kottoor	Indian poets, 1956 births
U.S. Route 36	U.S. Highways
Southern Miss Golden Eagles	Conference USA, Mississippi, Sports in the United States
U.S. Route 50	U.S. Highways
U.S. Route 54	U.S. Highways
Kar98 rifle	Rifles
United Nations Partition Plan for Palestine	1947 establishments, 1947 in law, Arab–Israeli conflict, History of Israel, History of Jordan, History of Palestine, History of the United Nations
Consumer price index	Economic indicators, Finance, Inflation, Macroeconomics, Microeconomics, Statistics
Stourbridge	Towns in the West Midlands (county)
Dudley	Towns in the West Midlands (county)
Nature Cat	2010s American television series, 2015 American television series debuts, American animated television series, Canadian animated television series, PBS Kids shows
Splash and Bubbles	English-language television programs, 2016 television series debuts, 2018 television series endings
Gordon Brand Jnr	1958 births, 2019 deaths, Scottish sportspeople, British golfers
Puși Dinulescu	People from Bucharest, 1942 births, 2019 deaths, Deaths from myocardial infarction, Romanian writers, Poets, Playwrights, Romanian movie directors
Ian Gibbons (musician)	1952 births, 2019 deaths, Deaths from bladder cancer, English pianists, Keyboardists
Dee Margo	1952 births, 21st-century American politicians, Living people
Prime Minister of Cameroon	Prime Ministers of Cameroon
Sadou Hayatou	1942 births, 2019 deaths, Prime Ministers of Cameroon
Simon Achidi Achu	1934 births, 2021 deaths, Prime Ministers of Cameroon
Joseph Ngute	1954 births, Living people, Prime Ministers of Cameroon, Current national leaders
President of Cameroon	Presidents of Cameroon
Ahmadou Ahidjo	1924 births, 1989 deaths, Deaths from myocardial infarction, Presidents of Cameroon, Prime Ministers of Cameroon
Federal Chancellor of Switzerland	Federal Chancellors of Switzerland
Walter Thurnherr	1963 births, Living people, Federal Chancellors of Switzerland
François Couchepin	Federal Chancellors of Switzerland, 1935 births, Living people
Annemarie Huber-Hotz	Federal Chancellors of Switzerland, Deaths from myocardial infarction, 1948 births, 2019 deaths
Ueli Maurer	1950 births, Living people, Presidents of the Swiss Confederation
René Felber	1933 births, 2020 deaths, Presidents of the Swiss Confederation
Milovan Minja Prelević	1970 births, 2019 deaths, Montenegrin footballers
Deepak Obhrai	1950 births, 2019 deaths, Deaths from liver cancer, Politicians from Alberta, People from Calgary, Privy Councillors (Canada), Members of the House of Commons of Canada
Schoschana Rabinovici	Holocaust survivors, 1932 births, 2019 deaths, Lithuanian Jews, Polish Jews, Israeli Jews, Polish writers, Israeli writers, Writers from Paris
Jocelyne Roy-Vienneau	1956 births, 2019 deaths, Canadian politicians, Cancer deaths in Canada, People from New Brunswick
Alexandra Strelchenko	1937 births, 2019 deaths, Russian singers
Miklós Ambrus	1933 births, 2019 deaths, Hungarian water polo players, Olympic gold medalists
Jean-Claude Bouttier	1944 births, 2019 deaths, French movie actors, French sportspeople, Boxers
Cliff Branch	1948 births, 2019 deaths, Oakland Raiders players, Sportspeople from Houston, Texas
Brian Lochore	1940 births, 2019 deaths, Deaths from stomach cancer, New Zealand rugby union players
President of Palau	Presidents of Palau
Thomas Remengesau Jr.	1956 births, Living people, Presidents of Palau
Kuniwo Nakamura	1943 births, 2020 deaths, Presidents of Palau
John Philip Saklil	1960 births, 2019 deaths, Indonesian people, Roman Catholics
Mike Troy	1940 births, 2019 deaths, American swimmers, American Olympic gold medalists, Sportspeople from Indianapolis, Indiana
Ernie Bowman	1935 births, 2019 deaths, American baseball players, San Francisco Giants players, Sportspeople from Tennessee
Prime Minister of Cambodia	Prime Ministers of Cambodia
André Goosse	1926 births, 2019 deaths, Belgian educators, Belgian writers
Willi Tokarev	1934 births, 2019 deaths, Deaths from cancer, Russian singers, Russian writers, Songwriters
Bob Wilber	1928 births, 2019 deaths, American jazz musicians, American saxophonists, American clarinetists, Musicians from New York City
Josef Kadraba	1933 births, 2019 deaths, Czech footballers
Bjorg Lambrecht	1997 births, 2019 deaths, Deaths in sport, Belgian cyclists
Asif Mohseni	1935 births, 2019 deaths, Afghan politicians, Civil servants
Alejandro Serrano	1933 births, 2019 deaths, Vice Presidents of Ecuador, Sports commentators
Vice President of Ecuador	Vice Presidents of Ecuador
Pedro Pierluisi	1959 births, Living people, American lawyers, Governors of Puerto Rico
Sushma Swaraj	1952 births, 2019 deaths, Deaths from myocardial infarction, Bharatiya Janata Party politicians, Indian politicians
Molar heat capacity	Energy
Spontaneity (chemistry)	Chemical reactions, Physical chemistry
Peep and the Big Wide World	2000s television series, 2010s television series, 2004 American television series debuts, 2011 American television series endings, American animated television series, Animated television series, American television series, Canadian animated television series, Canadian television series, Children's television series
Immobilized enzyme	Cell biology, Enzymes, Microbiology, Stereochemistry
U.S. Route 56	U.S. Highways
U.S. Route 160	U.S. Highways
U.S. Route 166	U.S. Highways
U.S. Route 69	U.S. Highways
U.S. Route 270	U.S. Highways
U.S. Route 73	U.S. Highways
U.S. Route 75	U.S. Highways
Roberto Totaro	Cartoonists, Italian people
U.S. Route 77	U.S. Highways
Sio (cartoonist)	Italian people, 1988 births, Cartoonists, Italian voice actors, Living people
U.S. Route 81	U.S. Highways
U.S. Route 83	U.S. Highways
U.S. Route 400	U.S. Highways
Tyson Foods	Companies listed on the New York Stock Exchange, 20th-century establishments in Arkansas, 1935 establishments in the United States, American food companies, Companies based in Arkansas
National Beef	Companies, Beef
Saline River (Kansas)	Rivers of Kansas
Wilson Lake (Kansas)	Geography of Kansas, Lakes of Kansas
Gerry Fairhead	1923 births, 2019 deaths, Canadian Olympians
Godfried Toussaint	1944 births, 2019 deaths, Canadian scientists, Computer scientists
Zebulon Pike	1813 deaths, 1779 births, American explorers
Miriam Butterworth	1918 births, 2019 deaths, Cardiovascular disease deaths in Connecticut, US Democratic Party politicians, American historians, American educators, American political activists, Politicians from Hartford, Connecticut, Writers from Hartford, Connecticut, People from West Hartford, Connecticut, People from Bloomfield, Connecticut
Toy & Wing	1917 births, 2019 deaths, 1912 births, 1997 deaths, American centenarians, American dancers, Entertainers from California, People from San Francisco
Inger Berggren	1934 births, 2019 deaths, Eurovision Song Contest entrants, Singers from Stockholm
Chaser (dog)	2004 births, 2019 deaths, Individual dogs
Redding Municipal Airport	Airports in California, Shasta County, California
Michael Roth	1936 births, 2019 deaths, German engineers, German computer scientists
Insular area	Geography of the United States
Container garden	Gardening, Flowers
Green roof	Architectural elements, Civil engineering, Ecology, Energy conservation, Gardening, Renewable energy, Sustainability, Sustainable development, Urban planning
Anders P. Ravn	1947 births, 2019 deaths, Danish writers, Computer scientists
David Berman (musician)	1967 births, 2019 deaths, Suicides by hanging in the United States, American poets, American cartoonists, Singers from Virginia, Writers from Virginia, Singer-songwriters from Chicago
Jorma Kinnunen	1941 births, 2019 deaths, Finnish Olympic silver medalists
Gergely Kulcsár	1934 births, 2020 deaths, Hungarian sportspeople, Olympic silver medalists, Olympic bronze medalists
Patton Brothers	1931 births, 1934 births, 2019 deaths, Deaths from cancer, English comedians, Duos, English television personalities, People from Kent
Arnie Brown	1942 births, 2019 deaths, Toronto Maple Leafs players, New York Rangers players, Detroit Red Wings players, New York Islanders players, Atlanta Flames players, Sportspeople from Ontario, American Hockey League players, World Hockey Association players, Memorial Cup winners, Ice hockey defencemen
Jaime Lucas Ortega y Alamino	1936 births, 2019 deaths, Deaths from pancreatic cancer, Cardinals of the Roman Catholic Church, Cuban people
Kevin Roster	1983 births, 2019 deaths, Deaths by euthanasia, People with cancer, American activists, Poker players, People from New York City
Carlos Cruz-Diez	1923 births, 2019 deaths, Artists, Venezuelan educators, People from Caracas
Biljana Plavšić	1930 births, Living people, Presidents of Republika Srpska, Members of the Presidency of Bosnia and Herzegovina
Humphrey Mijnals	1930 births, 2019 deaths, Dutch footballers, Surinamese sportspeople
Mike Roarke	1930 births, 2019 deaths, American military personnel of the Korean War, Detroit Tigers players, St. Louis Cardinals players, San Diego Padres players, Sportspeople from Rhode Island, People from West Warwick, Rhode Island
West Warwick, Rhode Island	Towns in Rhode Island
John Robert Schrieffer	1931 births, 2019 deaths, American physicists, Criminals from Illinois, Scientists from Illinois, People from Oak Park, Illinois
Leon Cooper	1930 births, Living people, American physicists, Scientists from New York City
Eduardo Gómez	1951 births, 2019 deaths, Deaths from laryngeal cancer, Spanish movie actors, Spanish television actors, Comedians, Actors from Madrid
Vladimir Kara-Murza Sr.	1959 births, 2019 deaths, Russian journalists, Television personalities, People from Moscow
Loek van Mil	1984 births, 2019 deaths, Accidental deaths, Baseball players, People from Oss, Sportspeople from North Brabant
Jaipal Reddy	1942 births, 2019 deaths, Deaths from pneumonia, Indian politicians
Ruth de Souza	1921 births, 2019 deaths, Brazilian movie actors, Brazilian television actors, Deaths from pneumonia, People from Rio de Janeiro
Copacabana, Rio de Janeiro	Neighborhoods, Rio de Janeiro
Egil Danielsen	1933 births, 2019 deaths, Norwegian Olympians, Norwegian politicians, Living people, Medalists at the 1956 Summer Olympics
Enrique Lafourcade	1927 births, 2019 deaths, Chilean writers, Critics, Chilean journalists, People from Santiago
Vasil Metodiev	1935 births, 2019 deaths, Bulgarian footballers, Bulgarian football managers
Mona-Liisa Nousiainen	1983 births, 2019 deaths, Deaths from cancer, Finnish Olympians
Tuvya Ruebner	1924 births, 2019 deaths, Czechoslovak people, Israeli academics, Jewish academics, Jewish Israeli writers, Naturalized citizens of Israel, People from Bratislava, Photographers, Poets, Refugees from Nazism, Slovakian Jews, Teachers, Translators
Zdeněk Srstka	1935 births, 2019 deaths, Olympians, Czech movie actors, People from Prague
Marcian Bleahu	1924 births, 2019 deaths, Geologists, European geographers, Romanian writers, Romanian politicians
Nick Buoniconti	1940 births, 2019 deaths, American activists, Miami Dolphins players, Sportspeople from Massachusetts, People from Springfield, Massachusetts
Deep Impact (horse)	2002 births, 2019 deaths, Deaths by euthanasia, Racehorses
W. Roy McCutcheon	1929 births, 2019 deaths, Canadian educators
Werner von Moltke	1936 births, 2019 deaths, German Olympians
Michael Crawford	1942 births, Living people, English movie actors, English television actors, English stage actors, English voice actors, English singers, Actors from Kent
Martín Arzola Ortega	1970s births, 2019 deaths, Murders by firearm, Mexican people, Criminals
María Auxiliadora Delgado	1937 births, 2019 deaths, Deaths from myocardial infarction, First Ladies, Activists, People from Montevideo
Raffaele Pisu	1925 births, 2019 deaths, Italian movie actors, Italian television actors, Comedians, People from Bologna
Jean-Luc Thérier	1945 births, 2019 deaths, French sportspeople, Racecar drivers
Butch Walker	1969 births, Living people
Black mustard	Brassicales
Karl Glusman	1988 births, American Christians, American movie actors, American television actors, American voice actors, Actors from New York City, Actors from Portland, Oregon, Jewish American actors, Living people
Shrek (character)	Shrek characters, Fictional characters introduced in 1990, Fictional characters introduced in 2001, Tony Hawk's (series) guest characters
Donkey (character)	Fictional animals, Fictional characters introduced in 1990, Fictional characters introduced in 2001, Shrek characters
Mariam V. Agababjan	Botanists
Hasmukhbhai Parekh	1911 births, 1994 deaths
Misconception	Words
Pradhan Mantri Awas Yojana	India
Islam in Bulgaria	Religion in Bulgaria, Islam by country
Valle de la Luna (Chile)	Valleys
Fabrizio Saccomanni	1942 births, 2019 deaths, Deaths from myocardial infarction, Italian economists, Politicians from Rome
Maimun Zubair	1928 births, 2019 deaths, Indonesian people, Religious leaders
Fabio Zerpa	1928 births, 2019 deaths, Uruguayan entertainers, Stage actors, Radio personalities, Journalists, Researchers
Jean-Pierre Mocky	1929 births, 2019 deaths, Deaths from renal failure, French movie actors, French movie directors, French movie producers, French screenwriters, People from Nice
Manfred Max-Neef	1932 births, 2019 deaths, Chilean writers, Chilean politicians, Chilean educators, Chilean economists
Stanisław Konturek	1931 births, 2019 deaths, Polish educators, Physiologists, Polish scientists, Polish writers
Dany Carrel	1932 births, Living people, French movie actors, French television actors, French stage actors
Ingeborg Schöner	1935 births, Living people, German movie actors, German television actors, German stage actors
Giuliano Montaldo	1930 births, Living people, Italian movie directors, Italian movie actors, Italian screenwriters, Television directors
Giulio Paradisi	1934 births, Living people, Italian movie directors, Italian screenwriters, Italian movie actors, Writers from Rome, Actors from Rome
Francesco Maselli	1930 births, Living people, Italian screenwriters, Italian movie directors, Italian movie actors, Television directors, Actors from Rome, Writers from Rome
George Gilder	1939 births, Living people, American critics, American political writers, American economists, American conservatives, Writers from New York City
Stu Rosen	1939 births, 2019 deaths, Cancer deaths in California, American television directors, American television actors, American television producers, American voice actors, Puppeteers, American television writers, Writers from Illinois, Writers from California, Actors from Illinois, Actors from California, People from Joliet, Illinois
Sag Harbor, New York	Villages in New York
Prime Minister of Malawi	Heads of government, Lists of prime ministers, Prime Ministers by country, Malawi
Zita of Bourbon-Parma	1892 births, 1989 deaths, Italian Roman Catholics, House of Habsburg-Lorraine, Austrian Roman Catholics, Hungarian Roman Catholics, Servants of God
Leo Ortolani	1967 births, Italian writers, Cartoonists, People from Pisa, Living people
Cathedral Quarter, Belfast	Quarters of Belfast
Johnson County Community College	20th-century establishments in Kansas, 1969 establishments in the United States, Colleges and universities in Kansas, Johnson County, Kansas
De Soto, Kansas	Cities in Johnson County, Kansas, 1857 establishments in Kansas Territory, Cities in Leavenworth County, Kansas
Ottawa University	1860s establishments in Kansas, 1865 establishments in the United States, Colleges and universities in Kansas
Wichita State University	1886 establishments in Kansas, Wichita State University
Washburn University	1860s establishments in Kansas, 1865 establishments in the United States, Colleges and universities in Kansas, Topeka, Kansas
Opportunity zone	Taxation, United States
Fort Hays State University	20th-century establishments in Kansas, 1902 establishments in the United States, Colleges and universities in Kansas
Delaware River (Kansas)	Rivers of Kansas
Tornado outbreak sequence of June 1966	Topeka, Kansas, 1966 in the United States, Tornadoes in the United States, Tornado outbreaks, 20th century in Kansas
Small Talk (song)	2019 songs, Katy Perry songs, Pop songs
Bandhan Bank	2015 establishments in India, Companies of India, Banks, Kolkata
Brian Kobilka	1955 births, Living people, Physiologists, Scientists from Minnesota, Stanford University faculty
Serranilla Bank	Atolls, Caribbean islands, Colombia, Territorial disputes, Geography of Colombia, Geography of the Caribbean, Island insular areas of the United States, Islands of the United States, United States Minor Outlying Islands
Daymark	Navigation
Charles Oser	1902 births, 1994 deaths, Federal Chancellors of Switzerland
Oskar Leimgruber	1886 births, 1976 deaths, Federal Chancellors of Switzerland
University of Fribourg	Colleges and universities in Switzerland
University of Neuchâtel	19th century establishments in Switzerland, 1838 establishments in Europe, Colleges and universities in Switzerland
University of Zurich	19th century establishments in Switzerland, 1833 establishments, Colleges and universities in Switzerland, Zürich
Ernie Colón	1931 births, 2019 deaths, Deaths from colorectal cancer, Cancer deaths in New York, American comics artists, People from San Juan, Puerto Rico
Huntington, New York	Towns in New York
Dave Parks	1941 births, 2019 deaths, American football wide receivers, American inventors, San Francisco 49ers players, New Orleans Saints players, Tennessee Titans players, Businesspeople from Texas
Fahrudin Jusufi	1939 births, 2019 deaths, Serbian footballers
Spitsbergen	Islands of Norway, Arctic islands
Liu Yifei	1987 births, Chinese movie actors, Living people, Actors from New York City, American pop singers, American movie actors, American television actors, Chinese singers, Chinese television actors, Singers from New York City, People who lost Chinese citizenship
Islip, New York	Towns in New York
Holtsville, New York	Hamlets in New York, Census-designated places in New York (state)
Davidson, Oklahoma	Towns in Oklahoma
Babylon (village), New York	Villages in New York
Deer Creek, Oklahoma	Towns in Oklahoma
Jefferson, Oklahoma	Towns in Oklahoma
Lamont, Oklahoma	Towns in Oklahoma
Manchester, Oklahoma	Towns in Oklahoma
Nash, Oklahoma	Towns in Oklahoma
Centerville, New York	Towns in New York
Alfred (town), New York	Towns in New York
Alfred (village), New York	Villages in New York
Delaware, Oklahoma	Towns in Oklahoma
Devol, Oklahoma	Towns in Oklahoma
Randlett, Oklahoma	Towns in Oklahoma
Temple, Oklahoma	Towns in Oklahoma
Dewar, Oklahoma	Towns in Oklahoma
Winchester, Oklahoma	Towns in Oklahoma
New Lebanon, New York	Towns in New York
Lorenz Park, New York	Census-designated places in New York (state)
Wyandotte, Oklahoma	Towns in Oklahoma
North Miami, Oklahoma	Towns in Oklahoma
North Enid, Oklahoma	Towns in Oklahoma
Dibble, Oklahoma	Towns in Oklahoma
Dover, Oklahoma	Towns in Oklahoma
Smith Village, Oklahoma	Towns in Oklahoma
Dickson, Oklahoma	Towns in Oklahoma
Dill City, Oklahoma	Cities in Oklahoma
Foss, Oklahoma	Towns in Oklahoma
Drummond, Oklahoma	Towns in Oklahoma
Émile Guillemin	1841 births, 1907 deaths, Artists from Paris, French sculptors, French painters
Nordaustlandet	Islands of Norway, Uninhabited islands
Edgeøya	Islands of Norway, Uninhabited islands
John Margetson	1927 births, 2020 deaths, British politicians, Knights Commander of the Order of St Michael and St George, Ambassadors to the United Nations
Jessie Reyez	1991 births, Living people, Canadian singer-songwriters, Canadian pop singers, Musicians from Toronto
Capita	1984 establishments in the United Kingdom, Companies of the United Kingdom, Companies listed on the London Stock Exchange, City of Westminster
CVC Capital Partners	1981 establishments in the United Kingdom, Companies of the United Kingdom, Finance, London, Luxembourg City
Dougherty, Oklahoma	Towns in Oklahoma
Dustin, Oklahoma	Towns in Oklahoma
Lamar, Oklahoma	Towns in Oklahoma
Spaulding, Oklahoma	Towns in Oklahoma
Solar Higri Calendar	Calendars, Iranian culture, Afghan society and culture
K. T. Shah	Alumni of the London School of Economics, Indian politicians
Noxubee County, Mississippi	1833 establishments in Mississippi, Mississippi counties
Francis Fonseca	1967 births, Living people, Belizean politicians
Mostar	Cities in Bosnia and Herzegovina
Board of Control for Cricket in India	Cricket in India
East Duke, Oklahoma	Towns in Oklahoma
Constantia (town), New York	Towns in New York
Mexico (village), New York	Villages in New York
Becca's Bunch	Children's television series
List of Becca's Bunch characters	Lists of fictional characters
Harmon Northrop Morse	1848 births, 1920 deaths, American chemists, Scientists from Vermont
Open Publication License	Free content licenses, Open content
ISO image	Computer file formats
Herut	Former political parties in Israel, Zionist parties
2008 People’s United Party (Belize) leadership election and convention	Politics of Belize, 2008 elections
Barraba, New South Wales	Towns in New South Wales
Ben Wallace (politician)	1970 births, Living people, British Army officers, Conservative MPs (UK), Members of the British House of Commons for English constituencies, Politicians from Kent, Privy Councillors (UK), Scottish Parliament Members, Secretaries of State of the United Kingdom, UK MPs 2005–2010, UK MPs 2010–2015, UK MPs 2015–2017, UK MPs 2017–2019, UK MPs 2019–
Mark Carney	1965 births, Living people, Canadian writers, Irish writers, British economists
Robert Buckland	1968 births, Living people, Conservative MPs (UK), Lord Chancellors, Members of the British House of Commons for English constituencies, Privy Councillors (UK), Secretaries of State of the United Kingdom, UK MPs 2010–2015, UK MPs 2015–2017, UK MPs 2017–2019, UK MPs 2019–
Najm ad-Din Ayyub	1173 deaths, Ayyubid dynasty
Ægypt	1980s books, 1990s books, 2000s books
Devil May Cry	Devil May Cry, Video game series
Gahal	Former political parties in Israel, Zionist parties, Liberal parties
Philip May	1957 births, Living people, People from Norfolk, Spouses of Prime Ministers of the United Kingdom
Rostislav Rybakov	1938 births, 2019 deaths, Russian educators, Writers from Moscow
Oscar Malbernat	1944 births, 2019 deaths, Deaths from renal failure, Argentine footballers, Argentine football managers
Cándido Sibilio	1958 births, 2019 deaths, Deaths from diabetes, Dominican Republic sportspeople, Spanish basketball players, Spanish Olympians
Rocket launcher	Ballistics
Bluey Adams	1935 births, 2019 deaths, Australian rules footballers, Sportspeople from Victoria (Australia), Cancer deaths in Australia
Recoilless rifle	Artillery, Rifles
Darryl Drake	1956 births, 2019 deaths, Washington Redskins players, Cincinnati Bengals players, American football wide receivers, American football coaches, Sportspeople from Louisville, Kentucky
Walter Martínez (footballer)	1982 births, 2019 deaths, Deaths from myocardial infarction, Honduran footballers

