Didier Demazière	Year of birth unknown, French sociologists, Living people
Legal clinic	Law
A.R. Chughtai	1897 births, 1975 deaths, Pakistani people
Ustad Allah Bux	1895 births, 1978 deaths, Pakistani people, Punjabi people
Henna	Flowering plants, Middle East, Indian culture, Pakistani culture
List of New England Patriots players	New England Patriots players, Lists of sportspeople
Dominican people (Dominican Republic)	Dominican Republic people
Bodo nationalism	Assam, Separatist movements of India, Nationalism
Somme River	Rivers of France, Hauts-de-France
United National Liberation Front	Separatist movements of India, Manipur, Rebel militia groups in Asia, Nationalist organizations in India
Ghost Dance	New religious movements, Native American
Suiko period	Japanese eras
Ballast tamper	Trains
WFMU	Jersey City, New Jersey, Radio stations in the United States, 1958 establishments in the United States, 20th-century establishments in New Jersey
Christiana Guinle	Brazilian stage actors, Brazilian television actors, Year of birth missing (living people), Living people
Jackie Earle Haley	1961 births, Living people, A Nightmare on Elm Street, American movie actors, American television actors, American stage actors, American voice actors, Actors from Los Angeles, California
River Phoenix	1970 births, 1993 deaths, Actors from Oregon, American activists, American child actors, American movie actors, American musicians, American stage actors, American television actors, American voice actors, Deaths from heart failure, Drug-related accidental deaths in the United States, Jewish American actors
Alan Cumming	1965 births, Living people, Actors who played Bond villains, Bisexual people, Drama Desk Award winners, Gay men, LGBT actors, Naturalized citizens of the United States, Officers of the Order of the British Empire, Scottish LGBT people, Scottish movie actors, Scottish stage actors, Scottish television actors, Scottish voice actors, Tony Award winning actors
Tent pegging	Equestrian sports, Middle East, Sport in India, Pakistani culture
Sadequain	1930 births, 1987 deaths, Pakistani people
Leavenworth, Kansas	County seats in Kansas, Cities in Leavenworth County, Kansas, History of Kansas, Bleeding Kansas, 1854 establishments in Kansas Territory
Arkalochori Axe	Minoan culture, Blades
National College of Arts	Colleges and universities in Pakistan, Lahore
John Lockwood Kipling	1837 births, 1911 deaths, People of British India, British illustrators
Prince Chichibu	1902 births, 1953 deaths, People from Tokyo, Princes and princesses, Japanese imperial family
Princess Chichibu	1909 births, 1995 deaths
Guelma	Cities in Algeria
Josef Fritzl	1935 births, Living people, Austrian people, Incest, Kidnappers, People with personality disorders, Prisoners, Rapists
Superiority bias	Psychology, Everyday life
OpenSolaris	Operating systems, Unix, Sun Microsystems, Oracle Corporation
Tyne Daly	1946 births, Living people, Actors from Wisconsin, American movie actors, American stage actors, American television actors, American voice actors, Drama Desk Award winners, Emmy Award winning actors, People from Madison, Wisconsin, Tony Award winning actors
Azerbaijan State Academic Opera and Ballet Theatre	Opera houses, Theatres in Baku, Buildings and structures in Baku, 1911 establishments, 1910s establishments in Azerbaijan
Liz Smith (journalist)	1923 births, 2017 deaths, American columnists, Bisexual people, Deaths from natural causes in the United States, Journalists from New York City, Journalists from Texas, LGBT journalists, LGBT people from New York City, LGBT people from Texas, Writers from Fort Worth, Texas
Ann Richards	1933 births, 2006 deaths, American feminists, American teachers, Cancer deaths in Texas, Deaths from esophageal cancer, Governors of Texas, Politicians from Austin, Texas, US Democratic Party politicians
Susannah York	1939 births, 2011 deaths, Actors from London, BAFTA Award winning actors, Cancer deaths in England, Deaths from multiple myeloma, English movie actors, English radio actors, English stage actors, English television actors, English voice actors
Robert Goulet	1933 births, 2007 deaths, Deaths from respiratory failure, Deaths from pulmonary fibrosis, American movie actors, American television actors, American stage actors, American voice actors, American radio actors, Actors from Massachusetts, Singers from Massachusetts, People from Lawrence, Massachusetts, Tony Award winning actors, Grammy Award winners
Lucille Bliss	1916 births, 2012 deaths, American movie actors, American television actors, American stage actors, American voice actors, American radio actors, American television personalities, American radio personalities, Actors from New York City
Daws Butler	1916 births, 1988 deaths, Deaths from myocardial infarction, American movie actors, American television actors, American stage actors, American voice actors, American radio actors, Comedians from Chicago, Actors from Ohio, Actors from Chicago, Television personalities from Chicago
Jimmy Donegan	1940 births, Living people, Australian painters, Indigenous Australian artists, Pitjantjatjara, Artists from South Australia, Artists from Western Australia
Lady Garden Park	Abbottabad, Parks in Pakistan
Commemorative plaque	Awards
Valonia ventricosa	Algae
Gulab Singh	1792 births, 1857 deaths, People of British India, Indian monarchs
Ranjit Singh	1780 births, 1839 deaths, Indian monarchs, 19th century in India, Punjabi people
Dogra	Ethnic groups in India
Tiwana	Ethnic groups in India, Ethnic groups in Pakistan, Punjabi people
America's Next Top Model, Cycle 15	America's Next Top Model
Khizar Hayat Tiwana	1900 births, 1975 deaths, People of British India, Punjabi people
Tarar	Ethnic groups in India, Ethnic groups in Pakistan, Punjabi people
Pahalgam	Tehsils of Jammu and Kashmir
Common ivy	Vines
Macaronesia	Islands of Macaronesia, Islands of Africa, Islands of Europe
Dhamrai Jagannath Roth	Hindu temples in Bangladesh
Killer Instinct	1994 video games
Doc Severinsen	1927 births, Living people, American jazz musicians, American pop musicians, Trumpeters, American television actors, Actors from Oregon, Grammy Award winners
Warraich	Punjabi people, Ethnic groups in Pakistan
Lena Horne	1917 births, 2010 deaths, Actors from New York City, Actors from Pittsburgh, Pennsylvania, African American actors, African American musicians, American civil rights activists, American dancers, American movie actors, American radio actors, American stage actors, American television actors, American voice actors, Cardiovascular disease deaths in the United States, Deaths from heart failure, Drama Desk Award winners, Singers from New York City, Singers from Pennsylvania, Tony Award winning actors, Warner Bros. Records artists
Francis Preston Blair	1791 births, 1876 deaths, Deaths from natural causes, American journalists, American abolitionists, Democratic Republican party (US) politicians, Politicians from Virginia, Politicians from Kentucky, Politicians from Washington, D.C., Spies, People from Silver Spring, Maryland
Araliaceae	Asterids
Hindkowan	Ethnic groups in Pakistan, Pakistani people
Patricia Neal	1926 births, 2010 deaths, Academy Award winning actors, Actors from Kentucky, American movie actors, American radio actors, American stage actors, American television actors, American voice actors, BAFTA Award winning actors, Cancer deaths in the United States, Deaths from lung cancer, Golden Globe Award winning actors, People from Knoxville, Tennessee, Tony Award winning actors
Thaddeus Stevens	1792 births, 1868 deaths, Deaths from natural causes, American lawyers, American abolitionists, US Republican Party politicians, United States representatives from Pennsylvania, Politicians from Vermont
Lincoln (movie)	2012 drama movies, 2010s biographical movies, 2010s war movies, American biographical movies, American drama movies, American war movies, English-language movies, Movies composed by John Williams, Movies directed by Steven Spielberg, Movies featuring a Best Actor Academy Award-winning performance
Benjamin Wade	1800 births, 1878 deaths, Deaths from natural causes, American lawyers, Presidents pro tempore of the United States Senate, Deans of the United States Senate, Politicians from Massachusetts, United States senators from Ohio, US Republican Party politicians, American abolitionists, American judges, Whig party (US) politicians
Japanese New Year	Japanese culture
Yoshirō Mori	Prime Ministers of Japan, 1937 births, Living people, People from Ishikawa Prefecture
Harry Tjutjuna	1930 births, Living people, Australian painters, Indigenous Australian artists, Pitjantjatjara, Artists from South Australia
2012 Asia Cup	2012 in Asia, 2012 in sports, Cricket, 2010s in Bangladesh
America's Next Top Model, Cycle 16	America's Next Top Model
Kingdom of God	Theology
Adinath Temple, Maheshkhali	Hindu temples in Bangladesh
Chandranath Temple	Hindu temples in Bangladesh
Alec McCowen	1925 births, 2017 deaths, Actors from Kent, Actors who played Q, English LGBT people, English movie actors, English radio actors, English stage actors, English television actors, English voice actors, Gay men, LGBT actors
Bill Tarmey	1941 births, 2012 deaths, Deaths from myocardial infarction, English television actors, English movie actors, English singers, English stage actors, English voice actors, English writers, Actors from Manchester, Musicians from Manchester, People from Lancashire
Stanley Tucci	1960 births, Living people, American movie actors, American television actors, American stage actors, American voice actors, Actors from New York, Golden Globe Award winning actors, Emmy Award winning actors, People from Peekskill, New York
Mia Wasikowska	1989 births, Living people, Australian movie actors, Australian television actors, Australian voice actors, People from Canberra
Alfred Hermann Fried	1864 births, 1921 deaths, Austrian Jews, Austrian journalists, Esperantists, Jewish activists, Jewish Nobel Prize winners, Jewish writers, Writers from Vienna, Austrian Nobel Prize winners
Christian Lous Lange	1869 births, 1938 deaths, Activists, Norwegian historians, Nobel Peace Prize winners, People from Stavanger, Norwegian political scientists, Teachers, University of Oslo alumni, Norwegian Nobel Committee, Norwegian Nobel Prize winners
Tobias Asser	1838 births, 1913 deaths, Dutch academics, Dutch Jews, Dutch jurists, Dutch lawyers, Dutch Nobel Prize winners, Jewish academics, Jewish lawyers, Jewish Nobel Prize winners, Nobel Peace Prize winners, People from Amsterdam
Hjalmar Branting	1860 births, 1925 deaths, Activists, Government ministers of Sweden, Nobel Peace Prize winners, Prime Ministers of Sweden
Binocular vision	Vision, Physiology
Fredrik Bajer	1837 births, 1922 deaths, Danish writers, Danish politicians, Danish educators, Teachers, Activists, Nobel Peace Prize winners, Danish Nobel Prize winners
Charles Albert Gobat	1843 births, 1914 deaths, Swiss lawyers, Swiss politicians, Swiss teachers, Swiss activists, Nobel Peace Prize winners
Herzl Museum	Mount Herzl, Museums in Jerusalem
Élie Ducommun	1833 births, 1906 deaths, Swiss activists, Swiss teachers, Nobel Peace Prize winners, People from Geneva
Garden of the Missing in Action	Missing in action, Monuments and memorials in Mount Herzl, Military monuments and memorials in Israel
Leif Garrett	1961 births, Living people, American movie actors, American television actors, American voice actors, American child actors, American television personalities, Actors from Hollywood, Singers from Los Angeles, California, Musicians from Los Angeles, California
Victims of Acts of Terror Memorial in Israel	Terrorism, Monuments and memorials in Mount Herzl, Monuments and memorials in Israel
Dalton's law	Laws of physics, Physical chemistry
Eretz Israel Museum	Museums in Tel Aviv
Marina and the Diamonds	British pianists, Welsh pop musicians, Welsh singers, 1985 births, Living people, Atlantic Records artists
Roy E. Disney	1930 births, 2009 deaths, Deaths from stomach cancer, Disney people, Chief executives, Disney animators, American animators, Artists from Chicago, Businesspeople from Los Angeles, California, Businesspeople from Chicago
Volcani Institute of Agricultural Research	Scientific organizations
Academy of the Hebrew Language	Language regulators, Hebrew language, Buildings and structures in Jerusalem, 1890 establishments, Educational organizations
The Family Jewels (album)	2010 albums
Israel Academy of Sciences and Humanities	Buildings and structures in Jerusalem, National academies of sciences, 1961 establishments in Asia, Education in Israel, 1960s establishments in Israel
Electra Heart (album)	2012 albums
Total Drama	Total Drama, English-language television programs, 2008 television series debuts, 2015 television series endings
List of Total Drama episodes	Lists of animated television series episodes, Total Drama
Gatka	Martial arts, Sport in India, Pakistani culture
Maliar	Ethnic groups in Pakistan
Michael Eisner	1942 births, Living people, American billionaires, American chief executives, American Jews, Businesspeople from Los Angeles, California, Businesspeople from New York, Jewish billionaires, Jewish businesspeople, Disney people, People from Mount Kisco, New York
Rita Ora	1990 births, Living people, English singer-songwriters, Rita Ora, Singers from London, Yugoslavian people, English R&B singers, English pop singers, English dance musicians, Atlantic Records artists
Comilla Jagannath Temple	Hindu temples in Bangladesh, 16th century establishments in Asia, Establishments in Bangladesh
Wingu Tingima	1920 births, 2010 deaths, Australian painters, Indigenous Australian artists, Pitjantjatjara, Artists from South Australia, Artists from Western Australia
Andrew Ebbett	1983 births, Anaheim Ducks players, Canadian ice hockey left wingers, Chicago Blackhawks players, Ice hockey people from British Columbia, Living people, Minnesota Wild players, Phoenix Coyotes players, Pittsburgh Penguins players, Vancouver Canucks players, American Hockey League players
Diane Downs	1955 births, Living people, American people convicted of assault, American people convicted of attempted murder, American people convicted of murder, American prisoners sentenced to life imprisonment, People from Phoenix, Arizona, People with antisocial personality disorder, People with histrionic personality disorder, People with narcissistic personality disorder
ICloud	Storage devices, Computer memory, Apple software
Hebrew University of Jerusalem	Buildings and structures in Jerusalem, Hebrew University of Jerusalem, Mount Scopus, 1918 establishments, 1910s establishments in Israel, Colleges and universities in Israel
Greg Jennings	Green Bay Packers players, 1983 births, Living people, Sportspeople from Michigan, People from Kalamazoo, Michigan
Don Messick	1926 births, 1997 deaths, Deaths from stroke, American movie actors, American television actors, American voice actors, American radio actors, American television personalities, Actors from Buffalo, New York
Don Hewitt	1922 births, 2009 deaths, Deaths from pancreatic cancer, American television producers, People from New York City, Emmy Award winners
Robert Wuhl	1951 births, Living people, American movie actors, American television actors, American stage actors, American voice actors, Comedians from New Jersey, Actors from New Jersey, Writers from New Jersey, Emmy Award winning actors
Ross Perot	1930 births, 2019 deaths, Deaths from leukemia, American billionaires, Chief executives, 1992 United States presidential candidates, 1996 United States presidential candidates, Businesspeople from Texas, Politicians from Texas, Independent politicians in the United States
Cover Drive	Barbadian people, Pop music groups
2004 NFL Draft	National Football League, 2004 in sports, 21st century in Manhattan, 2004 in New York (state), 2000s in New York City
Qazigund	Tehsils of Jammu and Kashmir
Abbaspur	Tehsils of Azad Kashmir
King Peak	Mountains of Canada, Yukon
Lovebird	True parrots
Patrick Leahy	1940 births, Living people, United States senators from Vermont, American movie actors, American voice actors, American writers, Deans of the United States Senate, Presidents pro tempore of the United States Senate, Actors from Vermont, US Democratic Party politicians, People from Montpelier, Vermont
Michael Bay	1965 births, Living people, American movie actors, Movie directors from California, Movie producers from California, Actors from Los Angeles, California, Saturn Award winners, Clio Award winners
Persimmon	Fruits, Ebenaceae
Shimla Hill	Abbottabad District, Mountain ranges of Pakistan
Shimla	Capital cities in India, Himachal Pradesh
Pakistan Military Academy	Buildings and structures in Abbottabad, Military of Pakistan, 1948 establishments in Asia, 20th century establishments in Pakistan
Brush-tailed rock-wallaby	Macropods, Marsupials of Australia
Courtship in animals	Zoology, Ethology
Roanoke Colony	Missing people, History of North Carolina, History of the United States, British Empire, 1585 establishments, Unknown disestablishments
Provisional government	Forms of government
Battle of Little Round Top	American Civil War battles, 1863 in Pennsylvania, July 1863 events
Jean-Charles Darmon	1961 births, Versailles Saint-Quentin-en-Yvelines University faculty, French literary critics, Living people
Azerbaijan State Philharmonic Hall	Concert halls, Buildings and structures in Baku, 1912 establishments, 1910s establishments in Azerbaijan
Alexander Parkes	1813 births, 1890 deaths, British inventors
Barnston	Uttlesford, Villages in Essex, Civil parishes in Essex
Berden	Uttlesford, Villages in Essex, Civil parishes in Essex
Birchanger	Uttlesford, Villages in Essex, Civil parishes in Essex
Great Canfield	Uttlesford, Villages in Essex, Civil parishes in Essex
Accipitridae	Accipitriformes
Import	Economics
Semites	Semitic peoples
Fazlur Khan	1929 births, 2013 deaths, Deaths from myocardial infarction, Burials at Graceland Cemetery, Naturalized citizens of the United States, People from Kolkata, Engineers, Architects from Chicago
Bruce Graham	1925 births, 2010 deaths, Deaths from emphysema, Cancer deaths in Florida, Naturalized citizens of the United States, Burials at Graceland Cemetery, Colombian people, Canadian people, Peruvian people, Architects from Chicago
Oghi Tehsil	Tehsils of Khyber Pakhtunkhwa
Oghi	Cities in Pakistan
Hubble Extreme Deep Field	Astronomy
Hypnotic	Drugs
Anxiolytic	Drugs used in psychiatry
Eileen Yaritja Stevens	1910s births, 2008 deaths, Australian painters, Indigenous Australian artists, Pitjantjatjara, Artists from South Australia
Fen	Wetlands
Armin van Buuren	1976 births, Living people, DJs, Dutch musicians, People from Leiden
The Mindy Project	2012 American television series debuts, 2010s American comedy television series, 2010s medical television series, American medical television series, Fox television series, Television series set in New York City, English-language television programs
Wishbone	American children's television series, PBS Kids shows, English-language television programs, 1995 television series debuts, 1997 television series endings
Bog	Wetlands
Reflexive relation	Mathematics
List of Wikipedias	Wikipedias
Jagannath Temple, Pabna	Hindu temples in Bangladesh, 14th century establishments in Asia, Establishments in Bangladesh
Kal Bhairab Temple, Brahmanbaria	Hindu temples in Bangladesh
Androgen	Male reproductive system, Hormones
BeOS	Operating systems
Coccus	Bacteria
Spirillum	Bacteria
Great Chicago Fire	1871 in the United States, 19th century in Chicago, Fires in the United States, October events
Chicago Loop	Community areas of Chicago
Vermin Supreme	1961 births, Living people, American artists, American anarchists, Politicians from Boston, Massachusetts, Politicians from Baltimore, Maryland, 2008 United States presidential candidates, 2012 United States presidential candidates, 2016 United States presidential candidates, 2020 United States presidential candidates, US Libertarian Party politicians
Ngupulya Pumani	1948 births, Living people, Australian painters, Indigenous Australian artists, Pitjantjatjara, Artists from South Australia
Meat ant	Ants
Smoked fish	Seafood
Thandiani	Hill Stations in Pakistan
Abdul Qayyum Khan	1863 births, 1937 deaths, People of British India
Marbled polecat	Mustelids
Hasan Abdal	Cities in Pakistan
Infrared spectroscopy	Analytical chemistry, Physical chemistry
Iwa jinja	Shinto shrines, Buildings and structures in Japan
Judah Maccabee	Ancient Israeli people, History of Hanukkah, Jewish military people
Milatjari Pumani	1928 births, Living people, Australian painters, Indigenous Australian artists, Pitjantjatjara, Artists from South Australia
Gulgee	Pakistani people, 1926 births, 2007 deaths, Deaths from asphyxiation, People from Peshawar, Painters
Jahangir	Indian people, Mughal emperors, Mughal Empire, 1569   births, 1627 deaths
Shah Jahan	1592 births, 1666 deaths, Mughal emperors
Shah Dara	Settlements in Pakistan
Shakir Ali	1914 births, 1975 deaths, Pakistani educators, Pakistani painters, People from Lahore
Sher Shah Suri	1486 births, 1545 deaths, Indian leaders
Khattak	Ethnic groups in Pakistan, Ethnic groups in Khyber Pakhtunkhwa
Khushal Khan Khattak	History of India, 1613 births, 1689 deaths
Kulgam	Tehsils of Jammu and Kashmir
Bethesda Softworks	1986 establishments in the United States, Video game companies, Bethesda, Maryland, 20th-century establishments in Maryland
2012 NATO Summit in Chicago	2012 in the United States, Diplomatic conferences, 2010s in Chicago
1968 Democratic National Convention	1968 in the United States, 1960s in Chicago, United States presidential nominating conventions, United States Democratic Party, August events
Sereno Peck Fenn	1844 births, 1927 deaths, Businesspeople from Cleveland, Ohio
John Andrews	United States Navy Medal of Honor recipients, 1821 births, Year of death unknown
Government College University	Education in Pakistan, Colleges and universities in Pakistan, Lahore
Kinnaird College for Women	Education in Pakistan, Colleges and universities in Pakistan, Lahore
Gawalmandi Food Street	Buildings and structures in Lahore
Fakir Khana	Lahore, Museums in Pakistan
Nur Jahan	1577 births, 1645 deaths, Indian people, Emperors and empresses, Mughal Empire
Gottlieb Wilhelm Leitner	1840 births, 1899 deaths, Hungarian Jews, Jewish British academics, Linguists, Naturalised citizens of the United Kingdom, People from Budapest, People of British India
List of civil parishes in Essex	Civil parishes in Essex, Lists of civil parishes in England
Stansted Mountfitchet	Uttlesford, Villages in Essex, Civil parishes in Essex
Chrishall	Uttlesford, Villages in Essex, Civil parishes in Essex
Little Bardfield	Uttlesford, Villages in Essex, Civil parishes in Essex
Great Hallingbury	Uttlesford, Villages in Essex, Civil parishes in Essex
Stebbing	Uttlesford, Villages in Essex, Civil parishes in Essex
Tilty	Uttlesford, Villages in Essex, Civil parishes in Essex
Lindsell	Uttlesford, Villages in Essex, Civil parishes in Essex
Nemmersdorf massacre	1944 in Europe, 1940s in Germany, Massacres in Europe, Massacres during Word War II, October 1944 events
Alaska Peninsula	Geography of Alaska, Peninsulas
King Island, Alaska	Pacific islands, Islands of Alaska
National Institutions House	Buildings and structures in Jerusalem, 1930 establishments
Bible Lands Museum	Ancient Israel and Judah, Museums in Jerusalem
Jack Williams	1924 births, 1945 deaths, United States Navy Medal of Honor recipients, American people of World War II, Pharmacists
John Willis	1921 births, 1945 deaths, United States Navy Medal of Honor recipients, American people of World War II, Pharmacists
Prophylaxis (chess)	Chess
Atlantic mackerel	Perciformes, Edible fish
Lester Archer	1838 births, 1864 deaths, People from New York, United States Army Medal of Honor recipients
George L. Banks	1839 births, 1924 deaths, United States Army Medal of Honor recipients, People from Ohio
Bullet (typography)	Punctuation, Typography
Richard Dennis	1826 births, Year of death unknown, People from Massachusetts, United States Navy Medal of Honor recipients
Keigo Higashino	1958 births, Living people, Japanese writers, People from Osaka
Takahiko Kozuka	1989 births, Living people, Japanese figure skaters, People from Aichi Prefecture
Thomas Ryan	1901 births, 1970 deaths, People from New Orleans, Louisiana, United States Navy Medal of Honor recipients
Abraham Cohn	1832 births, 1897 deaths, American Jews, German Jews, Jewish military people, Military personnel of the American Civil War, Naturalized citizens of the United States, People from Prussia, United States Army Medal of Honor recipients
1100 New York Avenue	Buildings and structures in Washington, D.C.
Dick Adkins	1920 births, 1955 deaths, Sportspeople from Texas, American baseball players
Richard Barrett	1838 births, 1898 deaths, United States Army Medal of Honor recipients, People from New York
Alkali Ridge	Utah, National Historic Landmarks of the United States, Archaeological sites in the United States
Ren Höek	Fictional dogs, Fictional characters introduced in 1991, The Ren & Stimpy Show characters
Angelica Pickles	Television characters, Movie characters, Animated characters
Lav	Hindu mythology
List of notable Lahoris	People from Lahore, Pakistan-related lists, Lists of Indian people
John J. Clausey	1875 births, 1951 deaths, United States Navy Medal of Honor recipients, People from San Francisco
Larry Hagman	1931 births, 2012 deaths, Actors from Dallas, Texas, Actors from Fort Worth, Texas, American movie actors, American movie directors, American movie producers, American radio actors, American stage actors, American television actors, American television directors, American television producers, American voice actors, Cancer deaths in the United States, Deaths from acute myeloid leukemia, Organ transplant recipients
J. K. Simmons	Academy Award winning actors, Golden Globe Award winning actors, BAFTA Award winning actors, Screen Actors Guild Award winners, Satellite Award winners, 1955 births, Living people, American movie actors, American television actors, American stage actors, American voice actors, American musical theatre actors, Actors from Detroit, Michigan, Actors from Columbus, Ohio, Actors from Montana, People from Missoula, Montana
Ganga Ram	1851 births, 1927 deaths, People of British India
Kim Il-yeop	1896 births, 1971 deaths, Feminists, Korean educators, South Korean politicians, South Korean journalists, Autobiographers
Amrita Sher-Gil	1913 births, 1941 deaths, Indian artists, Punjabi people
Alhamra Arts Council	Buildings and structures in Lahore, 1992 establishments in Asia, 20th century establishments in Pakistan
Bryce Courtenay	1933 births, 2012 deaths, Australian novelists, Writers from Sydney, South African people, Deaths from stomach cancer
The Power of One	1989 books
Frankie Yankovic	1915 births, 1998 deaths, Accordionists, American musicians, Purple Heart recipients
CatDog	Children's television series, Animated television series, English-language television programs, 1998 television series debuts, 2005 television series endings
Bowerbird	Passeri, Birds of Australia, Birds of Oceania
Muggsy Bogues	African-American basketball players, Sportspeople from Baltimore, Maryland, New Orleans Hornets players, Washington Wizards players, Golden State Warriors players, Toronto Raptors players, Living people, 1965 births, American basketball players
One-time pad	Cryptography
Danny Ferry	Living people, 1966 births, American basketball players, San Antonio Spurs players, Cleveland Cavaliers players, Sportspeople from Maryland
Shawn Kemp	1969 births, African-American basketball players, Cleveland Cavaliers players, Living people, Orlando Magic players, Portland Trail Blazers players, Seattle SuperSonics players, Sportspeople from Indiana, People from Elkhart, Indiana, American basketball players
Sayyid	Middle East, Asia
Ashiq Mohamed Warsi	1940 deaths, Pakistan Movement, Leaders of All India Muslim League, Year of birth missing (living people)
S.M. Sharif	Pakistan Movement, Leaders of All India Muslim League, Year of birth missing, Year of death missing
Charles Umpherston Aitchison	1832 births, 1896 deaths, People of British India
Akali Dal	Political parties in India
Edgar Rice Burroughs	1875 births, 1950 deaths, Deaths from myocardial infarction, American novelists, Tarzan, Writers from Chicago
Planetarium	Buildings and structures, Astronomy
Highways in Greece	Roads, Greece
El Dorado, Houston	Houston, Texas
Abilene Eagles	Baseball teams, Sports in Texas, Abilene, Texas, 1920 establishments in the United States, 1920s establishments in Texas, 1922 disestablishments, 1920s disestablishments in the United States, Disestablishments in Texas
Jairus C. Fairchild	Businesspeople from New York, Businesspeople from Cleveland, Ohio, Politicians from Cleveland, Ohio, Politicians from New York, 1801 births, 1862 deaths
Irène Joliot-Curie	French physicists, Female scientists, 1897 births, 1956 deaths, Scientists from Paris, French Nobel Prize winners
Lucius Fox	Batman characters, DC Comics characters
James Gordon (comics)	Batman characters, DC Comics characters
Alfred Pennyworth	Batman characters, Fictional characters introduced in the 1940s, Fictional British people, DC Comics characters
Bane (comics)	Batman characters, DC Comics supervillains, Fictional characters introduced in 1993, Fictional mass murderers
Catwoman	Batman characters, DC Comics adapted into movies, DC Comics supervillains, Fictional characters introduced in 1940
Ra's al Ghul	Batman characters, DC Comics characters, Fictional characters introduced in 1971
Yawar Hayat Khan	1943 births, 2016 deaths, Pakistani people, Punjabi people, Pakistani entertainers
Grant Park	History of Chicago, Parks in Chicago, 1901 establishments in the United States, 1900s establishments in Illinois
Buckingham Fountain	1927 establishments in Illinois, Buildings and structures completed in the 20th century, Buildings and structures in Chicago, Illinois, Landmarks in Chicago
10239 Hermann	Asteroids
Biblical inerrancy	Christian theology, Christian terminology
Independent Catholic churches	Catholicism, Old Catholicism
Battle of Cambrai	Battles of World War I, 1917 in the United Kingdom, 1910s in Germany, 1910s in France, November 1917 events, December events
Indian Mujahideen	Islamic terrorism, Religion in India
Bhopal State	Indian princely states, 1723 establishments, 1949 disestablishments in Asia, 18th century establishments in India, 1940s disestablishments in India, 1720s establishments in Asia
Cassius Fairchild	People from Ohio, People from Wisconsin, 1829 births, 1868 deaths, State legislators of the United States
Whiskey Tjukangku	1939 births, Living people, Australian painters, Indigenous Australian artists, Artists from South Australia, Australian printmakers
Issei	Japanese culture
Clavering	Uttlesford, Villages in Essex, Civil parishes in Essex
Elmdon	Uttlesford, Villages in Essex, Civil parishes in Essex
Great Easton	Uttlesford, Villages in Essex, Civil parishes in Essex
Nisei	Japanese culture
Littlebury	Uttlesford, Villages in Essex, Civil parishes in Essex
Aluminium iodide	Chemical compounds, Aluminium compounds
Galveston, Texas	Galveston, Texas, 1839 establishments in the Republic of Texas, County seats in Texas
Xerochrysum bracteatum	Asteraceae
Lockdown (TV series)	American television series
Eiichiro Oda	Japanese manga artists, 1975 births, Living people, People from Kumamoto Prefecture
Japan Gold Disc Award	J-pop, 1987 establishments in Japan
Étienne Pierre Ventenat	1808 deaths, 1757 births, French botanists, French writers, People from Limoges
Bract	Plants
Kyūdō	Archery, Martial arts
Château de Malmaison	Museums in France, Île-de-France
Xerochrysum	Asteraceae, Plants of Australia
Henry Charles Andrews	1830 deaths, English botanists, English artists, Engravers
Talia al Ghul	Batman characters, DC Comics characters
Guckkasten	South Korean musical groups, 2003 establishments in South Korea
Tjungkara Ken	1969 births, Living people, Australian painters, Indigenous Australian artists, Artists from South Australia, Pitjantjatjara
Neo-impressionism	Art movements
Crowns of Silla	History of Korea, Korean monarchs
Christiaan Hendrik Persoon	1761 births, 1836 deaths, South African scientists, Botanists
Nura Rupert	1933 births, Living people, Australian printmakers, Indigenous Australian artists, Artists from South Australia, Pitjantjatjara
Australian Plant Name Index	Databases, Plants of Australia, Science websites
Cabinet making	Woodworking
Mantidfly	Neuroptera
Tav	Letters (alphabet)
Barney Hajiro	1916 births, 2011 deaths, Military people from Hawaii, People from Maui, United States Army Medal of Honor recipients, Legion of Honour, American people of World War II
Conference of European Schools for Advanced Engineering Education and Research	Education, Technical colleges and universities in Europe
Ginger Wikilyiri	1932 births, Living people, Australian painters, Indigenous Australian artists, Artists from South Australia, Pitjantjatjara
North Queensland	Geography of Queensland, Regions of Australia
Payari	Bangladesh, Villages in Asia
Phidippus audax	Spiders, Animals of North America
Mikio Hasemoto	1916 births, 1943 deaths, Military people from Hawaii, United States Army Medal of Honor recipients, American people of World War II
Nicholas Marcellus Hentz	1797 births, 1856 deaths, French biologists, American zoologists, People from Versailles
Italian food	Italian food
Kashima-jingū	Shinto shrines, Buildings and structures in Japan
Friedrich von Wurmb	1742 births, 1781 deaths, German biologists
Core cities of Japan	Cities in Japan
Oligopsony	Market forms
Koreapas	Schools in South Korea, Websites
The Mall, Lahore	Buildings and structures in Lahore, 19th century establishments in Pakistan
William Lockhart	1841 births, 1900 deaths, Deaths from infectious disease, People of British India, Scottish people
Xeranthemum	Asteraceae
Afridi	Ethnic groups in Pakistan, Ethnic groups in Khyber Pakhtunkhwa
Joséphine de Beauharnais	1763 births, 1814 deaths, French royalty, House of Bonaparte
Helichrysum	Asteraceae
Xerochrysum bicolor	Asteraceae, Tasmania
Abbotsford House	Buildings and structures in Scotland
Walter Savage Landor	1775 births, 1864 deaths, English writers, English poets
Mihailo Živanović	1928 births, 1989 deaths, Classical musicians, Jazz musicians, Clarinetists, Serbian musicians, Yugoslavian people, Saxophonists, Songwriters, People from Belgrade
Nyakul Dawson	1930s births, 2007 deaths, Australian painters, Indigenous Australian artists, Artists from South Australia, Artists from Western Australia
List of football clubs in Azerbaijan	Lists of football teams, Football in Azerbaijan, Sports teams in Azerbaijan
Thomson–East Coast MRT line	Mass Rapid Transit (Singapore) lines
The Bridges of Madison County	1992 books, 20th century American novels
Massimo Firpo	Italian historians, 1946 births, Living people
Subprefectures of Japan	Districts of Japan
Joe Hayashi	1920 births, 1945 deaths, American military personnel of World War II, Military people from California, Military people killed in World War II, People from Monterey County, California, United States Army Medal of Honor recipients
Dobermann	Dog breeds
George Steinbrenner	1930 births, 2010 deaths, American billionaires, American philanthropists, Cardiovascular disease deaths in the United States, Deaths from myocardial infarction, New York Yankees, Businesspeople from Cleveland, Ohio, Businesspeople from New York City
Bob Sheppard	1910 births, 2010 deaths, Deaths from natural causes, American journalists, New York Yankees, People from New York City
William Makepeace Thackeray	English writers, 1811 births, 1863 deaths
Rebecca	Given names
Sardar	India, Iran, Pakistan, Afghanistan
Cameroon (sheep)	Caprids, Domesticated animals
Alpial	Ethnic groups in Pakistan
Shizuya Hayashi	1917 births, 2008 deaths, Military people from Hawaii, United States Army Medal of Honor recipients, American people of World War II
Four Freedoms Award	American culture, Awards, Dutch culture, Human rights, New York, Zeeland, 1982 establishments in the United States, 1980s establishments in the Netherlands
Flare star	Types of stars
Ed Sheeran	1991 births, Living people, Brit Award winners, British folk musicians, English guitarists, English singer-songwriters, Musicians from West Yorkshire, Atlantic Records artists, Members of the Order of the British Empire
Italian Libya	20th century in Italy, 20th century in Libya
National Democratic Front of Bodoland	Separatist movements of India, Nationalist organizations in India, Rebel militia groups in Asia, Assam
Richard J. Daley	1902 births, 1976 deaths, Deaths from myocardial infarction, DePaul University alumni, Mayors of Chicago, US Democratic Party politicians
Harold Washington	1922 births, 1987 deaths, Burials at Oak Woods Cemetery, African American lawyers, African-American military personnel, African American politicians, American military personnel of World War II, Cardiovascular disease deaths in Chicago, Deaths from myocardial infarction, Mayors of Chicago, US Democratic Party politicians, United States representatives from Illinois, State legislators of the United States
Chicago City Hall	Buildings and structures in Chicago, Illinois, Government of Chicago, 1911 establishments in the United States, 1910s establishments in Illinois
Anton Cermak	1873 births, 1933 deaths, American murder victims, Assassinated people, Czech politicians, Mayors of Chicago, Murders by firearm in Florida, US Democratic Party politicians
Jane Byrne	1933 births, 2014 deaths, Deaths from stroke, Mayors of Chicago, US Democratic Party politicians
Carter Harrison, Jr.	1860 births, 1953 deaths, Deaths from natural causes, Disease-related deaths in Chicago, Illinois, Burials at Graceland Cemetery, Mayors of Chicago, US Democratic Party politicians
Carter Harrison, Sr.	1825 births, 1893 deaths, Deaths by firearm, United States representatives from Illinois, Burials at Graceland Cemetery, American murder victims, Mayors of Chicago, Politicians from Kentucky, US Democratic Party politicians
Anmanari Brown	1930s births, Living people, Australian painters, Indigenous Australian artists, Pitjantjatjara, Artists from Western Australia, Artists from the Northern Territory
Levi Boone	1808 births, 1882 deaths, Burials at Rosehill Cemetery, Mayors of Chicago, Politicians from Kentucky
James Curtiss	1803 births, 1859 deaths, Mayors of Chicago, Politicians from Connecticut, Politicians from Philadelphia, Pennsylvania, US Democratic Party politicians, American lawyers
William B. Ogden	1805 births, 1877 deaths, Mayors of Chicago, Politicians from New York, US Democratic Party politicians
Eugene Sawyer	1934 births, 2008 deaths, Deaths from stroke, Burials at Oak Woods Cemetery, Cardiovascular disease deaths in Chicago, Mayors of Chicago, Politicians from Alabama, African American politicians, Businesspeople from Alabama, Businesspeople from Chicago, US Democratic Party politicians
Joseph Medill	1923 births, 1899 deaths, Mayors of Chicago, Burials at Graceland Cemetery, People from New Brunswick, Naturalized citizens of the United States, US Republican Party politicians
Alson Sherman	1811 births, 1903 deaths, Mayors of Chicago, Politicians from Vermont, US Democratic Party politicians
Roswell B. Mason	1805 births, 1892 deaths, Disease-related deaths in Chicago, Illinois, Burials at Rosehill Cemetery, Mayors of Chicago, Politicians from New York
Emil Hamilton	DC Comics characters
Thomas Coryat	1577 births, 1617 deaths, History of India, English writers, English explorers
Mian Family of Baghbanpura	History of India, History of Pakistan, Lahore, Punjabi people
Arain	Ethnic groups in Pakistan, Ethnic groups in India
Walter S. Gurnee	1813 births, 1903 deaths, Deaths from natural causes, Mayors of Chicago, Politicians from New York, Politicians from Michigan, US Democratic Party politicians
Basilar-type migraine	Migraine, Neurology
Dare County, North Carolina	19th-century establishments in North Carolina, 1870 establishments in the United States, North Carolina counties
Lionel Barrymore	1878 births, 1954 deaths, Deaths from myocardial infarction, American movie actors, American television actors, American stage actors, American radio actors, American silent movie actors, Actors from Philadelphia, Pennsylvania, Academy Award winning actors
John Barrymore	1882 births, 1942 deaths, Actors from Philadelphia, Pennsylvania, American movie actors, American radio actors, American stage actors, American television actors, Barrymore family, Deaths from cirrhosis, Disease-related deaths in Los Angeles
Two-Face	Batman characters, DC Comics supervillains, Fictional characters introduced in the 1940s
Scarecrow (comics)	Batman characters, DC Comics supervillains, Fictional characters introduced in the 1940s
Yeiki Kobashigawa	1917 births, 2005 deaths, Military people from Hawaii, United States Army Medal of Honor recipients, American people of World War II, Hilo, Hawaii
Electrocardiogram	Cardiology, Machines
Archaeozoology	Branches of zoology, Archaeology
Abel Pêra	1891 births, 1975 deaths, Brazilian movie actors, Brazilian television actors, Brazilian stage actors, Carpenters, Portuguese movie actors, Portuguese television actors, Portuguese stage actors
Barbary lion	Panthera, Mammals of Africa
Mount Scopus	Mount Scopus
Gordy	1990s family movies, 1990s adventure movies, 1995 comedy-drama movies, American family movies, American comedy-drama movies, Buddy movies, Disney movies, Miramax movies, Movies about animals, Movies set in Nebraska, American children's comedy movies
Mount of Olives	Mount of Olives, Neighbourhoods of Jerusalem
Mastic	Agriculture, Spices
Sansei	Japanese culture
Dondurma	Mastic ice creams
Gurban Gurbanov	Living people, 1972 births, Azerbaijani footballers
Maccabean Revolt	Rebellions in Asia, History of Hanukkah
George Bell Swift	1845 births, 1912 deaths, Cardiovascular disease deaths in Chicago, Mayors of Chicago, Burials at Rosehill Cemetery, Chicago City Council members, Deaths from myocardial infarction, Politicians from Cincinnati, Ohio, US Republican Party politicians
Epidendroideae	Orchids
Edward Fitzsimmons Dunne	1853 births, 1937 deaths, Mayors of Chicago, Governors of Illinois, Politicians from Connecticut, American lawyers, US Democratic Party politicians
William Emmett Dever	1862 births, 1929 deaths, Deaths from cancer, Cancer deaths in Chicago, Mayors of Chicago, Politicians from Boston, Massachusetts, US Democratic Party politicians
Francis Cornwall Sherman	1805 births, 1870 deaths, Mayors of Chicago, Politicians from Connecticut, US Democratic Party politicians
William Hale Thompson	1869 births, 1944 deaths, Mayors of Chicago, Burials at Oak Woods Cemetery, Politicians from Boston, Massachusetts, US Republican Party politicians
Augustus Garrett	1801 births, 1848 deaths, Deaths from myocardial infarction, Cardiovascular disease deaths in Chicago, Burials at Rosehill Cemetery, Mayors of Chicago, Politicians from New York City, US Democratic Party politicians
John Charles Haines	1818 births, 1896 deaths, Mayors of Chicago, Burials at Rosehill Cemetery, Politicians from New York, US Democratic Party politicians, People from Waukegan, Illinois
John Wentworth	1815 births, 1888 deaths, Mayors of Chicago, Burials at Rosehill Cemetery, United States representatives from Illinois, Politicians from New Hampshire, US Republican Party politicians
Mike Honda	1941 births, Living people, People from San Jose, California, United States representatives from California
Fred A. Busse	1866 births, 1914 deaths, Cardiovascular disease deaths in Chicago, Burials at Graceland Cemetery, Mayors of Chicago, US Republican Party politicians
Julian Sidney Rumsey	1823 births, 1886 deaths, Mayors of Chicago, Politicians from New York, US Republican Party politicians
Doris Matsui	1944 births, Living people, United States representatives from California
Robert Matsui	1941 births, 2005 deaths, US Democratic Party politicians, United States representatives from California, Deaths from myelodysplastic syndrome, Deaths from pneumonia, Politicians from Sacramento, California
Francis Fukuyama	1952 births, Living people, American writers, American political scientists, American bloggers
Yad Vashem	Mount Herzl, Museums in Jerusalem, Mountains of Jerusalem
Har HaMenuchot	Mountains of Jerusalem, Cemeteries in Israel
National Headquarters of the Israel Police	Buildings and structures in Jerusalem, Government of Israel, Police stations
Supreme Court of Israel	Buildings and structures in Jerusalem, Government of Israel, National supreme courts
Mark Takano	1960 births, Living people, Harvard University alumni
Mount Zion	Mount Zion, Neighbourhoods of Jerusalem
Patsy Mink	1927 births, 2002 deaths, American feminists, People from Maui, 1972 United States presidential candidates, United States representatives from Hawaii, Deaths from pneumonia
Bev Oda	1944 births, Living people, Privy Councillors (Canada), People from Thunder Bay
Vakkom Majeed	People of British India, Indian politicians, 1909 births, 2000 deaths
Melissa McBride	1965 births, Living people, American television actors, American movie actors, Actors from Kentucky
David Tsubouchi	1952 births, Living people
Tweeter	Audio technology
RCA connector	Audio technology, Electrical connectors
Preamplifier	Electronic musical instruments, Electronics, Audio technology
Mauno Koivisto	1923 births, 2017 deaths, Deaths from Alzheimer's disease, Presidents of Finland, Prime Ministers of Finland
Kyösti Kallio	1873 births, Presidents of Finland, 1940 deaths
O Foxo, Silleda	Towns in Spain, Galicia
Saimaa	Lakes of Finland
Yonsei (fourth-generation Nikkei)	Japanese culture
Colleen Hanabusa	US Democratic Party politicians, 1951 births, Living people, United States representatives from Hawaii, Politicians from Honolulu, Businesspeople from Hawaii
International Convention Center (Jerusalem)	Buildings and structures in Jerusalem, Convention and exhibition centers in Israel
Association of Football Federations of Azerbaijan	Football in Azerbaijan, 1992 establishments in Azerbaijan, UEFA
Plantation of Ulster	History of Ireland
Argleton	Internet memes, Lancashire, Google, Fictional locations
Sadao Munemori	1922 births, 1945 deaths, People from Los Angeles, California, United States Army Medal of Honor recipients, American people of World War II
Vertical angles	Angles
Kokeshi	Japanese culture
Azerbaijan Premier League	Football in Azerbaijan, Football leagues, 2007 establishments, 21st century establishments in Azerbaijan
Menorah (Temple)	History of Hanukkah
Bulguksa	Buddhist temples, Buildings and structures in South Korea, World Heritage Sites in South Korea
Akara	Bahia, Fried foods, Brazilian food, Nigerian culture, Benin, Ghana
Buckner Stith Morris	1800 births, 1879 deaths, Disease-related deaths in Chicago, Illinois, Burials at Rosehill Cemetery, Whig party (US) politicians, Mayors of Chicago, Politicians from Kentucky, American lawyers, Chicago City Council members
Seoul Lantern Festival	Festivals in Asia, Korean culture, Seoul, 2009 establishments in Asia, 2000s establishments in South Korea
Vibraslap	Percussion instruments
Mercury poisoning	Health problems
Students in Free Enterprise	International organizations, Non-profit organizations of the United States
Chesapeake–Leopard Affair	1800s in the United States, Battles, Royal Navy, United States Navy, 19th century in the United Kingdom, June events, 1807, 19th century in Virginia
Hector Burton	1930s births, Indigenous Australian artists, Artists from South Australia, Living people, Australian painters, Pitjantjatjara
Molecular cloning	DNA, Genetic engineering
Genetically modified food	Genetic engineering, Agriculture, Foods
Tie clip	Accessories
Phone connector	Electrical connectors, Audio technology
Tokoname, Aichi	Cities in Japan, Settlements in Aichi Prefecture
Avellino	Avellino, Capital cities in Italy
Museo d'arte – MdAO	Art museums in Italy, Avellino, 1995 establishments in Europe, 1990s establishments in Italy
Benjamin Wright Raymond	1801 births, 1883 deaths, Whig party (US) politicians, Mayors of Chicago, Politicians from New York, Burials at Graceland Cemetery
Alexander Loyd	1805 births, 1872 deaths, Deaths from heart failure, Cardiovascular disease deaths in Chicago, Burials at Rosehill Cemetery, Mayors of Chicago, Politicians from New York, US Democratic Party politicians
Central Texas Council of Governments	Texas, 1968 establishments in the United States, 1960s establishments in Texas
John Putnam Chapin	1810 births, 1864 deaths, Deaths from myocardial infarction, Cardiovascular disease deaths in Chicago, Whig party (US) politicians, Mayors of Chicago, Politicians from Vermont
Signs and symptoms	Medical signs
James Machon	1848 births, Year of death unknown, United States Navy Medal of Honor recipients
Surabaya	Cities in Indonesia, Java
Samul nori	Korean music
63 Building	Skyscrapers, Buildings and structures in Seoul
Busker Busker	South Korean musical groups, Indie bands, Reality television participants, 2011 establishments in Asia, 2010s establishments in South Korea
Menorah (Hanukkah)	Hanukkah, Religious symbols
Suspension of disbelief	Fantasy, Psychology, Fiction
James Hutchinson Woodworth	1804 births, 1869 deaths, Burials at Oak Woods Cemetery, Chicago City Council members, Mayors of Chicago, Politicians from New York, United States representatives from Illinois, US Republican Party politicians, State legislators of the United States
Isaac Lawrence Milliken	1815 births, 1885 deaths, Disease-related deaths in Chicago, Illinois, Burials at Rosehill Cemetery, Mayors of Chicago, Politicians from Maine, US Democratic Party politicians
Charles McNeill Gray	1807 births, 1885 deaths, Mayors of Chicago, Politicians from New York, US Democratic Party politicians
Thomas Dyer	1805 births, 1862 deaths, Deaths from myocardial infarction, Mayors of Chicago, Politicians from Connecticut, US Democratic Party politicians
John Blake Rice	1809 births, 1874 deaths, Cancer deaths in Chicago, Burials at Rosehill Cemetery, Actors from Chicago, Actors from Maryland, American stage actors, Deaths from liver cancer, Mayors of Chicago, Politicians from Maryland, United States representatives from Illinois, US Republican Party politicians
Harvey Doolittle Colvin	1815 births, 1892 deaths, Disease-related deaths in Chicago, Illinois, Burials at Rosehill Cemetery, Mayors of Chicago, Politicians from New York
Monroe Heath	1827 births, 1894 deaths, Deaths from stroke, Burials at Oak Woods Cemetery, Mayors of Chicago, Politicians from New Hampshire, US Republican Party politicians
Menelik II	Ethiopian people, 1913 deaths, 1844 births, Emperors and empresses, Addis Ababa
Rogers Arena	1995 establishments in Canada, Indoor arenas, Music venues, Sports buildings in Canada, Vancouver
Besse Cooper	1896 births, 2012 deaths, American supercentenarians, Deaths from respiratory failure, People from Tennessee
University of Bristol	Universities in England, Bristol
James Lovelock	1919 births, Living people, Companions of Honour, Commanders of the Order of the British Empire, Fellows of the Royal Society, English scientists, Ecology, Earth
DIN connector	Electrical connectors
XLR connector	Electrical connectors, Audio technology
Jayne Meadows	Actors from New York City, Actors from Connecticut, American stage actors, American television actors, American movie actors, Deaths from natural causes, 1919 births, 2015 deaths
Line level	Audio technology
Objectification	Literature
Kim Campbell	1947 births, Canadian writers, Canadian diplomats, Canadian lawyers, Living people, Politicians from British Columbia, Members of the House of Commons of Canada from British Columbia, Privy Councillors (Canada), Canadian Queen's Counsel
Joy Davidman	1915 births, 1960 deaths, American poets, Cancer deaths in England, Deaths from bone cancer, Writers from New York City
Girma Wolde-Giorgis	1924 births, Presidents of Ethiopia, Addis Ababa, 2018 deaths
Hydrometer	Measuring tools
Hygrometer	Measuring tools, Weather instruments
Gondola lift	Vehicles, Ski lifts
John A. Roche	1844 births, 1904 deaths, Accidental deaths, Burials at Rosehill Cemetery, Mayors of Chicago, Politicians from New York, US Republican Party politicians, People from Utica, New York
DeWitt Clinton Cregier	1829 births, 1898 deaths, Deaths from pneumonia, Burials at Rosehill Cemetery, Mayors of Chicago, Politicians from New York City, US Democratic Party politicians
Hempstead Washburne	1852 births, 1919 deaths, Mayors of Chicago, Politicians from Illinois, US Republican Party politicians
John Patrick Hopkins	1858 births, 1918 deaths, Deaths from influenza, Mayors of Chicago, Politicians from Buffalo, New York, US Democratic Party politicians
Jeonju	Korea, Cities in Asia
Frank J. Corr	1877 births, 1934 deaths, Deaths from myocardial infarction, Mayors of Chicago, Politicians from New York City, US Democratic Party politicians
Edward Joseph Kelly	1876 births, 1950 deaths, Deaths from heart failure, Mayors of Chicago, US Democratic Party politicians
Backpacking (travel)	Travel
Martin H. Kennelly	1887 births, 1961 deaths, Deaths from heart failure, Mayors of Chicago, US Democratic Party politicians
Starship Troopers	1997 action movies, 1990s adventure movies, 1997 science fiction movies, 1997 thriller movies, American action movies, American adventure movies, American science fiction movies, American thriller movies, English-language movies, Movies set on fictional planets, Movies directed by Paul Verhoeven
Trifles	Plays
SSG Landers	Sport in South Korea, Baseball teams, Incheon, 2000 establishments in Asia, 2000s establishments in South Korea
Michael Anthony Bilandic	1923 births, 2002 deaths, Deaths from heart failure, DePaul University alumni, Chicago City Council members, Mayors of Chicago, US Democratic Party politicians
Jean Baptiste Point du Sable	1818 deaths, Haitian people, People from Michigan City, Indiana, People from Chicago
Lester L. Bond	1829 births, 1903 deaths, Deaths from stroke, Burials at Rosehill Cemetery, Mayors of Chicago, Politicians from Ohio, US Republican Party politicians
Thomas Hoyne	1817 births, 1883 deaths, Accidental deaths, Mayors of Chicago, Independent politicians in the United States, Politicians from New York City
David Duvall Orr	1944 births, Living people, Mayors of Chicago, US Democratic Party politicians
Héctor Camacho	1962 births, 2012 deaths, Murder victims, Sportspeople from Puerto Rico, Boxers
Voiced consonant	Pronunciation
Dyke (geology)	Rocks
Angie Dickinson	1931 births, Living people, Actors from North Dakota, American movie actors, American television actors, American stage actors
Sill (geology)	Igneous rocks
Enantiomer	Stereochemistry
Aldol reaction	Organic reactions
Robert Kuroda	1922 births, 1944 deaths, Military people from Hawaii, United States Army Medal of Honor recipients, American people of World War II
Ryu Hyun-Jin	Living people, 1987 births, South Korean baseball players, Los Angeles Dodgers players
Skyfall	2012 movies, 2010s action movies, 2012 crime movies, 2010s spy movies, 2012 thriller movies, James Bond movies, Movies set in London, Movies set in China, Movies set in Turkey, Movies set in Scotland, Movies set in islands, English-language movies, Movies that won the Best Original Song Academy Award, Movies directed by Sam Mendes
Tomb of Zechariah (Ben Jehoiada)	Mount of Olives, Buildings and structures in Jerusalem, Monuments and memorials in Israel, Burial monuments and structures
Tomb of Absalom	Mount of Olives, Buildings and structures in Jerusalem, Monuments and memorials in Israel, Burial monuments and structures
Tomb of Nicanor	Archaeological sites in Israel, Buildings and structures in Jerusalem, Caves, Cemeteries in Israel, Hebrew University of Jerusalem, Mount Scopus, National cemeteries
Bezalel Academy of Art and Design	Mount Scopus, Buildings and structures in Jerusalem, Colleges and universities in Israel
Bahá'í World Centre	Bahá'í Faith, Buildings and structures in Haifa, Religion in Israel, Religious buildings
Eddie Bracken	1915 births, 2002 deaths, Deaths from surgical complications, American movie actors, American television actors, American stage actors, American radio actors, American voice actors, Comedians from New York City, American television personalities, American radio personalities, Actors from New York City
David Newell	1938 births, Living people, American television actors, American voice actors, Actors from Pittsburgh, Pennsylvania
The Crucible (2011 movie)	2011 movies, Korean-language movies
Medical assistant	Healthcare occupations
Scalping	Violence
Angkaliya Curtis	1928 births, Living people, Australian painters, Indigenous Australian artists, Pitjantjatjara, Artists from South Australia
Dickie Minyintiri	1915 births, Indigenous Australian artists, Artists from South Australia, Artists from Western Australia, Living people, Australian painters, Pitjantjatjara
24	24
25	20s
Ambrose	Milan, Christian religious leaders, Roman Catholics, 330s births, 390s deaths
Phu Quoc International Airport	Airports in Vietnam, 2012 establishments in Asia, 21st century establishments in Vietnam
Jerusalem Academy of Music and Dance	Buildings and structures in Jerusalem, Hebrew University of Jerusalem, Music schools
Ben Gurion International Airport	Airports in Israel, Buildings and structures in Tel Aviv
Korean Augmentation to the United States Army	Military of South Korea
Paloma Faith	1981 births, Living people, English singer-songwriters, Actors from London, British jazz musicians, British soul musicians, English movie actors, English pop singers, English television actors, People from Hackney, Singers from London, English musicians
Darlington transistor	Electronic circuits, Electronic components
Kaoru Moto	1917 births, 1992 deaths, Military people from Hawaii, United States Army Medal of Honor recipients, American people of World War II
Schmitt trigger	Electronic circuits
U.S. Army Nurse Corps	Nursing, United States Army, 1901 establishments in the United States
Ignaz Semmelweis	1818 births, 1865 deaths, Deaths by beating, Hungarian people, Physicians
Robert Eugene Bush	1926 births, 2005 deaths, American people of World War II, United States Navy Medal of Honor recipients, Purple Heart recipients, People from Tacoma, Washington
Televisión Nacional de Chile	Chilean television networks
Canal 13 (Chile)	Chilean television networks
Tonka Tomičić	1976 births, Chilean models, Chilean television presenters, Living people, People from Santiago
La Red	Chilean television networks
Pamela Díaz	Living people, 1981 births, Chilean models, Chilean television presenters, People from Puerto Varas
Buddy Guy	1936 births, Living people, American blues musicians, Chicago blues musicians, Musicians from Louisiana, Musicians from Chicago, Singers from Louisiana, Singers from Chicago, Grammy Award winners, Kennedy Center honorees
Ed O'Neill	1946 births, Living people, American movie actors, American television actors, American stage actors, American voice actors, Actors from Ohio, Screen Actors Guild Award winners, People from Youngstown, Ohio
Michael Dell	1965 births, Living people, Businesspeople from Houston, Texas, American billionaires, American inventors, American Jews, Chief executives, Writers from Houston, Texas
James Gosling	1955 births, Living people, Computer scientists, Canadian businesspeople, Chief executives, People from Calgary
Colt McCoy	1986 births, Living people, American Christians, American football quarterbacks, Cleveland Browns players, San Francisco 49ers players, Washington Redskins players, Sportspeople from New Mexico
Sense and Sensibility (movie)	1995 movies, Movies based on books, English-language movies
Antofagasta	Antofagasta
Karyn White	African-American singers, Singers from California, R&B musicians, 1965 births, Living people
Holland Taylor	1943 births, Living people, American movie actors, American television actors, American stage actors, American voice actors, Actors from Philadelphia, Pennsylvania, Emmy Award winning actors
Alan King	1927 births, 2004 deaths, Deaths from lung cancer, American movie actors, American television actors, American stage actors, American voice actors, American radio actors, American movie producers, Comedians from New York City, Jewish American actors, Actors from New York City, Writers from New York City, Movie producers from New York
Four Freedoms	1941 in the United States, Human rights, Speeches, Freedom
Right to an adequate standard of living	Human rights, Socioeconomics
Freedom from fear	Human rights, Freedom
Port Coquitlam	Cities in British Columbia, 1859 establishments, 1850s establishments in Canada
Four Freedoms Monument	Buildings and structures in Florida, Monuments and memorials in the United States, 1943 establishments in the United States, 1940s establishments in New York (state), 1940s establishments in Florida
Toomas Hendrik Ilves	1953 births, Living people, European diplomats, Presidents of Estonia, Journalists, Politicians from Stockholm
Nimravides	Machairodonts, Fossils, Sabretooth cats, Miocene
Gong Ji-young	1963 births, Living people, Korean writers, People from Seoul
Finnair	Companies of Finland, Airlines of Europe, 1923 establishments in Europe, 1920s establishments in Finland
Hazara District	Districts of Pakistan
Washuk District	Districts of Balochistan (Pakistan)
Bengali nationalism	Nationalism, Bangladesh, West Bengal
Swadhin Bangal Biplobi Parishad	Nationalist organizations in Bangladesh, 1961 establishments in Asia, 20th century establishments in Bangladesh
Helping hand	Electronics, Tools
Mini Israel	Museums in Israel
CNA Center	1972 establishments in Illinois
One Prudential Plaza	1955 establishments in the United States, 1950s establishments in Illinois
Power line communication	Computers
Chicago Theatre	Theatres in Chicago, Landmarks in Chicago, National Register of Historic Places
Chicago River	Geography of Chicago, Rivers of Illinois
Multiplexing	Telecommunications
Western Wall	Walls, Temple Mount, Judaism in Israel, Buildings and structures in Jerusalem
Haifa International Airport	Airports in Israel, Buildings and structures in Haifa
Carolina de Moras	1981 births, Chilean models, Chilean movie actors, Chilean television actors, Chilean television presenters, Living people, People from Osorno
Rockefeller Center	Buildings and structures in Manhattan, New York City Designated Landmarks
Coquitlam	Cities in British Columbia, 1908 establishments in North America, 1900s establishments in Canada
Transamerica Pyramid	Buildings and structures completed in the 20th century, Buildings and structures in San Francisco, Skyscrapers in the United States, Landmarks in San Francisco, 1972 establishments in the United States, 1970s establishments in California
Jerusalem International Airport	Airports in Asia, Airports in Israel, Buildings and structures in Jerusalem, Mandatory Palestine
Jorge Zabaleta	1970 births, Living people, People from Santiago, Chilean movie actors, Chilean television actors, Chilean stage actors, Chilean television presenters
1988 United States presidential election	1988 in the United States, 1988 elections, United States presidential elections
Jerusalem Light Rail	Buildings and structures in Jerusalem, Light rail, Transport in Israel
Radioisotope thermoelectric generator	Electricity, Machines
Carmelit	Haifa, Rapid transit systems, Transport in Israel
Jerusalem Historical City Hall Building	Buildings and structures in Jerusalem, Government buildings in Israel, Local government in Israel
Norman Rockwell Museum	Museums in Massachusetts, Art museums in the United States, 1969 establishments in the United States, 1960s establishments in Massachusetts
Freedom of Speech (Norman Rockwell)	1943 paintings, American paintings
Freedom of Worship (Norman Rockwell)	1943 paintings, American paintings
Freedom from Want (Norman Rockwell)	1943 paintings, American paintings
Freedom from Fear (painting)	1943 paintings, American paintings
Frank O. Salisbury	English painters, 1874 births, 1962 deaths
Óscar Romero	1917 births, 1980 deaths, Murder victims, Roman Catholic archbishops, Salvadoran people
Umeå	Umeå
Billy Wara	1920 births, 2008 deaths, Australian sculptors, Woodworkers, Artists from the Northern Territory, Indigenous Australian artists, Pitjantjatjara
Jämsä	Towns in Finland, Municipalities of Central Finland, 1866 establishments in Europe, 1860s establishments in Finland
Kiyoshi Muranaga	1922 births, 1944 deaths, People from Los Angeles, California, United States Army Medal of Honor recipients, American people of World War II
Audio feedback	Sound
Werner Leich	1927 births, Living people, Christian ministers, Christian theologians, East German people, German Lutherans, German military personnel of World War II, German theologians, Lutheran bishops, People from Thuringia
Eohippus	Horses, Fossils
Emiel van Lennep	1915 births, 1996 deaths, Dutch civil servants, Dutch diplomats, Politicians from Amsterdam
Tubuai	Islands of French Polynesia
Christ's College, Cambridge	Colleges of the University of Cambridge, 1347 establishments, 1340s establishments in England
National Geographic Bee	Geography, Competitions, Events in the United States
Science Daily	Science websites
Limbdi	Cities in India, Settlements in Gujarat
Shanghai Urban Planning Exhibition Center	Museums in China, Convention and exhibition centers, Urban planning, Buildings and structures in Shanghai
Shchusev State Museum of Architecture	Architecture, Urban planning, Buildings and structures in Moscow, Museums in Europe, Education in Russia
Cable cars in Haifa	Transport in Israel, Haifa, Cableways
Earl Scruggs	1924 births, 2012 deaths, Deaths from natural causes, Musicians from North Carolina, American bluegrass musicians, American guitarists, Banjo players, Grammy Award winners
Jenni Rivera	1969 births, American activists, American television actors, American television producers, Aviation deaths, Latin singers, Mexican television actors, Mexican singers, Actors from Long Beach, California, Singers from Los Angeles County, California
Elisabeth Murdoch	1909 births, 2012 deaths, Centenarians, Deaths from natural causes, Monarchists, People from Melbourne, Australian philanthropists
Hole (band)	1989 establishments in the United States, 1980s American music groups, 1990s American music groups, 2000s American music groups, 2010s American music groups, 2012 disestablishments in the United States, American rock bands, Musical groups disestablished in 2012, Musical groups established in 1989, Musical groups from Los Angeles, California
Churchill College, Cambridge	Colleges of the University of Cambridge, 1960 establishments in the United Kingdom, 1960s establishments in England
Statler and Waldorf	Muppets, Fictional characters
The Muppet Christmas Carol	1992 movies, Disney animated movies, Animated movies, Movies based on TV series, Movies based on books, Movies about animals, Muppets, American family movies, English-language movies
Nurzhol Boulevard	Kazakhstan, Roads, National squares
Jerusalem City Hall	Government buildings in Israel, Buildings and structures in Jerusalem, Local government in Israel
Clare College, Cambridge	Colleges of the University of Cambridge, 1326 establishments, 1320s establishments in Europe, 14th century establishments in England
1972 United States presidential election	1972 in the United States, United States presidential elections
The McGuire Sisters	American girl groups, Musical groups established in the 1950s, 1952 establishments in the United States, 20th-century establishments in Ohio, 1968 disestablishments, 1960s disestablishments in the United States, Disestablishments in Ohio
Hasmonean dynasty	Royal dynasties, Ancient Israel and Judah, Kings of ancient Judah, 1st-century BC disestablishments
Rizzo the Rat	Muppets, Fictional characters
Penola Catholic College	Schools in Australia, 1995 establishments, Buildings and structures in Melbourne, 1990s establishments in Australia
Greedy algorithm	Greedy algorithms
1968 United States presidential election	United States presidential elections, Ronald Reagan, Richard Nixon, 1968 in the United States
American Independent Party	1967 establishments in California, Political parties in the United States
Zen at War	Buddhism, 1997 books
Sunda clouded leopard	Felines
Seoul Fringe Festival	Performing arts, Festivals in Asia, Seoul, 1988 establishments in Asia, 1980s establishments in South Korea
Dynamic programming	Computer science, Combinatorial optimization
Karjala	Beers of Finland
Infrasound	Sound
Gorgias (Plato)	Works of philosophy
Full-range speaker	Audio technology
Concert band	Musical groups
Masato Nakae	1917 births, 1998 deaths, Military people from Hawaii, United States Army Medal of Honor recipients, American people of World War II
Maeshowe	Prehistoric buildings and structures, Buildings and structures in Scotland, Archaeological sites in Scotland, World Heritage Sites in the United Kingdom, Orkney, Neolithic
Clare Hall, Cambridge	Colleges of the University of Cambridge, 1966 establishments in England
Corpus Christi College, Cambridge	Colleges of the University of Cambridge, 1352 establishments, 14th century establishments in England, 1350s establishments in Europe
Ipse dixit	Logical fallacies, Latin words and phrases
Darwin College, Cambridge	Colleges of the University of Cambridge, 1964 establishments in the United Kingdom, 1960s establishments in England
Downing College, Cambridge	Colleges of the University of Cambridge
Höðr	Norse gods and goddesses
The Power Within	Power metal, DragonForce, 2008 albums
John Hancock Tower	Buildings and structures in Boston, Massachusetts, Skyscrapers in the United States, I. M. Pei buildings, 1969 establishments in the United States, 1960s establishments in Massachusetts
4th century BC	4th century BC
Theophrastus	4th century BC births, 3rd century BC deaths, Ancient Greek philosophers
JYJ	South Korean musical groups, 2010 establishments in South Korea, Musical groups established in 2010
Commodores	1960s American music groups, 1970s American music groups, 1980s American music groups, 1990s American music groups, 2000s American music groups, 2010s American music groups, American R&B bands, Funk bands, Musical groups from Alabama, Soul bands
Cops (TV series)	1989 American television series debuts, 1980s American television series, 1990s American television series, 2000s American television series, 2010s American television series, American crime television series, Police television series, English-language television programs
Hydrophone	Audio technology
Narva	Cities in Estonia
Rochester, Kent	Medway, Towns in Kent
8th century BC	8th century BC
Medway	Medway
Karhu	Beers of Finland
Kruskal's algorithm	Greedy algorithms, Graph theory, Combinatorial optimization
Gillingham, Kent	Gillingham, Kent
Koff	Beers of Finland
Olvi	Beers of Finland
Lapin Kulta	Beers of Finland
A Werewolf Boy	South Korean movies, 2012 movies, Monster movies
Harnai District	Districts of Balochistan (Pakistan)
Mega (Chile)	Chilean television networks, 1990 establishments in Chile
Chilevisión	Chilean television networks
Coloratura	Singing
High intensity training	Training, Fitness
Beth Hatefutsoth	Museums in Tel Aviv
International Institute for Terrorism Research	Think tanks, Terrorism, Israel
1923 Great Kantō earthquake	Earthquakes in Japan, 1923, 1920s in Japan, September events
Tom Daley	1994 births, Living people, British Olympic bronze medalists, Divers, English LGBT people, English sportspeople, Gay men, LGBT Olympians, People from Plymouth
Emmanuel College, Cambridge	Colleges of the University of Cambridge
Fitzwilliam College, Cambridge	Colleges of the University of Cambridge
Girton College, Cambridge	Colleges of the University of Cambridge
Federation of Genealogical Societies	Austin, Texas, Non-profit organizations of the United States, Genealogy
Pendulum (band)	2000s music groups, Musical groups established in 2002, 2010s music groups, Australian rock bands, Electronic music bands, Musical duos, Musical groups from Western Australia
Ryan Longwell	1974 births, Green Bay Packers players, Living people, Minnesota Vikings players
Jovan Belcher	1987 births, 2012 deaths, African American players of American football, American murderers, Criminals from New York, Kansas City Chiefs players, Murderers who committed suicide, Murder-suicides in the United States, Sportspeople from New York, Sportspeople who committed suicide, Suicides by firearm in the United States
Ted Bulley	1955 births, American Hockey League players, Canadian ice hockey left wingers, Chicago Blackhawks players, Ice hockey people from Ontario, Living people, International Hockey League (1945–2001) players, Quebec Major Junior Hockey League players, Ontario Hockey League players, Central Professional Hockey League players
Bunny Roser	1901 births, 1979 deaths, American baseball players, Sportspeople from St. Louis, Missouri
Mutant (movie)	1983 horror movies, American horror movies, English-language movies, Zombie movies
Fundamental force	Force
Platt Amendment	20th century in Cuba, 1901 in the United States
Bob Schieffer	1937 births, Living people, American journalists, American historians, Writers from Fort Worth, Texas, Writers from Austin, Texas, Emmy Award winners
Wakeboarding	Water sports, Board sports
Chicago Water Tower	Landmarks in Chicago, Buildings and structures in Chicago, Illinois, History of Chicago, 1869 establishments in the United States, 1860s establishments in Illinois
Albertus Magnus	1200s births, 1280 deaths, Christian theologians
Antônio Carlos Jobim	Brazilian singers, Deaths from cardiac arrest, Deaths from pulmonary embolism, Deaths from surgical complications, Deaths from urinary tract infection, Cardiovascular disease deaths in New York City, 1927 births, 1994 deaths, People from Rio de Janeiro
Bossa nova	Music genres
Charles Bridge	Stone bridges, Prague, Buildings and structures in the Czech Republic
Gamla stan	Stockholm
Cristián de la Fuente	1974 births, Living people, Chilean models, Chilean television actors, Chilean movie actors, People from Santiago, Chilean television presenters
Kia Tigers	Baseball teams, Sport in South Korea, 1982 establishments in Asia, 1980s establishments in South Korea
Audio mixer	Audio technology
Seoul International Fireworks Festival	Festivals in Asia, Seoul
Supercapacitor	Electronic components
CouchSurfing	Social networking, Companies of the United States
Independence Square (Ukraine)	Monuments and memorials, Buildings and structures in Ukraine, Kiev
Solvent extraction	Chemistry
College Scholastic Ability Test	Examinations, Education in South Korea
Juho Kusti Paasikivi	Presidents of Finland, 1870 births, 1956 deaths
Fiscal policy	Economic policy
Intensity of preference	Economics, Community
Bedchamber crisis	1830s in the United Kingdom, 1839
Lauri Kristian Relander	Presidents of Finland, Speakers of the Parliament of Finland, 1883 births, 1942 deaths
Kaarlo Juho Ståhlberg	Presidents of Finland, 1865 births, 1952 deaths
Vicki Escarra	Businesspeople from Georgia (U.S. state), 1955 births, Living people, People from Decatur, Georgia, American chief executives
Wingate Institute	Sport in Israel, 1957 establishments, Colleges and universities in Israel, 1950s establishments in Israel
Finnish markka	History of Finland, Former currencies of Europe
National Sport Center – Tel Aviv	Buildings and structures in Tel Aviv, Sports buildings, Sport in Israel, 1978 establishments in Asia, 1970s establishments in Israel
Närpes	Towns in Finland
Lappeenranta	Cities in Finland, Municipalities of South Karelia
Shinyei Nakamine	1920 births, 1944 deaths, Military people from Hawaii, United States Army Medal of Honor recipients, American people of World War II
National Building Museum	Museums in Washington, D.C., Architecture, Urban design, Urban planning, 1969 establishments in the United States, 20th-century establishments in Washington, D.C.
Gonville and Caius College, Cambridge	Colleges of the University of Cambridge
Imatra	Towns in Finland, Municipalities of South Karelia
Iisalmi	Towns in Finland, Municipalities of Northern Savonia
Homerton College, Cambridge	Colleges of the University of Cambridge
Hughes Hall, Cambridge	Colleges of the University of Cambridge
Charlottetown	Cities in Prince Edward Island, Provincial and territorial capitals of Canada
Summerside, Prince Edward Island	Cities in Prince Edward Island
Peter Travers	Living people, Year of birth missing (living people), American movie critics, American journalists
A. O. Scott	1966 births, Living people, American journalists, American movie critics, Jewish American writers, Writers from Massachusetts, Writers from New York City
Pehr Evind Svinhufvud	Presidents of Finland, 1861 births, 1944 deaths
Karachi South District	Districts of Sindh
11th century BC	11th century BC
2nd millennium BC	2nd millennium BC
3rd millennium BC	3rd millennium BC
Scottish highland dance	Dance types, Scotland
Paulina Porizkova	1965 births, Living people, American models, American movie actors, American television actors, Czech actors
Rich Girl	2004 songs, Gwen Stefani songs, Reggae songs, R&B songs
The Jerry Springer Show	1991 American television series debuts, 1990s American television series, 2000s American television series, 2010s American television series, American television talk shows, First run syndicated television programs, Stamford, Connecticut, English-language television programs
Merostomata	Chelicerata
Jack (tool)	Tools
Pielinen	Lakes of Finland
Karachi East District	Districts of Sindh
Lake Inari	Lakes of Finland
Oulujärvi	Lakes of Finland
Kemijoki	Rivers of Finland
Kymijoki	Rivers of Finland
Siikajoki (river)	Rivers of Finland
Päijänne	Lakes of Finland
Näsijärvi	Lakes of Finland
Höytiäinen	Lakes of Finland
Kallavesi	Lakes of Finland
Lake Keitele	Lakes of Finland
Jääsjärvi	Lakes of Finland
Keiko (whale)	1976 births, 2003 deaths, Cetaceans, Individual animals
Karelian pasty	Finnish food
Pasquale J. D'Amuro	Businesspeople from New York, Civil servants, Directors of intelligence agencies, American television personalities, Terrorism, Year of birth missing (living people), Living people
Karachi Central District	Districts of Sindh
Karachi West District	Districts of Pakistan
Goa liberation movement	Separatist movements of India, Nationalism, Colonialism, Goa
Sunamganj District	Districts of Bangladesh
Maulvibazar District	Districts of Bangladesh
Habiganj District	Districts of Bangladesh
William Nakamura	1922 births, 1944 deaths, People from Seattle, Washington, United States Army Medal of Honor recipients, American people of World War II
Rotuma	Islands of Fiji, Provinces of Fiji
Virmajärvi	Lakes of Finland
Shonan Gold	Citrus
Luirojärvi	Lakes of Finland, Lapland
Lake Ruovesi	Lakes of Finland
Lake Lappajärvi	Lakes of Finland
Adrian Smith (architect)	1944 births, Living people, Architects from Chicago
Luc Besson	1955 births, Living people, BAFTA Award winning directors, French screenwriters, Movie directors from Paris, Movie producers from Paris, Writers from Paris
Blushing	Face
Patricia Wettig	American television actors, Actors from Ohio, 1951 births, Living people
San Bernardino County, California	San Bernardino County, California, 1853 establishments in California
The Heroes of Olympus	Series of books, 2010s books, Children's books
John of the Cross	1542 births, 1591 deaths, Christian mystics, Spanish Roman Catholics
Exmoor pony	Horse breeds
Cairo spiny mouse	Rodents
Harz red mountain cattle	Cattle breeds
Consequentialism	Ethics, Philosophical movements and positions
Play (activity)	Human behavior, Ethology
North Karachi	Districts of Pakistan, Karachi
Dravida Nadu	History of Tamil Nadu, Nationalism, Separatist movements of India
Electric bicycle	Electric vehicles
Kokemäki	Cities in Finland
Laihia	Municipalities of Finland
Spacetime metric	Relativity
Rautalampi	Municipalities of Northern Savonia, 1560s establishments in Europe, 16th century establishments in Finland, 1561 establishments, Disestablishments in Europe
Vaasa	Cities in Finland
Kamakura shogunate	History of Japan, Samurai, 1192 establishments, 1190s establishments in Japan, 1330s disestablishments in Japan, 1333 disestablishments
Sandy Hook Elementary School shooting	2012 crimes in the United States, 2010s in Connecticut, 2010s mass shootings in the United States, 2010s murders in the United States, Attacks on buildings and structures in 2012, Attacks on schools in the United States, December events, Mass murder in 2012, Massacres in the United States, Murder-suicides in the United States, Murders by firearm in the United States, School shootings in the United States, Suicide in the 2010s, Suicides by firearm in the United States
Sysmä	Municipalities of Päijänne Tavastia
Lee Archer (pilot)	Businesspeople from New York, People from Yonkers, New York, American military people, Air force, 1919 births, 2010 deaths
1289	1289
Brenda Ann Spencer	1962 births, Living people, American murderers, American prisoners, Criminals from California, People from San Diego, California
Mango (airline)	2006 establishments, Low-cost airlines, Airlines of South Africa, 2000s establishments in South Africa
Oakville, Ontario	Towns in Ontario
1976 United States presidential election	1976 in the United States, Gerald Ford, Jimmy Carter, Ronald Reagan, United States presidential elections
Green Party of Canada	Green political parties, Political parties in Canada, 1983 establishments in Canada
Andrea Yates	People acquitted of murder, People from Texas, 1964 births, Living people
Gaia hypothesis	Ecology
Bangladesh Premier League	Cricket leagues, Sport in Bangladesh, 2012 establishments in Asia, 21st century establishments in Bangladesh
Justin Welby	1956 births, Living people, Alumni of the University of Cambridge, Anglican archbishops, Anglican priests, Archbishops of Canterbury, English Anglicans, English priests, Members of the House of Lords, People educated at Eton College, People from London, Privy Councillors (UK)
Sattar Bahlulzade	1909 births, 1974 deaths, Azerbaijani people, Painters
1956 United States presidential election	1956 in the United States, United States presidential elections
Joe Nishimoto	1920 births, 1944 deaths, Military people from California, United States Army Medal of Honor recipients, American people of World War II
Ahl al-Bayt	Arabic words and phrases, Islamic culture
Julia Vial	1977 births, Chilean television presenters, Chilean journalists, Living people, People from Santiago
Wikidata	Wikimedia Foundation, Wikis
Chris Ellis	1956 births, Living people, American movie actors, American television actors, American voice actors, American stage actors, Actors from Dallas, Texas, Actors from Memphis, Tennessee
Aidan Gillen	1968 births, Living people, Irish movie actors, Irish television actors, Irish voice actors, Irish stage actors, Actors from Dublin
Josh Stewart	1977 births, Living people, American movie actors, American television actors, American voice actors, American stage actors, Actors from West Virginia
Karimganj district	Districts of Assam, Territorial disputes
Life After People	American television series, Documentaries, English-language television programs
USS Constitution	Naval transport, 1794, 1797 in the United States, Naval ships of the United States
Grant's Tomb	1897 establishments in the United States, Ulysses S. Grant, Landmarks in Manhattan, Art Deco buildings, National Memorials of the United States, Burial monuments and structures, 1890s establishments in New York (state), New York City Designated Landmarks
Adlai Stevenson II	1900 births, 1965 deaths, Deaths from myocardial infarction, 1960 United States presidential candidates, United States Ambassadors to the United Nations, Politicians from Illinois, Politicians from California, US Democratic Party politicians, Governors of Illinois, American Christians, People from Bloomington, Illinois, People from Normal, Illinois
Allan Ohata	1918 births, 1977 deaths, Military people from Hawaii, United States Army Medal of Honor recipients, American people of World War II
Kazuo Kitai	Japanese photographers, 1944 births, Living people
Ville Nieminen	1977 births, 2002 Winter Olympics, American Hockey League players, Calgary Flames players, Chicago Blackhawks players, Colorado Avalanche players, Finnish ice hockey players, Finnish Olympic silver medalists, Living people, Medalists at the 2006 Winter Olympics, New York Rangers players, Pittsburgh Penguins players, San Jose Sharks players, St. Louis Blues players, Stanley Cup champions, Swedish Hockey League players, Tampere
Mara Wilson	1987 births, Living people, Actors from Burbank, California, American child actors, American movie actors, American stage actors, American television actors, Bisexual people, Jewish American actors, LGBT actors, LGBT people from California, LGBT playwrights, Writers from Los Angeles County, California, American bloggers
Heather (name)	Given names
Alberta Williams King	1904 births, 1974 deaths, Murdered African-American people, Deaths by firearm, People from Atlanta, Georgia
Coretta Scott King	1927 births, 2006 deaths, African American writers, American civil rights activists, American LGBT rights activists, Deaths from respiratory failure, Deaths from stroke, Martin Luther King Jr., Nonviolence advocates, Writers from Alabama
Elles	French drama movies, Polish movies, German drama movies, 2011 movies, Multilingual movies, Movies directed by Małgorzata Szumowska
Aokigahara	Forests, Geography of Japan
Breaking Bad	2008 American television series debuts, 2013 American television series endings, 2000s American drama television series, 2000s crime television series, 2010s American crime television series, 2010s American drama television series, Albuquerque, New Mexico, American crime drama television series, Cancer in fiction, Emmy Award winning programs, Golden Globe Award winning programs, Saturn Award winners, Screen Actors Guild Award winners, Television series about families, Works about drugs, English-language television programs
Margaret Purves	1935 births, Living people, British Army people, George Cross holders, Nurses, People from Cardiff
1952 United States presidential election	1952, 1950s in the United States, United States presidential elections
Bill Apiata	1972 births, Living people, New Zealand Māori people, Victoria Cross winners
Jean-Claude Van Damme	1960 births, Living people, Actors from Brussels, Belgian movie actors, Belgian movie directors, Belgian stage actors, Belgian television actors, Belgian voice actors, People from Brussels-Capital Region, Martial artists, People with bipolar disorder
United Liberation Front of Assam	Assam, Separatist movements of India, Politics of India, 1979 establishments in Asia, Rebel militia groups in Asia, Nationalist organizations in India, 1970s establishments in India
Tamil Nadu Liberation Army	Tamil Nadu, Separatist movements of India, Nationalist organizations in India, 1985 establishments in Asia, Rebel militia groups in Asia, 1980s establishments in India
John Sparkman	1899 births, 1985 deaths, American Methodists, Deaths from natural causes, United States representatives from Alabama, United States senators from Alabama, US Democratic Party politicians
Dolph Lundgren	1957 births, Living people, Swedish movie actors, Swedish television actors, Swedish stage actors, Swedish voice actors, Swedish movie directors, Martial artists, Sportspeople from Stockholm, Actors from Stockholm
Estes Kefauver	1903 births, 1963 deaths, Politicians from Tennessee
Muslim United Liberation Tigers of Assam	Assam, Islamic organizations, Islamic terrorism, Religion in India
Estelle Reiner	1914 births, 2008 deaths, Deaths from natural causes, Actors from New York City, American movie actors, American stage actors, American television actors, American voice actors, Comedians from New York City, Jewish American actors, Singers from New York City
History of Punjab	Punjab
Newtown, Connecticut	Cities in Connecticut, 1700s establishments in Connecticut, 1705 establishments
Qilin	Chinese culture, Legendary creatures
Jesse	Old Testament people, Ancient Israeli people
Industrial Workers of the World	Industrial Workers of the World, Chicago, Illinois, 1905 establishments in the United States, 1900s establishments in Illinois
John Donne	1572 births, 1631 deaths, English Anglicans, English poets
Flat feet	Feet, Developmental disorders
Metaphysical poets	Poetry
Carrie (2013 movie)	2013 horror movies, 2010s supernatural movies, 2010s teen movies, American movie remakes, American supernatural movies, American teen horror movies, Carrie, English-language movies, High school movies, Movies about bullying, Movies about murderers, Movies about revenge, Movies set in Maine, Proms in movies, Supernatural horror movies, Telekinesis in movies
Gustavo Ayon	Living people, 1985 births, Orlando Magic players, Mexican sportspeople
Zach Zarba	Living people, 1975 births, Sportspeople from New York City, National Basketball Association, Referees
Ben Hansbrough	Living people, 1987 births, Indiana Pacers players, Sportspeople from Missouri
Thomas Cranmer	1489 births, 1556 deaths, Academics of the University of Cambridge, Alumni of the University of Cambridge, Anglican archbishops, Anglican priests, Archbishops of Canterbury, Christian theologians, English Anglicans, English priests, English Roman Catholics, English theologians, Executed English people, Former Roman Catholics, People excommunicated by the Catholic Church, People executed by burning, People from Nottinghamshire, Protestant Reformers, Roman Catholic archbishops
Kim Hughes	1979 births, Living people, George Cross holders, British military people
Matsumoto Yamaga FC	Japanese football clubs, Nagano Prefecture
Christopher Finney	1984 births, Living people, British military people, George Cross holders, People from Brussels, People from Dorset, People from Greater Manchester
Ronnie Lott	1959 births, Living people, American football cornerbacks, American football safeties, New York Jets players, Sportspeople from Albuquerque, New Mexico, San Francisco 49ers players, Sportspeople from Los Angeles, California
Jesus College, Cambridge	Colleges of the University of Cambridge, 1496 establishments, 15th century establishments in England
Lucy Cavendish College, Cambridge	Colleges of the University of Cambridge, 1956 establishments in Europe, 1950s establishments in England
Magdalene College, Cambridge	Colleges of the University of Cambridge, 1428 establishments, 1420s establishments in Europe, 15th century establishments in England
Get Up Stand Up	Reggae songs, 1973 songs
List of Matsumoto Yamaga FC players	Lists of Japanese football players
Matsumoto, Nagano	Cities in Japan, Settlements in Nagano Prefecture
Kwangmyŏngsŏng-3 Unit 2	Satellites, North Korea, 2012 establishments in Asia, Establishments in North Korea
Derek Kinne	1930 births, Living people, George Cross holders, British military people
Tohoku Rakuten Golden Eagles	Baseball teams, Baseball in Japan, Miyagi Prefecture, Sendai, Miyagi
John DeLorean	1925 births, 2005 deaths, American chief executives, Engineers from Michigan, American Evangelicals, American military personnel of World War II, Businesspeople from Detroit, Michigan, Deaths from stroke
Corey Haim	1971 births, 2010 deaths, Actors from Toronto, Canadian movie actors, Canadian movie directors, Canadian movie producers, Canadian television actors, Canadian television directors, Canadian television producers, Canadian voice actors, Deaths from pneumonia, Infectious disease deaths in California
Liberal Democratic Party (Japan)	Political parties in Japan, Conservative parties
Women of World War I	Women, World War I
Tennessee Williams	1911 births, 1983 deaths, American LGBT people, American playwrights, Drug-related accidental deaths in the United States, Gay men, LGBT writers, Writers from Mississippi
The Creation (Haydn)	Oratorios, Compositions by Joseph Haydn
Killing Them Softly	2012 crime movies, 2012 thriller movies, 2010s crime thriller movies, American crime thriller movies, English-language movies, Movies about murderers, Movies based on books, Movies set in the 2000s, Movies directed by Andrew Dominik
Blainville-Boisbriand Armada	2011 establishments in Canada, Canadian Hockey League teams, Ice hockey teams in Quebec, Quebec Major Junior Hockey League
Drummondville Voltigeurs	1982 establishments in Canada, Canadian Hockey League teams, Ice hockey teams in Quebec, Quebec Major Junior Hockey League
Gatineau Olympiques	1969 establishments in Canada, Canadian Hockey League teams, Ice hockey teams in Quebec, Quebec Major Junior Hockey League
Rouyn-Noranda Huskies	1933 establishments, 1954 establishments in Canada, 1975 establishments in North America, Canadian Hockey League teams, Ice hockey teams in Quebec, Quebec Major Junior Hockey League, 1930s establishments in Canada, 1970s establishments in Canada
Sherbrooke Phoenix	Canadian Hockey League teams, Ice hockey teams in Quebec, Quebec Major Junior Hockey League, 2012 establishments in Canada
Val-d'Or Foreurs	1993 establishments in Canada, Canadian Hockey League teams, Ice hockey teams in Quebec, Quebec Major Junior Hockey League
Baie-Comeau Drakkar	1997 establishments in Canada, Canadian Hockey League teams, Ice hockey teams in Quebec, Quebec Major Junior Hockey League
Big E Langston	1986 births, Living people, African American players of American football, African-American wrestlers, American professional wrestlers, Sportspeople from Tampa, Florida, WWE wrestlers
Chicoutimi Saguenéens	1973 establishments in Canada, Canadian Hockey League teams, Ice hockey teams in Quebec, Quebec Major Junior Hockey League
Khowar Language Movement	1996 establishments in Asia, Languages of Khyber Pakhtunkhwa, Political organizations based in Asia
Quebec Remparts	1969 establishments in Canada, 1997 establishments in Canada, Canadian Hockey League teams, Ice hockey teams in Quebec, Quebec Major Junior Hockey League, Sport in Quebec City, 1996 disestablishments in North America
The Egyptian Theatre (Boise, Idaho)	Theatres in the United States, Buildings and structures in Idaho, Boise, Idaho, 1927 establishments in the United States, 20th-century establishments in Idaho
John E. Tourtellotte	1869 births, 1939 deaths, Businesspeople from Connecticut, American architects, Businesspeople from Idaho
Ada Odd Fellows Temple	Buildings and structures in Idaho, Boise, Idaho, 1903 establishments in the United States, 1900s establishments in Idaho
Elks Temple (Boise, Idaho)	Buildings and structures in Idaho, Boise, Idaho, 1914 establishments in the United States, 1910s establishments in Idaho
Murray Edwards College, Cambridge	Colleges of the University of Cambridge, 1954 establishments in Europe, 1950s establishments in England
Marabou stork	Ciconiiformes
Juliet Mills	1941 births, Living people, Actors from London, Emmy Award winners, English child actors, English movie actors, English stage actors, English television actors
Hayley Mills	1946 births, Living people, Actors from London, BAFTA Award winning actors, English child actors, English movie actors, English television actors, Golden Globe Award winning actors
Road signs in South Africa	Traffic, Transport in South Africa
Çayırköprü, Aydıntepe	Settlements in Turkey, Villages in Asia
Helen Smith (writer)	1968 births, English novelists, Living people
1996 All-Ireland Senior Camogie Championship Final	Sport in Dublin, 1996 in sports, 1996 in the United Kingdom, 1990s in Northern Ireland, 20th century in Dublin, September events
Wasylów Wielki	Villages in Poland
Metamya	Arctiidae
Arctiidae	Arctiidae
Cinnabar moth	Arctiidae
Antanas Sutkus	1939 births, Living people
Lithuanian National Prize	1989 establishments in Europe, Awards, Lithuanian culture
XSP (software)	Software
Constitutionalism	Constitutions
Lovely Mary	1916 movies, 1910s drama movies, American silent movies, American drama movies
Russell Simpson (actor)	1880 births, 1959 deaths, American movie actors, American stage actors, Actors from San Francisco
Bat'leth	Star Trek, Fictional weapons
Great-billed heron	Birds of Australia, Pelecaniformes
Little egret	Birds of Africa, Birds of Asia, Birds of Europe, Ciconiiformes, National symbols of Bangladesh
Chuck Jones	1912 births, 2002 deaths, Deaths from heart failure, American animators, American screenwriters, American television directors, American television producers, Academy Award winning directors, People from Spokane, Washington, People from Los Angeles, California
Dick Cavett	1936 births, Living people, American movie actors, American television actors, American stage actors, American voice actors, American radio actors, American television personalities, American radio personalities, American stand-up comedians, American television talk show hosts, American television presenters, American game show hosts, Actors from Nebraska, Actors from New York City, Writers from Nebraska, Writers from New York City, Emmy Award winning actors, Comedians from Nebraska, Comedians from New York City
Charles Cannon	1905 births, 1976 deaths, People from Quebec City, Politicians from Quebec
Sylvestre Ntibantunganya	1956 births, Living people, Presidents of Burundi
Antoine Nduwayo	Living people, 1942 births
Gęsianka	Villages in Poland
Crocmaz	Moldova
James King	Living people, 1990 births
Plympton Hundred	Devon
Brixton, Devon	Villages in Devon
KWUT	Radio stations in the United States, 1998 establishments in the United States, 20th-century establishments in Utah
Slogan	Phrases
Badbaado (refugee camp)	Somalia
Dúnchad mac Fiachnai	640s deaths
Sales tax	Government, Taxation
Thomas Kendrick (Medal of Honor)	1839 births, Year of death unknown, People from Maine, Military personnel of the American Civil War, United States Navy Medal of Honor recipients
Samuel W. Kinnaird	1840 births, 1923 deaths, Military personnel of the American Civil War, United States Navy Medal of Honor recipients
Lisa Hartman Black	Actors from Texas, American singers, 1956 births, Living people
Parveen Talukder	Bangladeshi politicians, Bangladeshi Muslims, 1958 births, Living people
Barge	Boats
Newnham College, Cambridge	Colleges of the University of Cambridge, 1871 establishments in the United Kingdom
Humayun	Mughal emperors, 1508 births, 1556 deaths
Andrew Jones (Medal of Honor)	1835 births, Year of death unknown, United States Navy Medal of Honor recipients, People from New York City, Military personnel of the American Civil War, People from Limerick
James Seanor	1833 births, Year of death unknown, People from Massachusetts, Military personnel of the American Civil War, United States Navy Medal of Honor recipients
Gannett Government Media	Publishing companies of the United States
Kutub al-Sittah	Islam, Religious texts
Quranism	Islamic denominations
George Taylor (Medal of Honor)	1830 births, 1893 deaths, People from New York, Military personnel of the American Civil War, United States Navy Medal of Honor recipients
Ferdinand Lemaire	Librettists
Pauline Viardot	French opera singers, 1821 births, 1910 deaths, French singers
Seoul Guarantee Insurance Company	Insurance companies, Companies of South Korea
Blind Love (2006 movie)	2006 movies, American independent movies
Special cities of Japan	Cities in Japan
Rockfish, Virginia	Unincorporated communities in Virginia
Lowesville, Virginia	Unincorporated communities in Virginia
Virginia Blue Ridge Railway	Transport in Virginia, Rail transport in the United States
Roses Mill, Virginia	Unincorporated communities in Virginia
Adial, Virginia	Unincorporated communities in Virginia
Rimouski Océanic	1995 establishments in Canada, Canadian Hockey League teams, Ice hockey teams in Quebec, Quebec Major Junior Hockey League
Connie McHugh	1938 births, 1997 deaths
Shawinigan Cataractes	1969 establishments in Canada, Canadian Hockey League teams, Ice hockey teams in Quebec, Quebec Major Junior Hockey League
Victoriaville Tigres	1982 establishments in Canada, Canadian Hockey League teams, Ice hockey teams in Quebec, Quebec Major Junior Hockey League
Chemical weapons in World War I	World War I, Chemical warfare
Jet Set Radio Future	2002 video games, Platform games, Xbox games
Dreadnought	Warships
Chromo, Colorado	Unincorporated communities in Colorado
Swahili coast	Geography of Kenya, Geography of Tanzania, Geography of Mozambique
Robert Bork	1927 births, 2012 deaths, United States Attorneys General, United States Solicitors General, American judges, American lawyers, Cardiovascular disease deaths in the United States, American educators, Politicians from Pennsylvania, US Republican Party politicians, Writers from Pennsylvania
Alphonso Taft	1810 births, 1891 deaths, American judges, American lawyers, Cardiovascular disease deaths in the United States, Deaths from heart failure, Politicians from Cincinnati, Ohio, William Howard Taft, Politicians from Vermont, US Republican Party politicians, United States Attorneys General
Bacolet	Towns in North America, Settlements in Trinidad and Tobago
Dwight Yorke Stadium	Trinidad and Tobago
United States Ambassador to the United Nations	United States Ambassadors to the United Nations
Ben Herring	1980 births, Living people, New Zealand rugby union players, Sportspeople from Auckland
Barłogi, Lubusz Voivodeship	Villages in Poland
Gmina Bobrowice	Poland
Czeklin	Villages in Poland
Piegłowo-Wieś	Villages in Poland
Saint Pauls Mountain	Mountains of Antarctica
Gabrielle	Given names
Cities of Japan	Cities in Japan
Stephanie	Given names
Kwon Young-ghil	1941 births, South Korean journalists, Human rights, South Korean politicians, Autobiographers, Korean activists, Living people
The Mentality of Apes	Biology books, 1925 books
Jessica	Given names
Laurens Hammond	1895 births, 1973 deaths
Eureka effect	Cognition, Problem solving
David Sarnoff	1891 births, Businesspeople from New York City, 1971 deaths
Insight	Cognition, Problem solving, Words
Lockheed Martin	Companies of the United States, Bethesda, Maryland, Lockheed & Lockheed-Martin aircraft
C. Srinivasa Iyengar	Indian politicians, Living people, Year of birth missing, People from Tamil Nadu
K. Ugrapandian	1945 births, living people, Tamil people, Tamil Nadu politicians
Ron Gourlay	Football in England, Living people, Year of birth missing (living people)
Balranald, New South Wales	Towns in New South Wales
United States fiscal cliff	Economy of the United States, 2012 in the United States
Leaf spring	Engineering
Camp Funston	Military, World War I
U-boat	Warships, World War I, World War II, Military of Germany
Kampos, Karditsa	Settlements in Greece, 2011 disestablishments in Europe
Mordellistena degressa	Polyphaga
Mordellistena	Polyphaga
Holism	Philosophical movements and positions
The Lone Ranger (TV series)	1940s in entertainment, 1950s television series, Western television series, American drama television series, ABC network shows, Children's television series, Black and white television series, English-language television programs
Pembroke College, Cambridge	Colleges of the University of Cambridge, 1347 establishments, 1340s establishments in England
William Dean Howells	1837 births, 1920 deaths, 19th-century American novelists, Writers from Massachusetts
Doughboy	United States Army, World War I
Colourful Radio	Radio stations in the United Kingdom, 2009 establishments in England
Cootie	Games
Play-Doh	Toys
Onslow, Nova Scotia	Settlements in Nova Scotia
Sylvie Testud	1971 births, Living people, French actors, People from Lyon
Mugur Sundar	Indian movie directors, Indian movie actors, Living people, 1938 births
Douglas Jackman	1902 births, 1991 deaths
Kurt Koffka	1886 births, 1941 deaths, Jewish German academics, Jewish German scientists, German psychologists, Scientists from Berlin
Diassodou	Settlements in Guinea, Towns in Africa
1918 Standard Time Act	1918, 1910s in the United States, United States federal legislation, 20th century in law
Cable TV Privacy Act	1984 in the United States, United States federal legislation
Lewis F. Powell Jr.	1907 births, 1998 deaths, Deaths from pneumonia, American judges, American lawyers, United States Supreme Court justices, US Democratic Party politicians, Politicians from Virginia
East Pakistan Rifles	History of Bangladesh
Harry Blackmun	1908 births, 1999 deaths, Deaths from natural causes, American lawyers, American judges, United States Supreme Court justices, US Republican Party politicians, Politicians from Illinois, Writers from Illinois, Politicians from Minnesota, Writers from Minnesota, Burials at Arlington National Cemetery
National Socialist Council of Nagaland	Separatist movements of India, Myanmar, Nationalist organizations in India, Christian organizations, Nagaland, Rebel militia groups in Asia, Christian terrorism
Havaily District	Districts of Pakistan
Hattian Bala District	Districts of Pakistan
Anointing of the Sick	Roman Catholicism, Sacraments
People's Revolutionary Party of Kangleipak	Separatist movements of India, Nationalist organizations in India, Manipur, 1977 establishments in Asia, Rebel militia groups in Asia, 1970s establishments in India
Stranded Pakistanis	History of Pakistan, Bangladesh
Olga Yakovleva (basketball, born 1963)	1963 births, Living people, Basketball players, Medalists at the 1988 Summer Olympics, Olympic bronze medalists, People from Saint Petersburg, Russian sportspeople, Soviet Olympic medalists
Michael Cassidy	1837 births, 1908 deaths, People from New York, Military personnel of the American Civil War, United States Navy Medal of Honor recipients
Hampton National Cemetery	Cemeteries in the United States, Hampton, Virginia, 1862 establishments in the United States, 19th-century establishments in Virginia
Alison Lohman	Actors from Riverside County, California, 1979 births, Living people, People from Palm Springs, California
Haapanen	Surnames
Hec Lalande	1977 births, 2010 deaths, Canadian ice hockey centres, Chicago Blackhawks players, Detroit Red Wings players, Ice hockey people from Ontario, American Hockey League players, Ontario Hockey League players, Eastern Hockey League players
Erkkilä	Surnames
Mike Hudson	1967 births, Canadian ice hockey centres, Chicago Blackhawks players, Edmonton Oilers players, Ice hockey people from Ontario, Living people, New York Rangers players, Phoenix Coyotes players, Pittsburgh Penguins players, St. Louis Blues players, Toronto Maple Leafs players, Stanley Cup champions, People from Guelph, International Hockey League (1945–2001) players, Ontario Hockey League players
Divisions of the Australian House of Representatives	Politics of Australia
Kansallis-Osake-Pankki	Banks, Companies of Finland, 1889 establishments in Europe, 19th century establishments in Finland, 1995 disestablishments in Europe
Taco John's International	American fast food restaurants, Cheyenne, Wyoming, 1969 establishments in the United States, 20th-century establishments in Wyoming
Mytilus (genus)	Bivalves
Mytilus coruscus	Bivalves
Embryophyte	Botany
Chanterelle	Edible fungi
Rubber band	Tools
Chinese scholar's rocks	Chinese culture
Common kingfisher	Birds of Europe, Birds of Asia, Coraciiformes
Wattieza	Plant taxonomy, Fossils, Trees
Susan	Given names
Suiseki	Japanese culture, Rocks
Prudential Tower	Buildings and structures in Boston, Massachusetts, Skyscrapers in the United States, 1964 establishments in the United States, 1960s establishments in Massachusetts
Suseok	Korean culture
Division of Werriwa	Electoral divisions of Australia, New South Wales, 1901 establishments in Australia
Zadar	Cities in Croatia
Cyclic vomiting syndrome	Migraine, Syndromes
East Bengal Regiment	Bangladesh, Military
People's Liberation Army of Manipur	Manipur, Separatist movements of India, 1978 establishments in Asia, Rebel militia groups in Asia, Nationalist organizations in India, 1970s establishments in India
Naga National Council	Separatist movements of India, Nationalist organizations in India, Nagaland
Naga people	Separatist movements of India, Indian people
Garo people	Ethnic groups in Bangladesh, Indian people, Meghalaya
Khasi people	Ethnic groups in Bangladesh, Indian people
Erin Burnett	Writers from Maryland, American television news anchors, American journalists, 1976 births, Living people
List of American Civil War Medal of Honor recipients	Lists of Medal of Honor recipients, Lists of the American Civil War
List of political parties in Australia	Political parties in Australia, Lists of political parties
Lev Vygotsky	Psychologists, Russian scientists
List of Australian Leaders of the Opposition	Leaders of the Opposition (Australia), Lists of politicians, Australia-related lists
List of Medal of Honor recipients for the Second Battle of Fort Fisher	Lists of Medal of Honor recipients, Lists of the American Civil War
List of Medal of Honor recipients for the Battle of Opequon	Lists of Medal of Honor recipients, Lists of the American Civil War
List of Medal of Honor recipients for the Battle of Cedar Creek	Lists of Medal of Honor recipients, Lists of the American Civil War
List of Medal of Honor recipients for World War I	Lists of Medal of Honor recipients
Karl Duncker	1903 births, 1940 deaths, German psychologists, People who committed suicide
Dianthus armeria	Caryophyllaceae
Gorkha National Liberation Front	Politics of India, 1980 establishments in Asia, 1980s establishments in India
Ted Demme	1963 births, 2002 deaths, Accidental deaths in California, American television directors, American television producers, Drug-related accidental deaths in the United States, Movie directors from New York City, Movie producers from New York City
Tie-dye	Cloth, Textile arts
Dhol	Pakistani culture, Drums
List of Medal of Honor recipients for World War II	Lists of Medal of Honor recipients
Hairspray (1988 movie)	1988 comedy movies, 1980s musical movies, 1980s teen comedy movies, American musical movies, American teen comedy movies, English-language movies, Movies set in Baltimore, Maryland, Movies set in the 1960s, American independent movies
Linderte	Villages in Lower Saxony
Ronnenberg	Towns in Lower Saxony
Alicia Witt	Actors from Massachusetts, American television actors, 1975 births, Living people, People from Worcester, Massachusetts
List of Medal of Honor recipients for the Battle of Iwo Jima	Lists of Medal of Honor recipients
List of Medal of Honor recipients for the Indian Wars	Lists of Medal of Honor recipients
List of Medal of Honor recipients for the Spanish–American War	Lists of Medal of Honor recipients
List of Philippine–American War Medal of Honor recipients	Lists of Medal of Honor recipients
List of national parks in Albania	Lists of national parks, National parks in Europe, Albania-related lists
List of national parks of Argentina	Lists of national parks, Argentina, National parks in South America, South America-related lists
National parks of Austria	Lists of national parks, National parks in Europe
National parks of Azerbaijan	Lists of national parks, Azerbaijan, National parks in Europe, National parks in Asia, Azerbaijan-related lists
Mid-range speaker	Audio technology
Marlo Thomas	Actors from Detroit, Michigan, 1937 births, Living people
Yellow Mama	Capital punishment in the United States, History of Alabama, 1927 establishments in the United States, 20th-century establishments in Alabama, 2002 disestablishments in the United States
List of Medal of Honor recipients (Veracruz)	Lists of Medal of Honor recipients, People from Veracruz
Yukio Okutsu	1921 births, 2003 deaths, Military people from Hawaii, United States Army Medal of Honor recipients, American people of World War II
George McCall Courts	1888 births, 1932 deaths, United States Navy Medal of Honor recipients
List of Medal of Honor recipients for the Boxer Rebellion	Lists of Medal of Honor recipients
Jimmy Savile	1926 births, 2011 deaths, BBC radio presenters, BBC television presenters, British cyclists, British DJs, British rapists, British sex offenders, Child sexual abusers, English professional wrestlers, English Roman Catholics, Members of the Order of the British Empire, People from Leeds, Television personalities from Yorkshire
Personal Best	1982 drama movies, 1980s LGBT movies, 1980s sports movies, American drama movies, American LGBT movies, American sports movies, English-language movies, LGBT drama movies, Sports drama movies
List of Korean War Medal of Honor recipients	Lists of Medal of Honor recipients, Korean War
Against All Odds	1980s thriller movies, 1984 drama movies, American drama thriller movies, English-language movies
Zechariah	Ancient Israeli people, New Testament people
Pennsylvania Turnpike	Roads in Pennsylvania
Free Trade Party	1889 establishments in Australia, 1909 disestablishments, Commonwealth Liberal Party, Political parties in Australia, 1900s disestablishments in Australia
Dubai International Airport	Airports in Asia, Buildings and structures in Dubai
List of living Medal of Honor recipients	Lists of Medal of Honor recipients
Zero Dark Thirty	2012 drama movies, 2012 thriller movies, 2010s drama thriller movies, American drama thriller movies, English-language movies, Movies about death, Movies about terrorism, Movies set in Asia, Pakistan, Movies based on the September 11 attacks
Wayne Hillman	1938 births, 1990 deaths, Canadian ice hockey defencemen, Chicago Blackhawks players, Deaths from cancer, Ice hockey people from Ontario, Minnesota North Stars players, New York Rangers players, Philadelphia Flyers players, American Hockey League players, World Hockey Association players
List of foreign-born Medal of Honor recipients	Lists of Medal of Honor recipients
List of Native American Medal of Honor recipients	Lists of Medal of Honor recipients, Native American people
Protectionist Party	Political parties in Australia, Commonwealth Liberal Party, 1889 establishments in Australia, 1909 disestablishments, 1900s disestablishments in Australia
Fallingwater	Buildings and structures in Pennsylvania, Houses in the United States, Architecture, Frank Lloyd Wright buildings
Laurie	Given names, Surnames
Commonwealth Liberal Party	Commonwealth Liberal Party, 1909 establishments, 1917 disestablishments, 1900s establishments in Australia, 1900s disestablishments in Australia
Australian Electoral Commission	Government agencies of Australia, Canberra, Elections, 1984 establishments in Australia
National Labor Party	Political parties in Australia, 1916 establishments, 1910s establishments in Australia, 1917 disestablishments, 20th century disestablishments in Australia
Fracking	Engineering, Fuel, Rocks, Environmental issues
Deana Carter	American country musicians, 1966 births, Living people, Musicians from Nashville, Tennessee, Singers from Nashville, Tennessee
Gabriele d'Annunzio	Italian writers, Italian poets, Italian playwrights, 1863 births, 1938 deaths
Kathy Mattea	Musicians from West Virginia, American country musicians, 1959 births, Living people
Hiroshi Miyamura	1925 births, Living people, People from Gallup, New Mexico, United States Army Medal of Honor recipients
Yorba Linda, California	Yorba Linda, California, 1967 establishments in California
Sanaa Lathan	Actors from New York City, American movie actors, American television actors, American voice actors, 1971 births, Living people
Yoshihiko Noda	Prime Ministers of Japan, 1957 births, Living people, People from Chiba Prefecture
Holy Innocents' Day	Christian holidays, December events, 480s establishments
The Twelve Days of Christmas	Christmas
Natalia Cigliuti	Actors from New York, 1978 births, Living people
Get Scraped	2005 albums, Deadmau5 albums
Vexillology (album)	2006 albums, Deadmau5 albums
Random Album Title	2008 albums, Deadmau5 albums
For Lack of a Better Name	2008 albums, Deadmau5 albums
4×4=12	2010 albums, Deadmau5 albums
Margaret Mitchell	1900 births, 1949 deaths, American manslaughter victims, American novelists, Road accident deaths in the United States, Writers from Atlanta, Georgia
Album Title Goes Here	2012 albums, Deadmau5 albums
Thermal resistance	Physics
Gosei (fifth-generation Nikkei)	Japanese culture
Professional Griefers	2012 songs, deadmau5 songs
Jena Malone	Actors from Nevada, Living people, 1984 births
The Veldt (song)	2012 songs, Deadmau5 songs
Maths (song)	2012 songs, deadmau5 songs
Raise Your Weapon	2010 songs, deadmau5 songs
Sakuteiki	Gardening, Japanese culture
Calama	Cities in Chile
Batman (1989 movie)	1989 movies, Batman (1989 movie series), Batman movies, Movies based on comic book characters, Movies composed by Danny Elfman, Movies directed by Tim Burton
Shelley Fabares	Actors from Santa Monica, California, 1944 births, Living people, American pop singers, Democrats (United States), Singers from California, American movie actors, American television actors
Gosei (questions)	Japanese culture
Gosei (competition)	Japanese culture
Above the Rim	1994 crime movies, 1994 drama movies, 1990s crime drama movies, 1990s sports movies, American crime drama movies, American sports movies, English-language movies, Movies set in New York City, Sports drama movies
Silver Linings Playbook	2012 drama movies, 2012 romance movies, 2010s romantic drama movies, American romantic drama movies, Bipolar disorder in fiction, English-language movies, Movies based on books, Movies set in Pennsylvania, Movies set in the 2000s, Movies directed by David O. Russell
Insurgency in North-east India	Separatist movements of India, Northeast India, Insurgencies, Rebellions in Asia
Dalitstan.org	Nationalist organizations in India, Separatist movements of India
Loie Fuller	Actors from Illinois, American dancers, Burials at Père Lachaise Cemetery, Deaths from pneumonia, 1862 births, 1928 deaths, Vaudeville performers
Frank Ono	1923 births, 1980 deaths, People from Indiana, United States Army Medal of Honor recipients, American people of World War II
British Broadcasting Company	Companies of the United Kingdom, 1922 establishments in the United Kingdom, 1926 disestablishments
Dabney Coleman	Actors from Texas, 1932 births, Living people
ARM architecture	Computer processors
Windows Phone	Microsoft operating systems
Nationalist Party of Australia	Political parties in Australia, 1917 establishments, 1910s establishments in Australia, 1930s disestablishments in Australia
Jonathan Meath	1955 births, Living people, American television producers, American television actors, Actors from Baltimore, Maryland, Actors from Boston, Massachusetts, Actors from New Hampshire, Peabody Award winners
Sherani District	Districts of Balochistan (Pakistan)
Don Francisco	1940 births, Living people, Chilean television presenters, Jewish entertainers, People from Talca, South American Jews, Television personalities, Television producers
Marathon Man	1976 crime movies, 1970s thriller movies, American crime thriller movies, English-language movies, French-language movies, German-language movies, Movies about murderers, Movies about siblings, Movies based on books, Movies set in New York City, Works about brothers, Movies directed by John Schlesinger, Movies about dentistry
Marthe Keller	1945 births, Living people, Swiss movie actors, Swiss stage actors, Swiss television actors, People from Basel
Luke Perry	Actors from Ohio, American movie actors, American television actors, American voice actors, 1966 births, 2019 deaths, Deaths from stroke, Cardiovascular disease deaths in California
The Dark Knight Trilogy	Movies directed by Christopher Nolan, Batman movies, Series of movies, Movies based on comic book characters, The Dark Knight Trilogy, Warner Bros. movies
Bitter orange	Medicinal plants, Citrus
Derek Hough	1985 births, Actors from Salt Lake City, Utah, Living people, singers from Utah, Musicians from Utah, American movie actors
Colleen Camp	Actors from San Francisco, 1953 births, Living people
Jessica Bowman	Actors from Contra Costa County, California, 1980 births, Living people
GoldenEye	1995 action movies, 1995 thriller movies, 1990s action thriller movies, 1990s crime thriller movies, 1990s spy movies, English-language movies, James Bond movies, Movies set in Russia, Movies set in North America, Movies about terrorism
Ursula Andress	1936 births, Living people, Actresses who played Bond girls, Swiss movie actors, Swiss television actors
Australian Labor Party (NSW)	Political parties in Australia, 1931 establishments, 1930s establishments in Australia, 1930s disestablishments in Australia
Division of Newcastle	Electoral divisions of Australia, New South Wales, 1901 establishments in Australia
Alisan Porter	American movie actors, 1981 births, Living people, People from Worcester, Massachusetts
Charles the Younger	Kings and queens, 772 births, 811 deaths, Frankish rulers, Carolingian dynasty
Django Unchained	2012 drama movies, 2010s western movies, American drama movies, American western movies, English-language movies, Movies directed by Quentin Tarantino, Movies composed by Ennio Morricone, Movies set in Mississippi, Movies featuring a Best Supporting Actor Academy Award-winning performance
Kate Maberly	English actors, 1982 births, Living people
Kazuo Otani	1918 births, 1944 deaths, Military people from California, United States Army Medal of Honor recipients, American people of World War II
List of Asian American Medal of Honor recipients	Lists of Medal of Honor recipients
Richie Dunn	1957 births, Buffalo Sabres players, Calgary Flames players, Hartford Whalers players, Living people, Sportspeople from Boston, Massachusetts, American Hockey League players, Ontario Hockey League players, Ice hockey defencemen
Gabriel Abraham	1991 births, Living people, Romanian footballers
Ali MacGraw	1939 births, Living people, Actors from New York, American movie actors, Golden Globe Award winning actors
Richard Rodney Bennett	1936 births, 2012 deaths, 20th century composers, 21st century composers, Commanders of the Order of the British Empire, English composers, Knights Bachelor, Musicians from Kent
Division of Shortland	Electoral divisions of Australia, New South Wales, 1949 establishments in Australia
Eva LaRue	American television actors, 1966 births, Living people
Japanese spider crab	Crabs, Animals of Japan, Living fossils
John Shortland	1769 births, 1810 deaths, Exploration of Australia, Royal Navy officers
Karla Bonoff	Singers from Los Angeles, California, 1951 births, Living people, Singer-songwriters from California
Cockfight	Sports involving animals, Crime, Violence in sports
Peterhouse, Cambridge	Colleges of the University of Cambridge, 1284 establishments, 13th century establishments in England
Oleta Adams	American singers, 1953 births, Living people
Robinson College, Cambridge	Colleges of the University of Cambridge, 1977 establishments in the United Kingdom
Vaginal flatulence	Female reproductive system
The Vanishing (1993 movie)	1993 thriller movies, 1993 drama movies, English-language movies, Movies directed by George Sluizer, 20th Century Fox movies
Barry Tuckwell	Officers of the Order of the British Empire, Classical horn players, 1931 births, 2020 deaths, Cardiovascular disease deaths in Australia
Shopian	Tehsils of Jammu and Kashmir
Marvel Cinematic Universe	Marvel Comics, Fictional universes, Series of movies, Marvel Cinematic Universe movies
George Sakato	1921 births, 2015 deaths, Military people from California, United States Army Medal of Honor recipients, American people of World War II
Melly Oitzl	Neuroscientists, 1955 births, Austrian scientists, Living people, Pharmacologists
Chronicle	History
Elle Fanning	1998 births, Living people, Actors from Georgia (U.S. state), American Baptists, American child actors, American movie actors, American television actors
Imelda Staunton	1956 births, Living people, Actors from London, Alumni of the Royal Academy of Dramatic Art, English movie actors, English radio actors, English television actors, English voice actors
Kathleen Quinlan	American movie actors, Actors from Pasadena, California, 1954 births, Living people, American television actors
Wim Crusio	1954 births, Living people, Dutch scientists, Geneticists, Neuroscientists, People from North Brabant
Fragmentation (computer)	Computing
2013 Formula One World Championship	Formula One seasons, 2013 in sports
Anonymus Valesianus	Manuscripts
Patti LuPone	Actors from New York, American stage actors, 1949 births, Living people, American television actors, American movie actors, Tony Award winning actors
Bermuda triangle	Atlantic Ocean
Fontella Bass	African American musicians, American R&B musicians, American pop musicians, American singers, American soul musicians, Cardiovascular disease deaths in the United States, Deaths from myocardial infarction, Disease-related deaths in Missouri, Singers from St. Louis, Missouri, 1940 births, 2012 deaths, American soul singers
Harry Carey Jr.	1921 births, 2012 deaths, Deaths from natural causes, American movie actors, American television actors, American stage actors, American voice actors, American radio actors, Actors from Los Angeles County, California
Larry Holden	1961 births, 2011 deaths, Cancer deaths in Massachusetts, American movie actors, American television actors, American movie producers, American screenwriters, Actors from Massachusetts, Writers from Massachusetts
Shimonoseki, Yamaguchi	Cities in Japan, Settlements in Yamaguchi Prefecture
Majoidea	Crabs
ValuJet Flight 592	1996 in the United States, 1990s in Florida, Aviation disasters in the 1990s, Aviation disasters in the United States
Cliff Osmond	1937 births, 2012 deaths, Actors from New Jersey, American movie actors, American movie directors, American movie producers, American radio actors, American radio personalities, American screenwriters, American stage actors, American television actors, American television directors, American television personalities, American television producers, American voice actors, Deaths from pancreatic cancer, Jewish American actors, Writers from New Jersey, People from Jersey City, New Jersey, People from Union City, New Jersey
Great Dividing Range	Mountain ranges of Australia, Geography of New South Wales, Geography of Victoria, Australia, Geography of Queensland
Photochemistry	Chemistry
Hastings-on-Hudson, New York	Villages in New York
Gameshow Marathon	2000s American television series, CBS network shows, Television game shows, English-language television programs
J. R. Martinez	1983 births, American television actors, Living people, Actors from Louisiana, People from Shreveport, Louisiana, People from Hope, Arkansas
Batman Forever	1994 action movies, 1994 crime movies, 1990s superhero movies, Batman (1989 movie series), Batman movies, English-language movies, Movies based on comic book characters, Movies directed by Joel Schumacher, Screenplays by Akiva Goldsman, Sequel movies
Henri Valois	1606 births, 1676 deaths, French scientists, Translators
Verdun	Cities in France, Communes in Meuse, Subprefectures in France
Paula Patton	Actors from Los Angeles, California, American movie actors, 1975 births, Living people, American television actors
Carl Stumpf	1848 births, 1936 deaths, German philosophers, German psychologists, Musicologists
Michael Learned	American television actors, 1939 births, Living people, American movie actors, American stage actors, Actors from Washington, D.C.
James Okubo	1920 births, 1967 deaths, People from Washington, United States Army Medal of Honor recipients, American people of World War II
Automotive industry	Automobiles, Industries
Tiffany Cross Medal of Honor	Orders, decorations, and medals of the United States, 1919 establishments in the United States, 1942 disestablishments in the United States
Naval History & Heritage Command	United States Navy, History of the United States, Washington, D.C.
Opel Signum	Opel automobiles, Front wheel drive vehicles, 2000s automobiles
Opel Omega	Opel automobiles, 1980s automobiles, 1990s automobiles, 2000s automobiles
Bob Balaban	1945 births, Living people, American movie actors, American television actors, American stage actors, American voice actors, American movie directors, American movie producers, Jewish American actors, Actors from Chicago, Writers from Chicago, Movie directors from Chicago, Movie producers from Chicago
Sofi Needs a Ladder	2010 songs, deadmau5 songs
Animal Rights (song)	2010 songs, deadmau5 songs
Some Chords	2010 songs, deadmau5 songs
Strobe (song)	2010 songs, deadmau5 songs
Ghosts 'n' Stuff	2008 songs, deadmau5 songs
I Remember	2008 songs, deadmau5 songs
Bandipora Tehsil	Tehsils of Jammu and Kashmir
Proserpina	Roman gods and goddesses
Ordinary People	1980 drama movies, American drama movies, Movies based on books, Movies directed by Robert Redford, English-language movies
List of Hispanic Medal of Honor recipients	Lists of Medal of Honor recipients
List of Irish American Medal of Honor recipients	Lists of Medal of Honor recipients
David Denby	1943 births, Living people, American movie critics, American journalists, American historians, Writers from New York City
Serius Jones	1982 births, Living people, Musicians from New Jersey
Anthony Lane	1962 births, Living people, British journalists, American movie critics, Writers from London
Theresa Randle	American movie actors, Actors from Los Angeles, California, 1964 births, Living people
Barbara Bel Geddes	1922 births, 2005 deaths, Actors from New York, American movie actors, American stage actors, American television actors, Breast cancer survivors, Cancer deaths in the United States, Deaths from lung cancer
Alpine skiing	Skiing, Winter Olympic sports
Sharon Gless	1943 births, Living people, Actors from Los Angeles, California, American movie actors, American television actors, Emmy Award winning actors, Golden Globe Award winning actors
Hans Ferdinand Linskens	German botanists, 1921 births, 2007 deaths
Old Tom Morris	1821 births, 1908 deaths, Scottish sportspeople, British golfers, People from Fife
Rosemary Harris	English movie actors, 1927 births, Living people, English stage actors
List of Jewish Medal of Honor recipients	Lists of Medal of Honor recipients, Jewish military people
Lesley Ann Warren	American movie actors, Actors from New York City, 1946 births, Living people
Ted Tanouye	1919 births, 1944 deaths, Military people from California, United States Army Medal of Honor recipients, American people of World War II
List of Medal of Honor recipients during peacetime	Lists of Medal of Honor recipients
List of Medal of Honor recipients for the Vietnam War	Lists of Medal of Honor recipients
Uyghur language	Uyghur language
East Turkestan independence movement	Nationalism, Politics of China, National liberation movements
East Turkestan Islamic Movement	Nationalist organizations in Asia, Terrorism, Rebel militia groups in Asia, Politics of China, Politics of Pakistan
Eastern bluebird	Passeriformes
List of African-American Medal of Honor recipients	Lists of Medal of Honor recipients, African-American people
List of Medal of Honor recipients	Lists of Medal of Honor recipients
Mariette Hartley	Actors from Connecticut, American television actors, American movie actors, Emmy Award winning actors, 1940 births, Living people
José B. Nísperos	United States Army Medal of Honor recipients, 1887 births, 1922 deaths
Telesforo Trinidad	1890 births, 1968 deaths, American military personnel of World War I, American military personnel of World War II, Filipino people, Firefighters, United States Navy Medal of Honor recipients
Terry Teruo Kawamura	1949 births, 1969 deaths, United States Army Medal of Honor recipients, Military people from Hawaii, Purple Heart recipients
Darkhan (city)	Mongolia, Cities in Asia, 1961 establishments in Asia, Establishments in Mongolia
Jamie Hyneman	1956 births, Living people, American historians, Scientists from Michigan, American television personalities, American atheists, American educators, Entertainers from Michigan, People from Indiana
Adam Savage	1967 births, Living people, Television personalities from New York City, American historians, Scientists from New York City, Artists from New York City, American atheists, American educators, Writers from New York City
Kendra Wilkinson	Actors from San Diego, California, American television actors, Models from San Diego, California, 1985 births, Living people, Writers from California, Participants in American reality television series
Dutch defence	Chess openings
Carloman II of Burgundy	750s births, 771 deaths, Carolingian dynasty, Frankish rulers
Carloman I of Austrasia	8th century births, 754 deaths, European politicians, Carolingian dynasty, Frankish rulers
St. Mirren Park	Football stadiums in Scotland, 2009 establishments in the United Kingdom, 2000s establishments in Scotland
St Catharine's College, Cambridge	Colleges of the University of Cambridge, 1473 establishments, 15th century establishments in England, 1470s establishments in Europe
Golden Hockey Stick	Ice hockey trophies and awards, Ice hockey in the Czech Republic
Hugh de Lotharingia	850s births, 895 deaths, Carolingian dynasty, Frankish rulers
Jenny Clack	1947 births, 2020 deaths, English palaeontologists, Fellows of the Royal Society, Female scientists
Dina Manfredini	American supercentenarians, People from Emilia-Romagna, Deaths from natural causes, 1897 births, 2012 deaths
Gabriel Abraham Rojas	1985 births, Venezuelan sportspeople, Living people
2034	2034, Years in the future
2033	2033, Years in the future
2028	2028, Years in the future
Rodney Yano	1943 births, 1969 deaths, Military people from Hawaii, United States Army Medal of Honor recipients
2049	2049, Years in the future
St Edmund's College, Cambridge	Colleges of the University of Cambridge, 1896 establishments in England
Jonathan Motzfeldt	1938 births, 2010 deaths, Prime Ministers of Greenland
Henrikh Mkhitaryan	1989 births, Living people, Armenian sportspeople
2045	2045, Years in the future
First Lieutenant	Military ranks
Air Force Instruction	United States Air Force
Acanthostega	Lobe-finned fish, Tetrapods
Corporal	Military ranks
Baramulla Tehsil	Tehsils of Jammu and Kashmir
Muhammad Zia-ul-Haq	1924 births, 1988 deaths, Aviation deaths, Former dictators, Generals, Pakistani military people, Presidents of Pakistan
Naxalite–Maoist insurgency	Politics of India, 20th century rebellions, Rebellions in Asia, Communism, Insurgencies, 20th century in India
Deaths in 2013	2013 deaths
Factor (medicine)	Medicine
Zig Ziglar	1926 births, 2012 deaths, American historians, American activists, Deaths from pneumonia, American educators, Businesspeople from Dallas, Texas, Businesspeople from Alabama, Businesspeople from Mississippi, Infectious disease deaths in the United States, People from Plano, Texas, People from Yazoo City, Mississippi, Republicans (United States), Writers from Alabama, Writers from Mississippi, Writers from Dallas, Texas
Landman (rank)	Military ranks
Ordinary seaman (rank)	Military ranks
Lake Tōya	Geography of Japan
Staff Sergeant	Military ranks
USS Colorado (1856)	Naval ships of the United States
Lori Loughlin	American television actors, Actors from New York City, 1964 births, Living people, American movie actors
Yamaguchi (name)	Surnames
Susan Dey	Actors from Illinois, American movie actors, American television actors, Golden Globe Award winning actors, 1952 births, Living people
Nevill Ground	Cricket, Kent, Sport in England
Kay Bailey Hutchison	1943 births, Living people, People from Galveston, Texas, Permanent Representatives of the United States to NATO, United States senators from Texas, US Republican Party politicians, Women diplomats, Women politicians
Gunner's mate	Military ranks
Sergeant First Class	Military ranks
USS Benicia (1868)	Naval ships of the United States
Charles Brown (Medal of Honor)	United States Marine Corps Medal of Honor recipients, 1849 births, Year of death unknown, People from New York City
John Coleman (Medal of Honor)	1847 births, 1897 deaths, United States Marine Corps Medal of Honor recipients
James Dougherty (Medal of Honor)	1897 deaths, 1839 births, United States Marine Corps Medal of Honor recipients
Ganghwado	Islands of South Korea
Selwyn College, Cambridge	Colleges of the University of Cambridge, 1882 establishments in England
A. J. Langer	American television actors, Actors from Ohio, 1974 births, Living people
Sidney Sussex College, Cambridge	Colleges of the University of Cambridge, 1596 establishments, 1590s establishments in England
Sexagenary cycle	Calendars, Units of time
Francis B. Wai	1917 births, 1944 deaths, American people of World War II, United States Army Medal of Honor recipients, Purple Heart recipients, People from Honolulu
Christopher Martin-Jenkins	1945 births, 2013 deaths, British historians, British journalists, Cancer deaths in England, Deaths from lymphoma, English sportspeople, English writers, People from Cambridgeshire
James Faulkner	1948 births, Living people, English movie actors, English television actors, English voice actors, English stage actors, Actors from London
Luge	Winter Olympic sports, Winter sports
Russian Soviet Federative Socialist Republic	Soviet Union
Illeana Douglas	American movie actors, American television actors, 1965 births, Living people
Frederick Franklin	1840 births, 1873 deaths, United States Navy Medal of Honor recipients, People from Portsmouth, New Hampshire
John J. Pershing	1860 births, 1948 deaths, American generals, American military personnel of the Spanish-American War, American military personnel of World War I, Burials at Arlington National Cemetery, Deaths from congestive heart failure, Deaths from coronary artery disease, People from Missouri
Narcissistic personality disorder	Cluster B personality disorders, Narcissism
Specialist (rank)	Military ranks
442nd Infantry Regiment (United States)	Congressional Gold Medal recipients
Rex Reed	1938 births, Living people, American movie actors, American television personalities, American journalists, American movie critics, Writers from Texas, Writers from New York City, Actors from Fort Worth, Texas, Actors from New York City
Joe Morgenstern	1932 births, Living people, American journalists, American historians, American movie critics, Writers from Pennsylvania, Writers from New York City, Pulitzer Prize winners
Vincent Canby	1924 births, 2000 deaths, American historians, Movie critics from Chicago, Journalists from Chicago, Writers from Chicago, Writers from New York City, American military personnel of World War II, Cancer deaths in New York
Jonathan Rosenbaum	1943 births, Living people, American historians, Movie critics from Chicago, Journalists from Chicago, Writers from Alabama, Writers from Chicago, People from Florence, Alabama
Jane Kaczmarek	American television actors, Actors from Wisconsin, 1955 births, Living people
Mike Awesome	1965 births, 2007 deaths, American professional wrestlers, Former WWE wrestlers, Sportspeople from Tampa, Florida, Suicides by hanging in the United States
Kenneth Turan	1946 births, Living people, American journalists, American historians, American radio personalities, American movie critics, Writers from New York City, Writers from Los Angeles, California
Steven Rea	Living people, Year of birth missing (living people), American historians, American movie critics, American poets, Journalists from London, Journalists from New York City, Writers from London, Writers from New York City
Michael Phillips (critic)	1961 births, Living people, American journalists, American historians, Movie critics from Chicago, Writers from Wisconsin, Writers from Chicago, People from Kenosha, Wisconsin, People from Racine, Wisconsin
Ansbertus	6th century births, 6th century deaths, Carolingian dynasty, European politicians, Autobiographers
Colin Covert	Living people, Year of birth missing (living people), American journalists, American historians, Movie critics from Chicago, Writers from Minneapolis, Minnesota, Writers from Chicago, Writers from New Jersey
Curriculum	Education
Otto I the Illustrious	Ottonian dynasty, 840s births, 912 deaths, History of Germany, European politicians, Kings and Queens in Germany, Autobiographers
Rachel Ward	English movie actors, 1957 births, Living people
Trinity Hall, Cambridge	Colleges of the University of Cambridge, 1350 establishments, 1350s establishments in Europe, 14th century establishments in England
Wolfson College, Cambridge	1965 establishments in England, Colleges of the University of Cambridge
Comenius	1592 births, 1670 deaths, Czech educators
James Buck	1808 births, 1865 deaths, United States Navy Medal of Honor recipients, People from Maryland
USS Buck (SP-1355)	Warships
Per "Dead" Ohlin	1969 births, 1991 deaths, Heavy metal singers, Musicians who committed suicide, Musicians from Stockholm, Suicides by firearm, Singers from Stockholm
Jōkyō calendar	Calendars
Jimmy Doolittle	1896 births, 1993 deaths, United States Army Medal of Honor recipients, Military people from California, People from Alaska, Alameda, California
Kansei calendar	Calendars
Tenpō calendar	Calendars
Jessica Andrews	Singers from Tennessee, American country musicians, 1983 births, Living people
Anna Wing	1914 births, 2013 deaths, Deaths from natural causes, Actors from London, English movie actors, English radio actors, English stage actors, English television actors, English voice actors
Hōryaku calendar	Calendars
Mikhail Kalashnikov	1919 births, 2013 deaths, Disease-related deaths in Russia, Russian engineers, Russian inventors, Soviet generals, Soviet military personnel of World War II
Brenda Joyce	American movie actors, Actors from Missouri, 1917 births, 2009 deaths
Inca Civil War	Civil wars, Inca civilization, 16th century in South America, 1529, 1530, 1531, 1532
Cao Dai	East Asian religions, New religious movements, Religion in Vietnam
2051	2051, Years in the future
2050	2050, Years in the future
The Lover	1992 romance movies, 1992 drama movies, 1990s romantic drama movies, English-language movies, French drama movies, French romance movies, Movies based on books, Movies set in the 1920s, Vietnamese movies, Movies directed by Jean-Jacques Annaud
Rover (space exploration)	Moon, Mars, NASA spacecraft
Camp Caves, Queensland	Settlements in Queensland, United States Army
Locksmith	Occupations, Locks
Peter Sutcliffe	1946 births, 2020 deaths, Deaths from the COVID-19 pandemic in the United Kingdom, English people convicted of murder, English prisoners, English serial killers, People convicted of attempted murder, People from Yorkshire, People with schizophrenia, Prisoners sentenced to life imprisonment
Kenneth Walker	1898 births, 1943 deaths, American aviators, American people of World War II, Aviation deaths, Missing American people, People from New Mexico, United States Army Medal of Honor recipients, Purple Heart recipients
Kate Bosworth	Actors from Los Angeles, California, Actors from Connecticut, American movie actors, 1983 births, Living people
Division of Banks	Electoral divisions of Australia, 1949 establishments in Australia, New South Wales
Tia Carrere	American movie actors, American television actors, Dancing with the Stars participants, Actors from Honolulu, 1967 births, Living people
Ferromagnetism	Magnetism
Division of Barton	Electoral divisions of Australia, New South Wales, 1922 establishments in Australia
David Jalbert	Living people, 1980 births, People from Quebec, Canadian singer-songwriters, Folk musicians
Genka calendar	Calendars, 7th century establishments in Japan, 7th century disestablishments in Japan, 604 establishments, 696 disestablishments
Semmyō calendar	Calendars
Gihō calendar	Calendars
Oestrous cycle	Hormones, Female reproductive system, Mammals
Taien calendar	Calendars
Veronique Cloutier	1974 births, Living people, Canadian entertainers, Television talk show hosts
Luteinizing hormone	Hormones
Goki calendar	Calendars
Thomas Ley	1880 births, 1947 deaths, Australian murderers, British murderers, Nationalist Party of Australia politicians, People from Bath, Somerset, Politicians from Somerset, Politicians from Sydney
Shah Puri dialect	Punjabi language
Kerning	Typography
P.M. Dawn	1980s American music groups, 1990s American music groups, 2000s American music groups, 2010s American music groups, 1988 establishments in the United States, American R&B bands, Hip hop bands, Musical groups from Jersey City, New Jersey, 1980s establishments in New Jersey
Bogor Regency	Indonesia
Bagh-e-Jinnah	Lahore, Parks in Pakistan
Grafting	Botany
Ivanhoe	British novels, 1920s books
American Forces Press Service	United States Department of Defense agencies
Pulpurru Davies	1940s births, Living people, Australian painters, Indigenous Australian artists, Artists from Western Australia
John Hemmingham	Living people, 1963 births, People from Sheffield, Trumpeters
2052	2052, Years in the future
Breuil-Cervinia	Settlements in Valle d'Aosta, Villages in Europe, Ski areas and resorts
Aosta	Regional capitals in Italy, Settlements in Valle d'Aosta
Goryōkaku	Buildings and structures in Hokkaido
Sankagiri	Settlements in Tamil Nadu, Salem District
The Lego Movie	2014 animated movies, 2014 comedy movies, American animated movies, American adventure movies, American comedy movies, Warner Bros. movies, Dystopian movies
American Forces Network	Military of the United States, Peabody Award winners, Radio stations, 1942 establishments in the United States
George Andrew Davis, Jr.	1920 births, 1952 deaths, Medal of Honor recipients, People from Texas, Purple Heart recipients
Tangmarg	Tehsils of Jammu and Kashmir
Barak Valley	Assam, Valleys, Geography of India
Ottawa Lady Senators	1988 establishments in Canada, Ice hockey teams in Ontario, Ottawa
South Chungcheong Province	Provinces of South Korea
Kenneth Mars	1935 births, 2011 deaths, Deaths from pancreatic cancer, American movie actors, American television actors, American stage actors, American voice actors, Television personalities from Chicago, Comedians from Chicago, Actors from Chicago
Kiki Farrel	1986 births, Living people, Indonesian actors, Actors from Jakarta
Lionel Jeffries	1926 births, 2010 deaths, Actors from London, Deaths from vascular dementia, Disease-related deaths in England, English movie actors, English radio actors, English stage actors, English television actors, English voice actors, Movie directors from London, Screenwriters from London, Writers from London
Russ Mayberry	1925 births, 2012 deaths, Naturalized citizens of the United States, American television directors, People from Glasgow, Businesspeople from Chicago
J. Michael Riva	1948 births, 2012 deaths, Deaths from stroke, People from New York City
Jane March	Actors from London, English movie actors, 1973 births, Living people
Regina Taylor	American movie actors, Actors from Texas, 1960 births, Living people
Christine Taylor	Actors from Pennsylvania, American movie actors, American television actors, 1971 births, Living people, People from Allentown, Pennsylvania
Iced Earth	1980s American music groups, 1980s establishments in Florida, 1985 establishments in the United States, 1990s American music groups, 2000s American music groups, 2010s American music groups, American heavy metal bands, Musical groups established in 1985, Musical groups from Florida, Power metal bands, Progressive metal bands, Tampa, Florida, Thrash metal bands
Holly Robinson Peete	American television actors, Actors from Philadelphia, Pennsylvania, 1964 births, Living people
Strip Me (song)	Songs by Natasha Bedingfield, 2010 songs
Guild Wars 2	Online games, Massively multiplayer online role-playing games, 2012 video games
Sister Sledge	1971 establishments in the United States, American girl groups, American R&B bands, 1970s establishments in Pennsylvania
Jimmy Fallon	1974 births, Living people, Webby Award winners, American movie actors, American voice actors, American television actors, American television personalities, Comedians from New York City, American television presenters, Actors from New York City, Writers from New York City, Singers from New York City, Musicians from New York City
Gorgoroth	1990s music groups, 1992 establishments in Europe, 2000s music groups, 2010s music groups, Black metal bands, Norwegian heavy metal bands, Musical groups from Bergen, 1990s establishments in Norway
Peter Breck	1929 births, 2012 deaths, Deaths from dementia, American movie actors, American television actors, American stage actors, American voice actors, American radio actors, American television personalities, American radio personalities, Actors from New York, Actors from Houston, Texas, People from Rochester, New York
Retinal migraine	Migraine
Immortal (band)	1980s music groups, Musical groups established in 1989, 1990s music groups, 2000s music groups, 2010s music groups, Black metal bands, Norwegian heavy metal bands, Musical groups from Bergen, 1980s establishments in Norway
Melanie Lynskey	Entertainers from North Island, New Zealand movie actors, New Zealand television actors, 1977 births, Living people
Ashford & Simpson	American R&B bands
Barbara Werle	1926 births, 2013 deaths, Deaths from natural causes, Actors from Los Angeles, California, Actors from New York, American movie actors, American radio actors, American stage actors, American television actors, People from Mount Vernon, New York
Tony Lip	1930 births, 2013 deaths, Actors from New Jersey, Actors from New York City, Actors from Pennsylvania, American movie actors, American stage actors, American television actors, American voice actors
Louis de Saint-Just	French people, 1767 births, 1794 deaths
Samantha Mathis	Actors from New York City, American movie actors, 1970 births, Living people
Jean-Paul Marat	Assassinated people, French murder victims, French scientists, Murders by blade weapons, 1743 births, 1793 deaths
Ayub K. Ommaya	Pakistani people, American physicians, 1930 births, 2008 deaths, Medical researchers
Ragout	French food
Melissa Leo	Actors from New York City, American movie actors, 1960 births, Living people
Internal conflict in Myanmar	Civil wars, History of Myanmar
Ambient intelligence	Computer science
Stew	Cooking methods
Joanna Cassidy	American movie actors, American television actors, Actors from New Jersey, 1945 births, Living people
David Suchet	Actors from London, English movie actors, English television actors, Living people, 1946 births, Commanders of the Order of the British Empire
Giuseppe Ungaretti	Italian writers, Italian poets, 1888 births, 1970 deaths, People from Alexandria
Michelle Dockery	Actors from London, Singers from London, 1981 births, Living people
Bailee Madison	1999 births, Actors from Florida, American movie actors, American child actors, People from Fort Lauderdale, Florida, Living people
Pamela Sue Martin	Actors from Hartford, Connecticut, American television actors, 1953 births, Living people
Bonnie Franklin	Actors from Santa Monica, California, American child actors, American movie actors, American stage actors, American television actors, American voice actors, Deaths from pancreatic cancer, 1944 births, 2013 deaths
Aisha Tyler	American movie actors, Comedians from California, 1970 births, Living people, American television actors, Actors from San Francisco
Francesca Capaldi	American children's television series, American child actors, Living people, 2004 births
Philippe Bond	Living people, Year of birth missing (living people), Canadian comedians, Entertainers from Quebec, Canadian radio personalities
Yilpi Adamson	1954 births, Living people, Australian painters, Indigenous Australian artists, Artists from South Australia, Artists from the Northern Territory, Pitjantjatjara, Textile artists, Weavers
Universal Soldier	1992 action movies, 1992 movies, English-language movies
Ommaya reservoir	Surgery
Wajih uz Zaman Khan	1962 births, Living people, Pakistani lawyers
Kimberley Walsh	English movie actors, English pop singers, English television presenters, Girls Aloud, Musicians from Bradford, Strictly Come Dancing participants, 1981 births, Living people
Steven William	Indonesian actors, actors from California, 1993 births, Living people
Dark Funeral	1990s music groups, Musical groups established in 1993, 2000s music groups, 2010s music groups, Black metal bands, Swedish heavy metal bands, 1993 establishments in Sweden
I (band)	2000s music groups, 2010s music groups, Black metal bands, Musical groups established in 2006, Norwegian heavy metal bands, Thrash metal bands, 2006 establishments in Europe
Milyika Carroll	1958 births, Living people, Australian painters, Indigenous Australian artists, Artists from South Australia, Pitjantjatjara, Textile artists, Australian printmakers, Ceramists
Genco Gulan	Sculptors, Painters, 1969 births, Living people, Turkish people
Pinscreen animation	Animation, Movie industry
Muria people	Ethnic groups in India, Chhattisgarh
Lucy Hale	American movie actors, American television actors, singers from Memphis, Tennessee, Actors from Memphis, Tennessee, 1989 births, Living people
Victoria Rowell	American television actors, Actors from Maine, People from Portland, Maine, Writers from Maine, 1959 births, Living people
Ashley Benson	American television actors, Actors from Anaheim, California, 1989 births, Living people
Love's Labour's Won	Plays by William Shakespeare
Vertigo	Migraine
Thomas J. Hudner, Jr.	1924 births, 2017 deaths, American aviators, American military personnel of the Korean War, American military personnel of the Vietnam War, People from Massachusetts, United States Navy Medal of Honor recipients
Malpiya Davey	1959 births, Living people, Australian painters, Indigenous Australian artists, Artists from South Australia, Pitjantjatjara, Australian printmakers, Weavers, Ceramists
Malya Teamay	1947 births, Living people, Australian painters, Indigenous Australian artists, Artists from the Northern Territory, Pitjantjatjara
Dress code	Clothing
MI5	Military of the United Kingdom, Intelligence agencies, Government agencies of the United Kingdom
Gretchen Mol	Actors from Connecticut, American movie actors, 1972 births, Living people
Function composition	Mathematics
Hunter Tylo	Actors from Texas, 1962 births, Living people
Weißenburg-Gunzenhausen	Weißenburg-Gunzenhausen
Familial hemiplegic migraine	Migraine
Aqdas	Bahá'í Faith, Religious texts
Rene Kulitja	1958 births, Living people, Australian painters, Indigenous Australian artists, Artists from South Australia, Artists from the Northern Territory, Pitjantjatjara, Ceramists
Pokémon X and Y	2013 video games, Nintendo 3DS games, Pokémon RPGs
Uri, Jammu and Kashmir	Tehsils of Jammu and Kashmir
Kepler (spacecraft)	NASA spacecraft
Dawn Wells	Actors from Nevada, 1938 births, 2020 deaths, People from Reno, Nevada, Deaths from the COVID-19 pandemic in the United States, American movie actors, American television actors, American stage actors, Models from Nevada
Speaker of the Australian House of Representatives	Government of Australia, Speakers of the Australian House of Representatives
Michelle Forbes	Actors from Texas, 1965 births, Living people
Huell Howser	1945 births, 2013 deaths, Deaths from prostate cancer, Actors from Los Angeles, California, Actors from Tennessee, American comedians, American movie actors, American radio actors, American radio personalities, American television actors, American television personalities, American television presenters, American voice actors, People from Knoxville, Tennessee
Bud Luckey	1934 births, 2018 deaths, Actors from Montana, American animators, American cartoonists, American composers, American movie actors, American musicians, American radio actors, American singers, American television actors, American voice actors, Annie Award winners, Clio Award winners, Deaths from stroke, Disney actors, Musicians from Montana, People from Billings, Montana, Singers from Montana, Writers from Montana
David R. Ellis	1952 births, 2013 deaths, Actors from Los Angeles, California, Actors from Santa Monica, California, American child actors, Movie directors from California
Hailee Steinfeld	Actors from Los Angeles, California, 1996 births, Living people, African American actors, Jewish American actors
Erin Gray	American television actors, Actors from Honolulu, 1950 births, Living people
Patrice O'Neal	1969 births, 2011 deaths, Cardiovascular disease deaths in the United States, Deaths from stroke, Deaths from diabetes, Comedians from Massachusetts, American radio personalities, American television personalities, American movie actors, American television actors, American voice actors, American radio actors, African American comedians, African American actors, Actors from New York City, Actors from Boston, Massachusetts
Plessis-Saint-Jean	Communes in Yonne
Accolay, Yonne	Former communes in Yonne
Aigremont, Yonne	Communes in Yonne
Aillant-sur-Tholon	Former communes in Yonne
Aisy-sur-Armançon	Communes in Yonne
Ancy-le-Franc	Communes in Yonne
Ancy-le-Libre	Communes in Yonne
Andryes	Communes in Yonne
Angely	Communes in Yonne
Annay-la-Côte	Communes in Yonne
Annay-sur-Serein	Communes in Yonne
Annéot	Communes in Yonne
Annoux	Communes in Yonne
Appoigny	Communes in Yonne
Arces-Dilo	Communes in Yonne
Arcy-sur-Cure	Communes in Yonne
Argentenay	Communes in Yonne
Argenteuil-sur-Armançon	Communes in Yonne
Armeau	Communes in Yonne
Arthonnay	Communes in Yonne
Asnières-sous-Bois	Communes in Yonne
Asquins	Communes in Yonne
Athie, Yonne	Communes in Yonne
Augy, Yonne	Communes in Yonne
Avallon	Subprefectures in France, Communes in Yonne
Bagneaux	Communes in Yonne
Baon	Communes in Yonne
Joan Van Ark	American television actors, Actors from New York, 1943 births, Living people
Supertramp (album)	1970 albums, Debut albums, Supertramp albums, Rock albums
Central Australian Aboriginal Media Association	Indigenous Australian culture, Indigenous Australian music, Organisations based in Australia, 1980 establishments in Australia
Division of Lalor	Electoral divisions of Australia, 1949 establishments in Australia
Bassou	Communes in Yonne
Bazarnes	Communes in Yonne
Beaumont, Yonne	Communes in Yonne
Bernouil	Communes in Yonne
Béru	Communes in Yonne
Bessy-sur-Cure	Communes in Yonne
Beauvilliers, Yonne	Communes in Yonne
Beauvoir, Yonne	Communes in Yonne
Beine	Communes in Yonne
Bellechaume	Communes in Yonne
La Belliole	Communes in Yonne
Abrest	Communes in Allier
Agonges	Communes in Allier
Ainay-le-Château	Communes in Allier
Andelaroche	Communes in Allier
Archignat	Communes in Allier
Arfeuilles	Communes in Allier
Arpheuilles-Saint-Priest	Communes in Allier
Arronnes	Communes in Allier
Aubigny, Allier	Communes in Allier
Audes	Communes in Allier
Aurouër	Communes in Allier
Autry-Issards	Communes in Allier
Avermes	Communes in Allier
Avrilly, Allier	Communes in Allier
Richard Blanco	American poets, Living people, 1968 births
Bagneux, Allier	Communes in Allier
Villefranche-d'Allier	Communes in Allier
Villeneuve-sur-Allier	Communes in Allier
Viplaix	Communes in Allier
Vitray	Former communes in Allier
Voussac	Communes in Allier
Barberier	Communes in Allier
Barrais-Bussolles	Communes in Allier
Bayet	Communes in Allier
Beaulon	Communes in Allier
Beaune-d'Allier	Communes in Allier
Bègues	Communes in Allier
Bellenaves	Communes in Allier
Bellerive-sur-Allier	Communes in Allier
Bert, Allier	Communes in Allier
Bessay-sur-Allier	Communes in Allier
Besson, Allier	Communes in Allier
Bézenet	Communes in Allier
Billezois	Communes in Allier
Billy, Allier	Communes in Allier
Biozat	Communes in Allier
Bizeneuille	Communes in Allier
Busset	Communes in Allier
Blomard	Communes in Allier
Bost, Allier	Communes in Allier
Boucé, Allier	Communes in Allier
Bransat	Communes in Allier
Le Bouchaud	Communes in Allier
Bourbon-l'Archambault	Communes in Allier, Spa towns in France
Janice Dickinson	Models from New York City, People with cancer, American television actors, American television personalities, Participants in American reality television series, 1955 births, Living people
Braize	Communes in Allier
Bresnay	Communes in Allier
Bressolles, Allier	Communes in Allier
Le Brethon	Communes in Allier
Le Breuil, Allier	Communes in Allier
Broût-Vernet	Communes in Allier
Brugheas	Communes in Allier
Buxières-les-Mines	Communes in Allier
La Celle, Allier	Communes in Allier
Cérilly, Allier	Communes in Allier
Cesset	Communes in Allier
La Chabanne	Communes in Allier
Chambérat	Communes in Allier
Chamblet	Communes in Allier
Chantelle, Allier	Communes in Allier
Chapeau, Allier	Communes in Allier
La Chapelaude	Communes in Allier
La Chapelle, Allier	Communes in Allier
La Chapelle-aux-Chasses	Communes in Allier
Chappes, Allier	Communes in Allier
Chareil-Cintrat	Communes in Allier
Charmeil	Communes in Allier
Charmes, Allier	Communes in Allier
Charroux, Allier	Communes in Allier
Chassenard	Communes in Allier
Château-sur-Allier	Communes in Allier
Châtel-de-Neuvre	Communes in Allier
Ygrande	Communes in Allier
Yzeure	Communes in Allier
Châtel-Montagne	Communes in Allier
Châtelperron	Communes in Allier
Châtelus, Allier	Communes in Allier
Châtillon, Allier	Communes in Allier
Chazemais	Communes in Allier
Chavenon	Communes in Allier
Chavroches	Communes in Allier
Chemilly, Allier	Communes in Allier
Chevagnes	Communes in Allier
Chezelle	Communes in Allier
Chézy, Allier	Communes in Allier
Chirat-l'Église	Communes in Allier
Chouvigny	Communes in Allier
Cindré	Communes in Allier
Cognat-Lyonne	Communes in Allier
Colombier, Allier	Communes in Allier
Commentry	Communes in Allier
Contigny	Communes in Allier
Cosne-d'Allier	Communes in Allier
Coulandon	Communes in Allier
Coulanges, Allier	Communes in Allier
Couleuvre	Communes in Allier
Courçais	Communes in Allier
Coutansouze	Communes in Allier
Couzon	Communes in Allier
Créchy	Communes in Allier
Cressanges	Communes in Allier
Creuzier-le-Neuf	Communes in Allier
Creuzier-le-Vieux	Communes in Allier
Deneuille-lès-Chantelle	Communes in Allier
Cusset	Communes in Allier
Deneuille-les-Mines	Communes in Allier
Désertines, Allier	Communes in Allier
Deux-Chaises	Communes in Allier
Diou, Allier	Communes in Allier
Domérat	Communes in Allier
Dompierre-sur-Besbre	Communes in Allier
Doyet	Communes in Allier
Droiturier	Communes in Allier
Durdat-Larequille	Communes in Allier
Ébreuil	Communes in Allier
Échassières	Communes in Allier
Vicq, Allier	Communes in Allier
Murat, Allier	Communes in Allier
Nades	Communes in Allier
Nassigny	Communes in Allier
Naves, Allier	Communes in Allier
La Petite-Marche	Communes in Allier
Escurolles	Communes in Allier
Espinasse-Vozelle	Communes in Allier
Estivareilles, Allier	Communes in Allier
Étroussat	Communes in Allier
Koobi Fora	Archaeological sites in Africa, Kenya, Prehistoric Africa
Ferrières-sur-Sichon	Communes in Allier
Suzanne Cleary	American poets, Living people, Year of birth missing (living people), People from Binghamton, New York, American academics
Layne Staley	American drummers, American guitarists, American heavy metal musicians, American rock musicians, American rock singers, Musicians from Washington, Drug-related deaths, 1967 births, 2002 deaths
Montluçon	Communes in Allier, Subprefectures in France
Steel mill	Industries
Shelley Long	American television actors, Actors from Indiana, 1949 births, Living people, People from Fort Wayne, Indiana, Emmy Award winning actors, Golden Globe Award winning actors
Caserta	Cities in Campania, Capital cities in Italy
Jane Curtin	American television actors, Actors from Massachusetts, Comedians from Massachusetts, 1947 births, Living people, Emmy Award winning actors
Lantern of the dead	Towers
Lavoir	Buildings and structures
Judith Krantz	1928 births, 2019 deaths, American novelists, Writers from New York City
Carl Berner	1902 births, 2013 deaths, American supercentenarians, Naturalized citizens of the United States, People from Stuttgart
James M. Buchanan	1919 births, 2013 deaths, Deaths from natural causes, American economists, American educators, Nobel Prize in Economics winners, Scientists from Chicago, Scientists from Virginia, Scientists from Tennessee
The Last Stand	2013 movies, American action movies, American crime movies, English-language movies, Movies set in Arizona, Lionsgate movies
Ronald Gamarra Herrera	Peruvian politicians, 1958 births, Living people
Vincent Forrester	1952 births, Living people, Artists from the Northern Territory, Indigenous Australian artists, Arrernte, Australian painters, Indigenous Australian activists, Civil servants, People from Alice Springs
Division of Warringah	Electoral divisions of Australia, New South Wales, 1922 establishments in Australia
Division of Lowe	Former electoral divisions of Australia, New South Wales, 1949 establishments in Australia, 2010 disestablishments
Maroda	Settlements in Uttarakhand, Villages in India
The Carrie Diaries	2013 American television series debuts, 2014 American television series endings, 2010s American television series, American comedy-drama television series, American teen television series, Television series set in Connecticut, Television series set in New York City, English-language television programs
Udhampur	Tehsils of Jammu and Kashmir
Chloe Bridges	American television actors, Actors from Louisiana, 1991 births, Living people
Palaeoptera	Insects
Tracie Spencer	American R&B musicians, Singers from Iowa, 1976 births, Living people, People from Waterloo, Iowa, Musicians from Iowa, American R&B singers
Broughton, Nova Scotia	Settlements in Nova Scotia
Palaeodictyoptera	Insects, Fossils
Crime of the Century	1974 albums, Supertramp albums, Rock albums
Robin Kankapankatja	1930 births, Australian painters, Indigenous Australian artists, Pitjantjatjara, Artists from South Australia
LinkedIn	Web 2.0, Social networking, 2002 establishments in the United States
Integer overflow	Computers
Slender Man	Internet memes, Fictional characters, Monsters
Bethesda, Maryland	Bethesda, Maryland, Census-designated places in Maryland, 1820 establishments in the United States, Montgomery County, Maryland, 19th-century establishments in Maryland
Division of East Sydney	Former electoral divisions of Australia, 1901 establishments in Australia, 1969 disestablishments in Australia
Division of Bland	Former electoral divisions of Australia, New South Wales, 1901 establishments in Australia, 1900s disestablishments in Australia
Division of Ballarat	Electoral divisions of Australia, Ballarat, Victoria, Australia, 1901 establishments in Australia
Windows 3.0	Microsoft operating systems
DirectX	Microsoft software, Graphics software
William Bland	1789 births, 1868 deaths, Australian medical doctors, Australian murderers, British murderers, Criminals from London, Disease-related deaths in Sydney, English inventors, English physicians, Infectious disease deaths in Australia, Politicians from London
CeCe Peniston	American R&B singers, Singers from Ohio, 1969 births, Living people
South Pole–Aitken basin	Impact craters, Surface features of the Moon
Straw man	Logical fallacies
André Roy	1975 births, Beauport Harfangs players, Boston Bruins players, Calgary Flames players, Canadian ice hockey right wingers, Chicoutimi Saguenéens (QMJHL) players, Drummondville Voltigeurs players, Ice hockey people from Quebec, Living people, Ottawa Senators players, Pittsburgh Penguins players, Sportspeople from New York, Stanley Cup champions, Tampa Bay Lightning players
Sandra Dee	People from Bayonne, New Jersey, Actors from New Jersey, American movie actors, American stage actors, American voice actors, Deaths from kidney disease, Disease-related deaths in the United States, 1944 births, 2005 deaths
Cégep de Saint-Hyacinthe	Colleges and universities in Canada, Quebec
Steve Bégin	1978 births, American Hockey League players, Boston Bruins players, Canadian ice hockey centres, Calgary Flames players, Dallas Stars players, Living people, Montreal Canadiens players, Nashville Predators players, Val-d'Or Foreurs players
Chenani	Tehsils of Jammu and Kashmir
Aylesford, Nova Scotia	Villages in Nova Scotia
Cornwallis Square	Villages in Nova Scotia
Leelee Sobieski	Actors from New York City, American movie actors, 1983 births, Living people
Oxford, Nova Scotia	1791 establishments, Towns in Nova Scotia, Establishments in Canada, 1790s establishments in North America
Freeport, Nova Scotia	Villages in Nova Scotia
Relay For Life	Charity events, Cancer
Flag football	Football
Nichi Vendola	Living people, Italian politicians, People from Bari, 1958 births
Bioterrorism	Terrorism
The Predator	1992 albums, Pop albums
Fashion in the 1920s	1920s, Fashion
Michiko Kichise	Japanese movie actors, Japanese television actors, 1975 births, Living people, Actors from Fukuoka Prefecture
Aquarius (constellation)	Constellations, Constellations listed by Ptolemy
Coclé Province	Provinces of Panama
Chiriquí Province	Provinces of Panama
Beugnon	Communes in Yonne
Bierry-les-Belles-Fontaines	Communes in Yonne
Blannay	Communes in Yonne
Bleigny-le-Carreau	Communes in Yonne
Hamilton Hill (comics)	Fictional characters introduced in 1981, Batman characters, DC Comics characters
Poison Ivy (comics)	Batman characters, DC Comics supervillains, Fictional bisexual females, Fictional characters introduced in 1966
Harley Quinn	Batman characters, DC Comics supervillains, Fictional bisexual females, Fictional characters introduced in 1992, The Joker
Riddler (comics)	Batman characters, DC Comics supervillains, Fictional characters introduced in the 1940s, Fictional mass murderers
Clayface	Batman characters, DC Comics characters
Killer Croc	Batman characters, DC Comics characters, Fictional African-American people, Fictional characters introduced in 1983
Mad Hatter (comics)	Batman characters, DC Comics characters
Man-Bat	Batman characters, DC Comics characters, Fictional characters introduced in the 1970s
Carmine Falcone	Batman characters, DC Comics characters
Sal Maroni	Batman characters, DC Comics characters
Hugo Strange	Batman characters, DC Comics characters, Fictional characters introduced in 1940
Leslie Thompkins	Batman characters, DC Comics characters
Gillian B. Loeb	Batman characters, DC Comics characters
Tali Tali Pompey	1940s births, 2011 deaths, Australian painters, Indigenous Australian artists, Pitjantjatjara, Artists from South Australia, Artists from the Northern Territory
Rupert Thorne	Batman characters, DC Comics characters
Harvey Bullock (comics)	Batman characters, DC Comics characters
Roland Daggett	Batman characters, DC Comics characters
Arnold Flass	Batman characters, DC Comics characters
Joe Chill	Batman characters, DC Comics characters
Victor Zsasz	Batman characters, DC Comics characters, Fictional characters introduced in 1992
Firefly (comics)	Batman characters, DC Comics characters, Fictional characters with fire or heat abilities
Michael Akins	Batman characters
Clock King	Batman characters, DC Comics characters
Jor-El	Kryptonians, Superman
General Zod	DC Comics supervillains, Kryptonians, Superman
Perry White	DC Comics characters, Superman
Willie Lumpkin	Marvel Comics characters
Division of Hunter	Electoral divisions of Australia, New South Wales
J. Jonah Jameson	Fictional characters introduced in 1963, Marvel Comics characters
Aunt May	Fictional characters introduced in 1962, Marvel Comics characters
Mary Leakey	1913 births, 1996 deaths, Kenyan people, British anthropologists, British archaeologists, Female scientists, Leakey family
Olivia Wilde	Actors from New York City, American movie actors, 1984 births, Living people
Charles des Moulins	1798 births, 1875 deaths, French botanists
Laetoli	Tanzania, Archaeological sites in Africa, Hominins, Fossils, Prehistoric Africa
Rachel Griffiths	Australian movie actors, 1968 births, Living people
Division of Wide Bay	Electoral divisions of Australia, Sunshine Coast, Queensland, 1901 establishments in Australia
Nancy Marchand	1928 births, 2000 deaths, Actors from Buffalo, New York, American movie actors, American stage actors, American television actors, Deaths from emphysema, Deaths from lung cancer, Cancer deaths in Connecticut
Bonnie Bartlett	American television actors, Actors from Wisconsin, 1929 births, Living people, Emmy Award winning actors
Ignosticism	Religion
Bléneau	Communes in Yonne
Béon, Yonne	Communes in Yonne
Bonnard, Yonne	Communes in Yonne
Bœurs-en-Othe	Communes in Yonne
Leigh Taylor-Young	American television actors, American movie actors, 1945 births, Living people
Priscilla Barnes	1955 births, Living people, Actors who played in James Bond movies, Actors from New Jersey, American television actors, American movie actors
Donald Glover	Actors from Georgia (U.S. state), Actors from Los Angeles, California, African American comedians, American movie actors, American movie producers, American rap musicians from California, American stand-up comedians, American television actors, 1983 births, Living people, Comedians from Los Angeles, California
Comarca Emberá-Wounaan	Provinces of Panama
Kunlun Mountains	Mountains of China
Blasphemy (band)	1980s Canadian music groups, 1990s Canadian music groups, 2000s Canadian music groups, 2010s Canadian music groups, Canadian black metal bands, Canadian death metal bands, Canadian heavy metal bands, Musical groups established in 1984, 1984 establishments in Canada
Lloyd Hartman Elliott	1918 births, 2013 deaths, American educators, Deaths from natural causes, Businesspeople from West Virginia
Jiřina Jirásková	1931 births, 2013 deaths, Czechoslovak people, Entertainers from Prague, Czech movie actors, Czech stage actors, Czech television actors
Two Is Better Than One	Pop songs, 2009 songs
Rex Trailer	1928 births, 2013 deaths, Actors from Boston, Massachusetts, Actors from Fort Worth, Texas, American movie actors, American radio actors, American stage actors, American television actors, American television producers, American voice actors, Deaths from pneumonia, Infectious disease deaths in Florida, Singers from Massachusetts, Singers from Texas, Television personalities from Texas
Sergiu Nicolaescu	1930 births, 2013 deaths, Deaths from cardiac arrest, Deaths from respiratory failure, Deaths from surgical complications, Romanian movie actors, Romanian movie directors, Romanian movie producers, Romanian politicians, Romanian screenwriters, Romanian stage actors, Romanian television actors
Marky Mark and the Funky Bunch	1980s American music groups, Musical groups established in 1989, 1990s American music groups, Musical groups disestablished in 1993, American boy bands, Hip hop bands, Musical groups from Massachusetts, 1989 establishments in the United States, 1980s establishments in Massachusetts, 1993 disestablishments in the United States
Reg Dean	1902 births, 2013 deaths, British supercentenarians, People from Staffordshire
Aaron Swartz	1986 births, 2013 deaths, American activists, Jewish American writers, Suicides by hanging in the United States, Writers from Chicago
Mariangela Melato	1941 births, 2013 deaths, Actors from Milan, Cancer deaths in Italy, Deaths from pancreatic cancer, Italian movie actors, Italian stage actors, Italian television actors, Italian voice actors
Koto Okubo	1897 births, 2013 deaths, Deaths from pneumonia, Japanese supercentenarians, People from Kanagawa Prefecture
Jiroemon Kimura	1897 births, 2013 deaths, Deaths from natural causes, Japanese supercentenarians, World record holders, People from Kyoto Prefecture
Ron Mercer	Living people, 1976 births, Boston Celtics players, Sportspeople from Nashville, Tennessee
Shark Tank	American reality television series, ABC network shows, English-language television programs
Ty Lawson	1987 births, African-American basketball players, Denver Nuggets players, Houston Rockets players, Living people, Sportspeople from Maryland, American basketball players
He Pingping	1988 births, 2010 deaths, Deaths from heart failure, Chinese people, World record holders, People with dwarfism
Svetlana Pankratova	1971 births, Living people, Russian people, World record holders, Volgograd
Ronnie and Donnie Galyon	1951 births, 2020 deaths, Deaths from congestive heart failure, People from Dayton, Ohio, Twin people from the United States, World record holders
William M. Daley	1948 births, Living people, American lawyers, Bankers, Politicians from Chicago, United States Secretaries of Commerce, US Democratic Party politicians, White House Chiefs of Staff
Debra Winger	Actors from Cleveland, Ohio, American movie actors, American television actors, 1955 births, Living people
Pulya Taylor	Living people, Australian sculptors, Woodworkers, Artists from South Australia, Artists from the Northern Territory, Indigenous Australian artists, Pitjantjatjara, Year of birth missing (living people)
Rob Kardashian	1987 births, Living people, Actors from Los Angeles, California, Dancing with the Stars participants, Kardashian family, Television personalities from Los Angeles, California

