Astelia banksii	Asparagales
Barclays	Banks of the United Kingdom, 1690 establishments, 17th century establishments in England, 1690s establishments in Europe
The Beano	Magazines of the United Kingdom
Dunedin	Cities in New Zealand
Dunfermline Building Society	Banks of the United Kingdom, Companies of the United Kingdom, 1869 establishments in the United Kingdom
Big Mac Index	Economics, McDonald's
Economic index	Economics
JeOS	Linux distributions, Ubuntu (operating system) derivatives
All Hope Is Gone (song)	2008 songs, Slipknot songs
The Blister Exists	Slipknot songs, 2006 songs
Fellatio	Sexual acts
Halo 3	Halo, Xbox 360 games, 2007 video games
Extremaduran language	Romance languages, Extremadura
Macron Stadium	Football stadiums in England, 1997 establishments in England
Tanoli	Ethnic groups in Pakistan, Ethnic groups in Khyber Pakhtunkhwa
Jirga	Dispute resolution, Politics of Pakistan
Gujar Khan	Rawalpindi District
Chlamydia infection	Sexually transmitted diseases, Diseases caused by bacteria
Ted Strickland	1941 births, Living people, Governors of Ohio
Michigan Wolverines	American Lacrosse Conference, Big Ten Conference, Central Collegiate Hockey Association, ECAC Lacrosse, University of Michigan
Boston Massacre	1770, History of Boston, Massachusetts, Crime in the United States, Manslaughter, Massacres, 1770s in Massachusetts, March events
Dreadlocks	Hairstyles
List of Russian football teams	Lists of football teams, Russian football clubs, Russia-related lists
F.C. Dynamo Moscow	Russian football clubs, 1923 establishments in the Soviet Union
Lev Yashin	1929 births, 1990 deaths, Russian footballers
Ronaldo	1976 births, Living people, Brazilian footballers, Footballers from Rio de Janeiro
Míchel (footballer)	1963 births, Living people, Spanish footballers, Spanish football managers, Sportspeople from Madrid
League of Ireland Premier Division	Football League of Ireland
Japanese kickboxing	Kickboxing
Emilio Butragueño	1963 births, Living people, Spanish footballers, Sportspeople from Madrid
Francisco Gento	1933 births, Living people, Spanish footballers
Athletic Bilbao	Spanish football clubs, 1898 establishments in Europe, 1890s establishments in Spain
Rafael Moreno Aranzadi	Spanish footballers, 1892 births, 1922 deaths
Telmo Zarra	1921 births, 2006 deaths, Spanish footballers
Andoni Goikoetxea Olaskoaga	1956 births, Living people, Spanish footballers, Spanish football managers
Hugo Sánchez	1958 births, Living people, Mexican footballers, Mexican football managers, Sportspeople from Mexico City
Tony Adams	1966 births, 1998 FIFA World Cup players, Arsenal F.C. players, English football managers, English footballers, Living people, Members of the Order of the British Empire, Premier League players, Sportspeople from London, UEFA Euro 2000 players
Paolo Maldini	1968 births, Living people, Association football defenders, Association football full-backs, Italian footballers, Sportspeople from Milan
Alessandro Del Piero	1974 births, Living people, Italian footballers
Football League Fourth Division	English Football League, Football in England, 1958 establishments in the United Kingdom, 1992 disestablishments in Europe, 1990s disestablishments in the United Kingdom
Purchasing power	Economics
Eratosthenes	276 BC births, 194 BC deaths, Greek geographers, Ancient mathematicians, Ancient Greek astronomers
Tubule	Anatomy
Jango Fett	Star Wars characters, Fictional characters introduced in 2002, Tony Hawk's (series) guest characters
Gilf el-Kebir	Geography of Egypt, Plateaus
HBOS	Banks of the United Kingdom, 2001 establishments in the United Kingdom
Must Get Out	Maroon 5 songs, 2006 songs
Ansel Adams	1902 births, 1984 deaths, Deaths from cardiovascular disease, American photographers, Artists from San Francisco, Disease-related deaths in the United States
Dorothea Lange	1895 births, 1965 deaths, American photojournalists
Lostprophets	1990s British music groups, 1997 establishments in the United Kingdom, 2000s British music groups, 2010s British music groups, 2013 disestablishments in the United Kingdom, British heavy metal bands, Musical groups disestablished in 2013, Musical groups established in 1997, Post-grunge bands, Welsh rock bands
Racism	Racism, Hatred
Korba	Cities in India, Settlements in Chhattisgarh
Apoptosis	Cell biology
Phagocyte	Blood cells, Physiology, Immunology
FM Static	Canadian punk bands, Pop punk bands, 2000s in music, Musical groups established in 2003, 2003 establishments in Canada
Wadi	Valleys
Noble gas compound	Periodic table, Chemistry, Noble gas compounds
Vector graphics editor	Graphics software
What Are You Waiting For?	Pop punk albums, 2003 albums
Negev	Regions of Israel, Deserts of Asia, World Heritage Sites in Asia
Alfred Eisenstaedt	1898 births, 1995 deaths, German photojournalists
Petrochemical	Chemistry
Electronegativity	Chemical bonding
Linus Pauling	1901 births, 1994 deaths, Deaths from prostate cancer, Unitarians, American biochemists, Time People of the Year, American activists, American Nobel Prize winners, Writers from Portland, Oregon, Scientists from Portland, Oregon, California Institute of Technology faculty
Strabo	60s BC births, 24 deaths, Greek geographers, Ancient Greek historians
Chris Waddle	1960 births, Living people, English footballers, Sportspeople from Tyne and Wear, Premier League players
Ray Ozzie	American computer scientists, Scientists from Nebraska, Microsoft people, 1955 births, Living people
Ian Ure	Scottish footballers, Scottish football managers, Living people, 1939 births
Identity theft	Types of crime
Sensor	Sensors, Tools, Computer hardware, Data input
Victory	War, Sports
Illegal immigration	Population, Legal terms
Francisco Castro	Portuguese footballers, 1979 births, Living people
Stuart Murdoch	1954 births, Living people, English footballers
Chris Cornell	1964 births, 2017 deaths, American Eastern Orthodox Christians, Musicians from Seattle, Washington, Musicians who committed suicide, Singers from Seattle, Washington, Soundgarden, Suicides by hanging in the United States, Former Roman Catholics
Curse tablet	Occult, Ancient Greece, Ancient Rome
Kim Thayil	1960 births, Living people, American guitarists, Soundgarden, Musicians from Seattle, Washington
Matt Cameron	American drummers, Soundgarden, Musicians from San Diego, California, American rock musicians, 1962 births, Living people
Ben Shepherd	1968 births, Living people, American guitarists, Bassists, Soundgarden, Musicians from Seattle, Washington
A-Sides	Soundgarden albums, 1997 albums
Greatest hits album	Greatest hits albums
Down on the Upside	Soundgarden albums, 1996 albums
Alternative metal	Heavy metal subgenres
Halloween (franchise)	Halloween movies, Horror movies
Turkish diaspora	Turkish people
Anemoi	Greek gods and goddesses
Hit (baseball)	Baseball
Shutout (baseball)	Baseball
Fried rice	Rice dishes, Chinese food
Uniform number (American football)	American football
Flag of Pakistan	National symbols of Pakistan, National flags, Flags of Pakistan
Coat of arms of Pakistan	National symbols of Pakistan, National coats of arms
Qaumī Tarāna	National symbols of Pakistan, National anthems
Gloydius himalayanus	Reptiles of Pakistan, Vipers
Green sea turtle	Turtles
Hardella thurjii	Reptiles of Pakistan
Hydrophis ornatus	Reptiles of Pakistan
Soundgarden discography	Discographies, Soundgarden
Louder Than Love	1989 albums, Soundgarden albums
Ultramega OK	1988 albums, Debut albums, Soundgarden albums, Heavy metal albums
List of Soundgarden band members	Soundgarden, Music-related lists, Lists of entertainers
List of Soundgarden awards	Soundgarden, Music-related lists
James Milner	1986 births, Living people, English footballers, Liverpool F.C. players, Manchester City F.C. players, People from Leeds, Premier League players
Peter Osgood	1947 births, 2006 deaths, Deaths from myocardial infarction, English footballers, People from Berkshire
Trevor Francis	1954 births, Living people, English footballers, English football managers, People from Plymouth, Premier League players, Manchester City F.C. players
Sub Pop	American record labels, Seattle, Washington, 1986 establishments in the United States, 1980s establishments in Washington (state)
SST Records	American record labels, Long Beach, California
A&M Records	American record labels, Companies based in California, Seattle, Washington
Skin Yard	1980s American music groups, 1990s American music groups, Grunge bands, Musical groups from Seattle, Washington, Musical groups established in 1985, 1985 establishments in the United States, 1980s establishments in Washington (state), Musical groups disestablished in 1993, 1993 disestablishments in the United States, 1990s disestablishments in Washington (state)
Hater (band)	Soundgarden, Musical groups from Seattle, Washington, American rock bands
Wellwater Conspiracy	American rock bands, Musical groups from Seattle, Washington, Musical groups established in 1993, 1993 establishments in the United States, 1990s establishments in Washington (state), Musical groups disestablished in 2004, 2004 disestablishments in the United States, 2000s disestablishments in Washington (state)
Temple of the Dog	Soundgarden, 1980s American music groups, 1990s American music groups, 2000s American music groups, 2010s American music groups, American heavy metal bands, Grunge bands, Musical groups from Seattle, Washington, Musical groups established in 1990, Musical groups disestablished in 1992, 1990 establishments in the United States, 1990s establishments in Washington (state), 1992 disestablishments in the United States, 1990s disestablishments in Washington (state)
Bruce Pavitt	Businesspeople from Chicago, People from Washington, 1959 births, Living people
A Sound Garden	Works of art, Seattle, Washington, 1982 establishments in the United States, 1980s establishments in Washington (state)
Fopp (EP)	1988 albums, Soundgarden albums
Screaming Life	1987 albums, Soundgarden albums
Loudest Love	Soundgarden albums, 1990 albums
Screaming Life/Fopp	Soundgarden albums, 1990 albums, Compilation albums
Louder Than Live	Soundgarden albums, 1990 albums
Motorvision	Soundgarden albums, 1992 albums
Songs from the Superunknown	1995 albums, Soundgarden albums
Jason Everman	1967 births, Living people, American rock guitarists, Musicians from Alaska, Nirvana members, Soundgarden
Hiro Yamamoto	1961 births, Living people, Bassists, Musicians from Illinois, American rock guitarists
Applied mathematics	Applied mathematics
Scott Sundquist	Soundgarden, American drummers, Musicians from Washington, American heavy metal musicians, American rock musicians, Year of birth missing (living people), Living people
A-ha	1990s music groups, 2000s music groups, Musical groups disestablished in 2010, Musical groups established in 1982, Norwegian musical groups, Oslo, Pop music groups, 1982 establishments in Europe, 1980s establishments in Norway, 2010 disestablishments in Europe
Professional baseball	Baseball
Anglicisation	English language
Offensive tackle	American football positions
Jeanne Rij-Rousseau	1870 births, 1956 deaths, French painters, People from Pays de la Loire
Big Ten Conference football champions	Big Ten Conference, 1896 establishments in the United States
Napalm Death	1981 establishments in England, 1980s British music groups, 1990s British music groups, 2000s British music groups, 2010s British music groups, Death metal bands, English heavy metal bands, Musical groups established in 1981
Chuck Schuldiner	1967 births, 2001 deaths, American songwriters, American Jews, Deaths from brain cancer, Singers from Florida, Heavy metal singers
Randy Orton	1980 births, American professional wrestlers, Living people, People from Knoxville, Tennessee, Sportspeople from Tennessee
Atonement	Christian theology, Judaism
Mark Henry	1971 births, African-American wrestlers, American Olympians, American professional wrestlers, Living people, Sportspeople from Texas, Weightlifters, WWE wrestlers
Cold War Kids	American rock bands, Soul bands, Blues bands, Indie rock bands, Musical groups from California, Long Beach, California
Of Mice and Men	1937 books, 20th century American novels, English-language novels
Europe (band)	1970s Swedish music groups, 1980s Swedish music groups, 1990s Swedish music groups, 2000s Swedish music groups, 2010s Swedish music groups, Hard rock bands, Musical groups established in 1979, Swedish heavy metal bands, 1979 establishments in Sweden, Musical groups disestablished in 1992, 1990s disestablishments in Sweden, 1992 disestablishments in Europe
Samuel Goldwyn	1879 births, 1974 deaths, American Jews, American movie producers, Businesspeople from New York, People from Warsaw
Edge (wrestler)	1973 births, Canadian professional wrestlers, Canadian movie actors, Canadian television actors, Former WWE wrestlers, Living people, Sportspeople from Ontario, WWE Hall of Fame, People from Asheville, North Carolina
Book of Tobit	Books of the Bible
Forbidden City	Buildings and structures in Beijing, Palaces, Art museums, World Heritage Sites in China
List of rivers of Pakistan	Rivers of Pakistan, Lists of rivers by country, Pakistan-related lists, Lists of rivers of Asia
Book of Zechariah	Old Testament books, Books of the Hebrew Bible
Book of Zephaniah	Books of the Hebrew Bible
Song of Songs	Books of the Hebrew Bible
Book of Isaiah	Books of the Hebrew Bible
Book of Nehemiah	Books of the Hebrew Bible
Book of Obadiah	Books of the Hebrew Bible, Old Testament books
Book of Nahum	Books of the Hebrew Bible, Old Testament books
Book of Micah	Books of the Hebrew Bible, Old Testament books
Book of Joel	Books of the Hebrew Bible, Old Testament books
Book of Hosea	Books of the Hebrew Bible, Old Testament books
Book of Haggai	Books of the Hebrew Bible, Old Testament books
Book of Habakkuk	Books of the Hebrew Bible
Book of Ezra	Books of the Hebrew Bible, Old Testament books
Aberdeen railway station	Aberdeen, Transport in Scotland, 1867 establishments in the United Kingdom, 19th century establishments in Scotland
Railway stations of Aberdeen	Railway stations in Scotland, Aberdeen
Thomas Friedman	1953 births, Living people, Alumni of the University of Oxford, American columnists, Journalists from Minnesota
Mark Bosnich	1972 births, Living people, Australian footballers, Association football goalkeepers, Sportspeople from Sydney
Dario Gradi	1941 births, Living people, Italian football managers, Italian footballers
Rio Ferdinand	1978 births, Living people, English footballers, Manchester United F.C. players, Sportspeople from London, Premier League players
Jack Charlton	1935 births, 2020 deaths, Deaths from dementia, Deaths from lymphoma, English football managers, English footballers, Sportspeople from Northumberland
Billy Wright	1924 births, 1994 deaths, 1950 FIFA World Cup players, 1954 FIFA World Cup players, 1958 FIFA World Cup players, Cancer deaths in London, Deaths from stomach cancer, English footballers, English football managers, Sportspeople from Shropshire
Mick McCarthy	1959 births, Living people, Irish footballers, Irish football managers, People from South Yorkshire
Ali Daei	1969 births, Living people, Iranian footballers, Iranian football managers
Carsten Ramelow	1974 births, Living people, German footballers, Sportspeople from Berlin
Geysir	Iceland, Geysers
Lens, Pas-de-Calais	Cities in France, Communes in Pas-de-Calais, Subprefectures in France
Music recording sales certification	Music industry
List of music recording sales certifications	Music industry, Music-related lists
Canadian Recording Industry Association	Music industry, Non-profit organizations
British Phonographic Industry	Music industry, 1973 establishments in Europe, 1970s establishments in the United Kingdom
Gramophone record	Audio disc, Storage devices
Hot Mainstream Rock Tracks	Billboard charts
1959–60 NHL season	1959 in North America, 1960 in North America
Sabellianism	Christian theology
Tritheism	Theology
Book of Jeremiah	Books of the Hebrew Bible, Old Testament books
Book of Lamentations	Books of the Hebrew Bible, Old Testament books
Book of Ezekiel	Books of the Hebrew Bible, Old Testament books, Christian eschatology
Book of Daniel	Books of the Hebrew Bible, Old Testament books, Eschatology, Christian eschatology
Book of Amos	Books of the Hebrew Bible, Old Testament books
Washington Mutual	1889 establishments in the United States, 2008 disestablishments in the United States, Banks of the United States, Seattle, Washington
Gray's Anatomy	Reference works, Anatomy, 1850s books
Gray's Anatomy for Students	2004 books, Anatomy
Killing Joke	English rock bands, English punk bands, English heavy metal bands
Dave Finlay	1958 births, Living people, Former WWE wrestlers, Northern Irish sportspeople, Sportspeople from Belfast
Chris Jericho	1970 births, American professional wrestlers, Canadian professional wrestlers, Canadian movie actors, Canadian rock singers, Canadian television actors, Living people, People from Winnipeg, Singers from New York, Sportspeople from New York, WWE wrestlers
Charles Curtis	1860 births, 1936 deaths, American Methodists, Majority leaders of the United States Senate, People from Topeka, Kansas, Presidents pro tempore of the United States Senate, United States representatives from Kansas, United States senators from Kansas, US Republican Party politicians, 20th-century American politicians, 19th-century American politicians, Kansas Republicans, Deaths from myocardial infarction
Big Show	1972 births, American movie actors, American professional wrestlers, American television actors, Living people, Sportspeople from South Carolina, WWE wrestlers
Robert Guiscard	Normans, 1015 births, 1085 deaths
William A. Wheeler	1819 births, 1887 deaths, Vice Presidents of the United States, Politicians from New York, 19th-century American politicians
Schuyler Colfax	1823 births, 1885 deaths, American abolitionists, Vice Presidents of the United States, Speakers of the United States House of Representatives, Politicians from New York City, 19th-century American politicians
Henry Wilson	1812 births, 1875 deaths, American Calvinists, Congregationalists, Deaths from stroke, Politicians from New Hampshire, United States senators from Massachusetts, 19th-century American politicians
Hubert Humphrey	1960 United States presidential candidates, 1968 United States presidential candidates, 1972 United States presidential candidates, Vice Presidents of the United States, United States senators from Minnesota, US Democratic Party politicians, Deaths from bladder cancer, 1978 deaths, 1911 births, 20th-century American politicians
Alben W. Barkley	1877 births, 1956 deaths, United States representatives from Kentucky, United States senators from Kentucky, US Democratic Party politicians, 20th-century American politicians, Minority leaders of the United States Senate, Majority leaders of the United States Senate
John Nance Garner	1868 births, 1967 deaths, Deaths from natural causes, Vice Presidents of the United States, Speakers of the United States House of Representatives, Politicians from Texas, US Democratic Party politicians, 20th-century American politicians, Minority leaders of the United States House of Representatives
Thomas A. Hendricks	1819 births, 1885 deaths, Governors of Indiana, Grover Cleveland, United States representatives from Indiana, US Democratic Party politicians, 19th-century American politicians
Levi P. Morton	1824 births, 1920 deaths, Deaths from pneumonia, Vice Presidents of the United States, Governors of New York, United States representatives from Vermont, 19th-century American politicians, Businesspeople from Vermont
Garret Hobart	1844 births, 1899 deaths, Vice Presidents of the United States, Politicians from New Jersey, US Republican Party politicians, Legislative speakers, 19th-century American politicians
Charles W. Fairbanks	1852 births, 1918 deaths, Vice Presidents of the United States, Politicians from Ohio, United States senators from Indiana, US Republican Party politicians, 20th-century American politicians, 19th-century American politicians
Thomas R. Marshall	1854 births, 1925 deaths, 20th-century American politicians, American people of World War I, Deaths from myocardial infarction, Governors of Indiana, US Democratic Party politicians
Charles G. Dawes	1865 births, 1951 deaths, Burials at Rosehill Cemetery, Vice Presidents of the United States, Directors of the Office of Management and Budget, American Nobel Prize winners, Calvin Coolidge, 20th-century American politicians, Deaths from coronary thrombosis, Ambassadors of the United States to the United Kingdom
Rainulf Drengot	Normans
Gregg Gillis	1981 births, Musicians from Pittsburgh, Pennsylvania, Electronic musicians, Living people
A∴A∴	Occult, 1907 establishments in Europe, 1900s establishments in the United Kingdom
The Book of the Law	1904 books, Spiritual books
Ordo Templi Orientis	New religious movements, Secret societies, 20th-century establishments
Luther Bible	Bible versions, Protestantism in Germany, History of Germany, Martin Luther
Wycliffe's Bible	Bible versions
Jens Jeremies	1974 births, 1998 FIFA World Cup players, 2002 FIFA World Cup players, German footballers, Living people, Sportspeople from Saxony, UEFA Euro 2000 players, UEFA Euro 2004 players
Ferenc Puskás	1927 births, 2006 deaths, 1954 FIFA World Cup players, 1962 FIFA World Cup players, Deaths from pneumonia, Disease-related deaths in Hungary, Hungarian footballers, Hungarian football managers, Medalists at the 1952 Summer Olympics, Olympic gold medalists, People with Alzheimer's disease, Spanish footballers, Sportspeople from Budapest
Michel Platini	1955 births, Living people, French footballers, French football managers, Presidents of UEFA
Hidetoshi Nakata	1977 births, Living people, Footballers from Yamanashi Prefecture, Japan international footballers, J1 League players, Shonan Bellmare players, 1998 FIFA World Cup players, 2002 FIFA World Cup players, 2006 FIFA World Cup players, 2001 FIFA Confederations Cup players, 2003 FIFA Confederations Cup players, 2005 FIFA Confederations Cup players, Footballers at the 1996 Summer Olympics, Footballers at the 2000 Summer Olympics
Relient K	American rock bands, American punk bands, Pop punk bands, Christian rock bands, Musical groups from Ohio, People from Canton, Ohio, 2000s American music groups
Hieronymus Bosch	People from 's-Hertogenbosch, Dutch painters, 1450s births, 1516 deaths
Bush (band)	English rock bands, Post-grunge bands
Fell on Black Days	Soundgarden, 1994 songs
Scarborough railway station	Scarborough, North Yorkshire
Methil	Towns in Fife
Chris Brown (album)	2005 albums, Debut albums, Hip hop albums, R&B albums
Economy of Pakistan	Economy of Pakistan
National Stock Exchange of Pakistan	Stock exchanges, Economy of Pakistan, Karachi
Flora and fauna of Pakistan	Plants of Pakistan, Animals of Pakistan
Resurrection of Jesus	Gospels, Jesus Christ
Crucifixion of Jesus	Jesus Christ, Gospels
Jim Ross	1952 births, American television presenters, Living people, Sportspeople from Oklahoma, Sportspeople from California, People from Norman, Oklahoma, Restaurateurs, WWE people, WWE Hall of Fame, American bloggers
King of the Ring	World Wrestling Entertainment pay-per-view events, 1985 establishments
John Layfield	1966 births, Living people, American professional wrestlers, Sportspeople from Texas, Former WWE wrestlers, American Internet celebrities
Mary J. Blige	1971 births, Living people, American rap musicians from New York, American movie actors, African American actors, Democrats (United States), Singers from New York City, Actors from New York City
Dancing Beijing	Symbols, 2008 Summer Olympics
Exploration	Exploration
Lactobacillus	Gram-positive bacteria
Waterford United F.C.	Irish football clubs, Waterford
Montpellier HSC	French football clubs, Montpellier, 1974 establishments in Europe, 1970s establishments in France
AS Monaco F.C.	French football clubs
Olympique de Marseille	French football clubs, Marseille, 1899 establishments in France
Arsène Wenger	1949 births, Living people, French footballers, French football managers, Arsenal F.C.
John Arne Riise	1980 births, Living people, Norwegian footballers
Patrick Vieira	1976 births, Living people, Arsenal F.C. players, Manchester City F.C. players, French footballers, Senegalese footballers, French football managers, 1998 FIFA World Cup players, 2006 FIFA World Cup players, People from Dakar
David Seaman	1963 births, Living people, Arsenal F.C. players, Dancing on Ice participants, English association football goalkeepers, Manchester City F.C. players, People from South Yorkshire, Sportspeople from Yorkshire, Premier League players
Luther Blissett	1958 births, Living people, Caribbean footballers, English footballers, Jamaican sportspeople
Chinese architecture	Chinese culture, Architecture
Jimmy Greaves	1940 births, 2021 deaths, English footballers, Sportspeople from London
Eugenio Corini	1970 births, Living people, Italian footballers
Vasile Miriuţă	1968 births, Living people, Hungarian footballers
Jerzy Dudek	1973 births, Living people, Polish footballers, Association football goalkeepers
Henrik Larsson	1971 births, Living people, Swedish footballers, People from Helsingborg
Ian Wright	1963 births, Living people, Sportspeople from London, Black British sportspeople, English footballers, English television presenters, Premier League players, Arsenal F.C. players, Crystal Palace F.C. players, West Ham United F.C. players
Clyde Best	1951 births, Living people, Bermudian people, British footballers, North American footballers, Sport in Bermuda
Edgar Davids	1973 births, Living people, Dutch footballers, People from Paramaribo
Marc-Vivien Foé	1975 births, 2003 deaths, Deaths from cardiomyopathy, Cameroonian footballers
Ian Hamilton	1950 births, Living people, English footballers, Sportspeople from London
Olympique Lyonnais	French football clubs, Lyon, 1899 establishments in France
F.C. Girondins de Bordeaux	French football clubs, Bordeaux, 1880s establishments in France, 1881 establishments in Europe
Glasgow Central station	Railway stations in Scotland, Buildings and structures in Glasgow, 1879 establishments in the United Kingdom, 1870s establishments in Scotland
Mary of Teck	1867 births, 1953 deaths, Bailiffs Grand Cross of the Order of St John, Cancer deaths in England, Deaths from lung cancer, Kings and Queens consort of the United Kingdom
Marlborough House	Buildings and structures in London, Royal residences in the United Kingdom
Richmond Park	Parks in the United Kingdom, London Borough of Richmond, Royal Borough of Kingston upon Thames, London Borough of Wandsworth
Brantridge Park	Buildings and structures in England, Royal residences in the United Kingdom
Osborne House	Buildings and structures in England, Royal residences in the United Kingdom
Docetism	Christian theology
List of British Royal Residences	Royal residences in the United Kingdom, United Kingdom-related lists
Tazz	1967 births, Living people, American professional wrestlers, TNA wrestlers, Sportspeople from New York City
Lille OSC	1940s establishments in France, 1944 establishments in Europe, French football clubs, Lille
Prince Andrew, Duke of York	1960 births, Living people, House of Windsor, Knights Grand Cross of the Royal Victorian Order, Knights of the Garter, Royalty from London, United Kingdom Dukes, Elizabeth II
Jinnah International Airport	Airports in Pakistan, Karachi
Demi Lovato	1992 births, Living people, Singers from New Mexico, Writers from Albuquerque, New Mexico, Actors from Dallas, Texas, American child actors, American child singers, American television actors, Writers from Dallas, Texas, Disney actors, Musicians from New Mexico, Actors from Albuquerque, New Mexico, People with bipolar disorder, Singers from Dallas, Texas, LGBT actors, LGBT singers, LGBT musicians, LGBT writers, LGBT people from Texas, People with non-binary gender identities
Road (sports)	Sports words
Parqués	Board games
Home (sports)	Sports words
Hurricane Hugo	Category 5 Atlantic hurricanes, Hurricanes in South Carolina, Retired tropical cyclone names, Hurricanes, 1989
Jerry Lawler	1949 births, American professional wrestlers, Living people, Sportspeople from Memphis, Tennessee, WWE wrestlers, WWE Hall of Fame
We Rock (Camp Rock song)	2008 songs, Camp Rock
Turkish alphabet	Alphabets, Turkey, Turkic languages
This is Me (Demi Lovato song)	2008 songs, Camp Rock
Play My Music	2008 songs, Camp Rock
Michael	Given names
Rivaldo	1972 births, Living people, Brazilian footballers
Peter Reid	1956 births, Living people, English footballers, English football managers, Sportspeople from Liverpool, Premier League players
Mehdi Mahdavikia	1977 births, Living people, Iranian footballers, Sportspeople from Tehran
Ali Karimi	1978 births, Living people, Iranian footballers
Ray Harford	1945 births, 2003 deaths, English footballers, English football managers, People from West Yorkshire
John Welsh	1984 births, Living people, English footballers, People from Liverpool
José Luis Chilavert	1965 births, Living people, Paraguayan footballers, Association football goalkeepers
Erik Nevland	Norwegian footballers, 1977 births, Living people
Bill Shankly	1913 births, 1981 deaths, Scottish footballers, Scottish football managers
Billy McNeill	1940 births, 2019 deaths, Deaths from dementia, Members of the Order of the British Empire, Scottish footballers, Scottish football managers, Scottish writers
Edmundo Alves de Souza Neto	1971 births, Living people, Brazilian footballers
Adrian Mutu	1979 births, Living people, Romanian footballers
David Moyes	Scottish football managers, Scottish footballers, 1963 births, Living people
Gérard Houllier	1947 births, 2020 deaths, Association football midfielders, Deaths from surgical complications, French footballers, French football managers
Waggle dance	Animal communication, Bees
Jim McLean	1937 births, 2020 deaths, Deaths from dementia, Scottish football managers, Scottish footballers
German Grand Prix	Formula One Grands Prix
Hockenheimring	Formula One circuits, 1932 establishments in Europe, 1930s establishments in Germany
Singapore Grand Prix	Events in Singapore, Formula One Grands Prix, Sport in Singapore
Morrissey	1959 births, Living people, English rock singers, English singer-songwriters, Lyricists, Musicians from Manchester, People with cancer, The Smiths members
Hernando de Soto Polar	1941 births, Living people, People from Lima, Economists, Peruvian politicians
Belgian Grand Prix	Formula One Grands Prix
Hernando de Soto	1490s births, 1542 deaths, Spanish explorers, People from Extremadura
Circuit de Monaco	Formula One circuits, Monte Carlo
Dutch Grand Prix	Formula One Grands Prix
United States Grand Prix	Formula One Grands Prix
Spanish Grand Prix	Formula One Grands Prix
Canadian Grand Prix	Formula One Grands Prix
Anantnag District	Districts of Jammu and Kashmir
Pakistan International Airlines	Airlines of Asia, Karachi, National symbols of Pakistan, Transport in Pakistan
Islamabad International Airport	Airports in Pakistan
International Air Transport Association	Aviation
Indian Sign Language	Sign languages, Languages of India, Languages of Pakistan
1935–36 NHL season	1935 in North America, 1936 in North America
Coppins	Royal residences in the United Kingdom
Bagshot Park	Royal residences in the United Kingdom
Balmoral Castle	Royal residences in the United Kingdom, Castles in Scotland
Beech	World Heritage Sites, Fagales
Fagales	Fagales
Bioethics	Medicine, Ethics
Caricaceae	Plant families, Brassicales
Pollen	Flowers, Plant anatomy
We Ski	Wii games, Wii-only games, 2008 video games
Denison, Texas	Cities in Texas, 1872 establishments in the United States, 1870s establishments in Texas
Mentha	Lamiaceae, Herbs
Lamiales	Lamiales
Lamiaceae	Lamiaceae
Nepeta	Lamiaceae
Garden angelica	Apiaceae
Rosemary	Herbs, Lamiaceae
Liquorice	Faboideae, Spices
Faboideae	Faboideae
Galegeae	Faboideae
Glycyrrhiza	Faboideae, Medicinal plants
Cumin	Apiaceae, Spices
Savory (herb)	Lamiaceae, Herbs
Superchunk	American rock bands, American punk bands, Indie rock bands, Musical groups from North Carolina
Semi-automatic firearm	Firearms
Semi-automatic rifle	Rifles
Bolt action	Firearms
Trigger (firearms)	Firearm components
Diatomic molecules	Stereochemistry
Fragile Future	2008 albums, Hawthorne Heights albums
Dundalk	County towns in Ireland, County Louth
County Louth	County Louth
Robot Chicken	2005 American television series debuts, 2000s American comedy television series, 2000s satirical television series, 2010s American comedy television series, 2010s satirical television series, Adult Swim, American animated television series, American satirical television series, English-language television programs
Victor Hammer (businessman)	1901 births, 1985 deaths, People from New York City, American philanthropists
MySims	2007 video games, Nintendo DS games, Windows games, The Sims, Wii games
The Sun (United Kingdom)	1964 establishments in the United Kingdom, Newspapers published in the United Kingdom, English-language newspapers
M2 Browning	Heavy machine guns, Machine guns of the United States
Stealth technology	Aircraft
Pakistan Peoples Party Parliamentarians	Political parties in Pakistan
Bangladesh Nationalist Party	Political parties in Bangladesh, Nationalist organizations in Bangladesh
Rosmarinus	Lamiaceae
Apiales	Asterids
Apiaceae	Apiaceae
Angelica	Apiaceae, Herbs
Blephilia	Lamiaceae
Ballota	Lamiaceae
Agastache	Lamiaceae, Herbs, Medicinal plants
Acrocephalus (plant)	Lamiaceae
Acinos	Lamiaceae
Acanthomintha	Lamiaceae
Franz von Papen	1879 births, 1969 deaths, Chancellors of the Weimar Republic, Ambassadors of Germany, German military personnel of World War I, German Roman Catholics, Government ministers of Nazi Germany, Majors, Members of the Reichstag (Nazi Germany), Members of the Reichstag (Weimar Republic), Prime Ministers of Prussia, Politicians from North Rhine-Westphalia, Politicians of the Nazi Party, Vice Chancellors of Germany
Lemon balm	Lamiaceae, Herbs
Bronchitis	Health problems, Respiratory system
Kashmiri people	Ethnic groups in India
Hastings	Towns in East Sussex
Malvern College	Schools in England, 1865 establishments in England
UN peacekeeping missions involving Pakistan	Pakistan
Pakistan Army	Military of Pakistan, Armies
Web of the City	1958 books, Books by Harlan Ellison, Brooklyn in fiction
Pakistani military	Military of Pakistan
Pakistan Navy	Navies, Military of Pakistan
Spider Kiss	1961 books, Books by Harlan Ellison, English-language novels
Pakistan Air Force	Air forces, Military of Pakistan
The Vines	Australian alternative rock bands, Post-grunge bands, Musical groups from Sydney
The Libertines	1997 establishments in England, 2004 disestablishments in the United Kingdom, 1990s British music groups, 2000s British music groups, English rock bands, Musical groups established in 1997, Musical groups from London
The Hives	Swedish rock music groups, Punk bands
Interpol (band)	1997 establishments in the United States, 1990s American music groups, 2000s American music groups, 2010s American music groups, American rock bands, Musical groups established in 1997, Musical groups from New York City
Editors	English rock bands
A Clash of Kings	A Song of Ice and Fire, 1998 books, 20th century American novels, Fantasy books
A Storm of Swords	A Song of Ice and Fire, 2000 books
A Feast for Crows	A Song of Ice and Fire, 2005 books, 21st century American novels, Fantasy books
Zest (ingredient)	Food ingredients, Citrus
Paprika	Spices
Clove	Myrtaceae, Spices, Indonesia, Herbs, Medicinal plants
Myrtales	Myrtales
Myrtaceae	Myrtaceae
Government of Pakistan	Government of Pakistan
Syzygium	Myrtaceae
Junoon (band)	Rock bands, Pakistani entertainers
Transportation in Pakistan	Transport in Pakistan
List of companies based in Tulsa, Oklahoma	Tulsa, Oklahoma, Oklahoma-related lists
ONEOK	Tulsa, Oklahoma, 1906 establishments in the United States, 1900s establishments in Oklahoma Territory
Ashley Force	1982 births, Living people, American racecar drivers, Yorba Linda, California, Sportspeople from California
Cottontail rabbit	Lagomorphs, Mammals of North America, Mammals of South America
Selhurst Park	Football stadiums in London
Zack de la Rocha	1970 births, Living people, Singers from California, People from Long Beach, California
Fire triangle	Fire
Modus ponens	Rules of inference
Angelo State University	Colleges and universities in Texas, 1928 establishments in the United States, 1920s establishments in Texas
Nicaragua	Nicaragua, Spanish-speaking countries
Battle of the Bands	Music competitions
Lalon Shah Bridge	Buildings and structures in Bangladesh, Bridges
Charlotte Moore Sitterly	1898 births, 1990 deaths, American astronomers, Scientists from Pennsylvania
Widzew Łódź	Polish football clubs, Łódź, 1910 establishments in Europe, 20th century establishments in Poland
Palestinian territories	Palestinian territories, Palestine
West Indies Federation	Former countries in North America, 1958 establishments in North America, 1962 disestablishments, 20th century disestablishments in North America
A Little Bit Longer	2008 albums
A Little Bit Longer (song)	2008 songs
Antioxidant	Health, Chemical processes
Marshmallow	Desserts
Coen brothers	American movie directors, Living people, American Jews, Writers from Minneapolis, Minnesota, Academy Award winning directors
Find a Way (song)	Rock songs, 1998 songs
The Picture of Dorian Gray	1890 books, British novels, Horror novels, English-language novels
The Little Red Book	Non-fiction books, China
Scouting for Boys	1908 books, Non-fiction books, Scouting
Wii Sports Resort	2009 video games, Wii games, Sports video games
Wii Chess	2008 video games, Wii games
Naked Lunch	Beat Generation
On the Road	Beat Generation, English-language novels, American novels
William Faulkner	1897 births, 1962 deaths, Writers from Mississippi, Pulitzer Prize winners, American Nobel Prize winners
Arthur Miller	1915 births, 2005 deaths, American atheists, American playwrights, Cardiovascular disease deaths in the United States, Deaths from heart failure, Jewish American writers, Jewish atheists, Pulitzer Prize winners
Oral sex	Human sexuality
Clyde F.C.	Scottish football clubs, North Lanarkshire, 1877 establishments in Scotland
Jouke de Vries	1960 births, Living people, Dutch columnists, Dutch political scientists, Writers from Friesland
Dundee F.C.	Scottish Premier League clubs, Dundee, 1893 establishments in the United Kingdom, 1890s establishments in Scotland
Siamang	Apes, Mammals of Asia
Caroline Unger	1803 births, 1877 deaths, Singers from Vienna, Contraltos, European opera singers
Jeremias Gotthelf	1797 births, 1854 deaths, Swiss writers
CBBC	BBC television channels
Brisingr	Inheritance Cycle, 2008 books, American novels, English-language novels, Fantasy books
Mermaid	Mythology
University of Edinburgh	Universities in the United Kingdom, Edinburgh, 1583 establishments, 1580s establishments in Europe, Establishments in Scotland
Inheritance Cycle	Inheritance Cycle
Continental Congress	18th century in Philadelphia, Legislatures, 1770s in Pennsylvania, Legislative branch of the United States government
Take This to Your Grave	2003 albums, Fall Out Boy albums, Fall Out Boy
Stephen Guernsey Cook Ensko	1896 births, 1969 deaths, Businesspeople from New York City
Will Turner	Pirates of the Caribbean characters
Jack Sparrow	Pirates of the Caribbean characters
Elizabeth Swann	Pirates of the Caribbean characters
Tom Hollander	1967 births, Living people, English movie actors, English stage actors, English television actors, Musical theater actors
Jack Davenport	1973 births, Living people, Actors from London, English movie actors, English television actors
Yulia MacLean	1986 births, Living people, Contraltos, Russian singers, New Zealand singers, Volgograd
Tia Dalma	Pirates of the Caribbean characters
Shasta Dam	Dams in the United States, Buildings and structures in California, Shasta County, California
Herman Melville	1819 births, 1891 deaths, 19th-century American novelists, 19th-century American poets, Writers from New York City
Martin Heidegger	1889 births, 1976 deaths, 20th century philosophers, German academics, German philosophers, Nazis, People from Baden-Württemberg
Parmenides	Presocratic philosophers
Democritus	Presocratic philosophers
Leucippus	Presocratic philosophers, 5th century BC births, 5th century BC deaths
Olympus	Biosphere reserves, Balkan Mountains, Mountains of Greece, Greek mythology
Kate (text editor)	KDE
Ronald David Laing	1927 births, 1989 deaths, Psychiatrists, Scottish people
Alcoholic drink	Alcoholic drink
Hapoel asi gilboa	Israeli football clubs
Amy Lee	Singer-songwriters from California, American pianists, Grammy Award winners, Singers from Arkansas, Mezzo-sopranos, 1981 births, Living people, Evanescence
Wild Dances	2004 songs, Eurovision Song Contest
Rocket-propelled grenade	Explosives
Tibetan Plateau	Geography of China, Plateaus
Heraclitus	Presocratic philosophers
Thales	Presocratic philosophers
Hardancourt	Communes in Vosges
Anaximander	610 BC births, 546 BC deaths, Presocratic philosophers
Anaximenes of Miletus	585 BC births, 525 BC deaths, Presocratic philosophers
Eberhardt del’Antonio	German writers, 1926 births, 1997 deaths
Gorgias	Philosophers, Presocratic philosophers, 5th century BC births, 4th century BC deaths
Sophism	Philosophy
Protagoras	Presocratic philosophers, Philosophers, 5th century BC births, 5th century BC deaths
Joshamee Gibbs	Pirates of the Caribbean characters
Pirate code	Piracy, Ethics
Hallelujah (Leonard Cohen song)	1984 songs, Leonard Cohen songs, Rock songs, Songs written by Leonard Cohen
Islamic State of Afghanistan	History of Afghanistan
Leonard Cohen	1934 births, 2016 deaths, Accidental deaths from falls in the United States, Canadian Jews, Canadian novelists, Canadian singer-songwriters, Cancer deaths in Los Angeles, Deaths from leukemia, Folk musicians, Folk singers, Jewish musicians, Jewish writers, Leonard Cohen, Musicians from Montreal, People from Westmount, Quebec, Canadian poets, Rock musicians, Rock singers, Writers from Montreal
Jeff Buckley	Accidental deaths by drowning in the United States, American folk musicians, American guitarists, American rock musicians, Musicians from California, Singers from California, 1966 births, Former Roman Catholics, 1997 deaths
Stigmata	Stigmata
Flag of Turkmenistan	Turkmenistan
Philolaus	Presocratic philosophers
Coat of arms of Turkmenistan	Turkmenistan, National coats of arms
Pre-Socratic philosophy	Presocratic philosophy
Milesian school	Presocratic philosophy
Pythagoreanism	Philosophical movements and positions
Anaxagoras	500 BC births, 428 BC deaths, Presocratic philosophers
Miletus	Settlements in Turkey
Tooth fairy	Folklore
893	893
Frederick I, Holy Roman Emperor	1122 births, 1190 deaths, Holy Roman Emperors
1036	1036
BBC Weather	BBC Online, Weather services
Cheap Trick	1973 establishments in the United States, 1970s American music groups, 1970s establishments in Illinois, 1980s American music groups, 1990s American music groups, 2000s American music groups, 2010s American music groups, American hard rock bands, American pop music groups, American rock bands, Musical groups established in 1973, Musical groups from Illinois, Rockford, Illinois, Warner Bros. Records artists
Strychnine	Poisons, Chemical compounds, Toxicology
Alkaloid	Chemical compounds, Biochemistry
Quinine	Chemical compounds, Drugs
Progressive bluegrass	Music genres
Hot Country Songs	Record charts
Neverland	Fictional locations
International Bluegrass Music Association	Music industry
Country Music Association Awards	Music awards
The Used	2000s American music groups, 2010s American music groups, American rock bands, Post-hardcore bands, Emo bands, Musical groups from Utah, 2000 establishments in the United States, Musical groups established in 2000, 20th-century establishments in Utah
Bobo-Dioulasso	Bobo Dioulasso
Koudougou	Cities in Burkina Faso
Banfora	Cities in Burkina Faso
Ouahigouya	Cities in Burkina Faso
Chirality	Stereochemistry
Londrina	Cities in Paraná State
Kaya	Cities in Burkina Faso
Superimposition	Graphics, Printmaking
Maringá	Cities in Paraná State
Tenkodogo	Cities in Burkina Faso
Fada N'gourma	Cities in Burkina Faso
Ponta Grossa	Cities in Paraná State
Dédougou	Cities in Burkina Faso
Houndé	Cities in Burkina Faso
Foz do Iguaçu	Cities in Paraná State
Cascavel	Cities in Paraná State
Julen Guerrero	1974 births, Living people, Spanish footballers
Emile Heskey	1978 births, Living people, 2002 FIFA World Cup players, 2010 FIFA World Cup players, Aston Villa F.C. players, Black British sportspeople, Liverpool F.C. players, Sportspeople from Leicester
Jan Koller	1973 births, Living people, Czech footballers
Rüştü Reçber	1973 births, Living people, Turkish footballers, Association football goalkeepers
William Regal	1968 births, Living people, WWE wrestlers, English professional wrestlers
Bryan Robson	1957 births, Living people, English footballers, English football managers, Manchester United F.C. players, Sportspeople from County Durham, Premier League players
Robbie Fowler	1975 births, Living people, English footballers, English football managers, Sportspeople from Liverpool, Premier League players
Hernán Crespo	1975 births, Living people, Argentine footballers
Kevin Keegan	1951 births, Living people, English footballers, English football managers, England national football team managers, People from South Yorkshire
Bob Holly	American professional wrestlers, Sportspeople from California, 1963 births, Living people, People from Glendale, California
Raúl González	1977 births, Living people, Spanish footballers, Sportspeople from Madrid
Luís Figo	1972 births, Living people, Portuguese footballers
Rudi Völler	1960 births, Living people, German football managers, German footballers, People from Hanau, Sportspeople from Hesse
Freddy Adu	1989 births, Living people, American footballers, Ghanaian people
Eamon Dunphy	1945 births, Living people, Irish footballers, Sportspeople from Dublin
Murat Yakin	1974 births, Living people, Swiss footballers, Swiss football managers, Sportspeople from Basel
Salmonella	Gram-negative bacteria
Paul Sturrock	1956 births, Living people, Scottish footballers, Scottish football managers
Avi Ran	1963 births, 1987 deaths, Association football goalkeepers, Israeli footballers, Jewish Israeli sportspeople
Mark Viduka	1975 births, Living people, Australian footballers, Sportspeople from Melbourne
Baichung Bhutia	1976 births, Living people, Indian footballers
Matthew Le Tissier	1968 births, Living people, English footballers, Guernsey
Amarok (software)	KDE
Ignoratio elenchi	Figures of speech, Logical fallacies
Informal fallacy	Logical fallacies, Critical thinking
Great Western Railway	Rail transport in Great Britain, Defunct railway companies of the United Kingdom, 1833 establishments, 1948 disestablishments in the United Kingdom, 1830s establishments in the United Kingdom
Stimulant	Chemistry, Drugs
Benzylpiperazine	Drugs
Turkish new lira	Turkish currency
Oedipus	Ancient Greece, Incest in fiction, Mythology
Gundam	Anime
Self-injury	Psychology
Guildford	Towns in Surrey, County towns in England
Socratic method	Human communication, Philosophy
Bill Maher	1956 births, Living people, American stand-up comedians, American political commentators, American television talk show hosts, Actors from New York City, American movie actors, American television actors, Comedians from New York City
Friedrich Hund	1896 births, 1997 deaths, German academics, German physicists, People from Karlsruhe
Ubuntu Live USB creator	Linux software
Shigella	Gram-negative bacteria
Puppet	Puppets
Paranthropus	Australopithecines
Lake Toba	Geography of Indonesia
Fatimah Jinnah Park	Islamabad, Parks in Pakistan
Hazratbal Shrine	Mosques in India, Srinagar
Jama Masjid, Srinagar	Mosques in India, Srinagar, 1394 establishments, 14th century establishments in India
Dachigam National Park	National parks in India
Hemis National Park	National parks in India
Kishtwar National Park	National parks in Pakistan
Salim Ali National Park	National parks in Pakistan
Ulysses (spacecraft)	NASA spacecraft, ESA spacecraft
Dual-tone multi-frequency	Telephone
Equilibrioception	Sensory system, Health, Fitness
Violence in ice hockey	Ice hockey
Gerard K. O'Neill	1927 births, 1992 deaths, American physicists, Cornell University alumni, Scientists from New York City
Rosary	Roman Catholicism
Kazakh language	Languages of Asia
Dunfermline Athletic F.C.	Scottish football clubs, 1885 establishments in the United Kingdom, 1880s establishments in Scotland
Greenock Morton F.C.	Scottish football clubs, 1874 establishments in Scotland
Livingston F.C.	Scottish football clubs, 1943 establishments in Europe, 1940s establishments in Scotland
Queen of the South F.C.	Scottish football clubs, 1919 establishments in the United Kingdom, 20th century establishments in Scotland
Ross County F.C.	Scottish Premier League clubs, 1929 establishments in Europe, 1920s establishments in Scotland
Irn-Bru	Soft drinks
Scottish Football League First Division	Scottish Football League, 1890 establishments in the United Kingdom, 1890s establishments in Scotland
Rain gauge	Measuring tools
Zürich S-Bahn	Rapid transit systems, Zürich, Transport in Switzerland
Thousand Foot Krutch	2000s music groups, 1990s music groups, Christian music bands, Canadian rock bands, Nu metal bands
Rosh Hashanah	Jewish festivals and holidays
Mass noun	Grammar
Dianthus	Caryophyllaceae
American Dream	American culture
Jason Upton	1973 births, Living people, Singers from Minneapolis, Minnesota, American singer-songwriters, Christian music singers
Richard Dean Anderson	1950 births, Living people, American movie actors, American television actors, Actors from Minneapolis, Minnesota, Ohio University alumni
Michael Shanks	1970 births, Canadian movie actors, Canadian television actors, Living people, People from Vancouver
Mycobacterium leprae	Gram-positive bacteria
Smells Like Teen Spirit	1991 songs, Nirvana songs
Mycobacterium tuberculosis	Gram-negative bacteria
Billabong (clothing)	Companies of Australia, Clothing companies
George Sand	1804 births, 1876 deaths, Feminists, French novelists, Writers from Paris, Pen names, French autobiographers, French culture, French feminists, French journalists, French literature, French nobility, French people, French playwrights, French socialists, French writers, LGBT writers, People from Centre-Val de Loire, People from Paris, Political activists
Type 23 frigate	British warships, Military of Chile
Nuremberg Laws	History of Germany, Legislation
Thrice	American rock bands, Musical groups from California, Irvine, California, Musical groups established in 1998, 1998 establishments in California, Musical groups disestablished in 2012, 2012 disestablishments in the United States, 2010s disestablishments in California
Sidewalk	Transport infrastructure
BMW	BMW, Companies listed on the DAX, 1916 establishments in Europe, 1910s establishments in Germany
Mazda	Automobile companies of Japan, Hiroshima, 1920 establishments in Asia, 1920s establishments in Japan
Itapema	Cities in Santa Catarina
Animal testing	Animal rights
Campylobacter	Gram-negative bacteria, Diseases caused by bacteria
Emperor Taishō	Emperors of Japan, 1879 births, 1926 deaths, People from Kyoto Prefecture
Emperor Meiji	Emperors of Japan, People from Kyoto Prefecture, 1852 births, 1912 deaths
Trivium (band)	1990s American music groups, 2000s American music groups, 2010s American music groups, American heavy metal bands, Thrash metal bands, Metalcore bands, Musical groups from Orlando, Florida, Musical groups established in 1999, 1999 establishments in the United States, 1990s establishments in Florida
Emily Browning	1988 births, Living people, Australian movie actors, Actors from Melbourne, Australian child actors
Trivium (liberal arts)	Middle Ages, Liberal arts, Cultural history
Ancient Greek boxing	Ancient Greece, Boxing
London School of Economics	1895 establishments in England, City of Westminster, Colleges and universities in London
Friedrich Hayek	1899 births, 1992 deaths, Austrian Nobel Prize winners, British academics, British economists, British Nobel Prize winners, British philosophers, Companions of Honour, Liberals, Libertarians, Naturalised citizens of the United Kingdom, Scientists from Vienna
Ancient Olympic Games	Olympic Games
Manhattan (movie)	1979 comedy movies, 1979 drama movies, 1970s comedy-drama movies, 1970s LGBT movies, 1970s romantic drama movies, American comedy-drama movies, American LGBT movies, American romantic comedy movies, American romantic drama movies, BAFTA Award winners, English-language movies, Movies directed by Woody Allen, Movies set in New York City, Screenplays by Woody Allen, United States National Film Registry movies
Match Point	2005 crime movies, 2005 drama movies, 2000s crime drama movies, 2000s crime thriller movies, Adultery in movies, British crime drama movies, British thriller movies, American crime drama movies, American thriller movies, Irish movies, Luxembourgian movies, French crime movies, French drama movies, French thriller movies, English-language movies, Movies about murderers, Movies directed by Woody Allen, Movies set in London
Punching bag	Sports equipment, Martial arts
Nocera Inferiore	Towns in Italy, Settlements in Campania
Nevado del Ruiz	Andes, Volcanoes of South America, Geography of Colombia
Tao	Taoism, Confucianism
Vitaceae	Plant families, Vitaceae
Vitis	Vitaceae
Smiley Smile	The Beach Boys albums, 1967 albums, Rock albums, Pop albums
Sulfur dioxide	Sulfur compounds, Oxides
Foreign policy	International relations
Dolná Krupá	Villages in Slovakia
Little Carpathians	Mountain ranges of the Carpathians, Mountains of Austria, Geography of Slovakia
Danubian Hills	Mountains of Europe, Geography of Slovakia
Human nature	Psychology, Humans
Krupá River	Rivers of Slovakia
Belly dance	Dances
Atreyu	American heavy metal bands, Metalcore bands, Musical groups from California, Roadrunner Records, Yorba Linda, California, Musical groups established in 1998, 1998 establishments in California, Musical groups disestablished in 2012, 2012 disestablishments in the United States, 2010s disestablishments in California
Michael Laudrup	1964 births, Living people, Danish footballers, Danish football managers
Clive Charles	1951 births, 2003 deaths, English footballers, Sportspeople from London
Paul Gascoigne	1967 births, 1990 FIFA World Cup players, English autobiographers, English footballers, English football managers, Living people, People with bipolar disorder, Sportspeople from County Durham, Sportspeople from Tyne and Wear, Tottenham Hotspur F.C. players, Premier League players
Marcel Desailly	1968 births, Living people, French footballers, People from Accra
Vinnie Jones	Celebrity Big Brother contestants, English footballers, English movie actors, English television actors, 1965 births, Living people, Premier League players, Actors from Hertfordshire, Sportspeople from Hertfordshire, People from Watford
Peter Schmeichel	Danish footballers, Association football goalkeepers, Manchester City F.C. players, Manchester United F.C. players, Strictly Come Dancing participants, 1963 births, Living people
Peter Shilton	1949 births, 1982 FIFA World Cup players, 1986 FIFA World Cup players, 1990 FIFA World Cup players, English football managers, English association football goalkeepers, Living people, Officers of the Order of the British Empire, Sportspeople from Leicester, Strictly Come Dancing participants, West Ham United F.C. players
Chris Coleman	1970 births, Living people, Welsh footballers, Welsh football managers, People from Swansea, Crystal Palace F.C. players
Marcus Hahnemann	1972 births, Living people, American footballers, Sportspeople from Seattle, Washington, Association football goalkeepers
Kit Symons	1971 births, Living people, English footballers, Welsh footballers, English football managers, Welsh football managers, People from Basingstoke, Sportspeople from Hampshire, Premier League players, Crystal Palace F.C. players, Manchester City F.C. players
Tim Howard	1979 births, Living people, American footballers, Sportspeople from New Jersey, Association football goalkeepers
Marcelo Salas	1974 births, Living people, Chilean footballers, People from La Araucanía Region
Duncan Edwards	1936 births, 1958 deaths, Aviation deaths, English footballers, Manchester United F.C. players, Sportspeople from Worcestershire
Roger Milla	1952 births, Living people, Cameroonian footballers
Toni Turek	1919 births, 1984 deaths, German association football goalkeepers, People from Duisburg, Sportspeople from North Rhine-Westphalia
Arthur, Prince of Wales	1486 births, 1502 deaths, House of Tudor
Farah River	Rivers of Afghanistan
Asuwa River	Rivers of Japan
Sagami River	Rivers of Japan
American Museum of Natural History	Museums in New York City, 1869 establishments in the United States, 1860s establishments in New York (state), Buildings and structures in Manhattan, New York City Designated Landmarks, Natural history museums
Janis Joplin	1943 births, 1970 deaths, American rock singers, American rock guitarists, Singer-songwriters from Texas, Drug-related accidental deaths in the United States, Mezzo-sopranos, Bisexual people
Ukulele	Plucked string instruments
Gary Glitter	1944 births, Living people, British prisoners, British sex offenders, Buddhists, Child sexual abusers, English criminals, English rock musicians, English singers, Musicians from Oxfordshire, Operation Yewtree, Vegetarians
Rick Astley	1966 births, Living people, English pop musicians, English singers, Musicians from Merseyside, Rick Astley
Swallows and Amazons (series)	Series of books, Children's books
Rick Astley discography	Rick Astley, Discographies
Arthur Ransome	1884 births, 1967 deaths, English writers, British journalists
Never Gonna Give You Up	Rick Astley songs, 1987 songs
Stanley Cup playoffs	Stanley Cup playoffs, National Hockey League, Stanley Cup
Deepak Chopra	1946 births, Living people, Indian writers, Physicians, HuffPost writers and columnists, People from New Delhi
Prime Minister of Israel	Lists of Israeli people, Lists of prime ministers, Prime Ministers of Israel
Abukuma River	Rivers of Japan
Agano River	Rivers of Japan
Arakawa River	Rivers of Japan
Chikugo River	Rivers of Japan
The Replacements (band)	American rock bands, American punk bands, Musical groups from Minnesota, Musicians from Minneapolis, Minnesota
Fuji River	Rivers of Japan
Hino River	Rivers of Japan
Jinzū River	Rivers of Japan
Uono River	Rivers of Japan
Ibi River	Rivers of Japan
Steely Dan	American rock bands, Jazz bands, Pop rock bands, Musical groups from New York
Mastodon (band)	American heavy metal bands, Musical groups from Atlanta, Georgia, Musical groups established in 2000, 2000 establishments in the United States, 2000s establishments in Georgia (U.S. state)
Tony Chimel	Living people, WWE people, People from New Jersey, People from Pennsylvania
Latin alphabet in Turkic countries	Latin alphabet, Turkey, Kazakhstan
Listeria	Gram-positive bacteria
American Eagle Outfitters	American clothing companies, 1977 establishments in the United States, 1970s establishments in Pennsylvania
Church of Scotland	Presbyterianism, Establishments in Scotland, 1560s establishments in Europe, 1560 establishments
Malcolm Young	1953 births, 2017 deaths, AC/DC, Deaths from dementia, Australian guitarists, Musicians from Glasgow, Musicians from Sydney, Australian songwriters, Australian rock musicians
A & C Black	Publishing companies of the United Kingdom, Book publishing companies, 1807 establishments, 1800s establishments in the United Kingdom
Lush	English pop music groups, Musical groups from London
Disturbed	1994 establishments in Illinois, 1990s American music groups, 2000s American music groups, 2010s American music groups, American heavy metal bands, Musical groups established in 1994, Musical groups from Chicago
Survivor (band)	1978 establishments in the United States, 1970s American music groups, 1970s establishments in Illinois, 1980s American music groups, 1990s American music groups, 2000s American music groups, 2010s American music groups, American rock bands, Grammy Award winners, Musical groups established in 1978, Musical groups from Chicago
Herne Bay	Towns in Kent
Murten	Cities in Switzerland, Municipalities of Fribourg, Imperial free cities
NOT gate	Logic gates
Paul Breitner	1951 births, Living people, German footballers, Sportspeople from Bavaria
Bobby Convey	1983 births, Living people, American footballers, Sportspeople from Philadelphia, Pennsylvania
Bruce Arena	1951 births, Living people, American footballers, American football managers, Sportspeople from New York City, Association football goalkeepers, Cornell University alumni
Jimmy Glass	1973 births, Living people, English association football goalkeepers, Sportspeople from Surrey
Miklós Fehér	1979 births, 2004 deaths, Deaths from cardiomyopathy, Hungarian footballers
Åge Hareide	1953 births, Living people, Norwegian footballers
Moussa Hojeij	1974 births, Living people, Lebanese footballers, People from Beirut, Football managers
Paul Mariner	1953 births, 2021 deaths, Deaths from brain cancer, English footballers, Sportspeople from Lancashire, English football managers
Reculver	Towns in Kent
Whitstable	Towns in Kent, Ports and harbours of the United Kingdom
Herne, Kent	Villages in Kent
Pier	Transport buildings and structures
CM Punk	1978 births, American atheists, American mixed martial artists, American professional wrestlers, Former WWE wrestlers, Living people, Sportspeople from Chicago, Total Nonstop Action Wrestling alumni
Charlie Haas	1972 births, American Christians, American professional wrestlers, Living people, Sportspeople from Houston, Texas, Former WWE wrestlers
Impossible object	Illusions, Art
Van Halen	1970s American music groups, 1980s American music groups, 1990s American music groups, 2000s American music groups, 2010s American music groups, Grammy Award winners, American hard rock bands, American heavy metal bands, Musical groups from California, Pasadena, California, Musical groups established in 1972, 1972 establishments in California, Warner Bros. Records artists
Alliance for the Future of Austria	Political parties in Austria
Idealism	Philosophical movements and positions, Reality
Empiricism	Epistemology, Philosophical movements and positions
Stoicism	Philosophical concepts
William Godwin	1756 births, 1836 deaths, English philosophers, English journalists, Anarchists
Rose garden	Agriculture, Roses, Gardening
Peter Kropotkin	Anarchists, Russian writers, 1842 births, 1921 deaths
Anarcho-communism	Communism, Anarchism
Johann Baptist Martinelli	1701 births, 1754 deaths, Austrian architects, People from Vienna
Agorism	Anarcho-capitalism, Libertarianism
Anton Pius Riegel	1789 births, 19th century deaths, Austrian architects, Year of death unknown
Hesperomannia arbuscula	Asteraceae
Eureka Tower	Buildings and structures in Melbourne, Skyscrapers in Australia, 2006 establishments in Australia
Tay Zonday	1982 births, Living people, Singers from Minneapolis, Minnesota, American Internet celebrities
Antoine Dufour	1979 births, Canadian guitarists, Folk musicians, Living people, Musicians from Quebec
Vheissu	2005 albums
The Artist in the Ambulance	2003 albums
Chuck Palumbo	1971 births, American professional wrestlers, Living people, People from West Warwick, Rhode Island, Sportspeople from Rhode Island
Vince J. McMahon	1914 births, 1984 deaths, Businesspeople from New York City, Deaths from pancreatic cancer, WWE people, WWE Hall of Fame
René Adler	1985 births, Living people, German association football goalkeepers, Sportspeople from Saxony
Kreator	1980s establishments in Germany, 1980s German music groups, 1990s German music groups, 2000s German music groups, 2010s German music groups, Essen, German heavy metal bands, Musical groups established in 1982, Thrash metal bands
Gojira	Death metal bands
Colin Barnett	1950 births, Living people, Premiers of Western Australia, People from Perth, Western Australia, Liberal Party of Australia politicians
Nathan Rees	1968 births, Living people, Premiers of New South Wales, Politicians from Sydney, Australian Labor Party politicians
Anna Bligh	1960 births, Living people, Premiers of Queensland, Australian Labor Party politicians
Mike Rann	1953 births, Living people, Premiers of South Australia, People from Adelaide, Australian Labor Party politicians
David Bartlett	Premiers of Tasmania, People from Hobart, 1968 births, Living people, Australian Labor Party politicians
John Brumby	1953 births, Living people, Premiers of Victoria, Politicians from Melbourne, Australian Labor Party politicians, Australian educators
Quentin Bryce	1942 births, Living people, Australian lawyers, Governors of Queensland, Australian Governors-General, Politicians from Brisbane, Knights of Grace of the Order of St John, Order of Australia
Crich Tramway Village	Derbyshire, Tram transport in the United Kingdom, Open air museums, Museums in England
Blue-baby syndrome	Syndromes
Kings of Leon	American rock bands, Musical groups from Oklahoma
Plaster	Materials
Minaret	Architectural elements, Islamic architecture
Omi	History of Japan, Japanese language
Mining feasibility study	Mining
Free market	Economic markets, Libertarianism
Quba Mosque	Mosques in Saudi Arabia, Religion in Saudi Arabia
Alan Carpenter	1957 births, Living people, Premiers of Western Australia, Australian Labor Party politicians
Geoff Gallop	1951 births, Living people, Premiers of Western Australia, Australian Labor Party politicians
Renton, Washington	Cities in Washington (U.S. state)
Premier of Western Australia	Premiers of Western Australia
Christian Heinrich Nebbien	1778 births, 1841 deaths, German architects, People from Lübeck
Krompachy	Cities in Slovakia
Kingfisher	Coraciiformes
São José dos Pinhais	Cities in Paraná State
Yone Minagawa	Japanese supercentenarians, 1893 births, 2007 deaths, People from Fukuoka Prefecture
Richard G. Hovannisian	American historians, Living people, 1932 births
Armenians in the Ottoman Empire	History of Armenia
Armenian Question	Armenian Genocide
Annihilation	Nuclear physics, Antimatter
South Asian river dolphin	River dolphins
Phone Booth (movie)	2003 crime movies, 2000s crime thriller movies, 20th Century Fox movies, American crime thriller movies, English-language movies, Movies directed by Joel Schumacher, Movies set in New York City
Beltway sniper attacks	2002 in the United States, 2000s in Maryland, 2000s in Virginia, 2000s in Washington, D.C., Crime in Virginia, Crime in Washington, D.C., Murder in 2002, Murder in the 21st century in the United States, Murders by firearm in the United States, October events, Terrorist attacks in the United States, Terrorist incidents in the 2000s
Ulmus wallichiana	Plants and animals of Kashmir, Ulmaceae
Central Karakoram National Park	National parks in Pakistan
Chitral National Park	National parks in Pakistan
Richard Court	1947 births, Living people, Premiers of Western Australia, Liberal Party of Australia politicians
Hazarganji-Chiltan National Park	National parks in Pakistan
Hingol National Park	National parks in Pakistan
Khunjerab National Park	National parks in Pakistan
Kirthar National Park	National parks in Pakistan
Lehri Nature Park	National parks in Pakistan
Carmen Lawrence	1948 births, Living people, Premiers of Western Australia, Australian Labor Party politicians, Government ministers of Australia
Machiara National Park	National parks in Pakistan
Margala Hills National Park	National parks in Pakistan
Cholistan desert	Deserts of Pakistan
Peter Dowding	1943 births, Living people, Premiers of Western Australia, Politicians from Melbourne, Australian lawyers, Australian Labor Party politicians
Indus Valley Desert	Deserts of Pakistan
Kharan desert	Deserts of Pakistan
Thal desert	Deserts of Pakistan
Flag of Texas	United States state flags, Texas
Benny Benson	People from Alaska, Deaths from myocardial infarction, 1913 births, 1972 deaths
Bowling for Soup	1994 establishments in Texas, 1990s American music groups, 2000s American music groups, 2010s American music groups, American rock bands, American punk bands, Musical groups established in 1994, Musical groups from Texas, Pop punk bands
Flag of Alaska	United States state flags, Alaska
2005 civil unrest in France	2005 crimes, 2005 in Europe, 2000s crimes in Europe, 2000s in France, 2000s riots, Crime in France, November events, October 2005 events, Riots in Europe
ASCII	Data input, Encodings
Vantage Point	2008 movies, American movies, Multilingual movies
Flag of Hawaii	United States state flags, Hawaii
2010 FIFA World Cup	FIFA World Cup, 2010 in association football, Football in South Africa, 2010s in South Africa
Cody Rhodes	1985 births, American professional wrestlers, Living people, Sportspeople from Georgia (U.S. state), Former WWE wrestlers, People from Marietta, Georgia
Jimmy Reiher, Jr.	1971 births, Living people, American professional wrestlers, Fijian sportspeople
Jim Duggan	1954 births, American professional wrestlers, Living people, Sportspeople from New York, WWE Hall of Fame, People from Glens Falls, New York
JTG	1984 births, American professional wrestlers, Former WWE wrestlers, Living people, Sportspeople from New York City
Lance Cade	1980 births, 2010 deaths, Deaths from cardiomyopathy, American professional wrestlers, Cardiovascular disease deaths in the United States, Deaths from heart failure, Drug-related deaths in the United States, Former WWE wrestlers, Sportspeople from Omaha, Nebraska
Matt Striker	1974 births, Living people, American professional wrestlers, Former WWE wrestlers, Sportspeople from New York City
Sicko	2007 movies, American documentary movies, American independent movies
Flag of Alabama	United States state flags, Alabama
Flag of Mexico	Mexico
Flag of the United Kingdom	National flags, Flags of the United Kingdom
Tommy Tynan	1955 births, Living people, English footballers, People from Liverpool
Lennie Lawrence	1941 births, Living people, English football managers, People from Brighton, Sportspeople from Sussex
Neil Warnock	1948 births, Living people, English footballers, English football managers, People from Sheffield
John Gregory	1945 births, Living people, English footballers, English football managers, Sportspeople from Lincolnshire
Roberto Carlos	1973 births, Living people, Association football defenders, Association football full-backs, Brazilian footballers
Bob Wilson (footballer, born 1941)	1941 births, Living people, Scottish footballers, British association football goalkeepers
Sepp Maier	1944 births, Living people, German association football goalkeepers, Sportspeople from Bavaria
Bob Stokoe	1930 births, 2004 deaths, Deaths from pneumonia, English footballers, Sportspeople from Northumberland
Lothar Matthäus	1961 births, Living people, German football managers, German footballers, Sportspeople from Bavaria
Douglas Haig, 1st Earl Haig	1861 births, 1928 deaths, British Army generals, People from Edinburgh, Knights Grand Cross of the Order of the Bath, Knights of the Thistle, Order of Merit, Knights Grand Cross of the Royal Victorian Order, Knights Commander of the Order of the Indian Empire
John Charles	1931 births, 2004 deaths, Welsh footballers, Welsh football managers, People from Swansea
Fredrik Ljungberg	1977 births, Living people, Swedish footballers, Swedish football managers
Martin Peters	1943 births, 2019 deaths, Deaths from Alzheimer's disease, Disease-related deaths in London, English footballers, Sportspeople from London
Dmitri Sychev	1983 births, Living people, Russian footballers
José Eulogio Gárate	Spanish footballers
Shinji Ono	1979 births, Living people, Footballers from Shizuoka Prefecture, Japan international footballers, J1 League players, J2 League players, Urawa Red Diamonds players, Shimizu S-Pulse players, Hokkaido Consadole Sapporo players, FC Ryukyu players, 1998 FIFA World Cup players, 2002 FIFA World Cup players, 2006 FIFA World Cup players, 2001 FIFA Confederations Cup players, Footballers at the 2004 Summer Olympics, 2000 AFC Asian Cup players, AFC Asian Cup-winning players
Iker Casillas	1981 births, Living people, Spanish association football goalkeepers, 2014 FIFA World Cup players, Sportspeople from Madrid
Jamie Murphy	1973 births, Living people, English footballers, Sportspeople from Manchester
List of presidents of Turkey	Presidents of Turkey, Lists of heads of state
Weightlifting	Weightlifting
Mullet	Teleosts
Flag semaphore	Flags, Messaging, Signalling
Asparagales	Asparagales
Asparagaceae	Asparagales
Hesperocallis	Agavaceae
Laurales	Trees, Magnoliopsida
Hasbro	1923 establishments in the United States, 20th-century establishments in Rhode Island, Rhode Island
Bay leaf	Herbs, Lauraceae
Ginger	Monocots, Spices
Revenue	Income
Net income	Income
Real time (media)	Media
Southern Cone	South America
1936–37 NHL season	1936 in North America, 1937 in North America
William M. Jennings	1920 births, 1981 deaths, Hockey Hall of Fame inductees, People from New York City
Robert Esche	1978 births, American Hockey League players, Living people, Ontario Hockey League players, Philadelphia Flyers players, Phoenix Coyotes players, Sportspeople from New York, American ice hockey goaltenders
Concussion	Brain
Mercury-in-glass thermometer	Medical equipment, Measuring tools, Thermometers
Language reform	Linguistics
Beaufort scale	Winds
The Wheel of Time	Fantasy books, Series of books
Robert Jordan	1948 births, 2007 deaths, Deaths from amyloidosis, Disease-related deaths in South Carolina, Pen names, People from Charleston, South Carolina, Writers from South Carolina
Brian Burke	1947 births, Living people, Premiers of Western Australia, People from Perth, Western Australia, Australian Labor Party politicians, Australian journalists
Ray O'Connor	1926 births, 2013 deaths, Australian criminals, Fraudsters, Liberal Party of Australia politicians, People from Perth, Western Australia, Premiers of Western Australia
Charles Court	1911 births, Premiers of Western Australia, People from Sussex, Liberal Party of Australia politicians
Chang'an	History of China, Cities in China
John Tonkin	1902 births, 1995 deaths, Premiers of Western Australia, Australian Labor Party politicians, Australian educators
David Brand	1912 births, 1979 deaths, Premiers of Western Australia, Liberal Party of Australia politicians
Albert Hawke	1900 births, 1989 deaths, Premiers of Western Australia, Politicians from South Australia, Australian Labor Party politicians
Ross McLarty	1891 births, 1962 deaths, Premiers of Western Australia, Liberal Party of Australia politicians
Frank Wise	1897 births, 1986 deaths, Administrators of the Northern Territory, Premiers of Western Australia, Politicians from Queensland, Australian Labor Party politicians
Early modern Europe	History of Europe
Kevin Moore (rugby league)	1965 births, Living people, Australian rugby league players, Sportspeople from Sydney, Coaches
Roman Čechmánek	1971 births, Living people, Los Angeles Kings players, Philadelphia Flyers players, American Hockey League players, Swedish Hockey League players, Czech ice hockey goaltenders
Jaromír Jágr	1972 births, Art Ross Trophy winners, Bill Masterton Memorial Trophy winners, Boston Bruins players, Calgary Flames players, Czech ice hockey players, Czechoslovak ice hockey players, Dallas Stars players, Florida Panthers players, Hart Memorial Trophy winners, Living people, Medalists at the 2006 Winter Olympics, New Jersey Devils players, New York Rangers players, Olympic bronze medalists, Olympic gold medalists, Philadelphia Flyers players, Pittsburgh Penguins players, Stanley Cup champions, Washington Capitals players
Spinning jenny	Machines, Tools
Roman Turek	1970 births, Calgary Flames players, Czech ice hockey goaltenders, Czechoslovak ice hockey players, Dallas Stars players, Living people, St. Louis Blues players, Stanley Cup champions
Driveshaft	Machines, Auto parts
Power loom	Tools, Machines, Weaving
Ahmadiyya	Islamic denominations
Paris Métro	Rapid transit systems, Paris, Transport in France, 1900 establishments in France
Heroes (TV series)	2006 American television series debuts, 2010 American television series endings, 2000s American drama television series, 2000s science fiction television series, 2010s American drama television series, 2010s science fiction television series, American science fiction television series, American time travel television series, NBC network shows, English-language television programs
Eddie Su'a	1983 births, Living people, Australian rugby league players, Sportspeople from Sydney
String (music)	String instrument construction
Peter Sellers	1925 births, 1980 deaths, Actors from Hampshire, British radio actors, Comedians from Hampshire, Deaths from myocardial infarction, English movie actors, English television actors, People from Portsmouth, Commanders of the Order of the British Empire
Boris Johnson	1964 births, Living people, Alumni of the University of Oxford, British journalists, Conservative MPs (UK), Current national leaders, English Anglicans, Leaders of the Conservative Party (UK), Mayors of London, Members of the British House of Commons for English constituencies, People educated at Eton College, Politicians from New York City, Privy Councillors (UK), UK MPs 2001–2005, UK MPs 2005–2010, UK MPs 2015–2017, UK MPs 2017–2019, UK MPs 2019–, Writers from London, Writers from New York City
NUbuntu	Live CD, Linux distributions, Ubuntu (operating system) derivatives
London Assembly	Local government in London, 2000 establishments in England
Somali language	Cushitic languages, Languages of Ethiopia, Somalia
Gravy	Sauces
B. F. Skinner	1904 births, 1990 deaths, American atheists, American autobiographers, American psychologists, Harvard University alumni, Scientists from Pennsylvania, Writers from Pennsylvania, Harvard University faculty
Falmouth Academy	Schools in Massachusetts
Breastfeeding	Babies, Milk, Breasts
Satyajit Ray	1921 births, 1992 deaths, Indian movie directors, Academy Award Honorary Award winners, Illustrators
Petrarch	1304 births, 1374 deaths, Italian poets, Medieval poets
Language planning	Languages
Johnny Marr	1963 births, Living people, English guitarists, English singer-songwriters, Keyboardists, Musicians from Manchester, The Smiths members
Years of Refusal	2009 albums
Indus Waters Treaty	Foreign relations of Pakistan, Foreign relations of India
John Willcock	1879 births, 1956 deaths, Premiers of Western Australia, Politicians from New South Wales, Australian Labor Party politicians
Philip Collier	1873 births, 1948 deaths, Premiers of Western Australia, Politicians from Victoria (Australia), Australian Labor Party politicians
James Mitchell	1866 births, 1951 deaths, Premiers of Western Australia, Viceroys in Australia, Nationalist Party of Australia politicians
Folie à Deux (album)	2008 albums, Fall Out Boy albums, Island Records albums, Rock albums
What a Catch, Donnie	2008 songs, Fall Out Boy songs
Stade de Suisse	Buildings and structures in Switzerland, Football stadiums in Europe, Football in Switzerland, Bern, 2005 establishments in Europe, 2000s establishments in Switzerland
Ken Livingstone	1945 births, Living people, British atheists, British socialists, Mayors of London, Democratic socialists, Politicians from London
Vatnajökull	Geography of Iceland
InterCity 225	Rail transport in the United Kingdom
British Rail	British Rail, 1948 establishments in Europe, 1940s establishments in the United Kingdom, 1997 disestablishments in Europe, 1990s disestablishments in the United Kingdom
Cobra	Elapidae
Cape Cobra	Elapidae
Kalahari Desert	Deserts, Geography of Botswana, Geography of Namibia, Geography of South Africa
Silverstein	2000s music groups, Emo bands, Canadian rock bands, Post-hardcore bands
Discovering the Waterfront	2005 albums, Punk albums
Pakistan State Oil (PSO)	Economy of Pakistan
Mahmud I	Sultans of the Ottoman Empire, 1696 births, 1754 deaths
Mahmud II	1785 births, 1839 deaths, Sultans of the Ottoman Empire
Mahmud II of Great Seljuk	Persian people, Kings and queens, 1100s births, 1131 deaths, Baghdad
Mahmud of Ghazni	971 births, 1030 deaths, Turkic peoples, Monarchs of Afghanistan, Emperors and empresses
Ghaznavid Empire	History of Iran, History of Afghanistan, History of Pakistan, Royal dynasties, 963 establishments, 12th century disestablishments in Asia, 960s establishments in Asia, 1186 disestablishments
Mahmud Shah (Sultan of Malacca)	History of Malaysia, 1528 deaths, Year of birth missing
Mahmud Shah Durrani	1769 births, 1829 deaths, Afghan leaders, Kings and queens
Durrani Empire	History of Afghanistan, History of Pakistan, History of Iran, 1747 establishments, 1919 disestablishments, 18th century establishments in Iran
Cognitive psychology	Cognition, Branches of psychology
Celâl Bayar	Centenarians, Presidents of Turkey, 1883 births, 1986 deaths
Perceptual psychology	Cognition
Mahmoud Abbas	1935 births, Living people, Palestinian Muslims, Palestinian nationalists, Palestinian politicians, Presidents (government), Prime ministers
Abid Hamid Mahmud	1957 births, 2012 deaths, Executed people, Generals, Iraqi military people
Social psychology	Branches of psychology
Mahmoud an-Nukrashi Pasha	1888 births, 1948 deaths, Prime Ministers of Egypt
Neuropsychology	Branches of psychology, Neurology
Abnormal psychology	Human behavior, Psychology
John B. Watson	1878 births, 1958 deaths, American psychologists, Scientists from South Carolina, People from Greenville, South Carolina
Indian English	Dialects of English, Languages of India, Languages of Bangladesh
Ivan Pavlov	1849 births, 1936 deaths, Physiologists, Psychologists, Russian Nobel Prize winners, Russian physicians, Soviet people, Saint Petersburg State University alumni
Hamilton College	Colleges and universities in New York, 1793 establishments in the United States, 18th-century establishments in New York (state)
Jon Stewart	1962 births, Living people, Actors from New York City, Comedians from New York City, American movie actors, American television actors, American television presenters, American television writers, Comedy Central personalities, Emmy Award winners, Grammy Award winners, Jewish American actors, Jewish American writers, Television talk show hosts, Writers from New York City
Quagga	Equids, Extinct species, IUCN Red List extinct species, Mammals of Africa, Odd-toed ungulates, Zebras
Przewalski's horse	Horses, Mammals of Asia
Nation state	Political geography, Nationalism
Joseph McCarthy	1908 births, 1957 deaths, American military personnel of World War II, American Roman Catholics, Anti-Communists, Deaths from hepatitis, Disease-related deaths in Maryland, Infectious disease deaths in the United States, United States senators from Wisconsin, US Republican Party politicians
Poet laureate	Poets
List of emperors of Japan	Emperors of Japan, Lists of heads of state, Lists of Japanese people
Katy Perry	1984 births, Living people, Actors from California, American LGBT rights activists, American pop singers, American television actors, Brit Award winners, Katy Perry, People from Santa Barbara, California, Singers from California
One of the Boys	2008 albums, Katy Perry albums, Debut albums, Pop albums
I Kissed a Girl	2008 songs, Katy Perry songs, LGBT songs
Hot N Cold	2008 songs, Katy Perry songs, Dance-pop songs
If I Were a Boy	2008 songs, 2000s ballads, Beyoncé songs, Pop ballads, Songs with feminist themes
Single Ladies (Put a Ring on It)	2008 songs, Beyoncé songs, Songs with feminist themes
Secure Shell	Internet security, Computer protocols
Application programming interface	Software
Peregrine falcon	Falconiformes, Birds of Pakistan, Birds of Kashmir
Mozilla Public License	Software licences, Mozilla
Ubisoft	Companies of France, Video game companies, French culture
Permissive software license	Software licences
Hero / Heroine	2007 songs, Boys Like Girls songs
Thunder (Boys Like Girls song)	Boys Like Girls songs, 2008 songs
1.22.03.Acoustic	2004 albums, Maroon 5 albums, Compilation albums
Live from SoHo (Maroon 5 album)	2008 albums, Maroon 5 albums
Alexander Berkman	1870 births, 1936 deaths, American writers, Russian writers, Anarchists
Murray Bookchin	1921 births, 2006 deaths, American anarchists, Jewish American writers, American historians, Green anarchism, People from Burlington, Vermont, Writers from New York City, Green thinkers
Carlo Cafiero	1846 births, 1892 deaths, Anarchist communists, People from Apulia
Benito Juárez	1806 births, 1872 deaths, Academics, Deputy mayors, Judges, People from Oaxaca, Presidents of Mexico
Madeleine Albright	1937 births, Living people, 20th-century American politicians, 21st-century American politicians, Columbia University alumni, Czech Jews, Czechoslovak people, Jewish American academics, Jewish American politicians, Jewish American writers, Jewish women politicians, Johns Hopkins University alumni, Naturalized citizens of the United States, United States Ambassadors to the United Nations, United States Secretaries of State, US Democratic Party politicians, Women diplomats, Writers from Prague
James Carville	Writers from Georgia (U.S. state), American television personalities, Democrats (United States), American political commentators, Living people, 1944 births
Colin Powell	1937 births, Living people, African-American military personnel, African American politicians, American generals, American military personnel of the Vietnam War, Politicians from New York City, Presidential Citizens Medal recipients, United States National Security Advisors, United States Secretaries of State
United States Secretary of State	United States Secretaries of State, 1789 establishments in the United States
Jacques Ellul	1912 births, 1994 deaths, Anarchists, Calvinists, French Christians, French theologians, People from Bordeaux
Johann Most	1846 births, 1906 deaths, American anarchists, American writers, German writers, People from Augsburg, Politicians from Bavaria, Politicians of the Social Democratic Party of Germany, Socialists
Francesco Saverio Merlino	Italian anarchists, Italian lawyers, People from Naples, 1856 births, 1930 deaths
Murray Rothbard	1926 births, 1995 deaths, American agnostics, American anarchists, American economists, Anarcho-capitalists, Jewish American scientists, Libertarians, Scientists from New York City
Carlo Tresca	Industrial Workers of the World, American anarchists, Socialists, Italian people, American murder victims, 1879 births, 1943 deaths
Benjamin Tucker	American anarchists, American philosophers, Writers from Massachusetts, 1854 births, 1939 deaths, Libertarians, American atheists
John Zerzan	1943 births, Living people, American anarchists, People from Salem, Oregon, Green anarchism, Writers from Oregon, Green thinkers
2014 FIFA World Cup	FIFA World Cup, 2014 FIFA World Cup
Ephedrine	Chemical compounds
Emiliano Zapata	1879 births, 1919 deaths, Generals, Mexican military people
Pseudoephedrine	Chemical compounds
Scion	Automobiles
Flag of Christmas Island	Flags, Christmas Island, Flags of country subdivisions
Philippsburg	Cities in Baden-Württemberg
Ainsworth, Wisconsin	Towns in Wisconsin, Langlade County, Wisconsin
Bex	Municipalities of Vaud
Erwitte	Soest Rural District
John Krasinski	1979 births, Living people, Actors from Massachusetts, American movie actors, American television actors, American movie directors, American screenwriters, American voice actors, Writers from Massachusetts
United States Department of State	United States Department of State
Cabinet of the United States	United States Executive Cabinet
United States Attorney General	United States Attorneys General, 1789 establishments in the United States
United States Secretary of Agriculture	United States Secretaries of Agriculture, 1889 establishments in the United States
List of United States Cabinets	Members of the Cabinet of the United States, Lists of politicians from the United States
United States Secretary of Homeland Security	United States Secretaries of Homeland Security, 2003 establishments in the United States
United States Department of Homeland Security	United States intelligence agencies, Federal law enforcement agencies of the United States
United States Secretary of the Interior	United States Secretaries of the Interior, 1849 establishments in the United States
United States Secretary of Commerce	United States Secretaries of Commerce, 1913 establishments in the United States
United States Department of Commerce	United States Department of Commerce, 1913 establishments in the United States
United States Department of the Interior	United States Department of the Interior, 1849 establishments in the United States
United States Department of Justice	Federal law enforcement agencies of the United States, United States Department of Justice
United States Department of Agriculture	United States Department of Agriculture, 1889 establishments in the United States
United States federal executive departments	United States federal executive departments
United States Department of Labor	United States Department of Labor, 1913 establishments in the United States
United States Secretary of Labor	United States Secretaries of Labor, 1913 establishments in the United States
Raster image processor	Printers
Sligo Rovers F.C.	Irish football clubs
Eircom Premier Division	Football League of Ireland, Defunct sports leagues, 1921 establishments in Europe, 2006 disestablishments, 20th century establishments in the Republic of Ireland, 2000s disestablishments in Europe
Sligo	County towns in Ireland, County Sligo
Fort Campbell	United States Army, Forts in the United States, Buildings and structures in Kentucky, Buildings and structures in Tennessee, 1941 establishments in the United States, 20th-century establishments in Kentucky, 20th-century establishments in Tennessee
Harlem	Manhattan, Neighborhoods of New York City
Taxane	Chemical compounds
Brooch	Jewelry
Flares	Trousers and shorts
Autopsy	Death, Medical procedures, Forensics
Supro Ozark 1560 S	Guitars
Stormbreaker	Children's books, 2000 books
Event-driven programming	Software
Leeds Bradford International Airport	Airports in England, Leeds
Leeds Metropolitan University	Leeds, Universities in England
Wetherby	Towns in West Yorkshire
Dynamic-link library	Software
Jack Peddie	1876 births, 1928 deaths, Scottish footballers
Nwankwo Kanu	1976 births, Living people, Nigerian footballers
Jay-Jay Okocha	1973 births, Living people, Nigerian footballers
Nicky Butt	1975 births, Living people, English footballers, Sportspeople from Manchester, Premier League players
Serie B	Football leagues, Football in Italy, 1929 establishments in Italy
Michael Cole	1968 births, Living people, American journalists, Entertainers from New York, Sportspeople from New York, WWE wrestlers, People from Syracuse, New York, American Internet celebrities
Rlogin	Internet, Computer protocols
Vasily Zaytsev	1915 births, 1991 deaths, Autobiographers, Recipients of the Order of Lenin, Russian writers, Soviet military personnel of World War II, Soviet writers
Mike Adamle	1949 births, Living people, Sportspeople from Ohio, National Football League broadcasters, College football broadcasters, Professional Wrestling broadcasters, Arena Football League broadcasters
Port forwarding	Internet, Computer protocols
Paul Burchill	1979 births, Living people, Former WWE wrestlers, English professional wrestlers, People from Surrey
Serial port	Computer hardware, Computer networking, Electrical connectors, Computer buses
Bambi	1942 movies, American animated movies, American family movies, Bambi, Disney animated movies, English-language movies, Movies about animals, Movies based on books, Movies composed by Oliver Wallace, United States National Film Registry movies
Flag of the Netherlands	National flags, Dutch culture
Coat of Arms of Netherlands	National coats of arms, Dutch culture
Flag of the United States Virgin Islands	US Virgin Islands, Flags of the United States
Morphine (band)	American rock bands, Musical groups from Massachusetts
Pietro Acciarito	Italian anarchists, 1871 births, 1943 deaths
Good (Morphine album)	1992 albums
Francisco Ascaso	1901 births, 1936 deaths, Spanish anarchists
Cure for Pain	1993 albums
Marie Louise Berneri	English writers, Italian anarchists, 1918 births, 1949 deaths
Marco Camenisch	Swiss activists, Environmentalists, Anarchists, Green anarchism, Green thinkers, Murderers, Prisoners, Swiss people, 1952 births, Living people
Sante Geronimo Caserio	1873 births, 1894 deaths, Italian anarchists, Criminals
Pakistan Day	Pakistan, Holidays
Karachi Agreement	20th century in Pakistan, 1940s in India, 1949 in Asia
Badshahi Mosque	Buildings and structures in Lahore, Mosques in Asia, Mughal architecture, Religion in Pakistan, World Heritage Sites in Pakistan, 1671 establishments, 17th century establishments in Asia
Minar-e-Pakistan	Buildings and structures in Lahore, National symbols of Pakistan, Pakistani culture
Mazar-e-Quaid	Buildings and structures in Karachi, 1970 establishments in Asia
Craig Anton	1962 births, Living people, American television actors, Comedians from Nebraska, Actors from Omaha, Nebraska
Queer as Folk (U.S.)	2000 American television series debuts, 2005 American television series endings, 2000s American drama television series, American LGBT television programs, Canadian television series, LGBT drama television series, Pittsburgh in fiction, English-language television programs
United States Secretary of Health and Human Services	United States Secretaries of Health and Human Services, 1980 establishments in the United States
United States Department of Health and Human Services	United States Department of Health and Human Services, 1953 establishments in the United States
United States Secretary of Energy	United States Secretaries of Energy, 1977 establishments in the United States
United States Department of Energy	United States Department of Energy
Dead Memories	2008 songs, Slipknot songs
Ted DiBiase, Jr.	1982 births, Living people, American professional wrestlers, Former WWE wrestlers, Sportspeople from Mississippi
Clinton, Mississippi	Cities in Mississippi, 1824 establishments in the United States, 1820s establishments in Mississippi
Apollo Beach, Florida	Census-designated places in Florida, Unincorporated communities in Florida
Loco, Switzerland	Former municipalities of Ticino, Villages in Ticino
Robert Gates	1943 births, Living people, Chancellors of the College of William & Mary, United States Secretaries of Defense, Directors of the Central Intelligence Agency, Politicians from Wichita, Kansas, Presidential Citizens Medal recipients
Director of Central Intelligence	Directors of the Central Intelligence Agency, United States intelligence agencies
Director of National Intelligence	United States Directors of National Intelligence
Donald Rumsfeld	United States Secretaries of Defense, White House Chiefs of Staff, Politicians from Chicago, Military people from Chicago, US Republican Party politicians, Permanent Representatives of the United States to NATO, 1988 United States presidential candidates, 1932 births, 2021 deaths, Deaths from multiple myeloma, Businesspeople from Chicago, Chief executives
Robert McNamara	US Republican Party politicians, Businesspeople from San Francisco, Politicians from San Francisco, United States Secretaries of Defense, World Bank, 1916 births, 2009 deaths, Presidents of the World Bank Group
James Forrestal	United States Secretaries of Defense, United States Secretaries of the Navy, Politicians from New York, 1949 deaths, 1892 births
Yaoi	Anime and manga terms
Yuri (manga)	Anime and manga terms
Immigration	Immigration
White Lion	1980s American music groups, 1990s American music groups, 2000s American music groups, 2010s American music groups, American heavy metal bands, Musical groups from New York City
Mike Tramp	Danish singers, 1961 births, Living people, People from Copenhagen
Delta, British Columbia	Cities in British Columbia
Surrey, British Columbia	Cities in British Columbia
Mark Lambert	English rugby union players, Sportspeople from London, 1985 births, Living people
Sadism	Human sexuality
James Inglis (rugby union)	1986 births, Living people, English rugby union players
Shane O'Connor	1983 births, Living people, Irish rugby union players
Alex Rogers	1986 births, Living people, English rugby union players
Gareth Williams (rugby union)	1988 births, Living people, Welsh rugby union players
David Blaney	1979 births, Living people, English rugby union players
Ryan Prosser	1988 births, Living people, Welsh rugby union players
Iain Grieve	1987 births, Living people, Rugby union players, Botswana people
Chris Ashwin	1987 births, Living people, English rugby union players, Gloucester, Sportspeople from Gloucestershire
Network address translation	Computer networking, Internet
Rey Mysterio	1974 births, American Roman Catholics, Former WWE wrestlers, Living people, Sportspeople from San Diego, California
Router	Computer networking, Internet
Masochism	BDSM
Jon Fisher	1972 births, Living people, Businesspeople from California
Lachlan Mitchell	1987 births, Living people, Australian rugby union players, Sportspeople from Sydney
Charlie Beech	1987 births, Living people, English rugby union players, People from Stevenage, Sportspeople from Hertfordshire
Showgrounds	Football stadiums, Football in the Republic of Ireland, Buildings and structures in the Republic of Ireland
Hugo Ellis	1988 births, Living people, English rugby union players, People from Hounslow (London borough)
Ross Batty	Living people, 1986 births, English rugby union players, Newcastle Falcons rugby union players
Tim Swinson	1987 births, Living people, English rugby union players, Newcastle Falcons rugby union players, Sportspeople from London
Rory Clegg	1990 births, Living people, English rugby union players, Newcastle Falcons rugby union players, People from Hanover, Sportspeople from Lower Saxony
Private network	Computer networking, Internet
Paul Cook (footballer)	1967 births, Living people, English footballers, English football managers, Sportspeople from Liverpool, Premier League players
David Cook (singer)	1982 births, Living people, American singer-songwriters, American Idol winners, Singers from Missouri
Roddy Piper	1954 births, 2015 deaths, Actors from Manitoba, Canadian movie actors, Canadian professional wrestlers, Canadian television actors, Cardiovascular disease deaths in Los Angeles, Deaths from cardiopulmonary arrest, Deaths from pulmonary embolism, People from Saskatoon, People from Winnipeg, WWE Hall of Fame, WWE people
Lolicon	Anime and manga terms, Child sexual abuse
Behemoth	Black metal bands, Death metal bands
Studio Ghibli	Movie studios, Companies of Japan, Studio Ghibli, 1985 establishments in Japan
Reverse DNS lookup	Computer networking, Internet
Polis	Ancient Greece
Doujinshi	Anime and manga terms, Manga
Mumia Abu-Jamal	1954 births, Living people, African-American people, American activists, American people convicted of murder, American prisoners sentenced to death, People from Philadelphia, Pennsylvania
Overkill	1980s American music groups, 1990s American music groups, 2000s American music groups, 2010s American music groups, Musical groups from New Jersey, American heavy metal bands, Thrash metal bands
The Police	1977 establishments in the United Kingdom, 1970s British music groups, 1980s British music groups, 2000s British music groups, 2008 disestablishments in the United Kingdom, English rock bands, Musical groups established in 1977, Musical groups from London, Musical groups disestablished in 2008
Damageplan	2003 establishments in the United States, 2004 disestablishments in the United States, 2000s American music groups, American heavy metal bands, Dallas, Texas, Musical groups established in 2003, Musical groups disestablished in 2004, Musical groups from Texas
Down (band)	American heavy metal bands
Triple DES	Cryptography
Breakout (album)	2008 albums, Miley Cyrus albums, Pop rock albums
7 Things	2008 songs, Miley Cyrus songs
Girls Just Want to Have Fun	1983 songs
Advanced Encryption Standard	Cryptography
Shōnen (media)	Anime and manga terms
The Amazing Race	American reality television series, 2000s television series, CBS network shows, Emmy Award winning programs
Financial crisis of 2007–2008	2007, 2008, Financial crises, Stock market
Detritivore	Animals
Skid Row	1980s American music groups, 1990s American music groups, 2000s American music groups, 2010s American music groups, American heavy metal bands
Carbon cycle	Geochemistry
Skepticism	Skepticism, Epistemology
United States Secretary of War	Former United States Executive Cabinet positions, 1789 establishments in the United States, 1947 disestablishments in the United States
United States Secretary of the Navy	Former United States Executive Cabinet positions, United States Secretaries of the Navy
United States Postmaster General	United States Postmasters General
White House Chief of Staff	White House Chiefs of Staff, 1946 establishments in the United States
Edmund Randolph	1753 births, 1812 deaths, United States Secretaries of State, United States Attorneys General, Governors of Virginia
John R. Steelman	1900 births, 1999 deaths, White House Chiefs of Staff, Politicians from Arkansas, US Republican Party politicians
James Baker	1930 births, Living people, American lawyers, Military people from Texas, Politicians from Houston, Texas, Princeton University alumni, United States Secretaries of State, United States Secretaries of the Treasury, US Republican Party politicians, White House Chiefs of Staff
National Library of China	National libraries in Asia, China
Ronaldinho	1980 births, Brazilian footballers, People from Porto Alegre, Living people, FIFA World Cup players, South American footballers
Les Ferdinand	1966 births, Living people, English footballers, Sportspeople from London, Premier League players
Chris Sutton	1973 births, Living people, English footballers, English football managers, People from Nottingham, Sportspeople from Nottinghamshire, Premier League players
Teddy Sheringham	1966 births, Living people, 1998 FIFA World Cup players, 2002 FIFA World Cup players, English footballers, English football managers, People from Waltham Forest (London borough), Sportspeople from London, Tottenham Hotspur F.C. players, Premier League players
Dwight Yorke	1971 births, Living people, Trinidad and Tobago footballers, Association football midfielders, Association football forwards, Aston Villa F.C. players, Manchester United F.C. players, Premier League players, 2006 FIFA World Cup players
Uwe Seeler	1936 births, Living people, German footballers, Order of Merit of the Federal Republic of Germany, Sportspeople from Hamburg
Herbert Chapman	1878 births, 1934 deaths, English footballers, English football managers, People from South Yorkshire
Jari Litmanen	1971 births, Living people, Finnish footballers
Denis Compton	1918 births, 1997 deaths, Arsenal F.C. players, Deaths from sepsis, Disease-related deaths in Berkshire, English cricketers, English footballers, Infectious disease deaths in England
Jan Mølby	1963 births, Living people, Danish footballers, Danish football managers
Tore André Flo	1973 births, Living people, Norwegian footballers
Iván Zamorano	1967 births, Living people, Chilean footballers, People from Santiago
Mark Hopley	1984 births, Living people, English rugby union players, People from Crewe, Sportspeople from Cheshire
Formentera	Balearic Islands
Menorca	Balearic Islands, Biosphere reserves
Sajid Mahmood	1981 births, Living people, English cricketers, People from Bolton, Sportspeople from Greater Manchester
Flag of Sri Lanka	National flags
RC4	Cryptography
General Electric	American technology companies
Blowfish (cipher)	Cryptography
Hal Colebatch	1872 births, 1953 deaths, Premiers of Western Australia, People from Herefordshire, Nationalist Party of Australia politicians, Members of the Australian Senate
Henry Lefroy	1854 births, 1930 deaths, Premiers of Western Australia, People from Perth, Western Australia, Nationalist Party of Australia politicians, Commonwealth Liberal Party politicians
Chevvy Pennycook	1987 births, Living people, People from Bristol, English rugby union players
John Scaddan	1876 births, 1934 deaths, Deaths from cerebral hemorrhage, Premiers of Western Australia, Politicians from South Australia, Australian Labor Party politicians, People from Perth, Western Australia
Frank Wilson	1859 births, 1918 deaths, Premiers of Western Australia, People from Sunderland
Newton Moore	1870 births, 1936 deaths, Premiers of Western Australia, Independent politicians in Australia
Mathew Turner	1988 births, Living people, South African rugby union players, People from Cape Town
Andrew Card	1974 births, Living people, American lobbyists, Politicians from Massachusetts, United States Secretaries of Transportation, US Republican Party politicians, White House Chiefs of Staff
Eton College	1440 establishments, 1440s establishments in England, Schools in England
PuTTY	Free software
Secure copy	Internet security, Computer protocols
Migros	Supermarkets of Switzerland, 1925 establishments in Europe, 20th century establishments in Switzerland, Zürich
SSH file transfer protocol	Internet, Computer protocols
Computer security	Computer security
Mark Odejobi	English rugby union players, Sportspeople from London, 1988 births, Living people
Damien Varley	1983 births, Living people, Irish rugby union players
Crayon Shin-chan	Anime
Hamtaro	Manga, Anime, 2002 television series debuts, 2004 television series endings
Finn Harps F.C.	Irish football clubs
Sadomasochism	Paraphilias
Lanzarote	Biosphere reserves, Islands of the Canary Islands
McMahon Line	Territorial disputes of China, 1910s treaties, 1910s in the United Kingdom, Tibet
Muradabad	Local government in India, Cities and towns in Uttar Pradesh
Theodor Heuss	1884 births, 1963 deaths, Former members of the German Bundestag, German academics, Members of the Reichstag (Weimar Republic), Order of Merit of the Federal Republic of Germany, Politicians from Baden-Württemberg, Politicians of the Free Democratic Party of Germany, Presidents of Germany
India-Pakistan maritime trespassing	Pakistan, India
Indo-Bangladeshi barrier	Foreign relations of Bangladesh, Foreign relations of India, Buildings and structures in India, Buildings and structures in Bangladesh, Territorial disputes of India
Frank-Walter Steinmeier	1956 births, Living people, Government ministers of Germany, Politicians from North Rhine-Westphalia, Politicians of the Social Democratic Party of Germany, Presidents of Germany, Vice Chancellors of Germany
Tipper Gore	Second Ladies of the United States, American photographers, 1948 births, Living people
Second Ladies and Gentlemen of the United States	Second Spouses of the United States
Lynne Cheney	Second Ladies of the United States, Writers from Wyoming, 1941 births, Living people, People from Casper, Wyoming
Graphium sarpedon	Graphium
Bama Boyz	Musical groups from Alabama, Hip hop bands, Montgomery, Alabama, Musical groups established in 2003, 2003 establishments in the United States, 2000s establishments in Alabama
Swallowtail butterfly	Papilionidae
Graphium	Graphium
Sauerbraten (video game)	2004 video games, MacOS games, Windows games
Town crier	Occupations
Plague of Justinian	Byzantine Empire, Ancient Rome, Plague pandemics, 541, 542, History of Europe
Zlib License	Software licences
Plant cutting	Agriculture
Ferdinand Lassalle	1825 births, 1864 deaths, German politicians, German prisoners, People from former German territories, People from Wrocław
Hans-Dietrich Genscher	1927 births, 2016 deaths, Cardiovascular disease deaths in Germany, Deaths from heart failure, Disease-related deaths in North Rhine-Westphalia, Former members of the German Bundestag, German lawyers, German military personnel of World War II, Government ministers of Germany, Nazis, Order of Merit of the Federal Republic of Germany, Politicians from Saxony-Anhalt, Politicians of the Free Democratic Party of Germany, Vice Chancellors of Germany
Jonny Kennedy (rugby union)	1990 births, Living people, English rugby union players, Sale Sharks rugby union players, Sportspeople from Cheshire
Franz Müntefering	1940 births, Living people, Former members of the German Bundestag, Government ministers of Germany, Politicians from North Rhine-Westphalia, Politicians of the Social Democratic Party of Germany, Vice Chancellors of Germany
Nick Royle	1983 births, Living people, English rugby union players, Sale Sharks rugby union players
Carl Fearns	1989 births, Living people, English rugby union players, Sale Sharks rugby union players, Sportspeople from Liverpool
James Gaskell	1990 births, Living people, English rugby union players, People from Crewe, Sale Sharks rugby union players, Sportspeople from Cheshire
Martin Halsall	1984 births, Living people, English rugby union players, Sale Sharks rugby union players, People from Lancashire
Alex Shaw	1987 births, Living people, English rugby union players, Sale Sharks rugby union players, Sportspeople from Kent
Chris Leck	1986 births, Living people, English rugby union players, Sale Sharks rugby union players, Sportspeople from Manchester
Secret Water	1939 books, Children's books, English novels
Gran Turismo (video game)	PlayStation games, 1997 video games, Gran Turismo series
Aramid	Armour, Polymers
Brute force attack	Cryptography
Information theory	Computer science
Block cipher	Cryptography
Authentication	Security, Computer security
DES-X	Cryptography
Hostname	Computer networking, Internet
National Institute of Standards and Technology	Standards, United States government agencies, 1901 establishments in the United States, United States Department of Commerce
Key size	Cryptography
Kandinsky	1866 births, 1944 deaths, People from Moscow, Printmakers, Russian painters
Public-key cryptography	Cryptography
John Ashcroft	1942 births, Living people, American lobbyists, American Pentecostals, Governors of Missouri, People from Springfield, Missouri, Politicians from Chicago, United States Attorneys General, United States senators from Missouri, US Republican Party politicians, Yale University alumni
Muslim conquests	History of Islam, History of Africa
Key space	Cryptography
Roger Williams (theologian)	1603 births, 1683 deaths, American Baptists, American Calvinists, American theologians, Christian ministers, Christian theologians, Christian writers, English Protestants, English theologians, History of Rhode Island, People from London, People from Providence, Rhode Island, Puritanism
Unitarianism	Unitarianism
United States National Security Council	United States National Security Council
Stephen Hadley	1947 births, Living people, United States National Security Advisors
Deputy National Security Advisor	United States National Security Council, United States-related lists
Director of the Central Intelligence Agency	Directors of the Central Intelligence Agency
Procopius	500 births, 565 deaths, Byzantine Empire, Ancient Roman historians, Ancient Roman writers
Porter Goss	1938 births, Living people, Directors of the Central Intelligence Agency, Politicians from Connecticut, United States representatives from Florida, US Republican Party politicians, People from Waterbury, Connecticut
George Tenet	Directors of the Central Intelligence Agency, People from New York, 1953 births, Living people
Peer Steinbrück	1947 births, Living people, Ministers-President of North Rhine-Westphalia, Politicians from Hamburg, Politicians of the Social Democratic Party of Germany
Wolfmother	Australian hard rock bands, Australian heavy metal bands, Grammy Award winners, Musical groups from Sydney
Defense Intelligence Agency	United States Department of Defense agencies, United States intelligence agencies
Makenna Cowgill	American television actors, American movie actors, Actors from Connecticut, Living people, 1998 births
African bush elephant	Elephants
Binda, New South Wales	Towns in New South Wales
Hollister Co.	American clothing companies, 2000 establishments in the United States, 2000s establishments in Ohio
Ron Simmons	1958 births, American professional wrestlers, Cleveland Browns players, College Football Hall of Fame, Living people, Sportspeople from Georgia (U.S. state), WWE Hall of Fame, WWE people
Fire services in the United Kingdom	Firefighting, Public services in the United Kingdom
Bleach (Nirvana album)	Nirvana albums, 1989 albums, Debut albums, Rock albums
Zub	1986 video games
Molly Hatchet	1970s American music groups, 1980s American music groups, 1990s American music groups, 2000s American music groups, 2010s American music groups, American rock bands, American hard rock bands, Southern rock bands, Musical groups from Florida, Musicians from Jacksonville, Florida, Musical groups established in 1975, 1975 establishments in the United States, 1970s establishments in Florida
Northern Italy	Geography of Italy
Thermosphere	Layers of Earth's atmosphere
Anaconda (installer)	Red Hat
Canowindra, New South Wales	Towns in New South Wales
Robert Cutler	United States National Security Advisors, Politicians from Boston, Massachusetts, 1895 births, 1974 deaths
St. Anthony-Chapel	Aachen, Buildings and structures in North Rhine-Westphalia, Churches in Germany
United States Secretary of Transportation	United States Department of Transportation, United States Secretaries of Transportation, 1967 establishments in the United States
The Bushwackers (band)	Australian musical groups, Folk music groups, Country bands, Musical groups from Melbourne, Musical groups established in 1973, 1973 establishments in Australia, Musical groups disestablished in 1984, 1984 disestablishments in Australia, Musical groups established in 1993, 1990s establishments in Australia
United States Department of Transportation	United States Department of Transportation, 1967 establishments in the United States
United States Department of War	Former United States Executive Departments, 1949 disestablishments, 1789 establishments in the United States, 1940s disestablishments in the United States
United States Department of Commerce and Labor	Former United States Executive Departments, United States Department of Commerce, United States Department of Labor, 1903 establishments in the United States, 1910s disestablishments in the United States
United States Department of Health, Education, and Welfare	Former United States Executive Departments, United States Department of Education, United States Department of Health and Human Services, 1953 establishments in the United States, 1979 disestablishments in the United States
United States Post Office Department	Former United States Executive Departments, United States Postal Service, 1792 establishments in the United States, 1971 disestablishments in the United States
United States Department of Education	United States Department of Education, 1979 establishments in the United States
United States Department of Housing and Urban Development	United States Department of Housing and Urban Development, 1965 establishments in the United States
United States Department of Veterans Affairs	United States Department of Veterans Affairs
Particle accelerator	Nuclear physics
United States Secretary of Education	United States Department of Education, United States Secretaries of Education, 1979 establishments in the United States
United States Secretary of Health, Education, and Welfare	United States Secretaries of Health, Education, and Welfare
Oveta Culp Hobby	United States Secretaries of Health, Education, and Welfare, Politicians from Texas, 1905 births, 1995 deaths
Patricia Roberts Harris	United States Secretaries of Health and Human Services, United States Secretaries of Health, Education, and Welfare, United States Secretaries of Housing and Urban Development, Politicians from Illinois, 1924 births, 1985 deaths
Assistant Secretary of Housing and Urban Development for Housing	United States Assistant Secretaries of Housing and Urban Development
United States Secretary of Housing and Urban Development	United States Department of Housing and Urban Development, United States Secretaries of Housing and Urban Development, 1966 establishments in the United States
Henry Paulson	Living people, 1946 births, United States Secretaries of the Treasury, Politicians from Florida, Christian Scientists
Reconquista	History of Spain
John W. Snow	1939 births, Living people, United States Secretaries of the Treasury, Politicians from Ohio
Paul H. O'Neill	2020 deaths, Deaths from lung cancer, Businesspeople from St. Louis, Missouri, US Republican Party politicians, Businesspeople from Pittsburgh, Pennsylvania, Politicians from Pittsburgh, Pennsylvania, United States Secretaries of the Treasury, Politicians from St. Louis, Missouri, 1935 births
Oliver Wolcott Jr.	1760 births, 1833 deaths, Governors of Connecticut, United States Secretaries of the Treasury, Yale University alumni, 19th-century American politicians, 18th-century American politicians
Samuel Dexter	United States Secretaries of the Treasury, United States Secretaries of War, Politicians from Boston, Massachusetts, 1761 births, 1816 deaths
United States Secretary of the Army	United States Secretaries of the Army
Kenneth Claiborne Royall	1894 births, 1971 deaths, American generals, American military personnel of World War I, American military personnel of World War II, Politicians from North Carolina, United States Secretaries of the Army, United States Secretaries of War
Pete Geren	1952 births, Living people, United States Secretaries of the Air Force, Politicians from Texas, US Democratic Party politicians, United States Secretaries of the Army
Astor markhor	Caprids, Mammals of Pakistan, Plants and animals of Kashmir
Kabul markhor	Caprids, Mammals of Asia
Junagarh	Cities in India
Nirvana (album)	Nirvana albums, 2002 albums
India–Pakistan border	Foreign relations of India, Pakistan
Emblem of Afghanistan	Afghanistan, National coats of arms
USB hub	Computing
Digital signature	Cryptography
Key generation	Cryptography
Symmetric-key algorithm	Cryptography
John Marshall	Chief Justices of the United States, United States Secretaries of State, United States Supreme Court justices, Founding Fathers of the United States, People from Virginia
William H. Crawford	United States Secretaries of the Treasury, United States Secretaries of War, Presidents pro tempore of the United States Senate, Politicians from Virginia, Slavers
James McHenry	Signers of the United States Constitution, United States Secretaries of War, 1753 births, 1816 deaths, People from Maryland
Timothy Pickering	1745 births, 1829 deaths, United States Postmasters General, United States Secretaries of State, United States Secretaries of War, Politicians from Massachusetts, People from Salem, Massachusetts
John Jay	1745 births, 1829 deaths, Deaths from stroke, Chief Justices of the United States, Founding Fathers of the United States, United States Supreme Court justices, Politicians from New York City, Slavers
Evan Longoria	1985 births, American League All-Stars, Baseball players from California, Living people, People from Downey, California, San Francisco Giants players, Sportspeople from California, Tampa Bay Devil Rays players, Tampa Bay Rays players
Nucleolus	Cell biology
Candice Bergen	American movie actors, American television actors, Actors from Beverly Hills, California, 1946 births, Living people
Duke Nukem 3D	1996 video games, Windows games, PlayStation games, Xbox 360 Live Arcade games, Sega Saturn games, Video game sequels, Sega Genesis games
William Rehnquist	1924 births, 2005 deaths, American Lutherans, Burials at Arlington National Cemetery, Chief Justices of the United States, Deaths from thyroid cancer, Harvard University alumni, Politicians from Milwaukee, Wisconsin, Stanford University alumni, United States Supreme Court justices
Hyderabad State	British India, Indian princely states, Former countries in South Asia, Territorial disputes of Pakistan, 1724 establishments, 1948 disestablishments in India, 1720s establishments in Asia, 18th century establishments in India, Nizams of Hyderabad
Two-nation theory	History of Pakistan, History of Bangladesh, Partition of India
Samuel Osgood	1747 births, 1813 deaths, United States Postmasters General, Politicians from Massachusetts
William Bradford (Attorney General)	1755 births, 1795 deaths, United States Attorneys General, Politicians from Philadelphia, Pennsylvania
Charles Lee (Attorney General)	1758 births, 1815 deaths, United States Attorneys General, Politicians from Virginia
Benjamin Stoddert	1751 births, 1813 deaths, Politicians from Maryland, United States Secretaries of the Navy
Joseph Hewes	1730 births, 1779 deaths, People from Princeton, New Jersey, Politicians from New Jersey, Politicians from North Carolina, Princeton University alumni, Signers of the U.S. Declaration of Independence
Candela	SI units
Hongwu Emperor	1328 births, 1398 deaths, Emperors and Empresses of China
Soulja Boy	American rap musicians from Illinois, 1990 births, Living people, Singers from Georgia (U.S. state), Singers from Illinois, African American musicians, American Internet celebrities, Twitch (service) streamers
Hadron	Subatomic particles
Zlatko Zahovič	1971 births, Living people, Slovenian footballers
Francis Lee	1944 births, Living people, English footballers, People from Lancashire
Shaun Goater	1970 births, Living people, Bermudian people, British footballers, North American footballers, Sport in Bermuda
Argentine Primera División	Football leagues, Football in Argentina, 1931 establishments, 20th-century establishments in Argentina, Sports leagues
Vladimír Šmicer	1973 births, Living people, Czech footballers
Dietmar Hamann	1973 births, Living people, German footballers, Sportspeople from Bavaria
Arthur Rowley	1926 births, 2002 deaths, English footballers, People from Wolverhampton, Sportspeople from Staffordshire
Laurie Cunningham	1956 births, 1989 deaths, English footballers, Sportspeople from London
Glenn Hoddle	1957 births, Living people, Chelsea F.C. players, English footballers, English football managers, England national football team managers, Sportspeople from London, Tottenham Hotspur F.C. players, Premier League players
Al-Saadi Qadhafi	1973 births, Living people, African footballers, People from Tripoli
Robert Pirès	1973 births, Living people, French footballers, People from Reims
Zoran Mirković	1971 births, Living people, Serbian footballers, People from Belgrade
Jimmy Floyd Hasselbaink	1972 births, Living people, 1998 FIFA World Cup players, Association football forwards, Chelsea F.C. players, Dutch football managers, Dutch footballers, Naturalised citizens of the Netherlands, People from Paramaribo, Premier League players
Andrew Cole	1971 births, Arsenal F.C. players, Black British sportspeople, English footballers, Living people, Manchester City F.C. players, Manchester United F.C. players, Sportspeople from Nottingham
FC Porto	Portuguese football clubs, Porto, 1893 establishments in Europe, Establishments in Portugal
F.C. Zenit Saint Petersburg	Russian football clubs, 1925 establishments, 1920s establishments in the Soviet Union
Steve Bruce	1960 births, Living people, English football managers, English footballers, Sportspeople from Northumberland, Premier League players
Stockport County F.C.	English football clubs, Stockport, Greater Manchester, 1883 establishments in the United Kingdom
Grand Theft Autumn / Where Is Your Boy	2003 songs, Fall Out Boy songs
Cornthwaite Rason	1858 births, 1927 deaths, Independent politicians in Australia, Politicians from Somerset, Premiers of Western Australia
Henry Daglish	1866 births, 1920 deaths, Premiers of Western Australia, Politicians from Victoria (Australia), Australian Labor Party politicians, People from Ballarat
Walter James	1863 births, 1943 deaths, Premiers of Western Australia, People from Perth, Western Australia, Independent politicians in Australia
Alf Morgans	1850 births, 1933 deaths, Premiers of Western Australia, Monmouthshire, Independent politicians in Australia
George Leake	1856 births, 1902 deaths, Independent politicians in Australia, Premiers of Western Australia, People from Perth, Western Australia
George Throssell	1840 births, 1910 deaths, Premiers of Western Australia, People from County Cork
John Forrest	1847 births, 1918 deaths, Premiers of Western Australia, Commonwealth Liberal Party politicians, Protectionist Party politicians, Treasurers of Australia
Into the Fire	Bryan Adams albums, 1987 albums
UK Albums Chart	Record charts
Attack model	Cryptography
Cuts Like a Knife	Bryan Adams albums, 1983 albums, Rock albums
You Want It You Got It	Bryan Adams albums, 1981 albums, Rock albums
Bryan Adams (album)	Bryan Adams albums, 1980 albums, Debut albums, Rock albums
Known-plaintext attack	Cryptography
18 til I Die	Bryan Adams albums, 1996 albums
On a Day Like Today	Bryan Adams albums, 1998 albums
Room Service	Bryan Adams albums, 2004 albums
11 (album)	2008 albums, Bryan Adams albums, Rock albums
Chosen-plaintext attack	Cryptography
Ciphertext-only attack	Cryptography
Chosen-ciphertext attack	Cryptography
Kambly	Food companies of Switzerland, 20th century establishments in Switzerland, 1910 establishments in Europe
Differential cryptanalysis	Cryptography
Linear cryptanalysis	Cryptography
Julianne Moore	1960 births, Living people, Academy Award winning actors, Satellite Award winners, Actors from North Carolina, American children's writers, American LGBT rights activists, American movie actors, American movie producers, American television actors, BAFTA Award winning actors, Emmy Award winning actors, Golden Globe Award winning actors, Scottish movie actors, Screen Actors Guild Award winners
Tropical Storm Cristobal (2008)	Atlantic tropical storms
Rijndael key schedule	Cryptography
Gorillaz	1998 establishments in England, 1990s British music groups, 2000s British music groups, 2010s British music groups, Animated characters, English rock bands, Musical groups established in 1998, Musical groups from Essex, Warner Bros. Records artists
Pantanal	Geography of Bolivia, Geography of Brazil, Paraguay, Biosphere reserves, Wetlands
Balliol College, Oxford	Colleges of the University of Oxford, 1263 establishments, 1260s establishments in Europe, 13th century establishments in England
Erich Mende	1916 births, 1998 deaths, German military personnel of World War II, Majors, People from former German territories, Politicians of the Christian Democratic Union of Germany, Politicians of the Free Democratic Party of Germany, Vice Chancellors of Germany
Petra Kelly	1947 births, 1992 deaths, Civil servants, Feminists, Former members of the German Bundestag, German essayists, German murder victims, German politicians of Alliance '90/The Greens, Green thinkers, Murders by firearm in Germany, Nonviolence advocates, Politicians from Baden-Württemberg
Along the River During Qingming Festival	Chinese culture, Paintings
Kaiserswerth	Düsseldorf-Kaiserswerth, Boroughs of Germany, Düsseldorf
Vichy	Former national capitals, Subprefectures in France, Capital of France, Communes in Allier
Indochina	Southeast Asia, Peninsulas
Wadi Halfa	Cities in Sudan
Mechanical energy	Mechanics, Energy
Vitiligo	Diseases
Virtue	Ethics
Greyhound Lines	American transport companies, 1914 establishments in the United States, Bus transport
Twofish	Cryptography
Truncated differential cryptanalysis	Cryptography
Fatimid Caliphate	Arab people, Caliphates, Former countries in the Middle East, Former monarchies, Former monarchies of Africa, Former monarchies of Asia, Royal dynasties, 909 establishments, 12th century disestablishments in Africa, 12th century disestablishments in Asia, 10th-century establishments in Africa, 10th century establishments in Asia, 1171 disestablishments
Maghreb	Regions of Africa
Plaintext	Cryptography
Ciphertext	Cryptography
Azad Kashmir Day	Kashmir, Holidays
Stream cipher	Cryptography
Nyon	Municipalities of Vaud, Cities in Switzerland
Letterkenny	Towns in Ireland, County Donegal
Thalwil	Cities in Switzerland, Municipalities of Zürich
Hearth	Home
Jack-o'-lantern	Cucurbitaceae
Lakes of Titan	Saturn's moons
West Coast blues	Blues music
Frederick Pottinger	1831 births, 1865 deaths, Australian police officers
Bushfire	Fire, Ecology
Artificial selection	Classical genetics, Domesticated animals, Agriculture
Selectable marker	Genetic engineering
Evolutionary algorithm	Artificial intelligence
Artificial life	Scientific modeling
Nils Aall Barricelli	1912 births, 1993 deaths, Norwegian mathematicians, Italian mathematicians
Genetic algorithm	Artificial intelligence
Ingo Rechenberg	1934 births, Living people
Evolution strategy	Artificial intelligence
John Henry Holland	1929 births, 2015 deaths, American psychologists, Scientists from Indiana
Ontario Lacus	Saturn's moons, Lakes
Penetrometer	Geology, Measuring tools
Crème brûlée	Desserts
Kraken Mare	Saturn's moons
Ligeia Mare	Saturn's moons
Keystream	Cryptography
Noor Jehan	1926 births, 2000 deaths, Pakistani movie actors, Pakistani singers, Punjabi people
Nusrat Fateh Ali Khan	1948 births, 1997 deaths, Pakistani people, Punjabi people, Pakistani singers, Bollywood playback singers
Aziz Mian	1942 births, 2000 deaths, Pakistani singers, People from Delhi
Kashmir Solidarity Day	Kashmir, Holidays
National emblem of Bangladesh	Bangladesh, National coats of arms
Instrument of Surrender	1971 in Bangladesh, 1971 in Pakistan, Bangladesh Liberation War
Product cipher	Cryptography
Islamic Republic	Politics of Pakistan, Mauritania, Iran, Politics of Afghanistan, Forms of government
Key schedule	Cryptography
EFF DES cracker	Cryptography
Classified information	National security, Secrecy
Security clearance	National security
Sensitive information	National security
Trade secret	Secrecy, Trade, Intellectual property law
Rock Steady	2001 albums, No Doubt albums
Meet-in-the-middle attack	Cryptography
Key whitening	Cryptography
ESTREAM	Cryptography
MacGuffin (cipher)	Cryptography
Feistel cipher	Cryptography
George Wythe	1726 births, 1805 deaths, Signers of the U.S. Declaration of Independence, Politicians from Virginia
Josiah Bartlett	1729 births, 1795 deaths, Signers of the U.S. Declaration of Independence, Politicians from Massachusetts, Governors of New Hampshire, American physicians, Democratic Republican party (US) politicians, Scientists from Massachusetts, Chief justices
Carter Braxton	Signers of the U.S. Declaration of Independence, Politicians from Virginia, 1736 births, 1797 deaths
Islamic theology	Islam
Mac OS X Leopard	MacOS
Weather forecast	Meteorology
MacBook	Apple hardware, Laptops
SMS	Communication
International waters	Bodies of water, Law of the sea
Alternative hip hop	Fusion music genres, Hip hop genres, Alternative music
Jason Varitek	1972 births, American baseball players, Boston Red Sox players, Sportspeople from Michigan, Living people
Süddeutsche Zeitung	Newspapers published in Germany, 1945 establishments in Europe, 1940s establishments in Germany
Frankfurter Allgemeine Zeitung	Newspapers published in Germany, 1949 establishments in Germany
Frankfurter Rundschau	Newspapers published in Germany
Die Zeit	Newspapers published in Germany
Der Spiegel	Magazines of Europe, Germany
Oliver Wolcott	1726 births, 1797 deaths, American generals, Governors of Connecticut, Signers of the U.S. Declaration of Independence, Yale University alumni, Lieutenant Governors of Connecticut
Thomas Paine	1737 births, 1809 deaths, 18th century philosophers, 19th century philosophers, American deists, American philosophers, American revolutionaries, English inventors, English philosophers, Founding Fathers of the United States, Naturalized citizens of the United States, People from Norfolk
Richard R. Schrock	American chemists, American Nobel Prize winners, Scientists from Indiana, Scientists from San Diego, California, 1945 births, Living people
All your base are belong to us	Video game memes
Gall	Plant tissues, Parasitism
Zeroth law of thermodynamics	Thermodynamics, Laws of physics
Third law of thermodynamics	Thermodynamics, Laws of physics
Dion Dublin	1969 births, Living people, English footballers, Sportspeople from Leicester, Premier League players
Danny Murphy	1977 births, Living people, English footballers, People from Chester, Sportspeople from Cheshire
Stéphane Henchoz	1974 births, Living people, Swiss footballers
Milan Baroš	1981 births, Living people, Czech footballers
Gabriel Batistuta	1969 births, Living people, Argentine footballers
Bentley	British automobile companies
Chloe O'Brian	Television characters
Communes of the Bouches-du-Rhône department	Communes in Bouches-du-Rhône, Lists of communes of France
Allauch	Communes in Bouches-du-Rhône
Alleins	Communes in Bouches-du-Rhône
Aubagne	Communes in Bouches-du-Rhône
Aureille	Communes in Bouches-du-Rhône
Auriol, Bouches-du-Rhône	Communes in Bouches-du-Rhône
Aurons	Communes in Bouches-du-Rhône
La Barben	Communes in Bouches-du-Rhône
Barbentane	Communes in Bouches-du-Rhône
Ehrenbreitstein	Buildings and structures in Rhineland-Palatinate, Castles in Germany, Koblenz
Les Baux-de-Provence	Communes in Bouches-du-Rhône
Beaurecueil	Communes in Bouches-du-Rhône
Belcodène	Communes in Bouches-du-Rhône
Berre-l'Étang	Communes in Bouches-du-Rhône
Bouc-Bel-Air	Communes in Bouches-du-Rhône
Jeep	American automobile companies, Sport utility vehicles
La Bouilladisse	Communes in Bouches-du-Rhône
Boulbon	Communes in Bouches-du-Rhône
Cabannes, Bouches-du-Rhône	Communes in Bouches-du-Rhône
Cabriès	Communes in Bouches-du-Rhône
Cadolive	Communes in Bouches-du-Rhône
Carnoux-en-Provence	Communes in Bouches-du-Rhône
Carry-le-Rouet	Communes in Bouches-du-Rhône
Cassis	Communes in Bouches-du-Rhône
Ceyreste	Communes in Bouches-du-Rhône
Charleval, Bouches-du-Rhône	Communes in Bouches-du-Rhône
Châteauneuf-le-Rouge	Communes in Bouches-du-Rhône
Châteauneuf-les-Martigues	Communes in Bouches-du-Rhône
Châteaurenard	Communes in Bouches-du-Rhône
La Ciotat	Communes in Bouches-du-Rhône
Cornillon-Confoux	Communes in Bouches-du-Rhône
Coudoux	Communes in Bouches-du-Rhône
Cuges-les-Pins	Communes in Bouches-du-Rhône
La Destrousse	Communes in Bouches-du-Rhône
Éguilles	Communes in Bouches-du-Rhône
Ensuès-la-Redonne	Communes in Bouches-du-Rhône
Eygalières	Communes in Bouches-du-Rhône
Eyguières	Communes in Bouches-du-Rhône
Eyragues	Communes in Bouches-du-Rhône
La Fare-les-Oliviers	Communes in Bouches-du-Rhône
Fontvieille, Bouches-du-Rhône	Communes in Bouches-du-Rhône
Fos-sur-Mer	Communes in Bouches-du-Rhône
Fuveau	Communes in Bouches-du-Rhône
Gardanne	Communes in Bouches-du-Rhône
Gémenos	Communes in Bouches-du-Rhône
Gignac-la-Nerthe	Communes in Bouches-du-Rhône
Grans	Communes in Bouches-du-Rhône
Graveson	Communes in Bouches-du-Rhône
Gréasque	Communes in Bouches-du-Rhône
Istres	Communes in Bouches-du-Rhône, Subprefectures in France
Jouques	Communes in Bouches-du-Rhône
Lamanon	Communes in Bouches-du-Rhône
Lambesc	Communes in Bouches-du-Rhône
Lançon-Provence	Communes in Bouches-du-Rhône
Maillane	Communes in Bouches-du-Rhône
Mallemort	Communes in Bouches-du-Rhône
Marignane	Communes in Bouches-du-Rhône
Mandaeism	Esotericism
Substitution box	Cryptography
Martigues	Communes in Bouches-du-Rhône
Mas-Blanc-des-Alpilles	Communes in Bouches-du-Rhône
Maussane-les-Alpilles	Communes in Bouches-du-Rhône
Meyrargues	Communes in Bouches-du-Rhône
Meyreuil	Communes in Bouches-du-Rhône
Mimet	Communes in Bouches-du-Rhône
Miramas	Communes in Bouches-du-Rhône
Mollégès	Communes in Bouches-du-Rhône
Mouriès	Communes in Bouches-du-Rhône
Noves	Communes in Bouches-du-Rhône
Orgon	Communes in Bouches-du-Rhône
Paradou	Communes in Bouches-du-Rhône
Pélissanne	Communes in Bouches-du-Rhône
Les Pennes-Mirabeau	Communes in Bouches-du-Rhône
La Penne-sur-Huveaune	Communes in Bouches-du-Rhône
Peynier	Communes in Bouches-du-Rhône
Peypin	Communes in Bouches-du-Rhône
Peyrolles-en-Provence	Communes in Bouches-du-Rhône
Plan-de-Cuques	Communes in Bouches-du-Rhône
Plan-d'Orgon	Communes in Bouches-du-Rhône
Confusion and diffusion	Cryptography
Port-de-Bouc	Communes in Bouches-du-Rhône
Port-Saint-Louis-du-Rhône	Communes in Bouches-du-Rhône
Puyloubier	Communes in Bouches-du-Rhône
Le Puy-Sainte-Réparade	Communes in Bouches-du-Rhône
Rognac	Communes in Bouches-du-Rhône
Rognes, Bouches-du-Rhône	Communes in Bouches-du-Rhône
Rognonas	Communes in Bouches-du-Rhône
La Roque-d'Anthéron	Communes in Bouches-du-Rhône
Communication Theory of Secrecy Systems	Cryptography
Come as You Are (Nirvana song)	Nirvana songs, 1992 songs
International Data Encryption Algorithm	Cryptography
Luduş	Towns in Romania
2008 Yemen floods	2008 in Asia, 2000s disasters in Asia, 21st century in Yemen, Floods in Asia, October 2008 events
Alexander Ramsey	1815 births, 1903 deaths, United States Secretaries of War, United States senators from Minnesota, Politicians from Pennsylvania
Lounge Act	Nirvana songs, 1991 songs
Hurricane Dean	2007 Atlantic hurricane season, Retired tropical cyclone names, Hurricanes in Mexico, 2007 in Mexico, 2000s in Puerto Rico, 2000s in the Dominican Republic, 2000s in Haiti, 2000s in Jamaica, History of the Cayman Islands, 2000s in Belize, 2000s in Honduras, 2000s in Nicaragua, August events, Hurricanes in Jamaica
Amazon Basin	Regions of South America, Drainage basins
Bixa orellana	Malvales
Xochiquetzal	Aztec gods and goddesses
Tlatoani	Kings and queens, Mexican people
José de Acosta	1539 births, 1600 deaths, Jesuits, Missionaries, Naturalists, Spanish Roman Catholics, Spanish writers
Catarrh	Diseases
Upper class	Social groups
Chocolate bar	Candy
Veracruz, Veracruz	Cities in Mexico, Veracruz
Hans Sloane	British physicians, People from County Down, 1660 births, 1773 deaths, Irish scientists
Royal College of Physicians	Medicine
Coenraad Johannes van Houten	1801 births, 1887 deaths, Dutch chemists, Dutch inventors, People from Amsterdam, Chocolate
Cocoa butter	Food ingredients
Pietro Longhi	1701 births, 1785 deaths, 18th century Italian painters
Alex Turner (musician)	English guitarists, English rock musicians, English singer-songwriters, People from Sheffield, 1986 births, Living people
Dodge	1900 establishments in the United States, American automobile companies, 1900s establishments in Michigan
Ordered pair	Mathematics
Arts and crafts	Hobbies, Art
Chrysler	American automobile companies, 1925 establishments in the United States
Nazia Hassan	1965 births, 2000 deaths, Pakistani singers, Cancer deaths in England, Deaths from lung cancer, Pakistani Muslims, People from Karachi, Sufis
Bilawal Bhutto Zardari	1988 births, Living people, Pakistani politicians
Muhammad Ijaz-ul-Haq	1953 births, Living people, Pakistani military people, Pakistani Muslims, Pakistani politicians
Zille Huma	Pakistani singers, Punjabi people, Year of birth missing (living people)
Sonya Jehan	Punjabi people, Pakistani movie actors, French actors, 1980 births, Living people
Aga Khan III	1877 births, 1957 deaths, British India, Knights Grand Commander of the Order of the Indian Empire, Knights Grand Commander of the Order of the Star of India, Knights Grand Cross of the Order of St Michael and St George, Knights Grand Cross of the Royal Victorian Order, Leaders of All India Muslim League, Muslim League, Muslims, People of British India, Privy Councillors (UK)
Iran-Pakistan barrier	Buildings and structures in Iran, Pakistan
William Sterndale Bennett	1816 births, 1875 deaths, English composers, Romantic composers
Grand Trunk Road	Transport in Pakistan, Roads in India
Space-time tradeoff	Computer science
Substitution-permutation network	Cryptography
Square (cipher)	Cryptography
Permutation box	Cryptography
Carnivorous plant	Flowering plants, Carnivorous plants
Joe Kinnear	Irish footballers, Irish football managers, Sportspeople from Dublin, 1946 births, Living people
Matt Busby	1909 births, 1994 deaths, Deaths from cancer, Scottish footballers, Scottish football managers
Brett Emerton	1979 births, Living people, Australian footballers, Sportspeople from Sydney
David Rocastle	English footballers, Sportspeople from London, 1967 births, 2001 deaths, Premier League players
Fazilka Tehsil	Punjab, India
Flag of Azerbaijan	Flags of Azerbaijan, Azerbaijani culture, National flags
Coat of arms of Azerbaijan	National coats of arms, National symbols of Azerbaijan
Roquefort-la-Bédoule	Communes in Bouches-du-Rhône
Roquevaire	Communes in Bouches-du-Rhône
Rousset, Bouches-du-Rhône	Communes in Bouches-du-Rhône
Le Rove	Communes in Bouches-du-Rhône
Saint-Andiol	Communes in Bouches-du-Rhône
Saint-Antonin-sur-Bayon	Communes in Bouches-du-Rhône
Saint-Cannat	Communes in Bouches-du-Rhône
Saint-Chamas	Communes in Bouches-du-Rhône
Saintes-Maries-de-la-Mer	Communes in Bouches-du-Rhône
Saint-Estève-Janson	Communes in Bouches-du-Rhône
Saint-Étienne-du-Grès	Communes in Bouches-du-Rhône
Saint-Marc-Jaumegarde	Communes in Bouches-du-Rhône
Saint-Martin-de-Crau	Communes in Bouches-du-Rhône
Saint-Mitre-les-Remparts	Communes in Bouches-du-Rhône
Saint-Paul-lès-Durance	Communes in Bouches-du-Rhône
Saint-Pierre-de-Mézoargues	Communes in Bouches-du-Rhône
Saint-Rémy-de-Provence	Communes in Bouches-du-Rhône
Saint-Savournin	Communes in Bouches-du-Rhône
Saint-Victoret	Communes in Bouches-du-Rhône
Salon-de-Provence	Communes in Bouches-du-Rhône
Sausset-les-Pins	Communes in Bouches-du-Rhône
Sénas	Communes in Bouches-du-Rhône
Septèmes-les-Vallons	Communes in Bouches-du-Rhône
Simiane-Collongue	Communes in Bouches-du-Rhône
Le Tholonet	Communes in Bouches-du-Rhône
Trets	Communes in Bouches-du-Rhône
Vauvenargues, Bouches-du-Rhône	Communes in Bouches-du-Rhône
Velaux	Communes in Bouches-du-Rhône
Venelles	Communes in Bouches-du-Rhône
Ventabren	Communes in Bouches-du-Rhône
Vernègues	Communes in Bouches-du-Rhône
Verquières	Communes in Bouches-du-Rhône
Vitrolles, Bouches-du-Rhône	Communes in Bouches-du-Rhône
Alphonse Daudet	1840 births, 1897 deaths, French playwrights, French poets, French novelists
Gustave Flaubert	1821 births, 1880 deaths, Cardiovascular disease deaths in France, Deaths from cerebral hemorrhage, French novelists, French playwrights, People from Rouen
Roquefort, Gers	Communes in Gers
Roquefort, Landes	Communes in Landes
Lookup table	Computer science
Roquefort, Lot-et-Garonne	Communes in Lot-et-Garonne
Roquefort-sur-Soulzon	Communes in Aveyron
Corn, Lot	Communes in Lot
Roquefort-de-Sault	Communes in Aude
Roquefort-des-Corbières	Communes in Aude
Roquefort-les-Cascades	Communes in Ariège
Roquefort-les-Pins	Communes in Alpes-Maritimes
Roquefort-sur-Garonne	Communes in Haute-Garonne
Avalanche effect	Cryptography
Rocquefort	Communes in Seine-Maritime
BBC Radio 1Xtra	BBC radio
Barrel	Containers, Units of volume
Claudio Ulpiano	Brazilian people, 1932 births, 1999 deaths, Philosophers
Jorge Mautner	1941 births, Living people, Brazilian Jews, Brazilian singers, Brazilian poets, Composers, Jewish musicians, Jewish writers, People from Rio de Janeiro
Meshuggah	Swedish heavy metal bands, Umeå, Musical groups established in 1987
Andy McKee	1979 births, Living people, American guitarists, American folk musicians, Musicians from Kansas, People from Topeka, Kansas
Beverly Hills Chihuahua	2008 movies, Disney movies, American family movies, Movies about animals, Movies directed by Raja Gosnell, Beverly Hills, California in fiction, American children's comedy movies
Destruction (band)	Thrash metal bands
Hans-Christian Ströbele	1939 births, Living people, German lawyers, German politicians of Alliance '90/The Greens, People from Halle, Saxony-Anhalt, Politicians from Saxony-Anhalt
Banksy	English artists, Year of birth unknown, Living people, English painters, Mural artists
Rodney Mullen	American skateboarders, Sportspeople from Florida, 1966 births, Living people
Tony Hawk	1968 births, Actors from San Diego, California, American movie actors, American philanthropists, American skateboarders, American television actors, Businesspeople from California, Living people, Sportspeople from San Diego, California, Skateboarders
Santa Maria, Bulacan	Settlements in the Philippines, 1647 establishments, Establishments in the Philippines, 17th century establishments in Asia
Winton M. Blount	United States Postmasters General, Politicians from Alabama, 1921 births, 2002 deaths
List of sex positions	Sexual acts, Lists
Richard Bache	1737 births, 1811 deaths, United States Postmasters General, People from Yorkshire
Mark Hughes	1963 births, Living people, Welsh footballers
Albert Gallatin	1761 births, 1849 deaths, United States Secretaries of the Treasury, People from Geneva
Henry Dearborn	1751 births, 1829 deaths, Politicians from New Hampshire, United States representatives from Massachusetts, United States Secretaries of War
Robert Smith (cabinet)	1757 births, 1842 deaths, United States Secretaries of State, United States Attorneys General, Politicians from Pennsylvania
Caesar A. Rodney	1772 births, 1824 deaths, Politicians from Wilmington, Delaware, United States Attorneys General, United States representatives from Delaware, United States senators from Delaware
Derrick Pierce	1974 births, Living people, Actors from Los Angeles, California, Actors from Massachusetts, American pornographic actors
Topher Grace	1978 births, Living people, American movie actors, American television actors, Actors from New York City
Mirepoix (cuisine)	Food ingredients
Béchamel sauce	Dishes named after people, Mother sauces
American Dad!	American Dad!, 2005 American television series debuts, 2000s American television series, 2010s American television series, Adult animated television series, Adult Swim, American animated television series, American sitcoms, Fox television series, English-language television programs
Mirepoix, Gers	Communes in Gers
Landon Donovan	1982 births, Living people, American footballers, Sportspeople from Los Angeles, California
Coriander	Apiaceae, Herbs, Spices
Brad Friedel	1971 births, Living people, American footballers, Sportspeople from Ohio, Association football goalkeepers, People from Lakewood, Ohio
Nílton Santos	1925 births, 2013 deaths, Deaths from respiratory failure, Footballers from Rio de Janeiro
DaMarcus Beasley	1982 births, Living people, American footballers, Sportspeople from Indiana, People from Fort Wayne, Indiana
Alecko Eskandarian	American footballers, Sportspeople from New Jersey, 1982 births, Living people
Smash Hits	Music magazines, Radio, Websites, British television channels
Liga I	Football leagues, Football in Romania, 1909 establishments in Europe, 20th century establishments in Romania
Battle of the Mediterranean	European battles of World War II, 1940 in Europe, 1941 in Europe, 1942 in Europe, 1943 in Europe, 1944 in Europe, 1945 in Europe
Cryptographic hash function	Cryptography
Data integrity	Computer science, Communication
Cryptosystem	Cryptography
Serpent (cipher)	Cryptography
Pretty Good Privacy	Cryptography, Internet security
Weak key	Cryptography
XSL attack	Cryptography
Sound the Alarm	2006 albums, Concept albums
Ennis	County towns in Ireland, County Clare
Trey Parker	1969 births, Living people, American animators, American movie directors, American screenwriters, Emmy Award winners, Actors from Colorado, Writers from Colorado, American movie actors, American television actors, American voice actors, Lyricists, Libertarians
Matt Stone	American animators, American movie actors, American screenwriters, Emmy Award winners, actors from Houston, Texas, writers from Texas, 1971 births, Living people, Libertarians
Treaty of friendship and alliance between the Government of Mongolia and Tibet	20th century in Mongolia, Tibet, 1910s treaties, 1913
Waterford	County towns in Ireland, Waterford
Dissipation	Thermodynamics, Physics
Galway	County towns in Ireland, County Galway
Porta Alchemica	Occult, Buildings and structures in Rome
Springfield, Massachusetts	County seats in Massachusetts, Springfield, Massachusetts
Global apartheid	Politics
Baccara	1981 disestablishments, Disco groups, Girl groups, Musical duos, Musical groups disestablished in 1981, Musical groups established in 1977, Pop music groups, Spanish musical groups, 1977 establishments in Europe, 1970s establishments in Spain, 1980s disestablishments in Europe
The Big Bang Theory	2007 American television series debuts, 2000s American sitcoms, 2000s romance television series, 2010s American sitcoms, 2010s romance television series, Autism in fiction, CBS network shows, College television series, Pasadena, California, Romantic comedy television series, Television series about families, Television series about friendship, Television series about marriage, Television series set in Los Angeles County, California, English-language television programs
Smilodon	Fossils, Machairodonts, Sabretooth cats
The Clash (Album)	1977 albums, The Clash albums, Punk albums
Give 'Em Enough Rope	1978 albums, The Clash albums, Punk albums
The Daily Show	1996 American television series debuts, 1990s American comedy television series, 1990s satirical television series, 2000s American comedy television series, 2000s satirical television series, 2010s American comedy television series, 2010s satirical television series, American satirical television series, Emmy Award winning programs, English-language television programs
Ritchie Neville	1979 births, Living people, English singers, People from Solihull
Five (band)	1997 establishments in the United Kingdom, 1990s British music groups, 2000s British music groups, 2010s British music groups, English boy bands, English pop music groups, Musical groups established in 1997, Musical groups from London
Secret Diary of a Call Girl	2007 British television series debuts, 2011 British television series endings, 2000s British drama television series, 2010s British drama television series, ITV television programmes, Television series set in London, Works about prostitution, English-language television programs
ITV2	British television channels
Belle de Jour (writer)	1975 births, Living people, American prostitutes, Bloggers, Jewish American writers, Jewish British writers, Jewish sex industry people, Naturalised citizens of the United Kingdom, Writers from Florida, American bloggers
Cloth mill Offermann	Buildings and structures in North Rhine-Westphalia, Companies of Germany, 18th century establishments in Germany
St. Anger	Metallica albums, 2003 albums
Killing Is My Business... and Business Is Good!	1984 albums, Debut albums, Heavy metal albums, Megadeth albums
Dalek	Doctor Who
Rust in Peace	Megadeth albums, 1990 albums
Fable II	2008 video games, Xbox 360 games, Role-playing video games
Aveyron	Departments in Occitanie
Bouches-du-Rhône	Departments in Provence-Alpes-Côte d'Azur
Vocal cords	Neck
Parallel computing	Computer science
WrestleMania IV	WrestleMania, Atlantic City, New Jersey, Sports in New Jersey, 1988 in professional wrestling, 1988 in the United States, 1980s in New Jersey, March events
Cantal	Departments in Auvergne-Rhône-Alpes
WrestleMania V	WrestleMania, Atlantic City, New Jersey, Sports in New Jersey, 1989 in professional wrestling, 1989 in the United States, 1980s in New Jersey, April events
Charente	Departments in Nouvelle-Aquitaine
Charente-Maritime	Departments in Nouvelle-Aquitaine
Optimization (computer science)	Computer science
Pilgrimage of Grace	16th century in England, 1536, Rebellions in Europe, 1530s in Europe
Embedded system	Computer science
WrestleMania VI	Sport in Toronto, WrestleMania, 1990 in professional wrestling, 1990s in Canada, History of Toronto, April events
Real-time computing	Computer science
AVN Award	Movie awards, Pornography, 1984 establishments
WrestleMania VII	WrestleMania, Sports in Los Angeles, 1991 in professional wrestling, 1991 in California, 1990s in Los Angeles, California, March events
WrestleMania VIII	WrestleMania, History of Indianapolis, Indiana, 1992 in professional wrestling, 1992 in the United States, April events, 20th century in Indiana
WrestleMania IX	WrestleMania, Las Vegas, Nevada, 1993 in the United States, 20th century in Nevada, 1993 in professional wrestling
Airbag	Automobiles, Safety
Darkly Dreaming Dexter	Crime fiction books, 2004 books
Dearly Devoted Dexter	Crime fiction books, 2005 books
Dexter in the Dark	Crime fiction books, 2007 books
Fugging, Austria	Cities and towns in Upper Austria
Susan Featherly	1963 births, Living people, American movie actors, Actors from New York, American television actors, People from Syracuse, New York
Ravenscraig	Towns in North Lanarkshire
Ron Wilson (ice hockey, born 1955)	1955 births, American ice hockey players, Canadian ice hockey defencemen, Ice hockey people from Ontario, Living people, Minnesota North Stars players, Toronto Maple Leafs players
Earth's inner core	Structure of the Earth
Peace Sells... but Who's Buying?	Megadeth albums, 1986 albums, Heavy metal albums
A Huge Ever Growing Pulsating Brain That Rules from the Centre of the Ultraworld	1989 songs
Hermann Carl Vogel	1841 births, 1907 deaths, German astronomers, People from Leipzig
Algol	Variable stars, Binary stars
So Far, So Good... So What!	Megadeth albums, 1988 albums
Lissamphibia	Amphibians
NRG Stadium	National Football League venues, Sports in Houston, Texas, Buildings and structures in Houston, Texas, Sports buildings in Texas
Bop It	Toys, Games
Shamanism	Religion
Jocky Scott	1948 births, Living people, Scottish football managers, Scottish footballers
Real-time operating system	Computer science
Rage (band)	German heavy metal bands
Egon Schiele	Austrian painters, Deaths from influenza, 1890 births, 1918 deaths
Reduced instruction set computer	Computer science
Complex instruction set computer	Computer science
Debugger	Computer science
BBC Radio 5 Live Sports Extra	BBC radio, Sports media
Firmware	Computer science
Tropical Storm Edouard (2008)	Atlantic tropical storms, Hurricanes in the United States, August events, 2008 Atlantic hurricane season, 2000s in Louisiana, 2008 in Texas
Immunity Aware Programming	Computer science, Radio
Discriminant	Mathematics
Single event upset	Electronic components
Chris Gbandi	1979 births, Living people, Liberian people, African footballers
Matthew Wolfenden (footballer)	English footballers, People from Oldham, Greater Manchester, 1987 births, Living people
Arthur Wharton	1865 births, 1930 deaths, Ghanaian footballers, Association football goalkeepers
Hristo Stoichkov	1966 births, Living people, Bulgarian footballers, Bulgarian football managers
Sandy Martens	1972 births, Living people, Belgian footballers
C. B. Fry	1872 births, 1956 deaths, English footballers, Sportspeople from London
Egil Olsen	1942 births, Living people, Norwegian footballers
Franck Queudrue	1978 births, Living people, French footballers, Sportspeople from Paris
Craig Bellamy	1979 births, Living people, 2012 Summer Olympics, British Olympians, Liverpool F.C. players, Manchester City F.C. players, Sportspeople from Cardiff, Welsh footballers, West Ham United F.C. players
Derlei	Brazilian footballers, 1975 births, Living people
Avril Lavigne	1984 births, Living people, Avril Lavigne, Canadian pop singers, Canadian rock guitarists, Canadian rock singers, Canadian singer-songwriters, Former good articles, Rock guitarists, Singers from Ontario
Hannibal Lecter	Characters in written fiction, Fictional characters introduced in 1981, Fictional European people, Fictional murderers, Fictional people with antisocial personality disorder, Movie characters
Asunción	National capitals in South America, Cities in Paraguay
Predestination	Theology, Christian theology, Hinduism
A Nightmare on Elm Street	1984 horror movies, 1980s ghost movies, 1980s serial killer movies, 1980s teen movies, A Nightmare on Elm Street movies, American ghost movies, American serial killer movies, American teen horror movies, English-language movies, Movies about suburbia, Slasher movies, Supernatural horror movies, American independent movies
Gladiolus	Iridaceae
Feathertail glider	Marsupials of Australia, Diprotodonts
Sugar glider	Marsupials of Australia, Diprotodonts
Bismarck Archipelago	Geography of Papua New Guinea
Legal precedent	Law
Ford Escort (Europe)	1960s automobiles, 1970s automobiles, 1980s automobiles, 1990s automobiles, Ford automobiles
Ford Fiesta	1970s automobiles, 1980s automobiles, 1990s automobiles, 2000s automobiles, Ford automobiles, 2010s automobiles
Ford Fusion (Europe)	2000s automobiles, Ford automobiles
Ford Galaxy	1990s automobiles, 2000s automobiles, Ford automobiles
Ford C-Max	2000s automobiles, 2010s automobiles, Ford automobiles
Ford S-Max	2000s automobiles, Ford automobiles
Ford Puma	1990s automobiles, 2000s automobiles, Ford automobiles
Kilkenny	County towns in Ireland, County Kilkenny, 1609 establishments, Establishments in the Republic of Ireland, 1600s establishments in Europe
Ford Cougar	1990s automobiles, 2000s automobiles, Ford automobiles
Ford Kuga	2000s automobiles, Ford automobiles
Ford Transit	Buses, Vans
Citroën XM	1980s automobiles, 1990s automobiles, Citroen automobiles
Citroën Xantia	1990s automobiles, 2000s automobiles, Citroen automobiles
Gaeltacht Quarter	Quarters of Belfast, Gaeltacht
Belfast Quarters	Quarters of Belfast
Citroën Xsara	1990s automobiles, 2000s automobiles, Citroen automobiles
Helsinki Olympic Stadium	Football stadiums in Europe, Football in Finland, Helsinki, 1952 Summer Olympics
Citroën Berlingo	Front wheel drive vehicles, Vans
DAX	Stock exchanges, Economy of Germany, Frankfurt
Westminster Under School	Schools in London, 1943 establishments in Europe, 1940s establishments in England
Furby	Toys
Cinderella (1950 movie)	1950 movies, 1950s romance movies, American family movies, American musical fantasy movies, American romance movies, Disney animated movies, English-language movies, Movies based on fairy tales, Movies composed by Oliver Wallace
God in Christianity	Christian theology
List of players with five or more goals in an NHL game	Lists of National Hockey League players, National Hockey League lists
Civil Police (Brazil)	Law enforcement agencies, Government of Brazil
Spring scale	Measuring tools
Churro	Desserts, Sweet breads, American food, Argentine food, Bolivian culture, Brazilian food, Chilean culture, Colombian food, Ecuador, Filipino culture, French food, Mexican food, New Mexico, Paraguay, Peruvian culture, Portuguese food, Spanish food, Uruguayan culture, Venezuelan food
The Lion King 1½	2004 movies, 2004 animated movies, American family movies, Disney animated movies, English-language movies, Sequel movies, The Lion King, Disney direct-to-video movies, Annie Award winners
Animatronics	Animation
Scar (The Lion King)	Animated characters, Disney characters, Kingdom Hearts characters, Fictional animals, Fictional characters introduced in 1994, Fictional murderers, The Lion King
Pepe le Pew	Looney Tunes characters, Animated characters, Fictional animals, Fictional characters introduced in the 1940s
List of Tom and Jerry episodes	Lists of animated television series episodes
Woolworths (Australia)	1924 establishments, 1920s establishments in Australia, Supermarkets of Australia
Privatization	Economics, Property
One Canada Square	1991 establishments in England, Buildings and structures completed in the 1990s, Buildings and structures in London, Skyscrapers in the United Kingdom
Chevrolet Monte Carlo	1970s automobiles, 1980s automobiles, 1990s automobiles, 2000s automobiles, Chevrolet automobiles
Plymouth Superbird	1970s automobiles
Dodge Charger Daytona	1960s automobiles
Opel Combo	1990s automobiles, 2000s automobiles, 2010s automobiles, Opel automobiles
Citroën 2CV	Front wheel drive vehicles, Sedans, 1950s automobiles, 1960s automobiles, 1970s automobiles, 1980s automobiles, 1990s automobiles, Citroen automobiles
Renault 4	Front wheel drive vehicles, 1960s automobiles, 1970s automobiles, 1980s automobiles, 1990s automobiles, Renault automobiles
Škoda Roomster	Škoda automobiles, 2000s automobiles
Volvo C30	2000s automobiles, 2010s automobiles, Volvo automobiles
Volkswagen Corrado	1980s automobiles, 1990s automobiles, Volkswagen automobiles, Front wheel drive vehicles
Volvo V70	1990s automobiles, 2000s automobiles, 2010s automobiles, Volvo automobiles
Volvo V50	2000s automobiles, 2010s automobiles, Volvo automobiles
Ford Mondeo	1990s automobiles, 2000s automobiles, 2010s automobiles, Ford automobiles
Volvo V40	1990s automobiles, 2000s automobiles, Volvo automobiles
Volvo S40	1990s automobiles, 2000s automobiles, 2010s automobiles, Volvo automobiles
El Hadji Diouf	1981 births, Living people, Senegalese footballers
Dennis Wise	1966 births, Living people, English footballers, English football managers, Sportspeople from London, Premier League players
Ashley Ward	English footballers, People from Lancashire, 1970 births, Living people, Premier League players
Ivica Kralj	1973 births, Living people, Montenegrin footballers, Association football goalkeepers
Bit-level parallelism	Computer science
Instruction level parallelism	Computer science
Data parallelism	Computer science
Task parallelism	Computer science
Interrupt latency	Computer science
Flavors of Entanglement	2008 albums, Alanis Morissette albums
Thread switching latency	Computer science
Process switching latency	Computer science
Penguin (comics)	Batman characters, DC Comics characters, Fictional characters introduced in 1941
Batman (1966 movie)	Movies based on TV series, Movies based on comic book characters, Batman movies, 1966 movies, English-language movies, Movies directed by Leslie H. Martinson
Context switch	Computer science
Diamond Jubilee	Parties, Time
The Jungle Book 2	2003 movies, 2003 animated movies, Disney animated movies, American family movies, American musical movies, Movies about animals, Jungle movies, Movies set in India, Sequel movies, Movies based on books
King Louie	Disney characters
Cindy McCain	1954 births, Living people, American Baptists, Businesspeople from Phoenix, Arizona, Politicians from Phoenix, Arizona, US Republican Party politicians
Thread (computer science)	Computer science
Tilde de Paula	1954 births, Living people, Swedish television presenters, Chilean television presenters
Sofia Wistam	1966 births, Living people, Swedish television presenters
Gry Forssell	1973 births, Living people, Swedish television presenters
Cynthia McKinney	1955 births, Living people, African American politicians, Greens politicians, Politicians from Atlanta, Georgia
Task (computers)	Computer science
Eddie Brock	Fictional characters introduced in 1988, Marvel Comics characters
Process (computing)	Computer science
Imam Samudra	1970 births, Criminals, Indonesian people
Huda bin Abdul Haq	1960 births, Criminals
Amrozi bin Nurhasyim	1962 births, 2008 deaths, Indonesian people, Muslim terrorists, People executed by firearm
Studs Terkel	American historians, Jewish American actors, American journalists, Actors from New York City, Actors from Chicago, Writers from New York City, Writers from Chicago, 1912 births, 2008 deaths, Pulitzer Prize winners, American movie actors, American television actors
Bob Barr	1948 births, Living people, American Methodists, Politicians from Iowa, 2008 United States presidential candidates, United States representatives from Georgia, US Libertarian Party politicians, US Republican Party politicians
Multi-user	Computer science, Computing, Video games
Flying squirrel	Squirrels
S1m0ne	2002 comedy-drama movies, 2002 science fiction movies, American comedy-drama movies, American science fiction movies, English-language movies
Sooty mangabey	Old World monkeys, Mammals of Africa
Joe Byrne	1856 births, 1880 deaths, Australian criminals, Ned Kelly, Bushrangers, People from Victoria (Australia), Booker Prize winners
College basketball	College basketball
Public university	Colleges and universities
University of Michigan-Flint	Colleges and universities in Michigan, University of Michigan, Flint, Michigan, 1956 establishments in the United States, 1950s establishments in Michigan
Shirley Hufstedler	United States Secretaries of Education, Politicians from Denver, Colorado, Deaths from cerebrovascular disease, 1925 births, 2016 deaths
University of Michigan–Dearborn	University of Michigan, 1959 establishments in the United States, 1950s establishments in Michigan
Margaret Spellings	United States Secretaries of Education, Politicians from Michigan, Politicians from Texas, US Republican Party politicians, 1957 births, Living people
Public Ivy	Colleges and universities in the United States
Nundle, New South Wales	Towns in New South Wales
National Library of Australia	Museums in Australia, National libraries, Government agencies of Australia, Buildings and structures in Canberra, 1960 establishments in Australia, Libraries in Australia
Breeza, New South Wales	Towns in New South Wales
Retail	Shops, Retail markets
Mauro Zárate	1987 births, Living people, Sportspeople from Buenos Aires, Argentine footballers
Gunnedah, New South Wales	Towns in New South Wales
Instruction pipelining	Computer science
Sami Hyypiä	1973 births, Living people, Finnish footballers
Now That's What I Call Music! 29 (U.S. series)	2009 albums, Compilation albums
Thrissur	Kerala
Michigan Territory	History of Michigan, 1805 establishments in the United States, 1837 disestablishments, 19th-century disestablishments in the United States, Former territories of the United States
Syro-Malabar Catholic Church	Eastern Catholicism
Jurassic Coast	Devon, Dorset, Geography of England, World Heritage Sites in the United Kingdom
Instruction (computer science)	Microprocessor design
Piacenza	Cities in Emilia-Romagna, Capital cities in Italy
Superscalar	Computer science
SA80	Firearms, British Army equipment
Geoff Bunn	1963 births, Living people, English artists, People from Birmingham
Fred Yates	1922 births, 2008 deaths, English painters, People from Lancashire
Sauerbraten	German food, Meat dishes
The Economist	Magazines of the United Kingdom
Our Lady of Guadalupe	Roman Catholicism, Christian symbols, Mexico City, Marian apparitions, 1531
Poison (band)	American hard rock bands, Glam metal bands, Musical groups from Pennsylvania, Enigma Records artists
Yao Ming	1980 births, Autobiographers, Basketball players, Chinese sportspeople, Houston Rockets players, Living people, People from Shanghai
Ray Emery	1982 births, 2018 deaths, Accidental deaths by drowning, American Hockey League players, Anaheim Ducks players, Canadian ice hockey goaltenders, Chicago Blackhawks players, Ice hockey people from Ontario, Ontario Hockey League players, Ottawa Senators players, People from Hamilton, Philadelphia Flyers players, Stanley Cup champions
Execution unit	Microprocessor design
Pre-1600 Atlantic hurricane seasons	Atlantic hurricane seasons
Valley Parade	Football stadiums in England, 1886 establishments in England
Levi Lincoln Sr.	1749 births, 1820 deaths, United States Attorneys General, Lieutenant Governors of Massachusetts, Governors of Massachusetts
James R. Schlesinger	1929 births, 2014 deaths, Deaths from pneumonia, Directors of the Central Intelligence Agency, Infectious disease deaths in the United States, Politicians from New York City, United States Secretaries of Defense, United States Secretaries of Energy
Simultaneous multithreading	Computer science
Out-of-order execution	Computer science
Speculative execution	Computer science
Branch prediction	Microprocessor design
Key exchange	Cryptography
Secure channel	Cryptography
Terminology	Terminology
Communes of the Vaucluse department	Communes in Vaucluse, Lists of communes of France
Althen-des-Paluds	Communes in Vaucluse
Ansouis	Communes in Vaucluse
Apt, Vaucluse	Communes in Vaucluse, Subprefectures in France
Aubignan	Communes in Vaucluse
Aurel, Vaucluse	Communes in Vaucluse
Auribeau	Communes in Vaucluse
Le Barroux	Communes in Vaucluse
La Bastide-des-Jourdans	Communes in Vaucluse
La Bastidonne	Communes in Vaucluse
Le Beaucet	Communes in Vaucluse
Beaumes-de-Venise	Communes in Vaucluse
Beaumettes	Communes in Vaucluse
Beaumont-de-Pertuis	Communes in Vaucluse
Beaumont-du-Ventoux	Communes in Vaucluse
Bédarrides	Communes in Vaucluse
Bédoin	Communes in Vaucluse
Blauvac	Communes in Vaucluse
Bollène	Communes in Vaucluse
Bonnieux	Communes in Vaucluse
Brantes	Communes in Vaucluse
Buisson	Communes in Vaucluse
Buoux	Communes in Vaucluse
Cabrières-d'Aigues	Communes in Vaucluse
Cabrières-d'Avignon	Communes in Vaucluse
Flag of Oman	Oman, National flags
Cadenet	Communes in Vaucluse
Caderousse	Communes in Vaucluse
Coat of arms of Oman	Oman, National coats of arms
Cairanne	Communes in Vaucluse
Camaret-sur-Aigues	Communes in Vaucluse
Caromb	Communes in Vaucluse
Carpentras	Communes in Vaucluse, Subprefectures in France
Caseneuve	Communes in Vaucluse
Castellet	Communes in Vaucluse
Caumont-sur-Durance	Communes in Vaucluse
Cavaillon	Communes in Vaucluse
Châteauneuf-de-Gadagne	Communes in Vaucluse
Châteauneuf-du-Pape	Communes in Vaucluse
Cheval-Blanc	Communes in Vaucluse
Courthézon	Communes in Vaucluse
Crestet	Communes in Vaucluse
Crillon-le-Brave	Communes in Vaucluse
Cucuron	Communes in Vaucluse
Entraigues-sur-la-Sorgue	Communes in Vaucluse
Entrechaux	Communes in Vaucluse
Faucon	Communes in Vaucluse
Flassan	Communes in Vaucluse
Fontaine-de-Vaucluse	Communes in Vaucluse
Gargas, Vaucluse	Communes in Vaucluse
Gignac, Vaucluse	Communes in Vaucluse
Gigondas	Communes in Vaucluse
Gordes	Communes in Vaucluse
Goult	Communes in Vaucluse
Grambois	Communes in Vaucluse
Grillon	Communes in Vaucluse
L'Isle-sur-la-Sorgue	Communes in Vaucluse
Jonquerettes	Communes in Vaucluse
Jonquières, Vaucluse	Communes in Vaucluse
Joucas	Communes in Vaucluse
Lacoste, Vaucluse	Communes in Vaucluse
Lafare	Communes in Vaucluse
Lagarde-d'Apt	Communes in Vaucluse
Lagarde-Paréol	Communes in Vaucluse
Lagnes	Communes in Vaucluse
Lamotte-du-Rhône	Communes in Vaucluse
Lapalud	Communes in Vaucluse
Lauris	Communes in Vaucluse
Lioux	Communes in Vaucluse
Loriol-du-Comtat	Communes in Vaucluse
Lourmarin	Communes in Vaucluse
Malaucène	Communes in Vaucluse
Malemort-du-Comtat	Communes in Vaucluse
Maubec, Vaucluse	Communes in Vaucluse
Mazan	Communes in Vaucluse
Ménerbes	Communes in Vaucluse
Mérindol	Communes in Vaucluse
Méthamis	Communes in Vaucluse
Mirabeau, Vaucluse	Communes in Vaucluse
Voice over Internet Protocol	Telephone, Internet protocols
Vaucluse	Departments in Provence-Alpes-Côte d'Azur
Diffie-Hellman key exchange	Cryptography
British royal family	British royalty, British monarchy, House of Windsor
MQV	Cryptography
Cher (department)	Departments in Centre-Val de Loire
Corrèze	Departments in Nouvelle-Aquitaine
Runtime	Computer science
Java virtual machine	Computer science
Station-to-Station protocol	Cryptography
Internet Key Exchange	Cryptography
Shared secret	Cryptography
Styphnolobium japonicum	Faboideae
Horsforth	Towns in West Yorkshire
Pre-shared key	Cryptography
Corse-du-Sud	Departments in Corsica
Haute-Corse	Departments in Corsica
Côte-d'Or	Departments in Bourgogne-Franche-Comté
Côtes-d'Armor	Departments in Brittany
Creuse	Departments in Nouvelle-Aquitaine
Dordogne	Departments in Nouvelle-Aquitaine
Doubs	Doubs
Drôme	Departments in Auvergne-Rhône-Alpes
IPsec	Internet protocols, Cryptography
Eure	Departments in Normandy
Eure-et-Loir	Departments in Centre-Val de Loire
Key-agreement protocol	Cryptography
Finistère	Departments in Brittany
1800–1809 Atlantic hurricane seasons	1800s in the United States, Atlantic hurricane seasons
1810–1819 Atlantic hurricane seasons	Atlantic hurricane seasons, 1810s
1820–1829 Atlantic hurricane seasons	Atlantic hurricane seasons, 1820s
1830–1839 Atlantic hurricane seasons	Atlantic hurricane seasons, 1830s
Jigglypuff	Pokémon monsters
Muhammad al-Qaim Bi-Amrillah	893 births, 946 deaths, Muslims
Victoria Falls	Waterfalls, Bodies of water of Africa, World Heritage Sites in Africa, Geography of Zambia, Geography of Zimbabwe
Anti-nuclear movement	Political movements, Nuclear energy

