Jump	Basic English 850 words
Light microscope	Microscopes
Rembrandt	1606 births, 1669 deaths, Dutch painters, Dutch Protestants, People from Leiden, Printmakers
Major movie studios	American film studios, Cinema of Southern California, Film distributors of the United States, Movie studios
Culinary mustard	Condiments
Condiment	Condiments
Vinegar	Condiments
Insecticide	Agriculture, Poisons
Paranoia	Psychosis
Delusion	Psychosis
Paganism	Paganism, Religions
1578	1578
1504	1504
1726	1726
Courage	Emotions
1710s	1710s
Fanatic	Sports, Fandom
Formula 1	Formula One
Abdullah Öcalan	1949 births, Living people, Kurdish people, Turkish people, Extradition
Caribbean Community	Caribbean Community, 1973 establishments
1747	1747
1762	1762
1620	1620
1520	1520
List of towns in Greenland	Lists of settlements in North America, Towns in North America, Settlements in Greenland
Qaqortoq	Settlements in Greenland
Sisimiut	Settlements in Greenland
Arctic Circle	Lines of latitude, Arctic
Kabul	Kabul
Parfait	Desserts, Ice cream, French food
Parrot	Parrots
Angel food cake	Cakes
Wrench	tools
Salman Rushdie	Booker Prize winners, English novelists, English essayists, Indian novelists, Indian essayists, Royal Society of Literature, 1947 births, Living people
Lilo & Stitch	2002 animated movies, 2002 science fiction movies, Disney animated movies, English-language movies, Impact of the September 11 attacks, Lilo & Stitch, American family movies, American musical movies, American science fiction movies
AFI's 100 Years... 100 Laughs	Lists of movies, American Film Institute
Irish Sea	Seas of the Atlantic Ocean, Ireland, Geography of the United Kingdom
Hatred	Basic English 850 words, Emotions
1270	1270
Dallas	1840s establishments in the Republic of Texas, 1841 establishments in the United States, Dallas, Texas, County seats in Texas
Ilulissat	Settlements in Greenland
Pan (genus)	Hominins
Meridian	Lines of longitude
1700s	1700s
District	Districts
Literacy	Education
Isle of Man	Isle of Man
French Revolution	French Revolution
Daffy Duck	Looney Tunes characters, Fictional ducks, Fictional characters introduced in the 1930s, Animated characters, Comics characters, Comic books
1650s	1650s
Guillotine	History, Capital punishment
School uniform	Uniforms
Primate	Primates
Tropic of Cancer	Lines of latitude
Equinox	Time, Astronomical phenomena
Teufelsbrücke	Buildings and structures in Switzerland, Stone bridges
Grandparent	Family, Relationships
1630s	1630s
Lepton	Elementary particles
1620s	1620s
Jersey	English-speaking countries, Islands of the Channel Islands, Jersey
East Timor	East Timor, Lesser Sunda Islands, Least developed countries
Country music	Country music
1690s	1690s
Tootsie	1982 comedy-drama movies, 1980s romantic comedy movies, 1980s romantic drama movies, Academy Award winning movies, American comedy-drama movies, American romantic comedy movies, American romantic drama movies, Columbia Pictures movies, English-language movies, Movies directed by Sydney Pollack, United States National Film Registry movies
Lynyrd Skynyrd	1966 establishments in the United States, 1960s American music groups, 1970s American music groups, 1980s American music groups, 1990s American music groups, 2000s American music groups, 2010s American music groups, American rock bands, Musical groups established in 1966, Musical groups from Florida, Musicians from Jacksonville, Florida, Southern rock bands
Peter Handke	1942 births, Living people, Austrian Nobel Prize winners, Austrian writers, European translators, People from Carinthia (state)
Density	Measurement, Matter
Gram	Units of mass
Longitude	Lines of longitude, Measurement
Hilary Duff	1987 births, Living people, Actors from Houston, Texas, American movie actors, American pop singers, American television actors, Extras, Singers from Houston, Texas
Oil platform	Energy
Continental shelf	Landforms, Oceanography, Biomes
Mariana Trench	Pacific Ocean, Oceanography, Plate tectonics
Mariana Islands	Islands of Oceania, Island insular areas of the United States, Micronesia
Image scanner	Computer hardware, Data input
Brassière	Underwear, Breasts
Torture	torture, War crimes
1680s	1680s
Iqaluit	Cities in Canada, Nunavut, Provincial and territorial capitals of Canada
Phasor	Engineering
Svalbard	Archipelagos, Arctic islands, Islands of Norway
1670s	1670s
Margrethe II of Denmark	1940 births, Living people, Kings and Queens of Denmark, Knights Grand Cross of the Royal Victorian Order, Order of Merit of the Federal Republic of Germany, People from Copenhagen, Current national leaders
Enterprise architecture	Business
Mutilation	Health, Torture
Heiner Zieschang	1936 births, 2004 deaths, German academics, German mathematicians, People from Kiel
Jan Mayen	Arctic islands, Islands of Norway, Uninhabited regions
Gate	Walls, Gates
City gate	Fortification, Walls
Bern	Bern, Imperial free cities, 1191 establishments, 1190s establishments in Europe, Establishments in Switzerland
Demo (software)	Software
Preview	Computing, Movie industry, Television
Atomic mass	Chemistry
Price	Basic English 850 words
1640s	1640s
1660s	1660s
Gaza Strip	Gaza Strip
Unemployment	Employment, Social issues
Salary	Employment, Income
Instant noodles	Noodles, Asian foods
Louis Armstrong	1901 births, 1971 deaths, African-American singers, American jazz musicians, Cardiovascular disease deaths in New York, Deaths from myocardial infarction, American jazz singers, Musicians from New Orleans, Louisiana, Singers from New Orleans, Louisiana, Trumpeters
1430s	1430s
Element	VOA Special English words
CBS	Columbia Broadcasting System, Viacom, 1927 establishments in the United States
Prime Minister of Canada	Prime Ministers of Canada, Government of Canada
Magnetism	Magnetism
Althing	Reykjavík, National legislatures, 10th century establishments in Europe, Establishments in Iceland
Amapá	Amapá, 1988 establishments in Brazil, States of Brazil
Fictional character	Fictional characters
Blues	Blues music, African-American history
Macroeconomics	Macroeconomics
Game theory	Economics, Game theory
Taj Mahal	Buildings and structures in India, Monuments and memorials, Uttar Pradesh, World Heritage Sites in India, Mughal architecture, 17th century establishments in India
Aryan	Asia language templates, Indo-European peoples, People
Uzbekistan	Uzbekistan, Members of the Organisation of Islamic Cooperation
1200s	1200s
United Arab Emirates	United Arab Emirates, Current monarchies, Members of the Organisation of Islamic Cooperation
Wok	Cookware and bakeware
United States Navy	United States Navy, 1798 establishments in the United States
Pro bono	Legal terms, Giving
Chemical formula	Chemical nomenclature, Notation
Harvard University	Association of American Universities, Collegiate Water Polo Association, ECAC Hockey, Harvard University, Ivy League, Cambridge, Massachusetts, 1636 establishments, 1630s establishments in Massachusetts
Tamil language	Tamil language
Kerala	Kerala, States of India
Malayalam	Dravidian languages, Languages of India, Kerala
Coimbatore	Cities in Tamil Nadu, Coimbatore district
Madurai	Cities in Tamil Nadu, Madurai district
Assam	Assam, States of India
Arunachal Pradesh	Arunachal Pradesh, Territorial disputes of India
Bihar	Bihar, States of India
Chhattisgarh	Chhattisgarh, States of India
Gujarat	Gujarat, States of India
Haryana	Haryana, States of India
Himachal Pradesh	Himachal Pradesh, States of India
Jammu and Kashmir (state)	Jammu and Kashmir, Territorial disputes of India, Territorial disputes of Pakistan
Jharkhand	Jharkhand, States of India
Madhya Pradesh	Madhya Pradesh, States of India
Manipur	Manipur, States of India
Meghalaya	Meghalaya, States of India
Mizoram	Northeast India, Mizoram, States of India
Nagaland	Nagaland, States of India
Odisha	Odisha, States of India
Punjab, India	Punjab, India, States of India
Rajasthan	Rajasthan, States of India
Tripura	Tripura, States of India
Uttarakhand	Uttarakhand, States of India
Uttar Pradesh	Uttar Pradesh, States of India
West Bengal	West Bengal, States of India
Szczecin	Cities in Poland
Metropolitan area	Metropolitan areas, Political subdivisions
Marathi language	Indo-Aryan languages, Languages of India
Gujarati language	Indo-Aryan languages, Languages of Pakistan, Languages of India
Punjabi language	Punjabi language, Languages of India, Languages of Punjab (Pakistan)
Sikhism	Sikhism
Kaveri River	Rivers of Tamil Nadu
Bhopal	Bhopal
Dialect	Language
Thanjavur	Settlements in Tamil Nadu, Thanjavur District
Oman	Oman, Current monarchies, Members of the Organisation of Islamic Cooperation, Ibadi kingdoms, Ibadism
Refugee	Refugees, Forced migration
Copperbelt	Provinces of Zambia
Levy Mwanawasa	1948 births, 2008 deaths, Presidents of Zambia, Vice-Presidents of Zambia
Cherokee	Cherokee Nation
Soup	Basic English 850 words, Soups
1420s	1420s
Hyderabad, India	Former good articles, Hyderabad, India
Manmohan Singh	Indian economists, Prime Ministers of India, 1932 births, Indian National Congress politicians, Living people
Indira Gandhi	1917 births, 1984 deaths, Alumni of the University of Oxford, Indian National Congress politicians, Assassinated people, Government ministers, Indian Hindus, Indian murder victims, Murders by firearm, People murdered in India, Prime Ministers of India, Women politicians
Nintendo 64	Nintendo video game consoles
Phobos	Greek gods and goddesses
Deimos	Greek gods and goddesses
Krakatoa	Volcanoes of Indonesia, Islands of Indonesia
Goldfish	Pets, Teleosts, Freshwater fish, Aquarium fish
Premature ejaculation	Human sexuality
Witch	Religion, Witches
1210s	1210s
West Bank	West Bank
Jan Hus	1369 births, 1415 deaths, Christian religious leaders, Czech people, Konstanz, Christianity of the Middle Ages, People executed by burning, Christian ministers, Roman Catholics
Konstanz	Konstanz, Konstanz (district)
Instant messaging	Instant messaging software, Messaging
AOL	Internet service providers, 1985 establishments in the United States
Youssef Rzouga	1957 births, Poets, Tunisian writers, Living people, People from Tunis
Mailman	Occupations, Postal service
Chinese postman problem	Graph theory
Four color theorem	Combinatorial optimization
Theorem	Mathematics
Triceratops	Ornithischia, Ceratopsids, Dinosaurs of North America
Border	Political geography
Genus	Taxonomy
Cretaceous	Cretaceous
Textbook	Learning
Axiom	Mathematics
Set	Set theory
Maldives	Maldives, Members of the Organisation of Islamic Cooperation
Prime Minister of Australia	Prime Ministers of Australia, Lists of prime ministers, Australia-related lists
1190s	1190s
Structure	Chemistry, Engineering, Geology, Linguistics, Physics, Systems
Hardcore punk	Hardcore punk
Limestone	Carbonate rocks, Sedimentary rocks
Root	Basic English 850 words, Plant anatomy
Piero Gobetti	Italian people, Italian journalists, 1901 births, 1926 deaths
Manama	Capital cities in Asia, Settlements in Bahrain
Protist	Protista, Cell biology
The Apple Dumpling Gang	1975 movies, Disney movies, Movies based on books
0s	0s
1001	1001
1009	1009
1024	1024
Quentin Tarantino	Actors from Tennessee, American movie actors, American movie directors, People from Knoxville, Tennessee, 1963 births, Living people
Leander-class frigate	British warships
Spacecraft	Spacecraft
Acoustics	Sound
Public finance	Economics
Budget	Economics, Accounting
Indirect tax	Taxation
Erode	Cities in Tamil Nadu, Erode district
Sky Sports	British television networks, Sport in the United Kingdom, British Sky Broadcasting
Rhetoric	Literature, Public speaking, Performing arts, Rhetoric
Skill	Skills
Hamas	Arab–Israeli conflict, Gaza Strip, National liberation movements, Nationalist organizations in Palestine, Political parties in Asia, Politics of Palestine, Sunni organizations, 1987 establishments in Asia, Islamic terrorism
Suicide attack	Suicide attacks
Laser	Light, Machines, Acronyms
NBC	NBC, 1926 establishments in the United States, American television networks, Companies based in New York City
Thiruvananthapuram	Capital cities in India, Settlements in Kerala
Animal Farm	1945 books, Animal Farm, Books by George Orwell
Miso	Japanese food
Miso soup	Soups, Japanese food
Wakame	Algae, Vegetables
Kelp	Algae, Vegetables
Tofu	Foods, Chinese food, Japanese food
Soy milk	Plant milks
Dashi	Food ingredients, Soups, Japanese food
Shiitake mushroom	Edible fungi
Soy sauce	Condiments, Sauces
Bowl	Kitchenware
Oktoberfest	1810 establishments in Europe, 1810s establishments in Germany, Entertainment in Germany, Festivals in Europe, Munich
Tomb Raider	Video game series
Hot dog	Sausage, German food, American food
Constipation	Diseases and disorders of the digestive system
Kernel (computer science)	Computer science
Ulm	Imperial free cities, 850s establishments, 9th century establishments in Europe, Establishments in Germany
Landlocked country	Countries
Kyrgyzstan	Kyrgyzstan, Members of the Organisation of Islamic Cooperation
Kebab	Middle Eastern foods, Afghanistan, Pakistani food, Iranian food, Turkish food, Azerbaijani food, Greek food
Halal	Food and drink, Islam
Surat	Cities in India, Settlements in Gujarat
Kanpur	Cities and towns in Uttar Pradesh, Towns in India
Web portal	Internet
Humanism	Humanism
The Guardian	1821 establishments, Newspapers published in the United Kingdom, 1820s establishments in the United Kingdom
Algae	Algae, Non-vascular plants
Alga (Korday district)	Hamlets, Settlements in Kazakhstan
Kelp forest	Biomes
Symbiosis	Symbiosis, Cell biology, Evolutionary biology
Al Ain	Cities in the United Arab Emirates
Jutland	Peninsulas, Geography of Denmark, Geography of Schleswig-Holstein, Regions of Germany
Plebiscite	Voting
Dubai	Dubai
Exclave	Exclaves
Enclave	Enclaves
Panhandle	Landforms
New town	Social sciences, Settlements, Urban planning
Park	Parks
Pond	Ponds, Biomes
Swan	Anatidae
Pupa	Insects
Goose	Geese, Poultry
Ovary	Anatomy of the female reproductive system
Axe	Cutting tools, Blades, Woodworking tools
Rhinoceros	Rhinoceroses
Alcoholic proof	Alcoholic drink
Acetobacter	Gram-negative bacteria
Archbishop of Canterbury	Archbishops of Canterbury
Ethanol	Fuel, Alcohols
Boiling point	Thermodynamics, Basic physics ideas
Platonic solid	Platonic solids
Euclidean algorithm	Algorithms
Eukaryote	Cell biology, Taxonomy, Eukaryotes
Unicellular organism	Microbiology
Multicellular organism	Evolutionary biology, Cell biology
Hexahedron	Polyhedra
Kazan State University	Colleges and universities in Russia, Tatarstan
New World	History of North America, History of South America
Rabbit	Lagomorphs, Pets
Louis Pasteur	1822 births, 1895 deaths, Cardiovascular disease deaths in France, Deaths from stroke, French chemists, Microbiologists, Vaccinologists
Akrotiri and Dhekelia	British overseas territories, Cyprus
Transcontinental country	Countries
Kurów	Villages in Poland
Scorpion	Arachnids
1216	1216
John Schlesinger	1926 births, 2003 deaths, Academy Award winning directors, Actors from London, BAFTA Award winners, British television directors, Cardiovascular disease deaths in California, Deaths from stroke, English movie actors, English movie producers, English television actors, English LGBT people, Jewish British actors, LGBT directors, Gay Jews, Jewish screenwriters, Movie directors from London
Landjäger	Sausage
Gilbert and Ellice Islands	Kiribati, Pacific islands, History of the United Kingdom, 1892 establishments in the United Kingdom, 19th-century establishments in Oceania
Casablanca	Casablanca
Flatulence	Digestive system
Computability theory	Theoretical computer science
Batman (city)	Cities in Turkey
Typewriter	Writing tools
Nocturnal animals	Zoology
Censorship	Censorship, Politics, Freedom
Czestochowa	Cities in Poland
Voivodeships of Poland	Voivodeships of Poland
50s	50s
Volleyball	Volleyball, Summer Olympic sports
Twilight	Parts of a day
Great Depression	20th century in the United States, Great Depression
1291	1291
Delhi	Delhi, Capital cities in Asia
European Central Bank	European Union, Banks, Frankfurt, 1998 establishments in Europe
Friendship	Sociology, Emotions, Relationships, State mottos of the United States, Texas
Clitoris	Anatomy of the female reproductive system
Berlin Wall	1961 establishments in Europe, 1990 disestablishments in Germany, Berlin Wall, 1960s establishments in Germany
Łódź	Łódź
Kraków	Kraków
Portland, Oregon	Portland, Oregon, Cities in Oregon, County seats in Oregon, 1845 establishments in the United States, 19th-century establishments in Oregon
Frame of reference	Relativity, Reference
Broadway	Manhattan, Roads in New York City, Theater, The Bronx
Schrödinger equation	Basic physics ideas, Mechanics, Partial differential equations
Nutmeg	Spices, Magnoliales
Run (island)	Islands of Indonesia
Shinty	Games, Sport in Scotland
1229	1229
1626	1626
1399	1399
54	54
48	40s
1244	1244
1253	1253
1627	1627
1645	1645
1072	1072
1263	1263
1264	1264
1641	1641
1680	1680
814	814
Hierarchy	Hierarchy
Sultan	Sultans
States and union territories of India	States of India, India-related lists
Finnish language	Finnic languages, Languages of Europe
Sleep	Basic English 850 words, VOA Special English words, Sleep
North Macedonia	North Macedonia, European Union candidate states
Anorexia nervosa	Eating disorders
Madness	Mental illnesses
Rabies	Diseases caused by viruses
Tirana	Tirana
John Forbes Nash Jr.	Abel Prize winners, American mathematicians, American Nobel Prize winners, Scientists from West Virginia, People with schizophrenia, Road accident deaths in New Jersey, 1928 births, 2015 deaths
Calisthenics	Fitness
Muteness	Health, Disability
Wooden spoon	Food utensils
Table tennis	Summer Olympic sports, Summer Paralympic Games, Table tennis, Indoor sports
Nayarit	States of Mexico
Mindanao	Islands of the Philippines
Phylum	Taxonomy
Knuckle	Joints
Conduction	Basic physics ideas
Royal family	Royalty and nobility, Monarchy
General election	Types of elections
2005 United Kingdom general election	2005 in the United Kingdom, 2005 elections, United Kingdom general elections, May 2005 events
Milenko Stefanovic	1930 births, Living people, classical musicians, jazz musicians, Clarinetists, Serbian musicians, Yugoslavian people, People from Belgrade
Flash memory	Computer memory
Bottrop	Urban districts in Regierungsbezirk Münster
Puducherry (union territory)	Puducherry
New York Yankees	New York Yankees, The Bronx
1048	1048
Terry Pratchett	1948 births, 2015 deaths, English science fiction writers, Deaths from Alzheimer's disease, Disease-related deaths in Wiltshire, English novelists, Infectious disease deaths in England, Writers from Buckinghamshire
1218	1218
1282	1282
Critic	Critics
Søren Kierkegaard	1813 births, 1855 deaths, 19th century philosophers, Danish writers, People from Copenhagen
1667	1667
Despotism	Forms of government
Lakshadweep	Commonwealth dependent states, Islands of India, Territories of India
Daman and Diu	Daman and Diu
Riding helmet	Protective clothing, Horse riding, Headgear
Ketchup	Condiments
1718	1718
Dadra and Nagar Haveli	Territories of India
1323	1323
Birthday	Birthdays
1442	1442
Yi I	Korean people, Confucianism, 1536 births, 1584 deaths
Yulgok	Pen names
Sunrise (company)	Entertainment companies
X-ray	Medical procedures, Light, Electromagnetism, Medical imaging
Computed tomography scanner	Medical equipment, Laboratory equipment, Medical imaging
Hanoi	Capital cities in Asia, Cities in Vietnam
The Chronicles of Narnia	The Chronicles of Narnia, Fantasy books
Asatru	Paganism
Otherkin	Lifestyles, Psychology
Pedro Romeiras	1961 births, Living people, Ballet dancers, People from Lisbon
Bonfire	Festivals, Fire
Bic Runga	1976 births, Living people, New Zealand singers, Pop musicians, People from Christchurch
Sputnik programme	Soviet spacecraft, Satellites, 1950s in the Soviet Union
Carnival	Religious festivals
Fasting	Religious behavior and experience, Food and drink
Walpurgis Night	Paganism
Bird flu	Diseases caused by viruses, Zoonoses
Jyllands-Posten Muhammad cartoons controversy	Controversies, History of Islam, 2005
Blasphemy	Theology
1180s	1180s
Brie	French cheeses
Charles-Maurice de Talleyrand-Périgord	1754 births, 1838 deaths, French diplomats
Pasteurization	Food preservation
Soft cheese	Cheeses
Cult	Cults
The Cult	English hard rock bands, English heavy metal bands, English punk bands
1028	1028
1056	1056
James A. Michener	1907 births, 1997 deaths, Deaths from renal failure, Writers from Pennsylvania, Writers from Hawaii, Writers from Austin, Texas, Harvard University faculty
1150s	1150s
War of 1812	1810s in the United States, Wars involving the British Empire, Wars involving the United States
Chandigarh	Capital cities in India, Punjab, India, Haryana, Territories of India
Convection	Basic physics ideas, Fluid mechanics, Heat transfer
Chipmunk	Squirrels, Mammals of North America
Vicente Mondéjar Piccio	1927 births, 2015 deaths, Filipino military people, Generals
Piccio	Italian families
1143	1143
Donald Duck	Fictional characters introduced in the 1930s, Fictional ducks, Donald Duck, Kingdom Hearts characters
1717	1717
Montevideo	Montevideo, 1726 establishments, 18th-century establishments in the Viceroyalty of Peru, 18th-century establishments in Uruguay
Book of Esther	Old Testament books
Clay	Sedimentary rocks
Rifle	Rifles
1748	1748
Deuterocanonical books	Books of the Bible
Sidekick	Fictional characters
Jurist	Jurists
Nicobar Islands	Islands of India, Andaman and Nicobar Islands
Andaman and Nicobar Islands	Commonwealth dependent states, Islands of India, Andaman and Nicobar Islands
Kazan	Tatarstan
Tornado	Tornadoes, Severe weather
Hard disk	Hard drives
Magnet	Magnetism, Tools
By-product	Waste
Toxic waste	waste
Space Runaway Ideon	Animated television series
Comic book	Comic books, Magazines
Spider-Man	Characters created by Stan Lee, Comic books, Fictional characters introduced in 1962, Fictional orphans, Marvel Comics adapted into movies, Marvel Comics mutates, Marvel Comics superheroes, Spider-Man, Tony Hawk's (series) guest characters, Fictional American people
Peanuts	Comic books, American comic strips
Eddie Cantor	Presidents of the Screen Actors Guild, American stage actors, Comedians from New York City, American Jews, Actors from New York City, Singers from New York City, American television actors, American radio actors, 1892 births, 1964 deaths
Days of Our Lives	1960s American television series, 1960s drama television series, 1970s American television series, 1970s drama television series, 1980s American drama television series, 1980s soap operas, 1990s American drama television series, 1990s soap operas, 2000s American drama television series, 2000s soap operas, 2010s American drama television series, 2010s soap operas, American soap operas, NBC network shows, English-language television programs
Recorder	Flutes
1067	1067
Adolphe Sax	1814 births, 1894 deaths, Belgian inventors, Belgian musicians, Clarinetists, People from Namur (province)
Unforgiven	1992 movies, 1990s western movies, American crime drama movies, Best Picture Oscar, English-language movies, Movies about prostitution, Movies about revenge, Movies set in Kansas, Movies set in the 19th century, United States National Film Registry movies, American western movies, Movies set in Wyoming, Movies directed by Clint Eastwood
Bucharest	Bucharest, Cities with more than a million inhabitants, 1459 establishments, 15th century establishments in Europe, Establishments in Romania
Avalanche	Natural events
Foot (unit)	Imperial units, Units of length
Acre	Units of area
Erfurt massacre	2002 in Europe, 2000s in Germany, 2000s murders in Europe, April events, Attacks on buildings and structures in Germany, Attacks on buildings and structures in the 2000s, Attacks on schools in Europe, Erfurt, Mass murder in Germany, Mass murder in the 2000s, Mass shootings in Europe, Mass shootings in the 2000s, Massacres in Europe, Murder in 2002, Murder-suicides in Europe, Murders by firearm in Germany, School shootings, Suicide in the 2000s, Suicides by firearm in Germany
Gymnasium (school)	Types of educational institutions
Huascarán	Andes, Volcanoes of South America, Geography of Peru
1490	1490
1571	1571
401	401
1068	1068
Australian rules football	Australian Football League
Australian Football League	Australian Football League
Urbain Grandier	1590 births, 1634 deaths, Executed French people, French Roman Catholics, People executed by burning, People executed for witchcraft
Cardinal Richelieu	1585 births, 1642 deaths, French Roman Catholics, French nobility, French politicians, Dukes and duchesses
Belaying	Rock climbing, Ropework
AFI's 100 Years... 100 Thrills	Lists of movies, American Film Institute
South Vietnam	1955 establishments in Asia, 1976 disestablishments in Asia, 20th century in Vietnam, Former countries in Southeast Asia, States and territories established in the 20th century, States and territories disestablished in the 20th century
Robert Ludlum	1927 births, 2001 deaths, Writers from New York City
1170s	1170s
Arab people	Arab people, Ancient history
Mebibyte	Computing measurement
Clergy	Religious workers
Acre (state)	Acre (state), States of Brazil
Roller coaster	Roller coasters
Zimbabwean dollar	Zimbabwe
Bahia	Bahia, States of Brazil
Body modification	Health, Body art
Serial killer	Serial killers
World Wide Fund for Nature	International environmental organizations, Companies of Switzerland, Conservation, Charities
Deforestation	Forests, Environmental issues
Scuba diving	Diving
Capillary	Blood vessels
Viriato Clemente da Cruz	1928 births, 1973 deaths, Poets, Angolan people
Mollusc	Molluscs
Sponge	Sponges, Basic English 850 words
Kibibyte	Computing measurement
Amplitude	Wave physics, Mechanical vibrations
Ska	Music genres, Jamaica, British culture, 1950s establishments in North America
Braille	Encodings, Disability, Writing systems
Switch	Electronic components, Electronic switches
Francis Bacon	1561 births, 1626 deaths, 16th century philosophers, 17th century philosophers, Attorneys general, Deaths from pneumonia, English philosophers, Infectious disease deaths in England, Lord Chancellors, Spies, Writers from London
Sled dog	Working dogs
Overland Expedition	1890s in the United States
Number theory	Number theory
Tear gas	Chemical compounds, Law enforcement equipment
Kaba Ma Kyei	National anthems, Myanmar
Yangon	Cities in Myanmar, Former national capitals
Pyinmana	Towns in Asia, Myanmar
Kyat	Currency of Asia, Myanmar
Burmese language	Burmese language
Danielle Steel	1947 births, Living people, American novelists, New York University alumni, Writers from New York City
Coat of arms	Coats of arms
Spear	weapons
Hat	Basic English 850 words, Headgear
Postage stamp	Postage stamps
Czechoslovakia	1918 establishments in Europe, 1990s disestablishments in Europe, Czechoslovakia, States and territories established in the 20th century, States and territories disestablished in the 1990s
1410s	1410s
William Randolph Hearst	1863 births, 1951 deaths, United States representatives from New York, Newspaper publishing, Businesspeople from San Francisco, US Democratic Party politicians, Politicians from California
Joseph Pulitzer	1847 births, 1911 deaths, American journalists, Hungarian Jews, Jewish American politicians, Jewish American writers, Jewish military people, Military personnel of the American Civil War, Naturalized citizens of the United States, Politicians from New York City, Pulitzer Prizes, United States representatives from New York, US Democratic Party politicians, Writers from New York City
Horace Greeley	1811 births, 1872 deaths, US Republican Party politicians, American journalists, United States representatives from New York, writers from New York
Arachnid	Arachnids, Arthropods, Parasites, Spiders
Arthropod	Arthropods
University of Alabama	Colleges and universities in Alabama, Oak Ridge Associated Universities, Southeastern Conference, 1831 establishments in the United States, 1830s establishments in Alabama
Buttercup	Flowers, Ranunculales
Gomaespuma	Radio programs
Engineer	Technology, Engineering, Science occupations
Division by zero	Arithmetics
Flamenco pa tos	Spanish culture, Holidays, Music festivals, Festivals in Europe
Peter I of Russia	1672 births, 1725 deaths, Emperors and empresses, Russian tsars, House of Romanov, Zaanstad
Musical note	Musical notation
Calabria	Calabria
WordPress	Internet, Software
Outback	Geography of Australia
Marske-by-the-Sea	Villages in North Yorkshire
PayPal	Websites, Finance, Elon Musk
Orson Welles	Academy Award Honorary Award winners, Actors from Wisconsin, American movie actors, American movie directors, American movie producers, American radio actors, American radio personalities, American screenwriters, American stage actors, American television actors, American television directors, American television producers, American television writers, American theatre directors, American voice actors, Theatre producers, Deaths from myocardial infarction, Writers from Wisconsin, People from Kenosha, Wisconsin, 1915 births, 1985 deaths
Slobodan Milošević	1941 births, 2006 deaths, Cardiovascular disease deaths in the Netherlands, Deaths from myocardial infarction, People who died in prison custody, Presidents of Serbia, Presidents of Yugoslavia, Presidents of Serbia and Montenegro, War criminals
Gymnosperm	Gymnosperms
Influenza pandemic of 1918	Diseases caused by viruses, 1918, 1919, 1920
Brock (Pokémon)	Pokémon characters, Anime characters
Zetland (lifeboat)	Boats
Silba	Mediterranean Islands, Islands of Europe, Geography of Croatia
Ian Fleming	1908 births, 1964 deaths, Cardiovascular disease deaths in England, Deaths from myocardial infarction, Disease-related deaths in Kent, English novelists, James Bond writers, People educated at Eton College, Writers from London
1602	1602
1676	1676
301	301
1611	1611
Raiders of the Lost Ark	1981 action movies, 1980s adventure movies, Indiana Jones movies, Movies set in the 1930s, Movies set in South America, Movies set in Asia, Movies set in Egypt, Movies set in Greece, Paramount movies, United States National Film Registry movies, Movies composed by John Williams
Ash Ketchum	Pokémon characters, Anime characters
World's Fair	Society
Métis people	First Nations people
Sangha	Buddhist terminology
Courteney Cox	1964 births, Living people, Actors from Birmingham, Alabama, American movie actors, American television actors, Arquette family
UEFA Champions League	UEFA Champions League, 1955 establishments in Europe
FA Cup	The Football Association, Football competitions, 1871 establishments in the United Kingdom
Old Trafford	1910 establishments in Europe, 1910s establishments in England, Football stadiums in England, Sport in Manchester
Stadium	Stadiums
Disaster	Natural disasters
Bobby Orr	1948 births, Art Ross Trophy winners, Boston Bruins players, Calder Trophy winners, Canadian ice hockey defencemen, Chicago Blackhawks players, Conn Smythe Trophy winners, Hart Memorial Trophy winners, Hockey Hall of Fame inductees, Ice hockey people from Ontario, James Norris Memorial Trophy winners, Living people, Ontario Hockey League players, Sportspeople from Ontario, Stanley Cup champions
The Muppet Show	Comedy television series, 1976 television series debuts, Muppets, First run syndicated television programs, 1981 disestablishments in the United States, 1981 television series endings, English-language television programs
1250	1250
Valencia (autonomous community)	Valencia (autonomous community)
Elx	Cities in Valencia (autonomous community), Municipalities in Valencia (autonomous community), Alicante Province
Java (programming language)	Programming languages, Sun Microsystems, Oracle Corporation
Eon	Geology, Units of time, Eons
Bhagavad Gita	Hindu texts
Upanishad	Hindu texts
Concert	Concerts
Palm tree	Trees, Arecaceae
Bailiwick of Guernsey	Guernsey
Alderney	Islands of the Channel Islands, Alderney
Hera	Twelve Olympians
Mirror	Tools
Space probe	Spacecraft, Machines
Blue's Clues	Children's television series, Nickelodeon television series, 1996 television series debuts, 2006 television series endings, Learning, Cognition
Ford Motor Company	Ford, 1903 establishments in the United States, Companies based in Michigan, 1900s establishments in Michigan
Rastafari movement	Rastafari
John Constable	1776 births, 1837 deaths, English painters, People from Suffolk, Royal Academicians
Alyssa Milano	1972 births, Living people, Actors from Brooklyn, Actors from Staten Island, American movie actors, American television actors, Musicians from Brooklyn, Musicians from Staten Island, Singers from New York City
A Beautiful Mind (movie)	2001 drama movies, 2000s biographical movies, American biographical movies, American drama movies, Best Picture Oscar, English-language movies, Golden Globe Award winning movies, Mental disorders in fiction, Movies about educators, Movies based on books, Movies directed by Ron Howard, Movies set in Massachusetts, Movies set in New Jersey, Movies set in universities and colleges, 1960s in fiction, 1970s in fiction, Academy Award winners, Historical movies, Movies based on real life events, Movies composed by James Horner, Movies set in Virginia, 2000s mystery movies, 2000s psychological movies, Screenplays by Akiva Goldsman, Universal Pictures movies
McGurk effect	Illusions, Sensory system, Experiments
J. M. W. Turner	1775 births, 1851 deaths, Artists from London, English painters, Royal Academicians
Mug	Containers
Claude Monet	Artists from Paris, French painters, Impressionist painters, 1840 births, 1926 deaths, Paintings by Claude Monet
Video	Technology
Exodus	Old Testament books
Stretching (body piercing)	Body art
Chernobyl disaster	1986 in Europe, 1980s explosions in Europe, 1980s in the Soviet Union, 20th century in Ukraine, April 1986 events, Disasters in the Soviet Union, Nuclear accidents
Pripyat	Cities in Ukraine, Ghost towns, Nuclear accidents, 1970s establishments in Europe, 1986 disestablishments, 20th century establishments in Ukraine
Thyroid cancer	Cancer
Containment building	Buildings and structures, Nuclear energy
Chernobyl	Cities in Ukraine, 1193 establishments, Establishments in Ukraine, 1190s establishments in Europe
Klaus Wowereit	1953 births, Living people, Gay men, German autobiographers, German LGBT people, German politicians of the Left Party, LGBT politicians, Politicians from Berlin, Politicians of the Social Democratic Party of Germany
Sino-Soviet split	History of the Soviet Union, History of the People's Republic of China
Awake	Basic English 850 words
Liu Bei	161 births, 223 deaths, Emperors of Three Kingdoms era
Cao Cao	155 births, 220 deaths, Three Kingdoms generals, Chinese poets
Zhang Fei	167 births, 221 deaths, Three Kingdoms generals
Dong Zhuo	139 births, 192 deaths, Three Kingdoms generals
Sun Quan	182 births, 252 deaths, Emperors of Three Kingdoms era
Conference	Communication
Pasture	Agriculture, Grasslands
Hectare	Units of area
Zhuge Liang	181 births, 234 deaths, Chinese politicians
Wavelength	Wave physics, Mechanical vibrations
Francis Scott Key	1779 births, 1843 deaths, 19th-century American poets, Writers from Maryland
Latex	Natural materials, Polymers
Drum	Drums
Pashupatinath Temple	Hindu temples, Nepal
Invasion	Military, Biology
Olive tree	Trees, Oleaceae
Hello	Human communication, Messaging
Annexation	Politics, International law
Manchuria	Russia, People's Republic of China
Tuva	Republics of Russia, Siberia, Federal subjects of Russia
Senkaku Islands	Islands of Japan, Islands of China, Islands of Taiwan, Territorial disputes, Ryukyu Islands, Uninhabited islands
World Youth Day	Roman Catholicism
Carl XVI Gustaf	Kings and Queens of Sweden, 1946 births, Living people, Recipients of the Decoration for Services to the Republic of Austria, Current national leaders
Age of Empires III	Real-time strategy video games, 2005 video games
Bank of China Tower	Skyscrapers in China, Buildings and structures in Hong Kong, I. M. Pei buildings, 1990 establishments in Asia, 1990s establishments in China
Ulan Bator	Mongolia, Capital cities in Asia, 1639 establishments, 17th century establishments in Asia, Establishments in Mongolia
Pyongyang	Pyongyang
IBM	American technology companies, 1911 establishments, Multinational technology companies
Mary, mother of Jesus	1st century BC births, 1st century deaths, Mary (mother of Jesus), New Testament people, Early Christian saints, People from Nazareth
Quake (video game)	Shooter video games, 1996 video games, Sega Saturn games
Kunya	Arabic words and phrases
Zen	Buddhism, Buddhist terminology
Scots	Scotland, West Germanic languages
Mathematical analysis	Mathematical analysis
Locust	Orthoptera, Agricultural pests
Grasshopper	Orthoptera
Olive oil	Cooking oils
Oil lamp	Lamps
Conjugation	Grammar
Tomáš Garrigue Masaryk	Czechoslovak politicians, Presidents of Czechoslovakia, 1850 births, 1937 deaths
Arachne	People in Greek mythology
Arachnophobia	Phobias, Spiders
Phobia	Phobias
John le Carré	1931 births, 2020 deaths, Alumni of the University of Oxford, Deaths from pneumonia, English novelists, Infectious disease deaths in England, Pen names, People from Poole, Writers from Dorset
Sexually transmitted disease	Sexually transmitted diseases
Atacama Desert	Deserts, Geography of Chile
International Atomic Energy Agency	International organizations, Nuclear energy, 1957 establishments
1080	1080
Roger Ebert	Burials at Graceland Cemetery, American agnostics, American historians, American journalists, Screenwriters from Illinois, Cancer deaths in Chicago, Democrats (United States), Movie critics from Chicago, People from Urbana, Illinois, Pulitzer Prize winners, Television personalities from Chicago, Webby Award winners, Writers from Chicago, Deaths from thyroid cancer, 1942 births, 2013 deaths, Former Roman Catholics
Seibersdorf	Cities and towns in Lower Austria
Russian Revolution	1917 in Russia, Revolutions
Baguette	Breads
Barometer	Weather, Weather instruments, Measuring tools
Nokia	1865 establishments in Europe, Electronics companies, Companies of Finland, Telephone companies, 1860s establishments in Finland, Mobile phone companies
Research	Research
Electronic Entertainment Expo	Video game events, 1995 establishments
Prince Edward Island	Prince Edward Island, 1873 establishments in Canada, Provinces and territories of Canada
Antigen	Immunology
Information entropy	Theoretical computer science
Spice Girls	1994 establishments in England, 1990s British music groups, 2000s British music groups, British girl groups, English pop music groups, Musical groups established in 1994, Musical quintets, Spice Girls, Musical groups disestablished in 2008, 2008 disestablishments in England
Traffic cone	Safety, Traffic signs
Agatha Christie	1890 births, 1976 deaths, Deaths from natural causes, English novelists, Writers from Devon, Torquay
Motion	Basic English 850 words
Kwame Nkrumah	1909 births, 1972 deaths, Presidents of Ghana, Prime ministers, Pan-Africanists, Privy Councillors (UK), Writers
Diego Velázquez	1599 births, 1660 deaths, Spanish painters
Kinshasa	Settlements in the Democratic Republic of the Congo, Capital cities in Africa
Great Barrier Reef	World Heritage Sites in Australia, National parks in Australia, Reefs, Geography of Queensland, Ecoregions, Australian National Heritage List, Protected areas of Queensland
Missouri Compromise	1820 in the United States, 19th century in Missouri, Slavery, Origins of the American Civil War
Peafowl	Phasianidae
Manager	Basic English 850 words, Management, Occupations
Dachshund	Dog breeds
Karachi	Cities in Pakistan, Settlements in Sindh, Capital of Pakistan
Transliteration	Language, Romanization
Taoism	Taoism
Adjustment	Basic English 850 words
Poverty	Poverty
British Empire	British Empire, History of Pakistan, History of Canada, British India
Chimbote	Cities in Peru
Tram	Rolling stock, Tram transport
Fast food	Fast food
Scott Joplin	1867 births, 1917 deaths, 20th century composers, African American musicians, American composers, American pianists, Deaths from infectious disease, Musicians from Texas
Propane	Alkanes
Flag of Japan	Japanese culture, National flags
Nationalism	 Nationalism
Drought	Droughts
Deafness	Disability, Hearing, Health problems
Liver bird	Liverpool, Merseyside, Sculptures
Demonstration	Social sciences
Chartist	19th century in the United Kingdom
Movie theater	Movie industry
1654	1654
The KLF	Musical groups from London, Hip hop bands, Electronic music bands
Monounsaturated fat	Lipids
Polyunsaturated fat	Lipids
The North Avenue Irregulars	1979 comedy movies, English-language movies
Candleshoe	1977 movies, Disney movies, Movies based on books
Hikaru Utada	Pop musicians, Japanese singers, Japanese songwriters, Singers from New York City, 1983 births, Living people
Scramble for Africa	19th century, 20th century, Colonialism, History of Africa
1160s	1160s
Seaweed	Algae
Fairy tale	Fairy tales
Game show	Games, Television game shows, Television genres
Genre	Genres
Kristy Swanson	1969 births, Living people, American movie actors, American television actors, Actors from Orange County, California
Octopus	Cephalopods
Byzantine Empire	Places of Ancient Rome, Byzantine Empire, Former countries in Europe, Former countries in the Middle East, Former countries in Africa, Roman Empire, 285 establishments, 1453 disestablishments, Establishments in Africa, 3rd century establishments in Asia, Establishments in Europe, Disestablishments in Europe, Disestablishments in Asia, Disestablishments in Africa
Guqin	Plucked string instruments, Chinese music, Masterpieces of the Oral and Intangible Heritage of Humanity
São Paulo (state)	São Paulo (state), States of Brazil
Trolley	Land vehicles
Mutant (Marvel)	Marvel Comics
Urethra	Anatomy of the urinary system, Anatomy of the male reproductive system
Stanislav Lem	1921 births, 2006 deaths, Polish writers
Hostage	Kidnapping
Intel	Technology companies
Nintendo Entertainment System	Nintendo video game consoles
System of a Down	American heavy metal bands, Grammy Award winners, Alternative metal bands, Musical groups from Los Angeles, California
Belarusian language	Slavic languages, Languages of Europe
Kevin Bacon	Actors from Philadelphia, Pennsylvania, American movie actors, American movie producers, American television actors, Golden Globe Award winning actors, Saturn Award winners, Screen Actors Guild Award winners, 1958 births, Living people
Kyra Sedgwick	1965 births, Living people, Actors from New York City, American movie actors, American movie producers, American television actors, American television producers, Emmy Award winning actors, Golden Globe Award winning actors
Treaty of Versailles	1919 in Europe, 1919 in France, 1910s treaties, World War I
Saint Pierre and Miquelon	Saint Pierre and Miquelon
50 (number)	Integers
Rzeszów	Cities in Poland
1604	1604
Houston	1836 establishments in the United States, 1830s establishments in the Republic of Texas, Houston, Texas, County seats in Texas
1138	1138
1140s	1140s
Polynesian people	Polynesia
Colonialism	Colonialism
Hey Arnold!	Animated television series, Nickelodeon television series, English-language television programs, 1996 television series debuts, 2004 television series endings
Diego Maradona	1960 births, 2020 deaths, 1982 FIFA World Cup players, 1986 FIFA World Cup players, 1990 FIFA World Cup players, 1994 FIFA World Cup players, Argentine footballers, Argentine football managers, People from Buenos Aires Province, Deaths from myocardial infarction
José Luis Rodríguez Zapatero	1960 births, Living people, People from Valladolid, Prime Ministers of Spain, Socialist politicians, Spanish socialists
Electric guitar	Guitars
Louise Brooks	1906 births, 1985 deaths, Actors from Kansas, American autobiographers, American silent movie actors, American stage actors, Cardiovascular disease deaths in the United States, Deaths from myocardial infarction
Bangor, Maine	Bangor, Maine, County seats in Maine
Ben Bradshaw	1960 births, Living people, Members of the British House of Commons for English constituencies, Labour MPs (UK)
Eschelbronn	Villages in Baden-Württemberg, Municipalities in Baden-Württemberg
Order of the Bath	History of the British Isles, Order of the Bath
Kurdish people	Kurds
Guerrilla warfare	War
Sacrament	Sacraments
St. Petersburg, Florida	St. Petersburg, Florida
20 (number)	Integers
40 (number)	Integers
70 (number)	Integers
Gas giant	Gas giants, Types of planet
North Vietnam	1945 establishments in Asia, 1976 disestablishments in Asia, 20th century in Vietnam, Former countries in Asia, States and territories established in the 1940s, States and territories disestablished in the 20th century
Set theory	Set theory
Demo (music)	Musical terminology
Breton language	Celtic languages, Languages of Europe
Celtic languages	Celtic languages
Salem, Tamil Nadu	Cities in Tamil Nadu, Salem District
Hunger strike	Social sciences, Deaths from starvation, Political prisoners
Hermitage Museum	Art museums, Buildings and structures in Saint Petersburg, Education in Russia, 1764 establishments, 18th century establishments in Russia
Boeing 747	Boeing 747
1081	1081
Richard Trevithick	1771 births, 1833 deaths, English inventors
Wasilla, Alaska	Cities in Alaska
Rantoul, Illinois	Villages in Illinois
Winter Springs, Florida	Cities in Florida
Fredericton, New Brunswick	Cities in New Brunswick, Provincial and territorial capitals of Canada
Clearwater, Florida	Cities in Florida, County seats in Florida
Jordanhill railway station	Railway stations in Scotland, Buildings and structures in Glasgow, 1887 establishments in Europe, 1880s establishments in Scotland
Googolplex	Integers
Flint	Sedimentary rocks
Valley Center, California	Census-designated places in California, Settlements in San Diego County, California
Newbridge, County Kildare	Towns in Ireland, County Kildare
Anaheim, California	Anaheim, California, 1857 establishments in California
Chair	Furniture
1163	1163
Hercules	Roman mythology
Navigation	Navigation
Hercules (1997 movie)	1997 movies, 1997 animated movies, Disney animated movies, Disney Renaissance, American fantasy movies, Movies based on Greek and Roman mythology, Movies composed by Alan Menken, Movies set in Greece, American comedy movies, American animated movies, Hercules (Disney)
The Karate Kid	1984 drama movies, 1980s sports movies, 1980s teen drama movies, American sports drama movies, American teen drama movies, Columbia Pictures movies, English-language movies, Movies about bullying, Movies set in Los Angeles, California, Teen sports movies, Martial arts movies, Karate, Movies directed by John G. Avildsen
533	533
Crazy Horse	Native American people, 1838 births, 1877 deaths, People from South Dakota
1185	1185
1377	1377
He-Man and the Masters of the Universe	Animated television series, First run syndicated television programs, English-language television programs
Fantasia Barrino	1984 births, Living people, Singers from North Carolina, American Idol winners, Actors from North Carolina
Cabrillo Beach	Beaches of California, Geography of Los Angeles, California
Chulalongkorn University	Colleges and universities in Thailand, 1917 establishments, Bangkok, 20th century establishments in Thailand, 1910s establishments in Asia
Khartoum	Capital cities in Africa, Cities in Sudan
Konkani language	Indo-Aryan languages, Languages of India
Trench	Everyday life
Trench coat	Clothing
Trumpet	Brass instruments, Jazz instruments
Microwave	wave physics
Microwave oven	Wave physics, Cooking appliances
Cobalt	Chemical elements, Metals, Transition metals
Canidae	Canids
Nickel	Chemical elements, Metals, Transition metals
Fox	Foxes
Food pyramid	Nutrition, Food and drink
Torso	Torso
Age of Mythology	2002 video games, Real-time strategy video games
Mississauga	Cities in Ontario
Cambridge, Massachusetts	Cambridge, Massachusetts, County seats in Massachusetts, 1630 establishments in Massachusetts
1280s	1280s
1087	1087
1672	1672
1684	1684
1713	1713
1743	1743
Coyote	Canids, Mammals of North America
Vole	rodents
Isthmus	Landforms
Rodent	Rodents
Titan (moon)	Saturn's moons
Computer number format	computer science
1550	1550
Columbus, Georgia	Columbus, Georgia, County seats in Georgia
Carthage	Ancient Rome, History of the Middle East, Phoenician colonies
1102	1102
1569	1569
1302	1302
Brockton, Massachusetts	Cities in Massachusetts, County seats in Massachusetts
Rabat	Capital cities in Africa, Cities in Morocco, 1146 establishments, Establishments in Morocco, 12th-century establishments in Africa
1222	1222
Duke Kahanamoku	1890 births, 1968 deaths, American Olympic gold medalists, Deaths from myocardial infarction, Surfers, Sportspeople from Hawaii
Overland Park, Kansas	Overland Park, Kansas
Bedford	Towns in Bedfordshire
Pentomino	Shapes
Ejaculation	Male reproductive system
Team	Relationships
Hirohito	Deaths from small intestine cancer, Emperors of Japan, 1901 births, 1989 deaths, People from Tokyo
Human evolution	Evolution, Anthropology, Hominins
Ancient Rome	Ancient Rome
Globalization	Politics
North Holland	North Holland
Folk music	Folk music
Abraham	Old Testament people, Ancient Israeli people
Tao Te Ching	Religious texts, Taoism
Bacon	Pork, Breakfast foods
Molotov-Ribbentrop pact	1930s treaties, World War II, Nazi Germany, 1930s in the Soviet Union
Vyacheslav Molotov	1890 births, 1986 deaths, Ambassadors of the Soviet Union, Recipients of the Order of Lenin, Soviet people of World War II, Heads of government of the Soviet Union
Babylonia	Mesopotamia, Former countries in the Middle East
Joachim von Ribbentrop	1893 births, 1946 deaths, Executed German people, Executed Nazis, Ambassadors of Germany, German war criminals, Government ministers of Nazi Germany, Holocaust perpetrators, Members of the Reichstag (Nazi Germany), People executed by hanging, People from Wesel, Politicians from North Rhine-Westphalia, Politicians of the Nazi Party, SS officers, German Lutherans
Noise	Sound
Karma	Hinduism, Philosophy
Western hemisphere	Hemispheres
Molotov cocktail	Incendiary weapons
Flammability	Thermodynamics
Arson	Arson, Types of crime
Cocktail	Alcoholic drink
1103	1103
Sneeze	Basic English 850 words, Physiology
Puma	Felines, Mammals of North America, Mammals of South America
Google Talk	Google
Armour	Armour, Military
North Star Computers	American technology companies
Mario Bros.	Mario platform games, 1983 video games
Oval	Shapes
Pipe organ	Keyboard instruments, Former good articles
Manx language	Celtic languages, Languages of Europe
Goidelic languages	Celtic languages, Languages of Europe
Manx cat	Cat breeds
Horn	Basic English 850 words
Agave	Agavaceae
Apple sauce	Apple products, Sauces
Charles Richter	1900 births, 1985 deaths, American physicists, Scientists from Ohio
1104	1104
Charles II of England	1630 births, 1685 deaths, House of Stuart, Kings and Queens of Scotland, 17th century in Europe
Crunk	Hip hop genres
Pimp	Prostitution
Allan Kardec	1804 births, 1869 deaths, Burials at Père Lachaise Cemetery, French esotericists, Occultists, People from Lyon, Teachers, 19th century philosophers, Deaths from aneurysm, Disease-related deaths in France, French educators, French philosophers, French writers, Parapsychology, Pseudonyms
Hyves	Social networking
Sex organ	Reproductive system
Laurence Olivier	1907 births, 1989 deaths, Actors from Surrey, Deaths from renal failure, Disease-related deaths in England, English movie actors, English stage actors, English television actors, English theatre directors, Knights Bachelor, Order of Merit, People buried in Westminster Abbey, United Kingdom Life Peers, Academy Award winning actors, Emmy Award winners, Golden Globe Award winners, BAFTA Award winners
Spiritism	New religious movements, Occult
Alexa	Websites, Amazon (company)
Poodle	Dog breeds
Irish language	Celtic languages, Ireland, Languages of Europe
Max and Ruby	2002 establishments in Canada, 2010s disestablishments in Canada, 2002 television series debuts, 2019 television series endings, Children's television series, English-language television programs, Nickelodeon television series, Television shows about rabbits and hares, Television series about siblings
1716	1716
400	400s
1147	1147
Apollo program	Apollo program
NASA	1958 establishments in the United States, NASA, Organizations based in the United States, Space agencies, Spaceflight
Advaita Vedanta	Hinduism
Parthenon	Ancient Greece, Buildings and structures in Athens, Ancient Greek and Roman temples and shrines
Physical anthropology	Physical anthropology
Jackal	Canids
Milwaukee	County seats in Wisconsin, Milwaukee, Wisconsin
Diogenes syndrome	Syndromes
Marx and Engels Internet Archive	Websites, Politics, Marxism, Non-profit organizations
NATO	1949 establishments, NATO
Felidae	Felines
1668	1668
Andrei Sakharov	1921 births, 1989 deaths, Deaths from heart failure, Human rights activists, Nuclear physicists, Russian physicists
1686	1686
1149	1149
1st century	1st century
Equidae	Equids
Lynx	Felines, Mammals of North America, Mammals of Europe, Mammals of Asia
Shania Twain	1965 births, Living people, Canadian feminists, Canadian pop singers, Canadian singer-songwriters, Country singers, Singers from Ontario
The Grass Roots	Musical groups from Los Angeles, California, American pop music groups, Folk music groups, American rock bands
Dionne Warwick	1940 births, Living people, Actors from New Jersey, African American musicians, American movie actors, American R&B singers, American soul musicians, American television actors, American television presenters, People from East Orange, New Jersey, Participants in American reality television series, Singers from New Jersey, Television talk show hosts, Warner Bros. Records artists
Barenaked Ladies	1980s Canadian music groups, 1990s Canadian music groups, 2000s Canadian music groups, 2010s Canadian music groups, Canadian rock bands, Musical groups established in 1988, Ontario, 1988 establishments in Canada
Paul Revere & the Raiders	American rock bands, Musical groups from Oregon, Musicians from Idaho, Musicians from Portland, Oregon, Singers from Idaho, Singers from Portland, Oregon, Musical groups established in 1958, 1958 establishments in the United States, 20th-century establishments in Oregon, Musical groups disestablished in the 1970s, 1976 disestablishments in the United States, Musical groups established in 1978, 1978 establishments in the United States
Nintendogs	2005 video games, Cancelled Nintendo GameCube games, Nintendo DS games, Nintendo DS-only games
Luigi	Fictional characters introduced in 1983, Fictional Italian people, Mario series characters
RAID	Storage devices
Leonid Brezhnev	1906 births, 1982 deaths, Deaths from myocardial infarction, Former dictators, People of the Vietnam War, Recipients of the Order of Lenin, Russian communists, Russian politicians, Soviet politicians
Approximation	Measurement, Mathematical approximation
PhpBB	Software, Free software
World Health Organization	1948 establishments, Geneva, Medical and health organizations, United Nations specialized agencies
Jerboa	Rodents, Arabic words and phrases, Mammals of Africa, Mammals of Asia
Aesop	620 BC births, 560 BC deaths, Ancient Greek writers, Slaves
Smell	Basic English 850 words
Olfaction	Sensory system
Teaspoon	Imperial units, Kitchenware, Units of volume, Tea
Camembert	Communes in Orne
Camembert cheese	French cheeses, Normandy
Childbirth	Life
Shiva	Hindu gods and goddesses
ASCII art	Graphics, Computing
Riddle	Logic, Games
Novalis	1772 births, 1801 deaths, German writers
Body piercing	Body art
Physical	Basic English 850 words
Elonka Dunin	1958 births, Living people, Writers from Missouri, Designers
Supernova	Supernovae
Bethlehem	Ancient Israel and Judah, Bethlehem, New Testament, Old Testament
Disco	Disco
Albert II, Prince of Monaco	1958 births, Living people, Princes and princesses of Monaco, Recipients of the Order pro merito Melitensi, Current national leaders
Rex Warner	1905 births, 1986 deaths, English writers, Translators
Hugh Cook	Canadian writers, 1942 births, Living people
Franz Boas	1858 births, 1942 deaths, Naturalized citizens of the United States, German scientists, American geographers, American anthropologists
Zapotec people	Mexico, Native American
IMAX	Movie terminology
Esotericism	Esotericism
Hugh Cook (science fiction author)	1956 births, English writers
Jainism	Jainism
Sect	Religion, Sociology
Caracal	Felines, Mammals of Pakistan
Eel	Teleosts, Edible fish
Easter egg	Easter traditions
Lemur	Lemuriformes
Good Friday	Christian holidays, Easter
Archaea	Archaeans, Prokaryotes, Microbiology
Jared Diamond	1937 births, Living people, American biologists, American geographers, Writers from Boston, Massachusetts, Scientists from Boston, Massachusetts, Pulitzer Prize winners
Iglesia ni Cristo	Nontrinitarianism, Protestantism
State court (United States)	United States law, Courts (law)
Emma Goldman	1869 births, 1940 deaths, American anarchists, American atheists, American autobiographers, American communists, American essayists, American feminists, American philosophers, American political activists, American prisoners, Cardiovascular disease deaths in Canada, Deaths from stroke, Jewish American scientists, Jewish American writers, Jewish activists, Jewish atheists, Jewish feminists, Jewish philosophers, American LGBT rights activists, Lithuanian Jews, Naturalized citizens of the United States, People from Kaunas, Russian Jews, Soviet Jews, Writers from New York City
Computer engineering	Computer science, Engineering
Spanish Civil War	1930s in Europe, 20th century in Spain, 20th century rebellions, Rebellions in Europe, Spanish Civil War
Fyodor Tyutchev	1803 births, 1873 deaths, Russian writers, Russian poets
Erythropoietin	Hormones, Biochemistry
Anarcho-punk	Lifestyles, Anarcho-punk
Household hardware	Technology
Slavic peoples	Slavic peoples
Maharbal	European people
Hannibal	Ancient Rome
Veganism	Animal rights, Vegetarianism, Diets
Necrophilia	Paraphilias, Sex crimes
Strait of Magellan	Straits, Bodies of water of South America
Fenerbahçe S.K.	Turkish football clubs
Homo sapiens	Hominins, Humans
Lake Tanganyika	Lake Tanganyika, Lakes of Africa, Geography of the Democratic Republic of the Congo, Geography of Tanzania, Geography of Zambia, Burundi
Pinocchio (1940 movie)	1940 movies, Disney animated movies, American family movies, American musical movies, United States National Film Registry movies, Movies based on books, Movies composed by Oliver Wallace, Movies that won the Best Original Song Academy Award
Lubbock, Texas	Lubbock, Texas, County seats in Texas
Pearl	Gemstones, Birthstones
Warner Bros.	Movie studios, Time Warner, 1923 establishments in the United States
Freedom of religion	Religious ethics, Human rights, Freedom, Libertarianism
MDC (band)	Anarcho-punk bands, American punk bands, Musical groups from Texas, Musicians from Austin, Texas
Optimus Prime	Fictional characters introduced in 1984, Transformers (franchise)
Comic strip	Art
First ScotRail	Transport in Scotland, Rail transport in the United Kingdom, First Group railway companies, Train operating companies
Waste container	Trash containers, Containers, Waste
Vijayanagara Empire	History of India, Empires, 1336 establishments, 1660 disestablishments, 14th century establishments in India, Disestablishments in India
Delhi Sultanate	Delhi Sultanate, History of Pakistan, History of India, 1210 establishments, 1520s disestablishments in Asia, Establishments in India, 1526 disestablishments, 1210s establishments in Asia
Hoysala Empire	History of India, Empires, 10th century establishments in Asia, 1000 establishments, 1346 disestablishments, Establishments in India, Disestablishments in India, 1340s disestablishments in Asia
Macedonia (ancient kingdom)	History of Greece, Empires, History of India
Burger King	1954 establishments in the United States, 1950s establishments in Florida, American fast food restaurants, Miami, Florida
Lech Kaczyński	1949 births, 2010 deaths, Aviation deaths, Polish movie actors, Polish Roman Catholics, Mayors of Warsaw, Presidents of Poland, Recipients of the Order of the White Eagle (Poland), Twin people
Argead dynasty	Ancient Greece, Royal dynasties
Antipatrid dynasty	Ancient Greece, Royal dynasties
Antigonid dynasty	Ancient Greece, Royal dynasties
Futurama	1999 American television series debuts, 2013 American television series endings, Adult animated television series, 1990s American sitcoms, 1990s animated television series, 2000s American sitcoms, 2000s animated television series, 2000s science fiction television series, 2010s American sitcoms, 2010s animated television series, 2010s science fiction television series, Adult Swim, American animated television series, American science fiction television series, American time travel television series, Comedy science fiction, Fox television series, Futurama, Television series set in New York City, Television series set in the future, English-language television programs
Radar	Electronics, Wave physics, Acronyms, Aviation safety, Navigation
GameSpot	Websites
TV.com	Entertainment websites
1159	1159
400s	400s
South Asia	South Asia
Thermodynamics	Thermodynamics
Brookhurst, Wyoming	Census-designated places in Wyoming, Natrona County, Wyoming
Bollywood	Cinema of India, Hindi
Dinah Washington	1924 births, 1963 deaths, Accidental deaths in the United States, African American musicians, American jazz musicians, Drug-related accidental deaths, Singers from Alabama, Singers from Chicago, People from Tuscaloosa, Alabama
Robin Ward	singers from Hawaii, 1941 births, Living people
Adrenal gland	Glands, Endocrine system
Chiswick	Areas of London, London Borough of Hounslow
The Golden Girls	1985 American television series debuts, 1992 television series endings, 1980s American television series, 1990s American television series, 1992 American television series endings, American sitcoms, Emmy Award winning programs, Golden Globe Award winning programs, Miami, Florida in fiction, NBC network shows, Television series set in Florida, 1992 disestablishments in the United States, English-language television programs
Bark	Plant anatomy, Plant physiology
Cowboy	Occupations
Janet Reno	1938 births, 2016 deaths, Cornell University alumni, Politicians from Miami, Florida, Deaths from Parkinson's disease, United States Attorneys General, US Democratic Party politicians
1493	1493
1285	1285
Alex Haley	African American writers, American novelists, American television producers, American television writers, Cardiovascular disease deaths in the United States, Deaths from myocardial infarction, Writers from New York, 1921 births, 1992 deaths, People from Ithaca, New York
Harold Robbins	Writers from New York City, 1916 births, 1997 deaths
Baptism	Sacraments
Nationalities of China	China
Shang Dynasty	Chinese dynasties
King Tang of Shang of China	1617 BC births, 1588 BC deaths, Kings of Shang Dynasty
Bu Bing	Kings of Shang Dynasty
New Year's Eve	Holidays
Chen dynasty	Chinese dynasties, 557 establishments, 589 disestablishments, 6th century establishments in Asia, Establishments in China, Disestablishments in China
Fighter aircraft	Military aviation, Air force
Aircraft carrier	Military aviation, Warships
Edward Kasner	1878 births, 1955 deaths, American mathematicians, Columbia University alumni, Scientists from New York City
Bay of Bengal	Bays, Geography of Asia, Indian Ocean
Malay Peninsula	Geography of Asia, Peninsulas
Jubilee line	London Underground lines, Transport in Brent, Transport in Camden, Transport in Greenwich, Transport in Newham, Transport in Southwark, Transport in Tower Hamlets, Transport in the City of Westminster, Tunnels underneath the River Thames, 1979 establishments in England
Medical emergency	Medical emergencies
Southeast Asia	Southeast Asia
Sprint	Running
Boxer (dog)	Dog breeds, Molossers
American Graffiti	1973 comedy movies, 1973 drama movies, 1970s comedy-drama movies, 1970s teen movies, American comedy-drama movies, American teen comedy movies, American teen drama movies, English-language movies, Movies directed by George Lucas, Movies set in California, Movies set in the 1960s, United States National Film Registry movies, Universal Pictures movies, Screenplays by George Lucas
Lake Vostok	Lakes, Geography of Antarctica
Infrared	Physics, Infrared, Chemistry
Municipalities of Republika Srpska	Republika Srpska, Settlements in Bosnia and Herzegovina, 1994 in Europe, 1990s in Bosnia and Herzegovina
Republika Srpska	Regions of Republika Srpska, Republika Srpska, 1995 establishments in Europe, 20th century establishments in Bosnia and Herzegovina
Kenneth Branagh	1960 births, Living people, Actors from Northern Ireland, BAFTA Award winning actors, BAFTA Award winning directors, British movie actors, British movie directors, British movie producers, British stage actors, British television actors, British television producers, Emmy Award winning actors, People from Belfast
Sculpture	Sculpture, Non-verbal communication
Charles V, Holy Roman Emperor	1500 births, 1558 deaths, Holy Roman Emperors, Kings and Queens of Spain, Kings and Queens of Italy, Counts and countesses of Flanders
Renaissance	Renaissance
Lava	Volcanology
Greenwich Village	Manhattan, Neighborhoods of New York City
Yoshiki	Musicians from Chiba Prefecture, Living people, 1965 births
Aragon	Aragon
Aragonese language	Aragonese language
1161	1161
1168	1168
1178	1178
251	251
1280	1280
675	675
1195	1195
1106	1106
525	525
1380	1380
303	303
687	687
1221	1221
1304	1304
1156	1156
1226	1226
1181	1181
1219	1219
1711	1711
1765	1765
1590	1590
1628	1628
1105	1105
1618	1618
1622	1622
Levi Eshkol	1895 births, 1969 deaths, Burials at Mount Herzl, Former Members of Knesset, Government ministers of Israel, Israeli former political leaders, Jewish Israeli politicians, Mapai politicians, Naturalized citizens of Israel, Prime Ministers of Israel, Ukrainian Jews
1580	1580
Sidney Sheldon	1917 births, 2007 deaths, American screenwriters, writers from Chicago
Mackenzie Bowell	1823 births, 1917 deaths, Knights Commander of the Order of St Michael and St George, People from Ontario, Politicians from Suffolk, Prime Ministers of Canada, Privy Councillors (Canada)
Rugby World Cup	Rugby union
1996 U.S. campaign finance scandal	1996 in the United States, 1990s in China
1008	1008
1045	1045
Kick	Basic English 850 words, Sports
1644	1644
Islam and clothing	Society
Charles I of England	1600 births, 1649 deaths, House of Stuart, Kings and Queens of Scotland
Pepin the Short	714 births, 768 deaths, Kings and Queens of France
Sense and Sensibility	1810s books, Books by Jane Austen, English novels, Fiction set in the past, Works about marriage, Works about sisters, Works about widowhood
Pride and Prejudice	1810s books, Books by Jane Austen, English novels
Emma (novel)	Books by Jane Austen, 1810s books, English novels
Chris Martin	1977 births, British anti–Iraq War activists, Coldplay, English pianists, English rock guitarists, English rock singers, Living people, Musicians from Devon
Joseph Fiennes	1970 births, Living people, Actors from Wiltshire, English movie actors, English stage actors, English television actors, English voice actors, People from Salisbury
1179	1179
Wikibooks	Wikimedia, Wikis, Websites established in 2004
Charles IX of France	1550 births, 1574 deaths, Kings and Queens of France, House of Valois
Henry III of France	1551 births, 1589 deaths, Kings and Queens of France, House of Valois, LGBT royalty
981	981
997	997
999	999
1015	1015
418	418
1660	1660
Constance of Arles	Kings and Queens consort of France, 973 births, 1034 deaths
Matilda of Boulogne	1105 births, 1152 deaths, Kings and Queens consort of England
Marie of Boulogne	French people, Earls and countesses
Marie of France	French royalty
Alix of France	French royalty, 1151 births, 1190s deaths
Margaret of Blois	Earls and countesses, French nobility, 1230 deaths
Flemish Region	Geography of Belgium
Feta cheese	Cheeses, Greek food
Sgt. Pepper's Lonely Hearts Club Band	The Beatles albums, 1967 albums, Concept albums, Rock albums
Winter Palace	Palaces in Russia, Buildings and structures in Saint Petersburg
Standing's day gecko	Lizards
Charles VI, Holy Roman Emperor	1685 births, 1740 deaths, Holy Roman Emperors, Habsburg Dynasty, Counts and countesses of Flanders, Archdukes and Archduchesses of Austria
Pierre Trudeau	1919 births, 2000 deaths, Cancer deaths in Quebec, Deaths from prostate cancer, Deaths from Parkinson's disease, Companions of Honour, Order of Canada, People from Montreal, Privy Councillors (Canada), Leaders of the Opposition (Canada), Members of the House of Commons of Canada from Quebec, Canadian Queen's Counsel
Jennifer Lopez	Actors from the Bronx, American dancers, American hip hop musicians, American movie actors, American pop singers, American R&B singers, American television actors, Businesspeople from New York City, Jennifer Lopez, Latin singers, Musicians from the Bronx, Singers from New York City, 1969 births, Living people
Anne of Brittany	1477 births, 1514 deaths, Kings and Queens consort of France, Dukes and Duchesses of Brittany, People from Nantes
Ritual	Culture
Maria Theresa	1717 births, 1780 deaths, Archdukes and Archduchesses of Austria, Holy Roman Empresses consort, Habsburg Dynasty, House of Habsburg-Lorraine, House of Lorraine, Grand Duchesses of Tuscany, Grand Dukes of Luxembourg
Marie Antoinette	1755 births, 1793 deaths, Dauphins and Dauphines of France, Executed French people, Habsburg Dynasty, Kings and Queens consort of France, Archdukes and Archduchesses of Austria, People executed by decapitation, Writers from Vienna, People of the French Revolution
Montesquieu	1689 births, 1755 deaths, French philosophers
Aristocracy	Social groups, Forms of government
Poseidon	Twelve Olympians
Object-oriented programming	Computer science
Message (computer science)	Computer science
Handball	Handball
Twelve Olympians	Twelve Olympians
Sandro Botticelli	1445 births, 1510 deaths, 15th century Italian painters, People from Florence
Hermes	Twelve Olympians
Maia	Nymphs
Pleiades (mythology)	Nymphs
Medieval commune	Middle Ages
Imperialism	Imperialism
Heresy	Theology
Cossacks	Ukrainian people, Ukraine
41	41
1341	1341
1522	1522
American Sign Language	Sign languages
Sign language	Disability, Sign languages, Language-related lists
Saint-Dié-des-Vosges	Communes in Vosges, Subprefectures in France
Rhodesian Ridgeback	Dog breeds
Glove	Accessories, Protective clothing
Sky High (2005 movie)	2000s superhero movies, 2005 movies, American family movies, American superhero movies, Disney movies
Tales of Symphonia	Nintendo GameCube games, PlayStation 2 games, PlayStation 3 games, Role-playing video games, 2004 video games, Windows games, Video games developed in Japan
Protestant Reformation	Protestant Reformation
Sermon	Christian genres
Sand	Basic English 850 words, Geology
Alsatian language	German dialects, Languages of Europe, Alsace
Ian McEwan	1948 births, Living people, Booker Prize winners, Commanders of the Order of the British Empire, English novelists, Royal Society of Arts, Royal Society of Literature, Writers from Hampshire
Mahjong	Games
Ionia	Ancient Greece
Harmonic	Wave physics
Art Ross Trophy	National Hockey League trophies and awards
Towel	Materials
South Georgia and the South Sandwich Islands	Antarctic region, South Georgia and the South Sandwich Islands
Vein	Blood vessels
Ottawa Senators	Ottawa Senators
Calgary Flames	Calgary Flames
Edmonton Oilers	1972 establishments in Canada, Ice hockey teams in Alberta, National Hockey League teams, Sport in Edmonton, World Hockey Association teams
Philadelphia Flyers	Philadelphia Flyers, 1967 establishments in the United States, 1960s establishments in Pennsylvania
Pittsburgh Penguins	Pittsburgh Penguins, 1967 establishments in the United States, 1960s establishments in Pennsylvania
Conn Smythe Trophy	National Hockey League trophies and awards
Los Angeles Kings	1967 establishments in California, Ice hockey teams in the United States, National Hockey League teams, Sports in Los Angeles
St. Louis Blues	St. Louis Blues, 1967 establishments in the United States, 1960s establishments in Missouri
Ratio	mathematics
Proportionality	Mathematics
Mitochondria	Organelles
Menominee, Michigan	Cities in Michigan, County seats in Michigan
Mortar and pestle	Tools, Laboratory equipment
1212	1212
1192	1192
Hiram E. McCallum	1900 births, 1989 deaths, Mayors of Toronto
Walter Cronkite	1916 births, 2009 deaths, Deaths from cerebrovascular disease, American television news anchors, American war correspondents, Writers from Missouri, Presidential Medal of Freedom recipients, Emmy Award winners, Peabody Award winners
Dog Day Afternoon	1975 drama movies, 1970s comedy-drama movies, 1970s crime drama movies, 1970s LGBT movies, American comedy-drama movies, American crime drama movies, American heist movies, American LGBT movies, Black comedy movies, English-language movies, LGBT comedy-drama movies, LGBT crime movies, Movies based on real life events, Movies directed by Sidney Lumet, Movies set in Brooklyn, Transgender in movies, United States National Film Registry movies, Warner Bros. movies
Cursor	Software
Kurt Gödel	1906 births, 1978 deaths, 20th century philosophers, American mathematicians, Austrian scientists, Deaths from starvation, People from Brno
Tyrannosaurus	Theropods, Tyrannosaurids, Dinosaurs of North America
Brno	Brno
David Hilbert	1862 births, 1943 deaths, German academics, German mathematicians, People from former German territories, People from Kaliningrad
Bertrand Russell	1872 births, 1970 deaths, 20th century philosophers, Academics of the University of Cambridge, Agnostics, Alumni of the University of Cambridge, British academics, British activists, British atheists, British autobiographers, British mathematicians, British Nobel Prize winners, British philosophers, Deaths from influenza, Democratic socialists, Labour Party (UK) people, LGBT rights activists, Members of the House of Lords, Nonviolence advocates, Order of Merit, United Kingdom Earls, Welsh politicians, Welsh writers
Alfred North Whitehead	1861 births, 1947 deaths, English mathematicians, English philosophers, Order of Merit, People from Kent, Ramsgate
Mask	Headgear, Culture, Non-verbal communication, Art, Metaphors
Holiday	Holidays
Spokane, Washington	Spokane, Washington, County seats in Washington, 1871 establishments in the United States, 19th-century establishments in Washington (state)
M16 rifle	Assault rifles, 5.56 mm firearms, Rifles of the Cold War
Foreskin	Anatomy of the male reproductive system
Sid Vicious	1957 births, 1979 deaths, Bassists, British punk musicians, Drug-related accidental deaths in the United States, English rock musicians, Musicians from London, Sex Pistols
Wii	Wii hardware, Seventh generation consoles
Joseph Strutt	1749 births, 1802 deaths, English artists, People from Essex
Tricia Nixon Cox	1946 births, Living people, Children of Presidents of the United States, People from Whittier, California
Grocon	Companies of Australia
Głuchołazy	Towns in Poland
1652	1652
1124	1124
Columbia River	Rivers of Canada, Rivers of Washington (U.S. state), Geography of British Columbia, Rivers of Oregon
1597	1597
Martyr	Theology, Death
Whittier, California	Whittier, California
List of German institutions	Politics of Germany, Government of Germany, Germany-related lists
List of French institutions	Politics of France, France-related lists
EarthBound	Mother series, 1994 video games, Super Nintendo Entertainment System games
Mother (video game)	1989 video games, Nintendo Entertainment System games, Mother series
Mother 1 + 2	Game Boy Advance games, 2003 video games, Mother series
Mother 3	2006 video games, Cancelled video games, Game Boy Advance games, Game Boy Advance-only games, Mother series
Cardcaptor Sakura	Anime series based on manga
1173	1173
Sunderland	Sunderland, Port cities and towns of the North Sea, Port cities and towns of England, Settlements in Tyne and Wear
List of kings of Carthage	Ancient Rome, Kings and queens, Lists of heads of state
Wilhelm Busch	1832 births, 1908 deaths, German poets, German painters, Autobiographers
Electronic sports	Sports video games
Skunk	Mammals of North America, Omnivores, Caniformia
Cerebellum	Anatomy of the brain
Sustainable development	Sustainable development
Ribose	Chemical compounds
Deoxyribose	Chemical compounds
Henry Royce	1863 births, 1933 deaths, English businesspeople
Seizure	Neurology
1236	1236
1238	1238
Profession	Occupations
International Nuclear Event Scale	Nuclear accidents
Hafnarfjörður	Cities in Iceland, Municipalities of Iceland
Level (disambiguation)	Measuring tools
Bloomington, Illinois	Cities in Illinois, County seats in Illinois
1252	1252
Giverny	Communes in Eure
Fort Collins, Colorado	Cities in Colorado, County seats in Colorado
Silver Spring, Maryland	Cities in Maryland, Montgomery County, Maryland, 1840 establishments in the United States, 19th-century establishments in Maryland
Iraq	Mesopotamia, Members of the Organisation of Islamic Cooperation
Neutron star	Types of stars, Astrophysics
Parent	Family
Lee Hsien Loong	1952 births, Living people, People's Action Party (Singapore) politicians, Prime Ministers of Singapore, Members of the Cabinet of Singapore
Adam and Eve	Old Testament people
Ramadan	Arabic words and phrases, Islamic calendar, Ramadan
Caykur Rizespor	Turkish football clubs
Tenzing Norgay	1914 births, 1986 deaths, Autobiographers, Cardiovascular disease deaths in India, Deaths from cerebral hemorrhage, Nepalese people, Sherpa, Mountain climbers
Sherpa	Sherpa, Mountain climbers
Charlotte Eagles	American soccer teams, Sports in Charlotte, North Carolina, 1993 establishments in the United States
Charlotte, North Carolina	Charlotte, North Carolina, County seats in North Carolina, 1755 establishments, 1750s establishments in North Carolina
Carolina Panthers	Carolina Panthers, 1995 establishments in the United States, 1990s establishments in North Carolina
Selgovae	Scottish people, History of the British Isles
Harrison Ford	1942 births, Living people, Actors from Chicago, American movie actors, American stage actors, American television actors, American voice actors, Carpenters, Democrats (United States), Movie producers from Chicago, Saturn Award winners
Prehistory	Periods and ages in history
Early Middle Ages	Middle Ages
KGB	Soviet Union, Intelligence agencies, 1954 establishments, 1950s establishments in the Soviet Union, 1991 disestablishments in the Soviet Union
Federal Security Service	Russia, National security, Intelligence agencies
Nicolaus Copernicus	1473 births, 1543 deaths, Astronomers
Projection (mathematics)	Mathematics
Drizzle	Precipitation
Lightning	Weather, Electricity
Roseau	National capitals in North America, Geography of Dominica
Paint	Basic English 850 words, Paints
Mark Antony	Roman generals, 83 BC births, 30 BC deaths
Digg	Websites
Crossword	Puzzles
Bob Geldof	Brit Award winners, Irish rock musicians, Irish singer-songwriters, Musicians from Dublin, Political activists, 1951 births, Living people, Honorary Knights Commander of the Order of the British Empire
Bullseye (1981 British game show)	1981 British television series debuts, 2006 British television series endings, 1980s British television series, 1990s British television series, 2000s British television series, ITV game shows, Darts, English-language television programs
Coronation Street	1960 establishments in the United Kingdom, 1960s British television series, 1960s drama television series, 1970s British television series, 1970s drama television series, 1980s British drama television series, 1990s British drama television series, 2000s British drama television series, 2010s British drama television series, British soap operas, ITV television programmes, Television series set in Manchester, Coronation Street, English-language television programs
European plaice	Flatfish, Edible fish
Taboo	Human issues
Flatfish	Flatfish, Edible fish, Mimicry
Pluto (Disney)	Fictional characters introduced in the 1930s, Fictional dogs, Mickey Mouse universe characters
Even number	Mathematics
Mardi Gras	Festivals
Røldalsvatnet	Lakes of Europe, Geography of Norway
Technorati	Websites, San Francisco
Stuart, Florida	Cities in Florida, County seats in Florida
Astoria, Oregon	Cities in Oregon, County seats in Oregon
The Goonies	1985 movies, 1980s adventure movies, 1980s family movies, American adventure movies, American family movies, Cult movies, English-language movies, Movies set in Oregon
Press Your Luck	Television game shows, English-language television programs
Newar language	Sino-Tibetan languages, Newar
Narcolepsy	Neurology, Sleep disorders
Danny Phantom	2004 television series debuts, American animated television series, Canadian animated television series, Nickelodeon television series, Television series created by Butch Hartman, Spacetoon shows, English-language television programs
Cane	tools
Homicide	Crime
Amazon (company)	All articles with unsourced statements, 1994 establishments in Washington (state), Seattle, Washington, Websites, Amazon (company)
Summer Olympic Games	Summer Olympic Games, Sports lists
Alpha Centauri	Binary stars, Red dwarfs
Last call bell	bells
TGV	Transport in France, Rapid transit systems, High-speed trains
Caregiver	Social sciences, Personal service occupations
Binoculars	Optics, Tools
Odd number	Numbers
1343	1343
1342	1342
1344	1344
Tent	Accommodations, camping
Cottage	Houses
Alaska plaice	Flatfish
Sleep paralysis	Symptoms
American plaice	Flatfish
Spider web	Arachnids
World Series	Major League Baseball World Series
Janet Jackson	1966 births, Living people, Actors from Indiana, African American actors, African American musicians, American movie actors, American R&B musicians, American pop musicians, American dance musicians, American singer-songwriters, American television actors, Janet Jackson, Emmy Award winners, Grammy Award winners, Singers from Indiana, Jackson family
Melissa Joan Hart	Actors from New York, American child actors, American movie actors, American television actors, American television directors, American television producers, American voice actors, Entertainers from New York, 1976 births, Living people
Colleen Fitzpatrick	1969 births, Living people, Singers from New Jersey, American movie actors, Actors from New Jersey
Jamie Lynn Spears	1991 births, Living people, American movie actors, American television actors, Actors from Louisiana, Singers from Louisiana, Actors from Mississippi, Singers from Mississippi, Britney Spears
Opel	1862 establishments, 1860s establishments in Germany, General Motors, Automobile companies of Germany, Hesse, Opel automobiles
JAG	1995 American television series debuts, 2005 American television series endings, 2000s American television series, American drama television series, Television series set in Washington, D.C., English-language television programs
Burn	Basic English 850 words
Adobe Photoshop	Graphics software, Vector graphics editors, Adobe software
Finger	Basic English 850 words, Limbs and extremities
Bronze	Alloys, Metallurgy
Flight	Basic English 850 words, Zoology, Physics
Reindeer	Deer, Animals used for transport, Arctic, Christmas, Domesticated animals, Even-toed ungulates, Mammals of Asia, Mammals of Europe, Mammals of North America
Deer	Deer
Dalton (unit)	Analytical chemistry, Units of measurement
Anion	Physical chemistry
David (Michelangelo)	Statues, Art by Michelangelo
Moses (Michelangelo)	Statues, Art by Michelangelo
The Birth of Venus (Botticelli)	Art by Sandro Botticelli, 15th century paintings
Primavera (Botticelli)	15th century paintings, Art by Sandro Botticelli
Cupid	Roman gods and goddesses
The Creation of Adam	Art by Michelangelo, Paintings with Christian themes, 16th century paintings
Newbury, Berkshire	Towns in Berkshire
Dvorak Simplified Keyboard	Writing tools, Computer hardware, Data input
Microsoft FrontPage	Microsoft software
Martial arts	Martial arts
Gonad	Glands
Felix Mendelssohn	1809 births, 1847 deaths, Deaths from stroke, German composers, Jewish German musicians, People from Hamburg, Romantic composers
Watercolour	Painting, Paints
Expert system	Artificial intelligence, Systems
Hermann Hesse	1877 births, 1962 deaths, German novelists, German painters, German poets, People from Baden-Württemberg, Swiss poets
Dynamic Host Configuration Protocol	Computer protocols, computer networking
Communication protocol	Computer protocols
Aldi	1913 establishments in Europe, 1910s establishments in Germany, Supermarkets of Germany
Channel Tunnel	Tunnels, Seven Wonders of the Modern World, Buildings and structures in England, Buildings and structures in France, Transport in England, Transport in France, Hauts-de-France, Kent, 1994 establishments in Europe
Katowice	Cities in Poland
Mobile phone	Mobile phones
Giorgio Napolitano	Presidents of Italy, Recipients of the Order pro merito Melitensi, 1925 births, Living people, People from Naples, Recipients of the Decoration for Services to the Republic of Austria
Robert Byrd	1917 births, 2010 deaths, American Baptists, American lawyers, Deaths from natural causes, Deans of the United States Senate, Minority leaders of the United States Senate, Majority leaders of the United States Senate, Presidents pro tempore of the United States Senate, 1976 United States presidential candidates, United States representatives from West Virginia, United States senators from West Virginia, US Democratic Party politicians, 20th-century American politicians, 21st-century American politicians
Artemis	Twelve Olympians
Apollo	Twelve Olympians
Nike (mythology)	Greek gods and goddesses
Montagu Island	islands
Styx	Greek gods and goddesses, Afterlife
Groucho Marx	National Radio Hall of Fame inductees, comedians from New York City, actors from New York City, American Jews, American movie actors, 1890 births, 1977 deaths, Deaths from pneumonia
Greek mythology	Greek mythology
Nyx	Greek gods and goddesses
Hemera	Greek gods and goddesses
Aether	Greek gods and goddesses
Keres (spirits)	Greek legendary creatures
Eris (goddess)	Greek gods and goddesses
Geras	Greek gods and goddesses
Hypnos	Greek gods and goddesses
Momus	Greek gods and goddesses
Moros	Greek gods and goddesses
Metis	Nymphs
Eos	Titans
Selene	Titans
Leto	Titans
Sioux Falls, South Dakota	County seats in South Dakota, Sioux Falls, South Dakota, 1876 establishments in the United States, 1870s establishments in Dakota Territory
30s	30s
Christopher Eccleston	Actors from Greater Manchester, Actors from Lancashire, English atheists, English movie actors, English stage actors, English television actors, 1964 births, Living people
Deliverance	1970 books, 1972 drama movies, 1970s adventure movies, 20th century American novels, 1970s crime drama movies, American crime drama movies, English-language movies, Movies about revenge, Movies based on books, Movies set in Georgia (U.S. state), Rape in movies, United States National Film Registry movies, Movies directed by John Boorman
The Adventures of Robin Hood	1938 movies, 1930s adventure movies, American adventure movies, United States National Film Registry movies, Swashbuckler movies, English-language movies, Movies directed by Michael Curtiz, Movies directed by William Keighley
Speed (1994 movie)	1994 crime movies, 1994 thriller movies, 20th Century Fox movies, 1994 action movies, 1990s crime thriller movies, American action movies, American crime thriller movies, Chase movies, English-language movies, Movies about extortion, Movies about murderers, Movies set in Los Angeles, California
Ares	Twelve Olympians
Anna Kavan	1901 births, 1968 deaths, English novelists
Voodoo	Voodoo
Mercury (mythology)	Roman gods and goddesses
Medusa	Greek legendary creatures, Monsters
Olga Bondarenko	1960 births, Living people, 1992 Summer Olympics, Competitors in athletics, Female athletes, Medalists at the 1988 Summer Olympics, Russian sportspeople, Soviet Olympic gold medalists
Hephaestus	Twelve Olympians
Vulcan (mythology)	Roman gods and goddesses
Tyche (planet)	Planets, Solar System
Fortuna (mythology)	Roman gods and goddesses
Demeter	Twelve Olympians
Ceres	Roman gods and goddesses
Roman mythology	Roman mythology
List of Roman gods and goddesses	Roman gods and goddesses, Lists of gods and goddesses
List of gods and goddesses	Lists of gods and goddesses
Ancient history	Ancient history
Andrzej Sapkowski	Polish writers, 1948 births, Living people
Staten Island	Islands of New York, County seats in New York, Staten Island, 1661 establishments, 1660s establishments in the Thirteen Colonies, 17th-century establishments in New York
Borough	Boroughs
Echo (mythology)	Nymphs
Helios	Titans
Bia	Greek gods and goddesses
Zelus	Greek gods and goddesses
Mnemosyne	Titans
Harmonia	Greek gods and goddesses
President pro tempore of the United States Senate	Presidents pro tempore of the United States Senate
David Tennant	1971 births, Living people, Doctor Who, Scottish movie actors, Scottish stage actors, Scottish television actors, Scottish voice actors
American Broadcasting Company	1943 establishments in the United States, American Broadcasting Company, Companies based in New York City, Disney companies
Fox Broadcasting Company	Fox Broadcasting Company, 1986 establishments in the United States
Papua New Guinea	Papua New Guinea, Current monarchies, English-speaking countries, Commonwealth realms, 1975 establishments, 1970s establishments in Oceania
Strom Thurmond	1902 births, 2003 deaths, American centenarians, American generals, American military personnel of World War II, Deans of the United States Senate, Deaths from heart failure, Governors of South Carolina, Presidents pro tempore of the United States Senate, Purple Heart recipients, Presidential Citizens Medal recipients, Presidential Medal of Freedom recipients, United States senators from South Carolina, US Democratic Party politicians, US Republican Party politicians, South Carolina Republicans
Roman Forum	Ancient Rome
Playwright	Plays, Entertainment occupations, Playwrights, Writing
Iambe	Greek gods and goddesses
Triangle (instrument)	percussion instruments
Bernie Little	1926 births, 2003 deaths, Sportspeople from Ohio
Perseus	People in Greek mythology
Niccolò Paganini	1782 births, 1840 deaths, Italian composers, People from Genoa, Romantic composers, Violinists
Samer Kamal	Taekwondo practitioners, Jordanian people, Living people, 1966 births
Violet (plant)	Flowers, Violets
Winnie the Pooh	Characters in written fiction, Fictional bears, Disney characters, Kingdom Hearts characters, Winnie the Pooh
960s	960s
Aleksander Kwasniewski	1954 births, Living people, Presidents of Poland
Viola sororia	Violets, Perennials
NAND gate	Logic gates
Under the Rainbow	1981 comedy movies, American comedy movies, Movies set in California
Gilli-danda	Games, Indian culture, Pakistani culture
Southern United States	Census Regions of the United States
Hick	Pejoratives
Greenhouse gas	Greenhouse gases
Omaha hold'em	Poker
Leverkusen	Leverkusen
Tocotronic	German rock bands, Indie rock bands, Hamburg
Bolesław Prus	Polish writers, 1847 births, 1912 deaths
2040	2040, Years in the future
Wayne Mixson	1922 births, 2020 deaths, Governors of Florida, Lieutenant Governors of Florida, Politicians from Alabama, US Democratic Party politicians, State legislators of the United States
Reubin Askew	1984 United States presidential candidates, American military people, United States Trade Representatives, Governors of Florida, Politicians from Oklahoma, Deaths from stroke, 1928 births, 2014 deaths
Trabant	Automobiles
Lindsay Lohan	1986 births, Living people, Actors from New York City, American child actors, American guitarists, American movie actors, American pop musicians, American television actors, American thieves, Models from New York City, Musicians from New York City, Singers from New York City
Postum	Drinks
Brok	Towns in Poland, Ostrowian County (Poland)
1480	1480
1099	1099
Herb Alpert	Musicians from Los Angeles, California, Trumpeters, 1935 births, Living people
Teddy bear	Toys
Hangul	Alphabets, Korea, 1443 establishments, 15th century establishments in Asia, Korean language
Lincoln Chafee	1953 births, Living people, American mayors, Governors of Rhode Island, 2016 United States presidential candidates, 2020 United States presidential candidates, United States senators from Rhode Island, Politicians from Wyoming, US Democratic Party politicians, US Republican Party politicians, US Libertarian Party politicians, People from Warwick, Rhode Island
Sascha Fischer	1970 births, Living people, German sportspeople, Rugby players, Sportspeople from Stuttgart
Bob Graham	United States senators from Florida, Governors of Florida, US Democratic Party politicians, 1936 births, Living people, 2004 United States presidential candidates
Americans	American people
Ohio Wesleyan University	Colleges and universities in Ohio, Five Colleges of Ohio, Great Lakes Colleges Association, Oberlin Group of Libraries, 1844 establishments in the United States, 1840s establishments in Illinois
Lakshmi	Hindu gods and goddesses
Ancient Australia	History of Australia, Ancient history, Indigenous Australian history
Dreamtime	Australian mythology, Indigenous Australian culture, Creation myths
Loch Ness Monster	Scotland, Cryptozoology
Southern rock	Rock music
Ostrów Mazowiecka	Towns in Poland, Ostrowian County (Poland)
100	100
Niue	Niue, Commonwealth dependent states, 1994 establishments in Oceania
Master race	Nazism, Race, Fascism
The Last Supper	Paintings with Christian themes, Paintings by Leonardo da Vinci, 15th century paintings
Thomas the Apostle	Early Christian saints, Twelve Apostles, 70s deaths, 1st century births
Bartholomew the Apostle	Early Christian saints, Twelve Apostles
Matthew the Evangelist	Early Christian saints, Twelve Apostles
John the Apostle	1st century births, 1st century deaths, Christian mystics, Early Christian saints, Twelve Apostles, 0s births, 100 deaths, 100s deaths, Ancient Christianity, Ancient Roman writers, Biblical people, Evangelists, Missionaries, New Testament people, Saints, Year of birth unknown
Saint Peter	Early Christian saints, Twelve Apostles, Popes, 67 deaths
Sistine Chapel	Churches in Italy, Vatican City, Roman Catholic churches
Pope Paul III	1468 births, 1549 deaths, Italian popes
Pope Sixtus IV	Italian popes, 1414 births, 1484 deaths, House of della Rovere
Pope Julius II	Italian popes, 1443 births, 1513 deaths, House of della Rovere
Donato Bramante	1440s births, 1514 deaths, Italian architects
Alexandre Dumas, père	1802 births, 1870 deaths, French writers, People with foods named after them
Beastie Boys	1981 establishments in New York (state), 1980s American music groups, 1990s American music groups, 2000s American music groups, 2010s American music groups, 2012 disestablishments in the United States, American rap music groups, American rock bands, Grammy Award winners, Hip hop bands, Musical groups disestablished in 2012, Musical groups established in 1981, Musical groups from New York City, Webby Award winners
Public Enemy	1980s American music groups, 1990s American music groups, 2000s American music groups, 2010s American music groups, Musical groups from New York, American rap music groups
Macbeth	Plays by William Shakespeare, Scotland in fiction, Literary terms
Love's Labour's Lost	Plays by William Shakespeare
Titus Andronicus	Plays by William Shakespeare
The Comedy of Errors	Plays by William Shakespeare
Pietà (Michelangelo)	Statues, Art by Michelangelo
Raphael	1483 births, 1529 deaths, 16th century Italian painters, Italian architects
Non-governmental organization	Organizations
Wikipedia	2001 establishments in the United States, Encyclopedias, Wikimedia, Wikis, Websites established in 2001
Conservation law	Basic physics ideas
Animal rights	Animal rights, Political movements
Aaron Sorkin	Golden Globe Award winning writers, American screenwriters, Writers from New York City, 1961 births, Living people
470s	470s
1060s	1060s
30s BC	30s BC
Aristophanes	450s BC births, 385 BC deaths, Ancient Greek writers
40s BC	40s BC
California Institute of Technology	Association of American Universities, Colleges and universities in California, Pasadena, California, 1891 establishments in California
Secrecy	Secrecy, Human communication
Chicago Cubs	Chicago Cubs, 1870 establishments in the United States, 1870s establishments in Illinois
Herpes simplex	Diseases caused by viruses, Sexually transmitted diseases
Władysław Reymont	1867 births, 1925 deaths, Polish Nobel Prize winners, Polish novelists
Introversion and extraversion	Psychology, Human behavior
Sartell, Minnesota	Cities in Minnesota
50s BC	50s BC
1690s BC	17th century BC
1680s BC	17th century BC
1670s BC	17th century BC
1080s BC	1080s BC
Sunset	Parts of a day, Astronomical phenomena
Pop punk	Punk rock
Sheryl Crow	Actors from Missouri, American country musicians, American guitarists, American movie actors, American rock singers, American singer-songwriters, American television actors, Grammy Award winners, Singers from Missouri, 1962 births, Living people
Chubby Checker	Singers from South Carolina, 1941 births, Living people
Irish people	Irish people, Celtic peoples
Claude Debussy	20th century composers, Cancer deaths in France, Deaths from colorectal cancer, French composers, 1862 births, 1918 deaths
P.O.D.	American heavy metal bands, Nu metal bands, Alternative metal bands, Christian metal bands, Reggae bands, Musical groups from San Diego, California
Blackbird	Thrushes
Geta (footwear)	Footwear, Japanese clothing
Tabi	Footwear, Japanese clothing
Bydgoszcz	Cities in Poland
The Mystery of Edwin Drood	Books by Charles Dickens, English novels, English-language novels, Books first published in serial form
Vientiane	Capital cities in Asia, Laos
Dome	Architectural elements
Address	Human geography, Postal service, E-mail
T cell	Immunology, Blood cells
Biscuit	Breads, Desserts
Electromagnet	Tools, Electromagnetism
Palau	Palau, 1994 establishments in Oceania
Island country	Countries, Islands
Llivia	Catalan Countries, Exclaves
Monkey Island	Video game series
Port Arthur massacre	1990s in Australia, April events, Mass murder in 1996, Mass shootings in the 1990s, Massacres, Murder in Australia, Murders by firearm, Tasmania
Backpacker murders	1990s in Australia, Murder in Australia, Murder in the 1990s, New South Wales
Death of Azaria Chamberlain	1980 births, 1980 deaths, Australian children, Missing people, People from Queensland
Murder of Peter Falconio	2001 crimes, 2001 deaths, 2000s in Australia, British people murdered abroad, English murder victims, Missing people, Murder in Australia, Murder in the 21st century, Northern Territory, People declared dead in absentia, People from West Yorkshire
John Howard	1939 births, Living people, Australian Anglicans, Australian lawyers, Commonwealth Chairpersons-in-Office, Leaders of the Opposition (Australia), Liberal Party of Australia politicians, Monarchists, Politicians from Sydney, Prime Ministers of Australia, Treasurers of Australia, University of Sydney alumni
Swedish language	Germanic languages, Languages of Europe, Swedish culture
Walter Mikac	Year of birth missing (living people), Living people, Australian writers
Martin Bryant	1967 births, Living people, Australian murderers, Australian prisoners, People convicted of murder, People from Tasmania
Rugby League	Rugby
Dustin Hoffman	Academy Award winning actors, Actors from Los Angeles, California, American movie actors, American television actors, Cancer survivors, Jewish American actors, Kennedy Center honorees, Movie producers from California, 1937 births, Living people
Chopper Read	1954 births, 2013 deaths, Arsonists, Australian criminals, Autobiographers, Cancer deaths in Victoria (Australia), Deaths from liver cancer, Kidnappers, Mafia, People convicted of assault, People convicted of attempted murder, Robbers, Writers from Melbourne
Elle McFeast	Television characters
Elle Macpherson	1964 births, Living people, Australian movie actors, Australian television actors, Australian models, Actors from Sydney
Andrew Denton	Australian comedians, Australian television presenters, 1960 births, Living people, People from Sydney
Rene Rivkin	1944 births, 2005 deaths, Australian businesspeople, Australian criminals, People from Shanghai, People from Sydney, Suicides in Australia
Eric Bana	Australian comedians, Australian movie actors, Australian television actors, Australian voice actors, Actors from Melbourne, Stand-up comedians, Television producers, Television writers, 1968 births, Living people
African-American Vernacular English	African-American history, Dialects of English, Languages of the United States, Linguistics
60s BC	60s BC
Joe Vialls	Australian police officers, Australian journalists, 1944 births, 2005 deaths, People from Perth, Western Australia
Tatts Group Limited	2006 establishments in Australia, Companies of Australia
Tsukuba, Ibaraki	Cities in Japan, Settlements in Ibaraki Prefecture
Narita International Airport	Airports in Japan, Buildings and structures in Tokyo, Chiba Prefecture
Chest	Torso
Blackburn	Towns in Lancashire
National Security Agency	1952 establishments in the United States, National security, United States Department of Defense agencies, United States government agencies
Robert Wadlow	1918 births, 1940 deaths, Infectious disease deaths in the United States, People from Alton, Illinois, World record holders, Deaths from hernia
Code	Cryptography, Human communication
Goaltender	Ice hockey positions
Wikispecies	Wikimedia, Science websites, Websites established in 2004
Lopp Lagoon	Lakes of the United States, Geography of Alaska, Lagoons
Welsh people	Celtic peoples, Ethnic groups in the United Kingdom, Welsh people
League of Nations	1919 establishments, 1946 disestablishments, Geneva, League of Nations
Audiolingual method	Learning, Language
Montenegro	Montenegro, European Union candidate states
Solar eclipse	Astronomical phenomena, Eclipses
Kate Fischer	1973 births, Living people, Australian television actors, People from Adelaide, Australian models, Australian movie actors, Actors from South Australia
Alton, Illinois	Cities in Illinois
Minneapolis	Minneapolis, Minnesota, County seats in Minnesota
St. Louis	County seats in Missouri, Missouri counties, Olympic cities, St. Louis, Missouri, 18th-century establishments in New Spain, 1764 establishments
Albert Coady Wedemeyer	American people of World War II, People from Omaha, Nebraska, 1897 births, 1989 deaths, American military people
William H. Tunner	1906 births, 1983 deaths
Sarasota, Florida	Sarasota, Florida, County seats in Florida, 1902 establishments in the United States, 1900s establishments in Florida
Paul Reubens	1952 births, Living people, People from Peekskill, New York, Actors from New York, American movie actors, American stage actors, American television actors, American television personalities, American voice actors, Comedians from New York, Jewish American actors, Jewish American comedians, Jewish American writers, Jewish businesspeople, Jewish screenwriters, Movie producers from New York, Writers from New York
Peekskill, New York	Cities in New York
Małkinia Górna	Villages in Poland, Ostrowian County (Poland)
John C. Calhoun	1782 births, 1850 deaths, Politicians from South Carolina, United States Secretaries of State, United States Secretaries of War, 19th-century American politicians
Pelvis	Bones, Human body features
Cyprus Mail	English-language newspapers published in Asia, Republic of Cyprus
Collision	Mechanics
Belgrade	Belgrade
Puncknowle	Villages in Dorset
Hydrogen economy	Ecology, Economics, Energy
Brachiosaurus	Jurassic dinosaurs, Brachiosaurs
Barnacle	Crustaceans
International organization	International organizations
Weapon of mass destruction	Weapons
Port Arthur, Tasmania	History of Australia, Towns in Tasmania, Prisons, World Heritage Sites in Australia, Australian Convict Sites, Museums in Australia, Open air museums, 1830 establishments, 1830s establishments in Australia
Odysseus	People in Greek mythology
Cast iron	Alloys, Iron
Incest	Incest, Psychology
The Canterbury Tales	British poems, The Canterbury Tales
Sweat	Integumentary system
Adult Swim	2001 establishments in California, Adult Swim, American television networks, American television series, American television stations, Time Warner subsidiaries
WESC	Companies of Sweden, Clothing companies
Ozámiz	Cities in the Philippines
Tillage	Agriculture
Yarmouth, Nova Scotia	Towns in Nova Scotia
Spleen	Glands, Lymphatic system
Placenta	Pregnancy and childbirth
Glorious Revolution	17th century in England, British monarchy, Rebellions in Europe, 1688, 17th century rebellions, 1680s in Europe
Electromagnetism	Electromagnetism
Acton, Massachusetts	Towns in Massachusetts
Urbana, Illinois	cities in Illinois, county seats in Illinois
Bill Oddie	1941 births, Living people, Actors from Birmingham, Actors from Lancashire, Alumni of the University of Cambridge, Comedians from Lancashire, English movie actors, English television actors, English television presenters, English television writers, People with bipolar disorder, People from Rochdale, Television personalities from Lancashire, Writers from Birmingham, Writers from Lancashire
Montgomery Ward	American department stores, 1872 establishments in the United States, 2000 disestablishments in the United States
Toe	Basic English 850 words, Feet
AFC Champions League	Football competitions, 1967 establishments in Asia
Newton's laws of motion	Mechanics, Laws of physics
Fencing	Fencing
Administrator	Internet, Occupations
Geneva Conventions	Geneva Conventions
International law	International law
Hague Convention	Treaties and Conventions, The Hague
The Hague	The Hague, Cities in the Netherlands, Settlements in South Holland, Provincial capitals of the Netherlands
S.A.S.	1941 establishments in Europe, Military of the United Kingdom, Special Forces, 1940s establishments in the United Kingdom
Kookaburra Sport	Companies of Australia, Cricket
Lancashire	Ceremonial counties of England, Lancashire
Church of England	Anglicanism, England
Tense (grammar)	Grammar
Blackpool Tower	1894 establishments in the United Kingdom, Blackpool, Monuments and memorials in England, Towers in the United Kingdom, Buildings and structures completed in the 19th century
Theme park	Theme parks
Kookaburra	Coraciiformes, Birds of Australia, Birds of Oceania
Poll tax	Taxation
Canadian dollar	Currency of North America, Economy of Canada, 1858 establishments, 1850s establishments in Canada
Bonn	Cities in North Rhine-Westphalia, Bonn
CAF Champions League	Football competitions
Copa Libertadores	Football competitions, CONMEBOL
Longbow	Archery, Weapons
African Union	International organizations, 2002 establishments, Politics of Africa, 2000s establishments in Africa
Bastille	History of France, Buildings and structures in Paris, 1789 disestablishments, 18th century disestablishments in Europe
The Freecycle Network	Internet
Slashdot	Websites
Hooke's law	Mechanics
Railfan	Rail transport
Time (magazine)	1923 establishments in the United States, American magazines, Weekly magazines, Time Warner, Magazines published in New York City
Cable television	Cable television, Television technology
Antenna	Radio antennas
Jack London	American novelists, Writers from San Francisco, Writers from Alaska, Writers from Hawaii, 1876 births, 1916 deaths
Jerk	Mechanics, physical quantity
Electric current	Electricity
Inbreeding	Classical genetics
Cambridge	Cambridge
Adventures of Huckleberry Finn	Bad boy books, Books by Mark Twain, 1884 books, Children's books, English-language novels, American novels
Snooker	Snooker
Aaliyah	1979 births, 2001 deaths, Actors from Brooklyn, Actors from Detroit, Michigan, African American actors, African American musicians, American contemporary R&B singers, American movie actors, Atlantic Records artists, Aviation deaths, Musicians from Brooklyn, Singers from Detroit, Michigan, Singers from New York City
Simple Plan	Pop punk bands, Canadian rock bands, 2000s music groups, 2010s music groups, Atlantic Records artists
Serj Tankian	1967 births, Living people, Armenian people, Naturalized citizens of the United States, People from Beirut, Singers from Los Angeles, California
Axl Rose	1962 births, Living people, Guns N' Roses, American singer-songwriters, Singers from Indiana, American heavy metal singers
Gravitational energy	Mechanics, Gravitation
Equal	Basic English 850 words
Shining Rock Wilderness	Wilderness Areas of the United States, Geography of North Carolina
Radioactive decay	Nuclear physics
Nicotine	Drugs
Addiction	Addiction, Psychology
Secession	Politics
New England	New England
Rockville, Virginia	Cities in Virginia
Intelligence quotient	Intelligence, Giftedness, Tests
Dead Calm	1963 books, Crime fiction books, English-language novels
Event Horizon	1997 horror movies, 1997 science fiction movies, 1990s science fiction horror movies, 1990s supernatural movies, American science fiction horror movies, American supernatural movies, British horror movies, British science fiction movies, English-language movies, Movies set in the future
Melting point	Thermodynamics, Chemistry
Michael Hayden	Directors of the Central Intelligence Agency, Writers from Pittsburgh, Pennsylvania, Politicians from Pittsburgh, Pennsylvania, American political writers, American generals, 1945 births, Living people
Lutherstadt Wittenberg	States of the Holy Roman Empire, Wittenberg Rural District, Martin Luther
Cyberstalking	Internet, Types of crime
Current	Basic English 850 words
Voltage	Energy, Electricity
Stopwatch	Clocks, Measuring tools
Departments of France	Departments of France
Macrosociology	Sociology
Banja Luka Region	Regions of Republika Srpska
Doboj Region	Regions of Republika Srpska
Bijeljina Region	Regions of Republika Srpska
Flag of Poland	National flags, Polish culture
Transrapid	High-speed trains, Transport in the People's Republic of China, Shanghai
Torque	Basic physics ideas, Physical quantity, Mechanics, Engineering
Warm	Basic English 850 words, Thermodynamics
University of Leeds	Leeds, Universities in England, 1831 establishments in Europe, 1830s establishments in England
Leeds	Leeds, Towns in West Yorkshire
Strong interaction	Force, Nuclear physics, Basic physics ideas
Brittany	Brittany
Standard Model	Basic physics ideas, Relativity, Matter, Nuclear physics
Moldovan language	Romance languages, Moldova, Romania, Languages of Europe
List of states with limited recognition	Lists of countries
Electrical resistance	Electronics, Electricity
Electromagnetic induction	Electromagnetism
BBC Proms	Classical music festivals, Music festivals in England, BBC, Entertainment in London
Mount Merapi	Volcanoes of Indonesia
Electrical conductor	Electricity, Basic physics ideas
Michelson interferometer	Measuring tools, Optics, Astrophysics
The Gods Must Be Crazy	1980 action movies, 1980 comedy movies, 20th Century Fox movies, South African movies, Botswanan movies, Multilingual movies, Movies set in Africa, Movies set in deserts
Janus	Roman gods and goddesses
The Care Bears Adventure in Wonderland	1987 movies, 1980s family movies, Canadian animated movies, Canadian family movies, English-language movies
Conducting	Music
Norwegian language	Germanic languages, Languages of Norway
French Polynesia	French Polynesia
Osnabrück	Osnabrück
Neighbour	Relationships
Flip-flop (electronics)	Electronic components, Electronic circuits
Satoshi Tajiri	1965 births, Living people, Japanese video game designers, People from Tokyo, Pokémon, Nintendo people
Ilkley	Towns in West Yorkshire
Econometrics	Economics
Franconia	Bavaria
King of Arms	Heraldry, Occupations
Psychokinesis	Parapsychology, Science fiction
List of international Cartoon Network channels	Cartoon Network, Television lists
Autobiography	Literary terms, Autobiographies
Penjing	Agriculture, Art
Brian Eno	1948 births, Living people, British record producers, English rock musicians, Grammy Award winners, Musicians from Suffolk
Kirby (character)	Anime characters, Animated television series, Fictional characters introduced in 1992, Kirby, Nintendo video game characters
Capacitor	Electronic components
Strategy	Military, Games
Design pattern	Computer science
Amarillo, Texas	Cities in Texas, County seats in Texas
Lansdowne, Pennsylvania	Cities in Pennsylvania
Gillingham F.C.	1893 establishments in England, English football clubs, Gillingham, Kent
Round (music)	Musical forms
Gall bladder	Anatomy of the digestive system
Addenbrooke's Hospital	Buildings and structures in England, Cambridge, Hospitals in the United Kingdom
Koala	Marsupials of Australia, Diprotodonts
John Adams (composer)	1947 births, Living people, American composers, 20th century composers, 21st century composers, Writers from Massachusetts
Handcuffs	Law enforcement equipment
Flashlight	Light sources
Discrimination	Discrimination
Ernest Rutherford	1871 births, 1937 deaths, New Zealand scientists, British chemists, Nuclear physicists, People buried in Westminster Abbey, Order of Merit, Privy Councillors (UK), United Kingdom Barons, Fellows of the Royal Society, Presidents of the Royal Society, New Zealand Nobel Prize winners
Serialism	Musical movements
Frédéric Chopin	Deaths from tuberculosis, Infectious disease deaths in France, Polish pianists, Polish composers, Polish Roman Catholics, French composers, French Roman Catholics, Romantic composers, 1810 births, 1849 deaths
Mikhail Glinka	1804 births, 1857 deaths, Russian composers, Romantic composers, People from Saint Petersburg, Russian musicians
1510	1510
Ellipsoid	Three-dimensional shapes
Liancourt Rocks	Islands of South Korea
Pentagram	Symbols, Religious symbols
Benzene	Hydrocarbons
Tasmanian devil	Dasyuromorphia, Marsupials of Australia
Joseph Haydn	1732 births, 1809 deaths, Austrian composers, Classical era composers
Scale (music)	Music theory
Orthology (language)	Language
1712	1712
Toei Company	Animation studios in Asia
Naoko Takeuchi	1967 births, Living people, Japanese animators
Kimi Ga Yo	Japanese culture, National anthems
April Fools' Day	Holidays
Baroque music	Periods in music history
Canyon	Canyons
Pattern language	Language, Computer science
National Maritime Day	holidays
Nuclear fusion	Astrophysics, Nuclear energy
Concertmaster	Musicians
Mutual assured destruction	Military, Nuclear weapons
Stairway to Heaven	1971 songs, Led Zeppelin
Thin Lizzy	20th century establishments in the Republic of Ireland, 1960s music groups, 1970s music groups, 1980s Irish music groups, 1990s Irish music groups, 2000s Irish music groups, 2010s Irish music groups, Hard rock bands, Irish rock bands, Musical groups established in 1969, Musical groups from Dublin
Aziz al-Abub	Year of birth missing, Lebanese Muslims, Lebanese nationalists, Lebanese terrorists, Muslim terrorists, Psychiatrists
Hobbit	Middle-earth, Fictional races
Bilbo Baggins	Fictional characters introduced in 1937, Characters in The Hobbit, The Lord of the Rings characters
Middle-earth	Middle-earth
Arnold Rosé	1863 births, 1946 deaths, Austrian Jews, Austrian violinists, Concertmasters, Jewish musicians, Refugees from Nazism, Romanian Jews, Romanian musical entertainers
10s	10s
10s BC	10s BC
40s	40s
Pontiac Silverdome	Sports in Detroit, Michigan, Sports buildings in the United States, WrestleMania host, Buildings and structures in Michigan, 1975 establishments in the United States, 20th-century establishments in Michigan, 2007 disestablishments in the United States, Disestablishments in Michigan
List of decades	Time, Lists
80s	80s
Estonian language	Finnic languages, Languages of Europe
Chromosome	Chromosomes
Giovanni Gabrieli	1557 births, 1612 deaths, Italian composers, Baroque composers, Organists
Arcangelo Corelli	Italian composers, Baroque composers, Violinists, 1653 births, 1713 deaths
Henry Purcell	English composers, Baroque composers, 1659 births, 1695 deaths, People buried in Westminster Abbey, Gentlemen of the Chapel Royal
François Couperin	1668 births, 1733 deaths, French composers, Baroque composers
Christoph Willibald von Gluck	German composers, Classical era composers, 1714 births, 1787 deaths
Jan Ladislav Dussek	1760 births, 1812 deaths, Classical era composers
Johannes Brahms	Deaths from cancer, German composers, German pianists, People from Hamburg, Romantic composers, 1833 births, 1897 deaths
Frederick Delius	1862 births, 1934 deaths, English composers, 20th century composers
Béla Bartók	20th century composers, Cancer deaths in the United States, Deaths from leukemia, Hungarian composers, 1881 births, 1945 deaths
Benjamin Britten	20th century composers, British conductors, Cardiovascular disease deaths in England, Companions of Honour, Deaths from heart failure, English composers, English LGBT people, English pianists, Gay men, Grammy Award winners, LGBT composers, LGBT musicians, Musicians from Suffolk, Order of Merit, 1913 births, 1976 deaths
Claudio Monteverdi	1567 births, 1643 deaths, Italian composers, Baroque composers, People from Cremona
Charlie Kaufman	American screenwriters, Writers from New York City, 1958 births, Living people
Oxbow lake	Lakes
Sequel	Literary terms, Movie industry
Major League Soccer	Major League Soccer, Soccer in the United States, Sports organizations of the United States, 1996 establishments in the United States
Chicago Fire FC	American soccer teams, Sports in Chicago, Illinois, 1997 establishments in the United States, 1990s establishments in Illinois
Columbus SC	American soccer teams, Columbus, Ohio, Major League Soccer teams, 1994 establishments in the United States, 20th-century establishments in Ohio
Sporting Kansas City	Major League Soccer teams, Kansas City, Kansas, 1995 establishments in the United States, 20th-century establishments in Kansas
New England Revolution	American soccer teams, Major League Soccer teams, 1994 establishments in the United States, 1990s establishments in Massachusetts
New York Red Bulls	American soccer teams, Football clubs owned by Red Bull, 1995 establishments in the United States, 1990s establishments in New Jersey
Colorado Rapids	1990s establishments in Colorado, 1996 establishments in the United States, American soccer teams, Major League Soccer teams
FC Dallas	American soccer teams, Sports in Dallas, Texas, Major League Soccer teams, 1996 establishments in the United States, 1990s establishments in Texas
Houston Dynamo	American soccer teams, Sports in Houston, Texas, Major League Soccer teams, 2005 establishments in the United States, 2000s establishments in Texas
San Jose Earthquakes	American soccer teams, Sports in San Jose, California, Major League Soccer teams, 1994 establishments in California
Los Angeles Galaxy	American soccer teams, Sports in Los Angeles, Major League Soccer teams, 1995 establishments in California
Real Salt Lake	American soccer teams, Salt Lake City, 2004 establishments in the United States, 21st-century establishments in Utah
Toronto FC	Sport in Toronto, Canadian soccer teams, Major League Soccer teams, 2005 establishments in Canada
President of Germany	Politics of Germany, Lists of heads of state, Germany-related lists, President of Germany
Miami Fusion F.C.	American soccer teams, Sports in Miami, Florida, 1998 establishments in the United States, 2001 disestablishments in the United States
Tampa Bay Mutiny	American soccer teams, Sports in Tampa, Florida, 1996 establishments in Florida, 2001 disestablishments in the United States
San Jose Clash	1994 establishments in California, 1999 disestablishments, 1990s disestablishments in California
The Gillette Company	1900s establishments in Massachusetts, 1901 establishments in the United States, Companies based in Massachusetts, Boston, Massachusetts
Abkhazia	Abkhazia, Caucasus, Autonomous republics of Georgia (country)
Heinrich Schütz	German composers, Baroque composers, 1585 births, 1672 deaths
Domenico Scarlatti	Italian composers, Baroque composers, 1685 births, 1757 deaths, People from Naples
Wilhelm Friedemann Bach	1710 births, 1784 deaths, Bach family, Classical era composers, German composers, German organists, People from Weimar
Indiana Jones	Fictional American people, Fictional characters introduced in 1981, Movie characters
Lord Protector	Heads of state, Titles
Fantasy	Fantasy
Materialism	Philosophical movements and positions
Northern Cyprus	Northern Cyprus
New Caledonia	Islands of Oceania, Melanesia, Australasia, Gondwana, New Caledonia
Dam	Civil engineering, Dams, Flood control
David Beckham	1975 births, Living people, 1998 FIFA World Cup players, 2002 FIFA World Cup players, 2006 FIFA World Cup players, English footballers, Manchester United F.C. players, People from Leytonstone, Sportspeople from London, UEFA Euro 2000 players, UEFA Euro 2004 players, Premier League players
Sonata	Sonatas, Classical music, Musical forms
Sonata form	Musical forms
Aria	Musical forms
Elijah Wood	1981 births, Living people, American movie actors, American television actors, American voice actors, Actors from Cedar Rapids, Iowa
Ian McKellen	1939 births, Living people, Actors from Lancashire, Alumni of the University of Cambridge, Commanders of the Order of the British Empire, Companions of Honour, Drama Desk Award winners, English activists, English LGBT people, English movie actors, English stage actors, English television actors, English voice actors, Gay men, Golden Globe Award winning actors, Knights Bachelor, LGBT actors, LGBT rights activists, Actors from Greater Manchester, People from Bolton, People with cancer, Saturn Award winners, Screen Actors Guild Award winners, Tony Award winning actors, Wigan
Gandalf	Fictional characters introduced in 1937, Fictional characters with immortality, Characters in The Hobbit, The Lord of the Rings characters
Viggo Mortensen	Satellite Award winners, 1958 births, Living people, American movie actors, American photographers, American poets, Actors from New York City, Writers from New York City
Sean Astin	1971 births, Living people, American movie actors, Movie directors from California, Actors from Santa Monica, California
Ian Holm	1931 births, 2020 deaths, Actors from Essex, BAFTA Award winners, Deaths from Parkinson's disease, English movie actors, English stage actors, English television actors, English voice actors, Tony Award winning actors
Luigi Boccherini	1743 births, 1805 deaths, Cellists, Classical era composers, Italian composers, People from Lucca
George Frideric Handel	1685 births, 1759 deaths, Baroque composers, English composers, German composers, Naturalised citizens of the United Kingdom, People buried in Westminster Abbey, People from Halle, Saxony-Anhalt
Richard Wagner	Cardiovascular disease deaths in Italy, Deaths from myocardial infarction, German autobiographers, German composers, People from Leipzig, Romantic composers, 1813 births, 1883 deaths
A Connecticut Yankee in King Arthur's Court	Books by Mark Twain, 1889 books, American novels, English-language novels
Juno (mythology)	Roman gods and goddesses
Excalibur	Arthurian legend, Mythological swords
Georg Philipp Telemann	1681 births, 1767 deaths, Baroque composers, German composers, Multi-instrumentalists, People from Magdeburg
Giovanni da Palestrina	Italian composers, Renaissance composers, 1525 births, 1594 deaths
The Prince and the Pauper	Books by Mark Twain, 1882 books, Children's books, English-language novels, American novels
The Adventures of Tom Sawyer	1876 books, Children's books, Books by Mark Twain, English-language novels, American novels
Billy Boyd	1968 births, Living people, Scottish movie actors, Scottish television actors, Scottish stage actors
Turing machine	Computer science
Canadian football	Canadian football
John Rhys-Davies	1944 births, Living people, Welsh Christians, Welsh movie actors, Welsh stage actors, Welsh television actors, Welsh voice actors
Sean Bean	1959 births, Living people, Actors from Yorkshire, Actors who played Bond villains, English movie actors, English stage actors, English television actors, English voice actors, Entertainers from Sheffield
Tripoli, Greece	Cities in Greece
2006 FIFA World Cup	FIFA World Cup, 2006 in association football, 2006 in Europe, 2000s in Germany, Sport in Berlin, Football in Germany, June events, July 2006 events
Polynesia	Polynesia
Cocaine	Illegal drugs
Viola	String instruments
Windsor, Berkshire	Windsor, Berkshire
Windsor Castle	Castles in England, Royal residences in the United Kingdom, Windsor, Berkshire, 11th century establishments in Europe
Peugeot 206	Peugeot automobiles, Front wheel drive vehicles, 1990s automobiles, 2000s automobiles, 2010s automobiles
Renault Clio	Renault automobiles
Trojan Horse	Greek mythology
Tesco	Supermarkets of the United Kingdom, Companies listed on the London Stock Exchange, Shops, 1919 establishments in the United Kingdom
Fiat Panda	Fiat automobiles, Front wheel drive vehicles, 1980s automobiles, 1990s automobiles, 2000s automobiles, 2010s automobiles
Fiat Croma	Fiat automobiles, Front wheel drive vehicles, 1980s automobiles, 1990s automobiles, 2000s automobiles, 2010s automobiles
Fiat Ulysse	Fiat automobiles, 1990s automobiles, 2000s automobiles, 2010s automobiles, Front wheel drive vehicles
Fiat Punto	Fiat automobiles, 1990s automobiles, 2000s automobiles, 2010s automobiles
Volkswagen Polo	1970s automobiles, 1980s automobiles, 1990s automobiles, 2000s automobiles, 2010s automobiles, Volkswagen Polo
Volkswagen Fox	2000s automobiles, 2010s automobiles, Volkswagen automobiles
Proton Savvy	Automobiles
Peugeot 107	Peugeot automobiles, Front wheel drive vehicles, 2000s automobiles, 2010s automobiles
Toyota Aygo	Toyota automobiles, Front wheel drive vehicles, 2000s automobiles, 2010s automobiles
Airbus A380	Airbus aircraft
Paris (mythology)	People in Greek mythology
Helen of Troy	People in Greek mythology
RSA algorithm	Cryptography, Algorithms
Hector	People in Greek mythology
Hecuba	People in Greek mythology, Slaves
Priam	People in Greek mythology
Achilles	People in Greek mythology, Classical Greek literature
Nymph	Nymphs
Romantic music	Periods in music history
Nereid	Nymphs
Romanticism	Art movements, Cultural history, Literature, Philosophical movements and positions
Seveso disaster	1976 in Europe, 1970s crimes in Europe, 1970s disasters in Europe, 1970s in Italy, Disasters in Italy, July events, Lombardy
Junichiro Koizumi	Prime Ministers of Japan, Alumni of University College London, 1942 births, Living people, Politicians from Kanagawa Prefecture, Keio University alumni
Majulah Singapura	National anthems, Singapore
Abruzzo	Abruzzo
Teramo	Cities in Abruzzo, Capital cities in Italy
Aegean Sea	Seas of the Atlantic Ocean
William de Wiveleslie Abney	1843 births, 1920 deaths, English chemists, English astronomers, English photographers
Giacomo Casanova	Italian writers, 1725 births, 1798 deaths, People from Venice
Colima, Colima	Capital cities in Mexico, Colima
Given name	Given names
Family name	Surnames
John the Baptist	1st century BC births, 1st century deaths, Ancient Israeli people, Early Christian saints, Executed people, New Testament people
List of English monarchs	Kings and Queens of England, Lists of heads of state
List of Scottish monarchs	Kings and Queens of Scotland, Lists of heads of state
Dandelion	Flowers, Asteraceae, Herbs
Motet	musical forms
John Carmack	1970 births, Living people, Businesspeople from Kansas, American computer scientists, Scientists from Kansas, American bloggers
Anthem	musical forms
Chinese characters	Chinese language, Writing systems
Improvisation	musical performance techniques, Plays, Theatrical forms
Reichstag (building)	Buildings and structures in Berlin, Landmarks in Germany, Reichstag, 1894 establishments in Europe, 1890s establishments in Germany
Siren	Greek legendary creatures
Sirens (movie)	1994 movies, English-language movies
Lavender	Lamiaceae, Herbs
St. Gallen	St. Gallen, Imperial free cities
Hollyoaks	1995 establishments in the United Kingdom, 1995 television series debuts, 1990s British drama television series, 1990s British television series debuts, 1990s soap operas, 1990s teen television series, 2000s British drama television series, 2000s soap operas, 2000s teen television series, 2010s British drama television series, 2010s soap operas, 2010s teen television series, British soap operas, British teen television series, Chester, British teen drama television series, English-language television programs
Muse (band)	1994 establishments in England, 1990s British music groups, 2000s British music groups, 2010s British music groups, Alternative rock bands, Devon, English rock bands, Musical groups established in 1994, Musical trios, Progressive rock bands, Warner Bros. Records artists
Astrology	Astrology
Theatre of ancient Greece	Ancient Greece, Theater
Sophocles	Ancient Greek writers
Black pepper	Piperales, Spices
Chili pepper	Capsicum, Spices, Vegetables
Aeschylus	Ancient Greek writers, 525 BC births, 456 BC deaths
Euripides	Ancient Greek writers, 5th century BC births, 406 BC deaths
Chard	Amaranthaceae, Leaf vegetables
Half-life (element)	Nuclear physics
Cyclops	Greek legendary creatures
Magnetic field	Magnetism
Forehead	Face
James Prescott Joule	1889 births, 1818 deaths, English physicists, People from Salford, Greater Manchester
Andromache	People in Greek mythology, Slaves
Astyanax	People in Greek mythology
Neoptolemus	People in Greek mythology
Earth's orbit	Orbits, Earth
Penelope	People in Greek mythology
Anemia	Disorders
Memphis, Tennessee	Memphis, Tennessee, County seats in Tennessee
Dari (Eastern Persian)	Persian language, Languages of Afghanistan, Languages of Iran, Languages of Pakistan
Halo (series)	Halo
Counterpoint	Music, Music theory
Guided by Voices	American rock bands, American pop music groups, Musicians from Dayton, Ohio, Musical groups from Ohio, Musical groups established in 1983, 1983 establishments in the United States, 1980s establishments in Ohio, Musical groups disestablished in 2014, 2014 disestablishments in the United States, Musical groups disestablished in 2004, 2004 disestablishments in the United States, Disestablishments in Ohio, Musical groups established in 2010, 2010 establishments in the United States, 21st-century establishments in Ohio
Eugenics	Eugenics
Sterilisation	Biological reproduction
Cerberus	Greek legendary creatures, Afterlife
Yerevan	Yerevan, Capital cities in Asia, National capitals in Europe
Smallpox	Smallpox
Ancient China	History of China, Ancient history
Shaka	1781 births, 1828 deaths, African people, History of South Africa, Assassinated people
Halo	Optics
Greek underworld	Greek mythology, Afterlife
Mughal Empire	Mughal Empire, History of Pakistan, History of India, History of Afghanistan, History of Bangladesh, 1526 establishments, 1858 disestablishments, 1520s establishments in Asia, 19th century disestablishments in Asia
British Raj	British India, History of Pakistan, Myanmar, Viceroys, 1858 establishments, 1850s establishments in the United Kingdom, 19th century establishments in India, 19th century establishments in Pakistan, Establishments in Bangladesh, 1947 disestablishments in India, 1947 disestablishments in the United Kingdom, 1850s establishments in Asia
Lever	Engineering, Tools
Pulley	Mechanics, Tools
Józef Piłsudski	1867 births, 1935 deaths, Presidents of Poland
1526	1526
Isaiah Berlin	1909 births, 1997 deaths, 20th century philosophers, British philosophers, Jewish British academics, Jewish British scientists, Knights Bachelor, Latvian Jews, Naturalised citizens of the United Kingdom, Order of Merit, People from Riga, Russian Jews
Guru Granth Sahib	Sikhism, Religious texts
Zeno of Elea	490s BC births, 430s BC deaths, Presocratic philosophers
Zeno of Citium	333 BC births, 264 BC deaths, Ancient Greek philosophers
Iron Curtain	History of Europe, Communism
Indus Valley civilization	History of Pakistan, Ancient history, History of India, History of Afghanistan
Sumer	Mesopotamia
Cingular Wireless	American technology companies, Telephone companies, Mobile phones
Mystery Science Theater 3000	1988 American television series debuts, 1999 American television series endings, 1980s American television series, 1990s American television series, American comedy television series, Netflix original shows, English-language television programs
Blaze Starr	1932 births, 2015 deaths, Actors from West Virginia, American adult models, American comedians, American erotic dancers
Zip drive	storage devices
Cosmetics	Cosmetics
Napoleonic Wars	Wars involving France
Cantata	Musical forms
Clavichord	Keyboard instruments, Early musical instruments, String instruments, Percussion instruments
Harmony	music theory
Bow (weapon)	Archery, Weapons
Nuclear physics	Nuclear physics
Seljuk Empire	Former monarchies of Asia, Former empires, History of Iran, Medieval Azerbaijan, Former countries in Asia, Former countries in the Middle East, Royal dynasties, 11th century establishments in Asia, 14th century disestablishments in Asia
Central Asia	Central Asia
Turkestan	Regions of Asia, Central Asia, Nationalism
Mesoamerica	Mesoamerica
Cathode ray tube	Display technology, Television technology, Electronic components
Recitative	musical forms
Ancient India	History of India, Ancient history
Partition of India	20th century in Bangladesh, Partition of India
World Heritage Site	World Heritage Sites
Tail	Basic English 850 words, Animal anatomy
Ganesha	Hindu mythology
Indie (music)	Music industry
Chivas USA	American soccer teams, 2004 establishments in California, 2014 disestablishments in the United States, 2010s disestablishments in California
Abu Musab al-Zarqawi	1966 births, 2006 deaths, Al-Qaeda people, Jordanian people
Salta Province	Provinces of Argentina
Fermat's primality test	Computer science, Number theory
Hash function	Computer science
Trinity	Christian theology
Mošovce	Mošovce, Cities in Slovakia
South Ossetia	South Ossetia, Autonomous republics of Georgia (country)
Soprano	Vocal ranges, Sopranos
Alto	Vocal ranges
Tenor	Vocal ranges
Bass (sound)	Music theory, Sound
Baritone	Vocal ranges
Sappho	Ancient Greek poets, Bisexual people, LGBT writers, 7th century BC births, 6th century BC deaths
Harry Potter and the Order of the Phoenix	2003 books, Harry Potter books, Movies about giants
List of U.S. state songs	Lists of United States state insignia, Lists of songs
Pleiades	Open star clusters
Nicomachus of Gerasa	Ancient mathematicians
Deimos (moon)	Moons of Mars
Phobos (moon)	Moons of Mars
Charon (moon)	Pluto's moons
Charon (mythology)	Greek gods and goddesses, Afterlife
Chaos (mythology)	Greek mythology, Creation myths
Eros	Greek gods and goddesses
Wheelwright	Occupations
Rotterdam	Rotterdam, Cities in the Netherlands, Settlements in South Holland
Throne	Royalty and nobility, Monarchy
Altar	Church architecture
Donald Bradman	1908 births, 2001 deaths, Australian cricketers, Deaths from pneumonia, Infectious disease deaths in Australia, Knights Bachelor, Sportspeople from New South Wales
Ian Botham	1955 births, Living people, English cricketers, English footballers, Sportspeople from Cheshire
Daphne (mythology)	Nymphs
Massively multiplayer online role-playing game	Massively multiplayer online role-playing games, Video game genres
Middle English	English language, 1060s establishments, 15th-century disestablishments
Patroclus	People in Greek mythology
James VI and I	1566 births, 1625 deaths, House of Stuart, Kings and Queens of Scotland, Kings and Queens of Great Britain
Hesiod	Ancient Greek poets, Year of birth unknown, Year of death unknown
Fu Xiancai	Chinese people, Civil rights
Phoebus	Greek gods and goddesses
Overture	Musical forms
Luthier	Music, Occupations
Moss, Norway	Cities in Norway, Municipalities of Norway
Dorset	Dorset, Ceremonial counties of England
Poole	Unitary authorities in Dorset, Towns in Dorset, Ports and harbours of the United Kingdom
Gorilla	Hominids, Mammals of Africa
Matthew Bellamy	English guitarists, English rock musicians, English singer-songwriters, Musicians from Cambridge, Musicians from Devon, 1978 births, Living people
Chris Wolstenholme	1978 births, Living people, English guitarists, Warner Bros. Records artists
Dominic Howard	1977 births, Living people, English musicians
Penlight	Light sources
Raam	Hindu mythology
Bournemouth	Bournemouth
Christchurch, Dorset	Towns in Dorset
Symphony	Musical forms
Upper Franconia Government Region	Upper Franconia
Weimar Republic	1930s disestablishments in Germany, 1910s establishments in Germany, States and territories disestablished in the 20th century, States and territories established in the 20th century, Weimar, Weimar Republic, 1918 establishments, 1933 disestablishments in Europe
Lemma (mathematics)	Mathematics
Avatar	Hinduism

