List of rivers of Botswana	Lists of rivers by country, Lists of rivers of Africa, Geography of Botswana
List of rivers of Brazil	Lists of rivers by country, Rivers of Brazil, Lists of rivers of South America
List of rivers of Brunei	Brunei, Lists of rivers by country, Lists of rivers of Asia
List of rivers of Burkina Faso	Burkina Faso, Lists of rivers by country, Lists of rivers of Africa
List of rivers of Burundi	Burundi, Lists of rivers by country, Lists of rivers of Africa
Memrise	Education, Software, Websites
Karl Weierstraß	1815 births, 1897 deaths, German mathematicians
Tilla Charouni	Islamabad
List of rivers of Cambodia	Rivers of Cambodia, Lists of rivers by country, Lists of rivers of Asia
List of rivers of Cameroon	Cameroon, Lists of rivers by country, Lists of rivers of Africa
List of rivers of the Central African Republic	Central African Republic, Lists of rivers by country, Lists of rivers of Africa
List of rivers of Chile	Rivers of Chile, Lists of rivers by country, Lists of rivers of South America
List of rivers of Chad	Chad, Lists of rivers by country, Lists of rivers of Africa
List of rivers of Colombia	Rivers of Colombia, Lists of rivers by country, Lists of rivers of South America
List of rivers of the Democratic Republic of the Congo	Geography of the Democratic Republic of the Congo, Lists of rivers by country, Lists of rivers of Africa
List of rivers of the Republic of the Congo	Geography of the Republic of the Congo, Lists of rivers by country, Lists of rivers of Africa
List of rivers of Costa Rica	Geography of Costa Rica, Lists of rivers of North America, Lists of rivers by country
Rivers of Ivory Coast	Ivory Coast, Lists of rivers by country, Lists of rivers of Africa
List of rivers of Cuba	Geography of Cuba, Lists of rivers by country, Lists of rivers of North America
List of rivers of Cyprus	Cyprus, Lists of rivers by country, Lists of rivers of Europe, Lists of rivers of Asia
Dezső Czigány	Hungarian people, Painters, 1883 births, 1937 deaths
List of rivers of the Czech Republic	Rivers of the Czech Republic, Lists of rivers by country, Lists of rivers of Europe
Rachel Berry	Fictional American people, Glee, Television characters
List of rivers of Denmark	Rivers of Denmark, Lists of rivers by country, Lists of rivers of Europe
List of rivers of Dominica	Dominica, Lists of rivers by country, Lists of rivers of North America
List of rivers of the Dominican Republic	Rivers of the Dominican Republic, Lists of rivers by country, Lists of rivers of North America
Audrey Tautou	1976 births, Living people, French movie actors, French television actors
Taryn Manning	1978 births, Living people, Actors from Tucson, Arizona, Actors from Virginia, American movie actors, Singers from Arizona
American Reunion	2012 comedy movies, 2010s sequel movies, 2010s sex comedy movies, American Pie movies, American sequel movies, American sex comedy movies, English-language movies, Movies about families, Movies set in Michigan
Natasha Lyonne	Actors from Miami, Florida, Actors from New York City, American child actors, American movie actors, American television actors, Jewish American actors, 1979 births, Living people
Jennifer Coolidge	1963 births, Living people, American television actors, American movie actors, Actors from Boston, Massachusetts
Sakaser	Mountains of Pakistan
Tilla Jogian	Geography of Pakistan, Punjab (Pakistan), Hills
Hermaphroditus	Greek gods and goddesses
Max Payne	2001 video games, PlayStation 2 games, Shooter video games, Xbox games
Nautiloid	Cephalopods
Aphroditus	Greek gods and goddesses
Charles Bonnet	1720 births, 1793 deaths, Swiss biologists, Philosophers, Naturalists, People from Geneva
Trait theory	Psychology
Trait (album)	1988 albums
Trait (computer programming)	Computer programming
Granger, Indiana	Cities in Indiana
Transuranium element	Chemical elements
Stupendemys	Turtles, Fossils
Carol Greider	1961 births, Living people, American Nobel Prize winners, Female scientists, Scientists from San Diego, California, American molecular biologists, American geneticists
Telomerase	Enzymes, Chromosomes
Luc Montagnier	1932 births, Living people, French academics, French biologists, French Nobel Prize winners, Legion of Honour, People from Centre-Val de Loire, Virologists
List of rivers of East Timor	East Timor, Lists of rivers by country, Lists of rivers of Asia
List of rivers of Ecuador	Lists of rivers by country, Rivers of Ecuador, Lists of rivers of South America
Brad Falchuk	1971 births, Living people, American screenwriters, American Jews, American television writers, American television directors, American television producers, writers from Massachusetts
Glee club	Musical groups
Teamwork	Social groups
Interracial marriage	Marriage, Race
Same-sex relationship	LGBT
List of rivers of El Salvador	El Salvador, Lists of rivers by country, Lists of rivers of North America
Francisco Maschio	Horse racing, Argentine people, 1890s births, 20th century deaths, Year of death missing
List of rivers of Equatorial Guinea	Equatorial Guinea, Lists of rivers by country, Lists of rivers of Africa
List of rivers of Eritrea	Eritrea, Lists of rivers by country, Lists of rivers of Africa
List of rivers of Estonia	Geography of Estonia, Lists of rivers by country, Lists of rivers of Europe
List of rivers of Ethiopia	Ethiopia, Lists of rivers by country, Lists of rivers of Africa
List of rivers of Fiji	Fiji, Lists of rivers by country, Lists of rivers of Oceania
List of rivers of Finland	Rivers of Finland, Lists of rivers by country, Lists of rivers of Europe
List of rivers of France	Rivers of France, Lists of rivers by country, France-related lists, Lists of rivers of Europe
List of rivers of Gabon	Gabon, Lists of rivers by country, Lists of rivers of Africa
List of Bob's Burgers episodes	Lists of animated television series episodes
List of rivers of Georgia (country)	Geography of Georgia (country), Lists of rivers by country, Lists of rivers of Europe, Lists of rivers of Asia
List of rivers of Germany	Rivers of Germany, Lists of rivers by country, Germany-related lists, Lists of rivers of Europe
List of rivers of Ghana	Ghana, Lists of rivers by country, Lists of rivers of Africa
List of rivers of Greece	Rivers of Greece, Lists of rivers by country, Lists of rivers of Europe
List of rivers of Grenada	Grenada, Lists of rivers by country, Lists of rivers of North America
List of rivers of Guatemala	Rivers of Guatemala, Lists of rivers of North America, Lists of rivers by country
Ajax, Ontario	Towns in Ontario
List of rivers of Guinea-Bissau	Guinea-Bissau, Lists of rivers by country, Lists of rivers of Africa
Jelly Belly	Candy, American food companies, 1869 establishments in the United States, 1860s establishments in California
Assa Abloy	Locks, Companies of Sweden, 1994 establishments in Europe, 1990s establishments in Sweden
The Bonfire of the Vanities (movie)	1990 drama movies, American drama movies, English-language movies, Movies based on books, Movies directed by Brian De Palma, Movies set in New York City
Rashtrapati Bhavan	Buildings and structures in India
President of India	Presidents of India
Ra.One	2011 science fiction movies, 2010s superhero movies, Indian movies, Hindi-language movies, 2010s chase movies
J. R. D. Tata	1904 births, 1993 deaths, Indian businesspeople, Businesspeople from Paris, Aviators
Chilean Army	Military of Chile, Armies
Agent Vinod	2012 movies, Indian movies, 2010s thriller movies
Kareena Kapoor	1980 births, Indian actors, Living people
Chilean Air Force	Military of Chile, Air forces
Downtown MRT line	2013 establishments in Asia, 2010s establishments in Singapore, Mass Rapid Transit (Singapore) lines
Safe House	2012 thriller movies, 2010s action thriller movies, 2010s spy movies, American action thriller movies, American spy movies, English-language movies, Movies set in South Africa
Lee Hartwell	1939 births, Living people, American biologists, Scientists from Los Angeles, California, Nobel Prize in Physiology or Medicine winners
The Nutcracker and the Mouse King	Fairy tales
Victor Ferreyra	1964 births, Living people, Argentine footballers
Marcelo Morales	1966 births, Living people, Argentine footballers
Yoshimasa Suda	1967 births, Living people, Footballers from Tokyo Prefecture
Eric van Rossum	1963 births, Living people, Dutch footballers, People from Nijmegen, Sportspeople from Gelderland
Formula One car	Formula One
Naoto Hori	1964 births, Living people, Footballers from Kanagawa Prefecture
Peter Garrett	1953 births, Living people, Politicians from Sydney, Australian Labor Party politicians, Australian activists, Australian singers, Australian rock musicians, Government ministers of Australia, Musicians from Sydney
John McConnell	1915 births, 2012 deaths, American activists, People from San Francisco
Marco Antonio Pais dos Santos	1963 births, Living people, Brazilian footballers
Celso Luis Gomes	1964 births, Living people, Brazilian footballers
Edu Manga	1967 births, Living people, Brazilian footballers
Structural isomer	Chemistry
Marcos Fernando Nang	1969 births, Living people, Brazilian footballers
Luís Müller	1961 births, Living people, Brazilian footballers
Susumu Uemura	1964 births, Living people, Footballers from Shiga Prefecture
Antônio Rinaldo Gonçalves	1964 births, Living people, Brazilian footballers
Toru Morikawa	1966 births, Living people, Footballers from Ishikawa Prefecture
Kazuaki Koezuka	1967 births, Living people, Footballers from Osaka Prefecture
Hiroshi Ninomiya (footballer, born 1969)	1969 births, Living people, Footballers from Kumamoto Prefecture
Makoto Yamazaki	1970 births, Living people, Footballers from Kagoshima Prefecture
Paulo Rodrigues Bulk	1960 births, Living people, Brazilian footballers
Capitão	1966 births, Living people, Brazilian footballers
Everton Nogueira	1959 births, Living people, Brazilian footballers
Aldrovani Menon	1972 births, Living people, Brazilian footballers
Mirandinha	1959 births, Living people, Brazilian footballers
Hiroshi Saito	1970 births, Living people, Footballers from Tokyo Prefecture
Yoshinori Higashikawa	1964 births, Footballers from Ishikawa Prefecture, Japanese football managers, Living people
Tetsu Nagasawa	1968 births, Living people, Footballers from Ehime Prefecture
Hiroyuki Yoshida	1969 births, Living people, Footballers from Tokyo Prefecture
Kiril Metkov	1965 births, Living people, Bulgarian footballers, People from Sofia
Tetsuya Ogura	1970 births, Living people, Footballers from Kanagawa Prefecture
Takashi Umezawa	1972 births, Living people, Footballers from Mie Prefecture
Helka Hynninen	1930 births, Living people, Finnish singers
Lucknow	Capital cities in India, Cities and towns in Uttar Pradesh
Desperado	1995 action movies, 1995 crime movies, 1995 thriller movies, American crime movies, Multilingual movies, Mexican movies
Mariano Rajoy	1955 births, Living people, People from Santiago de Compostela, Prime Ministers of Spain, Deputy Prime Ministers of Spain
Orange-breasted sunbird	Passeriformes
Karl Pearson	1857 births, 1936 deaths, Alumni of King's College, Cambridge, English mathematicians, Fellows of the Royal Society, People from London
Yutyrannus	Cretaceous dinosaurs, Coelurosaurs, Dinosaurs of Asia
Nankai Trough	Geography of Japan, Pacific Ocean
Roland Emmerich	Gay men, German LGBT people, German movie directors, German movie producers, German screenwriters, LGBT directors, LGBT producers, LGBT screenwriters, People from Stuttgart, Television producers, 1955 births, Living people
Amélie	2001 comedy movies, 2001 romance movies, 2000s romantic comedy movies, French comedy movies, French-language movies, French romance movies, Movies set in Paris, Movies set in the 1990s, Movies directed by Jean-Pierre Jeunet
List of rivers of Guyana	Lists of rivers by country, Guyana, Lists of rivers of South America
List of rivers of Haiti	Geography of Haiti, Lists of rivers by country, Lists of rivers of North America
List of rivers of Honduras	Honduras, Lists of rivers by country, Lists of rivers of North America
List of rivers of Hungary	Rivers of Hungary, Lists of rivers by country, Lists of rivers of Europe
List of rivers of Iceland	Geography of Iceland, Lists of rivers by country, Lists of rivers of Europe
Child's Play (1988 movie)	1988 horror movies, Child's Play movies, 1980s horror thriller movies, 1980s serial killer movies, American horror thriller movies, American serial killer movies, Supernatural horror movies, English-language movies, Movies set in Chicago, Illinois, Movies shot in Chicago, Illinois, American independent movies, Obscenity controversies
List of rivers of India	Rivers of India, Lists of rivers by country, India-related lists, Lists of rivers of Asia
List of rivers of Indonesia	Geography of Indonesia, Lists of rivers by country, Lists of rivers of Asia
List of rivers of Iran	Geography of Iran, Lists of rivers by country, Lists of rivers of Asia
List of rivers of Iraq	Rivers of Iraq, Lists of rivers by country, Lists of rivers of Asia
Matt Moore (American football)	Dallas Cowboys players, Carolina Panthers players, Miami Dolphins players, 1984 births, Living people, Football players from California
Bride of Chucky	1998 comedy movies, 1998 horror movies, Child's Play movies, American comedy movies, American horror movies, American sequel movies, American supernatural movies, BDSM in movies, Comedy horror movies, English-language movies, Movies set in New Jersey
List of rivers of Ireland	Rivers of Ireland, Lists of rivers by country, Lists of rivers of Europe
List of rivers of Israel	Israel-related lists, Lists of rivers by country, Lists of rivers of Asia, Rivers of Israel
List of rivers of Italy	Rivers of Italy, Lists of rivers by country, Lists of rivers of Europe, Italy-related lists
Jennifer Tilly	1958 births, Living people, Actors from Los Angeles, California, American movie actors, American television actors, American voice actors, Canadian voice actors
List of rivers of Jamaica	Jamaica, Lists of rivers by country, Lists of rivers of North America
Jason Taylor	Miami Dolphins players, Washington Redskins players, New York Jets players, 1974 births, Living people, Sportspeople from Pittsburgh, Pennsylvania, American football linebackers, American football defensive ends
List of rivers of Japan	Rivers of Japan, Lists of rivers by country, Lists of rivers of Asia
List of rivers of Jordan	Rivers of Jordan, Lists of rivers by country, Lists of rivers of Asia
Katherine Heigl	Actors from Washington, D.C., American movie actors, American television actors, 1978 births, Living people
List of rivers of Kazakhstan	Geography of Kazakhstan, Lists of rivers by country, Lists of rivers of Asia
List of rivers of Kenya	Geography of Kenya, Lists of rivers by country, Lists of rivers of Africa
List of rivers of Korea	Lists of rivers by country, Lists of rivers of Asia, Geography of Korea
List of rivers of Kuwait	Kuwait, Lists of rivers by country, Lists of rivers of Asia
List of rivers of Kyrgyzstan	Lists of rivers by country, Lists of rivers of Asia, Geography of Kyrgyzstan
List of rivers of Laos	Rivers of Laos, Lists of rivers by country, Lists of rivers of Asia
List of rivers of Latvia	Latvia, Lists of rivers by country, Lists of rivers of Europe
Bharat Ratna	Orders, decorations, and medals, Indian awards
Kiyonobu Okajima	1971 births, Living people, Footballers from Tokyo Prefecture
Wolnei Caio	1968 births, Living people, Brazilian footballers
Sergio Henrique Savoia Bernardes	1973 births, Living people, Brazilian footballers
Pedro Massacessi	1966 births, Living people, Argentine footballers
Shinya Nishikawa	1974 births, Living people, Footballers from Fukuoka Prefecture
Jose Alves dos Santos Júnior	1969 births, Living people, Brazilian footballers
Hirokazu Ota	1971 births, Living people, Footballers from Kyoto Prefecture
Émerson Luiz Firmino	1973 births, Living people, Brazilian footballers
Evil eye	Magic (paranormal), Superstitions
Milyang Group Gang Rape	2004 crimes, Rape, South Korean criminals
Yasuhiro Yamada	1968 births, 2013 deaths, Footballers from Hiroshima Prefecture
Hiroaki Hiraoka (footballer)	1969 births, Living people, Footballers from Shizuoka Prefecture
Kiyoshi Nakamura	1971 births, Living people, Footballers from Shiga Prefecture
Marco Aurelio Silva Businhani	1972 births, Living people, Brazilian footballers
Noriaki Asakura	1973 births, Living people, Footballers from Shizuoka Prefecture
Takao Oishi	1964 births, Living people, Footballers from Shizuoka Prefecture
Kenji Komata	1964 births, Living people, Footballers from Niigata Prefecture
André Paus	1965 births, Living people, Dutch footballers, Sportspeople from Overijssel
Yasuyuki Iwasaki	1971 births, Living people, Footballers from Shizuoka Prefecture
Shigeo Sawairi	1963 births, Living people, Footballers from Shizuoka Prefecture
Toshiyuki Kosugi	1968 births, Living people, Footballers from Tokyo Prefecture
Masashi Shimamura	1971 births, Living people, Footballers from Kumamoto Prefecture
Inner ear	Hearing
Lambeosaurinae	Hadrosauridae
Seiji Kubo	1973 births, Living people, Footballers from Ibaraki Prefecture
Mitsutoshi Tsushima	1974 births, Living people, Footballers from Shizuoka Prefecture
Toru Kawashima	1970 births, Living people, Footballers from Osaka Prefecture
Kaoru Asano	1973 births, Living people, Footballers from Osaka Prefecture
Kazuya Matsuda	1973 births, Living people, Footballers from Osaka Prefecture
Capri	Islands of Italy
Hypochondriasis	Mental illnesses
Marcus Vipsanius Agrippa	60s BC births, 12 BC deaths, Roman generals
Edward Calvin Kendall	1886 births, 1972 deaths, American chemists, Columbia University alumni, American Nobel Prize winners, Scientists from Connecticut
Riccardo Drigo	Conductors, Composers, Italian people, 1846 births, 1930 deaths
Pierina Legnani	Ballerinas, 1863 births, 1930 deaths, Italian people
Johnny B. Goode	1950s songs, Rock songs
Mathilde Kchessinska	1872 births, 1971 deaths, Russian ballerinas
Saikaidō Seamounts	Seamounts, Pacific Ocean, Volcanoes of Asia
Totem and Taboo	1914 books, Science books
Susan Sontag	1933 births, 2004 deaths, Alumni of the University of Oxford, American feminists, American political activists, Bisexual Jews, Cancer deaths in New York City, Deaths from leukemia, Harvard University alumni, Jewish activists, Jewish American LGBT people, Jewish American writers, Jewish feminists, LGBT feminists, LGBT people from Arizona, LGBT people from Los Angeles, California, LGBT people from New York City, LGBT writers, People from Tucson, Arizona, University of Chicago alumni, Writers from Arizona, Writers from Los Angeles, California, Writers from New York City
Money Train	1995 action movies, 1995 comedy movies, 1995 crime movies, 1995 thriller movies, 1990s action thriller movies, 1990s buddy movies, 1990s crime thriller movies, 1990s criminal comedy movies, American action thriller movies, American buddy movies, American crime thriller movies, American criminal comedy movies, Buddy comedy movies, Buddy cop movies, English-language movies, Movies set in New York City, Movies directed by Joseph Ruben
List of rivers of Lebanon	Lebanon, Lists of rivers by country, Lists of rivers of Asia
List of rivers of Lesotho	Lists of rivers by country, Lists of rivers of Africa, Lesotho
Legally Blonde	2001 comedy movies, American comedy movies, English-language movies, Legal movies, Movies about fraternities and sororities, Movies based on books, Movies set in California, Movies set in Massachusetts, Movies set in universities and colleges
List of rivers of Liechtenstein	Rivers of Liechtenstein, Lists of rivers by country, Lists of rivers of Europe
List of rivers of Lithuania	Lithuania, Lists of rivers by country, Lists of rivers of Europe
List of rivers of Luxembourg	Lists of rivers by country, Lists of rivers of Europe, Rivers of Luxembourg
List of rivers of North Macedonia	North Macedonia, Lists of rivers by country, Lists of rivers of Europe
List of rivers of Madagascar	Madagascar, Lists of rivers by country, Lists of rivers of Africa
List of rivers of Malawi	Lists of rivers by country, Lists of rivers of Africa, Geography of Malawi
List of rivers of Malaysia	Geography of Malaysia, Lists of rivers by country, Lists of rivers of Asia
List of rivers of Mauritius	Geography of Mauritius, Lists of rivers by country, Lists of rivers of Africa
List of rivers of Mexico	Rivers of Mexico, Lists of rivers by country, Lists of rivers of North America
List of rivers of the Federated States of Micronesia	Lists of rivers by country, Federated States of Micronesia, Lists of rivers of Oceania
Alexander Gorsky	Choreographers, 1871 births, 1924 deaths, Russian people
Box Office Mojo	Movie production, Entertainment websites
William Smith (geologist)	English geologists, 1769 births, 1839 deaths
Mukeshpuri	Mountains of Pakistan
Cybele	Greek gods and goddesses, Roman gods and goddesses
Nishinoomote, Kagoshima	Cities in Kyushu, Settlements in Kagoshima Prefecture
Attis	Greek gods and goddesses, Roman gods and goddesses
Agdistis	Greek gods and goddesses, Roman gods and goddesses
Galli	Priests
Demchok	Kashmir, Territorial disputes of India, Territorial disputes of China
Carabiniers of Chile	1927 establishments in Chile, Law enforcement agencies of Chile, Santiago de Chile
Lucius Tarquinius Superbus	Roman people, 6th century BC births, 496 BC deaths, Kings and queens
Columbo	1968 television series debuts, 2003 American television series endings, 1960s American television series, 1970s American television series, 1980s American drama television series, 1990s American drama television series, 1990s crime television series, 2000s American drama television series, 2000s crime television series, 2000s mystery television series, American crime drama television series, American mystery television series, NBC network shows, Television series set in Los Angeles, California, English-language television programs
Investigations Police of Chile	1933 establishments, Law enforcement agencies of Chile, Santiago de Chile, 1930s establishments in Chile
Chilean Gendarmerie	1929 establishments in South America, Law enforcement agencies of Chile, Santiago de Chile, 1920s establishments in Chile
Erin Andrews	Major League Baseball broadcasters, National Football League broadcasters, College basketball broadcasters, College football broadcasters, National Hockey League broadcasters, People from Lewiston, Maine, Writers from Maine, Writers from Florida, American sports commentators, American journalists, 1978 births, Living people
Gokishichidō	Geography of Japan, Japanese culture, History of Japan
Good Morning America	American television talk shows, 1975 American television series debuts, ABC network shows, English-language television programs
Biological species concept	Evolutionary biology
Kyushu-Palau Ridge	Pacific Ocean, Volcanoes of Asia
Seamount	Seamounts
Hazelnut	Edible nuts and seeds
Sibling species	Evolutionary biology
Sherilyn Fenn	American television actors, American movie actors, Actors from Detroit, Michigan, 1965 births, Living people
Circuit (political division)	History of China, History of Japan, History of Korea
Saikaidō	Geography of Japan, Japanese culture
Document Object Model	Software
Nankaidō	Geography of Japan, Japanese culture
Cathedral of the Most Holy Conception, Chile	Roman Catholic Cathedrals, Buildings and structures in Chile, Concepción
Bring It On	2000 comedy movies, 2000s sports movies, 2000s teen comedy movies, American sports comedy movies, American teen comedy movies, English-language movies, High school movies, Movies set in Los Angeles, California, Movies set in San Diego, California, Teen sports movies, Universal Pictures movies, American independent movies
Carrie (1976 movie)	1976 horror movies, 1970s horror thriller movies, 1970s teen movies, American horror thriller movies, Supernatural horror movies, American teen horror movies, Carrie, English-language movies, High school movies, Movies about bullying, Movies about revenge, Movies based on books by Stephen King, Movies directed by Brian De Palma, Proms in movies, Telekinesis in movies
Don't Look Now	1973 horror movies, 1973 thriller movies, 1970s horror thriller movies, 1970s serial killer movies, 1970s supernatural movies, British crime movies, British horror movies, British thriller movies, Crime thriller movies, English-language movies, Hertfordshire, Italian horror movies, Italian thriller movies, Movies about dysfunctional families, Movies based on books, Movies set in Venice, Movies directed by Nicolas Roeg
Yellow-backed duiker	Bovids, Mammals of Africa
Grey crowned crane	Cranes
Marwar	History of India, Indian princely states, Rajasthan
Kapurthala (princely state)	History of India, Indian princely states, Punjab, India
Daniel McKeague	1970s births, Living people, American voice actors, American television actors, Comedians from Minnesota, Actors from Minnesota
Gilbert Gottfried	Living people, American movie actors, American television actors, 1955 births, American stand-up comedians, American voice actors, Actors from New York City, Comedians from New York City
Cooch Behar (princely state)	Indian princely states, History of India, West Bengal, 1580s establishments, 1949 disestablishments in Asia, 1940s disestablishments in India
Tripura (princely state)	History of India, Tripura, Indian princely states
Don Freund	American composers, American classical musicians, 20th century composers, 21st century composers, 1947 births, Writers from Pittsburgh, Pennsylvania, Musicians from Pittsburgh, Pennsylvania, Living people, American educators
Nham Biền	Vietnam
List of American movies of 1991	1991 in the United States, 1991 movies, American movies, Lists of movies
Planning	Planning
John Hickenlooper	1952 births, Living people, 2020 United States presidential candidates, United States senators from Colorado, American geologists, Mayors of Denver, American Protestants, Businesspeople from Pennsylvania, Governors of Colorado, Businesspeople from Denver, Colorado, Scientists from Pennsylvania, Politicians from Denver, Colorado, Politicians from Pennsylvania, Quakers, Scientists from Denver, Colorado, US Democratic Party politicians
Dorf an der Pram	Cities and towns in Upper Austria
Gradualism	Earth sciences, Evolutionary biology, Politics, Planning
Ernst Kummer	1810 births, 1893 deaths, German mathematicians, Foreign Members of the Royal Society
Leopold Kronecker	1823 births, 1891 deaths, Foreign Members of the Royal Society, German mathematicians, Jewish German academics, Jewish German scientists
French Academy of Sciences	Research, France
Búri	Norse gods and goddesses
Comparison of regions of Japan	Geography of Japan, Japanese culture, Subdivisions of Japan
Hokurikudō	Geography of Japan, Japanese culture
Campagnola Cremasca	Settlements in Lombardy
Comunes of the Province of Pavia	Lists of settlements in Europe, Settlements in Lombardy
Alagna	Settlements in Lombardy
Mimi Rogers	Actors from Florida, American movie actors, American television actors, Poker players, 1956 births, Living people
Albaredo Arnaboldi	Settlements in Lombardy
Frascarolo	Settlements in Lombardy
Mortal Thoughts	1991 crime movies, 1991 thriller movies, 1990s crime thriller movies, 1990s mystery movies, American crime thriller movies, American mystery movies, English-language movies, Movies about domestic violence, Movies directed by Alan Rudolph
Maggie Gyllenhaal	Golden Globe Award winning actors, 1977 births, Living people, Actors from New York City, American movie actors, Jewish American actors
The Battle for Wesnoth	2003 video games
Vigevano	Settlements in Lombardy, Towns in Italy, 10th century establishments in Europe, Establishments in Italy
Fiat Palio	Fiat automobiles, Front wheel drive vehicles, 1990s automobiles, 2000s automobiles, 2010s automobiles
The Sword of Truth	Sword of Truth books
Kunio Kishida	1890 births, 1954 deaths, Writers from Tokyo
Jerry Maguire	1996 romance movies, 1996 comedy-drama movies, 1990s romantic comedy movies, 1990s romantic drama movies, 1990s sports movies, Academy Award winning movies, American comedy-drama movies, American romantic comedy movies, American romantic drama movies, American sports movies, English-language movies, Golden Globe Award winning movies, Sports drama movies, Movies directed by Cameron Crowe
Domestic partnership	Law
LGBT rights in the Republic of China	LGBT rights by country, Politics of Taiwan
List of rivers of Mongolia	Mongolia, Lists of rivers by country, Lists of rivers of Asia
List of rivers of Montenegro	Montenegro, Lists of rivers by country, Lists of rivers of Europe
List of rivers of Morocco	Lists of rivers by country, Lists of rivers of Africa, Geography of Morocco
List of rivers of Mozambique	Lists of rivers by country, Lists of rivers of Africa, Geography of Mozambique
Competition (economics)	Economics
List of rivers of Myanmar	Rivers of Myanmar, Lists of rivers by country, Lists of rivers of Asia
Enver Pasha	1881 births, 1922 deaths, Generals, Government ministers, Military personnel of World War I, Muslims, Ottoman people, Turkish military people, Turkish politicians
List of rivers of Namibia	Lists of rivers by country, Lists of rivers of Africa, Geography of Namibia
List of rivers of Nepal	Geography of Nepal, Lists of rivers by country, Lists of rivers of Asia
Hotel Mario	1994 video games, Puzzle video games, Video game memes
Greater flamingo	Birds of Africa, Birds of Pakistan
Bar-headed goose	Geese
Müller's Bornean gibbon	Apes, Mammals of Asia
Jorge Ricardo	Equestrians, 1961 births, Living people, Brazilian sportspeople
Grey bamboo lemur	Lemuriformes, Mammals of Africa
Angola colobus	Mammals of Africa, Old World monkeys
Chris Evert	1954 births, American female tennis players, French Open champions, Living people, People from Boca Raton, Florida, Sportspeople from Florida, US Open (tennis) champions, Wimbledon champions, World No. 1 tennis players
Senate of Chile	Government of Chile, National upper houses
Laurie Metcalf	1955 births, Living people, Actors from Illinois, People from Carbondale, Illinois, American movie actors, American television actors, American voice actors, Tony Award winning actors, Drama Desk Award winners, Emmy Award winning actors
Robert Herbert	1905 deaths, 1831 births, Alumni of the University of Oxford, Australian LGBT people, English LGBT people, Gay men, LGBT politicians, People educated at Eton College, People from Brighton, Politicians from Sussex, Premiers of Queensland
Lara Giddings	1972 births, Living people, Premiers of Tasmania, Australian Labor Party politicians
Premier of Tasmania	Premiers of Tasmania
Bother (song)	2002 songs
Croup	Viruses, Respiratory system, Infectious diseases
List of rivers of the Netherlands	Lists of rivers by country, Rivers of the Netherlands, Lists of rivers of Europe
List of rivers of New Zealand	Lists of rivers by country, Lists of rivers of Oceania, Bodies of water of New Zealand
List of rivers of Nicaragua	Geography of Nicaragua, Lists of rivers by country, Lists of rivers of North America
Christopher Showerman	Living people, 1971 births, Actors from Michigan, American television actors, American movie actors
List of rivers of Nigeria	Geography of Nigeria, Lists of rivers by country, Lists of rivers of Africa, Rivers of Nigeria
San'yōdō	Geography of Japan, Japanese culture
List of rivers of Norway	Lists of rivers by country, Geography of Norway, Lists of rivers of Europe
List of rivers of Oman	Geography of Oman, Lists of rivers by country, Lists of rivers of Asia
List of rivers of Palau	Palau, Lists of rivers by country, Lists of rivers of Oceania
List of rivers of Panama	Panama, Lists of rivers by country, Lists of rivers of North America
George Graham (clockmaker)	1673 births, 1751 deaths, English inventors, People from Cumbria
George Graham (footballer)	1944 births, Living people, Scottish footballers, Scottish football managers, Arsenal F.C. players, Aston Villa F.C. players, Chelsea F.C. players, Crystal Palace F.C. players, Manchester United F.C. players
List of rivers of Niger	Geography of Niger, Lists of rivers by country, Lists of rivers of Africa
San'indō	Geography of Japan, Japanese culture
List of rivers of Oceania	Lists of rivers of Oceania
List of rivers of Paraguay	Lists of rivers by country, Rivers of Paraguay, Lists of rivers of South America
Otitis	Inflammation
List of rivers of Peru	Rivers of Peru, Lists of rivers by country, Lists of rivers of South America
Synovial fluid	Joints
Cracking joints	Joints
Premier of South Australia	Premiers of South Australia
Dance of the Sugar Plum Fairy	Ballets by Lev Ivanov, Compositions by Pyotr Ilyich Tchaikovsky, Ballets first performed by the St. Petersburg Imperial Ballet
Black-and-white ruffed lemur	Lemuriformes, Mammals of Africa
Pear (color)	Shades of green, Shades of yellow
Lycopod	Vascular plants
Marie Bashir	1930 births, Living people, Governors of New South Wales, Australian medical doctors, Australian academics, University of Sydney alumni, University of Sydney faculty
Cecil Woodham-Smith	British historians, 1896 births, 1977 deaths
Solenn Colléter	1974 births, Living people, Alumni of the École nationale de l'aviation civile, French novelists
Surrogacy	Law, Pregnancy and childbirth
Manicouagan crater	Impact craters, Geography of Quebec
−1 (number)	Integers
List of iCarly episodes	2007 in American television, 2008 in American television, 2009 in American television, 2010 in American television, 2011 in American television, 2012 in American television, Lists of comedy television series episodes, Lists of Nickelodeon television series episodes
Japanese saw	Cutting tools
MD5	Algorithms
List of rivers of the Philippines	Lists of rivers by country, Rivers of the Philippines, Lists of rivers of Asia
List of rivers of Poland	Rivers of Poland, Lists of rivers by country, Lists of rivers of Europe, Poland-related lists
List of rivers of Portugal	Lists of rivers by country, Lists of rivers of Europe, Geography of Portugal
List of rivers of Puerto Rico	Lists of rivers of the United States, Puerto Rico
List of rivers of Romania	Rivers of Romania, Lists of rivers by country, Romania-related lists, Lists of rivers of Europe
Tōsandō	Geography of Japan
Mass Gathering Medicine	Social groups, Emergency medicine
List of rivers of Russia	Rivers of Russia, Lists of rivers by country, Lists of rivers of Europe, Lists of rivers of Asia
List of rivers of Rwanda	Rwanda, Lists of rivers by country, Lists of rivers of Africa
List of rivers of Saint Kitts and Nevis	Saint Kitts and Nevis, Lists of rivers by country, Lists of rivers of North America
List of rivers of Saint Lucia	Saint Lucia, Lists of rivers by country, Lists of rivers of North America
List of rivers of Saint Vincent and the Grenadines	Geography of Saint Vincent and the Grenadines, Lists of rivers by country, Lists of rivers of North America
List of rivers of Serbia	Rivers of Serbia, Lists of rivers by country, Lists of rivers of Europe
List of rivers of Sierra Leone	Sierra Leone, Lists of rivers by country, Lists of rivers of Africa
List of rivers of Singapore	Geography of Singapore, Lists of rivers by country, Lists of rivers of Asia
Administrator of the Northern Territory	Administrators of the Northern Territory, Heads of government of Australian states and territories
List of rivers of Slovakia	Rivers of Slovakia, Lists of rivers by country, Lists of rivers of Europe
List of rivers of Slovenia	Rivers of Slovenia, Lists of rivers by country, Lists of rivers of Europe
Septicemic plague	Plague
Titian	1490s births, 1576 deaths, 16th century Italian painters
Giorgione	1470s births, 1510 deaths, 15th century Italian painters
Hamza Ben Driss Ottmani	1940 births, Alumni of the École nationale de l'aviation civile, Economists, Moroccan writers, Living people, People from Rabat
Ivan Vsevolozhsky	Russian people, 1835 births, 1909 deaths, Russian theatre directors, Russian diplomats, Costume designers, Librettists
Troy McClure	The Simpsons characters, Fictional characters introduced in 1991
Anton Graff	1736 births, 1813 deaths, Swiss painters
Carolyn Mary Kleefeld	Living people, Year of birth missing (living people), American poets, American artists, Writers from California
List of rivers of South Africa	Lists of rivers by country, Lists of rivers of Africa, Geography of South Africa
List of rivers of South Sudan	Lists of rivers by country, Lists of rivers of Africa, South Sudan
List of rivers of Spain	Rivers of Spain, Lists of rivers by country, Lists of rivers of Europe
List of rivers of Sri Lanka	Sri Lanka, Lists of rivers by country, Lists of rivers of Asia
List of rivers of Sudan	Sudan, Lists of rivers by country, Lists of rivers of Africa
The Dream of Gerontius	Compositions by Edward Elgar, Oratorios
Birmingham Town Hall	Birmingham, Concert halls in England
Chloë Moretz	1997 births, Living people, Actors from Atlanta, Georgia, Actors from New York City, American child actors, American movie actors, American television actors, American voice actors
Hex editor	Software
List of rivers of Suriname	Lists of rivers by country, Suriname, Lists of rivers of South America
List of rivers of Sweden	Rivers of Sweden, Lists of rivers by country, Lists of rivers of Europe
List of rivers of Switzerland	Rivers of Switzerland, Lists of rivers by country, Switzerland-related lists, Lists of rivers of Europe
List of rivers of Syria	Rivers of Syria, Lists of rivers by country, Lists of rivers of Asia
List of rivers of Tanzania	Geography of Tanzania, Lists of rivers by country, Lists of rivers of Africa
List of rivers of Togo	Togo, Lists of rivers by country, Lists of rivers of Africa
List of rivers of Trinidad and Tobago	Trinidad and Tobago, Lists of rivers by country, Lists of rivers of North America
List of rivers of Turkey	Rivers of Turkey, Lists of rivers by country, Lists of rivers of Europe, Lists of rivers of Asia
List of rivers of Turkmenistan	Lists of rivers by country, Lists of rivers of Asia, Geography of Turkmenistan
List of rivers of Uganda	Uganda, Lists of rivers by country, Lists of rivers of Africa
List of rivers of Ukraine	Rivers of Ukraine, Lists of rivers by country, Lists of rivers of Europe
List of rivers of the United Kingdom	Geography of the United Kingdom, Lists of rivers of the United Kingdom
List of main rivers of England	Lists of rivers of the United Kingdom, Rivers of England, Lists about England
List of main rivers of Wales	Lists of rivers of the United Kingdom, Rivers of Wales, Lists about Wales
List of rivers of Uruguay	Lists of rivers by country, Rivers of Uruguay, Lists of rivers of South America
List of rivers of Venezuela	Lists of rivers by country, Rivers of Venezuela, Lists of rivers of South America
List of rivers of Vietnam	Rivers of Vietnam, Lists of rivers by country, Lists of rivers of Asia
List of rivers of Zambia	Lists of rivers by country, Lists of rivers of Africa, Geography of Zambia
Richard Nikolaus von Coudenhove-Kalergi	1894 births, 1972 deaths, 20th century philosophers, Austrian politicians
List of rivers of Zimbabwe	Lists of rivers by country, Lists of rivers of Africa, Geography of Zimbabwe
Flag of Afghanistan	National flags, Afghanistan
Afghan National Anthem	Afghan society and culture, National anthems
President of Afghanistan	Presidents of Afghanistan
Vice President of Afghanistan	Vice Presidents of Afghanistan
Muhammad Qasim Fahim	1957 births, 2014 deaths, Asian military people, Deaths from myocardial infarction, Tajik people, Vice Presidents of Afghanistan
Karim Khalili	Vice Presidents of Afghanistan, Living people, 1950 births, Hazara politicians, Hazara people
Chief Justice of Afghanistan	Politics of Afghanistan, Chief justices
Abdul Salam Azimi	1936 births, Living people, Afghan people
Noshaq	Landforms of Afghanistan, Mountains of Asia
Registan Desert	Geography of Afghanistan, Deserts of Asia
Helmand River	Geography of Iran, Rivers of Afghanistan
Saif Ali Khan	1970 births, Living people, Indian actors
Official residence	Government buildings, Houses
Uhwudong	Dancers, Korean painters, Korean writers, 1430s births, 1480 deaths, Poets
Van der Waals force	Force, Chemical bonding
Michel Wachenheim	Living people, Alumni of the École nationale de l'aviation civile, 1951 births, Ambassadors of France, French aviators, Alumni of the École Polytechnique
Closeted	LGBT, Metaphors
Iolanta	Compositions by Pyotr Ilyich Tchaikovsky, Operas
Hrithik Roshan	1974 births, Living people, Indian actors, Actors from Mumbai
Stephen Root	1951 births, People from Sarasota, Florida, American movie actors, American television actors, American voice actors, Actors from Florida, Living people
Goose step	Military
James Hong	1929 births, American movie actors, American television actors, American voice actors, Living people, Actors from Minneapolis, Minnesota
Kung Fu Panda Holiday	English-language movies, American animated movies, Christmas movies, 2010 movies, 2010 animated movies, Kung Fu Panda, Television movies
Lockheed C-130 Hercules	Military aircraft, Lockheed & Lockheed-Martin aircraft
Mazar-i-Sharif	Cities in Afghanistan
Badakhshan Province	Provinces of Afghanistan
Fayzabad, Badakhshan	Cities in Afghanistan
Bactria–Margiana Archaeological Complex	Archaeological sites in Asia
Uzbek language	Languages of Russia, Languages of Tajikistan, Turkmenistan, Uzbekistan, Languages of China, Turkic languages
Turkmen language	Languages of Iran, Russia, Turkmenistan, Turkey, Turkic languages
Nuristani languages	Languages of Afghanistan, Languages of Pakistan, Indo-Iranian languages
Telephone numbers in Afghanistan	Telephone numbers, Afghanistan
Helmand Province	Provinces of Afghanistan
Ghazni Province	Provinces of Afghanistan
Ghazni	Cities in Afghanistan
Pashayi language	Languages of Afghanistan, Dardic languages
Kushan Empire	History of Iran, History of Pakistan, Former empires, 1st-century establishments, History of India, Disestablishments in Asia
Jennifer Lawrence	1990 births, Living people, Academy Award winning actors, Satellite Award winners, American child actors, American movie actors, American television actors, American voice actors, Golden Globe Award winning actors, Actors from Louisville, Kentucky, Screen Actors Guild Award winners
Buddhas of Bamiyan	Statues, Buddhism, Geography of Afghanistan, World Heritage Sites in Asia
Tahirid dynasty	Former monarchies of Asia, 873 disestablishments, 821 establishments, History of Islam, Royal dynasties
History of Azerbaijan	History of Azerbaijan
Marilyn Chambers	1952 births, 2009 deaths, Actors from Rhode Island, American erotic dancers, American models, American movie actors, American pornographic actors, Cardiovascular disease deaths in California, Deaths from cerebral hemorrhage
Sistan	Geography of Iran, History of Iran, History of Persia
Saffarid dynasty	History of Iran, History of Afghanistan, Tajikistan, History of Islam, Royal dynasties, 9th century establishments in Asia, 867 establishments, 1002 disestablishments
Bukhara	World Heritage Sites in Asia, Cities in Uzbekistan, History of Persia
Lashkar Gah	Cities in Afghanistan
Greater Khorasan	Regions of Asia, Central Asia, South-central Asia, History of Persia
Al-Farabi	Philosophers, 950s deaths, Turkish people, Scientists, Musicians
Abū Rayḥān al-Bīrūnī	973 births, 1048 deaths, Philosophers, Persian mathematicians, Asian anthropologists
Timurid dynasty	History of Islam, Mongol Empire, History of Iran, History of Uzbekistan, Royal dynasties
Satrap	History of Persia
Hotaki dynasty	History of Iran, History of Afghanistan, Former countries in Asia, Former monarchies of Asia, Royal dynasties, 1709 establishments, 1738 disestablishments, 1700s establishments in Asia, Disestablishments in Asia
Himni i Flamurit	National anthems, Albania
Telephone numbers in Albania	Telephone numbers, Albania
List of heads of state of Albania	Lists of heads of state, Politics of Albania, Albania-related lists
List of prime ministers of Albania	Lists of prime ministers, Prime Ministers of Albania
Zayyanid dynasty	History of Algeria, History of Morocco, Former monarchies of Africa, Royal dynasties, 1236 establishments, 1556 disestablishments, 1230s establishments in Africa
Catholic University of the North	Colleges and universities in Chile, Antofagasta, 1956 establishments in South America, 20th-century establishments in Chile
Gennady Zyuganov	1944 births, Living people, Colonels, Communist politicians, Russian communists, Russian politicians, Soviet military people
Isfana	Towns in Asia, Geography of Kyrgyzstan
Amsterdam Airport Schiphol	Airports in Europe, Transport in the Netherlands, Buildings and structures in the Netherlands, Amsterdam, Haarlemmermeer
Flybe	1979 establishments in the United Kingdom, Airlines of the United Kingdom, Low-cost airlines
Aurigny Air Services	1968 establishments, Airlines of Europe, Channel Islands, 1960s establishments in Europe
Blue Islands	1999 establishments in Europe, Airlines of Europe, Channel Islands
British Midland Airways Limited	Airlines of the United Kingdom, 1938 establishments in the United Kingdom
Bmibaby	Airlines of the United Kingdom, 2002 establishments in the United Kingdom
BMI Regional	Airlines of the United Kingdom, 1987 establishments in the United Kingdom
Belfast City Airport	Airports in the United Kingdom, Belfast, County Antrim, Buildings and structures in Northern Ireland, Transport in Northern Ireland, 1983 establishments in the United Kingdom, 20th century establishments in Northern Ireland
Ipswich Airport	Airports in England, Ipswich
Amānullāh Khān	1892 births, 1960 deaths, Monarchs of Afghanistan
Badghis Province	Provinces of Afghanistan
Qala e Naw	Cities in Afghanistan
Tōkaidō (road)	Roads in Japan, Japanese culture
Tōkaidō (region)	Geography of Japan, Japanese culture
Romantic poetry	Poetry
Baghlan Province	Provinces of Afghanistan
Puli Khumri	Cities in Afghanistan
Antonietta Di Martino	1978 births, Living people, 2008 Summer Olympics, High jumpers, Italian athletes, Italian Olympians, People from Campania
Bamyan Province	Provinces of Afghanistan
Hakucho	Japanese space program, Satellites
Languages of Afghanistan	Languages of Afghanistan
Bamyan	Cities in Afghanistan
Daykundi Province	Provinces of Afghanistan
Lauren Ambrose	1978 births, Living people, Actors from Massachusetts, American movie actors
Nili, Afghanistan	Cities in Afghanistan
Farah Province	Provinces of Afghanistan
Tenma	Japanese space program, Satellites
Farah, Afghanistan	Cities in Afghanistan
Faryab Province	Provinces of Afghanistan
Alain Lefebvre	Living people, 1947 births, Alumni of the École nationale de l'aviation civile, French journalists
Sakigake	Japanese space program, Satellites
Southern	Surnames
Maymana	Cities in Afghanistan
Ghōr Province	Provinces of Afghanistan
Chaghcharan	Cities in Afghanistan
Paula Zahn	American journalists, Writers from Omaha, Nebraska, 1956 births, Living people
Herat Province	Provinces of Afghanistan
Fred Flintstone	Animated characters, Fictional characters introduced in the 1960s, The Flintstones
Cookie Monster	Muppets
Modest Tchaikovsky	1850 births, 1916 deaths, Russian people, Playwrights, Russian LGBT people, Gay men
Antonietta Dell'Era	Dancers, Italian people, 1861 births, 1945 deaths
Jowzjan Province	Provinces of Afghanistan
Sheberghan	Cities in Afghanistan
Kabul Province	Provinces of Afghanistan
Suisei	Japanese space program, Satellites
Kandahar Province	Provinces of Afghanistan
Ginga (satellite)	Japanese space program, Satellites
Temuco Catholic University	Colleges and universities in Chile, 1991 establishments in South America, 1990s establishments in Chile
Kapisa Province	Provinces of Afghanistan
Mahmud-i-Raqi	Cities in Afghanistan
Khost Province	Provinces of Afghanistan
Khost	Cities in Afghanistan
Kunar Province	Provinces of Afghanistan
Asadabad, Afghanistan	Cities in Afghanistan
Kunduz Province	Provinces of Afghanistan
Kunduz	Cities in Afghanistan
Laghman Province	Provinces of Afghanistan
Mehtar Lam	Cities in Afghanistan
Logar Province	Provinces of Afghanistan
Pul-i-Alam	Cities in Afghanistan
Nangarhar Province	Provinces of Afghanistan
Annette Funicello	1942 births, 2013 deaths, Deaths from multiple sclerosis, People with multiple sclerosis, Actors from California, Actors from New York, American movie actors, American television actors, Singers from California, Singers from New York, People from Utica, New York
Nimruz Province	Provinces of Afghanistan
Zaranj	Cities in Afghanistan
Nuristan Province	Provinces of Afghanistan
Parun	Cities in Afghanistan
Urozgan Province	Provinces of Afghanistan
Tarinkot	Cities in Afghanistan
Yohkoh	Japanese space program, Satellites
Gardēz	Cities in Afghanistan
Sanitary epidemiological reconnaissance	Epidemiology, War
Cambridge Airport	1938 establishments in the United Kingdom, Airports in England, 1930s establishments in England
Fortune-telling	Divination, Superstitions, Magic (paranormal)
Yes, Virginia, there is a Santa Claus	Christmas, 1897, American literature
Dan Rather	1931 births, Living people, American television news anchors, Journalists from Texas, American war correspondents, Peabody Award winners, Television personalities from Texas, Emmy Award winners
Lycée Edgar-Poe	Schools in France, 1965 establishments in Europe, Buildings and structures in Paris, 1960s establishments in France
Bias (textile)	Woven fabrics
Madeleine Vionnet	French fashion designers, French fashion houses, 1876 births, 1975 deaths
Shōtai	Japanese eras, 898 establishments, 9th century establishments in Japan, 901 disestablishments, 10th century disestablishments in Japan
Seve Ballesteros	Cancer deaths in Spain, Deaths from brain cancer, Golfers, People from Cantabria, Spanish sportspeople, 1957 births, 2011 deaths
Katsuō-ji	Buddhist temples in Japan, 760s establishments in Japan, 765 establishments
Paktika Province	Provinces of Afghanistan
Sharana, Afghanistan	Cities in Afghanistan
Alexander Glazunov	1865 births, 1936 deaths, Russian people, Russian composers
Paul Oswald Ahnert	1897 births, 1989 deaths, German astronomers
Jason Dolley	1991 births, Living people, American television actors
Panjshir Province	Provinces of Afghanistan
Bazarak, Panjshir	Cities in Afghanistan
Parwan Province	Provinces of Afghanistan
Charikar	Cities in Afghanistan
Treaty of Rawalpindi	History of Afghanistan, 1920s treaties, 1919 in the United Kingdom, 1921 in the United Kingdom
Demography of Afghanistan	Demographics of Afghanistan
Samangan Province	Provinces of Afghanistan
Samangan	Cities in Afghanistan
Sar-e Pol Province	Provinces of Afghanistan
Sar-e Pol city	Cities in Afghanistan
To each according to his contribution	Socialism
Takhar Province	Provinces of Afghanistan
Taloqan	Cities in Afghanistan
Maidan Wardak Province	Provinces of Afghanistan
Maidan Shar	Cities in Afghanistan
Zabul Province	Provinces of Afghanistan
Qalat, Zabul Province	Cities in Afghanistan
Afghan afghani	Afghanistan, Currency of Asia
Pamir languages	Languages of Pakistan, Iranian languages, Languages of Tajikistan, Languages of Afghanistan
Durrës	Cities in Albania
Settlements in Albania	Lists of settlements in Europe, Albania
Elbasan	Cities in Albania
Vlorë	Cities in Albania
Districts of Albania	Districts of Albania
Flag of Albania	Albania, National flags
Coat of arms of Albania	Albania, National coats of arms
Bamir Topi	1957 births, Living people, European diplomats, People from Tirana, Presidents of Albania, Veterinarians
Sali Berisha	1944 births, Living people, Presidents of Albania, Prime Ministers of Albania
The Godfather Part III	1990 crime movies, 1990 drama movies, 1990s crime drama movies, American crime drama movies, American gangster movies, American sequel movies, English-language movies, Movies set in Italy, Movies set in New York City, Movies set in the 1970s, Movies set in the 1980s, Movies directed by Francis Ford Coppola
Architecture of Singapore	Singapore, Architecture
Berat County	Counties of Albania
Dibër County	Counties of Albania
Durrës County	Counties of Albania
Elbasan County	Counties of Albania
Diarchy	Monarchy, Forms of government
List of heads of government of Andorra	Prime Ministers of Andorra, Heads of government, Lists of heads of state
Co-Princes of Andorra	Princes of Andorra
Juan Luis Vives	1493 births, 1540 deaths, Humanists, Spanish scientists, People from Valencia
Alexey Arhipovsky	Russian musicians, 1967 births, Living people
Kate	Given names
Fier County	Counties of Albania
Gjirokastër County	Counties of Albania
Korçë County	Counties of Albania
Kukës County	Counties of Albania
Lezhë County	Counties of Albania
Shkodër County	Counties of Albania
Tirana County	Counties of Albania
Vlorë County	Counties of Albania
Berat	Cities in Albania
Peshkopi	Cities in Albania
List of World Heritage Sites in Japan	World Heritage Sites in Japan, Japanese culture, Lists of World Heritage sites
Fier	Cities in Albania
Gjirokastër	Cities in Albania
Korçë	Cities in Albania
Kukës	Cities in Albania
Lezhë	Cities in Albania
385 BC	385 BC
Tap dance	Dance types
Mishima, Shizuoka	Cities in Japan, Settlements in Shizuoka Prefecture
Shkodër	Cities in Albania
Isadora Duncan	1877 births, 1927 deaths, Accidental deaths in France, American dancers, Bisexual people, American communists, LGBT dancers, Artists from San Francisco, Road accident deaths
Berat District	Districts of Albania
Kuçovë District	Districts of Albania
Bulqizë District	Districts of Albania
Delvinë District	Districts of Albania
Devoll District	Districts of Albania
Dibër District	Districts of Albania
Raveena Tandon	1974 births, Living people, Indian actors
Myles Standish	1580s births, 1656 deaths, Mayflower passengers, People buried in the Myles Standish Burial Ground, Duxbury, Massachusetts
Scientific revolution	History of science
Jack the Giant Slayer (movie)	2013 movies, 2010s adventure movies, 2010s fantasy movies, Movies based on fairy tales, American adventure movies, American fantasy movies, English-language movies, Warner Bros. movies
Dick Jones	Actors from Texas, American child actors, American movie actors, American television actors, American radio actors, American voice actors, Accidental deaths from falls, 1927 births, 2014 deaths
Carolyn Hennesy	American voice actors, 1962 births, Living people
Durrës District	Districts of Albania
Elbasan District	Districts of Albania
Fier District	Districts of Albania
Gjirokastër District	Districts of Albania
Gramsh District	Districts of Albania
Has District	Districts of Albania
Kavajë District	Districts of Albania
Kolonjë District	Districts of Albania
Korçë District	Districts of Albania
Krujë District	Districts of Albania
Kukës District	Districts of Albania
Kurbin District	Districts of Albania
Lezhë District	Districts of Albania
Librazhd District	Districts of Albania
Lushnjë District	Districts of Albania
American Bandstand	American television series, American television, First run syndicated television programs, English-language television programs
Malësi e Madhe District	Districts of Albania
Mallakastër District	Districts of Albania
Mat District	Districts of Albania
Mirditë District	Districts of Albania
Peqin District	Districts of Albania
Përmet District	Districts of Albania
Pogradec District	Districts of Albania
Pukë District	Districts of Albania
Sarandë District	Districts of Albania
Shkodër District	Districts of Albania
Skrapar District	Districts of Albania
Tepelenë District	Districts of Albania
Dick Clark's New Year's Rockin' Eve with Ryan Seacrest	American television, English-language television programs, ABC network shows
Tirana District	Districts of Albania
Tropojë District	Districts of Albania
Vlorë District	Districts of Albania
Albanian Armed Forces	Albania, Military
Mount Korab	Balkan Mountains, Geography of Albania, North Macedonia
Albanian lek	Currency of Europe, Albania
Principality of Arbër	History of Albania, 1190 establishments, 1255 disestablishments, 1190s establishments in Europe, 12th century disestablishments in Europe
League of Lezhë	History of Albania, 1440s establishments in Europe, 15th-century disestablishments, 1444 establishments
Yttrium(III) oxide	Oxides
Karen Allen	American television actors, American movie actors, Actors from Illinois, 1951 births, Living people, Saturn Award winners, Actors from Chicago
Bullet to the Head	2012 thriller movies, 2010s action thriller movies, American action thriller movies, Movies directed by Walter Hill, English-language movies
Christian Slater	Golden Globe Award winning actors, American movie actors, 1969 births, Living people
Respirator	Protective clothing, Headgear
Small shelly fossils	Fossils, Ediacaran, Cambrian
Bo Bice	American country musicians, Southern rock musicians, American rock guitarists, American Idol contestants, Living people, 1975 births, Singers from Huntsville, Alabama, Musicians from Huntsville, Alabama
Walter Pidgeon	Presidents of the Screen Actors Guild, Canadian movie actors, Canadian stage actors, Canadian television actors, 1897 births, 1984 deaths
Greeks in Albania	Greek people, Albanian people
Treaty of London (1913)	1910s treaties, 1913, Ottoman Empire, History of Albania, 20th century in London, 1910s in England
Loretta Young	1913 births, 2000 deaths, Academy Award winning actors, Actors from Los Angeles, California, American child actors, American movie actors, American Roman Catholics, American silent movie actors, American television actors, Deaths from ovarian cancer, Emmy Award winners, Golden Globe Award winners, Actors from Salt Lake City, Utah
Constitution of Albania	Politics of Albania, Constitutions
President of Albania	Presidents of Albania
Prime Minister of Albania	Prime Ministers of Albania
Napa, California	Cities in California, County seats in California, Cities in the San Francisco Bay Area, Napa County, California
Disney Parks, Experiences and Products	1954 establishments in the United States, American entertainment companies, Disney companies
Madeleine Astor	1893 births, 1940 deaths, People from New York City, RMS Titanic
Civil Rights Act of 1964	1964 in the United States, United States federal legislation, 1960s in law
Voting Rights Act of 1965	1965 in the United States, African-American history, Democratic rights, United States federal legislation, 1960s in law
Bok choy	Leaf vegetables
Amadora	Cities in Portugal, Municipalities of Portugal
Magica	Power metal bands, Romanian musical entertainers
Symphonic metal	Symphonic metal
Lucien Petipa	French ballet dancers, French choreographers, People from Marseille, 1815 births, 1898 deaths
Bob Brown	1944 births, Living people, Australian Greens politicians, Australian LGBT people, Gay men, LGBT politicians, Members of the Australian Senate, Politicians from New South Wales, Politicians from Tasmania
Basketball court	Basketball, Sports buildings
Archaeometallurgy	Archaeology, Metals
Barry O'Farrell	Premiers of New South Wales, 1959 births, Living people, Politicians from Melbourne, Liberal Party of Australia politicians
Friend of Dorothy	Gay slang
I Could Go On Singing	1963 drama movies, British drama movies, American drama movies, 1960s musical movies, Movies directed by Ronald Neame
Tassili n'Ajjer	Mountains of Africa, Prehistoric Africa, World Heritage Sites in Africa, Geography of Algeria
Tipaza	World Heritage Sites in Africa, Settlements in Algeria, Towns in Africa, 1867 establishments, Establishments in Algeria, 19th-century establishments in Africa
Barbary Coast	Geography of Africa
Kameyama, Mie	Cities in Japan, Settlements in Mie Prefecture
National Liberation Front (Algeria)	Politics of Algeria‎, Socialism, Political parties in Africa, 1954 establishments, Nationalist organizations in Africa, National liberation movements, 20th-century establishments in Algeria
Ahmed Ben Bella	1918 births, 2012 deaths, Presidents of Algeria, Muslims
Elizabeth Banks	Actors from Massachusetts, American movie actors, American television actors, American voice actors, Democrats (United States), 1974 births, Living people
Flag of Algeria	National flags, Algeria
Movie 43	2013 comedy movies, 2010s black comedy movies, 2010s sex comedy movies, American black comedy movies, American sex comedy movies, English-language movies, American independent movies
Justin Long	American movie actors, Actors from Fairfield, Connecticut, 1978 births, Living people
Australian Convict Sites	Australian Convict Sites, World Heritage Sites in Australia
Sequoia National Park	National parks in the United States, Geography of California, Tulare County, California, 1890 establishments in the United States, 1890s establishments in California
Summer Stock	American musical movies, 1950 movies, MGM movies
Commission nationale de la certification professionnelle	Education in France, 2002 establishments in France
Kupiškis	Cities in Lithuania
Greater Blue Mountains Area	Geography of New South Wales, World Heritage Sites in Australia, Australian National Heritage List
Blaenavon Industrial Landscape	Buildings and structures in Wales, World Heritage Sites in the United Kingdom
Groupement des industries françaises aéronautiques et spatiales	1908 establishments in Europe, Aviation in France, Aerospace engineering, Scientific organizations, 1900s establishments in France
Esquire (magazine)	1932 establishments in the United States, American magazines, Magazines published in New York City
UniverSud Paris	Colleges and universities in France, 1991 establishments in France, Île-de-France
Charity (practice)	Altruism
Daphnia	Branchiopods
President of Algeria	Presidents of Algeria, 1962 establishments in Africa, 20th-century establishments in Algeria
From each according to his ability, to each according to his need	Socialism
Kassaman	National anthems, Algeria, 20th-century establishments in Algeria, 1956 establishments in Africa
San Francisco row houses	Buildings and structures in San Francisco
Emblem of Algeria	Algeria, National coats of arms, 1976 establishments in Africa, 20th-century establishments in Algeria
Abdelaziz Bouteflika	1937 births, Presidents of Algeria, 2021 deaths, Presidents of the United Nations General Assembly, Recipients of the Decoration for Services to the Republic of Austria, Deaths from stroke, Deaths from cardiac arrest
Prime Minister of Algeria	Prime Ministers of Algeria, 1962 establishments in Africa, 20th-century establishments in Algeria
Ahmed Ouyahia	1952 births, Living people, Prime Ministers of Algeria
Adrar Province	Provinces of Algeria
Carlton Gardens, Melbourne	Buildings and structures in Melbourne, Botanical gardens, World Heritage Sites in Australia
Chlef Province	Provinces of Algeria
Laghouat Province	Provinces of Algeria
Crater Lake National Park	National parks in the United States, Oregon
Oum El Bouaghi Province	Provinces of Algeria
Bob Carr	1947 births, Living people, Premiers of New South Wales, Politicians from Sydney, Australian Labor Party politicians, Members of the Australian Senate, Australian ministers for Foreign Affairs
List of World Heritage Sites in Australia	World Heritage Sites in Australia, Australian culture, Lists of World Heritage sites, Australia-related lists
The Dark Knight Rises	2012 movies, 2010s superhero movies, American thriller movies, British movies, Batman movies, English-language movies, Movies based on comic book characters, Movies composed by Hans Zimmer, Movies directed by Christopher Nolan, IMAX movies, The Dark Knight Trilogy, Warner Bros. movies
Total Recall (1990 movie)	1990 action movies, 1990s mystery movies, 1990 science fiction movies, American action movies, American mystery movies, American science fiction movies, English-language movies, Movies based on books, Movies directed by Paul Verhoeven, Movies set in the future, Movies set on Mars, Dystopian movies, Movies about dreams
That's the Way (I Like It)	Pop songs, 1975 songs
Hefei	Cities in China
Anhui	Provinces of China
Australian Fossil Mammal Sites (Riversleigh / Naracoorte)	World Heritage Sites in Australia, Lagerstätten, Protected areas of South Australia, Protected areas of Queensland
Indian Armed Forces	Military of India
Na Hye-sok	Korean writers, Korean poets, Korean painters, Korean feminists, 1896 births, 1948 deaths
Indian Army	Military of India, Armies
Old City (Jerusalem)	Neighbourhoods of Jerusalem, World Heritage Sites in Asia, Jewish history, History of Islam, History of Palestine
Djoudj National Bird Sanctuary	Senegal, Birds, World Heritage Sites in Africa, 1971 establishments in Africa, National parks in Africa
Refining	Industries
American cheese	Processed cheese
Fraser Island	World Heritage Sites in Australia, Islands of Australia, Protected areas of Queensland, Biosphere reserves
Village Voice	Newspapers in New York City, 1955 establishments in the United States, 1950s establishments in New York (state)
Purnululu National Park	World Heritage Sites in Australia, Protected areas of Western Australia, National parks in Australia
Cinema of India	Cinema of India, Indian culture
Lord Howe Island Group	World Heritage Sites in Australia, Islands of Australia, Geography of New South Wales
Lord Howe Island	Geography of New South Wales, Islands of Australia, Volcanoes of Australia, Australian National Heritage List
Islam in Iran	Islam by country, Iranian culture
Jaú National Park	National parks in South America, World Heritage Sites in South America, Geography of Brazil, Amazonas (Brazil)
List of World Heritage Sites in Ecuador	World Heritage Sites in South America, Ecuador, Lists of World Heritage sites
Batna Province	Provinces of Algeria
Béjaïa Province	Provinces of Algeria
Biskra Province	Provinces of Algeria
Béchar Province	Provinces of Algeria
Blida Province	Provinces of Algeria
Bouïra Province	Provinces of Algeria
Tamanghasset Province	Provinces of Algeria
Tébessa Province	Provinces of Algeria
Tlemcen Province	Provinces of Algeria
Patti Austin	1950 births, Living people, Singers from New York City, Singer-songwriters from New York, American R&B singers
Tiaret Province	Provinces of Algeria
Tizi Ouzou Province	Provinces of Algeria
Algiers Province	Algiers, Provinces of Algeria
Djelfa Province	Provinces of Algeria
Jijel Province	Provinces of Algeria
Lactarius torminosus	Fungi
Sétif Province	Provinces of Algeria
Saïda Province	Provinces of Algeria
Skikda Province	Provinces of Algeria
Sidi Bel Abbès Province	Provinces of Algeria
Annaba Province	Provinces of Algeria
Guelma Province	Provinces of Algeria
Constantine Province	Provinces of Algeria
Médéa Province	Provinces of Algeria
Mostaganem Province	Provinces of Algeria
M'Sila Province	Provinces of Algeria
Mascara Province	Provinces of Algeria
Ouargla Province	Provinces of Algeria
Oran Province	Provinces of Algeria
El Bayadh Province	Provinces of Algeria
Illizi Province	Provinces of Algeria
Island of stability	Physics
Bordj Bou Arréridj Province	Provinces of Algeria
Boumerdès Province	Provinces of Algeria
El Tarf Province	Provinces of Algeria
Tindouf Province	Provinces of Algeria
Tissemsilt Province	Provinces of Algeria
El Oued Province	Provinces of Algeria
Khenchela Province	Provinces of Algeria
Souk Ahras Province	Provinces of Algeria
Tipasa Province	Provinces of Algeria
Mila Province	Provinces of Algeria
Macquarie Island	World Heritage Sites in Australia, Islands of Australia, Australian National Heritage List, Protected areas of Tasmania, Biosphere reserves
Aïn Defla Province	Provinces of Algeria
Naama Province	Provinces of Algeria
Aïn Témouchent Province	Provinces of Algeria
Matilde Camus	1919 births, Spanish poets, 2012 deaths, People from Cantabria
Ghardaïa Province	Provinces of Algeria
Camus	Surnames
Relizane Province	Provinces of Algeria
Wāli	Titles
Shark Bay	World Heritage Sites in Australia, Geography of Western Australia, Australian National Heritage List
People's Provincial Assembly	Government of Algeria
Numidia	History of Algeria, History of Tunisia
Rustamid	History of Africa, History of Algeria, History of Islam, Former theocracies, Former countries in Africa, Former monarchies of Africa
Zirid dynasty	History of Algeria, History of Africa, Former monarchies of Africa, Royal dynasties, 10th-century establishments in Africa, 12th century disestablishments in Africa, 973 establishments, 1152 disestablishments
Stonehenge, Avebury and Associated Sites	Buildings and structures in England, World Heritage Sites in the United Kingdom, Stone circles, Archaeological sites in Wiltshire, National Trust properties, Henges, Neolithic
Hammadid dynasty	History of Africa, Former monarchies of Africa, 11th-century establishments in Africa, 12th century disestablishments in Africa, 1152 disestablishments, 1014 establishments
French colonial empire	History of France, Overseas empires, Colonialism, 1534 establishments, 1946 disestablishments
Algerian dinar	Currency of Africa, Algeria, 1964 establishments in Africa, 20th-century establishments in Algeria
Central Atlas Tamazight	Berber languages, Morocco
Iwami Ginzan Silver Mine	World Heritage Sites in Japan, Museums in Japan, Mining, Buildings and structures in Japan, Shimane Prefecture, 1520s establishments in Asia, 1923 disestablishments, 16th century establishments in Japan, 20th century disestablishments in Japan, 1526 establishments, 1920s disestablishments in Asia
Shrines and Temples of Nikkō	Buildings and structures in Japan, World Heritage Sites in Japan, Shinto shrines, Tochigi Prefecture, Buddhist temples in Japan
Wet Tropics of Queensland	World Heritage Sites in Australia, Geography of Queensland, Australian National Heritage List
The Last Temptation of Christ	1988 movies, Academy Award winning movies, American drama movies, American epic movies, English-language movies, Movies directed by Martin Scorsese, David Bowie, American independent movies
Flag of Andorra	Andorra, National flags
Important Cultural Properties of Japan	Japanese culture
Coat of arms of Andorra	National coats of arms, Andorra
El Gran Carlemany	National anthems, Andorra
Joan Enric Vives Sicília	1949 births, Living people, Current national leaders, People from Barcelona, Princes of Andorra, Roman Catholic archbishops, Spanish Roman Catholics
Nemesi Marqués Oste	1935 births, Living people, Andorran people, Christian clergy, Governors-general, Spanish Roman Catholics
Saltaire	Buildings and structures in England, World Heritage Sites in the United Kingdom
Christian Frémont	1942 births, 2014 deaths, Deaths from cancer, Andorran people, French politicians, Governors-general, People from Nouvelle-Aquitaine
Antoni Martí	1963 births, Living people, Prime Ministers of Andorra
Paréage	Treaties, Middle Ages
Crown of Aragon	History of France, History of Spain, Former monarchies of Europe
List of countries by GDP (PPP)	GDP-related lists of countries
Saint Helena, Ascension and Tristan da Cunha	Saint Helena, Ascension and Tristan da Cunha
Canillo	Parishes of Andorra
Encamp	Parishes of Andorra
Escaldes-Engordany	Parishes of Andorra
La Massana	Parishes of Andorra
Ordino	Parishes of Andorra
Sant Julià de Lòria	Parishes of Andorra
Coma Pedrosa	Pyrenees, Geography of Andorra
Our Lady of Meritxell	Andorra, Statues, Marian shrines
Rheumatoid arthritis	Inflammation, Diseases and disorders of joints, Rheumatology
World Heritage Committee	UNESCO, International organizations, Conservation
Willandra Lakes Region	World Heritage Sites in Australia, Geography of New South Wales, Australian National Heritage List
Sloth (deadly sin)	Seven deadly sins
Ponte Buggianese	Towns in Tuscany
The Hardy Boys	Characters in written fiction, Children's books, Fiction books, Fictional American people, Series of books, Television series by Disney
Stella McCartney	1971 births, Living people, British fashion designers, Paul McCartney
Chunseong	1891 births, 1977 deaths, South Korean writers, Korean poets
Historic Monuments of Ancient Nara	World Heritage Sites in Japan, Buildings and structures in Japan, Japanese culture
University of Valparaíso	Colleges and universities in Chile, Valparaíso, 1981 establishments in Chile
Historic Monuments of Ancient Kyoto (Kyoto, Uji and Otsu Cities)	World Heritage Sites in Japan, Buildings and structures in Kyoto Prefecture, Japanese culture
Vredefort crater	World Heritage Sites in Africa, Impact craters, Geography of South Africa
Chinese Crested Dog	Dog breeds
Universitat d'Andorra	Andorra, Colleges and universities in Europe, 1997 establishments in Europe
Telephone numbers in Andorra	Telephone numbers, Andorra
List of countries by GDP (PPP) per capita	GDP-related lists of countries
List of countries by GDP (nominal)	GDP-related lists of countries
List of countries by GDP (nominal) per capita	Lists of countries by GDP per capita
Varicose veins	Diseases and disorders of the cardiovascular system, Blood vessels
Emblem of Angola	National coats of arms, Angola, 1990 establishments, 1990s establishments in Africa, 20th-century establishments in Angola
Angola Avante	Angola, National anthems, 1975 establishments in Africa, 1970s establishments in Angola
Chokwe language	Niger-Congo languages
South Mbundu language	Niger-Congo languages, Languages of Africa
Kimbundu	Niger-Congo languages, Languages of Africa
Ganguela	Ethnic groups in Africa
Kwanyama	Languages of Africa, Niger-Congo languages
Bengo Province	Provinces of Angola
Benguela Province	Provinces of Angola
Bié Province	Provinces of Angola
Cabinda Province	Provinces of Angola
Australian Fossil Mammal Sites (Riversleigh)	World Heritage Sites in Australia, Protected areas of Queensland, Australian National Heritage List, Lagerstätten
Kwikset	Locks, Companies of the United States
Hiroshima Peace Memorial (Genbaku Dome)	World Heritage Sites in Japan, Buildings and structures in Japan, Hiroshima, 1915 establishments, 1910s establishments in Japan
Elisha Cuthbert	1982 births, Living people, Actors from Calgary, Actors from Quebec, Canadian child actors, Canadian movie actors, Canadian television actors
The Italian Job	1969 comedy movies, 1969 drama movies, 1960s comedy-drama movies, 1960s crime movies, British comedy-drama movies, British crime drama movies, British criminal comedy movies, Chase movies, English-language movies, Heist movies, Movies set in Italy
Cuando Cubango Province	Provinces of Angola
Cuanza Norte Province	Provinces of Angola
Cuanza Sul Province	Provinces of Angola
Cunene Province	Provinces of Angola
Salmacis	Nymphs
Huambo Province	Provinces of Angola
Huíla Province	Provinces of Angola
Luanda Province	Provinces of Angola
Historic Monuments and Sites of Hiraizumi	World Heritage Sites in Japan, Buildings and structures in Japan, Japanese culture
Lunda Norte Province	Provinces of Angola
Lunda Sul Province	Provinces of Angola
Malanje Province	Provinces of Angola
Moxico Province	Provinces of Angola
Namibe Province	Provinces of Angola
Uíge Province	Provinces of Angola
Zaire Province	Provinces of Angola
Caxito	Cities in Angola
Benguela	Cities in Angola
Kuito	Cities in Angola
Cabinda (city)	Cities in Angola
Menongue	Settlements in Angola, Towns in Africa
N'dalatando	Settlements in Angola, Towns in Africa
Teenage pregnancy	Pregnancy and childbirth
Bandō, Ibaraki	Cities in Japan
The Amazing Spider-Man (2012 movie)	2012 science fiction movies, 2010s action movies, 2010s superhero movies, Spider-Man movies, Movies composed by James Horner, English-language movies, Reboot movies, The Amazing Spider-Man (2012 movie series)
Sudbury Basin	Geography of Ontario, Impact craters
Ladbroke Grove rail crash	1999 disasters, 1999 in England, 20th century in London, Railway accidents in Europe, October events
Thames Trains	Train operating companies, Railway operators in London, 1996 establishments in England, 2004 disestablishments in the United Kingdom, 21st century disestablishments in England
Freeport, Bahamas	Districts of the Bahamas, 1955 establishments, 1950s establishments in North America, 20th-century establishments in the Bahamas
Grand Bahama International Airport	Airports in North America, The Bahamas
Florida's Turnpike	Roads in Florida, Things named after Ronald Reagan
Hala'ib Triangle	Territorial disputes, Egypt, Sudan
Daniel Stern	American television actors, American movie actors, Actors from Maryland, 1957 births, Living people, People from Bethesda, Maryland
David Cone	New York Yankees players, 1963 births, Living people, Sportspeople from Kansas City, Missouri, National League All-Stars
Cesarean section	Surgery, Biological reproduction
Waheed Murad	1938 births, 1983 deaths, Pakistani movie actors, Pakistani people, Cinema of Pakistan, People from Karachi
Sumbe	Cities in Angola
Ondjiva	Cities in Angola
Huambo	Cities in Angola
Lubango	Cities in Angola
Lucapa	Cities in Angola
Saurimo	Cities in Angola
Malanje	Cities in Angola
Out of the Game	2012 albums, Rufus Wainwright albums
Luena, Moxico Province	Cities in Angola
Namibe	Cities in Angola, 1840 establishments, Establishments in Portugal, Establishments in Angola, 1840s establishments in Africa, 1840s establishments in Europe
Uíge	Cities in Angola
M'banza-Kongo	Cities in Angola, 1570 establishments, Establishments in Angola
West Africa Time	Time zones
White-cheeked antbird	Passeriformes
President of Angola	Presidents of Angola, 1975 establishments in Africa, 1970s establishments in Angola
William John Swainson	1789 births, 1855 deaths, British ornithologists, Fellows of the Royal Society, Scientists from London, Artists from London
José Eduardo dos Santos	1942 births, Living people, Presidents of Angola
Vice President of Angola	Angolan people, Vice presidents
Fernando da Piedade Dias dos Santos	1950 births, Vice presidents, Living people, Prime ministers, Angolan people, Legislative speakers
Angolan War of Independence	1960s, 1970s, 20th century in Angola, Wars involving Portugal, Wars involving South Africa, Wars of independence, History of Portugal
Monogamy	Marriage, Sexuality
Angolan Civil War	History of Angola, Civil wars
Formicariidae	Tyrannides
Telephone numbers in Angola	Angola, Telephone numbers
Tyche	Greek gods and goddesses
Angolan kwanza	Currency of Africa, Angola, 1977 establishments in Africa, 1970s establishments in Angola
Charles Sibley	American ornithologists, Scientists from California, 1917 births, 1998 deaths
Jon Edward Ahlquist	Year of birth missing (living people), Living people, American biologists, American ornithologists
Blue Thunder	1983 drama movies, 1983 thriller movies, American drama movies, American thriller movies, English-language movies, Movies set in Los Angeles, California, Movies directed by John Badham
Honors music	National anthems
Fair Antigua, We Salute Thee	Antigua and Barbuda, National anthems
Flag of Antigua and Barbuda	Antigua and Barbuda, National flags
Priapus	Greek gods and goddesses
Mamma Mia!	2008 movies, 2000s romantic comedy movies, American musical movies, English-language movies, Movies set in Greece, Universal Pictures movies
Sparkle	American musical movies, 2012 movies, American drama movies, English-language movies
Planaria	Flatworms
Ironbridge Gorge	World Heritage Sites in the United Kingdom, Shropshire, Canyons
The Iron Bridge	Bridges in the United Kingdom, World Heritage Sites in the United Kingdom, Shropshire
Herma	Ancient Greece, Sculpture
26th of July Movement	1950s in Cuba, Political parties, Nationalist organizations, National liberation movements, 1953, July events
Antiplatelet drug	Drugs
Charles Edward Trevelyan	British politicians, 1807 births, 1886 deaths, Civil servants
Penelope (movie)	2006 comedy movies, 2006 romance movies, 2000s fantasy movies, American fantasy movies, American romantic comedy movies, English-language movies, American independent movies
Mimusops	Sapotaceae
Coalbrookdale	Villages in Shropshire
Drosophila simulans	Drosophila
Nozomi (spacecraft)	Japanese space program, Canada, Spacecraft
Hayabusa	Japanese space program, Spacecraft, 21st century in Japan
Jessica Chastain	American movie actors, American television actors, Actors from Sacramento, California, 1977 births, Living people
Juei	Japanese eras
Genryaku	Japanese eras
Bunji (era)	Japanese eras, 1185 establishments, 1180s establishments in Japan, 1190 disestablishments, 12th century disestablishments in Japan
Rush Hour (movie)	American comedy movies, American action movies, 1998 movies, Movies directed by Brett Ratner, Multilingual movies
Kenkyū	Japanese eras, 1190 establishments, 1190s establishments in Japan, 1199 disestablishments, 12th century disestablishments in Japan
2112 (album)	1976 albums, Progressive rock albums, Hard rock albums, Heavy metal albums
Shōji (era)	Japanese eras, 1200s disestablishments in Japan, 1201 disestablishments, 1199 establishments, 1190s establishments in Japan
Kennin	Japanese eras, 1200s establishments in Japan, 1200s disestablishments in Japan, 1201 establishments, 1204 disestablishments
Spectacled caiman	Crocodilia
Coat of arms of Antigua and Barbuda	Antigua and Barbuda, National coats of arms
Saint George Parish, Antigua and Barbuda	Parishes of Antigua and Barbuda
Saint John Parish, Antigua and Barbuda	Parishes of Antigua and Barbuda
Saint Mary Parish, Antigua and Barbuda	Parishes of Antigua and Barbuda
Saint Paul Parish, Antigua and Barbuda	Parishes of Antigua and Barbuda
Saint Peter Parish, Antigua and Barbuda	Parishes of Antigua and Barbuda
Saint Philip Parish, Antigua and Barbuda	Parishes of Antigua and Barbuda
Redonda	Geography of Antigua and Barbuda, Caribbean islands, Uninhabited regions
Fortune cookie	Chinese food, Cookies, Luck
Monarchy of Antigua and Barbuda	Antigua and Barbuda, Current monarchies
The Reader	2008 drama movies, 2008 romance movies, 2000s romantic drama movies, Academy Award winning movies, American romantic drama movies, BAFTA Award winning movies, English-language movies, German-language movies, German romance movies, German drama movies, Golden Globe Award winning movies, Movies based on books, Movies set in the 1950s, Movies set in the 1960s, Movies set in the 1980s, Movies set in the 1990s
Rachel Getting Married	2008 drama movies, 2008 romance movies, American drama movies, English-language movies, Movies about drugs, Movies directed by Jonathan Demme, American independent movies
Genkyū	Japanese eras, 1200s establishments in Japan, 1200s disestablishments in Japan, 1204 establishments, 1206 disestablishments
Shiretoko National Park	World Heritage Sites in Japan, 1964 establishments in Asia, National parks in Asia, 1960s establishments in Japan
Billy Tipton	1914 births, 1989 deaths, Deaths from ulcers, Deaths from emphysema, American jazz musicians, American pianists, American saxophonists, LGBT musicians, LGBT people from Oklahoma, Musicians from Oklahoma, Musicians from Kansas City, Missouri, People from Oklahoma City, Oklahoma, Transgender and transsexual people
Hip replacement	Joints, Surgery
Slurry	Materials
Ken'ei	Japanese eras, 1200s establishments in Japan, 1200s disestablishments in Japan, 1206 establishments, 1207 disestablishments
Jōgen (Kamakura period)	Japanese eras, 1200s establishments in Japan, 1210s disestablishments in Japan, 1207 establishments, 1211 disestablishments
Newport Aquarium	Aquariums, Buildings and structures in Kentucky
Biwer	Communes in Luxembourg
Amyloplast	Organelles, Plant physiology
Kenryaku	Japanese eras, 13th-century establishments in Japan, 1210s disestablishments in Japan, 1211 establishments, 1210s establishments in Asia, 1213 disestablishments
Kempo (era)	Japanese eras, 1210s establishments in Asia, 1210s disestablishments in Japan, 1213 establishments, 13th-century establishments in Japan, 1219 disestablishments
Il Canzoniere	14th century books, Poetry
Arc flash	Electricity
Facesitting	Sexual acts
Jōkyū	Japanese eras, 1219, 1220, 1221, 1222, 1220s in Japan
Black magic	Divination, Occult, Magic (paranormal)
Viola Davis	Academy Award winning actors, American television actors, American movie actors, American stage actors, Satellite Award winners, 1965 births, Living people, Tony Award winning actors, Golden Globe Award winning actors, Emmy Award winning actors, Screen Actors Guild Award winners, Drama Desk Award winners
True name	Language, Names
Jōō (Kamakura period)	Japanese eras, 1222, 1223, 1224, 1220s in Japan
Leeward Caribbean Creole English	Antigua and Barbuda, Languages of the Caribbean
Diary of a Wimpy Kid (movie)	2010 comedy movies, American comedy movies, 20th Century Fox movies
List of governors-general of Antigua and Barbuda	Lists of governors-general, Governors-general of Antigua and Barbuda
Louise Lake-Tack	1944 births, Living people, Governors-general of Antigua and Barbuda
Prime Minister of Antigua and Barbuda	Lists of prime ministers, Prime Ministers of Antigua and Barbuda
Baldwin Spencer	1948 births, Living people, Prime Ministers of Antigua and Barbuda, Seventh-day Adventists
Lester Bird	1938 births, 2021 deaths, Prime Ministers of Antigua and Barbuda, Lawyers, Male athletes, Politicians from New York City, Sportspeople from New York City
Area code 268	Antigua and Barbuda, Area codes
Taurobolium	Religious terminology, Paganism
Gennin	Japanese eras, 1224, 1225, 1220s in Japan
Karoku	Japanese eras, 1225, 1226, 1227, 1220s in Japan
Antei	Japanese eras, 1227, 1228, 1229, 1220s in Japan
Gary Thomasson	1951 births, Living people, Los Angeles Dodgers players, San Francisco Giants players, New York Yankees players, Oakland Athletics players
Kangi	Japanese eras, 1229, 1230, 1231, 1232, 1220s in Japan, 1230s in Japan
Jōei	Japanese eras, 1232, 1233, 1230s in Japan
Tenpuku	Japanese eras, 1233, 1234, 1230s in Japan
Tomason	Art
Mystery fiction	Fiction genres, Mysteries
Nematode	Nematodes
Bromance	Slang, Men
Turbatrix aceti	Nematodes
Edward Stratemeyer	1862 births, 1930 deaths, 19th-century American children's writers, American children's writers, Publishers, Writers from New Jersey
Julie Delpy	1969 births, Living people, Actors from Paris, American movie actors, American movie directors, American movie producers, American screenwriters, American television actors, French movie actors, French screenwriters, French television actors, Movie directors from Paris, Movie editors, Movie producers from Paris, Naturalized citizens of the United States, Writers from Paris
Bunryaku	Japanese eras, 1234, 1235, 1230s in Japan
Katei	Japanese eras, 1235, 1236, 1237, 1238, 1230s in Japan
Ribalonga	Parishes, Portugal, 13th century establishments in Europe, Establishments in Portugal
Tokyo Skytree	Buildings and structures in Tokyo, Skyscrapers
Jean Robieux	1925 births, 2012 deaths, French physicists, Alumni of the École nationale de l'aviation civile, Alumni of the École Polytechnique
Grevenmacher	Communes in Luxembourg
Ryakunin	Japanese eras, 1238, 1239, 1230s in Japan
En'ō	Japanese eras, 1239, 1240, 1230s in Japan, 1240s in Japan
Ninji	Japanese eras, 1240, 1241, 1242, 1243, 1240s in Japan
Osweiler	Settlements in Luxembourg
Kangen	Japanese eras, 1243, 1244, 1245, 1246, 1247, 1240s in Japan
Ichneumon	Parasitoids, Wasps
Information asymmetry	Market failure
SWV	Musical groups from New York City, American R&B bands, American pop music groups, American girl groups, Musical groups established in 1990, 1990 establishments in New York (state), Musical groups disestablished in 1998, 1998 disestablishments in the United States, 1990s disestablishments in New York (state), Musical groups established in 2005, 2005 establishments in New York (state)
Simpson's paradox	Statistics
Coat of arms of Argentina	Argentina, National coats of arms
Jenny Agutter	1952 births, Living people, Actors from Somerset, BAFTA Award winning actors, British child actors, Emmy Award winning actors, English movie actors, English television actors
En unión y libertad	Argentina, Mottos
Patagonia	Geography of Argentina, Geography of Chile
Omen	Divination
Boyacá	Departments of Colombia, 1858 establishments, 1850s establishments in South America, 19th-century establishments in Colombia
Phoebe Cates	American movie actors, Actors from New York City, Models from New York City, 1963 births, Living people
Hōji	Japanese eras, 1247, 1248, 1249, 1240s in Japan
Argentine Antarctica	Antarctic territorial claims, Geography of Argentina, 1901 establishments, Establishments in Antarctica, 1900s establishments in Argentina
Chilean Antarctic Territory	Geography of Chile, Antarctic territorial claims, 1940 establishments in South America, 20th-century establishments in Chile, Establishments in Antarctica
Kenchō	Japanese eras, 1249, 1250, 1251, 1252, 1253, 1254, 1255, 1256, 1240s in Japan, 1250s in Japan
Kōgen	Japanese eras, 1256, 1257, 1250s in Japan
Shōka	Japanese eras, 1257, 1258, 1259, 1250s in Japan
Bunpō	Japanese eras, 1317 establishments, 1310s establishments in Japan, 1319 disestablishments, 1310s disestablishments in Japan
Gen'ō	Japanese eras, 1319, 1320, 1321, 1310s in Japan, 1320s in Japan
Ampullariidae	Gastropods
Lottery	Gambling
Hilbert's problems	Mathematics, Problem solving
Energy drink	Drinks
Kellie Martin	American television actors, American movie actors, American voice actors, Actors from Riverside County, California, 1975 births, Living people, People from Riverside, California
Mutunus Tutunus	Roman gods and goddesses
Lionel Guérin	Living people, Alumni of the École nationale de l'aviation civile, Aviation, French politicians, Environmentalists, French businesspeople, 1956 births
Omar Hawsawi	Saudi Arabian footballers, 1985 births, Living people
Abdulaziz Fallatah	Saudi Arabian footballers, Living people, 1985 births, People from Mecca
True Romance	1993 crime movies, 1993 drama movies, 1990s crime drama movies, 1990s road movies, American crime drama movies, American road movies, English-language movies, Movies directed by Tony Scott, Movies set in Detroit, Michigan, Movies set in Los Angeles, California
La Sylphide	Ballets
Muromachi period	Periods in Japanese history, Samurai, 1330s establishments in Japan, 1573 disestablishments, 1333 establishments, 16th century disestablishments in Japan
Jason Griffith	1980 births, Actors from New York City, American movie actors, Pokémon, American voice actors, Living people
Kim (given name)	Given names
Kim (surname)	Surnames
Samantha	Given names
Kim, Colorado	Towns in Colorado, 1974 establishments in the United States, 1970s establishments in Colorado
Andrea	Given names
Genkyō	Japanese eras, 1321, 1322, 1323, 1324, 1320s in Japan
Catamarca Province	Provinces of Argentina
Chaco Province	Provinces of Argentina
Jennifer	Given names
Corrientes Province	Provinces of Argentina
Entre Ríos Province	Provinces of Argentina
Sylvain Cloutier	1974 births, Living people, Ice hockey people from Quebec, Chicago Blackhawks players, Canadian ice hockey centres, American Hockey League players, ECHL players, International Hockey League (1945–2001) players, Ontario Hockey League players
Margaret	Given names
Genkō (era)	Japanese eras, 1330s establishments in Japan, 1330s disestablishments in Japan, 1331 establishments, 1334 disestablishments
Gentoku	Japanese eras, 1329 establishments, 14th century establishments in Japan, 1332 disestablishments, 1330s disestablishments in Japan
Substitute good	Microeconomics, Goods
Complementary good	Microeconomics
Split, Croatia	Cities in Croatia
St. Lucie County Public Schools	Schools in the United States, Buildings and structures in Florida
Mongol invasions of Japan	Wars involving Japan, Wars involving China, Mongol Empire, 13th century in Japan, 1274, 1281
Genkō yōshi	Japanese culture
Formosa Province	Provinces of Argentina
Andrew	Given names
Jujuy Province	Provinces of Argentina
La Pampa Province	Provinces of Argentina
La Rioja Province, Argentina	Provinces of Argentina
Fatal Attraction	1987 crime movies, 1987 horror movies, 1980s crime thriller movies, 1980s horror thriller movies, Adultery in movies, American crime thriller movies, American horror thriller movies, Borderline personality disorder in fiction, English-language movies, Movies about stalking, Movies directed by Adrian Lyne, Movies set in New York, Movies set in New York City, Pregnancy movies
Angela	Given names
Amol	Cities in Iran, Mazandaran Province
Shōchū (era)	Japanese eras, 1324, 1325, 1326, 1320s in Japan
Karyaku	Japanese eras, 1326 establishments, 14th century establishments in Japan, 1329 disestablishments, 14th century disestablishments in Japan
Misiones Province	Provinces of Argentina
Neuquén Province	Provinces of Argentina
Río Negro Province	Provinces of Argentina
Sauvane Delanoë	Child actors, Voice actors, French actors, 1978 births, Living people
San Juan Province, Argentina	Provinces of Argentina, Wine regions
San Luis Province	Provinces of Argentina
Santa Cruz Province, Argentina	Provinces of Argentina
Santa Fe Province	Provinces of Argentina
Santiago del Estero Province	Provinces of Argentina
Tierra del Fuego Province, Argentina	Provinces of Argentina
Aldemaro Romero	Jazz musicians, Pianists, Venezuelan entertainers, 1928 births, 2007 deaths
President of Argentina	Presidents of Argentina, Government of Argentina
List of vice presidents of Argentina	Vice Presidents of Argentina, Lists of politicians
Supreme Court of Argentina	Government of Argentina, National supreme courts, 1863 establishments, 19th-century establishments in Argentina
Julio Cobos	Vice Presidents of Argentina, 1955 births, Living people
American Hairless Terrier	Terriers
Jean-Charles Corbet	Living people, French aviators, Alumni of the École nationale de l'aviation civile, Year of birth missing (living people), French businesspeople
Kepler conjecture	Mathematics
Sphere packing	Geometry
I'm Too Sexy	1991 songs, Narcissism in fiction
Teenage Life	2006 songs
Swagger Jagger	2011 songs, Hip hop songs, Pop songs
Consistency proof	Logic
M1918 Browning Automatic Rifle	7.62 mm firearms, Battle rifles, Light machine guns, Automatic rifles, Machine guns of the United States
Río de la Plata	Rivers of Argentina, Rivers of Uruguay
Paraguay River	Rivers of Argentina, Rivers of Bolivia, Rivers of Brazil, Rivers of Paraguay
Bermejo River	Rivers of Bolivia, Rivers of Argentina
Colorado River (Argentina)	Rivers of Argentina
Templo Libertad	Synagogues, Buildings and structures in Argentina, 1932 establishments in South America, 20th-century establishments in Argentina
Beth Yaacov Synagogue	Synagogues, Buildings and structures in Madrid
Paraná River	Rivers of Argentina, Rivers of Brazil, Rivers of Paraguay
Pampas	Geography of Argentina, Geography of Brazil, Geography of Uruguay
Chuck Lorre Productions	Television production companies
Nobuyuki Abe	1875 births, 1953 deaths, Generals, Japanese military people, People from Ishikawa Prefecture, Prime Ministers of Japan
Femminiello	Gender, Italy
Bourrée	Ballroom dances
North London Collegiate School	1850 establishments in Europe, Schools in London, 1850s establishments in England
Jacques Villiers	1924 births, 2012 deaths, Alumni of the École nationale de l'aviation civile, French engineers, Aviation in France, Alumni of the École Polytechnique
Entity-relationship model	Database modeling
Andrew Wiles	Abel Prize winners, English mathematicians, 1953 births, Living people, Fellows of the Royal Society
Richard Taylor (mathematician)	British mathematicians, Living people, 1962 births, Fellows of the Royal Society
Yi Bok-nam	1555 births, 1597 deaths, Generals, Korean military people, Korean politicians
Algebraic equation	Equations
Algebraic solution	Algebra
Sylvie Faucheux	Living people, 1960 births, French politicians, French educators, Presidents of the Université de Versailles Saint-Quentin-en-Yvelines, Versailles Saint-Quentin-en-Yvelines University faculty
Derivative (finance)	Finance
The Walking Dead (comics)	The Walking Dead, 2003 books, Comic books
Mickey	1982 songs
Hollaback Girl	2004 songs, 2005 songs, Gwen Stefani songs, Hip hop songs, R&B songs
Jeff Daniels	Emmy Award winning actors, Saturn Award winners, 1955 births, Living people, Actors from Georgia (U.S. state), Actors from Michigan, American movie actors, American stage actors, American television actors, American voice actors
Joe Pesci	Academy Award winning actors, American movie actors, American television actors, BAFTA Award winning actors, Actors from Newark, New Jersey, 1943 births, Living people
Naoto Ōshima	Japanese video game designers, 1964 births, Living people, Sega people
Dennis Franz	American television actors, American movie actors, 1944 births, Living people
List of cities in New York (state)	Lists of cities by US state, Cities in New York
Rafinha	Living people, 1985 births, Brazilian footballers
Second moment of area	Engineering, Physical quantity, Geometry
Jean-Luc Vayssière	Living people, 1956 births, French educators, French biologists, French chemists, Geneticists, Presidents of the Université de Versailles Saint-Quentin-en-Yvelines, Versailles Saint-Quentin-en-Yvelines University faculty
Denying the correlative	Logical fallacies
William Smith O'Brien	1803 births, 1864 deaths, Alumni of the University of Cambridge, British Anglicans, Former members of the British House of Commons, Irish politicians, People from County Clare, Political activists, Prisoners sentenced to death
False dilemma	Logical fallacies
Countess Dracula	1971 horror movies, 1970s serial killer movies, Biographical movies, British horror movies, English-language movies, Hungarian movies, Movies about abduction, Movies about dysfunctional families, Movies set in Europe
John Mitchel	1815 births, 1875 deaths, Northern Ireland people, Activists
Phytoremediation	Conservation, Sustainable technologies
Wanderlust	2012 comedy movies, Adultery in movies, American comedy movies, English-language movies, Movies set in Georgia (U.S. state), Movies set in New York City
Indian Navy	Navies, Military of India
Jean Peyrelevade	Living people, 1939 births, Alumni of the École nationale de l'aviation civile, French businesspeople, French politicians, People from Marseille, Civil servants, Alumni of the École Polytechnique, Alumni of the Institut d'études politiques de Paris
Sukhoi Su-30MKI	Indian military aircraft
Hindustan Aeronautics Limited	Aircraft companies, Companies of India, Military of India, Bangalore
200 BC	200s BC
101 BC	100s BC
Amado Boudou	1963 births, Living people, Vice Presidents of Argentina
Russian Air Force	Military of Russia, Air forces
Ricardo Lorenzetti	1955 births, Living people, Argentine people, Argentine judges
Alessandro Manzoni	Italian writers, Italian poets, Italian playwrights, Italian Roman Catholics, 1785 births, 1873 deaths
Football in Argentina	Football in Argentina
Pato	Sport in Argentina, Equestrian sports
Argentine National Congress	Argentine National Congress
New Plymouth	Cities in New Zealand, 1841 establishments, 1840s establishments in New Zealand
Argentine Senate	Argentine National Congress, National upper houses
Argentine Chamber of Deputies	Argentine National Congress, National lower houses
Liberty X	2001 establishments in England, 2000s British music groups, 2010s British music groups, English R&B bands, English pop music groups, Musical groups established in 2001, Musical groups from London
May Revolution	1810, 19th century rebellions, Buenos Aires, 19th century in Argentina, 19th century in Spain, Revolutions
Argentine Declaration of Independence	1816, Declarations of independence, 19th century in Argentina, Politics of Argentina
Constitution of Argentina	Government of Argentina, Constitutions, 1853
Argentine peso	Currency of South America, Economy of Argentina, 1826 establishments, 19th-century establishments in Argentina, 1820s establishments in South America
Gul Mohamad Zhowandai	1905 births, 1988 deaths, Afghan writers, Poets, People from Kabul
CEGEP	Colleges and universities in Canada, 1967 establishments in North America, 1960s establishments in Canada
Zwonowice	Villages in Poland
Presenter	Entertainers
Television presenter	Television presenters
Dollar sign	Currency symbols
Time in Argentina	Time by country, Argentina
Telephone numbers in Argentina	Telephone numbers, Argentina
Municipalities of Argentina	Subdivisions of Argentina
Departments of Argentina	Subdivisions of Argentina
House of Savoy	House of Savoy
Bourbon Restoration	House of Bourbon, 19th century in France, 1814 establishments, 1830 disestablishments, 1810s establishments in Europe, 19th century establishments in France, Disestablishments in France, 19th century disestablishments in Europe
Kingdom of the Two Sicilies	19th century in Italy, 1816 establishments in Europe, 1861 disestablishments, Former monarchies in Italy, House of Bourbon, 19th century establishments in Italy, 1860s disestablishments in Italy
Black Rain	1989 action movies, 1980s crime thriller movies, American action movies, American crime thriller movies, English-language movies, Gangster movies, Japanese movies, Movies set in New York City, Movies set in Japan, Movies directed by Ridley Scott
Mer Hayrenik	Armenia, National anthems
Yazidi	Abrahamic religions, Ethnic groups in the Middle East, Kurds
Serzh Sargsyan	1954 births, Living people, Prime Ministers of Armenia, Presidents of Armenia
Prime Minister of Armenia	Lists of prime ministers, Government of Armenia, Prime Ministers of Armenia, 1918 establishments, 20th century establishments in Armenia
Tigran Sargsyan	1960 births, Living people, Prime Ministers of Armenia
National Assembly (Armenia)	National legislatures, Government of Armenia
Hovik Abrahamyan	1958 births, Prime Ministers of Armenia, Living people, Legislative speakers
Samvel Nikoyan	Armenian politicians, 1958 births, Living people, Legislative speakers
25th century BC	Centuries, 3rd millennium BC
336 BC	336 BC
331 BC	330s BC
Northern Court	14th century in Japan, 1336 establishments in Japan, 1390s disestablishments in Japan, 1392 disestablishments
201 BC	200s BC
185 BC	180s BC
77 BC	70s BC
Southern Court	14th century in Japan, 1336 establishments in Japan, 1390s disestablishments in Japan, 1392 disestablishments
120	120
69 BC	69 BC
330	330
8 BC	8 BC
336	336
428	428
422	420s
84 BC	80s BC
34 BC	30s BC
Yu Gamdong	15th century births, 15th century deaths, Autobiographers, Dancers, Korean painters, Korean poets, Korean writers, Prostitutes
Yangnyeong	Princes and princesses, Korean poets, Korean writers, Autobiographers, 1394 births, 1462 deaths
Wadō (era)	Japanese eras, 700s establishments in Japan, 710s disestablishments in Japan, 708 establishments, 715 disestablishments
ISO 639-2	ISO 639
ISO 639-3	ISO 639
Vehicle registration plate	Identification documents, Law, Road transport
Armenian dram	Currency of Europe, Armenia, Currency of Asia, 1993 establishments, 20th century establishments in Armenia
Telephone numbers in Armenia	Telephone numbers, Armenia
Aragatsotn Province	Provinces of Armenia
Ararat Province	Provinces of Armenia
Armavir Province	Provinces of Armenia
New York Public Library	Buildings and structures in New York City, Libraries in the United States, 1854 establishments in the United States, 1850s establishments in New York (state)
Reiki (era)	Japanese eras, 710s establishments in Japan, 710s disestablishments in Japan, 715 establishments, 717 disestablishments
LGBT rights in Thailand	LGBT rights by country, Thailand
LGBT rights in Myanmar	LGBT rights by country, Myanmar
Gegharkunik Province	Provinces of Armenia
Kotayk Province	Provinces of Armenia
Lori Province	Provinces of Armenia
Shirak Province	Provinces of Armenia
Syunik Province	Provinces of Armenia
Sakurai, Nara	Cities in Nara Prefecture
Boogie Nights	1997 drama movies, 1990s buddy movies, 1990s LGBT movies, American buddy movies, American drama movies, American LGBT movies, English-language movies, Golden Globe Award winning movies, LGBT drama movies, Movies about pornography, Movies about prostitution, Movies set in Los Angeles, California, Movies set in the 1970s, Movies set in the 1980s, Murder-suicide in movies, NC-17 rated movies, American independent movies, Movies directed by Paul Thomas Anderson
Tavush	Provinces of Armenia
Vayots Dzor	Provinces of Armenia
Tenri, Nara	Cities in Nara Prefecture
Postal codes in Armenia	Armenia, Postal codes
Ashtarak	Cities in Armenia
Artashat, Armenia	Cities in Armenia
Armavir, Armenia	Cities in Armenia
20th century BC	2nd millennium BC, 20th century BC
19th century BC	2nd millennium BC, 19th century BC
18th century BC	2nd millennium BC, 18th century BC
1300s BC (decade)	2nd millennium BC
1100s BC (decade)	2nd millennium BC
1550s BC	16th century BC
21st century BC	3rd millennium BC, 21st century BC
Kōryō, Nara	Cities in Japan, Settlements in Nara Prefecture
1249	1249, 1240s
321 BC	320s BC
297 BC	297 BC
358 BC	350s BC
U.S. state	States of the United States
University of Paris-Seine	Colleges and universities in France, 2012 establishments in Europe, Île-de-France, 2010s establishments in France
Common barn owl	Strigiformes
North American river otter	Mustelids, Mammals of North America
Shiki District, Nara	Districts of Japan
Gavar	Cities in Armenia
Kyōtanabe, Kyoto	Cities in Japan, Settlements in Kyoto Prefecture
Kingdom of Armenia (Antiquity)	Ancient Armenia, Ancient history of Azerbaijan, Former empires, History of Armenia, History of Georgia (country), History of Iran, History of Iraq, History of Syria, History of Turkey, 4th-century BC establishments, 5th-century disestablishments
Hrazdan	Cities in Armenia, Capital cities in Europe
Yōrō	Japanese eras, 710s establishments in Japan, 720s disestablishments in Japan, 717 establishments, 724 disestablishments
Vanadzor	Cities in Armenia
Kapan	Settlements in Armenia, Capital cities in Europe
Ijevan	Cities in Armenia
Yeghegnadzor	Settlements in Armenia, Capital cities in Europe
Jinki (era)	Japanese eras, 720s establishments in Japan, 720s disestablishments in Japan, 724 establishments, 729 disestablishments
Monarchy of Australia	Government of Australia, Current monarchies
Australian Senate	Parliament of Australia, National upper houses
Australian House of Representatives	Parliament of Australia, National lower houses
Automatic rifle	Automatic rifles
Telephone numbers in Australia	Telephone numbers, Australia
1910 in music	1910, 20th century in music
The Kingdom (Elgar)	Oratorios, Compositions by Edward Elgar
Broadheath, Worcestershire	Villages in Worcestershire, Civil parishes in England
Statute of Westminster 1931	1931, 1930s in Europe, 20th century in the United Kingdom, Commonwealth realms, Acts of the Parliament of the United Kingdom
Statute of Westminster Adoption Act 1942	1942, 1940s in Australia, Legislation
Australia Act 1986	1986, Politics of Australia, Legislation, 1980s in Australia, 1980s in the United Kingdom
Botany Bay	Geography of New South Wales, Bays of Australia, Sydney
Corroboree	Australian culture, Indigenous Australian culture
Andrew Luck	1989 births, Living people, Sportspeople from Washington, D.C., American football quarterbacks, Indianapolis Colts players
Robert Griffin III	1990 births, Living people, African American players of American football, American football quarterbacks, Sportspeople from Texas, Washington Redskins players, Heisman Trophy winners
Blue Mountains (New South Wales)	Mountain ranges of Australia, Geography of New South Wales
Gregory Blaxland	1778 births, 1853 deaths, Australian explorers, People from Kent
Watchdog timer	Clocks, Electronic components, Electronic circuits
William Lawson (explorer)	1774 births, 1850 deaths, Australian explorers, People from London, People from Middlesex
William Wentworth	1790 births, 1872 deaths, Australian explorers, Australian poets, Politicians from Sydney, Australian journalists, Writers from Sydney
Battleship	Warships
Ray Guy	1949 births, American football punters, Living people, Oakland Raiders players, Sportspeople from Georgia (U.S. state)
Punt	American football, Canadian football, Rugby, Sports words
Drop kick	American football, Canadian football, Rugby, Sports words
Single (baseball)	Baseball, Sports words
Fair ball	Baseball rules, Sports words
Error (baseball)	Baseball statistics
Official scorer	Baseball, Sports occupations
Les Ballets Trockadero de Monte Carlo	Ballet companies
New South Wales Legislative Council	Government of Australia, New South Wales, Legislatures of country subdivisions
Busby Berkeley	1895 births, 1976 deaths, American movie directors, People from Los Angeles, California, American choreographers
Parliament of South Australia	Parliaments, Legislatures of country subdivisions, Government of Australia, South Australia
ANZAC Day	Military of Australia, New Zealand, World War I, Holidays
Tom Roberts	1856 births, 1931 deaths, Australian painters, Cancer deaths in Victoria (Australia), English painters, People from Dorset, People from Melbourne
Snowy Mountains Scheme	Australia, Hydropower
Australian cinema	Australian movies, Australian culture
Holly Hunter	Academy Award winning actors, Actors from Georgia (U.S. state), American movie actors, American television actors, American television producers, American voice actors, BAFTA Award winning actors, Emmy Award winning actors, Golden Globe Award winning actors, 1958 births, Living people
Music of Australia	Australian music
Australian literature	Australian culture, Literature by nationality
483	480s
874	870s
501	500s
515	510s
497	490s
549	540s
623	623
548	540s
547	547
875	870s
1004	1004
1060	1060
1055	1055
870	870
1011	1011
Maggie Grace	American television actors, American movie actors, Actors from Ohio, 1983 births, Living people
Jōgen (Heian period)	Japanese eras
Tengen (era)	Japanese eras
Eikan	Japanese eras
Kanna (era)	Japanese eras
Serge Ibaka	1989 births, African people, Living people, Oklahoma City Thunder players, Orlando Magic players, Toronto Raptors players
Peja Stojaković	1977 births, Croatian sportspeople, Dallas Mavericks players, Indiana Pacers players, Living people, New Orleans Hornets players, Sacramento Kings players, Toronto Raptors players, National Basketball Association players with retired numbers
Eien	Japanese eras
Vanna White	American game show hosts, American movie actors, American television actors, actors from South Carolina, Living people, 1957 births, People from Myrtle Beach, South Carolina
Eiso	Japanese eras
Colleen McCullough	1937 births, 2015 deaths, Australian novelists, Deaths from renal failure, Disease-related deaths in Australia, Order of Australia, University of Sydney alumni, Writers from New South Wales
Shōryaku	Japanese eras
Patrick White	1912 births, 1990 deaths, Australian LGBT people, Australian Nobel Prize winners, Australian novelists, Australian playwrights, Autobiographers, LGBT Nobel Prize winners, LGBT writers, Writers from New South Wales
Slim Dusty	1927 births, 2003 deaths, Australian country musicians, Australian guitarists, Australian singer-songwriters, Members of the Order of the British Empire, Musicians from New South Wales, Order of Australia, Record producers
Chōtoku	Japanese eras
Indigenous Australian music	Indigenous Australian music
Skippy the Bush Kangaroo	Australian television series, 1966 television series debuts, 1970 disestablishments, 1960s television series, 1970s television series, English-language television programs
Tenpyō	Japanese eras, 720s establishments in Japan, 8th century disestablishments in Japan, 748 disestablishments, 729 establishments
Groupement des écoles d'aéronautique	Aerospace engineering, Aviation in France, French Civil Aviation University, Engineering schools
In the Wake of the Bounty	1933 movies, Australian movies, Movies based on books, Historical movies, Mutiny on the Bounty
Kokoda Front Line!	Academy Award winning movies, 1942 movies, Australian movies, Documentary movies
Ken G. Hall	People from Sydney, Members of the Order of the British Empire, 1901 births, 1994 deaths, Order of Australia, Australian movie directors, Australian movie producers
Picnic at Hanging Rock	1975 drama movies, 1975 mystery movies, Australian drama movies, English-language movies, Movies based on books, Movies set in the 1900s, Movies set in Australia, Victoria, Australia, Movies directed by Peter Weir
Gallipoli (1981 movie)	Australian movies, 1981 movies, 1980s war movies, Movies directed by Peter Weir
The Man from Snowy River (1982 movie)	1982 drama movies, Australian movies, 1980s western movies, 20th Century Fox movies, Movies about animals, Movies set in Australia
Light therapy	Medicine
Crocodile Dundee	1986 comedy movies, 1986 romance movies, 1980s adventure movies, 1980s romantic comedy movies, 20th Century Fox movies, American romantic comedy movies, Australian comedy movies, Australian romance movies, English-language movies, Movies set in New York City, Movies set in Australia, Movies set in deserts, Paramount movies, American independent movies
Australia (2008 movie)	2008 drama movies, 2008 romance movies, 2000s romantic drama movies, 2000s war movies, 20th Century Fox movies, Australian drama movies, Australian romance movies, English-language movies, Epic movies, Historical movies, Movies set in the 1930s, Movies set in the 1940s, World War II movies, Movies set in Australia, Movies set in deserts, 2008 movies
ANZ Championship	Sport in Australia, Sport in New Zealand, Sports leagues, Organisations based in Australia, 2008 establishments
W-League	Soccer in the United States, Soccer in Canada, Football leagues
W-League (Australia)	Football in Australia, Football leagues, 2008 establishments in Australia, Organisations based in Australia
Women's National Basketball League	Basketball leagues, Sport in Australia
Guar	Faboideae
Tone deafness	Human communication
Institut aéronautique et spatial	Aviation in France, Education in France, Aerospace engineering, 1980 establishments in France, Toulouse
Okhotigone	Spiders
Ménage à trois	Human sexuality
Elena Ionescu	1988 births, Romanian singers, Living people
Hypermobility	Joints
Tenpyō-kanpō	Japanese eras, 749, 8th century establishments in Japan, 8th century disestablishments in Japan, 749 disestablishments, 749 establishments, 8th century in Japan
Tenpyō-shōhō	Japanese eras, 8th century establishments in Japan, 8th century disestablishments in Japan, 757 disestablishments
John Cale	1942 births, Living people, British bass guitarists, British pianists, British record producers, British rock guitarists, Officers of the Order of the British Empire, Violists, Welsh rock musicians, Welsh singers
Centro Federal de Educação Tecnológica Celso Suckow da Fonseca	Colleges and universities in Brazil, Rio de Janeiro, 1909 establishments in Brazil
Asturias Airport	Airports in Spain, Asturias
Charisma	Human skills, Sociology
Christine	Given names
Bayville, New York	Villages in New York
Brenda	Given names
Tenpyō-hōji	Japanese eras, 8th century establishments in Japan, 8th century disestablishments in Japan, 765 disestablishments, 757 establishments
Tyrol (state)	Tyrol (state)
Styria	Styria
Coat of arms of Austria	Government of Austria, National coats of arms
Land der Berge, Land am Strome	Austria, National anthems
Jello Biafra	Living people, 1958 births, Actors from Colorado, American anarchists, American atheists, Musicians from Colorado, Musicians from San Francisco, People from Boulder, Colorado, Greens politicians, Actors from San Francisco, Punk musicians
Rudolph Nureyev	1938 births, 1993 deaths, Ballet dancers, Deaths from AIDS, Gay men, Infectious disease deaths in France, LGBT choreographers, LGBT dancers, Russian LGBT people, Soviet people
Invented tradition	Traditions
Burgenland Croatian	Languages of Europe, Slavic languages, Burgenland
Spoken language	Language
Nancy Allen	1950 births, Living people, American movie actors, American television actors, Actors from New York, People from Yonkers, New York
Josef Korbel	1909 births, 1977 deaths, Czech Jews, Czechoslovak people, Diplomats, Jewish American academics, Naturalized citizens of the United States
Heather O'Rourke	1975 births, 1988 deaths, Deaths from cardiac arrest, Deaths from sepsis, Actors from San Diego, California, American child actors, American movie actors, American television actors, Disease-related deaths in San Diego County
Brenda Russell	American R&B singers, American pop musicians, Singers from New York City, 1949 births, Living people
Mastère en sciences	Education in France, Qualifications
Falstaff (opera)	Operas, Compositions by Giuseppe Verdi
François Hollande	1954 births, Living people, Alumni of the Institut d'études politiques de Paris, French lawyers, French mayors, People from Rouen, Presidents of France, Social democrats, Socialist Party (France) politicians
Bilan d'aptitude délivré par les grandes écoles	Education in France, Qualifications, 2001 establishments in Europe, 2000s establishments in France
Andromeda XIX	Local galaxies, Dwarf galaxies
Brussels Airlines	2006 establishments in Europe, Airlines of Europe, Star Alliance, Companies of Belgium, Transport in Belgium, Brussels, IATA members
Castel Goffredo	Cities in Lombardy
Polandball	Internet memes
Yugoslavs	Slavic peoples, Yugoslavian people
Rhetorical question	Rhetoric
Tenpyō-jingo	Japanese eras, 765 establishments, 760s establishments in Japan, 8th century disestablishments in Japan, 767 disestablishments
Engi (era)	Japanese eras, 901 establishments, 10th century establishments in Japan, 923 disestablishments, 10th century disestablishments in Japan
President of Austria	Government of Austria, Presidents of Austria
Chancellor of Austria	Chancellors of Austria, Government of Austria
List of presidents of the National Council of Austria	Austrian politicians, Government of Austria, Lists of legislative speakers, Austria-related lists
Jeffrey Masson	1941 births, Living people, American psychologists, American historians, American writers
Barbara Prammer	1954 births, 2014 deaths, Cancer deaths in Austria, Deaths from pancreatic cancer, Government ministers of Austria, People from Upper Austria, Social democrats
First Austrian Republic	1919 establishments in Europe, 1934 disestablishments in Europe, 20th century in Austria, Former republics
Euro sign	Currency symbols
Telephone numbers in Austria	Telephone numbers, Austria
Austrian Sign Language	Sign languages, Austrian culture
Second Viennese School	Austrian composers, 20th century in Austria
Korean Peninsula	Peninsulas, Geography of Korea
Oskar Kokoschka	1886 births, 1980 deaths, Austrian painters, British painters, Austrian poets, Austrian playwrights, British poets, British playwrights
Inge Morath	Austrian artists, Cancer deaths in New York City, People from Graz, Photographers, European translators, 1923 births, 2002 deaths
Jean-Louis Vaudoyer	1883 births, 1963 deaths, French novelists, French poets, French essayists, French historians, Librettists, Members of the Académie française
Léon Bakst	1866 births, 1924 deaths, Russian artists, Russian painters
Ballet shoe	Footwear, Ballet
Cannibalism in animals	Carnivores, Cannibalism
Curtsey	Dance, Non-verbal communication
Isaac Butt	Irish politicians, 1813 births, 1879 deaths
Adam Yauch	1964 births, 2012 deaths, American rap musicians, Deaths from salivary gland cancer, Cancer deaths in New York City, Musicians from Brooklyn
Zoosemiotics	Semiotics
Juri Lotman	1922 births, Semioticians, 1993 deaths
Świętochłowice	Cities in Poland
Schnitzel	German food, Austrian food, Meat dishes
Kaiserschmarrn	Austrian food, Desserts, Baked foods
Knödel	German food, Austrian food, Hungarian culture, Czech culture
Tafelspitz	Austrian food, Meat dishes
Schönbrunn Palace	Palaces, World Heritage Sites in Austria, Museums in Europe, Buildings and structures in Austria, Former royal residences
Hoher Dachstein	World Heritage Sites in Austria, Alps, Mountains of Austria, Styria, Upper Austria
Salzkammergut	World Heritage Sites in Austria, Regions of Austria, Salzburgerland, Styria, Upper Austria
Semmering railway	World Heritage Sites in Austria, Transport in Austria, Rail transport in Europe
Eggenberg Castle, Graz	Museums in Europe, Castles, World Heritage Sites in Austria, Buildings and structures in Austria, Graz, 1630s establishments in Europe
David Cronenberg	1943 births, Living people, Actors from Toronto, Canadian Jews, Canadian movie actors, Canadian movie directors, Canadian movie producers, Canadian screenwriters, Canadian television actors, Canadian television directors, Cinematographers, Jewish actors, Jewish businesspeople, Movie editors
Yoko Shimomura	1967 births, Living people, Japanese composers, Japanese musicians, Video game composers, Women composers, People from Hyōgo Prefecture
Wachau	Valleys, World Heritage Sites in Austria, Regions of Austria, Lower Austria
Lake Neusiedl	Biosphere reserves, World Heritage Sites in Austria, Lakes of Europe, Lakes of Austria, Geography of Hungary, Burgenland
Eurobeat	Eurobeat
Maureen Stapleton	People from Troy, New York, Academy Award winning actors, Golden Globe Award winning actors, Emmy Award winning actors, Tony Award winning actors, BAFTA Award winning actors, 1925 births, 2006 deaths, Deaths from COPD, American television actors, American movie actors, American stage actors
Tango & Cash	1989 comedy movies, 1989 action movies, 1980s criminal comedy movies, American action movies, American criminal comedy movies, Buddy cop movies, English-language movies, Movies about drugs, Movies set in Los Angeles, California, Warner Bros. movies, Movies directed by Andrei Konchalovsky
March of Azerbaijan	Azerbaijan, National anthems, National symbols of Azerbaijan
Access network	Networks, Electronics
Azerbaijani people	Azerbaijani people
Constitutional republic	Forms of government
Artur Rasizade	1935 births, Prime Ministers of Azerbaijan, Living people
Caucasian Albania	Caucasus, Former countries in Europe, History of Azerbaijan, Ancient history of Azerbaijan, 4th-century BC establishments, 8th-century disestablishments
Enchō	Japanese eras, 923 establishments, 10th century establishments in Japan, 931 disestablishments, 930s disestablishments in Asia, 10th century disestablishments in Japan
1223	1223
Singapore Standard Time	Time by country, Singapore
The Vagina Monologues	Plays, Women
Amur leopard	Panthera, Critically endangered species
Der Freischütz	Operas, Compositions by Carl Maria von Weber
Jeremy Renner	1971 births, Living people, American stage actors, American movie actors, American television actors, Actors from Stanislaus County, California
Elles Bougent	Transport in France, 2005 establishments in France
The Avengers (movie)	2012 science fiction movies, 2010s action movies, Movies based on comic book characters, American action movies, American science fiction movies, Avengers movies, Disney movies, English-language movies, Marvel Cinematic Universe movies, Movies directed by Joss Whedon, Screenplays by Joss Whedon, American superhero movies, 2010s superhero movies
Jōhei	Japanese eras, 931 establishments, 10th century establishments in Japan, 938 disestablishments, 10th century disestablishments in Japan, 930s disestablishments in Asia
Geraldine Page	1924 births, 1987 deaths, Deaths from myocardial infarction, American stage actors, American movie actors, DePaul University alumni, Actors from Missouri, Academy Award winning actors, Golden Globe Award winning actors, Emmy Award winning actors
Joanne	Given names
Gethsemane	Bible, Buildings and structures in Jerusalem, Religion in Israel
Eldiguzids (Atabegs of Azerbaijan)	Medieval Azerbaijan, History of Iran, Azerbaijani dynasties, Royal dynasties, Azerbaijani states
Serafin R. Cuevas	Filipino politicians, Deaths from liver cancer, 1928 births, 2014 deaths
Constitution of Azerbaijan	Constitutions, Politics of Azerbaijan
Azerbaijani manat	Economy of Azerbaijan, Currency of Asia, Currency of Europe
Azerbaijan Time	Azerbaijan, Time by country
Left- and right-hand traffic	Road transport, Traffic
Répertoire national des certifications professionnelles	Education in France, 2002 establishments in France
Agnieszka Radwańska	1989 births, Living people, Female tennis players, People from Kraków, Polish sportspeople
Telephone numbers in Azerbaijan	Telephone numbers, Azerbaijan
United Nations Human Rights Council	United Nations, Human rights, 2006 establishments
Georgian people	Ethnic groups in Europe, Georgia (country), Georgian people
Atropates	Ancient history of Azerbaijan, History of Azerbaijan, History of Iran, Achaemenid Empire, 370s BC births, 4th century BC deaths, Kings and queens
370 BC	370s BC
285 BC	280s BC
350 BC	350s BC
275 BC	270s BC
203 BC	200s BC
220 BC	220 BC
230 BC	230s BC
310 BC	310s BC
380 BC	380s BC
The Avengers (TV programme)	British television series, 1961 establishments in Europe, 1969 disestablishments in the United Kingdom, 1969 television series endings, 1960s establishments in the United Kingdom, English-language television programs
Fernando Grostein Andrade	1981 births, Living people, Brazilian movie directors, Brazilian screenwriters, Brazilian movie producers
Falling Down	1993 crime movies, 1993 drama movies, 1990s crime drama movies, 1990s crime thriller movies, 1990s drama thriller movies, 1990s satirical movies, American crime drama movies, American crime thriller movies, American drama thriller movies, American satirical movies, Borderline personality disorder in fiction, English-language movies, Midlife crisis movies, Movies about dysfunctional families, Movies set in Los Angeles, California, Warner Bros. movies, Movies directed by Joel Schumacher
Karabakh horse	Horse breeds, Azerbaijan, Armenia
Alim Qasimov	1957 births, Living people, Azerbaijani musicians, Singers
Folk dance	Folklore, Dance types
Celebrations	Candy
Chokha	Clothing, Georgia (country), Caucasus
Eastern world	Country classifications, Political geography, Cultural geography
Maiden Tower (Baku)	Towers in Asia, Buildings and structures in Baku, 12th-century establishments, Azerbaijani culture, World Heritage Sites in Azerbaijan, Museums in Baku
Palace of the Shirvanshahs	Palaces, Buildings and structures in Baku, 15th century, Azerbaijani culture, World Heritage Sites in Azerbaijan, Museums in Baku
Hand (unit)	Horses, Units of length, Imperial units
Diwan (poetry)	Poetry, Persian literature
Ghazal	Poetry forms
Jahan Shah	1467 deaths, Azerbaijani people, Kings and queens, Year of birth unknown
Book of Dede Korkut	Mythology, History books, Poems
Abbas II of Persia	1632 births, 1666 deaths, Shahs of Iran
2012 FIFA U-17 Women's World Cup	FIFA U-17 Women's World Cup, 2012 in association football, 21st century in Azerbaijan, Football in Azerbaijan
Azerbaijan national futsal team	National sports teams of Azerbaijan, Sport in Azerbaijan, Futsal
2010 UEFA Futsal Championship	2010 in sports, Futsal, Sport in Hungary, Budapest, 21st century in Hungary, 2010 in Europe
DreamWorks Animation	1994 establishments in California, American animation studios, Companies based in San Francisco, Companies listed on NASDAQ, Companies listed on the New York Stock Exchange, Glendale, California, Universal Pictures
Bagan	Cities in Myanmar, 9th century establishments in Asia, Buddhist buildings
User guide	Genres, Technology
Cyril Bourlon de Rouvre	1945 births, Living people, Alumni of the Institut polytechnique des sciences avancées, Formula One people, French businesspeople, French engineers, French mayors, French politicians
Secret	Basic English 850 words
RNA polymerase	RNA, Enzymes, Molecular biology
Weronika Książkiewicz	Entertainers from Moscow, Polish movie actors, Polish television actors, 1981 births, Living people
Gameloft	Video game companies, 1999 establishments in France
Adolfo Suárez Madrid–Barajas Airport	Airports in Spain, Buildings and structures in Madrid, Adolfo Suárez, 1931 establishments in Europe, 1930s establishments in Spain
Jeff Bridges	1949 births, Living people, People with cancer, Academy Award winning actors, Actors from Los Angeles, California, American child actors, American country musicians, American movie actors, American movie producers, American television actors, American voice actors, BAFTA Award winning actors, Screen Actors Guild Award winners, Golden Globe Award winning actors, Singers from Los Angeles, California
Don't Say a Word	2001 crime movies, 2001 thriller movies, 2000s crime thriller movies, 2000s psychological movies, American crime thriller movies, American psychological movies, English-language movies, Kidnapping in fiction, Mental disorders in fiction, Movies based on books, Movies set in New York
Unterhaltungssoftware Selbstkontrolle	1994 establishments in Germany, Censorship, Video game ratings, Cultural organizations, Entertainment in Germany
Tengyō	Japanese eras, 938 establishments, 10th century establishments in Japan, 947 disestablishments, 10th century disestablishments in Japan
Not Going Out	2006 British television series debuts, 2000s British sitcoms, 2000s romance television series, 2010s British sitcoms, 2010s romance television series, 2020s sitcoms, BBC television sitcoms, English-language television programs, Romantic comedy television series, Television series about dysfunctional families, Television series about friendship, Television series about marriage, Television series about siblings, Television series about suburbia, Television series set in London
Jeremy Irons	1948 births, Living people, Annie Award winners, Best Actor Academy Award winners, Emmy Award winning actors, English movie actors, English stage actors, English television actors, English voice actors, Golden Globe Award winning actors, People from the Isle of Wight, Screen Actors Guild Award winners, Tony Award winning actors
Ashik	Musical groups, Folk music, Masterpieces of the Oral and Intangible Heritage of Humanity
Akinchi	Newspapers published in Azerbaijan, Azerbaijani-language newspapers, 1875 establishments, 1877 disestablishments
Raion	Political subdivisions
Autonomous republic	Political subdivisions, Autonomous areas
Nakhchivan Autonomous Republic	Caucasus, Autonomous areas, Economic regions of Azerbaijan
Khachmaz (city)	Cities in Azerbaijan
Spitting spider	Spiders
Tilda Swinton	1960 births, Living people, Academy Award winning actors, Actors from London, English movie actors, English television actors, English voice actors
Amedeo Avogadro	Italian scientists, 1776 births, 1856 deaths, People from Turin, Italian physicians
Martin Chalfie	Nobel Prize in Chemistry winners, 1947 births, Living people, American biochemists
Takashi Kasahara (footballer, born 1988)	1988 births, Living people, Footballers from Saitama Prefecture
Absheron Rayon	Districts of Azerbaijan
Rayon	Chemical compounds
Khizi Rayon	Districts of Azerbaijan
Patsy Kensit	Actors from London, British child actors, Celebrity Big Brother contestants, English movie actors, English pop singers, English Roman Catholics, English singers, English television actors, People from Hounslow (London borough), Singers from London, Strictly Come Dancing participants, 1968 births, Living people
Lethal Weapon	1987 action movies, 1980s buddy movies, 1980s crime thriller movies, American action movies, American crime thriller movies, Buddy cop movies, English-language movies, Movies about drugs, Movies about prostitution, Movies set in Los Angeles, California, Screenplays by Shane Black, Warner Bros. movies
Macedonian phalanx	Military terminology, Ancient Greece
List of settlements in Florida	Cities in Florida, Lists of settlements in the United States, Florida-related lists
List of cities in Idaho	Cities in Idaho, Idaho-related lists, Lists of cities by US state
List of cities in Arkansas	Cities in Arkansas, Arkansas-related lists, Lists of cities by US state
List of towns in Virginia	Towns in Virginia, Lists about U.S. states, Lists of settlements in the United States
Confectionery	Desserts
Sustainable seafood	Fishing, Sustainable development
Pacifica, California	Cities in California, Cities in the San Francisco Bay Area, Settlements in San Mateo County, California
Howlin' Wolf	1910 births, American blues singers, Singers from Mississippi, 1976 deaths
Hercule Poirot	Characters in written fiction, Television characters, Movie characters, Crime fiction
Oligochaete	Annelids
Bush Doctor	1978 albums, Reggae albums
Ikariam	2008 video games, Real-time strategy video games, Online games
Reactivity series	Chemistry
Vidal Sassoon	British Jews, Cancer deaths in the United States, Deaths from leukemia, People from London, 1928 births, 2012 deaths
Amanda Redman	Actors from Sussex, English movie actors, English television actors, Entertainers from Brighton, 1957 births, Living people
Special forces	Military
Sumqayit	Cities in Azerbaijan, 1949 establishments in Asia, 20th century establishments in Azerbaijan
Aghjabadi Rayon	Districts of Azerbaijan
Administrative divisions of Azerbaijan	Subdivisions of Azerbaijan
Agdash Rayon	Districts of Azerbaijan
Barda Rayon	Districts of Azerbaijan
Beylagan Rayon	Districts of Azerbaijan
Bilasuvar Rayon	Districts of Azerbaijan
Goychay Rayon	Districts of Azerbaijan
Hajigabul Rayon	Districts of Azerbaijan
Imishli Rayon	Districts of Azerbaijan
Kurdamir Rayon	Districts of Azerbaijan
Mingachevir	Cities in Azerbaijan
Neftchala Rayon	Districts of Azerbaijan
Saatly Rayon	Districts of Azerbaijan
Sabirabad Rayon	Districts of Azerbaijan
Salyan Rayon	Districts of Azerbaijan
Shirvan (city)	Cities in Azerbaijan, Districts of Azerbaijan
Ujar Rayon	Districts of Azerbaijan
Yevlakh Rayon	Districts of Azerbaijan
Jecheon AIDS scandal	2003 crimes, 21st century in South Korea, HIV/AIDS, 2003 in Asia
Raven paradox	Logical paradoxes
Margin of error	Statistics
Overfishing	Environmental issues, Ecology, Fishing
School holiday	Holidays, Education
Yevlakh	Cities in Azerbaijan
Zardab Rayon	Districts of Azerbaijan
Agsu Rayon	Districts of Azerbaijan
Gobustan Rayon	Districts of Azerbaijan
Ismayilli District	Districts of Azerbaijan
Shamakhi Rayon	Districts of Azerbaijan
Agstafa Rayon	Districts of Azerbaijan
Dashkasan Rayon	Districts of Azerbaijan
The Big C	2010 American television series debuts, 2013 American television series endings, 2010s American television series, American comedy-drama television series, Bipolar disorder in fiction, Cancer in fiction, Fiction about suburbia, Minneapolis, Minnesota, Minnesota in fiction, English-language television programs
We Came as Romans	2000s American music groups, 2010s American music groups, American heavy metal bands, Post-hardcore bands, Metalcore bands, Musical groups from Michigan
Sleeping with Sirens	2000s American music groups, 2010s American music groups, American heavy metal bands, Post-hardcore bands, Musical groups from Orlando, Florida
Tenryaku	Japanese eras, 947 establishments, 10th century establishments in Japan, 957 disestablishments, 10th century disestablishments in Japan
Alexisonfire	2000s music groups, 2010s music groups, Canadian punk bands, Post-hardcore bands, Hardcore punk, Musical groups established in 2001, 2001 establishments in Canada, Musical groups disestablished in 2011, 2011 disestablishments in Canada
Dying Fetus	American heavy metal bands, Death metal bands, Hardcore punk, Musical groups from Maryland, Musical groups established in 1991, 1991 establishments in the United States, 1990s establishments in Maryland
Tentoku	Japanese eras, 10th century establishments in Japan, 960s disestablishments in Japan, 957 establishments, 961 disestablishments
Gary Kildall	1942 births, 1994 deaths, American computer scientists, Chief executives, Scientists from Seattle, Washington, Businesspeople from Seattle, Washington
Gadabay Rayon	Districts of Azerbaijan
Ganja, Azerbaijan	Cities in Azerbaijan, 5th-century establishments, Establishments in Azerbaijan
Qazakh Rayon	Districts of Azerbaijan
Goygol Rayon	Districts of Azerbaijan
Goranboy Rayon	Districts of Azerbaijan
Carnivoramorpha	Carnivora
Saint-Quentin-en-Yvelines	Communes in Yvelines
Vélizy-Villacoublay	Communes in Yvelines
Rambouillet	Communes in Yvelines, Subprefectures in France
Le Chesnay	Former communes in France, Communes in Yvelines
Mantes-la-Jolie	Communes in Yvelines, Subprefectures in France
Mantes-la-Ville	Communes in Yvelines
Gulf of Tonkin resolution	1964 in the United States, Vietnam War, August events
Carnassial	Teeth, Mammals
Brian De Palma	Actors from New Hampshire, Actors from New Jersey, Actors from Philadelphia, Pennsylvania, American movie actors, American movie editors, American television actors, Movie directors from New Jersey, Movie directors from Pennsylvania, Movie producers from New Jersey, Movie producers from Pennsylvania, Writers from Newark, New Jersey, Screenwriters from New Jersey, Screenwriters from Pennsylvania, Writers from New Hampshire, Writers from Philadelphia, Pennsylvania, 1940 births, Living people
Great Fire of Meireki	Fires in Asia, History of Tokyo, 1657, 1650s in Japan
Poltergeist (1982 movie)	1982 horror movies, 1980s ghost movies, American ghost movies, Supernatural horror movies, BAFTA Award winning movies, English-language movies, Haunted house movies, Movies about suburbia, Movies composed by Jerry Goldsmith, Movies set in California, Orange County, California
Jackie Mason	1931 births, 2021 deaths, Actors from New York City, Actors from Wisconsin, American movie actors, Screenwriters from New York City, American stand-up comedians, American television actors, American voice actors, Comedians from New York City, Emmy Award winning actors, Movie producers from New York, Jewish American actors, Jewish American writers, Jewish American comedians, Tony Award winning actors, Writers from Wisconsin, Republicans (United States)
Certificat de formation à la sécurité	Aviation in France, Education in France, Aviation licenses and certifications, Academic degrees
Naftalan	Cities in Azerbaijan, 12th-century establishments, Establishments in Azerbaijan
Samukh Rayon	Districts of Azerbaijan
Shamkir Rayon	Districts of Azerbaijan
Tovuz Rayon	Districts of Azerbaijan
Quba District	Districts of Azerbaijan
Qusar Rayon	Districts of Azerbaijan
Khachmaz Rayon	Districts of Azerbaijan
Shabran Rayon	Districts of Azerbaijan
Siazan Rayon	Districts of Azerbaijan
Qubadli District	Districts of Azerbaijan
Kalbajar District	Districts of Azerbaijan
Lachin District	Districts of Azerbaijan
Zangilan Rayon	Districts of Azerbaijan
Hawaiian–Emperor seamount chain	Seamounts, Geography of Hawaii, Pacific Ocean
Braes of Doune Wind Farm	Wind farms, Buildings and structures in Scotland, 2007 establishments in the United Kingdom, 2000s establishments in Scotland
Notre-Dame-d'Auteuil	Churches in France, Normandy
Church of Saint-Céneri-le-Gerei	Churches in France, Normandy, Roman Catholic churches
Ōwa	Japanese eras, 960s establishments in Japan, 960s disestablishments in Japan, 961 establishments, 964 disestablishments
Chambois	Communes in Orne
Kōhō	Japanese eras, 960s establishments in Japan, 960s disestablishments in Japan, 964 establishments, 968 disestablishments
Anna (era)	Japanese eras, 960s establishments in Japan, 10th century disestablishments in Japan, 968 establishments, 970 disestablishments
Keith Ferguson	1972 births, Living people, American movie actors, American television actors, Comedians from Los Angeles, California, American voice actors, Actors from Los Angeles, California
Tenroku	Japanese eras, 10th century establishments in Japan, 10th century disestablishments in Japan, 970 establishments, 973 disestablishments
Ten'en	Japanese eras
Julie Walters	1950 births, Living people, BAFTA Award winning actors, English movie actors, English stage actors, English television actors, English voice actors, Cancer survivors, Golden Globe Award winning actors, People from Staffordshire
Villers-en-Ouche	Former communes in Orne
José Luís Peixoto	Portuguese writers, 1974 births, Living people, Novelists
Astara Rayon	Districts of Azerbaijan
Jalilabad Rayon	Districts of Azerbaijan
Lankaran Rayon	Districts of Azerbaijan
Lankaran	Cities in Azerbaijan
Saint-Cénéri-le-Gérei	Communes in Orne
Lerik Rayon	Districts of Azerbaijan
Masally Rayon	Districts of Azerbaijan
Yardymli Rayon	Districts of Azerbaijan
Babek District	Districts of Azerbaijan
Julfa District	Districts of Azerbaijan
Kangarli District	Districts of Azerbaijan
Nakhchivan (city)	Cities in Azerbaijan
Ordubad District	Districts of Azerbaijan
Sadarak District	Districts of Azerbaijan
Super glue	Materials, Chemical compounds
Shakhbuz District	Districts of Azerbaijan
Sharur District	Districts of Azerbaijan
Balakan District	Districts of Azerbaijan
Qabala Rayon	Districts of Azerbaijan
Qakh District	Districts of Azerbaijan
Oghuz Rayon	Districts of Azerbaijan
Shaki District	Districts of Azerbaijan
Shaki, Azerbaijan	Cities in Azerbaijan
Mónica Spear	1984 births, 2014 deaths, Beauty pageant winners, Murders by firearm, Television actors, Venezuelan models
Zagatala District	Districts of Azerbaijan
Agdam Rayon	Districts of Azerbaijan
Fizuli Rayon	Districts of Azerbaijan
Jabrayil Rayon	Districts of Azerbaijan
Khojaly District	Districts of Azerbaijan
Khojavend District	Districts of Azerbaijan
Shusha Rayon	Districts of Azerbaijan
Tartar Rayon	Districts of Azerbaijan
Gary Weis	American movie directors, American television directors, Living people, Year of birth missing (living people)
Gary Weiss (baseball)	1955 births, Living people, Los Angeles Dodgers players, Major League Baseball shortstops, Sportspeople from Texas
Karmin	Musical groups from Massachusetts, American pop music groups, American R&B bands, Musical groups established in 2010, 2010 establishments in the United States, 21st-century establishments in Massachusetts, American Internet celebrities
Felsic	Igneous rocks, Minerals
Paparazzi Project	Aviation, Aircraft, Aerospace engineering
Meagan Good	1981 births, Living people, American television actors, American movie actors
Nia Long	1970 births, Living people, American television actors, American movie actors, Actors from New York City, Actors from Iowa City, Iowa
Viviparity	Developmental biology, Biological reproduction
Taihō (era)	Japanese eras, 701 establishments, 700s establishments in Japan, 704 disestablishments, 8th century disestablishments in Japan
Jennifer Jones	1919 births, 2009 deaths, Academy Award winning actors, Actors from Oklahoma, American movie actors, Golden Globe Award winning actors
Flag of the Bahamas	National flags, The Bahamas
Keiun	Japanese eras, 700s establishments in Japan, 8th century disestablishments in Japan, 708 disestablishments, 704 establishments
Rebecca De Mornay	1959 births, Living people, Actors from California, American movie actors, American television actors
Coat of arms of the Bahamas	The Bahamas, National coats of arms
March On, Bahamaland	National anthems, the Bahamas
Afro-Bahamian	The Bahamas, Ethnic groups in The Bahamas, Ethnic groups in North America, African people
Gail O'Grady	1963 births, Living people, American television actors, Actors from Detroit, Michigan
White Bahamian	The Bahamas, Ethnic groups in The Bahamas, Ethnic groups in North America
Monarchy of the Bahamas	Politics of the Bahamas, Current monarchies
Governor-General of The Bahamas	Governors-General of the Bahamas, Lists of governors-general
Feminization of poverty	Women, Poverty
Holes (movie)	2003 comedy-drama movies, 2000s adventure movies, 2000s prison movies, American adventure movies, American comedy-drama movies, American mystery movies, American prison movies, Movies based on books, Movies set in the 1890s, Movies set in the 1900s, Movies set in the 1990s, Multilingual movies, Prison comedy movies, Prison drama movies, Movies set in deserts, Movies directed by Andrew Davis
Nanboku-chō period	Periods in Japanese history, 1330s establishments in Japan, 1390s disestablishments in Japan, 1392 disestablishments
Nefertem	Egyptian gods and goddesses
Arthur Foulkes	1928 births, Governors-General of the Bahamas, Knights Grand Cross of the Order of St Michael and St George, Living people, Ambassadors to France, Ambassadors to China
Prime Minister of the Bahamas	Lists of prime ministers, Politics of the Bahamas, Prime Ministers of the Bahamas, 1969 establishments in North America, 20th-century establishments in the Bahamas
Perry Christie	1943 births, Living people, Prime Ministers of the Bahamas
Parliament of the Bahamas	Politics of the Bahamas, National legislatures, 1729 establishments, Establishments in the Bahamas, 1720s establishments in North America
Bahamian dollar	Currency of North America, The Bahamas, 1966 establishments in North America, 20th-century establishments in the Bahamas
Area code 242	Area codes, The Bahamas
Bimini	Districts of the Bahamas, Islands of the Bahamas
Andros, Bahamas	Islands of the Bahamas, Districts of the Bahamas
New Providence	Districts of the Bahamas, Islands of the Bahamas
Socorro, São Paulo	Cities in São Paulo (state), 1829 establishments, 19th-century establishments in Brazil
Enyo	Greek gods and goddesses
Rose Hill, New South Wales	History of Australia, Sydney, 1788 establishments in Australia
Sleipnir	Norse mythology
Necrotizing fasciitis	Integumentary system, Diseases caused by bacteria
Mount Alvernia	Geography of the Bahamas, Mountains of North America
George Rose	1744 births, 1818 deaths, English politicians, Members of the British House of Commons for English constituencies
List of elevation extremes by country	Lists of countries
Cat Island, Bahamas	Islands of the Bahamas, Districts of the Bahamas, 1999 establishments in the Bahamas
Berry Islands	Islands of the Bahamas, Districts of the Bahamas
École des hautes études commerciales de Paris	Colleges and universities in France, Paris, 1880s establishments in France, 1881 establishments in Europe
Shilling	Currency
Nomenclature des niveaux de formation	Education in France
Mario Vargas Llosa	1936 births, Living people, Nobel Prize in Literature winners, Peruvian politicians, Peruvian journalists, Essayists, Novelists
International Certificate of Competence	Boats, Qualifications, Licenses
Association des professionnels navigants de l'aviation	Aviation in France, Non-profit organizations of France, 1927 establishments in Europe, 1920s establishments in France
Aviation Without Borders	Aviation, Non-profit organizations of France, 1980 establishments in France
Kundalini	Hinduism
Atonement (movie)	2007 drama movies, 2007 romance movies, 2000s mystery movies, 2000s romantic drama movies, 2000s war movies, Academy Award winning movies, BAFTA Award winning movies, British romantic drama movies, British war movies, English-language movies, Epic movies, Golden Globe Award winning movies, Movies based on books, Movies set in the 1930s, Movies set in the 1940s, World War II movies
Hammer toe	Feet
Oviraptorosaur	Oviraptorosauria, Cretaceous dinosaurs
Taika (era)	Japanese eras, 7th century establishments in Japan, 7th century disestablishments in Japan, 645 establishments, 650 disestablishments
Ajkaceratops	Dinosaurs of Europe, Cretaceous dinosaurs
Calamosaurus	Dinosaurs of Europe, Cretaceous dinosaurs, Theropods
Matej	Given names
Lysyl oxidase	Enzymes
Muret - Lherm Aerodrome	Airports in France, Occitanie
Shopping	Society, Hobbies, Economics
AT&T Stadium	National Football League venues, Sports buildings in Texas, Arlington, Texas, Dallas Cowboys, 2009 establishments in the United States, 2000s establishments in Texas
Croatian Liberation Movement	Croatia, Political parties, 1956 establishments in South America, 20th-century establishments in Argentina
List of National Football League stadiums	National Football League venues, United States-related lists, Sports lists
Le Dieu Bleu	Ballets Russes productions, Ballets starring Nijinsky, Ballets
Melissa	Given names
Exuma	Districts of the Bahamas, Islands of the Bahamas, 1999 establishments in the Bahamas
Black Point, Bahamas	Districts of the Bahamas
Central Abaco	Districts of the Bahamas
A La Costa Sud	Compilation albums, 2009 albums
Central Andros	Districts of the Bahamas
Central Eleuthera	Districts of the Bahamas
Crooked Island, Bahamas	Islands of the Bahamas, Districts of the Bahamas
East Grand Bahama	Districts of the Bahamas
Grand Cay	Districts of the Bahamas
Abaco Islands	Islands of the Bahamas
Harbour Island, Bahamas	Districts of the Bahamas, Islands of the Bahamas
Eleuthera	Islands of the Bahamas
Hope Town	Districts of the Bahamas, 1996 establishments in the Bahamas
Long Island, Bahamas	Islands of the Bahamas, Districts of the Bahamas, 1996 establishments in the Bahamas
Mangrove Cay	Districts of the Bahamas, Islands of the Bahamas
Moore's Island	Districts of the Bahamas, Islands of the Bahamas
North Abaco	Districts of the Bahamas
North Andros	Districts of the Bahamas, Islands of the Bahamas, 1996 establishments in the Bahamas
North Eleuthera	Districts of the Bahamas
Rum Cay	Islands of the Bahamas, Districts of the Bahamas
South Abaco	Districts of the Bahamas
South Andros	Districts of the Bahamas, 1996 establishments in the Bahamas
Managed services	Business, Management, Marketing
Biscarrosse–Parentis Airport	Airports in France, Nouvelle-Aquitaine
Castelnaudary - Villeneuve Airport	Airports in France, Occitanie
Peace of Paris (1814)	19th century in France, 1810s treaties, 19th century in Sweden, 1810s in the United Kingdom
Château-Arnoux-Saint-Auban Airport	Airports in France, Provence-Alpes-Côte d'Azur
Apollo 9	Apollo program
Carcassonne Airport	Airports in France, Occitanie
Alpes–Isère Airport	Airports in France, Grenoble
Saint-Yan Airport	Airports in France, Bourgogne-Franche-Comté
Treaty of Paris (1259)	Treaties, History of France, 13th century in England, Normandy, Channel Islands, 1259, December events
Treaty of Paris (1303)	14th century in France, 1300s in England, Treaties, 1303, May events
Melun Villaroche Aerodrome	Airports in France, Île-de-France
Montpellier – Méditerranée Airport	Airports in France, Montpellier
Otradnoye	Towns in Russia
South Eleuthera	Districts of the Bahamas
Spanish Wells	Districts of the Bahamas, 1996 establishments in the Bahamas
West Grand Bahama	Districts of the Bahamas, 1996 establishments in the Bahamas
Airexpo	AirExpo, Aviation in France, Festivals in Europe, French Civil Aviation University, 1987 establishments in France
Green Turtle Cay	Islands of the Bahamas, Districts of the Bahamas
King Fahd Causeway	Buildings and structures in Saudi Arabia, Buildings and structures in Bahrain, Bridges, 1986 establishments in Asia, 20th century establishments in Saudi Arabia
Greater Kashmir	Kashmir, English-language newspapers published in India
Qatar Bahrain Causeway	Qatar, Buildings and structures in Bahrain, Bridges
Flag of Bahrain	Bahrain, National flags
Coat of arms of Bahrain	National coats of arms, Bahrain
Bahrainona	National anthems, Bahrain
Constitutional monarchy	Monarchy
Teide National Park	Canary Islands, National parks in Spain, World Heritage Sites in Spain, 12 Treasures of Spain, 1954 establishments in Europe, 1950s establishments in Spain
King of Bahrain	Kings and queens, Politics of Bahrain, Bahraini people
Hamad bin Isa Al Khalifa	1950 births, Arab people, Bahraini people, Living people, Kings and queens, Current national leaders
Line of succession to the Bahraini throne	Politics of Bahrain, Lines of succession of monarchies
Synecdoche	Communication, Rhetoric, Figures of speech
Metonymy	Communication, Rhetoric, Figures of speech
Salman, Crown Prince of Bahrain	1969 births, Living people, Prime Ministers of Bahrain, Princes and princesses
Prime Minister of Bahrain	Politics of Bahrain, Prime Ministers of Bahrain, Lists of prime ministers
Khalifa bin Salman Al Khalifa	1936 births, 2020 deaths, Deaths from heart failure, Prime Ministers of Bahrain
National Assembly of Bahrain	1973 establishments in Asia, National legislatures, Politics of Bahrain, History of Bahrain
Bahraini dinar	Bahrain, Currency of Asia
Telephone numbers in Bahrain	Telephone numbers, Bahrain
Dilmun	History of Bahrain, Archaeological sites in Asia, History of the Middle East
Tylos	History of Bahrain
Awal	History of Bahrain
23rd century BC	3rd millennium BC, 23rd century BC
24th century BC	3rd millennium BC, 24th century BC
22nd century BC	3rd millennium BC, 22nd century BC
29th century BC	3rd millennium BC, 29th century BC
Pacific Northwest tree octopus	Hoaxes, Internet
26th century BC	3rd millennium BC, 26th century BC
Xenon difluoride	Fluorine compounds
600s BC (decade)	600s BC
580s BC	580s BC
200	200
496 BC	496 BC
253	250s
Viktor Troicki	1986 births, Living people, Male tennis players, Serbian tennis players, People from Belgrade
242	240s
Janko Tipsarević	1984 births, Living people, Male tennis players, Serbian tennis players, People from Belgrade
Stranger with My Face	Fiction books, Horror and fiction
Delhi Capitals	Cricket clubs, Indian Premier League
406 BC	400s BC
240	240s
276	270s
173	173
175	175
127	127
540s BC	540s BC
203	203
Euclid's lemma	Number theory
Thiruvalluvar	Tamil people, Philosophers, Poets, Year of birth unknown, Year of death unknown
Tephritidae	Flies
Japanese imperial family tree	Emperors of Japan, Japanese imperial family
Magnetic monopole	Subatomic particles
Frank Bruno	1961 births, Living people, Actors from London, Black British actors, Black British sportspeople, British boxers, English movie actors, English television actors, People from Hammersmith, People from Wandsworth, People with bipolar disorder, Sportspeople from London
Carina nebula	Nebulae
’O sole mio	19th century songs
Gian Carlo Menotti	Italian composers, 1911 births, 2007 deaths
260	260s
284	280s
188	188
480 BC	480 BC
495 BC	495 BC
Arquette	Surnames
David Arquette	1971 births, Living people, Actors from Virginia, Actors from Los Angeles, California, Movie directors from Los Angeles, California, American movie actors, American movie directors, American movie producers, American television actors, American television directors, American television producers, American voice actors, Jewish American actors, American wrestlers, Arquette family, Participants in American reality television series, Sportspeople from Virginia
320	320s
274	270s
President of Ecuador	Presidents of Ecuador
324	320s
339	339
Opéra de Monte-Carlo	Opera houses, Monaco
238	238
209	209
205	205
197	197
218	210s
239	230s
311	311
241	240s
243	240s
313	310s
217	210s
470 BC	470s BC
411 BC	411 BC
405 BC	400s BC
570s BC	570s BC
473 BC	470s BC
350	350
372	370s
376	370s
294	290s
334	330s
333	330s
231	230s
226	226
266	260s
277	270s
349	340s
291	290s
254	254
271	270s
283	280s
270	270
264	260s
150	150
165	165
Google Play	Google
Ragged Island	Islands of the Bahamas, Districts of the Bahamas
The Open Door Tour	Evanescence, Concert tours
Chelsea (name)	Given names
Stairlift	Elevators
Teatro Regio (Turin)	Opera houses in Italy, Buildings and structures in Italy, Turin, 1740 establishments, 18th century establishments in Italy, 1740s establishments in Europe
Al-Hasa	History of the Middle East, Geography of Saudi Arabia
Qatif	Saudi Arabia
House of Khalifa	Bahrain, Royal dynasties
Islamic Consultative Assembly	Iran, National legislatures, 1906 establishments in Asia, 20th century establishments in Iran
Charles Belgrave	1894 births, 1969 deaths, Bahraini people, British Army officers
Abdul Amir al-Jamri	1937 births, 2006 deaths, Muslims, Bahraini people, Religious leaders
Sheikh	Titles, Arabic words and phrases
Abdulhadi al-Khawaja	1962 births, Living people, Bahraini people, Danish people, Human rights activists, Prisoners sentenced to life imprisonment
Hasan Mushaima	Bahraini people, Living people, 1948 births, Activists
Governorate	Political subdivisions
Governorates of Jordan	Governorates of Jordan
Governorates of the Palestinian National Authority	Politics of Palestine, Political subdivisions, Geography of Palestine
Governorates of Saudi Arabia	Saudi Arabia
Capital Governorate, Bahrain	Governorates of Bahrain
Central Governorate	Governorates of Bahrain
Northern Governorate	Governorates of Bahrain
Southern Governorate	Governorates of Bahrain
Mountain of Smoke	Bahrain, Hills
Territorial waters	Law of the sea
Refinery	Chemical processes
Master of Business Administration	Academic degrees
Australian Greens	Australian Greens, 1992 establishments in Australia, Green political parties
Grande école	Education in France
Kerrang! Awards	Music awards
Beginnings	1969 albums, Debut albums, Slade albums, Rock albums
Play It Loud	1970 albums, Rock albums
Slayed?	1972 albums, Slade albums, Hard rock albums, Glam rock albums
Sladest	1973 albums, Slade albums, Glam rock albums
Old New Borrowed and Blue	1974 albums, Slade albums, Rock albums
Slade Alive!	1972 albums, Hard rock albums, Slade albums
Slade in Flame (album)	1974 albums, Slade albums, Rock albums
Nobody's Fools	1976 albums, Slade albums, Rock albums
Whatever Happened to Slade	1977 albums, Slade albums, Rock albums
Return to Base	1979 albums, Slade albums, Rock albums
We'll Bring the House Down	1981 albums, Slade albums, Rock albums
Till Deaf Do Us Part	1981 albums, Slade albums, Rock albums
The Amazing Kamikaze Syndrome	1983 albums, Slade albums, Glam rock albums
Keep Your Hands Off My Power Supply	1984 albums, Slade albums, Hard rock albums
Rogues Gallery	1985 albums, Slade albums, Rock albums
Natalie	Given names
Crackers – The Christmas Party Album	1985 albums, Slade albums, Hard rock albums
You Boyz Make Big Noize	1987 albums, Slade albums
Slade Alive, Vol. 2	1978 albums, Rock albums, Slade albums
Slade on Stage	1972 albums, Rock albums, Slade albums
Salon du livre aéronautique	Events in Europe, 2009 establishments in France, French Civil Aviation University, Toulouse
Laura	Given names
39th G8 summit	G8, 2013 in the United Kingdom, History of Northern Ireland
Bugatti	Automobile companies of France, Volkswagen
Samantha Mumba	1983 births, Living people, Actors from Dublin, Dancing on Ice participants, Irish movie actors, Irish pop singers, R&B musicians, Singers from Dublin
Financial Times	Newspapers published in the United Kingdom, 1888 establishments in the United Kingdom
Bahraini people	Bahraini people
Muharraq	Settlements in Bahrain
Bani Jamra	Settlements in Bahrain
A'ali	Settlements in Bahrain
Souq	Retail markets, Arabic words and phrases
Muharram	Islamic festivals, Islamic calendar
Diana Dors	1931 births, 1984 deaths, Actors from Wiltshire, Cancer deaths in Berkshire, Deaths from ovarian cancer, English movie actors, English television actors, People from Swindon
Day of Ashura	Islamic calendar, Holidays
Scientific management	Management, Manufacturing
40th G7 summit	G8, 2014 in Europe, 2010s in Belgium, Brussels, June 2014 events
President of Bangladesh	Presidents of Bangladesh
Zillur Rahman	1929 births, 2013 deaths, Presidents of Bangladesh, Bangladeshi Muslims
Prime Minister of Bangladesh	Politics of Bangladesh, Lists of prime ministers
Father Ted	1995 establishments in the United Kingdom, 1995 television series debuts, 1998 television series endings, 1990s establishments in the Republic of Ireland, 1990s disestablishments in the United Kingdom, 1990s British sitcoms, 1990s British television series debuts, BAFTA Award winners, Channel 4 comedy, English-language television programs
Sheikh Hasina	1947 births, Prime Ministers of Bangladesh, Bangladeshi Muslims, Living people, Current national leaders
Abdul Hamid (politician)	Living people, Bangladeshi politicians, Bangladeshi Muslims, 1944 births, Current national leaders, Legislative speakers
Chief Justice of Bangladesh	Bangladeshi politicians, Chief justices, Lists of people
Cox's Bazar	Beaches of Asia, Settlements in Bangladesh
Sundarbans	World Heritage Sites in Asia, Geography of Bangladesh, Forests
Rangpur Division	Divisions of Bangladesh, Districts of British India, Districts of East Pakistan, 2010 establishments in Asia, 21st century establishments in Bangladesh
Tigon	Panthera, Animal hybrids
Eosinophil granulocyte	Blood cells
Christine Milne	1953 births, Living people, Politicians from Tasmania, Australian Greens politicians, Members of the Australian Senate
Aerostatics	Aerospace engineering, Fluid mechanics
37th G8 summit	G8, 2011 in Europe, 2010s in France
Khulna	Cities in Bangladesh
Rajshahi	Cities in Bangladesh
Sylhet	Cities in Bangladesh
Barisal	Barisal
Bogra	Settlements in Bangladesh
Cumilla	Cities in Bangladesh
Mymensingh	Cities in Bangladesh
Rangpur, Bangladesh	Cities in Bangladesh
San Cristóbal, Táchira	Cities in Venezuela, 1560s establishments in South America, Establishments in Venezuela, 1561 establishments
Elizabeth Hurley	Actors from Hampshire, English businesspeople, English models, English movie actors, English movie producers, English television actors, English television presenters, People from Basingstoke, 1965 births, Living people
Sledgehammer Games	Video game companies, American technology companies
Technicien aéronautique d'exploitation	Occupations in aviation, French Civil Aviation University, Aviation licenses and certifications
6th G7 summit	G8, 1980 in Europe, Venice, 1980s in Italy
Meghna River	Rivers of Bangladesh
Jatiya Sangsad	Politics of Bangladesh, National legislatures
Independence Day of Bangladesh	Bangladeshi culture, History of Bangladesh, National Days
Telephone numbers in Bangladesh	Telephone numbers, Bangladesh
Charyapada	Poetry, Buddhist texts
Michael Madhusudan Dutt	Bangladeshi poets, Playwrights, Christians, 1824 births, 1873 deaths
Kazi Nazrul Islam	20th century philosophers, Indian revolutionaries, Muslims, 1899 births, 1976 deaths, National symbols of Bangladesh, Bangladeshi poets, Bangla Academy Literary Award winners, Recipients of the Ekushey Padak, Bangladeshi Muslims
Ektara	Folk instruments, Plucked string instruments
Biryani	Iranian food, Indian food, Rice dishes
Vesak	Buddhism, Festivals in Asia, Religious festivals
Pohela Boishakh	Festivals in Asia, Bangladeshi culture, West Bengal
Magpie-robin	Passeriformes
Juliette Binoche	Academy Award winning actors, Actors from Paris, BAFTA Award winning actors, French movie actors, 1964 births, Living people
Scientific model	Scientific modeling, Interdisciplinary fields, Reality
Skadi	Norse gods and goddesses
Hawkeye (Marvel Comics)	Marvel Comics superheroes, Marvel vs. Capcom fighters
Commercial pilot licence	Aviation licenses and certifications
Airline Transport Pilot Licence	Aviation licenses and certifications
Fushimi Inari-taisha	Shinto shrines, Buildings and structures in Kyoto Prefecture, Kyoto
Technicien supérieur de l'aviation	Aviation licenses and certifications, Occupations in aviation, French Civil Aviation University, Air traffic control
Ectopic pregnancy	Diseases and disorders of the female reproductive system
Chōhō (era)	Japanese eras
Bangladesh national cricket team	Sport in Bangladesh, Cricket clubs, 2000 establishments in Asia, 20th century establishments in Bangladesh
2011 Cricket World Cup	2011 in sports, Cricket World Cup, Sport in Bangladesh, 2011 in Asia, 2010s in India, 21st century in Sri Lanka, 2010s in Bangladesh
Kabaddi	Team sports, Sport in Bangladesh, Sport in Iran, Sport in Pakistan, Sport in India
List of Major League Baseball stadiums	Major League Baseball venues, Baseball lists, Lists of buildings
The Sopranos	1999 American television series debuts, 2007 American television series endings, 1990s American drama television series, 1990s crime television series, 2000s American drama television series, 2000s crime television series, American crime drama television series, Antisocial personality disorder in fiction, Emmy Award winning programs, Golden Globe Award winning programs, HBO television series, Peabody Award winners, Television series set in New Jersey, English-language television programs
Kankō	Japanese eras
Carrom	Games, Indoor sports
European Network for Accreditation of Engineering Education	Education, Qualifications
Angling	Fishing
Bridgetown	World Heritage Sites in North America, National capitals in North America, Cities in the Caribbean, Barbados, 1628 establishments, 17th-century establishments in the British Empire
Hurricane belt	Hurricanes, Atlantic Ocean
Grantley Adams International Airport	Barbados, Airports in North America
Flag of Barbados	Barbadian culture, National flags, 1966 establishments in Barbados
NME Awards	Music awards, British music
Overexposed (album)	2012 albums, Maroon 5 albums
Coat of arms of Barbados	Barbadian culture, National coats of arms, 1966 establishments in Barbados
James–Lange theory	Emotions
Nurse Jackie	2009 American television series debuts, 2015 American television series endings, 2000s American comedy television series, 2000s American drama television series, 2000s medical television series, 2010s American comedy television series, 2010s American drama television series, 2010s comedy-drama television series, 2010s medical television series, American comedy-drama television series, American medical television series, Black comedy television series, Television series set in New York City, English-language television programs
Christ Church, Barbados	Parishes of Barbados, 1627 establishments, 17th-century establishments in the British Empire
Saint Andrew, Barbados	Parishes of Barbados
Gestational diabetes	Diseases and disorders of the female reproductive system, Diabetes mellitus
Zhou Enlai	1898 births, 1976 deaths, Chinese politicians
Jean-Marc Ayrault	1950 births, Living people, French mayors, Prime Ministers of France, French Roman Catholics, Government ministers of France, People from Pays de la Loire, Socialist Party (France) politicians
Slade in Flame	1975 movies
Ingénieur des études et de l'exploitation de l'aviation civile	Aviation licenses and certifications, Occupations in aviation, French Civil Aviation University
Joseph Monier	French inventors, 1823 births, 1906 deaths
Gary Johnson	1953 births, Living people, American activists, US Republican Party politicians, US Libertarian Party politicians, 2012 United States presidential candidates, 2016 United States presidential candidates, Governors of New Mexico, Writers from New Mexico, Writers from North Dakota, Politicians from North Dakota, People from Minot, North Dakota, Businesspeople from North Dakota, Businesspeople from New Mexico, 20th-century American politicians, 21st-century American politicians
Menarche	Female reproductive system
Viper	Vipers
Abdelbaset al-Megrahi	Deaths from prostate cancer, Murderers, People from Tripoli, Prisoners sentenced to life imprisonment, 1952 births, 2012 deaths
Tony Hancock	1924 births, 1968 deaths, Actors from Birmingham, Actors who committed suicide, British radio actors, British screenwriters, Comedians from Hampshire, Comedians who committed suicide, Drug-related suicides, English movie actors, English television actors, People from Bournemouth, Suicides in Australia, Writers from Birmingham, Writers from Hampshire, Writers who committed suicide
Chōwa	Japanese eras
Kannin	Japanese eras
Jian (era)	Japanese eras
Tawang	Tibet, Territorial disputes of China, Arunachal Pradesh
Clara Petacci	1912 births, 1945 deaths, Deaths by firearm in Italy, People from Rome
Filippo Raciti	Italian people, 1967 births, 2007 deaths, Police officers
Natural law	Types of law, Philosophy
Robert Zemeckis	1952 births, Living people, American television directors, American television producers, American television writers, Movie directors from Chicago, Movie producers from Chicago, Screenwriters from Chicago
Offensive guard	American football positions
Center (American football)	American football positions, American football centers
Joseph Epstein	1937 births, Living people, American writers
Ross Lynch	1995 births, Living people, American television actors, Actors from Colorado
Flo Rida	Living people, 1979 births, African-American singers, American hip hop musicians, American rap musicians from Florida, Democrats (United States), Singers from Florida, People's Choice Award winners, Atlantic Records artists
Bram Cohen	Living people, 1975 births, American computer scientists, American Jews, People from San Francisco, American bloggers
Icy Tower	Freeware games, 2001 video games, Platform games
Technicien supérieur des études et de l'exploitation de l'aviation civile	Occupations in aviation, French Civil Aviation University, Aviation licenses and certifications, Air traffic control
Babak (name)	Given names, Persian language
On the Buses	1969 establishments in the United Kingdom, 1973 television series endings, 1960s British television series, 1960s sitcoms, 1970s British sitcoms, 1970s British workplace television series, 1970s workplace comedy television series, British workplace comedy television series, Essex, Television series about families, Television series about friendship, English-language television programs
Hyperactivity	Human behavior, Symptoms
Manju (era)	Japanese eras
Amy Heckerling	1954 births, Living people, American television directors, American television producers, American television writers, Movie directors from New York City, Movie producers from New York City, Screenwriters from New York City, Writers from the Bronx
Chōgen	Japanese eras
Chōryaku	Japanese eras
Mercenary (band)	Danish heavy metal bands, Death metal bands, Melodic death metal bands, Power metal bands, Thrash metal bands, Musical groups established in 1991, 20th century establishments in Denmark, 1991 establishments in Europe
Accept (band)	German heavy metal bands
Autumn (band)	Musical groups established in 1995, Gothic metal bands, Dutch heavy metal bands, Groningen (city)
Jennifer Stone	1993 births, Living people, American television actors, American movie actors, Actors from Texas, Arlington, Texas
Jennette McCurdy	1992 births, Living people, American child actors, American television actors, Actors from Los Angeles, California, Singers from Los Angeles, California, American stage actors, American movie actors, American voice actors, American country singers, American pop singers
Seattle Pilots	Milwaukee Brewers, 1969 establishments in the United States, 1960s establishments in Washington (state), 1969 disestablishments, 1960s disestablishments in the United States, 20th-century disestablishments in Washington (state)
Adder	Vipers
Harry Potter and the Goblet of Fire (movie)	2005 movies, 2000s fantasy movies, Harry Potter movies, Movies based on books
Tapaculo	Tyrannides
Gnateater	Tyrannides
Ovenbird	Passeriformes
Wang Jha-ji	1066 births, 1122 deaths, Ambassadors, Autobiographers, Generals, Korean educators, Korean military people, Korean musicians, Korean politicians, Korean writers
Hemopneumothorax	Medical emergencies, Respiratory system
Advanced Technician in Aviation non civil servant	Occupations in aviation, French Civil Aviation University, Aviation licenses and certifications
State Duma	National lower houses, Politics of Russia, 1906 establishments, 20th century establishments in Russia
Cradle Mountain-Lake St Clair National Park	Protected areas of Tasmania, National parks in Australia, Tasmanian Wilderness
Whatcheeria	Tetrapods, Fossils
TAE	Acronyms
Monarchy of Barbados	Politics of Barbados, Commonwealth realms, Current monarchies
List of governors-general of Barbados	Governors-General of Barbados, Politics of Barbados, Lists of governors-general, 1966 establishments in Barbados
Elliott Belgrave	1931 births, Governors-General of Barbados, Living people
List of Eastern Caribbean people	Caribbean people, Lists of people
Bajan Creole	Barbadian culture, Languages of the Caribbean
Barbadian people	Barbadian people
Prime Minister of Barbados	Lists of prime ministers, Prime Ministers of Barbados
Freundel Stuart	1951 births, Prime Ministers of Barbados, Living people
Parliament of Barbados	Politics of Barbados, National legislatures
Barbadian dollar	Barbados, Currency of North America, 1935 establishments in North America, 20th-century establishments in Barbados
North American Numbering Plan	Telephone numbers
Area code 246	Area codes, Barbados
Mount Hillaby	Barbados, Geography of the Caribbean, Mountains of North America
Saint George, Barbados	Parishes of Barbados, 1966 establishments in Barbados
Saint James, Barbados	Parishes of Barbados
8 Out of 10 Cats	2005 British television series debuts, 2000s British comedy television series, 2010s British comedy television series, 2020s British comedy television series, British television game shows, Channel 4 comedy, English-language television programs, Panel games
Chōkyū	Japanese eras
Polycystic ovary syndrome	Diseases and disorders of the female reproductive system, Syndromes
Zola (entertainer)	1981 births, Living people, Actors, Musicians, South African entertainers, Television presenters
Arlette Zola	1949 births, Living people, Swiss singers
David Warner (actor)	1941 births, Actors from Manchester, Emmy Award winning actors, English movie actors, English stage actors, English television actors, English voice actors, Living people
Chris Pine	1980 births, Living people, Actors from Los Angeles, California, American movie actors, American television actors, American video game actors, American voice actors
Hyperglycemia	Blood disorders

