Wall plug	Hardware (mechanical)
Prince George of Cambridge	House of Windsor, Royalty from London, 2013 births, Living people
Rapcore	Rap music, Hip hop genres
Fred Dretske	1932 births, 2013 deaths, American philosophers, Scientists from Illinois, Deaths from heart failure, People from Waukegan, Illinois
Tom Corbett	US Republican Party politicians, Governors of Pennsylvania, 1949 births, Living people
Louis Mountbatten, 1st Earl Mountbatten of Burma	1900 births, 1979 deaths, Admirals, Assassinated people, British politicians, English murder victims, Irish Republican Army, People from Berkshire, People murdered in Europe, Royal Navy officers, Viceroys
Richard Erdman	1925 births, 2019 deaths, Deaths from dementia, American movie actors, American television actors, American voice actors, American stage actors, American movie directors, American movie producers, Actors from Oklahoma, People from Enid, Oklahoma
Ayushita	1989 births, Living people, Pop musicians, R&B musicians, Indonesian singers, Actors from Jakarta, movie actors, Television actors
The Butler	2013 movies, American drama movies, Historical movies, Movies set in Washington, D.C., Movies set in Louisiana, Movies set in California
Rosiers-d'Égletons	Communes in Corrèze
42 (movie)	2013 movies, American biographical movies, American sports movies, Warner Bros. movies
Silvio Fazio	Living people, 1952 births, Writers from Rome
Controlled-access highway	Roads
North American Aviation T2J Buckeye	United States Navy aircraft, Vietnam War aircraft
Art Clokey	1921 births, 2010 deaths, American adoptees, American animators, Infectious disease deaths in California, People from Detroit, Michigan
Bartlett's Familiar Quotations	Reference works, 2003 books
John Moore (broadcaster)	1966 births, Living people, Canadian voice actors, Movie critics, Canadian radio personalities, Canadian television presenters, People from Montreal
Better Than Chocolate	1999 romance movies, 1999 comedy movies, 1990s romantic comedy movies, 1999 LGBT movies, Canadian comedy movies, Canadian romance movies, Canadian LGBT movies, English-language movies
Bell 205	Bell aircraft, Civil aircraft
Bell 204	Bell aircraft, Civil aircraft
Bell 222	Civil aircraft, Helicopters, Bell aircraft
Great Sasuke	1969 births, Former WWE wrestlers, Japanese professional wrestlers, Living people, People from Iwate Prefecture
Separatism	Sociology
Ugni	Shrubs, Myrtaceae
Bell X-1	Bell aircraft, United States Army aircraft, United States Air Force aircraft
Bell P-63 Kingcobra	Bell aircraft, World War II American aircraft, United States military aircraft
Curtiss C-46 Commando	World War II American aircraft, United States Air Force aircraft, United States Army aircraft, United States Navy aircraft, Civil aircraft
Dassault Super Mirage 4000	Dassault Aviation, French military aircraft
Dassault Falcon 20	United States Coast Guard aircraft, Dassault Aviation, French military aircraft
Dassault Falcon 10	Civil aircraft, Dassault Aviation, French military aircraft
Gloster Gladiator	Royal Air Force aircraft, World War II British aircraft
Leduc 0.10	Aviation in France, Aircraft
Duke of Norfolk	British Dukes and Duchesses
McDonnell FH Phantom	United States Marine Corps aircraft, United States Navy aircraft
Arundel Cathedral	Cathedrals in England, Roman Catholic churches
Jinsei Shinzaki	1966 births, Former WWE wrestlers, Japanese professional wrestlers, Living people, People from Tokushima Prefecture
Arundel	Towns in West Sussex
Flower pot	Gardening, Containers
Bernadette Lafont	1938 births, 2013 deaths, Cardiovascular disease deaths in France, Deaths from cardiac arrest, French movie actors, French stage actors, French television actors, French voice actors
Virginia E. Johnson	1925 births, 2013 deaths, American educators, American physicians, American psychologists, Disease-related deaths in the United States, People from Springfield, Missouri, Scientists from Missouri, Sexologists
William H. Masters	1915 births, 2001 deaths, Deaths from Parkinson's disease, American physicians, Scientists from Cleveland, Ohio
Married... with Children	1987 American television series debuts, 1997 disestablishments, 1980s American comedy television series, 1990s American comedy television series, American sitcoms, Television series set in Chicago, Illinois, English-language television programs
According to Jim	2001 American television series debuts, 2009 American television series endings, 2000s American television series, American sitcoms, Television series about dysfunctional families, Television series about marriage, Television series about siblings, Television series about suburbia, Television series set in Chicago, Illinois, ABC network shows, English-language television programs
George Lopez (TV series)	2002 American television series debuts, 2007 American television series endings, 2000s American television series, American comedy television series, ABC network shows, Television series set in Los Angeles, California, English-language television programs
Belita Moreno	1949 births, Living people, American movie actors, American television actors, American voice actors, Actors from Dallas, Texas
Emiliano Díez	1953 births, Living people, Cuban actors, Movie actors, Television actors, Singers, People from Havana
Valente Rodriguez	1964 births, Living people, American movie actors, American television actors, American voice actors, Actors from Texas
Constance Marie	1965 births, Living people, American movie actors, American television actors, American voice actors, Actors from Los Angeles, California
Luis Armand Garcia	1992 births, Living people, American movie actors, American television actors, Actors from Illinois
Aimee Garcia	1978 births, Living people, American movie actors, American television actors, Actors from Chicago
Paranoia (2013 movie)	2013 drama movies, 2013 thriller movies, 2010s drama thriller movies, American drama thriller movies, English-language movies, FBI in fiction, Movies based on books
The Conjuring	2013 horror movies, American horror movies, American supernatural movies, English-language movies, Haunted house movies, Movies based on real life events, Movies set in the 1970s, Rhode Island in fiction, Saturn Award winning movies
Family Weekend	2013 comedy-drama movies, American comedy-drama movies, English-language movies, American independent movies
Mick Dodson	1950 births, Living people, Human rights activists, Australian lawyers, Australian of the Year Award winners, Indigenous Australian activists, Order of Australia, People from Melbourne, People from the Australian Capital Territory, People from the Northern Territory
Hume Cronyn	1911 births, 2003 deaths, Actors from London (Ontario), American movie actors, American radio actors, American stage actors, American television actors, American voice actors, Canadian movie actors, Canadian radio actors, Canadian stage actors, Canadian television actors, Canadian voice actors, Cancer deaths in the United States, Deaths from prostate cancer, Emmy Award winning actors, Naturalized citizens of the United States, Tony Award winning actors
Edward Platt	1916 births, 1974 deaths, Actors from Staten Island, American movie actors, American stage actors, American television actors, American voice actors, Cardiovascular disease deaths in California, Deaths from myocardial infarction, Princeton University alumni
Barbara Feldon	1933 births, Living people, Actors from Pennsylvania, American movie actors, American stage actors, American television actors, American voice actors, Models from Pennsylvania
Institute of Political Studies in Belgrade	Research organizations in Europe, 1968 establishments in Europe, Belgrade
Christina Cox	Canadian television actors, Canadian movie actors, 1971 births, Living people
Lanu-puisto	Parks, Geography of Finland, 1992 establishments in Europe, 20th century establishments in Finland
Headphone amplifier	Audio technology
Tube amplifier	Audio technology
IRS tax forms	Government of the United States, Taxation
Banana plug	Electrical connectors
Division of Aston	Electoral divisions of Australia, Victoria, Australia, 1984 establishments in Australia
Division of Batman	Former electoral divisions of Australia, Victoria, Australia, 1906 establishments in Australia
Balanced circuit	Electronic circuits
Rotary switch	Electronic switches
Commodore VIC-20	Commodore computers
Commodore 16	Commodore computers
The Incredible Burt Wonderstone	2013 movies, American comedy movies, Warner Bros. movies, Movies set in Los Angeles, California, Movies set in Las Vegas, English-language movies
Flight (movie)	2012 drama movies, American drama movies, English-language movies, Movies directed by Robert Zemeckis
Kelly Reilly	1977 births, Living people, English movie actors, English television actors, English stage actors, English voice actors, Actors from Surrey
Richard I, Duke of Normandy	930s births, 996 deaths, House of Normandy, Dukes and duchesses
Betsy Ross	1752 births, 1836 deaths, Deaths from natural causes, People from Philadelphia, Pennsylvania
Douglas A-1 Skyraider	United States Navy aircraft, Douglas aircraft, United States Air Force aircraft, Vietnam War aircraft
North American Rockwell OV-10 Bronco	United States Navy aircraft, United States Air Force aircraft, Vietnam War aircraft
Spherical geometry	Geometry
SPAD S.XIII	World War I aircraft, French military aircraft
Photobleaching	Light, Cell biology
Cotentin Peninsula	Normandy, Geography of France, Peninsulas
Aérospatiale SA-315 Lama	Aérospatiale, Indian military aircraft, Helicopters
George H. Hitchings	1905 births, 1998 deaths, American physicians, Nobel Prize in Physiology or Medicine winners
Amazon Standard Identification Number	Books, Amazon (company)
Fuji Television	Television stations, Companies of Japan
Division of Northern Melbourne	Former electoral divisions of Australia, 1901 establishments in Australia, 1900s disestablishments in Australia
List of soups	Food-related lists, Soups
Jo-Jo the Dog-Faced Boy	1868 births, 1904 deaths, Deaths from pneumonia, People from Saint Petersburg, Russian entertainers, Sideshow performers
Epiphany (holiday)	Christian holidays, January events
Bangor, New York	Towns in New York, 1806 establishments, 1800s establishments in New York (state)
Korpilahti	Former municipalities of Finland
Ranua	Municipalities of Lapland (Finland), 1917 establishments in Europe, 1910s establishments in Finland
Posio	Municipalities of Lapland (Finland)
Magi	New Testament people
Tornio	Towns in Finland, Municipalities of Lapland (Finland)
Kozienice	Cities in Poland
Kemi	Towns in Finland, Municipalities of Lapland (Finland)
Inari, Finland	Municipalities of Lapland (Finland)
Pello	Municipalities of Lapland (Finland)
Sample	Statistics
Enontekiö	Municipalities of Lapland (Finland)
Pukkila	Municipalities of Uusimaa, 1898 establishments in Europe, 19th century establishments in Finland
Kerava	Towns in Finland, Municipalities of Uusimaa
Sound level meter	Sound, Measuring tools
2012 Pacific hurricane season	Pacific hurricane seasons, 2012 in weather
Porvoo	Towns in Finland, Municipalities of Uusimaa
Trinity Church, Halmstad	Churches in Sweden, Roman Catholic churches, 1981 establishments in Europe, 1980s establishments in Sweden
Helsingborg Municipality	Municipalities of Sweden
Landskrona Municipality	Municipalities of Sweden
Åre Municipality	Municipalities of Sweden
Åre	Settlements in Jamtland County, Ski areas and resorts in Sweden
Church of Sweden Abroad	Church of Sweden
Swedish Evangelical Mission	1856 establishments in Europe, Church of Sweden, 19th century establishments in Sweden
Evangelical Free Church in Sweden	1997 establishments in Sweden, Baptist churches, Protestantism in Sweden
Dansbandskampen	Music media, Swedish music, Television, 2008 establishments in Europe, 2000s establishments in Sweden
Svensktoppen	1962 establishments in Sweden, Record charts, Radio, Swedish music
Vuorenkylä	Municipalities of Finland
Sveriges Radio	1925 establishments in Sweden, Entertainment in Sweden, Radio
Sveriges Television	1956 establishments in Sweden, Swedish television
Aftonbladet	1830 establishments in Europe, Newspapers published in Sweden, Stockholm
Swedish Americans	Ethnic groups in the United States
Expressen	1944 establishments in Sweden, Newspapers published in Sweden, Stockholm
Allsång på Skansen	1935 establishments in Sweden, Music events, Radio programs, Stockholm, Television programs
Skansen	1891 establishments in Sweden, Buildings and structures in Stockholm, Zoos, Open air museums, Djurgården
Djurgården	Djurgården
Gröna Lund	1883 establishments in Europe, Djurgården, 1880s establishments in Sweden
Essingeleden	1966 establishments in Sweden, Roads, Stockholm, Transport in Sweden
Bollebygd Municipality	1995 establishments in Europe, Municipalities of Sweden, 1990s establishments in Sweden
Borås Municipality	Municipalities of Sweden
Atlantic Division (NBA)	National Basketball Association divisions
Nykvarn Municipality	1999 establishments in Sweden, Municipalities of Sweden
Uppvidinge Municipality	Municipalities of Sweden
Ystad Municipality	Municipalities of Sweden
Central Division (NBA)	National Basketball Association divisions
Sandviken Municipality	Municipalities of Sweden
Ystad	Settlements in Skane County
Ljungarum Church	Church of Sweden churches, Buildings and structures in Jönköping
Sofia Church, Jönköping	Church of Sweden churches, Buildings and structures in Jönköping, Buildings and structures completed in the 19th century
Christina Church	Church of Sweden churches, Buildings and structures in Jönköping
Friends Arena	Stadiums in Sweden, Football stadiums in Sweden
Stockholm Olympic Stadium	Stadiums in Sweden, Buildings and structures in Stockholm, Sport in Stockholm
Scandinavium	Indoor arenas, Stadiums in Sweden, Ice hockey in Sweden, Sport in Gothenburg, Buildings and structures in Gothenburg
Stockholm Globe Arena	Ice hockey in Sweden, Buildings and structures in Stockholm, Stadiums in Sweden
Råsunda Stadium	1937 establishments in Europe, 2012 disestablishments in Sweden, Football stadiums in Sweden, 1930s establishments in Sweden
Söderstadion	Bandy in Sweden, Stadiums in Sweden, Football stadiums in Sweden, Sport in Stockholm, Buildings and structures in Stockholm
Johanneshovs isstadion	Buildings and structures in Stockholm, Stadiums in Sweden, Ice hockey in Sweden
Shiloh	1991 books, Children's books, English-language novels, 20th century American novels, Newbery Medal winning books
Hugh the Great	890s births, 950s deaths, Dukes and duchesses of France
Mini-DIN connector	Electrical connectors
Reed switch	Electronic switches, Magnetism
Mando Diao	1999 establishments in Sweden, Swedish rock music groups, Musical groups established in 1999
Borlänge Municipality	Municipalities of Sweden
Doomwyte	Redwall, 2008 books, Fantasy books
Richard II, Duke of Normandy	10th century births, 1026 deaths, House of Normandy, Dukes and duchesses
The Sable Quean	Redwall, 2010 books, Fantasy books
Saint Joachim	Early Christian saints, 1st century BC births
Ranked list of Spanish autonomous communities by area	Autonomous communities of Spain, Geography-related lists
Golden Gate (Jerusalem)	Temple Mount, Gates in Jerusalem's Old City Walls
Luhanka	Municipalities of Central Finland
Laukaa	Municipalities of Central Finland
Sahara Hotnights	Swedish rock music groups
Uurainen	Municipalities of Central Finland
Melody Club	Swedish pop music groups, 2000 establishments in Sweden
Takida	1999 establishments in Sweden, Swedish rock music groups
Nastola	Former municipalities of Finland, Lahti
Orimattila	Towns in Finland, Municipalities of Päijänne Tavastia
Hollola	Municipalities of Päijänne Tavastia
Kärkölä	Municipalities of Päijänne Tavastia
Hämeenlinna	Towns in Finland, Municipalities of Kanta-Häme
Padasjoki	Municipalities of Päijänne Tavastia
Kuhmoinen	Municipalities of Central Finland
Pori	Cities in Finland
Särkänniemi	Theme parks in Europe, Finnish culture, Tampere, 1969 establishments in Europe, 20th century establishments in Finland
Matti Nykänen	1963 births, 2019 deaths, Deaths from diabetes, 1984 Winter Olympics, 1988 Winter Olympics, Finnish Olympic silver medalists, Finnish singers, Olympic gold medalists
Heinola	Towns in Finland, Municipalities of Päijänne Tavastia
Olavi Lanu	1925 births, 2015 deaths, Finnish people, Sculptors
The Well-Tempered Clavier	Compositions by Johann Sebastian Bach
Pottiputki	Gardening tools
Ranked list of Spanish autonomous communities by population	Autonomous communities of Spain, Geography-related lists
Imperiet	Musical groups disestablished in 1988, 1980s Swedish music groups, Musical groups established in 1983, Stockholm, Swedish rock music groups, 1983 establishments in Sweden, 1980s disestablishments in Sweden, 1988 disestablishments in Europe
BWO	2003 establishments in Europe, 2010 disestablishments in Europe, Swedish pop music groups, Synth-pop, 2000s establishments in Sweden, 21st century disestablishments in Sweden
Stiftelsen	2010 establishments in Sweden, Swedish rock music groups
Soviet submarine S-363	1981 in Europe, 1980s in Sweden, Cold War, 1980s in the Soviet Union
Folkhemmet	20th century in Sweden, Politics of Sweden
Bell 214	Bell aircraft, Iran, Civil aircraft, Military aircraft
Lockheed MC-130	United States Air Force aircraft, Lockheed & Lockheed-Martin aircraft
Catalina affair	1952 in Europe, 1950s in the Soviet Union, 1950s in Sweden, Cold War
The Redwall Cookbook	Redwall, Non-fiction books
Massa's in de Cold Ground	19th century American songs, Compositions by Stephen Foster
Järvenpää	Towns in Finland
Kokkola	Towns in Finland, Municipalities of Central Ostrobothnia, 1620s establishments in Europe, 17th century establishments in Finland, 1620 establishments
Kouvola	Towns in Finland, Municipalities of Kymenlaakso, 2009 establishments in Europe, 2000s establishments in Finland
Hamina	Towns in Finland, Municipalities of Kymenlaakso
Taka Michinoku	1973 births, Former WWE wrestlers, Japanese professional wrestlers, Living people, People from Chiba Prefecture
Repovesi National Park	National parks in Finland, 2003 establishments in Europe
Shaheed-e-Mohabbat Boota Singh	Indian movies, Movies based on real life events
Boota Singh	1957 deaths, Year of birth missing, Punjabi people, British military people, Indian people, World War II people
Geometric topology	Mathematics
Lake Gałęziste	Lakes of Europe, Geography of Poland
Riksdag	National legislatures, Government of Sweden
Hawker Hunter	Royal Air Force aircraft, British military aircraft, Hawker aircraft
Noice	1977 establishments in Sweden, Swedish rock music groups
Freestyle	1980s Swedish music groups, Musical groups disestablished in 1983, Musical groups established in 1980, Swedish pop music groups, 1980 establishments in Sweden, 1983 disestablishments in Europe, 1980s disestablishments in Sweden
Style (band)	Musical groups disestablished in 1989, 1980s Swedish music groups, Musical groups established in 1983, Swedish pop music groups, 1983 establishments in Sweden, 1980s disestablishments in Sweden
Dag Vag	1978 establishments in Sweden, Swedish pop music groups
Eldkvarn	Buildings and structures in Stockholm, 1805 establishments, 1800s establishments in Europe, 19th century establishments in Sweden, 1878 disestablishments, Disestablishments in Sweden, 1870s disestablishments in Europe
Eldkvarn (band)	1971 establishments in Sweden, Swedish rock music groups, Norrköping
Kikki, Bettan & Lotta	2000s Swedish music groups, Musical groups established in 2001, 2004 disestablishments in Sweden, 2001 establishments in Sweden
Matz Bladhs	Dansbands, Swedish musical groups
Hawker Sea Hawk	British military aircraft, Indian military aircraft, Hawker aircraft
Family Four	Swedish musical groups
Frequency response	Sound
Sukhoi Su-25	Soviet military aircraft
Audio crossover	Sound, Electronic circuits
Hawker Hurricane	Hawker aircraft, Royal Air Force aircraft, World War II British aircraft
Hawker Siddeley HS-748	Hawker aircraft, Civil aircraft
Airbus A318	Airbus aircraft
CASA C-212 Aviocar	Civil aircraft, Military aircraft, United States Air Force aircraft
Eu, Seine-Maritime	Communes in Seine-Maritime
Akaa	Cities in Finland
Mämmi	Finnish food, Desserts
Hanko	Cities in Finland, Municipalities of Uusimaa
Rosvopaisti	Finnish food
Gunnora	950s births, 1030s deaths, House of Normandy, Dukes and duchesses
Stockholm City Hall	Buildings and structures in Stockholm, Government buildings
Stockholm Palace	Buildings and structures in Stockholm, Castles
Riddarholmen Church	Church of Sweden churches, Churches in Stockholm
Royal Chapel, Stockholm	Church of Sweden churches, Churches in Stockholm
Adolf Fredrik Church	Church of Sweden churches, Churches in Stockholm
Hedvig Eleonora Church	Church of Sweden churches, Churches in Stockholm
Sweden women's national ice hockey team	1987 establishments in Sweden, Ice hockey teams in Sweden, National ice hockey teams
Svenska Dagbladet	1884 establishments in Europe, Newspapers published in Sweden, Stockholm
Kitee	Cities in Finland, 1631 establishments, 17th century establishments in Finland, 1630s establishments in Europe
FC Groningen	1971 establishments in Europe, 1970s establishments in the Netherlands, Dutch football clubs, Groningen (city)
Jönköpings-Posten	1865 establishments in Europe, Newspapers published in Sweden, Jönköping, 19th century establishments in Sweden
Stadsparksvallen	1902 establishments in Europe, Stadiums in Sweden, Sport in Jönköping, Buildings and structures in Jönköping, 1900s establishments in Sweden
Joutseno	Towns in Finland, Former municipalities of Finland
Norrahammar	Settlements in Jonkoping County
Tenhult	Settlements in Jonkoping County
Smålandsstenar	Settlements in Kalmar County
Gislaved Municipality	Municipalities of Sweden
Vaggeryd Municipality	Municipalities of Sweden
Värnamo Municipality	Municipalities of Sweden
The Rogue Crew	Redwall, Fantasy books, 2011 books
Skillingaryd	Settlements in Jonkoping County
Gnosjö Municipality	Municipalities of Sweden
Eksjö Municipality	Municipalities of Sweden
Aneby Municipality	Municipalities of Sweden
Tranås Municipality	Municipalities of Sweden
Karlsborg Municipality	Municipalities of Sweden
Håbo Municipality	Municipalities of Sweden
Bålsta	Settlements in Uppsala County
Kalix Municipality	Municipalities of Sweden
Ånge Municipality	Municipalities of Sweden
Lockheed F-117 Nighthawk	United States Air Force aircraft, Lockheed & Lockheed-Martin aircraft
Vindeln Municipality	Municipalities of Sweden
Degerfors Municipality	Municipalities of Sweden
Söderköping Municipality	Municipalities of Sweden
Oxelösund Municipality	Municipalities of Sweden
Kristinehamn Municipality	Municipalities of Sweden
Katrineholm Municipality	Municipalities of Sweden
Knivsta Municipality	Municipalities of Sweden, 2003 establishments in Europe
Percival Pembroke	Royal Air Force aircraft
Lotta på Liseberg	2004 establishments in Sweden, Music events, Television programs
Lohja	Cities in Finland, Municipalities of Uusimaa
Royal Aircraft Factory SE-5	British military aircraft, World War I aircraft
Calculating Infinity	1999 albums, Heavy metal albums
Sävsjö Municipality	Municipalities of Sweden
Västervik Municipality	Municipalities of Sweden
Vetlanda Municipality	Municipalities of Sweden
Oskarshamn Municipality	Municipalities of Sweden
Vimmerby Municipality	Municipalities of Sweden
Olofström Municipality	Municipalities of Sweden
Karlshamn Municipality	Municipalities of Sweden
Ronneby Municipality	Municipalities of Sweden
Arvika Municipality	Municipalities of Sweden
Arboga Municipality	Municipalities of Sweden
Boulton Paul Defiant	World War II British aircraft, Royal Air Force aircraft
Emmaboda Municipality	Municipalities of Sweden
Sunne Municipality	Municipalities of Sweden
Surahammar Municipality	Municipalities of Sweden
Hallstahammar Municipality	Municipalities of Sweden
Lindesberg Municipality	Municipalities of Sweden
Nora Municipality	Municipalities of Sweden
Stenungsund Municipality	Municipalities of Sweden
English Electric Lightning	Royal Air Force aircraft, British military aircraft, Saudi Arabia, Kuwait
Enköping Municipality	Municipalities of Sweden
Sigtuna Municipality	Municipalities of Sweden
Ockelbo Municipality	Municipalities of Sweden
Hudiksvall Municipality	Municipalities of Sweden
Ljusdal Municipality	Municipalities of Sweden
Hofors Municipality	Municipalities of Sweden
Bollnäs Municipality	Municipalities of Sweden
Nordanstig Municipality	Municipalities of Sweden
Öckerö Municipality	Municipalities of Sweden
Kramfors Municipality	Municipalities of Sweden
Berg Municipality	Municipalities of Sweden
Storuman Municipality	Municipalities of Sweden
Shemini Atzeret	Jewish festivals and holidays
Strömsund Municipality	Municipalities of Sweden
Bräcke Municipality	Municipalities of Sweden
Krokom Municipality	Municipalities of Sweden
Ragunda Municipality	Municipalities of Sweden
Arvidsjaur Municipality	Municipalities of Sweden
Arjeplog Municipality	Municipalities of Sweden
Jokkmokk Municipality	Municipalities of Sweden
Pajala Municipality	Municipalities of Sweden
Gällivare Municipality	Municipalities of Sweden
Älvsbyn Municipality	Municipalities of Sweden
Överkalix Municipality	Municipalities of Sweden
Övertorneå Municipality	Municipalities of Sweden
Bjurholm Municipality	Municipalities of Sweden
Åsele Municipality	Municipalities of Sweden
Dorotea Municipality	Municipalities of Sweden
Vilhelmina Municipality	Municipalities of Sweden
Sorsele Municipality	Municipalities of Sweden
Robertsfors Municipality	Municipalities of Sweden
Nordmaling Municipality	Municipalities of Sweden
Vännäs Municipality	Municipalities of Sweden
Norsjö Municipality	Municipalities of Sweden
Malå Municipality	Municipalities of Sweden
Katarina Church	Church of Sweden churches, Churches in Stockholm
Sofia Church	Church of Sweden churches, Churches in Stockholm
Maria Magdalena Church	Church of Sweden churches, Churches in Stockholm
William Scranton	1917 births, 2013 deaths, Deaths from cerebral hemorrhage, 1964 United States presidential candidates, Governors of Pennsylvania, United States representatives from Pennsylvania, United States Ambassadors to the United Nations, US Republican Party politicians, Politicians from Connecticut
Klara Church	Church of Sweden churches, Churches in Stockholm
Bradley Whitford	1959 births, Living people, American movie actors, American television actors, American stage actors, American voice actors, American journalists, Actors from Wisconsin, Writers from Wisconsin, People from Madison, Wisconsin, HuffPost writers and columnists
The Cabin in the Woods	2012 horror movies, 2010s monster movies, 2010s satirical movies, American ghost movies, American horror movies, American monster movies, American parody movies, American satirical movies, English-language movies, Zombie movies, Apocalyptic movies, Lionsgate movies
ParaNorman	2012 animated movies, 2012 comedy movies, 2012 horror movies, 2010s LGBT movies, 2010s monster movies, American animated movies, American comedy movies, American horror movies, American LGBT movies, American monster movies, Comedy horror movies, English-language movies, Ghost movies, LGBT comedy movies, Movies set in Massachusetts, Zombie movies
Richard III, Duke of Normandy	990s births, 1027 deaths, House of Normandy, Dukes and duchesses
Tabernacle	Old Testament
Non-conformism	Protestant Reformation, Church organization
Mora Church	Church of Sweden churches
Leksand Municipality	Municipalities of Sweden
Rättvik Municipality	Municipalities of Sweden
Munkfors Municipality	Municipalities of Sweden
Hedemora Municipality	Municipalities of Sweden
Smedjebacken Municipality	Municipalities of Sweden
Malung-Sälen Municipality	Municipalities of Sweden
Fagersta Municipality	Municipalities of Sweden
Filipstad Municipality	Municipalities of Sweden
Åmål Municipality	Municipalities of Sweden
Mellerud Municipality	Municipalities of Sweden
Putney	Putney
Kil Municipality	Municipalities of Sweden
Grums Municipality	Municipalities of Sweden
Forshaga Municipality	Municipalities of Sweden
Hagfors Municipality	Municipalities of Sweden
Torsby Municipality	Municipalities of Sweden
Storfors Municipality	Municipalities of Sweden
Eda Municipality	Municipalities of Sweden
Säffle Municipality	Municipalities of Sweden
Årjäng Municipality	Municipalities of Sweden
Hammarö Municipality	Municipalities of Sweden
Avesta Municipality	Municipalities of Sweden
Ludvika Municipality	Municipalities of Sweden
Gagnef Municipality	Municipalities of Sweden
Orsa Municipality	Municipalities of Sweden
English Electric Canberra	Royal Air Force aircraft, Australian military aircraft, British military aircraft
Vansbro Municipality	Municipalities of Sweden
Säter Municipality	Municipalities of Sweden
Älvdalen Municipality	Municipalities of Sweden
Kungsör Municipality	Municipalities of Sweden
Köping Municipality	Municipalities of Sweden
Sala Municipality	Municipalities of Sweden
Skinnskatteberg Municipality	Municipalities of Sweden
Norberg Municipality	Municipalities of Sweden
Sundbyberg Municipality	Municipalities of Sweden
Martin B-57 Canberra	Vietnam War aircraft, United States Air Force aircraft, Pakistan
Strängnäs Municipality	Municipalities of Sweden
Norrtälje Municipality	Municipalities of Sweden
Botkyrka Municipality	Municipalities of Sweden
Haninge Municipality	Municipalities of Sweden
Huddinge Municipality	Municipalities of Sweden
Salem Municipality	Municipalities of Sweden
Mjölby Municipality	Municipalities of Sweden
British Aircraft Corporation TSR-2	British military aircraft
Fieseler Fi 156 Storch	World War II German aircraft, German military aircraft
Dewoitine D.520	French military aircraft, World War II aircraft
Heby Municipality	Municipalities of Sweden
Tierp Municipality	Municipalities of Sweden
Östhammar Municipality	Municipalities of Sweden
Laxå Municipality	Municipalities of Sweden
Hällefors Municipality	Municipalities of Sweden
Ljusnarsberg Municipality	Municipalities of Sweden
Karkkila	Cities in Finland
Lekeberg Municipality	Municipalities of Sweden
Kumla Municipality	Municipalities of Sweden
Hallsberg Municipality	Municipalities of Sweden
Finspång Municipality	Municipalities of Sweden
Gullspång Municipality	Municipalities of Sweden
Flen Municipality	Municipalities of Sweden
Nokia, Finland	Towns in Finland
Todd Orlando	American ice hockey players, 1986 births, Living people
Rave	Music, Parties
I'm So Excited	2013 comedy movies, 2010s LGBT movies, Spanish movies, Spanish-language movies, Movies directed by Pedro Almodóvar
Sälen	Settlements in Dalarna County, Ski areas and resorts in Sweden
Boxholm Municipality	Municipalities of Sweden
The Other Woman (2014 movie)	2014 buddy movies, 2014 comedy movies, 2014 romance movies, 2010s romantic comedy movies, Adultery in movies, American buddy movies, American romantic comedy movies, Buddy comedy movies, English-language movies, Female buddy movies, 2010s feminist movies, Movies about revenge, Movies set in Connecticut, Movies set in Manhattan, The Bahamas
Vaxholm Municipality	Municipalities of Sweden
Nynäshamn Municipality	Municipalities of Sweden
Edge of Tomorrow	2014 action movies, 2014 science fiction movies, American action movies, American science fiction movies, English-language movies, Warner Bros. movies, Apocalyptic movies, Dystopian movies
Danderyd Municipality	Municipalities of Sweden
Gurdas Maan	1957 births, Living people, Punjabi people, Indian singers, Indian actors
Nacka Municipality	Municipalities of Sweden
Sollentuna Municipality	Municipalities of Sweden
Vallentuna Municipality	Municipalities of Sweden
Tyresö Municipality	Municipalities of Sweden
Ekerö Municipality	Municipalities of Sweden
Sölvesborg Municipality	Municipalities of Sweden
Järfälla Municipality	Municipalities of Sweden
Österåker Municipality	Municipalities of Sweden
Täby Municipality	Municipalities of Sweden
Värmdö Municipality	Municipalities of Sweden
Upplands Väsby Municipality	Municipalities of Sweden
Upplands-Bro Municipality	Municipalities of Sweden
Vingåker Municipality	Municipalities of Sweden
Sekai no Owari	Japanese rock bands
Trosa Municipality	Municipalities of Sweden
Gnesta Municipality	Municipalities of Sweden
Tokyo Broadcasting System	Japanese television networks
Celestial coordinate system	Coordinate systems, Astronomy
Essunga Municipality	Municipalities of Sweden
Vara Municipality	Municipalities of Sweden
Vadstena Municipality	Municipalities of Sweden
Ödeshög Municipality	Municipalities of Sweden
Åtvidaberg Municipality	Municipalities of Sweden
Kinda Municipality	Municipalities of Sweden
Ydre Municipality	Municipalities of Sweden
Varberg Municipality	Municipalities of Sweden
Falkenberg Municipality	Municipalities of Sweden
Hylte Municipality	Municipalities of Sweden
Kungsbacka Municipality	Municipalities of Sweden
Laholm Municipality	Municipalities of Sweden
Kungälv Municipality	Municipalities of Sweden
Mölndal Municipality	Municipalities of Sweden
Orust Municipality	Municipalities of Sweden
Tjörn Municipality	Municipalities of Sweden
Tjörn	Islands of Sweden
Värmdö	Islands of Sweden
Valdemarsvik Municipality	Municipalities of Sweden
Nybro Municipality	Municipalities of Sweden
Torsås Municipality	Municipalities of Sweden
Mönsterås Municipality	Municipalities of Sweden
Högsby Municipality	Municipalities of Sweden
Hultsfred Municipality	Municipalities of Sweden
Älmhult Municipality	Municipalities of Sweden
Alvesta Municipality	Municipalities of Sweden
Tingsryd Municipality	Municipalities of Sweden
Ljungby Municipality	Municipalities of Sweden
Lessebo Municipality	Municipalities of Sweden
Markaryd Municipality	Municipalities of Sweden
Strömstad Municipality	Municipalities of Sweden
Tanum Municipality	Municipalities of Sweden
Pays de Caux	Normandy, Geography of France
Pays de Bray	Normandy, Geography of France, Hauts-de-France
Israel National Trail	Geography of Israel, Trails
Cakka Nuraga	Indonesian singers, Child singers, 1998 births, Living people, Pop musicians, Rock musicians
Bocage	Geography of France, Landforms
International Academy of Architecture	Sofia, Non-profit organizations
World Architecture Festival	Festivals in Asia, Architecture, 2008 establishments, Events in Singapore
World Urbanism Day	Urban planning, Events
Kittur Chennamma	Indian people, Kings and queens, 1778 births, 1829 deaths, Resistance to the British Empire
Surface-mount technology	Electronics
Herzliya Interdisciplinary Center	Colleges and universities in Israel, 1994 establishments in Asia, 1990s establishments in Israel
University of Buenos Aires	Colleges and universities in South America, Buenos Aires
Through-hole technology	Electronics
Munkedal Municipality	Municipalities of Sweden
Lysekil Municipality	Municipalities of Sweden
Bengtsfors Municipality	Municipalities of Sweden
Örkelljunga Municipality	Municipalities of Sweden
Dals-Ed Municipality	Municipalities of Sweden
Färgelanda Municipality	Municipalities of Sweden
Sotenäs Municipality	Municipalities of Sweden
Lilla Edet Municipality	Municipalities of Sweden
Uddevalla Municipality	Municipalities of Sweden
Partille Municipality	Municipalities of Sweden
Ale Municipality	Municipalities of Sweden
Lerum Municipality	Municipalities of Sweden
Alingsås Municipality	Municipalities of Sweden
Filter (electronics)	Electronic circuits
Bjuv Municipality	Municipalities of Sweden
Ängelholm Municipality	Municipalities of Sweden
Eslöv Municipality	Municipalities of Sweden
Staffanstorp Municipality	Municipalities of Sweden
Trelleborg Municipality	Municipalities of Sweden
Bromölla Municipality	Municipalities of Sweden
Lund Municipality	Municipalities of Sweden
Lomma Municipality	Municipalities of Sweden
Osby Municipality	Municipalities of Sweden
Tomelilla Municipality	Municipalities of Sweden
Svedala Municipality	Municipalities of Sweden
Klippan Municipality	Municipalities of Sweden
Åstorp Municipality	Municipalities of Sweden
Kävlinge Municipality	Municipalities of Sweden
Östra Göinge Municipality	Municipalities of Sweden
Vellinge Municipality	Municipalities of Sweden
Båstad Municipality	Municipalities of Sweden
Burlöv Municipality	Municipalities of Sweden
Simrishamn Municipality	Municipalities of Sweden
Skurup Municipality	Municipalities of Sweden
Perstorp Municipality	Municipalities of Sweden
Highway 1 (Israel)	Roads in Israel, West Bank
Hässleholm Municipality	Municipalities of Sweden
Svalöv Municipality	Municipalities of Sweden
Höganäs Municipality	Municipalities of Sweden
Hörby Municipality	Municipalities of Sweden
Höör Municipality	Municipalities of Sweden
Sjöbo Municipality	Municipalities of Sweden
Highway 2 (Israel)	Roads in Israel
Tranemo Municipality	Municipalities of Sweden
Tibro Municipality	Municipalities of Sweden
Herrljunga Municipality	Municipalities of Sweden
Mark Municipality	Municipalities of Sweden
Svenljunga Municipality	Municipalities of Sweden
Grästorp Municipality	Municipalities of Sweden
Vårgårda Municipality	Municipalities of Sweden
Götene Municipality	Municipalities of Sweden
Töreboda Municipality	Municipalities of Sweden
Highway 20 (Israel)	Roads in Israel, Tel Aviv
Härryda Municipality	Municipalities of Sweden
Begin Road	Roads in Israel, Jerusalem, 1998 establishments in Asia, 1990s establishments in Israel
International Union of Architects	France, International organizations, Architecture
Benedicta Boccoli	1966 births, Living people, Actors from Milan, Italian movie actors, Italian stage actors
Tage Erlander	1901 births, 1985 deaths, Government ministers of Sweden, Prime Ministers of Sweden
Per Albin Hansson	1885 births, 1946 deaths, Government ministers of Sweden, Prime Ministers of Sweden
Rona Anderson	1926 births, 2013 deaths, Actors from Edinburgh, Actors from Ottawa, Deaths from natural causes, Scottish movie actors, Scottish stage actors, Scottish television actors, Scottish voice actors
Henryk Baranowski	1943 births, 2013 deaths, Polish movie actors, Polish television actors, Polish stage actors, Voice actors
Vickers Viscount	Civil aircraft, Transport in the United Kingdom
Bell P-59 Airacomet	Bell aircraft, World War II American aircraft, United States Air Force aircraft
Lockheed P-80 Shooting Star	United States Air Force aircraft, Lockheed & Lockheed-Martin aircraft
Dhaka High Court	Courts (law), Bangladesh, 1947 establishments in Asia, 20th century establishments in Bangladesh
Training aircraft	Aircraft
Caroline Aigle	1974 births, 2007 deaths, Deaths from melanoma, French aviators, French Air Force, Alumni of the École Polytechnique
Huun-Huur-Tu	1992 establishments in Asia, Russian musical groups
Guillermo Álvarez Guedes	1928 births, 2013 deaths, Business people, Comedians from Florida, Cuban actors, Disease-related deaths in the United States, American movie actors, Actors from Miami, Florida, Writers from Miami, Florida
Kim Novak	1933 births, Living people, Actors from Chicago, American movie actors, American stage actors, American television actors, American voice actors, Breast cancer survivors
Jobs (movie)	2013 movies, Steve Jobs, American biographical movies, American drama movies, English-language movies, American independent movies
Central bank	Banks, Government, Finance
Lateral line	Fish, Sensory system
Spherical coordinate system	Coordinate systems
Dan Schneider	1966 births, Living people, Writers from Memphis, Tennessee, American screenwriters, American television producers
Safety boot	Footwear
National anthem of South Africa	South Africa, National anthems
Rainer Maria Rilke	1875 births, 1926 deaths, Austrian poets, Cancer deaths in Switzerland, Deaths from leukemia, Writers from Prague
Natsume Sōseki	1867 births, 1916 deaths, Japanese novelists, Writers from Tokyo
Cable tester	Measuring tools
Impedance matching	Electronics
Robert I, Duke of Normandy	1035 deaths, House of Normandy, Dukes and duchesses, Unexplained deaths, Year of birth unknown
Asa Butterfield	1997 births, Living people, Actors from London, English child actors, English movie actors, English television actors, People from Islington
Highway 4 (Israel)	Roads in Israel
Trans-Samaria Highway	Roads in Israel, West Bank
Trans-Israel Highway	Roads in Israel
List of French departments by population	Departments of France, France-related lists
Avro Shackleton	Royal Air Force aircraft
Ponthieu	Subdivisions of France, History of France, Provinces
Antonov An-22	Soviet & Russian aircraft, Civil aircraft, Soviet military aircraft
Hawker Tempest	Royal Air Force aircraft, World War II British aircraft, Hawker aircraft
Arrival of a Train at La Ciotat	1896, Short movies, French movies
John Graves (author)	1920 births, 2013 deaths, Deaths from natural causes, Writers from Fort Worth, Texas
Dassault Étendard IV	French military aircraft, Dassault Aviation
Squadron	Military terminology, Military aviation, Army, Navy, Air force
McDonnell Douglas F-15E Strike Eagle	United States Air Force aircraft
Douglas A-4 Skyhawk	United States Navy aircraft, United States Marine Corps aircraft, Vietnam War aircraft, Israel Defense Forces, Douglas aircraft
Douglas A-3 Skywarrior	United States Navy aircraft, Douglas aircraft, Vietnam War aircraft
Douglas B-66 Destroyer	United States Air Force aircraft, Douglas aircraft, Vietnam War aircraft
Dassault Super-Étendard	Dassault Aviation, French military aircraft
Abbeville	Communes in Somme, Subprefectures in France
AM-39 Exocet	Missiles, Military of France
Véhicule Blindé Léger	Military of France, Military transport
Subway Surfers	2012 video games, 3D platform games, Mobile games
Geographical Names Board of New South Wales	Geography of New South Wales
Candy Crush Saga	2012 video games
Rare	Video game companies, Companies of the United Kingdom
Emperor Takakura	Emperors of Japan, 1161 births, 1181 deaths
Lagan	Rivers of Sweden
Nissan (river)	Rivers of Sweden
Viskan	Rivers of Sweden
Ätran	Rivers of Sweden
Vaggeryd	Settlements in Jonkoping County
Malung	Settlements in Dalarna County
Gislaved	Settlements in Jonkoping County
Bad Piggies	Puzzle video games, Fictional pigs
Moscow Ring Road	Roads in Russia
Trans-Siberian Highway	Roads in Russia
Saint Petersburg Ring Road	Roads in Russia
Galvanic isolation	Electronics
Opto-isolator	Electronic components
Värnamo	Settlements in Jonkoping County
Insulator (electricity)	Electricity, Electronics
Sung Jae-ki	1967 births, 2013 deaths, Anti-Communists, Autobiographers, South Korean businesspeople, Civil rights activists, Human rights activists, South Korean politicians, Suicides by drowning, Suicides by jumping
Yakovlev Yak-38	Soviet military aircraft
Dipole speaker	Audio technology
Sommarkrysset	Music media, Djurgården, Television programs
Askola	Municipalities of Uusimaa
Bingolotto	Swedish television, Television game shows
Nordman	Swedish musical groups
Charles the Simple	870s births, 920s deaths, Kings and Queens of France, Carolingian dynasty
Jill Johnson	1973 births, Living people, Swedish singers, Country musicians
Cheung Chau	Geography of Hong Kong, Islands of China
Freda'	Swedish pop music groups, Musical groups established in 1983
Cantonese Wikipedia	Wikipedias, Websites established in 2006
Yakovlev Yak-3	Soviet military aircraft, World War II aircraft
Robert Curthose	1050s births, 1134 deaths, House of Normandy
Push-pull aircraft	Aircraft
October (album)	U2 albums, 1981 albums, Island Records albums, Rock albums, Punk albums
Pornainen	Municipalities of Uusimaa
Alavus	Cities in Finland
Virrat	Cities in Finland
Southeast Division (NBA)	National Basketball Association divisions
Piaggio P.180 Avanti	Civil aircraft, Italian aircraft
Battle of Shiloh	American Civil War battles, 19th century in Tennessee, 1862 in the United States, April events, Ulysses S. Grant
Panavia Tornado	British military aircraft, German military aircraft, Italian military aircraft
Electronic warfare	Military
Nippon Sei Ko Kai	Anglicanism
Hearse	Automobiles, Death customs
Shfela	Regions of Israel
Brunel University	Universities in London
Sharon plain	Regions of Israel, Plains
Hassan Ademov	1953 births, Living people, Bulgarian politicians
Alice Haldeman	1853 births, 1915 deaths, Deaths from pneumonia, American philanthropists, Businesspeople from Illinois
Charles Brenton Huggins	1901 births, 1997 deaths, Deaths from natural causes, Canadian scientists, Naturalized citizens of the United States, American physicians, Medical researchers, Scientists from Chicago, People from Nova Scotia, Nobel Prize in Physiology or Medicine winners, Canadian Nobel Prize winners, American Nobel Prize winners
Hugh Dempster	1900 births, 1987 deaths, Deaths from pneumonia, British movie actors, British stage actors, British television actors, British voice actors, Actors from London
James B. Bradwell	1828 births, 1907 deaths, Deaths from pneumonia, American lawyers, American judges, United States representatives from Illinois, People from Utica, New York
Thomas Reed (architect)	1817 births, 1878 deaths, Architects, Danish businesspeople
Glenn Plummer	Actors from Contra Costa County, California, 1961 births, Living people, American movie actors, American television actors, People from Richmond, California
Jacki Weaver	Australian movie actors, Australian television actors, Australian stage actors, 1947 births, Living people, Actors from Sydney
Glasnost	Mikhail Gorbachev, 1980s in the Soviet Union, Politics, Words
Nerve cord	Anatomy of the nervous system
Ion Creangă	Romanian writers, 1837 births, 1889 deaths, Autobiographers, Romanian social scientists
Vasile Alecsandri	Romanian politicians, Romanian writers, Romanian diplomats, 1821 births, 1890 deaths
Tower of Saviors	Mobile games
Outboard motor	Motors
Interest rate	Finance
Pirkka-Pekka Petelius	Finnish singers, 1953 births, Living people, Finnish movie actors
John Amis	1922 births, 2013 deaths, Deaths from natural causes, British radio personalities, Music critics, Writers from London, Television personalities from London
Invaders Must Die (song)	2008 songs
Junkers Ju 88	World War II German aircraft, German military aircraft
Grumman X-29	Aircraft, NASA, Grumman aircraft
General Atomics MQ-1 Predator	Unmanned aerial vehicles, United States Air Force aircraft
Avro 504	British military aircraft, World War I aircraft
Pica d'Estats	Pyrenees, Mountains of France, Occitanie
Treaty of Saint-Clair-sur-Epte	911, History of France, Treaties
Epte	Rivers of France, Normandy
Puzzle & Dragons	Mobile games
Electrostatic loudspeaker	Audio technology
Public address system	Electronics, Audio technology, Sound
Ion Luca Caragiale	Romanian writers, Romanian journalists, Poets, 1852 births, 1912 deaths
Amazing Alex	Puzzle video games
Tolleshunt Knights	Villages in Essex, Civil parishes in Essex
Woodham Mortimer	Villages in Essex, Civil parishes in Essex
Woodham Walter	Villages in Essex, Civil parishes in Essex
Canewdon	Villages in Essex, Civil parishes in Essex
Hullbridge	Villages in Essex, Civil parishes in Essex
Rawreth	Villages in Essex, Civil parishes in Essex
La Rosaleda	Football stadiums in Spain, Malaga
Little Burstead	Villages in Essex, Civil parishes in Essex
Lyriel	2000s establishments in Germany, 2003 establishments in Europe, German rock bands, Musical groups established in 2003, Musicians from North Rhine-Westphalia, 2000s German music groups, 2010s German music groups
Ramsden Bellhouse	Villages in Essex, Civil parishes in Essex
Kelvedon Hatch	Villages in Essex, Civil parishes in Essex
Mountnessing	Villages in Essex, Civil parishes in Essex
Stondon Massey	Villages in Essex, Civil parishes in Essex
West Horndon	Villages in Essex, Civil parishes in Essex
Shelland	Villages in Suffolk, Civil parishes in Suffolk
Richmond, North Yorkshire	Towns in North Yorkshire, Civil parishes in North Yorkshire
Bishop Auckland	Towns in County Durham, Civil parishes in County Durham
Todmorden	Towns in West Yorkshire, Civil parishes in West Yorkshire
William Clito	1100s births, 1128 deaths, Flanders, House of Normandy
Russell Howard	1980 births, Living people, British stand-up comedians, Comedians from Bristol, English television personalities
Horten	Municipalities of Norway, Cities in Norway
Alajärvi	Cities in Finland
Jakobstad	Towns in Finland, 1652 establishments, 17th century establishments in Finland, 1650s establishments in Europe
Stavanger	Stavanger
Geoffrey V, Count of Anjou	House of Plantagenet, Counts of Anjou, 1113 births, 1151 deaths
Chords Bridge	Bridges, Buildings and structures in Jerusalem, Transport in Israel
Delhi Ring Road	Roads in India, Delhi
Second Ring Road (Beijing)	Roads in China, Beijing, Transport in the People's Republic of China, 1980 establishments in Asia, 1980s establishments in China
Curtiss P-36 Hawk	World War II American aircraft, United States military aircraft
Ariège (river)	Rivers of France, Occitanie
Pretty Little Liars	2010 American television series debuts, 2017 American television series endings, 2010s American drama television series, 2010s mystery television series, 2010s teen television series, American LGBT television programs, American mystery television series, American teen drama television series, English-language television programs
Seremban	Cities in Malaysia, 1840 establishments, 1840s establishments in Asia, Establishments in Malaysia
Cliché	Figures of speech, Prose, Words
Seremban (district)	Malaysia
Division of Bruce	Electoral divisions of Australia, Victoria, Australia, 1955 establishments in Australia
Division of Calwell	Electoral divisions of Australia, Victoria, Australia, 1984 establishments in Australia
Division of Casey	Electoral divisions of Australia, Victoria, Australia, 1969 establishments in Australia
Division of Chisholm	Electoral divisions of Australia, 1949 establishments in Australia
Paint.net	Graphics software
Division of Corangamite	Electoral divisions of Australia, Geelong, 1901 establishments in Australia
Division of Corio	Electoral divisions of Australia, Geelong, 1901 establishments in Australia
Lee Kyu-wan	1862 births, 1946 deaths, South Korean politicians, Anti-Communists, Autobiographers
Division of Deakin	Electoral divisions of Australia, Victoria, Australia, 1937 establishments, 1930s establishments in Australia
Division of Dunkley	Electoral divisions of Australia, 1984 establishments in Australia
Arrondissements of the Ariège department	Arrondissements of France, Occitanie
Arrondissement of Foix	Arrondissements of France, Occitanie
Division of Gellibrand	Electoral divisions of Australia, 1949 establishments in Australia
William Adelin	1100s births, 1120 deaths, House of Normandy, Heirs apparent who never acceded
Australian Labor Party (Anti-Communist)	1955 establishments in Australia, 1978 disestablishments, 20th century disestablishments in Australia, Political parties in Australia
Division of Bass	Electoral divisions of Australia, Tasmania, 1903 establishments in Australia
Division of Braddon	Electoral divisions of Australia, Tasmania, 1955 establishments in Australia
Division of Denison	Former electoral divisions of Australia, Tasmania, 1903 establishments in Australia
Hanshin Tigers	Baseball teams, Baseball in Japan
Pontic Mountains	Mountains of Turkey, Mountain ranges
Oona O'Neill	1925 births, 1991 deaths, American people, Bermudian people, Cancer deaths in Switzerland, Deaths from pancreatic cancer, Naturalised citizens of the United Kingdom
SpongeBob's Last Stand	SpongeBob SquarePants episodes, 2010 television episodes
Tim M. Babcock	1919 births, 2015 deaths, Governors of Montana, US Republican Party politicians, Politicians from Minnesota, Lieutenant Governors of Montana
Joseph Cotten	1905 births, 1994 deaths, Deaths from pneumonia, Deaths from throat cancer, American movie actors, American television actors, American stage actors, American voice actors, American radio actors, Actors from Virginia
Gail Kobe	1931 births, 2013 deaths, Deaths from natural causes, American movie actors, American television actors, American stage actors, American voice actors, American television producers, Actors from Michigan
Lavasoa dwarf lemur	Lemuriformes, Mammals of Africa
North–South divide in the United Kingdom	Geography of the United Kingdom, Economy of the United Kingdom, History of the United Kingdom
William Orpen	Painters, People from the Republic of Ireland, 1878 births, 1931 deaths, Knights Commander of the Order of the Indian Empire
Atrium	Architecture
Mac App Store	Apple software
Black cockatoo	Cockatoos
Kota Baru	Capital cities in Malaysia
Malacca City	Capital cities in Malaysia
Johor Bahru	Capital cities in Malaysia
Kuala Terengganu	Capital cities in Malaysia
Kuantan	Capital cities in Malaysia
Kuching	Capital cities in Malaysia
Shah Alam	Capital cities in Malaysia
George Town, Penang	Capital cities in Malaysia
Ipoh	Capital cities in Malaysia
Alor Setar	Capital cities in Malaysia
Kangar	Capital cities in Malaysia
Baku Stock Exchange	Stock exchanges, 2000 establishments, Economy of Azerbaijan, Buildings and structures in Baku, 21st century establishments in Azerbaijan
Junkers Ju 52	World War II German aircraft, German military aircraft
Dassault Flamant	French military aircraft, Dassault Aviation, Vietnam War aircraft
Leksand	Settlements in Dalarna County
Leksand Church	Church of Sweden churches
Rättvik Church	Church of Sweden churches
Rättvik	Settlements in Dalarna County
Swedish Ice Hockey Association	1922 establishments in Sweden, Ice hockey in Sweden
Theodor Herzl	1860 births, 1904 deaths, Burials at Mount Herzl, Deaths from cardiovascular disease, Deaths from sclerosis, Hungarian Jews, Zionists
Arrondissement of Pamiers	Arrondissements of France, Occitanie
Arrondissement of Saint-Girons	Arrondissements of France, Occitanie
China National Highways	Roads in China
Urban Expressways (Japan)	Roads in Japan
Colon Cemetery	Havana, National cemeteries, 1876 establishments, Military monuments and memorials, 19th-century establishments in Cuba, 1870s establishments in North America
Anjou	History of France, Geography of France, History of England
Transfiguration	Gospels, Jesus Christ
National People's Army	East Germany, Military of Germany, 1956 establishments in Europe, 1950s establishments in Germany
Serse	Compositions by George Frideric Handel, 1730s operas, 1738
Land Forces of the National People's Army	East Germany, Military of Germany
Volksmarine	Navy, Military of Germany, 1956 establishments in Europe
Buddy Scott	1935 births, 1994 deaths, Deaths from stomach cancer, Cancer deaths in Chicago, Chicago blues musicians, Musicians from Mississippi, Musicians from Chicago
Barrett Deems	1914 births, 1998 deaths, Deaths from pneumonia, Infectious disease deaths in Chicago, American jazz musicians, American drummers, Musicians from Springfield, Illinois
Peter Novick	1934 births, 2012 deaths, Deaths from lung cancer, American historians, Writers from New Jersey, People from Jersey City, New Jersey
Junior Wells	1934 births, 1998 deaths, Deaths from lymphoma, Cancer deaths in Chicago, Burials at Oak Woods Cemetery, Chicago blues musicians, Singers from Memphis, Tennessee, Musicians from Memphis, Tennessee, Singers from Arkansas, Musicians from Arkansas
Filippo Taglioni	1777 births, 1871 deaths, Italian people, Choreographers
Auguste Vestris	1760 births, 1842 deaths, French choreographers, French ballet dancers
Division of Franklin	Electoral divisions of Australia, Tasmania, 1903 establishments in Australia
Division of Lyons	Electoral divisions of Australia, Tasmania, 1984 establishments in Australia
Central Bank of Azerbaijan	Banks, Economy of Azerbaijan, 1992 establishments in Azerbaijan, Buildings and structures in Baku
Harbin International Snow and Ice Festival	Festivals in Asia, Chinese culture, 1985 establishments in Asia, 1980s establishments in China
Division of Gippsland	Electoral divisions of Australia, Victoria, Australia, 1901 establishments in Australia
Division of Goldstein	Electoral divisions of Australia, Victoria, Australia, 1984 establishments in Australia
Linear independence	Linear algebra
Division of Blair	Electoral divisions of Australia, Queensland, 1998 establishments in Australia
Mary Kom	1983 births, Living people, Indian sportspeople, Boxers, Olympic bronze medalists
Count of Anjou	Counts of Anjou
Ingelger	880s deaths, Counts of Anjou, 9th century births
Tyndall effect	Light
Bandai-Azuma Roadway	Roads in Japan
Mid-Sea Road	Roads in Japan
Arrondissements of the Pyrénées-Orientales department	Arrondissements of France, Occitanie
Arrondissement of Céret	Arrondissements of France, Occitanie
Arrondissement of Perpignan	Arrondissements of France, Occitanie
Arrondissement of Prades	Arrondissements of France, Occitanie
East German mark	Former currencies of Europe, Economy of Germany, East Germany, 1948 establishments in Germany, 1990 disestablishments in Germany
Fulk I of Anjou	870s births, 940s deaths, Counts of Anjou
Charles University	Prague, Colleges and universities in Europe
Fanny Elssler	1810 births, 1884 deaths, Ballerinas, Austrian people
Wells Fargo	Banks of the United States, 1852 establishments in the United States, 1850s establishments in California
Division of Brand	Electoral divisions of Australia, Western Australia
Aji Pangeran Tumenggung Pranoto Airport	Airports in Asia, Transport in Indonesia, Buildings and structures in Indonesia
Morgan Stanley	Banks of the United States, 1935 establishments in the United States, 1930s establishments in New York (state)
Division of Canning	Electoral divisions of Australia, Western Australia, 1949 establishments in Australia
Bracket fungus	Fungi
Jelly fungus	Fungi
Stinkhorn	Fungi
Todd Graff	1959 births, Actors from New York City, American child actors, American screenwriters, American movie actors, American television actors, Living people, LGBT directors
Second Battle of Bull Run	American Civil War battles, 1862 in Virginia, August events
Cytotoxic T cell	blood cells, Immunology
Lockheed C-141 Starlifter	United States Air Force aircraft, Lockheed & Lockheed-Martin aircraft, Vietnam War aircraft
Fuji FA 200	Civil aircraft, Japan
War (U2 album)	U2 albums, 1983 albums, Island Records albums, Rock albums, Punk albums
Sweet roll	Sweet breads
Margaret Pellegrini	1923 births, 2013 deaths, Deaths from stroke, American movie actors, American television actors, Actors from Alabama, People from Tuscumbia, Alabama, People with dwarfism
Pterois	Teleosts
Viscount	History of Europe, Royalty and nobility, Titles
Division of Cowan	Electoral divisions of Australia, Western Australia, 1984 establishments in Australia
Division of Curtin	Electoral divisions of Australia, Western Australia, 1949 establishments in Australia
Lionel Rose	1948 births, 2011 deaths, Australian boxers, Australian of the Year Award winners, Indigenous Australian sportspeople, Members of the Order of the British Empire, Sportspeople from Victoria (Australia)
Malachi Favors	1927 births, 2004 deaths, Deaths from pancreatic cancer, Bassists, American jazz musicians, Musicians from Mississippi, Musicians from Chicago
R. Hunter Middleton	1989 births, 1985 deaths, Deaths from natural causes, American painters, Writers from Chicago, People from Glasgow
Povilas Tautvaišas	1916 births, 1980 deaths, Deaths from myocardial infarction, Lithuanian sportspeople, American chess players
Carl Wright (actor)	1932 births, 2007 deaths, Actors from Orlando, Florida, African-American movie actors, American radio personalities, Cancer deaths in Florida
Fulk II of Anjou	900s births, 960s deaths, Counts of Anjou
Morpho	Nymphalidae
Battle of Malvern Hill	American Civil War battles, 1862 in Virginia, July events
Northwest Division (NBA)	National Basketball Association divisions
Pacific Division (NBA)	National Basketball Association divisions
Southwest Division (NBA)	National Basketball Association divisions
Wells Fargo Center (Philadelphia)	Indoor arenas, Buildings and structures in Philadelphia, Pennsylvania
Protocol 41	Internet protocols
Castor and Pollux	People in Greek mythology, Roman mythology
Sodablasting	Cleaning tools
On Human Nature	Biology books, 1978 books
Geoffrey I, Count of Anjou	930s births, 980s deaths, Counts of Anjou
Bremach	Italian automobile companies, Trucks
Cessna T-41 Mescalero	United States Air Force aircraft, Cessna aircraft
Bell 47	Bell aircraft, Civil aircraft
List of heads of state of Libya	Heads of state of Libya, Lists of heads of state
List of heads of government of Libya	Prime Ministers of Libya, Lists of politicians
Ali Zeidan	1950 births, Living people, Kidnapped people, Prime Ministers of Libya
Air Forces of the National People's Army	Air forces, Military of Germany
Raúl Héctor Castro	1916 births, 2015 deaths, Governors of Arizona, Naturalized citizens of the United States, Ambassadors of the United States, US Democratic Party politicians
Guinevere	Arthurian legend
Scott Wilson (actor)	1942 births, 2018 deaths, Deaths from leukemia, Cancer deaths in Los Angeles, American movie actors, American television actors, American voice actors, American stage actors, Actors from Atlanta, Georgia
Dick Gregory	1932 births, 2017 deaths, African American comedians, African American writers, American civil rights activists, American critics, Businesspeople from Chicago, Businesspeople from Missouri, Cardiovascular disease deaths in Washington, D.C., Comedians from Chicago, Comedians from Missouri, Deaths from heart failure, Writers from St. Louis, Missouri, Writers from Chicago
Hip hop soul	Fusion music genres, Hip hop genres, R&B music
Order of Lenin	Soviet Union, 1930 establishments, 1991 disestablishments in the Soviet Union, Orders, decorations, and medals, 20th century establishments in the Soviet Union
Con Air	1997 crime movies, 1997 thriller movies, 1997 action movies, 1990s crime thriller movies, American action movies, American crime thriller movies, English-language movies
Saving Mr. Banks	2013 drama movies, 2010s biographical movies, American biographical movies, American drama movies, Disney movies, English-language movies, Movies set in the 1960s
Jokkmokk	Settlements in Norrbotten County
Skin graft	Surgery, Animal tissues
List of World Heritage Sites in Azerbaijan	Lists of World Heritage sites, World Heritage Sites in Azerbaijan
Nirodha	Buddhist terminology
Shahram Rostami	Year of birth missing (living people), Living people, Aviators, Generals, Iranian military people
Brookhaven, Georgia	2012 establishments in the United States, 21st-century establishments in Georgia (U.S. state), Cities in Georgia (U.S. state)
M129 Grenade launcher	Weapons
Russian literature	Russian literature
William P. Clark Jr.	1931 births, 2013 deaths, American judges, American Roman Catholics, Deaths from Parkinson's disease, Disease-related deaths in California, People from Oxnard, California, People from Ventura County, California, Politicians from California, Ranchers, United States Deputy Secretaries of State, United States National Security Advisors, United States Secretaries of the Interior, US Republican Party politicians
Haji (actress)	1946 births, 2013 deaths, Actors from Quebec, Canadian entertainers, Canadian movie actors, Canadian sex industry people, Erotic dancers
Russ Meyer	1922 births, 2004 deaths, Deaths from pneumonia, Deaths from Alzheimer's disease, American screenwriters, American cinematographers, American photographers, American editors, American movie actors, Movie directors from California, Movie producers from California, Businesspeople from Oakland, California, Writers from Oakland, California, Actors from Oakland, California
Public Enemies (2009 movie)	2009 movies, American biographical movies, American crime drama movies, Japanese movies, Movies set in the 1930s, Movies set in Chicago, Illinois, Movies shot in Chicago, Illinois, English-language movies, Movies directed by Michael Mann
Douglas Seale	1913 births, 1999 deaths, Deaths from pneumonia, English movie actors, English television actors, English stage actors, English voice actors, English radio actors, English movie producers, Movie directors from London, Actors from London
University of Paris	Colleges and universities in France, Paris, 1150s establishments, 12th century establishments in Europe, Establishments in France
Not Without My Daughter	1991 drama movies, American drama movies, Iran, Movies set in Michigan, Movies about domestic violence, Movies based on books, Movies based on real life events, Movies set in Iran, Movies set in the 1980s, Tehran, Multilingual movies, American independent movies
Heteropogon contortus	Poaceae
Bucheon	Cities in South Korea
Land reclamation	Geography
Jerry Maren	1920 births, 2018 deaths, American movie actors, American television actors, Actors from Boston, Massachusetts, Writers from Boston, Massachusetts, People with dwarfism, Deaths from heart failure, Deaths from dementia, Cardiovascular disease deaths in California
Ruth Duccini	1918 births, 2014 deaths, Deaths from natural causes, American movie actors, American television actors, Actors from Minnesota, Writers from Minnesota, People with dwarfism
University of Leicester	Universities in England, Leicester
International Planning History Society	History of urban planning, Urban planning organizations, 1974 establishments in England, Leicester, International organizations, Organisations based in England
Yukuhashi, Fukuoka	Towns in Fukuoka Prefecture
List of Atlantic hurricanes in the 18th century	Atlantic hurricane seasons, 18th century in North America
Crossing the Rubicon	Metaphors
Pico Ruivo	Mountains of Europe, Madeira Islands
Henry Polic II	1945 births, 2013 deaths, Deaths from cancer, American movie actors, American television actors, American stage actors, American voice actors, Actors from Pittsburgh, Pennsylvania
Prince Friso of Orange-Nassau	1968 births, 2013 deaths, Deaths in sport, Dutch businesspeople, Dutch royalty, Princes and princesses
Russell's paradox	Logical paradoxes, Set theory
Augusta Victoria Hospital	1907 establishments in Asia, Buildings and structures in Jerusalem, Hospitals in Israel, Mount of Olives, 1900s establishments in Israel
Fulk III of Anjou	970s births, 1040 deaths, Counts of Anjou
The Adventures of Tintin (movie)	2011 movies, 2010s action movies, 2010s adventure movies, 2010s mystery movies, American action movies, American adventure movies, American mystery movies, Movies directed by Steven Spielberg, Movies composed by John Williams, English-language movies, Movies set in deserts
Vasiliy Mihaylovich Peskov	1930 births, 2013 deaths, Russian writers, Russian journalists, Ecologists, Russian photographers, Unexplained deaths
Order of the Aztec Eagle	Orders, decorations, and medals, Mexican culture, 1933 establishments, 1930s establishments in Mexico
Division of Durack	Electoral divisions of Australia, Western Australia, 2008 establishments in Australia
Division of Gorton	Electoral divisions of Australia, Victoria, Australia, 2004 establishments in Australia
Measure	Basic English 850 words, VOA Special English words
Division of Holt	Electoral divisions of Australia, Victoria, Australia, 1969 establishments in Australia
James Dougherty (police officer)	1921 births, 2005 deaths, American police officers, People from Los Angeles, California, People from Texas, Deaths from leukemia
Division of Lingiari	Electoral divisions of Australia, Northern Territory, 2001 establishments in Australia
Sophie Germain prime	Number theory
Touraine	Geography of France, Pays de la Loire, Centre-Val de Loire
Emily Procter	1968 births, Living people, American movie actors, American television actors, Actors from Raleigh, North Carolina
Eve Hewson	1991 births, Living people, Irish movie actors, People from Dublin
Ali Hewson	1961 births, Living people, Activists, Irish businesspeople
Division of Solomon	Electoral divisions of Australia, Northern Territory, 2000 establishments in Australia
Izalco (volcano)	Volcanoes of North America, El Salvador
Madeiran wall lizard	Lizards
Moab	Ancient history, History of Jordan, Old Testament
Suffering	Life, Emotions, Pain, Ethics
The Defiant Ones	1958 drama movies, 1950s crime movies, American crime drama movies, English-language movies, Movies directed by Stanley Kramer
Penny Ur	Bilingualism and second language acquisition researchers, Linguists, Officers of the Order of the British Empire, Living people, 1944 births, British educators, English people
Feng shui	Chinese culture, Luck
Adam Rodríguez	1975 births, Living people, Actors from New York, People from Yonkers, New York
Exogeny	Earth sciences
Boeing E-6 Mercury	Boeing 707, United States Navy aircraft
Boeing E-3 Sentry	Boeing 707, United States Air Force aircraft
Fiat G.91	Italian military aircraft
Tonic immobility	Zoology, Ethology
God's Gonna Cut You Down	Johnny Cash songs, Folk music
Hurt (Nine Inch Nails song)	1996 songs, Johnny Cash songs, Songs about drugs, Nine Inch Nails
Folsom Prison Blues	1950s songs, Johnny Cash songs, Country songs, Songs written by Johnny Cash
Man in Black (song)	1971 songs, Johnny Cash songs, Country songs, Songs written by Johnny Cash
Kingsland, Arkansas	Cities in Arkansas
Vasoconstriction	Blood vessels
Jeannette Littlemore	Bilingualism and second language acquisition researchers, Linguists, Living people, Year of birth missing (living people)
Wish I Was Here	2014 movies, American comedy-drama movies, English-language movies, Movies set in Los Angeles, California
A Boy Named Sue	1969 songs, Country songs, American poems, Johnny Cash songs
Let It Be (song)	1970 songs, The Beatles songs
Escape from New York	1981 movies, Movies directed by John Carpenter, American science fiction movies, Movies set in New York City, English-language movies, Dystopian movies, American independent movies
Escape from L.A.	1996 movies, American science fiction movies, Movies directed by John Carpenter, Movies set in Los Angeles, California, English-language movies, Post-apocalyptic movies, Dystopian movies, Movies with underwater settings, American independent movies
Blue Jasmine	2013 drama movies, American drama movies, English-language movies, Movies directed by Woody Allen, American independent movies
The Thing (1982 movie)	1982 horror movies, 1982 science fiction movies, 1980s monster movies, 1980s science fiction horror movies, American monster movies, American movie remakes, American science fiction horror movies, Movies set in Antarctica, English-language movies, Movies directed by John Carpenter, Multilingual movies, Universal Pictures movies
Poseidon (movie)	2006 movies, 2000s disaster movies, 2000s movie remakes, American action movies, American disaster movies, American movie remakes, English-language movies, Movies directed by Wolfgang Petersen, Survival movies
Air Force One (movie)	1997 movies, American action movies, American thriller movies, Movies directed by Wolfgang Petersen, Movies composed by Jerry Goldsmith, English-language movies, Columbia Pictures movies, Political movies, Movies about terrorism, Movies set in Asia, Movies set in Russia, Movies set in Washington, D.C.
Triangular trade	Atlantic Ocean, History of colonialism, Trade, Economic history, Historic slave trade
Waistline (clothing)	Clothing
Heliocentrism	Solar System
Trance	Psychology, Words
Spitzer Space Telescope	Space telescopes
Age of the universe	Cosmology
Nominative case	Grammar
Genitive case	Grammar
NuSTAR	Space telescopes
Malahide	County Dublin, Settlements in the Republic of Ireland
Carmelo Flores Laura	1906 births, 2014 deaths, Bolivian people, Centenarians, Longevity claims
John Barry	1933 births, 2011 deaths, Deaths from myocardial infarction, English composers, People from Yorkshire
Olinguito	Mammals of South America, Carnivora
Jericho	Cities in the West Bank, Old Testament
Marvin Kaplan	1927 births, 2016 deaths, Deaths from heart failure, Cardiovascular disease deaths in California, American movie actors, American television actors, American voice actors, American stage actors, Actors from New York City
Lisa Robin Kelly	Actors from Connecticut, American movie actors, American television actors, Drug-related deaths in the United States, 1970 births, 2013 deaths
Earl Cameron	1917 births, 2020 deaths, Deaths from pneumonia, Bermudian people, British movie actors, British stage actors, British television actors, British voice actors, British centenarians, Actors who played in James Bond movies
Earl Stevick	1923 births, 2013 deaths, Bilingualism and second language acquisition researchers, Linguists, People from Sioux City, Iowa, Columbia University alumni
Bipolar junction transistor	Electronics
Death anniversary	Death customs, Confucianism, Chinese culture, Korean culture
Head teacher	Education occupations
Boinpalle	Villages in Andhra Pradesh
Computer assisted language learning	Learning, Computer science
Darwin's finches	Evolution, Passeriformes, Charles Darwin
York, Pennsylvania	Cities in Pennsylvania, County seats in Pennsylvania, 1741 establishments in the Thirteen Colonies, 18th-century establishments in Pennsylvania
Wilson's theorem	Number theory
Dolby Surround 7.1	Audio technology
List of Kojak episodes	Lists of television series episodes
The Top 100 Crime Novels of All Time	Lists of books, 19th century books, 20th century books, Crime fiction books
Penn's Creek Massacre	Massacres in the United States, 18th century in Pennsylvania, 1755
African art	Art, Africa
Showaddywaddy	People from Leicester, English pop music groups, 1970s British music groups
Dependent personality disorder	Personality disorders, Psychiatry
Fugue state	Disorders, Psychiatry
Marmaduke (movie)	20th Century Fox movies, American movies, Movies about dogs, Movies about cats, Movies set in California, Movies set in Kansas
Rachel Boston	1982 births, Living people, American television actors, American movie actors, Actors from Tennessee, People from Chattanooga, Tennessee
Pico do Fogo	Volcanoes of Africa, Geography of Cape Verde
Smith Wigglesworth	1859 births, 1947 deaths, English Protestants, Evangelists, Pentecostals, People from Yorkshire, Plumbers
Demographics of Azerbaijan	Azerbaijan, Demographics by country
Heidelberg Catechism	1563, Calvinism, Heidelberg, Protestant theology, Christian texts
Geoffrey II of Anjou	1006 births, 1060 deaths, Counts of Anjou
Celestial Navigations	American musical groups, New Age music
August Schellenberg	1936 births, 2013 deaths, Actors from Montreal, Actors from Toronto, American movie actors, American stage actors, American television actors, American voice actors, Canadian movie actors, Canadian stage actors, Canadian television actors, Canadian voice actors, Deaths from lung cancer
Douglas Fairbanks, Jr.	1909 births, 2000 deaths, Deaths from myocardial infarction, American movie actors, American television actors, American stage actors, American voice actors, American radio actors, American silent movie actors, Actors from New York City, Actors from Los Angeles, California, Actors from Paris, Actors from London
Christopher Isherwood	1904 births, 1986 deaths, Alumni of the University of Cambridge, American LGBT people, American novelists, American playwrights, Cancer deaths in the United States, Deaths from prostate cancer, English LGBT people, English novelists, English playwrights, Gay men, LGBT novelists, LGBT playwrights, Naturalized citizens of the United States, Writers from Cheshire
Paul Scofield	1922 births, 2008 deaths, Academy Award winning actors, Actors from Birmingham, Actors from Sussex, BAFTA Award winning actors, Cancer deaths in England, Deaths from leukemia, Disease-related deaths in Sussex, English movie actors, English stage actors, English television actors, English voice actors, Emmy Award winning actors, Golden Globe Award winning actors, Tony Award winning actors
Stanley Holloway	1890 births, 1982 deaths, English movie actors, English television actors, English stage actors, English radio actors, English voice actors, English poets, Actors from Essex, Actors from London, Comedians from London, Singers from London
Family International	Cults, 1968 establishments in the United States, Christian organizations based in the United States, New religious movements
Division of Berowra	Electoral divisions of Australia, New South Wales, 1969 establishments in Australia
Division of Hotham	Electoral divisions of Australia, Victoria, Australia, 1969 establishments in Australia
Condominium	Houses
American Swedish Institute	Minneapolis, Minnesota, Museums in the United States, 20th-century establishments in Minnesota
Geoffrey III, Count of Anjou	1040s births, 1096 deaths, Counts of Anjou
Ermengarde-Blanche of Anjou	1010s births, 1076 deaths, Dukes and Duchesses of Anjou
Division of Indi	Electoral divisions of Australia, Victoria, Australia, 1901 establishments in Australia
Division of Melbourne	Electoral divisions of Australia, Victoria, Australia, 1901 establishments in Australia
Division of Isaacs	Electoral divisions of Australia, Victoria, Australia, 1969 establishments in Australia
Castaways of the Flying Dutchman	Fantasy books, 2001 books
Division of Bradfield	Electoral divisions of Australia, New South Wales, 1949 establishments in Australia
Rolv Wesenlund	1936 births, 2013 deaths, Deaths from heart failure, Norwegian comedians, Norwegian movie actors, Norwegian television actors, Norwegian stage actors, Norwegian singers, Norwegian writers
Gabriel García Moreno	1821 births, 1875 deaths, Assassinated people, Presidents of Ecuador, People from Guayaquil
Vicente Rocafuerte	1783 births, 1847 deaths, Presidents of Ecuador, People from Guayaquil
José Joaquín de Olmedo	1780 births, 1847 deaths, Presidents of Ecuador, Vice Presidents of Ecuador, Mayors of Guayaquil
Vicente Ramón Roca	1792 births, 1858 deaths, Deaths from pneumonia, Presidents of Ecuador, People from Guayaquil
Manuel de Ascásubi	1802 births, 1876 deaths, Deaths from myocardial infarction, Presidents of Ecuador, People from Guayaquil, Vice Presidents of Ecuador
Diego Noboa	1789 births, 1870 deaths, Deaths from pneumonia, Presidents of Ecuador, People from Guayaquil
José María Urvina	1808 births, 1891 deaths, Deaths from natural causes, Presidents of Ecuador, People from Guayaquil
Francisco Robles	1811 births, 1893 deaths, Deaths from heart failure, Presidents of Ecuador, People from Guayaquil
Jerónimo Carrión	1804 births, 1873 deaths, Deaths from pneumonia, Presidents of Ecuador, People from Guayaquil, Vice Presidents of Ecuador
Pedro José de Arteta	1797 births, 1873 deaths, Deaths from myocardial infarction, Presidents of Ecuador, People from Quito, Vice Presidents of Ecuador
Television movie	Television movies
Juan Javier Espinosa	1815 births, 1870 deaths, Deaths from myocardial infarction, Disease-related deaths in Ecuador, People from Quito, Presidents of Ecuador
The Day After	English-language movies, 1983 movies, Television movies, Disaster movies, American television movies, American science fiction movies, Apocalyptic movies
Francisco León Franco	1832 births, 1880 deaths, Presidents of Ecuador, People from Quito, Vice Presidents of Ecuador
José Javier Eguiguren	1816 births, 1884 deaths, Presidents of Ecuador
Antonio Borrero	1827 births, 1911 deaths, Deaths from natural causes, Presidents of Ecuador, Vice Presidents of Ecuador
Ignacio de Veintemilla	1828 births, 1908 deaths, Deaths from heart failure, Presidents of Ecuador, People from Quito
Osvaldo Hurtado	1939 births, Living people, Presidents of Ecuador, Vice Presidents of Ecuador
Jaime Roldós Aguilera	1940 births, 1981 deaths, Aviation deaths, Presidents of Ecuador, People from Guayaquil
Guillermo Rodríguez	1924 births, Living people, Presidents of Ecuador
Otto Arosemena	1925 births, 1984 deaths, Accidental deaths from falls, Presidents of Ecuador, People from Guayaquil
Clemente Yerovi	1904 births, 1981 deaths, Deaths from heart failure, Politicians from Barcelona, Presidents of Ecuador
Carlos Julio Arosemena Monroy	1919 births, 2004 deaths, Deaths from natural causes, Presidents of Ecuador, People from Guayaquil, Vice Presidents of Ecuador
Camilo Ponce Enríquez	1912 births, 1976 deaths, Deaths from myocardial infarction, Presidents of Ecuador, People from Quito
Carlos Julio Arosemena Tola	1888 births, 1952 deaths, Deaths from stroke, Presidents of Ecuador, People from Guayaquil
Mariano Suárez Veintimilla	1887 births, 1980 deaths, Deaths from natural causes, Presidents of Ecuador, People from Quito
Carlos Mancheno Cajas	1902 births, 1996 deaths, Deaths from natural causes, Presidents of Ecuador
Division of Calare	Electoral divisions of Australia, New South Wales, 1906 establishments in Australia
Division of Charlton	Former electoral divisions of Australia, New South Wales, 1984 establishments in Australia
Mongolian Wikipedia	Wikipedias, Websites established in 2004
Harmonic analysis	Digital signal processing, Mathematical analysis
Frank Kameny	1925 births, 2011 deaths, American LGBT rights activists, Cardiovascular disease deaths in the United States, Gay men, LGBT people from New York, People from New York City
Carlos Alberto Arroyo del Río	1893 births, 1969 deaths, Deaths from pneumonia, Presidents of Ecuador, People from Guayaquil
Julio Enrique Moreno	1879 births, 1952 deaths, Deaths from myocardial infarction, Presidents of Ecuador
Andrés Córdova	1892 births, 1983 deaths, Deaths from natural causes, Presidents of Ecuador, People from Quito
Aurelio Mosquera	1883 births, 1939 deaths, Deaths from myocardial infarction, Presidents of Ecuador, People from Quito
Manuel María Borrero	1883 births, 1975 deaths, Deaths from natural causes, Presidents of Ecuador
Alberto Enríquez Gallo	1895 births, 1962 deaths, Deaths from stroke, Presidents of Ecuador, People from Quito
Federico Páez	1876 births, 1974 deaths, Deaths from natural causes, Presidents of Ecuador, People from Quito
Antonio Pons	1897 births, 1980 deaths, Deaths from pneumonia, Presidents of Ecuador, People from Quito
Abelardo Montalvo	1876 births, 1950 deaths, Deaths from heart failure, Presidents of Ecuador
Juan de Dios Martínez	1875 births, 1955 deaths, Presidents of Ecuador, People from Guayaquil
Alberto Guerrero Martínez	1878 births, 1941 deaths, Deaths from myocardial infarction, Presidents of Ecuador, People from Quito
Carlos Freile Larrea	1876 births, 1942 deaths, Deaths from stroke, Disease-related deaths in Ecuador, People from Quito, Presidents of Ecuador
Alfredo Baquerizo	1859 births, 1951 deaths, Deaths from natural causes, Presidents of Ecuador, People from Guayaquil, Vice Presidents of Ecuador
Luis Larrea Alba	1894 births, 1979 deaths, Deaths from pneumonia, Presidents of Ecuador, People from Guayaquil
Isidro Ayora	1879 births, 1978 deaths, Deaths from natural causes, Presidents of Ecuador, People from Guayaquil
Gonzalo Córdova	1863 births, 1928 deaths, Presidents of Ecuador, People from Quito
José Luis Tamayo	1858 births, 1947 deaths, Deaths from pneumonia, Presidents of Ecuador
Fulk IV, Count of Anjou	1040s births, 1090s deaths, Counts of Anjou
Leónidas Plaza	1865 births, 1932 deaths, Deaths from myocardial infarction, Presidents of Ecuador
Francisco Andrade Marín	1841 births, 1935 deaths, Deaths from pneumonia, Presidents of Ecuador, People from Guayaquil
Carlos Freile Zaldumbide	1851 births, 1928 deaths, Deaths from heart failure, Presidents of Ecuador
Emilio Estrada	1855 births, 1911 deaths, Deaths from heart failure, Presidents of Ecuador
Lizardo García	1844 births, 1927 deaths, Deaths from natural causes, Firefighters, People from Guayaquil, Presidents of Ecuador
Vicente Lucio Salazar	1832 births, 1896 deaths, Deaths from myocardial infarction, Presidents of Ecuador, People from Quito
Luis Cordero Crespo	1833 births, 1912 deaths, Deaths from pneumonia, Presidents of Ecuador, Poets
Antonio Flores Jijón	1833 births, 1915 deaths, Deaths from pneumonia, Presidents of Ecuador, People from Quito
Pedro José Cevallos	1830 births, 1892 deaths, Deaths from myocardial infarction, Presidents of Ecuador, People from Quito
José Plácido Caamaño	1837 births, 1901 deaths, Deaths from myocardial infarction, Presidents of Ecuador, Mayors of Guayaquil
The Angel's Command	2003 books, Fantasy books
Roots (TV miniseries)	1977 television series debuts, ABC network shows, Miniseries, Emmy Award winning programs, Golden Globe Award winners, Peabody Award winners, English-language television programs
Standing ovation	Non-verbal communication, Theater
Allendale, New Jersey	Boroughs in New Jersey, 1894 establishments in the United States, 1890s establishments in New Jersey
Momoiro Clover Z	Japanese musical groups, J-pop bands, Idol groups, 2008 establishments in Asia, 2000s establishments in Japan
Division of Chifley	Electoral divisions of Australia, New South Wales, 1969 establishments in Australia
Gaya College of Engineering	Bihar, Colleges and universities in India, 2008 establishments in India
Dota 2	2013 video games, Real-time strategy video games
Echium vulcanorum	Boraginaceae, Cape Verde
Rafael Carvajal	1818 births, 1881 deaths, Presidents of Ecuador, Vice Presidents of Ecuador
Adventures of Captain Marvel	1941 movies, English-language movies, Movie serials, Movies directed by William Witney, American superhero movies
Elmore Leonard	1925 births, 2013 deaths, American television writers, Cardiovascular disease deaths in the United States, Deaths from stroke, Disease-related deaths in Michigan, Screenwriters from Louisiana, Screenwriters from Michigan, Writers from Detroit, Michigan, Writers from New Orleans, Louisiana
Enoch	Old Testament people
Ted Post	1918 births, 2013 deaths, Deaths from natural causes, American television directors, Movie directors from New York, Movie producers from New York
Pupusa	El Salvador, Breads
Kate Wilson Sheppard	1847 births, 1934 deaths, People from Liverpool, Civil rights activists
Escape from Alcatraz (movie)	1979 movies, 1970s action movies, American thriller movies, American action movies, Movies directed by Don Siegel
Bill Gold	1921 births, 2018 deaths, Deaths from Alzheimer's disease, American artists, People from New York City
Whina Cooper	1895 births, 1994 deaths, Knights and Dames Commander of the Order of the British Empire, New Zealand Māori people
Ellen Albertini Dow	1913 births, 2015 deaths, Actors from Pennsylvania, American movie actors, American centenarians, American television actors
Westerly, Rhode Island	Towns in Rhode Island, 1669 establishments, 1660s establishments in the Thirteen Colonies
Atari 7800	Video game consoles, Atari hardware
Division of La Trobe	Electoral divisions of Australia, Victoria, Australia, 1949 establishments in Australia
Manila hostage crisis	2010 crimes, 2010s in Hong Kong, 2010s in the Philippines, 2010s murders in Asia, August events, Manila, Mass murder in Asia, Mass shootings in Asia, Mass shootings in the 2010s, Sieges
Graphic designer	Graphics, Design
Saintonge	Geography of France, Nouvelle-Aquitaine
Geoffrey II, Count of Gâtinais	1040s deaths, French nobility, Year of birth unknown, 1000s births
Populaire (movie)	2012 comedy movies, 2012 romance movies, 2010s romantic comedy movies, Belgian movies, French-language movies, French romance movies, Movies set in New York City, Movies set in the 1950s
Mehmed VI	1861 births, 1926 deaths, Sultans of the Ottoman Empire, Caliphs
Vienna Bend, Louisiana	Settlements in Natchitoches Parish, Louisiana, Census-designated places in Louisiana
Morelos Municipality, Coahuila	Municipalities of Coahuila
Municipalities of Campeche	Municipalities of Campeche
Syn (goddess)	Norse gods and goddesses
Gerðr	Norse gods and goddesses
Rindr	Norse mythology
Geoffrey IV, Count of Anjou	1070s births, 1106 deaths, Counts of Anjou
Erysimum caboverdeanum	Brassicaceae, Cape Verde
1999 Bridge Creek–Moore tornado	1999 disasters, 1999 in the United States, 20th century in Oklahoma, Tornadoes in the United States, May events
Division of Jagajaga	Electoral divisions of Australia, Victoria, Australia, 1984 establishments in Australia
Division of Mallee	Electoral divisions of Australia, Victoria, Australia, 1949 establishments in Australia
Division of Maribyrnong	Electoral divisions of Australia, Victoria, Australia, 1906 establishments in Australia
Division of McEwen	Electoral divisions of Australia, Victoria, Australia, 1984 establishments in Australia
Santorini caldera	Volcanoes of Europe, Mountains of Greece
Coptic language	Afroasiatic languages, Egypt, 17th-century disestablishments
Richard Warren	Mayflower passengers, 1580 births, 1628 deaths
Brian Sims	1978 births, Living people, American football players, LGBT people from Pennsylvania, Politicians from Pennsylvania, Gay men, LGBT politicians, LGBT sportspeople
Psychopathology	Medicine, Psychiatry, Psychology
Sid Bernstein	1918 births, 2013 deaths, Deaths from natural causes, People from New York City
Lee Thompson Young	1984 births, 2013 deaths, Actors who committed suicide, Actors from South Carolina, American movie actors, American television actors, American voice actors, Suicides in California
Nickelodeon (Italian TV channel)	Nickelodeon, Italy, 2004 establishments in Italy
Gyrocompass	Navigation, Tools
Division of McMillan	Former electoral divisions of Australia, Victoria, Australia, 1949 establishments in Australia
Michael Mifsud	1981 births, Living people, Maltese footballers
Division of Melbourne Ports	Former electoral divisions of Australia, Victoria, Australia, 1901 establishments in Australia
Coburger Hütte	Tyrol (state)
Seebensee	Lakes of Austria, Tyrol (state)
Lady with an Ermine	Paintings by Leonardo da Vinci, 15th century paintings
Mixed forest	Forests, Biomes
Ancient woodland	Forests of the United Kingdom, England
Bluebell wood	Forests of Europe, Flowers
Ardennes (forest)	Forests of Belgium, Forests of France, Geography of Belgium, Geography of Luxembourg, Grand Est, Hainaut (province), Liège (province), Luxembourg (Belgium), Mountain ranges, Mountains of Europe, Mountains of France, Namur (province), Wallonia
Ginevra de' Benci	Paintings by Leonardo da Vinci, 15th century paintings
Auguste Jean Baptiste Chevalier	Botanists, French botanists, Explorers, 1873 births, 1956 deaths
Fatin Shidqia	Indonesian singers, 1996 births, Living people, The X Factor contestants
Oh! Susanna	19th century American songs, Compositions by Stephen Foster
Pilliga forest	Geography of New South Wales, Forests of Australia, Protected areas of New South Wales
Beautiful Dreamer	19th century American songs, Compositions by Stephen Foster
Box-Ironbark forest	Ecosystems, Geography of Victoria, Australia, Forests of Australia
Ironbark	Trees of Australia, Eucalyptus
Belanglo State Forest	Protected areas of New South Wales, Forests of Australia
Wombat State Forest	Protected areas of Victoria (Australia), Forests of Australia
Kaiju	Movie characters, Monsters, Japanese culture
Liz Smith (actress)	1921 births, 2016 deaths, Actors from Lincolnshire, English movie actors, English stage actors, English television actors, English voice actors
Eileen Essell	1922 births, English movie actors, English television actors, English stage actors, English voice actors, Actors from London
Jetty Paerl	1921 births, 2013 deaths, Deaths from natural causes, Dutch singers, People from Amsterdam
Gilbert Taylor	1914 births, 2013 deaths, British cinematographers, Deaths from natural causes, People from Hertfordshire
Orville Redenbacher	1907 births, 1995 deaths, Deaths from myocardial infarction, Brazil, Indiana, Accidental deaths by drowning, American botanists, Businesspeople from Indiana
Tommy Chong	1938 births, Living people, Actors from Calgary, American activists, American movie actors, American movie directors, American musicians, American television actors, American television directors, American television writers, American voice actors, Canadian movie actors, Canadian movie directors, Canadian musicians, Canadian television actors, Canadian television directors, Canadian television writers, Canadian voice actors, Naturalized citizens of the United States, People with cancer
2012 (movie)	2009 movies, 2000s adventure movies, 2000s disaster movies, 2009 science fiction movies, American adventure movies, American disaster movies, American science fiction movies, Columbia Pictures movies, English-language movies, Movies directed by Roland Emmerich, Movies set in France, Movies set in Las Vegas, Movies set in London, Movies set in Los Angeles, California, Movies set in Nevada, Movies set in New York City, Movies set in Paris, Movies set in the United Kingdom, Movies set in Washington, D.C.
Băneasa Forest	Forests of Europe, Bucharest, Geography of Romania
Leith	Edinburgh, Ports and harbours of the United Kingdom
Mount Cole State Forest	Protected areas of Victoria (Australia), Forests of Australia
Royal forest	Forests of Europe, History of Europe
Lapiș Forest	Forests of Europe, Geography of Romania
Hürtgen Forest	Forests of Germany, Geography of North Rhine-Westphalia
Zitter Forest	Forests of Belgium, Forests of Germany, Geography of North Rhine-Westphalia, Liège (province), Wallonia
New Forest	Forests of the United Kingdom, South East England, National parks in the United Kingdom, 1079 establishments
High Wood	Forests of France, Somme, Hauts-de-France
Natural England	2006 establishments in the United Kingdom, Conservation organisations of the United Kingdom
Sclerophyll	Botany, Ecology
Chelsea Manning	1987 births, Living people, American criminals, American military people, American prisoners, LGBT military people, LGBT politicians, LGBT people from Oklahoma, Politicians from Oklahoma, Politicians from Maryland, US Democratic Party politicians, Transgender and transsexual people
Charnwood Forest	Forests of the United Kingdom, Leicestershire
Neil Hamilton (actor)	1899 births, 1984 deaths, American movie actors, American television actors, American stage actors, American voice actors, American radio actors, Actors from Massachusetts, Deaths from asthma, People from Lynn, Massachusetts
Alan Napier	1903 births, 1988 deaths, Actors from Worcestershire, Cardiovascular disease deaths in California, Deaths from stroke, English movie actors, English radio actors, English stage actors, English television actors, English voice actors
Cratfield	Villages in Suffolk, Civil parishes in Suffolk, Suffolk Coastal
Culpho	Villages in Suffolk, Civil parishes in Suffolk, Suffolk Coastal
Stafford Repp	1918 births, 1974 deaths, Deaths from myocardial infarction, American movie actors, American television actors, American stage actors, Actors from San Francisco
William Dozier	1908 births, 1991 deaths, Deaths from stroke, American movie actors, American television actors, American voice actors, American movie producers, American television producers, Actors from Omaha, Nebraska
Byron Keith	1917 births, 1996 deaths, Deaths from myocardial infarction, American movie actors, American television actors, American stage actors, Actors from Illinois
Madge Blake	1899 births, 1969 deaths, Deaths from myocardial infarction, American movie actors, American television actors, American stage actors, Actors from Kansas
Yvonne Craig	1937 births, 2015 deaths, Actors from Illinois, Actors from Columbus, Ohio, American dancers, American movie actors, American stage actors, American television actors, American voice actors, Ballerinas, Cancer deaths in Los Angeles, Deaths from breast cancer
Dallinghoo	Villages in Suffolk, Civil parishes in Suffolk, Suffolk Coastal
Bluebell	Asparagales
The World's End (movie)	2013 comedy movies, 2013 science fiction movies, British comedy movies, British science fiction movies, American comedy movies, American science fiction movies, Japanese movies, Apocalyptic movies, Post-apocalyptic movies, Dystopian movies
Darsham	Villages in Suffolk, Civil parishes in Suffolk, Suffolk Coastal
Chã das Caldeiras	Calderas, Volcanoes of Africa, Geography of Cape Verde
Dennington	Villages in Suffolk, Civil parishes in Suffolk, Suffolk Coastal
Earl Soham	Villages in Suffolk, Civil parishes in Suffolk, Suffolk Coastal
Easton, Suffolk	Villages in Suffolk, Civil parishes in Suffolk, Suffolk Coastal
Oil sands	Geology, Oils
350.org	International environmental organizations, Organizations based in the United States
Fulk, King of Jerusalem	1090s births, 1143 deaths, Counts of Anjou, Crusaders, Kings and queens
Pacific Rim (movie)	2013 action movies, 2010s adventure movies, 2013 science fiction movies, American action movies, American adventure movies, American science fiction movies, English-language movies, Monster movies, Movies set in San Francisco, Warner Bros. movies, Movies directed by Guillermo del Toro, Apocalyptic movies, Dystopian movies
The Fifth Estate (movie)	2013 movies, American drama movies, American thriller movies
Julie Harris	1925 births, 2013 deaths, Actors from Massachusetts, Actors from Michigan, American movie actors, American stage actors, American television actors, American voice actors, Cardiovascular disease deaths in Massachusetts, Deaths from congestive heart failure, Emmy Award winning actors, Grammy Award winners, Kennedy Center honorees, People from Grosse Pointe, Michigan, Tony Award winning actors
Hepburn Regional Park	Protected areas of Victoria (Australia), Forests of Australia
Creswick Regional Park	Protected areas of Victoria (Australia), Forests of Australia
Canonical form	Mathematics
Enfield State Park	Protected areas of Victoria (Australia), Forests of Australia
Messmate	Trees of Australia, Eucalyptus
Eucalyptus viminalis	Trees of Australia, Eucalyptus
Eucalyptus dives	Trees of Australia, Eucalyptus
Eyke	Villages in Suffolk, Civil parishes in Suffolk, Suffolk Coastal
Falkenham	Villages in Suffolk, Civil parishes in Suffolk, Suffolk Coastal
Azerbaijani diaspora	Azerbaijani diaspora, Ethnic groups in Asia
Ermenonville Forest	Forests of France, Hauts-de-France
Forest of Tronçais	Forests of France, Auvergne-Rhône-Alpes
Numinbah Nature Reserve	Rainforests, World Heritage Sites in Australia, Protected areas of New South Wales, Forests of Australia
Iranian Azerbaijanis	Azerbaijani diaspora, Iran, Ethnic groups in Asia
Forest of Chaux	Forests of France, Bourgogne-Franche-Comté
Bois de Boulogne	Paris, Forests of France, Parks, 1850s establishments in France
Forest of Fontainebleau	Forests of France, Île-de-France
Caledonian Forest	Forests of the United Kingdom, Geography of Scotland
Friston	Villages in Suffolk, Civil parishes in Suffolk, Suffolk Coastal
Great Bealings	Villages in Suffolk, Civil parishes in Suffolk, Suffolk Coastal
Great Glemham	Villages in Suffolk, Civil parishes in Suffolk, Suffolk Coastal
Wildlife	Ecology
Chantilly Forest	Forests of France, Hauts-de-France
Man of Korea	South Korea, Civil rights, Human rights, Non-profit organizations of Asia, 2008 establishments in South Korea
Hasketon	Villages in Suffolk, Civil parishes in Suffolk, Suffolk Coastal
Hemley	Villages in Suffolk, Civil parishes in Suffolk, Suffolk Coastal
Fourier analysis	Functions and mappings
Cannock Chase	Staffordshire, Forests of the United Kingdom
Aleksandr Kokorin	1991 births, Living people, Russian footballers
Heveningham	Villages in Suffolk, Civil parishes in Suffolk, Suffolk Coastal
Hollesley	Villages in Suffolk, Civil parishes in Suffolk, Suffolk Coastal
Huntingfield	Villages in Suffolk, Civil parishes in Suffolk, Suffolk Coastal
Belarusian Wikipedia	Wikipedias
Punjabi Wikipedia	Wikipedias, Punjabi language
Summer Esperanto Study	Esperanto, Language education, Events
Redditch	Towns in Worcestershire
Rugby, Warwickshire	Towns in Warwickshire
Stafford	County towns in England, Towns in Staffordshire
Tamworth	Towns in Staffordshire, Non-metropolitan districts of Staffordshire
Burton upon Trent	Towns in Staffordshire, Market towns in England
Stone, Staffordshire	Towns in Staffordshire, Civil parishes in Staffordshire
Lothal	Archaeological sites in Asia, Ports and harbours, Cities in India, Settlements in Gujarat, 24th century BC
Kenilworth	Towns in Warwickshire, Civil parishes in England
Leek, Staffordshire	Towns in Staffordshire, Market towns in England, Civil parishes in Staffordshire
Droitwich Spa	Towns in Worcestershire, Civil parishes in England
Corby	Towns in Northamptonshire
Natchez, Mississippi	Cities in Mississippi, 1716 establishments in the Thirteen Colonies, Former United States state capitals, County seats in Mississippi
Heath	Habitats
Edward Herrera	1986 births, Living people, Maltese footballers
Justin Haber	1981 births, Living people, Maltese footballers
Loughborough	Towns in Leicestershire, Market towns in England
Kidderminster	Towns in Worcestershire
Barnard Castle	Towns in County Durham, Civil parishes in County Durham
Northallerton	Towns in North Yorkshire, Civil parishes in North Yorkshire
Mildenhall	Towns in Suffolk, Civil parishes in Suffolk
St Neots	Towns in Cambridgeshire, Civil parishes in Cambridgeshire
Iken	Villages in Suffolk, Civil parishes in Suffolk, Suffolk Coastal
Kettleburgh	Villages in Suffolk, Civil parishes in Suffolk, Suffolk Coastal
Knodishall	Villages in Suffolk, Civil parishes in Suffolk, Suffolk Coastal
Letheringham	Villages in Suffolk, Civil parishes in Suffolk, Suffolk Coastal
Levington	Villages in Suffolk, Civil parishes in Suffolk, Suffolk Coastal
Little Bealings	Villages in Suffolk, Civil parishes in Suffolk, Suffolk Coastal
Little Glemham	Villages in Suffolk, Civil parishes in Suffolk, Suffolk Coastal
Middleton, Suffolk	Villages in Suffolk, Civil parishes in Suffolk, Suffolk Coastal
Monewden	Villages in Suffolk, Civil parishes in Suffolk, Suffolk Coastal
Brandon, Suffolk	Towns in Suffolk, Civil parishes in Suffolk
Stoke Ash	Villages in Suffolk, Civil parishes in Suffolk
Count of Flanders	Counts and countesses of Flanders, History of France
Yvain	Arthurian legend, Characters in written fiction, Fictional knights
Michael Jackson's This Is It	2009 movies, Michael Jackson, American movies, Documentaries, Movies directed by Kenny Ortega
Mud (movie)	2012 drama movies, 2010s coming-of-age movies, American coming-of-age movies, American drama movies, Arkansas, English-language movies, American independent movies, Lionsgate movies
The Illinois	Skyscrapers in Chicago, Frank Lloyd Wright buildings
Mount Pearl	Cities in Newfoundland and Labrador
Corner Brook	1956 establishments in North America, Cities in Newfoundland and Labrador, 1950s establishments in Canada
Lelydorp	Cities in Suriname, Capital cities in South America
Parham	Villages in Suffolk, Civil parishes in Suffolk, Suffolk Coastal
Ramsholt	Villages in Suffolk, Civil parishes in Suffolk, Suffolk Coastal
Reform School Girl	Movies directed by Edward Bernds, English-language movies, 1957 drama movies, 1950s crime movies, Movies produced by American International Pictures
High School Hellcats	1958 movies, English-language movies, 1950s crime movies, American crime movies, Movies directed by Edward Bernds, Movies produced by American International Pictures
Fantastic Voyage	1966 movies, English-language movies, 1960s science fiction movies, Movies directed by Richard Fleischer, Adventure movies, 1960s drama movies
Beach Party	1960s musical movies, 1963 comedy movies, English-language movies, Movies produced by American International Pictures, American musical comedy movies, Movies directed by William Asher
Havelock Ellis	1859 births, 1939 deaths, English physicians, British psychologists, Sexologists, Sexual revolution, Writers from London
Oliver Twist (movie)	Movies based on books by Charles Dickens, English-language movies, Crime drama movies, 1948 movies, Movies directed by David Lean
Rendham	Villages in Suffolk, Civil parishes in Suffolk, Suffolk Coastal
Saxtead	Villages in Suffolk, Civil parishes in Suffolk, Suffolk Coastal
Ixelles Ponds	Ponds, Geography of Belgium, Brussels-Capital Region
Shottisham	Villages in Suffolk, Civil parishes in Suffolk, Suffolk Coastal
Snape, Suffolk	Villages in Suffolk, Civil parishes in Suffolk, Suffolk Coastal
Sternfield	Villages in Suffolk, Civil parishes in Suffolk, Suffolk Coastal
Sudbourne	Villages in Suffolk, Civil parishes in Suffolk, Suffolk Coastal
Sutton, Suffolk	Villages in Suffolk, Civil parishes in Suffolk, Suffolk Coastal
Theberton	Villages in Suffolk, Civil parishes in Suffolk, Suffolk Coastal
Thorington	Villages in Suffolk, Civil parishes in Suffolk, Suffolk Coastal
Tuddenham St. Martin	Villages in Suffolk, Civil parishes in Suffolk, Suffolk Coastal
Walberswick	Villages in Suffolk, Civil parishes in Suffolk, Suffolk Coastal
Walpole	Villages in Suffolk, Civil parishes in Suffolk, Suffolk Coastal
Westleton	Villages in Suffolk, Civil parishes in Suffolk, Suffolk Coastal
Santiago de Cuba	Cities in Cuba, 1515 establishments, Establishments in Cuba
Adlington	Towns in Lancashire, Civil parishes in England
Poltimore	Villages in Devon, Civil parishes in Devon, East Devon
Godmanchester	Towns in Cambridgeshire, Civil parishes in Cambridgeshire
PewDiePie	1989 births, People from Gothenburg, Swedish people, Swedish YouTubers, Living people
Gordon Kahn	American screenwriters, 1902 births, 1962 deaths
The Piano Guys	Musical groups from Utah, Classical music, 2010s American music groups
Holland, Michigan	Cities in Michigan
New City, New York	Hamlets in New York, County seats in New York
Curtido	Condiments, Salads
Old Chicago Main Post Office Redevelopment	Skyscrapers in Chicago, Proposed skyscrapers in the United States
Gerard Murphy (Irish actor)	1955 births, 2013 deaths, Actors from Northern Ireland, Cancer deaths in England, Deaths from prostate cancer, Irish movie actors, Irish stage actors, Irish television actors, Irish voice actors
Dauberval	1742 births, 1802 deaths, French ballet dancers, French choreographers
Cri-Cri	Fictional animals
Baldwin I, Count of Flanders	879 deaths, Counts and countesses of Flanders, 9th century births
List of mayors of Gotham City	DC Comics characters, Lists of fictional characters
The Windy Hill	1921 books, Newbery Honor books, Children's books
Cornelia Meigs	1884 births, 1973 deaths, Children's writers, Writers from Illinois, Biographers, American novelists
Armenians in Switzerland	Armenian diaspora, Switzerland
Double dissolution	Politics of Australia
Gall wasp	Wasps
André Schembri	1986 births, Living people, Maltese footballers
Steatorrhea	Diseases and disorders of the digestive system
Meijer	Companies of the United States
Rockland County, New York	New York (state) counties
Baldwin II, Count of Flanders	860s births, 910s births, Counts and countesses of Flanders
IPv4 address shortage	Internet protocols
Flan	Pies
Timbale (food)	Desserts
Upside-down cake	Cakes
Game pie	Savoury pies
Tappan Zee Bridge	Bridges in New York, Cantilever bridges, Steel bridges
Antipope Benedict XIII	Spanish popes, 1328 births, 1423 deaths, People from Aragon
Charles-Louis-Étienne Nuitter	1828 births, 1899 deaths, French people, Librettists
Arthur Saint-Léon	1821 births, 1870 deaths, French choreographers
Nephew and niece	Family
Rodan	Monsters, Godzilla, Fictional dinosaurs
Hungary in the Eurovision Song Contest 2009	2009 in Europe, Eurovision Song Contest, 21st century in Hungary
Arnulf I, Count of Flanders	890s births, 964 deaths, Counts and countesses of Flanders
Baldwin III, Count of Flanders	940s births, 960s deaths, Counts and countesses of Flanders
Emulsion	Physical chemistry
Aspall	Villages in Suffolk, Civil parishes in Suffolk, Mid Suffolk
Athelington	Villages in Suffolk, Civil parishes in Suffolk, Mid Suffolk
Badwell Ash	Villages in Suffolk, Civil parishes in Suffolk, Mid Suffolk
Baylham	Villages in Suffolk, Civil parishes in Suffolk, Mid Suffolk
Bedfield	Villages in Suffolk, Civil parishes in Suffolk, Mid Suffolk
Bedingfield	Villages in Suffolk, Civil parishes in Suffolk, Mid Suffolk
Firewood	Wood, Fuel
Steven Sharp Nelson	Living people, American cellists, American Latter Day Saints, Musicians from Salt Lake City, Utah, 1977 births
Goliath birdeater spider	Spiders
Elijah Muhammad	1897 births, 1975 deaths, African-American people, American civil rights activists, American Muslims, Converts to Islam, Deaths from congestive heart failure, Politicians from Georgia (U.S. state), Religious leaders
Malcolm X (1992 movie)	1992 movies, American biographical movies, American drama movies, United States National Film Registry movies, Movies set in Massachusetts, Movies set in New York City, Political movies
Judith, Countess of Flanders	840s births, 870s deaths, Counts and countesses of Flanders
Mechagodzilla	Monsters, Godzilla, Fictional robots, Fictional dinosaurs
Coupling constant	Quantum mechanics, Statistics
Latin dance	Latin dances
Arnulf II, Count of Flanders	960s births, 980s deaths, Counts and countesses of Flanders
Baldwin IV, Count of Flanders	980s births, 1035 deaths, Counts and countesses of Flanders
Ribozyme	RNA, Enzymes
Violin Concertos (Mozart)	Compositions by Wolfgang Amadeus Mozart, Violin concertos
Samurai Pizza Cats	Anime, Animated television series, 1990 television series debuts
Latte	Coffee
Adventure movie	Adventure movies, Movie genres
Fernand Léger	French painters, French sculptors, French filmmakers, 1881 births, 1955 deaths
Solomon R. Guggenheim Museum	Frank Lloyd Wright buildings, Museums in New York City, 1939 establishments in New York (state), Buildings and structures in Manhattan
Robie House	Frank Lloyd Wright buildings, Buildings and structures in Chicago, Illinois, Landmarks in Chicago, National Historic Landmarks of the United States, Houses in the United States, 1910 establishments in the United States, 1910s establishments in Illinois
Humberto Maturana	1928 births, Biologists, Systems scientists, 2021 deaths, Chilean scientists, Chilean writers, Philosophers, People from Santiago, Deaths from pneumonia
Spring Green, Wisconsin	Villages in Wisconsin, Sauk County, Wisconsin
Baldwin V, Count of Flanders	1012 births, 1067 deaths, Counts and countesses of Flanders
Weymouth, Massachusetts	Cities in Massachusetts, 1630 establishments in Massachusetts
Francisco Varela	1946 births, 2001 deaths, Biologists, Systems scientists, Chilean scientists
Angry Birds Toons	Animated television series, Finnish culture
Eustace I, Count of Boulogne	1049 deaths, Year of birth unknown
2012 Delhi gang rape	2012 in India, 2010s murders in Asia, December events, Delhi, Kidnapping, Murder in 2012, Murder in India, Rape
American Airlines Flight 587	2001 aviation disasters, 2001 in the United States, 2000s in New York City, Aviation disasters in the United States, November events, Queens (New York City)
La Cambre Abbey	1201 establishments, Abbeys, Buildings and structures in Belgium, Brussels-Capital Region, 1200s establishments in Europe
Altered state of consciousness	Consciousness
Tony! Toni! Toné!	American boy bands, American R&B bands, American pop music groups
Autopoiesis	Biology, Systems theory, Philosophy of science
Aloe	Asparagales
Baldwin VI, Count of Flanders	1030s births, 1070 deaths, Counts and countesses of Flanders
David Frost	1939 births, 2013 deaths, Comedians from Kent, Deaths from myocardial infarction, Deaths from cardiomyopathy, Emmy Award winners, English journalists, English television presenters, Officers of the Order of the British Empire, Television personalities from Kent, Writers from Kent
Battle of Cassel (1071)	1071, Battles involving France, Flanders, February events, Battles of the Middle Ages
Piano Concerto No. 20 (Mozart)	Compositions by Wolfgang Amadeus Mozart, Piano concertos
Words with Friends	2009 video games
Taliesin West	Frank Lloyd Wright, Buildings and structures in Arizona
Frank Lloyd Wright-Prairie School of Architecture Historic District	Frank Lloyd Wright buildings, Cook County, Illinois
Taliesin (studio)	Frank Lloyd Wright, Buildings and structures in Wisconsin
American Institute of Architects	Buildings and structures in Washington, D.C., Organizations in Washington, D.C., Architecture
Mort Walker	1923 births, 2018 deaths, Deaths from pneumonia, Disease-related deaths in Connecticut, American comics artists, American cartoonists, People from Kansas, People from Kansas City, Missouri
Orson Bean	1928 births, 2020 deaths, American movie actors, American television actors, American stage actors, American voice actors, American television presenters, American television personalities, Actors from Vermont, People from Burlington, Vermont
Charlestown, Rhode Island	Towns in Rhode Island, 1738 establishments, 1730s establishments in the Thirteen Colonies, 18th-century establishments in Rhode Island
Shahid Afridi	Living people, Pakistani people, Pashtun people, Pakistani cricketers, 1975 births, People from Karachi
Southern Connecticut State University	Colleges and universities in Connecticut, 1893 establishments in the United States, New Haven, Connecticut, 19th-century establishments in Connecticut
So Long, Frank Lloyd Wright	1970 songs, Frank Lloyd Wright
Unity Chapel	Churches in the United States, Frank Lloyd Wright, 1886 establishments in the United States, 1880s establishments in Wisconsin
Johnson Wax Headquarters	Buildings and structures in Wisconsin, Frank Lloyd Wright buildings, 1930s establishments in the United States
Larkin Administration Building	Buildings and structures in New York, Buffalo, New York, Frank Lloyd Wright buildings, 1906 establishments in the United States, 1900s establishments in New York (state)
Encopresis	Disorders
Antony Costa	1981 births, Living people, English singer-songwriters, English television actors, Singers from London
Harry Ferrier	1987 births, Living people, Welsh actors
With Blood Comes Cleansing	2005 establishments in the United States, 2000s American music groups, 2010s American music groups, 2010 disestablishments in the United States, Albany, Georgia, American heavy metal bands, Deathcore bands, Musical groups disestablished in 2010, Musical groups established in 2005
Ableism	Discrimination, Disability
Soledad Mexia	1899 births, 2013 deaths, American supercentenarians, Deaths from natural causes, People from San Diego, California, People from Sinaloa
Murray Gershenz	1922 births, 2013 deaths, Deaths from myocardial infarction, American movie actors, American television actors, Actors from New York City
Nintendo 2DS	Nintendo 3DS, Nintendo video game consoles
Xhosa people	Ethnic groups in Africa, South African people
Giuseppina Bozzacchi	Ballerinas, 1853 births, 1870 deaths, People from Milan
Lance Storm	1969 births, Canadian professional wrestlers, Former WWE wrestlers, Living people, Sportspeople from Ontario
Shoemaking	Footwear, Occupations
Dynamite Kid	1958 births, English professional wrestlers, Former WWE wrestlers, 2018 deaths
Motivation	Psychology
Gonadotropin-releasing hormone	Hormones
Southern hip hop	Hip hop genres
Ole Ernst	1940 births, 2013 deaths, Danish movie actors, Danish television actors, Danish stage actors, People from Copenhagen
Ronald Coase	1910 births, 2013 deaths, Alumni of the London School of Economics, British Nobel Prize winners, British educators, Deaths from natural causes, English centenarians, English historians, English scientists, Writers from Middlesex
Frederik Pohl	1919 births, 2013 deaths, Deaths from respiratory failure, Disease-related deaths in Illinois, American editors, Writers from New York City
Valérie Benguigui	1965 births, 2013 deaths, Actors from Paris, Cancer deaths in France, Deaths from breast cancer, French movie actors, French stage actors, French television actors
Soteriology	Theology
Developmental coordination disorder	Disability
Lance Bass	1979 births, Living people, Actors from Mississippi, American LGBT people, American pop musicians, American television producers, Gay men, LGBT singers, Musicians from Mississippi, NSYNC
Ian "H" Watkins	1976 births, Living people, Actors from Glamorgan, Celebrity Big Brother contestants, Gay men, LGBT actors, LGBT dancers, LGBT singers, Musicians from Glamorgan, Welsh pop singers
Mars Reconnaissance Orbiter	NASA spacecraft
Pippi Longstocking	Movie characters, Television characters, Characters in written fiction
Black Eye galaxy	Spiral galaxies
Centaurus A	Starburst galaxies
Marble Arch	Buildings and structures in London
Thou (unit)	Units of length, Imperial units
Knock Madness	2013 albums, Hip hop albums
Yard	Units of length, Imperial units
Shohreh Solati	1959 births, Living people, Iranian singers, People from Tehran
Godzilla (2014 movie)	2014 action movies, 2014 science fiction movies, 2010s adventure movies, American action movies, American adventure movies, American science fiction movies, English-language movies, Godzilla, MonsterVerse, Reboot movies, Warner Bros. movies, Movies about dinosaurs, Movies set in islands, Movies set in Japan, Movies set in Hawaii, Movies set in San Francisco, Apocalyptic movies
Anguirus	Monsters, Godzilla, Fictional dinosaurs
National Art Museum of Azerbaijan	Museums in Baku, Art museums, National museums in Asia, Buildings and structures in Baku, 1936 establishments in Asia, 20th century establishments in Azerbaijan
Antonino Rocca	1927 births, 1977 deaths, Infectious disease deaths in New York City, Professional wrestlers, Sportspeople from Veneto, WWE Hall of Fame
Brownian motion	1827, Albert Einstein, Basic physics ideas, Physics
University of New Haven	Colleges and universities in Connecticut, 1920 establishments in the United States, 20th-century establishments in Connecticut
Kylie (album)	Kylie Minogue albums, 1988 albums
Monster movie	Movie genres
The Beast from 20,000 Fathoms	1953 movies, Monster movies, 1950s science fiction movies, English-language movies, Warner Bros. movies
Transkei	History of South Africa
Xhosa language	Languages of South Africa, Niger-Congo languages
Thembu people	South African people, Ethnic groups in Africa
University of Fort Hare	Colleges and universities in South Africa
African National Congress Youth League	Nationalist organizations in South Africa, Nelson Mandela, Politics of South Africa, Youth organizations, 1944 establishments, 20th-century establishments in South Africa
Inkatha Freedom Party	Political parties in South Africa
Sit-ski	Skiing equipment
Mono-ski	Skiing equipment
Most distant things	Galaxies, Astronomy lists
Double play	Baseball
UDFj-39546284	Galaxies
Cypriniformes	Ray-finned fish
Googoosh	1950 births, Living people, Iranian singers, People from Tehran, Azerbaijani diaspora
Anthem of the Armenian Soviet Socialist Republic	History of Armenia, National anthems
University of Rhode Island	Colleges and universities in Rhode Island, 1892 establishments in the United States, 19th-century establishments in Rhode Island
Fluorescence	Light sources
Travesti	Theater, Gender
Greyfriars Bobby	Individual dogs, Edinburgh
Luminescence	Science, Light sources
Victim blaming	Psychology, Discrimination, Crime
Greyfriars Bobby (movie)	Disney movies, Movies about dogs, Movies based on books, 1961 movies, American family movies, English-language movies, Movies directed by Don Chaffey
Ambroise Vollard	1866 births, 1939 deaths, French businesspeople, French artists, Road accident deaths
Khomein	Cities in Iran, Capital cities in Asia, Markazi Province
Sorkheh	Cities in Iran, Semnan Province, Capital cities in Asia
Semnan Province	Semnan Province
Tommy Gunn	1967 births, Living people, Actors from New Jersey, American pornographic actors
Semnan, Iran	Cities in Iran, Semnan Province
Razavi Khorasan Province	Razavi Khorasan Province
List of monarchs of Wessex	Kings of Wessex, Lists of heads of state
South Khorasan Province	Provinces of Iran
North Khorasan Province	Provinces of Iran
Bojnord	Cities in Iran
Ardabil	Cities in Iran
Ardabil Province	Provinces of Iran
Sana'a Governorate	Governorates of Yemen
Al Hudaydah Governorate	Governorates of Yemen
Hajjah Governorate	Governorates of Yemen
Sa'dah Governorate	Governorates of Yemen
Greyfriars Kirkyard	Cemeteries, Edinburgh
Skye terrier	Terriers
B-25 Empire State Building crash	1945 in the United States, 1940s in New York (state), Aviation disasters in the United States, Disasters in the 1940s, History of Manhattan, 20th century in New York City, July events
Pulp fiction	Fiction books
Japanese occupation of Hong Kong	1941 establishments, 1945 disestablishments in Asia, 1940s in Japan, History of Hong Kong, World War II
2012 Lamma Island ferry collision	2012 disasters, Accidental deaths, 2010s in Hong Kong, Disasters in China, 2012 in Asia, 2010s in China
Anthony Di Pietro	1969 births, Living people, People from Melbourne, Australian businesspeople
Vitruvius	70s BC births, 1st century BC deaths, Roman people, Architects, Engineers
Red Lobster	American restaurants, 1969 establishments in the United States
Wankel engine	Machines, Propulsion
Parking lot	Road transport, Traffic
Voyage of Slaves	Fantasy books, 2006 books
Greek Orthodox Church	Eastern Orthodox Church, Greek culture
The Great Redwall Feast	Redwall, 1996 books
Lightsaber	Star Wars, Fictional weapons, Science fiction technology
Hartford Courant	Newspapers in the United States, Hartford, Connecticut, 1764 establishments in the Thirteen Colonies, 18th-century establishments in Connecticut
Biceps	Muscles, Limbs and extremities
Philanthropy	Society
Altenbrunslar	Villages in Hesse
Tatooine	Star Wars planets
Redhill, Surrey	Towns in Surrey
Redhill, Nottinghamshire	Villages in Nottinghamshire
Naboo	Star Wars planets
Redhill, Somerset	Villages in Somerset
Mercia	Anglo-Saxons, East Midlands, West Midlands (region)
Stormtrooper (Star Wars)	Fictional characters introduced in 1977, Star Wars characters
Cal Worthington	1920 births, 2013 deaths, American radio personalities, American television personalities, Deaths from natural causes, Businesspeople from Oklahoma
Concord, Massachusetts	Towns in Massachusetts, 1635 establishments, 1630s establishments in Massachusetts
Value judgement	Words, Psychology
Ski pole	Skiing equipment
Galapagos shark	Sharks
Abell 2029	Galaxy clusters
Ski bindings	Skiing equipment
Ski boots	Skiing equipment, Footwear
Slim Burna	1988 births, Living people, Hip hop musicians, Musicians from Essex, Nigerian singers, Pop musicians, Reggae musicians, Singers
Walking on Locusts	John Cale albums, 1996 albums
Paris 1919	John Cale albums, 1973 albums
Vintage Violence	John Cale albums, 1970 albums
Black Panties (R. Kelly album)	2013 albums, R&B albums
Vladimír Guma Kulhánek	1944 births, Living people, Czech musicians, Bass guitarists
Roman Dragoun	1956 births, Living people, Czech musicians, Keyboardists, Czech singers
Words for the Dying	John Cale albums, 1989 albums
Honi Soit	John Cale albums, 1981 albums
Slow Dazzle	John Cale albums, 1975 albums
Helen of Troy (album)	John Cale albums, 1975 albums
BlackAcetate	John Cale albums, 2005 albums
BCS National Championship Game	College football
Matt Harvey	1989 births, Living people, New York Mets players
Padmé Amidala	Fictional characters introduced in 1999, Star Wars characters
Chicharrón	Meat dishes, American food, Bolivian culture, Chilean food, Colombian food, Costa Rica, Cuban culture, Dominican Republic, Ecuador, Filipino culture, Guam, Guatemala, Honduran culture, Mexican food, New Mexico, Nicaraguan culture, Panamanian culture, Peruvian culture, Portuguese food, Spanish food, Uruguayan culture, Venezuelan food
Lyndon LaRouche	1922 births, 2019 deaths, 1976 United States presidential candidates, 1980 United States presidential candidates, 1984 United States presidential candidates, 1988 United States presidential candidates, 1996 United States presidential candidates, 2004 United States presidential candidates, American political activists, American political writers, American economists, Scientists from New Hampshire, US Democratic Party politicians, Writers from New Hampshire, Politicians from New Hampshire
Brooklyn College	Colleges and universities in New York City, 1930 establishments in the United States, Brooklyn, 1930s establishments in New York (state)
Macduff (Shakespeare)	Characters in Shakespeare's plays
River system	Drainage basins, Rivers
Battle of Buxar	British India, Mughal Empire, Bihar, Battles, 1764, 18th century in Asia, October events
Suffragette	First-wave feminism, Democracy movements, Women's suffrage
Music for a New Society	John Cale albums, 1982 albums
Technical writing	Prose, Communication
John Cale discography	Discographies
Multi-instrumentalist	Multi-instrumentalists
Fear (album)	John Cale albums, 1974 albums
Artificial Intelligence (album)	John Cale albums, 1985 albums
The Academy in Peril	John Cale albums, 1972 albums, Andy Warhol
Songs for Drella	John Cale albums, Lou Reed albums, 1990 albums
Lou Reed (album)	Lou Reed albums, 1972 albums
Transformer (album)	Lou Reed albums, 1972 albums
Sabotage/Live	John Cale albums, 1979 albums
Jardin des Plantes	Botanical gardens in Europe, Paris, Zoos
Class ring	Academia, Traditions
Joint Intelligence Committee	Intelligence agencies, Government of the United Kingdom
Tony Dungy	American football coaches, 1955 births, Living people, Sportspeople from Michigan, People from Jackson, Michigan
Oakland Alameda Coliseum	Stadiums in the San Francisco Bay Area, Major League Baseball venues, Football stadiums in the United States, Oakland Athletics, Sports in Oakland, California, 1966 establishments in California
George A. Miller	1920 births, 2012 deaths, American psychologists, Scientists from West Virginia, Writers from West Virginia, People from Charleston, West Virginia, Phrases
Astrophytum	Cactaceae
GRU	Soviet Union, Russia, Intelligence agencies, 1918 establishments in the Soviet Union, 1991 disestablishments in the Soviet Union
Balaclava	Protective clothing
John Cale Comes Alive	John Cale albums, 1984 albums
Taking Tiger Mountain (By Strategy)	Brian Eno albums, 1974 albums
Wrong Way Up	John Cale albums, Brian Eno albums, 1990 albums
Protective gear in sports	Sports equipment
Mobility aid	Disability, Medical equipment
Ski lift	Ski lifts, Machines
Ski instructor	Skiing, Sports occupations, Education occupations
Kellogg–Briand Pact	War, 1920s treaties, League of Nations
Guide skier	Skiing
Ski goggles	Skiing equipment, Protective clothing, Headgear
Ski suit	Skiing equipment, Protective clothing
Whistler Creekside	Ski areas and resorts in Canada, Settlements in British Columbia
2002 Winter Paralympics	2002 in sports, Sports in the United States, 2002 Winter Paralympics, History of Utah
2010 Winter Paralympics	Sport in British Columbia, 2010 Winter Paralympics
2006 Winter Paralympics	2006 in sports, 2006 Winter Paralympics, 2000s in Italy, Sport in Italy, March events, History of Turin
Paraplegia	Diseases and disorders
International Ski Federation	Skiing, Sports organizations
Punial State	Pakistani princely states, Former subdivisions of Pakistan, 1974 disestablishments, 1970s disestablishments in Asia
Athelred of Wessex	845 births, 871 deaths, Kings of Wessex
Bernard of Clairvaux	French Roman Catholics, Christian saints, French theologians, 1090 births, 1153 deaths
Aesculus indica	Plants and animals of Kashmir, Sapindaceae
Mini-bar	Machines, Alcoholic drink
Rhododendron ponticum	Plants and animals of Kashmir, Rhododendron
Otto Sander	1941 births, 2013 deaths, Deaths from cancer, German movie actors, German television actors, German voice actors, German stage actors, People from Hanover
274301 Wikipedia	Asteroids
Maladolescenza	1977 drama movies, 1970s romantic drama movies, Italian romance movies, Italian drama movies, German romance movies, German drama movies, Obscenity controversies
Crystallinity	Physical quantity
Mint (candy)	Candy
Virgin Islands	Caribbean islands
Raab	Cities and towns in Upper Austria
Ray Dolby	1933 births, 2013 deaths, Businesspeople from Portland, Oregon, American inventors, People with Alzheimer's disease, Cancer deaths in the United States, Deaths from leukemia
Délfor Dicásolo	1920 births, 2013 deaths, Deaths from natural causes, Argentine actors, Argentine artists, Argentine comedians, Argentine screenwriters, Writers from Buenos Aires
Coming to America	1988 movies, 1988 comedy movies, American comedy movies, Movies directed by John Landis, Movies set in Africa, Movies set in New York City
Nekromantik	1987 horror movies, German horror movies
Granary	Agricultural buildings
Silo	Agricultural buildings
Flag of Kazakhstan	National flags, Kazakhstan
Flag of Kosovo	National flags, Kosovo
Power County, Idaho	Idaho counties, 1913 establishments in Idaho
Oil-paper umbrella	Chinese culture
Deontological ethics	Ethics
Snow skin mooncake	Chinese food, Cakes
Pragmatic ethics	Ethics
Jon Philp	Living people, 1960 births, Ambassadors of Australia, People from Bangkok
Centre for Conflict and Peace Studies	Research organizations in Asia, International relations, 2006 establishments in Asia, Politics of Afghanistan, Kabul
Susan Cox	Year of birth missing (living people), Living people, Ambassadors of Australia
South Jeolla Province	Provinces of South Korea
Cheka	Intelligence agencies, Soviet Union, 1917 establishments in Europe, 1910s establishments in the Soviet Union
Jorge Pedreros	1942 births, 2013 deaths, Deaths from pneumonia, Chilean movie actors, Chilean television actors, Musicians, Comedians, People from Santiago
Das Boot	1981 drama movies, 1980s war movies, Epic movies, German drama movies, Movies based on books, Movies directed by Wolfgang Petersen, Movies with underwater settings, Movies set in the 1940s, World War II movies
Kigurumi	Entertainment
Hiiu County	Hiiu County
Harju County	Harju County
Rapla County	Counties of Estonia
Jean Dunn	Year of birth missing (living people), Living people, Ambassadors of Australia
Heidi Bootle	Australian diplomats, Living people, Year of birth missing (living people)
Agnes Monica	1986 births, Living people, Pop musicians, R&B musicians, Indonesian singers
Patricia Holmes	Living people, Year of birth missing (living people), Ambassadors of Australia
Libation	Death customs, Worship
Quantum foam	Quantum mechanics
Virtual learning environment	Learning, Technology
Semper Fidelis	19th century American songs, American marches, Compositions by John Philip Sousa, United States Marine Corps
Barclays Center	Sports buildings in New York City, Brooklyn, 2012 establishments in the United States, 2010s establishments in New York (state)
Meerut	Cities and towns in Uttar Pradesh
John Philip Sousa	1854 births, 1932 deaths, 20th century composers, American composers, American conductors, Musicians from Washington, D.C., United States Marine Corps personnel
The Stars and Stripes Forever	19th century American songs, American marches, Compositions by John Philip Sousa
The Washington Post (march)	19th century American songs, American marches, Compositions by John Philip Sousa
Lesse	Rivers of Belgium, Wallonia, Luxembourg (Belgium), Namur (province)
Melanie Klein	1882 births, 1960 deaths, Psychoanalysts, British scientists
Hawaiian religion	Culture of Hawaii, Religions, Religion in the United States
Chaplin (movie)	1992 comedy-drama movies, 1990s biographical movies, American biographical movies, American comedy-drama movies, Movies composed by John Barry, Movies directed by Richard Attenborough, Movies set in London, Movies set in the 1900s, Movies set in the 1910s, Movies set in the 1920s, Movies set in the 1930s, Movies set in the 1940s, Movies set in the 1950s, Movies set in the 1960s, Movies set in the 1970s, Swiss culture
Taps	19th century American songs
Orinoco	Rivers of Colombia, Rivers of Venezuela
Stock footage	Movie terminology
Children's Corner	Compositions by Claude Debussy, Solo piano pieces
The Afternoon of a Faun	Compositions by Claude Debussy, Orchestral works
Sylvia (ballet)	Ballets, Compositions by Léo Delibes
La Source	Ballets, Compositions by Léo Delibes
Eureka, California	Settlements in Humboldt County, California, Cities in California, County seats in California
A German Requiem	Compositions by Johannes Brahms
The Pearl Fishers	Compositions by Georges Bizet, Operas
Jeux d'enfants	Solo piano pieces, Compositions by Georges Bizet
Les Troyens	Compositions by Hector Berlioz, Operas
Bluebeard's Castle	1910s operas, Compositions by Béla Bartók, 1911 works
Twerking	Dances
Mamungkukumpurangkuntjunya Hill	Geography of South Australia, Hills, Pitjantjatjara
Church of Anthrax	John Cale albums, 1971 albums
Bayraklı	2008 establishments in Asia, Districts of Turkey
Chub (gay)	Gay slang
Agror	Valleys of Pakistan, Khyber Pakhtunkhwa
Henry Lau	1989 births, Living people, Singers from Toronto, K-pop singers
Flight of the Bumble Bee	Compositions by Nikolai Rimsky-Korsakov, Orchestral works
Scheherazade (Rimsky-Korsakov)	Compositions by Nikolai Rimsky-Korsakov, Orchestral works
Salome (opera)	Compositions by Richard Strauss, 1905 works, 1900s operas
Viqueque Municipality	Municipalities of East Timor
Theo Peckham	American Hockey League players, Canadian ice hockey defencemen, Chicago Blackhawks players, Edmonton Oilers players, Ice hockey people from Ontario, Living people, 1987 births, ECHL players, Ontario Hockey League players
William Tell Overture	Compositions by Gioachino Rossini, Overtures
Cinderella (opera)	Compositions by Gioachino Rossini, Operas
Valse triste	Compositions by Jean Sibelius, Waltzes
Violin Concerto (Sibelius)	Compositions by Jean Sibelius, Violin concertos
Mike Kostka	1985 births, American Hockey League players, Canadian ice hockey defencemen, Chicago Blackhawks players, Ice hockey people from Ontario, Living people, New York Rangers players, Tampa Bay Lightning players, Toronto Maple Leafs players
Fifty Shades of Grey (movie)	2015 romance movies, 2015 drama movies, 2010s romantic drama movies, American romantic drama movies, BDSM in movies, Controversies, English-language movies, Movies based on books, Movies set in Washington (U.S. state)
Juan dela Cruz	National personifications, Philippines
Juan dela Cruz (TV series)	2010s television series, Philippine television series, 2013 television series debuts, 2013 establishments in Asia, 2010s establishments in the Philippines, 2013 television series endings, 21st century disestablishments in Asia
Flag of the Philippines	Philippines, National flags
Bangsamoro Republik	2013 establishments in Asia, Philippines
Moro National Liberation Front	Islamic organizations, 1969 establishments in Asia, Nationalist organizations in Asia, Rebel militia groups in Asia, 1960s establishments in the Philippines
Marlon Stöckinger	Racecar drivers, 1991 births, Living people, Filipino sportspeople, People from Manila
ClariS	Girl groups, J-pop bands, 2009 establishments in Asia, Duos, People from Hokkaido, 2000s establishments in Japan
Philippine eagle	Birds of Asia, Philippines, Accipitriformes
Shifty Adventures in Nookie Wood	John Cale albums, 2012 albums
Battle of New Orleans	1814, 1815, 1810s in the United States, Andrew Jackson, Battles involving the United States, 19th century in Louisiana
Tlazolteotl	Aztec gods and goddesses
Washington Navy Yard shooting	2013 murders in the United States, 2010s in Washington, D.C., 2010s mass shootings in the United States, Crime in Washington, D.C., Massacres in the United States, Murders by firearm in the United States
Looper (movie)	2012 crime movies, 2012 thriller movies, 2010s crime thriller movies, 2010s action movies, 2012 science fiction movies, American action movies, American crime thriller movies, American science fiction movies, English-language movies, Dystopian movies, American independent movies
Roman house	Ancient Rome, Houses
Yomiuri Giants	Baseball teams, Baseball in Japan
Dili Municipality	Municipalities of East Timor
Turquoise-browed motmot	Coraciiformes, Birds of North America
Holyoke, Massachusetts	Cities in Massachusetts, 1745 establishments, 1740s establishments in the Thirteen Colonies, 18th-century establishments in Massachusetts
Nymphomaniac (movie)	2013 drama movies, 2010s LGBT movies, Adultery in movies, Belgian movies, Danish movies, English-language movies, French drama movies, German drama movies, Swedish movies, LGBT drama movies, LGBT erotic movies, Movies about virginity, Rape in movies, Movies directed by Lars von Trier, Movies about pedophilia
Lauren Bush	People from Denver, Colorado, Models from Houston, Texas, 1984 births, Living people
Greg Wilcock	Living people, Year of birth missing (living people), Ambassadors of Australia
Louise Hand	Year of birth missing (living people), Living people, Ambassadors of Australia
The Saint of Bleecker Street	Compositions by Gian Carlo Menotti, Stigmata, 1950s operas, 1954
Assemblywomen	Long words, Ancient Greece
Māori Wikipedia	Māori language
Night on Bald Mountain	Compositions by Modest Mussorgsky, Orchestral works
Iron deficiency anemia	Blood disorders
Romeo and Juliet (ballet)	Ballets, Compositions by Sergei Prokofiev
Jenůfa	1900s operas, Compositions by Leoš Janáček, 1904 works
L'Orfeo	Compositions by Claudio Monteverdi, 17th century operas
Il ritorno d'Ulisse in patria	Compositions by Claudio Monteverdi, 17th century operas
Dmitri Kulikov	Buffalo Sabres players, Florida Panthers players, Living people, Russian ice hockey players, Winnipeg Jets players, 1990 births
Archaeocyatha	Sponges
Fanfare for the Common Man	Compositions by Aaron Copland, Orchestral works
Rodeo (ballet)	Ballets, Compositions by Aaron Copland
List of figures in Greek mythology	Greek gods and goddesses, Lists of gods and goddesses
Land bridge	Landforms, Biology
Nathan MacKinnon	1995 births, Calder Trophy winners, Canadian ice hockey centres, Colorado Avalanche players, Ice hockey people from Nova Scotia, Living people, People from Nova Scotia, Quebec Major Junior Hockey League players, Memorial Cup winners
Invitation to the Dance	Compositions by Carl Maria von Weber, Solo piano pieces
Konzertstück in F minor	Compositions by Carl Maria von Weber, Piano concertos
Chaperone (protein)	Molecular biology, Proteins
Ribonuclease	Enzymes, RNA, Immunology
Baucau Municipality	Municipalities of East Timor
Illinois Secretary of State	Government of Illinois
Illinois Attorney General	Government of Illinois
Illinois Comptroller	Government of Illinois
Illinois Treasurer	Government of Illinois
Jesse White (politician)	1934 births, Living people, Politicians from Illinois, US Democratic Party politicians
Lieutenant Governor of Illinois	Lieutenant Governors of Illinois
Illinois House of Representatives	Government of Illinois, United States representatives from Illinois, State lower houses in the United States
Animal hoarding	Pets
Jesse White (actor)	1917 births, 1997 deaths, Deaths from myocardial infarction, Deaths from surgical complications, American movie actors, American television actors, American stage actors, American television personalities, Actors from Buffalo, New York, Actors from Akron, Ohio, Actors from Cleveland, Ohio
Lisa Madigan	1966 births, Living people, Politicians from Illinois, US Democratic Party politicians, State legislators of the United States
Sheila Simon	1961 births, Living people, Lieutenant Governors of Illinois, People from Carbondale, Illinois, Politicians from Springfield, Illinois, US Democratic Party politicians
Judy Baar Topinka	1944 births, 2014 deaths, Deaths from stroke, Politicians from Chicago, United States representatives from Illinois, US Republican Party politicians, State legislators of the United States
Dan Rutherford	1955 births, Living people, Politicians from Illinois, United States representatives from Illinois, US Republican Party politicians, State legislators of the United States
Michael Madigan	1942 births, Living people, State legislators of the United States, Politicians from Chicago, US Democratic Party politicians
The Evil Within	2014 video games, PlayStation 3 games, PlayStation 4 games, Windows games, Xbox 360 games, Xbox One games
Thematic map	Cartography
Fruit Ninja	2010 video games, Xbox 360 games, Windows games
David Luiz	1987 births, Living people, Brazilian footballers
Jack Wilshere	1992 births, Living people, English footballers, Arsenal F.C. players, Premier League players
Ruggero Leoncavallo	1857 births, 1919 deaths, Entertainers from Campania, Italian composers, Librettists, People from Naples
Pagliacci	Operas
Beorhtric of Wessex	Year of birth unknown, 800s deaths, Kings of Wessex
American Airlines Flight 191	1979 in the United States, Aviation disasters in the 1970s, 1970s in Illinois, Aviation disasters in the United States, May events
Ken Norton	1943 births, 2013 deaths, African-American boxers, Cardiovascular disease deaths in the United States, Deaths from heart failure, Sportspeople from Illinois
Marcel Reich-Ranicki	1920 births, 2013 deaths, Cancer deaths in Germany, Critics, Deaths from prostate cancer, Polish writers, Writers from Berlin
Michael Giannatos	1941 births, 2013 deaths, Actors from Istanbul, Deaths from myocardial infarction, Disease-related deaths in Greece, Greek actors, Television actors, Stage actors, Movie actors
Eiji Toyoda	1913 births, 2013 deaths, Japanese businesspeople, Deaths from natural causes, Japanese centenarians, Toyota, People from Aichi Prefecture
Erich Loest	1926 births, 2013 deaths, Writers who committed suicide, German writers, People from Saxony
Cynewulf of Wessex	Year of birth unknown, 780s deaths, Kings of Wessex
Mengjiang United Autonomous Government	Former countries in Asia, 1939 establishments, 1945 disestablishments in Asia, 20th century in Japan, 20th century in China, 20th century in Mongolia
Andrea Palladio	1508 births, 1580 deaths, Italian architects
Giovanni Battista Tiepolo	1696 births, 1770 deaths, 18th century Italian painters
Elegy for Brahms	Compositions by Hubert Parry, Orchestral works
Das Lied von der Erde	Compositions by Gustav Mahler, Orchestral works, Vocal music
Evaporating dish	Laboratory equipment
Muhammed Ahmed	Sudan, Religious leaders, 1845 births, 1885 deaths, Muslims
Sigeberht of Wessex	Year of birth unknown, 750s deaths, Kings of Wessex
Enrico Caruso	1873 births, 1921 deaths, Entertainers from Campania, Italian opera singers, People from Naples
David Wright (baseball)	New York Mets players, 1982 births, Living people, People from Norfolk, Virginia
Enough Said (movie)	2013 movies, American romantic comedy movies, 2010s romantic comedy movies
The Amazing Spider-Man 2	2014 action movies, 2014 science fiction movies, Movies composed by Hans Zimmer, English-language movies, Spider-Man movies, The Amazing Spider-Man (2012 movie series), 2010s superhero movies
Cuthred of Wessex	Year of birth unknown, 750s deaths, Kings of Wessex
2011 Joplin tornado	2011 in the United States, 2010s in Missouri, Tornadoes in the United States, 2011 in weather
Alex Henrique da Silva	1982 births, Living people, Armenian sportspeople, Brazilian footballers
São Miguel Island	Azores
Power forward (basketball)	Basketball
Tsubasa Imai	Singers from Kanagawa Prefecture, Japanese movie actors, Japanese voice actors, 1981 births, Living people
Hideaki Takizawa	1982 births, Living people, Actors from Tokyo, Musicians from Tokyo
Planets beyond Neptune	Solar System
Pietro Mascagni	1863 births, 1945 deaths, Italian composers, People from Livorno
Combat Zone Wrestling	1999 establishments in the United States, Professional wrestling promotions, Sports in Philadelphia, 1990s establishments in Pennsylvania
Jean de Venette	French historians, Monks, French writers, 1307 births, 1360s deaths
Athelheard of Wessex	Year of birth unknown, 740s deaths, Kings of Wessex
Blurred Lines (song)	2013 songs, Controversies, Funk songs, Plagiarism, Soul songs, Songs about sexuality, R&B songs
Arthus reaction	Immunology
Installation art	Art movements
Joakim Nordström	1992 births, American Hockey League players, Carolina Hurricanes players, Chicago Blackhawks players, Living people, Stanley Cup champions, Swedish ice hockey players, Swedish Hockey League players, Ice hockey centres
WataMote	Anime, 2013 television series debuts, 2013 establishments in Asia, 2010s establishments in Japan
Vampire Weekend	2006 establishments in New York (state), Indie rock bands, Musical groups established in 2006
Pentatomidae	Hemiptera
Draco (lawgiver)	Year of birth unknown, Year of death unknown, Ancient Greek politicians, People from Athens
Lunar Society	Members of the Lunar Society, Birmingham
Matthew Boulton	1728 births, 1809 deaths, British engineers, English businesspeople, People from Birmingham, Members of the Lunar Society, English inventors, Fellows of the Royal Society
Peasants' Revolt	14th century in England, 1381, Rebellions in Europe
Leas Cliff Hall	Kent, Concert halls in England
Dirty rap	Rap music
East Coast hip hop	Hip hop genres
Food photography	Photography, Food and drink
Ine of Wessex	Year of birth unknown, 720s deaths, Kings of Wessex
Hitachi	Companies of Japan, Manufacturing
Westgate shopping mall attack	Al-Shabaab (militant group), Attacks on buildings and structures in Africa, Attacks on buildings and structures in the 2010s, Attacks on shops, Islamic terrorist incidents in Africa, Islamic terrorist incidents in the 2010s, Mass murder in Africa, Mass murder in the 2010s, Mass shootings in Africa, Mass shootings in the 2010s, Murder in 2013, Nairobi, September events, Terrorist incidents in 2013, Terrorist incidents in Africa in the 2010s
Eurovision Song Contest 2014	2014 in Europe, 2014 in music, 2010s in Denmark, 21st century in Copenhagen, Eurovision Song Contest, May 2014 events
AMBER Alert	1996 establishments, Children, Emergency services, Law enforcement techniques, Kidnapping
Aníbal Cavaco Silva	1939 births, Living people, Presidents of Portugal, Prime Ministers of Portugal, Roman Catholics
Jalal Talabani	1933 births, 2017 deaths, Cardiovascular disease deaths in Germany, Deaths from cerebral hemorrhage, Deaths from stroke, Presidents of Iraq, Kurdish politicians, Prime Ministers of Iraq
British Darts Organisation	Sports organizations, Organisations based in the United Kingdom, 1973 establishments in Europe, Darts, 1970s establishments in the United Kingdom
Fishbourne Roman Palace	Buildings and structures in England, Ancient Rome, Archaeological sites in England
Bugsy Malone	1976 comedy movies, 1976 crime movies, 1970s musical movies, British criminal comedy movies, British family movies, British musical movies, English-language movies, Gangster movies, Movies set in New York City, Movies set in the 1920s, Movies directed by Alan Parker
Funk Volume	2009 establishments in California, Companies based in Los Angeles, Independent record labels
Sam Ruben	1913 births, 1943 deaths, Scientists from California, American biochemists
Eartham Pit, Boxgrove	Archaeological sites in England, West Sussex, Stone Age, Tools
Armide	17th century operas
Tartuffe	Plays by Molière
The Imaginary Invalid	Plays by Molière
The Misanthrope	Plays by Molière
Dom Juan	Plays by Molière
The Miser	Plays by Molière
Viktor Zinger	Soviet Olympic gold medalists, 1941 births, 2013 deaths, Russian ice hockey goaltenders
Les Précieuses ridicules	Plays by Molière
The Doctor in Spite of Himself	Plays by Molière
The School for Wives	Plays by Molière
The Learned Ladies	Plays by Molière
Le Bourgeois gentilhomme	Plays by Molière
Monsieur de Pourceaugnac	Plays by Molière
Extra-sensory perception	Occult, Pseudoscience
History of science	History of science
Lockheed T-33	United States Air Force aircraft, Lockheed & Lockheed-Martin aircraft
Fat Girl	2000s romantic drama movies, 2001 movies
Oras	Companies of Finland, 1945 establishments in Europe, 20th century establishments in Finland
Bath, Maine	Cities in Maine, County seats in Maine, 1780s establishments in the United States, 18th-century establishments in Maine, 1781 establishments in North America
Social isolation	Social sciences, Psychology
Runaway (dependent)	Family, Human behavior, Homelessness, Children
Warsaw Metro	Rail transport in Europe, Warsaw, Rapid transit systems
Water pollution	Water pollution
Treaty of Ghent	1810s treaties, 1810s in the United Kingdom, 1810s in the United States, 1814, Ghent
Heated shot	Ballistics
DMX	1970 births, 2021 deaths, Actors from New York, African American actors, African American musicians, American rap musicians from New York, Musicians from New York, People from Yonkers, New York, People from Mount Vernon, New York, Deaths from myocardial infarction, Drug-related deaths in the United States, Cardiovascular disease deaths in New York
Baliung River	Geography of Indonesia, Rivers of Asia
Al-Shabaab (militant group)	Al-Shabaab (militant group)
Patience	Emotions
Fan death	Superstitions, Death
Copenhagen Zoo	1859 establishments in Europe, Zoos, Buildings and structures in Denmark, Copenhagen, 19th century establishments in Denmark
Civil Registry and Identification Service of Chile	Government of Chile, Public services
Thomas Merton	Monks, 1915 births, 1968 deaths, American writers
Rauma	Cities in Finland
South Orange, New Jersey	Townships in New Jersey
Southern Methodist University	Colleges and universities in Texas, Dallas, Texas, American Athletic Conference
National Zoological Gardens of South Africa	Zoos, Pretoria
Ann C. Crispin	Writers from Connecticut, 1950 births, 2013 deaths, American science fiction writers, Deaths from cancer, People from Stamford, Connecticut
Moscow Zoo	Zoos, Buildings and structures in Moscow
Berlin Zoological Garden	Zoos in Germany, Buildings and structures in Berlin
Falco Lombardi	Fictional characters introduced in 1993, Nintendo video game characters, Star Fox
Afrosoricida	Mammals
Brookfield Place	Buildings and structures in Manhattan, 1988 establishments in the United States, 1980s establishments in New York (state)
Caedwalla of Wessex	650s births, 680s deaths, Kings of Wessex
Petting zoo	Zoos
De Havilland	Aircraft companies, Companies of the United Kingdom, 1920 establishments in the United Kingdom, 1964 disestablishments
Columbus Zoo and Aquarium	Zoos in the United States, Columbus, Ohio
Louis B. Mayer	1884 births, 1957 deaths, Academy Awards, American Jews, American movie producers, Belarusian Jews, Deaths from leukemia, Jewish businesspeople, Naturalized citizens of the United States, People from Minsk, Russian Jews
Hollywood blacklist	Discrimination, Movie industry, 20th century in the United States
Alan Parker	1944 births, 2020 deaths, Disease-related deaths in London, Academy Award winning directors, BAFTA Award winning directors, BAFTA Award winning writers, Commanders of the Order of the British Empire, Movie directors from London, Movie producers from London, People from Islington, Screenwriters from London
Aviary	Zoos, Birds, Animal enclosures
St. Peter's Square	Vatican City, National squares
Sandbar	Landforms
Old MacDonald Had a Farm	Children's songs
The Inheritors (novel)	1955 books, Fantasy books, William Golding
Wishing well	Superstitions
Who's Afraid of the Big Bad Wolf?	1933, 1930s songs
Franchot Tone	1905 births, 1968 deaths, American movie actors, American radio actors, American stage actors, American television actors, Deaths from lung cancer
Bird cage	Animal enclosures, Birds
Saint Sophia Cathedral in Harbin	Museums in China, Buildings and structures in China, Cathedrals, 1907 establishments in Asia, 20th century establishments in China
Henri Murger	Writers from Paris, 1822 births, 1861 deaths
Scènes de la vie de bohème	French novels, 1840s books
Luigi Illica	1857 births, 1919 deaths, Italian writers, Librettists
Giuseppe Giacosa	People from Turin, Librettists, Italian writers, 1857 births, 1906 deaths
Entrapment	Ethics, Law, Types of crime
Sos Sargsyan	1929 births, 2013 deaths, Deaths from myocardial infarction, Armenian actors, Armenian movie directors, Armenian writers, People from Yerevan
Tuskegee University	Colleges and universities in Alabama
Alawites	Islamic denominations, Syria
Sung Wong Toi	Hong Kong, Monuments and memorials
Umberto Giordano	1867 births, 1948 deaths, Italian composers, Italian people
Mutiny on the Bounty (1935 movie)	1935 movies, 1930s adventure movies, 1930s drama movies, American adventure movies, Movies based on books, Best Picture Oscar, English-language movies, Movies directed by Frank Lloyd
Omoseye Bolaji	1968 births, Living people, Nigerian writers, South African people
Lantau Island	Geography of Hong Kong, Islands of China
Christian terrorism	Christian terrorism
Orange Is the New Black	2013 American television series debuts, 2010s American comedy television series, 2010s American drama television series, 2010s LGBT television series, American comedy-drama television series, American crime drama television series, American LGBT television programs, LGBT comedy television series, LGBT drama television series, Television series set in New York, Transgender, Peabody Award winners, Netflix original shows
Charles Laughton	1899 births, 1962 deaths, Academy Award winners, Actors from Yorkshire, American LGBT people, American movie actors, American movie directors, American movie producers, American screenwriters, American television actors, Bisexual people, Cancer deaths in the United States, Deaths from kidney cancer, English LGBT people, English movie directors, English movie producers, English screenwriters, English television actors, LGBT actors, LGBT directors, Naturalized citizens of the United States, Best Actor Academy Award winners
The Hunchback of Notre Dame (1939 movie)	1939 movies, 1930s horror movies, 1930s drama movies, American horror movies, American drama movies, Movies based on books, English-language movies, Movies directed by William Dieterle
Balk	Baseball, Sports words
Ealdorman	Anglo-Saxons
Centwine of Wessex	Year of birth unknown, 680s deaths, Kings of Wessex
Les Misérables	1860s books, 19th century books, French novels, Works by Victor Hugo
Toilers of the Sea	French novels, Works by Victor Hugo, 1860s books
Taronga Zoo	Zoos in Australia, 1916 establishments, Buildings and structures in Sydney, 1910s establishments in Australia
Mario vs. Donkey Kong	2004 video games, Game Boy Advance games, Puzzle video games, Platform games, Mario video games, Donkey Kong, Virtual Console games, Virtual Console games for Wii U
Madame Bovary	1850s books, 1856, Adultery in fiction, Books first published in serial form, French novels, Suicide in fiction
Wii Party U	2013 video games, Wii U games, Party video games
Water Margin	Chinese novels, 14th century books
The Turn of the Screw	1890s books, American novels, Horror novels, Works by Henry James, English-language novels
The Portrait of a Lady	1880s books, 19th century American novels, English-language novels, Works by Henry James
Daisy Miller	1879 books, American novels, English-language novels, Works by Henry James
Colcannon	Irish culture, Foods
To Kill a Mockingbird (movie)	1962 drama movies, Academy Award winning movies, American drama movies, Movies based on books, Movies set in Alabama, Movies set in the 1930s, Rape in movies, Universal Pictures movies, Movies directed by Robert Mulligan, To Kill a Mockingbird
Lord Jim	Works by Joseph Conrad, 1900 books, Novels
Just So Stories	Works by Rudyard Kipling, British short stories, 1900s books, 1902 works, Children's books
Blind experiment	Experiments
Crossgates Commons	Buildings and structures in New York
St Paul's Suite	Compositions by Gustav Holst, Suites
First Suite in E-flat for Military Band	Compositions by Gustav Holst, Suites
Songs of a Wayfarer	Compositions by Gustav Mahler, Songs
The Marble Faun	American novels, Works by Nathaniel Hawthorne, 1860s books
Saint Francis of Assisi (opera)	20th century operas, 1983 works
Kaira	Gods and goddesses
Ledbury	Towns in Herefordshire
Ulgan	Gods and goddesses
Dalmatian City-states	History of Italy, Dalmatia
Battle of Palmito Ranch	1865 in the United States, 19th century in Texas, American Civil War battles, May events
Battle of Nashville	American Civil War battles, 1864 in the United States, History of Nashville, Tennessee, 19th century in Tennessee, December events
Interstate 787	Interstate Highways, Roads in New York
Interstate 890	Interstate Highways, Roads in New York
Parade Square	Warsaw, Buildings and structures in Poland, Town squares, National squares, 1955 establishments in Europe, 20th century establishments in Poland, 1950s establishments in the Soviet Union
Esau	Old Testament people
Arrondissements of the Haute-Garonne department	Arrondissements of France, Lists of arrondissements of France
Anthony of Padua	Christian saints, 1195 births, 1231 deaths, People from Lisbon, Franciscans
Goodnight Moon	1947 books, English-language picture books
Counselor	Psychology, Occupations
Harold and the Purple Crayon	1955 books, English-language picture books
Flag of Vietnam	National flags, Symbols of Vietnam
Joe Maddon	1954 births, Living people, Chicago Cubs managers, Tampa Bay Rays, Major League Baseball managers, Los Angeles Angels
Hurricane Ingrid	Hurricanes in Mexico, 2013 in weather, 2010s in Mexico
Antonio Ghislanzoni	1824 births, 1893 deaths, Italian writers
Baidu Baike	Websites, Encyclopedias, 2006 establishments in Asia
Culture of Nepal	Nepali culture
Surface water	Water
Nature photography	Photography, Life
Tetanurae	Carnosaurs
Fight Club (book)	1996 books, 20th century American novels, Dissociative identity disorder in fiction, English-language novels
St Augustine's Abbey	6th century establishments in England, Benedictine abbeys, Archaeological sites in England, Churches in England, World Heritage Sites in the United Kingdom, Museums in England, 1530s disestablishments, Ruins
G-Unit Records	American record labels, Hip hop
Yung Berg	Living people, 1986 births, African American musicians, Musicians from Chicago, American rap musicians from Illinois
Heart of a Dog	Russian novels, 1925 books, Books by Mikhail Bulgakov, Novels
Through the Looking-Glass	English novels, Books by Lewis Carroll, Fantasy books, Children's books, English-language novels, 1871 books
John Tenniel	1820 births, 1914 deaths, British illustrators
Project for Public Spaces	Urban planning organizations, Non-profit organizations of New York, 1975 establishments in New York (state), Organizations in New York City
Sylvie and Bruno	English novels, Fantasy books, Children's books, Books by Lewis Carroll, 1893 books, 1889 books
Association of Spanish Language Academies	Language regulators, Spanish language, Madrid, 1951 establishments
Académie française	Language regulators, French language, Buildings and structures in Paris, 1635 establishments, National academies, 1630s establishments in Europe, 17th century establishments in France
The Tale of Squirrel Nutkin	Beatrix Potter, Fantasy books, 1900s books, 1903, English-language picture books
The Story of Babar	Children's picture books, 1930s books, Books with jungle settings, Fantasy books, 1931 works
Central Hindi Directorate	Language regulators, Hindi, Buildings and structures in India
Russian Language Institute	Buildings and structures in Moscow, Language regulators, 1944 establishments in the Soviet Union
Australian Academy of Science	Buildings and structures in Canberra, National academies of sciences, 1954 establishments, Organisations based in Australia, Australian National Heritage List, 1950s establishments in Australia
Chinese Academy of Sciences	Beijing, National academies of sciences, 1949 establishments in Asia, 20th century establishments in China
Jerome	340s births, 420 deaths, Ancient Roman historians, Ancient Roman writers, Bible translators, Christian clergy, Christian saints, Christian theologians, Priests
Bell hooks	1952 births, Living people, African American writers, American feminist writers, American radical feminists, Writers from Kentucky
Great Smoky Mountains National Park	World Heritage Sites in the United States, National parks in the United States, Tennessee, Geography of North Carolina
Magna Graecia	History of Italy, Ancient Greece
Goody Two-Shoes	English-language novels, Children's books, 18th century books, 1765 works
Gloria E. Anzaldúa	1942 births, 2004 deaths, American feminist writers, American radical feminists, Deaths from diabetes, Disease-related deaths in Texas, Lesbian feminists, LGBT people from Texas, LGBT writers, Writers from Texas
Kalākaua	songwriters, 1836 births, 1891 deaths, Kings and queens, Knights Grand Cross of the Order of St Michael and St George, People from Hawaii, Native Hawaiians
Psychological abuse	Psychology
Anniversary	Days, Chronology, Holidays
Arrondissement of Muret	Arrondissements of France
Arrondissement of Saint-Gaudens	Arrondissements of France
Arrondissement of Toulouse	Arrondissements of France
San Luis Potosí, San Luis Potosí	Capital cities in Mexico, San Luis Potosí, 1592 establishments, 16th-century establishments in Mexico
Morelia	Michoacán, Capital cities in Mexico, 1541 establishments, 1540s establishments in Mexico
Wine (bishop)	year of birth unknown, 670s deaths, Christian religious leaders
As-Suwayda	Cities in Syria, Druze
Ar-Raqqah	Cities in Syria, 3rd-century BC establishments, Establishments in Syria
Al Mahwit Governorate	Governorates of Yemen
'Amran Governorate	Governorates of Yemen
Raymah Governorate	Governorates of Yemen
Táchira	States of Venezuela
Zulia	States of Venezuela
Cenwalh of Wessex	Year of birth unknown, 670s deaths, Kings of Wessex
Maracaibo	Cities in Venezuela, 1529 establishments, 16th-century establishments in Venezuela
Ricardo Montaner	1957 births, Living people, Venezuelan entertainers
Yaracuy	States of Venezuela
Apure	States of Venezuela
Rebecca Nurse	1621 births, 1692 deaths, Executed American people, People executed for witchcraft, People from Massachusetts, Salem Witch Trials
Food court	Restaurants
Walt Disney Studios Home Entertainment	1980 establishments in the United States, Companies based in California, Disney companies
List of North American Numbering Plan area codes	Telephone numbers in Canada, Telephone numbers in the United States, Canada-related lists, United States-related lists, Area codes
So Random!	2010s American television series, 2011 American television series debuts, American children's television series, Television spin-offs, Television series by Disney, Pages created with the Article Wizard, 2012 American television series endings, English-language television programs
Cwichelm of Wessex	Year of birth unknown, 630s deaths, Kings of Wessex
File hosting service	Internet, File sharing
Kamen Rider	Japanese television series, Children's television series, 1971 establishments in Asia, 1970s establishments in Japan
Holywell Green	Villages in West Yorkshire, Hamlets in England
Pihtipudas	Municipalities of Central Finland
Red River Parish, Louisiana	Red River Parish, Louisiana, 1871 establishments in the United States, 1870s establishments in Louisiana, Ark-La-Tex
Coronary artery bypass surgery	Surgery
Puck (Shakespeare)	Folklore, Characters in Shakespeare's plays
Shylock	Characters in Shakespeare's plays
Chico Albuquerque	1917 births, 2000 deaths, Brazilian photographers, Deaths from stroke, People from Fortaleza
Nicolas Poussin	1594 births, 1665 deaths, French painters
Yeongwol County	Counties, Subdivisions of South Korea
List of Lords Provost of Dundee	Dundee, Lists of politicians, Scottish politicians
Government shutdown in the United States	Government of the United States
Cynegils of Wessex	Year of birth unknown, 640s deaths, Kings of Wessex, 642 deaths, 7th century births, 7th century deaths, Anglo-Saxons, House of Wessex, Kings and Queens of England
Stingy Jack	Folklore, Irish culture, Fictional characters
Jimmy Hoffa	1913 births, 1975 deaths, Unsolved murders in the United States, Brazil, Indiana, American murder victims, People declared dead in absentia, Missing American people, American labor leaders, American political activists, People from Indiana
Foreign relations of Bangladesh	Foreign relations of Bangladesh
Edin Osmanović	1964 births, Living people, Slovenian footballers, Slovenian football managers
Folding-Fin Aerial Rocket	Weapons
Purple bacteria	Gram-negative bacteria
Jet fuel	Aviation, Fossil fuels
Stedman Graham	African-American people, American educators, Businesspeople from New Jersey, Living people, 1951 births
Juliet (Shakespeare)	Characters in Shakespeare's plays
Mercutio	Characters in Shakespeare's plays
Southwell, Nottinghamshire	Towns in Nottinghamshire
Nepal Bhasa Wikipedia	Wikipedias
Egyptian Arabic Wikipedia	Wikipedias, 2008 establishments
Oriya Wikipedia	Wikipedias, Websites established in 2002
Gewisse	Anglo-Saxons, Kings of Wessex
How Wikipedia Works	2008 books, Works about Wikipedia
Tituba	People from Massachusetts, 17th century births, Year of death unknown, Slaves, Salem Witch Trials
Caddo Parish, Louisiana	Caddo Parish, Louisiana, 1838 establishments in the United States, 1830s establishments in Louisiana
Edward Moss	1977 births, American comedians, American movie actors, American television actors, Living people, Actors from Los Angeles, California, Comedians from Los Angeles, California
Pulitzer Prize for Drama	Pulitzer Prizes
Friar Laurence	Characters in Shakespeare's plays
Titania (Shakespeare)	Characters in Shakespeare's plays, Folklore
James H. Billington	1929 births, 2018 deaths, Deaths from pneumonia, Disease-related deaths in Washington, D.C., American educators, People from Bryn Mawr, Pennsylvania, Politicians from Philadelphia, Pennsylvania, Writers from Philadelphia, Pennsylvania
George Soros	1930 births, Living people, American billionaires, American Jews, American philanthropists, American progressives, Businesspeople from London, Businesspeople from New York City, Democrats (United States), Holocaust survivors, Hungarian businesspeople, Hungarian Jews, Jewish billionaires, Jewish businesspeople, Jewish philanthropists, Naturalized citizens of the United States, People from Budapest
Chaim Topol	1935 births, Living people, Actors who played in James Bond movies, Golden Globe Award winning actors, Israeli Jews, Israeli movie actors, Israeli stage actors, Israeli television actors, Israeli voice actors, Jewish actors, People from Tel Aviv
Headquarters of the United Nations	United Nations, Buildings and structures in Manhattan
Sings the Ballads of the True West	Johnny Cash, 1965 albums
Coming Soon (1999 movie)	1999 romance movies, 1999 comedy movies, 1990s romantic comedy movies, American romantic comedy movies
Carlos Mencia	1967 births, Living people, American comedians, American movie actors, American television actors
The Man Comes Around (song)	2002 songs, Johnny Cash songs, Songs written by Johnny Cash
Ceolwulf of Wessex	Year of birth unknown, 610s deaths, Kings of Wessex
Bridget Sloan	1992 births, Living people, American gymnasts
Titration	Analytical chemistry
The Wikipedia Revolution	2008 books, Works about Wikipedia
Diderot effect	Sociology, Economics
Game Freak	1989 establishments in Asia, Video game companies, Companies of Japan, 1980s establishments in Japan
Christina Rossetti	English poets, 1830 births, 1894 deaths
Thanet	Thanet, 1974 establishments in England
Ocean gyre	Oceanography
Striptease (movie)	1996 comedy-drama movies, 1990s sex comedy movies, American comedy-drama movies, American sex comedy movies
Goderich, Ontario	Towns in Ontario, 1827 establishments, 1820s establishments in Canada
Davy lamp	Lamps
Substance abuse	Health problems, Drugs, Psychiatry
Lorde	1996 births, Entertainers from North Island, Feminists, Grammy Award winners, Living people, New Zealand singers, People from Auckland, Singer-songwriters
Britons (Celtic people)	Ethnic groups in Europe, History of the United Kingdom, Celtic peoples
Big Time Rush	American boy bands, American television series, Nickelodeon television series, English-language television programs
Clonazepam	Drugs, Drugs used in psychiatry
Tenant farming	Agriculture, Labor
Hope Springs (2012 movie)	2012 romance movies, 2012 comedy-drama movies, 2010s romantic comedy movies, 2010s romantic drama movies, American comedy-drama movies, American romantic comedy movies, American romantic drama movies, Movies set in Maine, Movies set in Nebraska, People's Choice Award winners
Mockbuster	Movies, Mockbuster movies
Ceol of Wessex	Year of birth unknown, 570s deaths, Kings of Wessex
Slavonic Orthodox	Eastern Orthodox Church
Characters in Romeo and Juliet	Characters in Shakespeare's plays, Lists of fictional characters
Gravity (2013 movie)	2013 drama movies, 2013 3D movies, 2013 science fiction movies, 2010s thriller movies, American drama movies, British drama movies, American science fiction movies, British science fiction movies, American thriller movies, British thriller movies, English-language movies, Warner Bros. movies, Movies directed by Alfonso Cuarón
The Million Second Quiz	2013 American television series debuts, 2010s American television series, NBC network shows, Television quiz shows, English-language television programs
The Ice Storm	1997 drama movies, Adultery in movies, American drama movies, English-language movies, Movies directed by Ang Lee, Movies set in Connecticut, Movies set in the 1970s, Screenplays by James Schamus
Edith Nesbit	English writers, 1858 births, 1924 deaths
Artemisia (movie)	1990s biographical movies, 1997 drama movies, 1997 movies, French drama movies, German drama movies, Italian drama movies, Movies directed by Agnès Merlet
C major	Musical keys, Major scales
Geoffroi de Charny	1300 births, 1356 deaths, French writers, Knights, Crusaders
Mixtape	Audio technology, Compilation albums
Caius (jurist)	Ancient Roman writers, Lawyers, 2nd century deaths, 2nd century births
Pascal's simplex	Mathematics
Corey Locke	Montreal Canadiens players, Canadian ice hockey centres, New York Rangers players, Ottawa Senators players, 1984 births, Sportspeople from Toronto, American Hockey League players, Living people, Ontario Hockey League players
Harrow (tool)	Agricultural machinery
Bell Labs	Research organizations in the United States, 1925 establishments in the United States
Ceawlin of Wessex	Year of birth unknown, 590s deaths, Kings of Wessex
Meet the Press	NBC network shows, American television talk shows, 1950s American television series, 1960s American television series, 1970s American television series, American television news programs, Black and white television series, NBC, Peabody Award winners, Radio programs, English-language television programs
MultiMediaCard	Storage devices
Gaius	Given names
Willa Ford	Musicians from Florida, Actors from Florida, Participants in American reality television series, 1981 births, Living people
Erin Wasson	People from Irving, Texas, Actors from Texas, Models from Texas, 1982 births, Living people
Mademoiselle	1935 establishments in the United States, 2001 disestablishments in the United States, American women's magazines, Fashion magazines
Don't Worry, Be Happy	Pop songs, 1988 songs
Crécy-en-Ponthieu	Communes in Somme
Sahti	Finnish culture, Beer
What's New Pussycat?	1960s romantic comedy movies, 1965 comedy movies, American romantic comedy movies, French romance movies, French comedy movies, Movies directed by Clive Donner
I'll Do Anything	1994 comedy-drama movies, American comedy-drama movies
Joely Fisher	American television actors, American movie actors, Actors from Burbank, California, 1967 births, Living people
Lighting	Light
Mamie Gummer	American television actors, American movie actors, Actors from New York, 1983 births, Living people
Cynric of Wessex	Year of birth unknown, 560s deaths, Kings of Wessex
Kendrick Lamar	1987 births, Living people, African American musicians, American rap musicians from California, Musicians from California, American Christians, American hip hop musicians, American songwriters, Brit Award winners, Grammy Award winners, People from Compton, California, Pulitzer Prize winners
The Chew	2011 American television series debuts, American television talk shows, ABC network shows, English-language television programs
Cooking show	Television programs, Cooking
Cerdic of Wessex	Year of birth unknown, 530s deaths, Kings of Wessex
Euler characteristic	Mathematics
Smith College	Colleges and universities in Massachusetts, 1871 establishments in the United States, Five Colleges, Incorporated, Oberlin Group of Libraries, 1870s establishments in Massachusetts
Oberon	Folklore, Characters in Shakespeare's plays
Howard the Duck	Comic books, Marvel Comics characters, Marvel Comics adapted into movies
Horchata	Drinks
Aescwine of Wessex	Year of birth unknown, 670s deaths, Kings of Wessex
Notre Dame Stadium	1930 establishments in the United States, Stadiums in the United States, Buildings and structures in Indiana, 20th-century establishments in Indiana
Makenzie Vega	Actors from Los Angeles, California, American television actors, American movie actors, 1994 births, Living people
The Road to Wellville	1994 comedy-drama movies, American comedy-drama movies, Movies directed by Alan Parker
Father of the Pride	American animated television series, English-language television programs, NBC network shows
Wine cellar	Wine, Rooms
Bukit Timah Nature Reserve	Geography of Singapore, Parks
Theresa Caputo	Living people, American television personalities, American comedians, American television actors, People from New York
Mrs. Parker and the Vicious Circle	1994 drama movies, 1990s biographical movies, American biographical movies, American drama movies, Movies directed by Alan Rudolph
Afternoon Delight	2013 comedy-drama movies, American comedy-drama movies, American independent movies
Cage (rapper)	1973 births, Living people, American rap musicians from New York, Musicians from New York, People from Würzburg
2013–14 Hull City A.F.C. season	2013 in association football, 2013 in England, 2014 in association football, 2014 in England, Football seasons, Kingston upon Hull
Rod Grams	1948 births, 2013 deaths, American radio personalities, Cancer deaths in Minnesota, Deaths from colorectal cancer, United States representatives from Minnesota, United States senators from Minnesota, US Republican Party politicians
Arrondissements of the Côte-d'Or department	Arrondissements of France
Agilbert	year of birth unknown, year of death unknown, Christian religious leaders
Nicholas Oresko	1917 births, 2013 deaths, Deaths from surgical complications, American military people, People from Bayonne, New Jersey
Siegfried & Roy	American movie actors, American magicians, Duos, Naturalized citizens of the United States, German actors, German entertainers, American television actors
Janet Yellen	1946 births, Living people, American chief executives, American economists, Bankers, Businesspeople from New York City, Chairs of the Federal Reserve, Democrats (United States), Jewish American academics, Jewish American politicians, Jewish businesspeople, Politicians from Brooklyn, United States Council of Economic Advisers, Yale University alumni, United States Secretaries of the Treasury
Thanks for Sharing	2013 comedy-drama movies, American comedy-drama movies, American independent movies, Lionsgate movies
List of road routes in New South Wales	Roads in Australia, New South Wales, Lists of roads
Fragile X syndrome	Syndromes, Autism, Genetic disorders
Maggie Siff	Actors from New York City, American television actors, American movie actors, 1974 births, Living people
Consumer protection	Commerce, Law
Lubricant	Oils, Materials
Depart From Me	2009 albums, Rap music
Picts	Celtic peoples, Ethnic groups in the United Kingdom, Scottish people
Young Buck	1981 births, Living people, African-American rappers, American rap musicians, Musicians from Nashville, Tennessee
Pennacook	Native American, Ethnic groups in the United States
Gordian I	159 births, 238 deaths, Roman Emperors, People who committed suicide
Mutya Keisha Siobhan	2011 establishments in England, 2010s British music groups, British girl groups, Musical groups established in 2011, Musical groups from London
Arrondissement of Beaune	Arrondissements of France
Canadian literature	Canadian culture, Literature by nationality
Ray Bolger	American dancers, American movie actors, Deaths from bladder cancer, Actors from Boston, Massachusetts, 1904 births, 1987 deaths
Jack Haley	Actors from Boston, Massachusetts, American dancers, Deaths from myocardial infarction, American movie actors, American singers, 1898 births, 1979 deaths
Bert Lahr	1895 births, 1967 deaths, Actors from New York City, Deaths from cancer, Vaudeville performers, American musical theatre actors, American movie actors
Billie Burke	1885 births, 1970 deaths, Actors from Washington, D.C., Deaths from natural causes, American stage actors, American movie actors, American television actors
Arrondissement of Dijon	Arrondissements of France
Arrondissement of Montbard	Arrondissements of France
Owain Glyndŵr	1350s births, 1410s deaths, Princes and Princesses of Wales, Welsh people
Marie Claire	1937 establishments in Europe, 1930s establishments in France, Fashion magazines, Monthly magazines
Tromsø	Tromsø
Principality of Capua	Former monarchies in Italy, Former principalities, States of the Holy Roman Empire, 9th century establishments in Europe, Establishments in Italy, 11th-century disestablishments, Disestablishments in Italy
Badulla District	Districts of Sri Lanka
Organisation for the Prohibition of Chemical Weapons	International organizations, 1997 establishments, The Hague, Nobel Peace Prize winners, Chemical warfare
Actuator	Machines
First Battle of the Marne	1914 in Europe, 1910s in France, Battles involving France, Battles involving Germany, Battles involving the United Kingdom, Battles of World War I, September events
Ca$hville Records	American record labels, 2006 establishments in the United States
G-Unit	2000s American music groups, 2010s American music groups, Hip hop bands, Musical groups from New York
Božidar Boki Milošević	Yugoslavian people, Clarinetists, Songwriters, Serbian musicians, People from Belgrade, 1931 births, 2018 deaths
Susanne Sundfør	1986 births, Living people, Norwegian musical entertainers, Singer-songwriters, People from Oslo
Branch Davidians	New religious movements, Christian denominations, 1955 establishments in the United States, Christianity in the United States, Texas, Cults, 1950s establishments in Texas, 1993 in the United States, 1990s in Texas
Ilene Graff	American movie actors, Living people, American television actors
Isotopes of hydrogen	Hydrogen, Isotopes
Crimea	Republic of Crimea, Autonomous areas, Geography of Ukraine, Geography of Russia, Peninsulas
Redback spider	Spiders, Venomous animals, Animals of Australia
Pow-wow (folk magic)	Magic (paranormal)
Vastu shastra	Architecture, Hindu temples
Alice Liddell	1852 births, 1934 deaths, People from Westminster
Nazi mysticism	Nazism, Occult, Religion in Germany
Anthroposophy	Esotericism, Spirituality, Philosophy
Venom	Poisons
Soliloquy	Drama, Literature
Somniloquy	Sleep disorders
Aurornis	Dinosaurs of Asia, Jurassic dinosaurs, Saurischia
Casting (metalworking)	Sculpture, Manufacturing
Canadair CL-13 Sabre	Military aircraft, Military of Canada
Development Regions of Nepal	Subdivisions of Nepal
Zones of Nepal	Zones of Nepal
Willie Degel	Businesspeople from New York, American television personalities, 1967 births, Living people, Restaurateurs
Restaurant Stakeout	2012 American television series debuts, American reality television series, Food Network
DVD-Audio	Audio disc, DVD
Boris Christoff	European opera singers, 1914 births, 1993 deaths, Bulgarian singers
Italian Peninsula	Peninsulas, Regions of Europe
Battle of Reading (871)	Battles involving England, Anglo-Saxons, Battles of the Middle Ages, 871, 9th century in England
Auditory hallucination	Psychosis, Medical signs
Flat panel display	Display technology
HMS Royal Oak	British warships
Districts of Nepal	Districts of Nepal
Capital gain	Economics
São Paulo Cathedral	Roman Catholic Cathedrals, São Paulo, Buildings and structures in Brazil, 1967 establishments, 1960s establishments in Brazil
Sweet Genius	American reality television series, Food Network, 2011 American television series debuts, English-language television programs
Saints Row (series)	Video game series, 2006 video games, 2008 video games, 2011 video games, 2013 video games, 2015 video games, THQ games, Windows games
Pelagia noctiluca	Jellyfish, Cnidarians
Octene	Alkenes
Cyclooctane	Cycloalkanes
Ryan Nugent-Hopkins	1993 births, Canadian ice hockey centres, Edmonton Oilers players, Ice hockey people from British Columbia, Living people, People from Burnaby, American Hockey League players
Alex Smith	1984 births, Living people, American football quarterbacks, Kansas City Chiefs players, San Francisco 49ers players
Pembrokeshire	Counties of Wales
Slug (rapper)	African American musicians, American rap musicians, Living people, 1972 births, Musicians from Minnesota
Scott Sanders	1969 births, Living people, Chicago Cubs players, Detroit Tigers players, San Diego Padres players, Seattle Mariners players
Provenance	Words, Archaeology, Art, Paleontology
Eastern Development Region, Nepal	Subdivisions of Nepal
Branle	Ballroom dances, French culture
Gavin Henson	1982 births, Living people, RC Toulonnais players, Welsh rugby union players
Marlon Jackson	1957 births, Living people, African American musicians, Jackson family, American pop musicians, American singers, Musicians from Indiana
Tishrei	Judaism, Months
Parícutin	Volcanoes of Mexico
Ice sheet	Landforms
John Davis (sealer)	American explorers, 1784 births, People from Surrey, English explorers, People from Connecticut, Antarctica, Year of death unknown
Superman suit	Superman, Clothing
Winti	Afro-American religion, Suriname
Sonkajärvi	Municipalities of Northern Savonia, 1922 establishments in Europe, 1920s establishments in Finland
Bob McDonnell	1954 births, Living people, American military people, Boston University alumni, Colonels, Criminals from Pennsylvania, Governors of Virginia, Politicians from Philadelphia, Pennsylvania, US Republican Party politicians
Governor of Virginia	Governors of Virginia
Jackie Jackson	1951 births, Living people, Jackson family, African American musicians, American singers, Singers from Indiana
Tito Jackson	Singers from Indiana, Living people, Jackson family, African American musicians, American pop musicians, 1953 births
Evapotranspiration	Ecology, Water
Defend Your Castle	2008 video games, Wii games
Central Development Region, Nepal	Subdivisions of Nepal
The Narrative (band)	2006 establishments in New York (state), 2000s American music groups, 2010s American music groups, American rock bands, Indie rock bands, Musical groups established in 2006, Musical groups from New York
Robert Stewart, Viscount Castlereagh	British politicians, 1769 births, 1822 deaths, British Viscounts, People who committed suicide
Bambi Meets Godzilla	1969 movies, Animated movies, Short movies, Godzilla
Social drinking	Alcohol drinking habits, Leisure
Western Development Region, Nepal	Subdivisions of Nepal
Star Fox 2	Star Fox, Super Nintendo Entertainment System games
Jimmy Waite	1969 births, American Hockey League players, Canadian ice hockey goaltenders, Chicago Blackhawks players, Chicoutimi Saguenéens (QMJHL) players, Ice hockey people from Quebec, International Hockey League (1945–2001) players, Living people, New Jersey Devils players, New York Islanders players, Phoenix Coyotes players, San Jose Sharks players
Mike Veisor	1952 births, Living people, American Hockey League players, Canadian ice hockey goaltenders, Canadian Jews, Chicago Blackhawks players, Hartford Whalers players, Ice hockey people from Ontario, Jewish sportspeople, People from Toronto, Winnipeg Jets (1979–96) players, Ontario Hockey League players, Central Professional Hockey League players
Star Fox Command	2006 video games, Nintendo DS games, Star Fox
Matt Underhill	1979 births, Canadian ice hockey goaltenders, Chicago Blackhawks players, Ice hockey people from British Columbia, Living people, American Hockey League players, ECHL players
Jocelyn Thibault	1975 births, American Hockey League players, Buffalo Sabres players, Canadian ice hockey goaltenders, Chicago Blackhawks players, Colorado Avalanche players, Ice hockey people from Quebec, Living people, Montreal Canadiens players, People from Montreal, Pittsburgh Penguins players, Quebec Nordiques players, Sherbrooke Faucons players, Trois-Rivières Draveurs players
Rob Tallas	1973 births, American Hockey League players, Boston Bruins players, Canadian ice hockey goaltenders, Chicago Blackhawks players, Florida Panthers players, Ice hockey people from Alberta, Living people, Seattle Thunderbirds players, Sportspeople from Edmonton, ECHL players, International Hockey League (1945–2001) players
Doug Stevenson	1927 births, 1975 deaths, Canadian ice hockey goaltenders, Chicago Blackhawks players, Ice hockey people from Saskatchewan, New York Rangers players, People from Regina, Saskatchewan, American Hockey League players, Eastern Hockey League players
Christian Soucy	1970 births, Canadian ice hockey goaltenders, Chicago Blackhawks players, Ice hockey people from Quebec, Living people, American Hockey League players, ECHL players, International Hockey League (1945–2001) players
Prayer in Christianity	Christian worship and liturgy, Christian terminology
Mid-Western Development Region, Nepal	Subdivisions of Nepal
Bill Young	1930 births, 2013 deaths, American Methodists, American military people, Deaths from multiple myeloma, Politicians from Pittsburgh, Pennsylvania, United States representatives from Florida, US Republican Party politicians
Tom Foley	1929 births, 2013 deaths, Ambassadors of the United States to Japan, American Roman Catholics, Cardiovascular disease deaths in Washington, D.C., Deaths from stroke, People from Spokane, Washington, Speakers of the United States House of Representatives, United States representatives from Washington, US Democratic Party politicians, 20th-century American politicians, 21st-century American politicians, Majority leaders of the United States House of Representatives
Bruce McGill	1950 births, Living people, American movie actors, American television actors, American voice actors, American stage actors, Actors from San Antonio, Texas
Arianna Huffington	1950 births, Living people, Alumni of the University of Cambridge, American journalists, American political commentators, American chief executives, Bloggers, Businesspeople from California, Greek writers, People from Athens, HuffPost, HuffPost writers and columnists, Writers from California, American bloggers
Papahānaumokuākea Marine National Monument	World Heritage Sites in the United States, Geography of Hawaii, National Monuments of the United States
Catherine Palace	Palaces in Russia, Buildings and structures in Saint Petersburg, Former royal residences
Ed Lauter	1938 births, 2013 deaths, Deaths from mesothelioma, Actors from New York, American movie actors, American stage actors, American television actors, American voice actors, Cancer deaths in the United States, Comedians from New York
Hans Riegel	1923 births, 2013 deaths, German billionaires, Cancer deaths in Germany, Cardiovascular disease deaths in Germany, Deaths from brain cancer, Deaths from heart failure, Deaths from surgical complications, German businesspeople, People from Bonn
Sea	Seas, Bodies of water, Oceans
Würstelstand	Fast food, Austrian culture
Jan Steen	1620s births, 1679 deaths, Dutch painters, People from Leiden
Respiratory failure	Medical emergencies, Respiratory system, Organ failure
Battle of Vimy Ridge	1917 in Europe, 1910s in France, Battles involving Canada, Battles involving Germany, Battles involving the United Kingdom, Battles of World War I, Hauts-de-France
Far-Western Development Region, Nepal	Subdivisions of Nepal
Oarfish	Ray-finned fish
Naked Cowboy	Singers from Ohio, 2012 United States presidential candidates, American guitarists, New York City, 1970 births, Living people
Fable (video game)	2004 video games, MacOS games, Microsoft video games, Role-playing video games, Xbox games, Xbox 360 games
Adagio for Strings	Compositions
Paleography	Science, Writing
Zombie walk	Monsters, Festivals
Integron	Horizontal gene transfer, Bacteria
Philip Short	1945 births, Living people, English writers
Pointless (game show)	2009 British television series debuts, 2000s British television series, 2010s British television series, BBC Television programmes, British television game shows, Television quiz shows, English-language television programs
William Marshal, 1st Earl of Pembroke	1100 births, 1200 deaths, Knights, Crusaders
Samuel Barber	1910 births, 1981 deaths, Deaths from cancer, LGBT composers, LGBT people from Pennsylvania, Gay men, Pulitzer Prize winners
Lake Rara	Lakes of Asia, Geography of Nepal
Captain Phillips (movie)	2013 movies, American action movies, American thriller movies, Movies based on books
12 Years a Slave (movie)	Best Picture Oscar, Academy Award winning movies, Golden Globe Award winning movies, 2013 drama movies, 2010s biographical movies, American biographical movies, American drama movies, British biographical movies, British drama movies, Movies based on books, Movies composed by Hans Zimmer, Movies set in Louisiana, Movies set in New York, Movies set in the 19th century, American independent movies
World War Z (movie)	2013 action movies, 2013 thriller movies, American action movies, American thriller movies, British action movies, British thriller movies, Maltese movies, Movies based on books, Apocalyptic movies, Movies directed by Marc Forster
Effigy	Death customs, Sculpture, Monuments and memorials
Green Party of the United States	Green Party of the United States, 2001 establishments in the United States, Green political parties
Particle board	Wood
Guttermouth	American punk bands, 1988 establishments in California, Musical groups from Huntington Beach, California, Musical groups established in 1988
Morien	Arthurian legend, Characters in written fiction
Oriented strand board	Wood
Emilia Plater	1806 births, 1832 deaths, European military people, Lithuanian people, Polish people
Affinity	Marriage, Relationships
Consanguinity	Marriage, Relationships
OFK Bačka	Serbian football clubs, 1945 establishments in Europe
Hurricane Emily (1993)	Hurricanes, 1993
Socialist Party of America	1901 establishments in the United States, 1972 disestablishments in the United States, Political parties in the United States, Socialism
Socialist Party of Great Britain	Political parties in the United Kingdom, 1904 establishments in the United Kingdom, Socialism
World Socialist Party of the United States	Political parties in the United States, 1916 establishments in the United States, Socialism
University of the Sacred Heart, Tokyo	Colleges and universities in Tokyo
Darren Pang	1964 births, Canadian ice hockey goaltenders, Chicago Blackhawks players, Ice hockey people from Ontario, Living people, National Hockey League broadcasters, American Hockey League players, International Hockey League (1945–2001) players, Ontario Hockey League players
Lawrence Klein	1920 births, 2013 deaths, American economists, American Nobel Prize winners, Deaths from natural causes, Jewish American academics, Jewish American scientists, Jewish Nobel Prize winners, Scientists from Omaha, Nebraska
Robert Solow	1924 births, Living people, American economists, American educators, American military personnel of World War II, American Nobel Prize winners, Harvard University alumni, Nobel Prize in Economics winners, Scientists from Brooklyn
Douglass North	1920 births, 2015 deaths, Deaths from esophageal cancer, American economists, American educators, American Nobel Prize winners, Nobel Prize in Economics winners, Scientists from Massachusetts
Thomas Schelling	1921 births, 2016 deaths, Deaths from fractured hip, American economists, American educators, Nobel Prize in Economics winners, Scientists from Oakland, California, American Nobel Prize winners, Harvard University faculty
Viking invasion of Britain	9th century in England, Danish people, 860s, 870s, History of the Netherlands
Kenneth Arrow	1921 births, 2017 deaths, American economists, Deaths from natural causes, Jewish American academics, Jewish American scientists, Jewish Nobel Prize winners, Nobel Prize in Economics winners, Scientists from New York City
Robert D. Maxwell	1920 births, 2019 deaths, American military people, People from Boise, Idaho
Walter D. Ehlers	1921 births, 2014 deaths, Deaths from renal failure, American military people, People from Kansas
The Exorcist (movie)	1973 horror movies, 1970s supernatural movies, American horror movies, American supernatural movies, English-language movies, Movies based on books, Warner Bros. movies, Movies directed by William Friedkin, Religious horror movies
Bud Adams	1923 births, 2013 deaths, Deaths from natural causes, Businesspeople from Oklahoma, Sportspeople from Oklahoma
Georges Descrières	1930 births, 2013 deaths, Cancer deaths in France, French movie actors, French stage actors, French television actors, French voice actors, People from Bordeaux
2 Live Crew	1985 establishments in the United States, 1998 disestablishments in the United States, Controversies in the United States, Hip hop bands, Musical groups disestablished in 1998, Musical groups established in 1985, Musical groups from Miami, Florida, 1980s establishments in Florida, Obscenity controversies
Nina Davuluri	Miss America winners, 1989 births, Living people, Nonviolence advocates, People from Syracuse, New York
Jack Norris	1942 births, Boston Bruins players, Canadian ice hockey goaltenders, Chicago Blackhawks players, Ice hockey people from Saskatchewan, Living people, Los Angeles Kings players, American Hockey League players
The Apprentice (UK TV series)	2004 British television series debuts, 2000s British television series, 2010s British television series, British reality television series, The Apprentice, English-language television programs
Adam Munro	1982 births, Canadian ice hockey goaltenders, Chicago Blackhawks players, Ice hockey people from Ontario, Living people, American Hockey League players, ECHL players, Ontario Hockey League players
Nehemiah Grew	1641 births, 1712 deaths, Fellows of the Royal Society, Botanists, English scientists, Physiologists
Johannes Müller	1801 births, 1858 deaths, German academics, German biologists, People from Koblenz, Anatomists, Fellows of the Royal Society, Foreign Members of the Royal Society, German Roman Catholics, German doctors, People from Rhineland-Palatinate, People who committed suicide, Physiologists, Ichthyologists
Sobolev space	Calculus
Tata Institute of Fundamental Research	Research organizations in Asia, Mumbai, 1945 establishments in Asia, 1940s establishments in India
Mojo!	PlayStation 2 games, 2003 video games
1556 Shaanxi earthquake	1556, Earthquakes in China, Gansu, Shaanxi, 16th century in Asia, History of China, Articles on pre-1900 earthquakes
Naturopathy	Medicine, Pseudoscience
Oscar Yanes	1927 births, 2013 deaths, Deaths from pneumonia, Disease-related deaths in Venezuela, People from Caracas, Venezuelan writers
Divine right of kings	Monarchy, Political systems, Religious ethics
Alfie Moore	1904 births, 1984 deaths, Canadian ice hockey goaltenders, Chicago Blackhawks players, Ice hockey people from Ontario, New York Americans players, People from Toronto, American Hockey League players
Greg Millen	1957 births, Canadian ice hockey goaltenders, Chicago Blackhawks players, Detroit Red Wings players, Hartford Whalers players, Ice hockey people from Ontario, Living people, National Hockey League broadcasters, Pittsburgh Penguins players, Quebec Nordiques players, St. Louis Blues players, American Hockey League players, Ontario Hockey League players
Gilles Meloche	1950 births, California Golden Seals players, Canadian ice hockey goaltenders, Chicago Blackhawks players, Cleveland Barons (NHL) players, Ice hockey people from Quebec, Living people, Minnesota North Stars players, People from Montreal, Pittsburgh Penguins players, International Hockey League (1945–2001) players, Quebec Major Junior Hockey League players
Total Eclipse	1990s biographical movies, 1995 drama movies, American biographical movies, American drama movies, American independent movies, Movies based on plays, French drama movies, Belgian movies, Movies directed by Agnieszka Holland
Philomena	2013 drama movies, 2010s biographical movies, British biographical movies, British drama movies, French drama movies, English-language movies, Movies set in the 1950s, Movies set in the 2000s, Movies set in London, Movies set in Washington, D.C., Movies directed by Stephen Frears
Buenos Aires Convention	Buenos Aires, 1910s treaties, Copyright, 1910, 20th century in Argentina, 1910s in South America
Sébastien Caron	1980 births, American Hockey League players, Anaheim Ducks players, Canadian ice hockey goaltenders, Chicago Blackhawks players, Ice hockey people from Quebec, Living people, Memorial Cup winners, Pittsburgh Penguins players, Rimouski Océanic players‎, Stanley Cup champions, Tampa Bay Lightning players
Jan Purkyně	1787 births, 1869 deaths, Czech scientists, Biologists
Roger I de Montgomery	Year of birth unknown, Year of death unknown, Normans
Barákapuszta	Villages in Hungary, 17th century establishments in Europe, Establishments in Hungary, Unknown disestablishments
Chris Clifford	1966 births, Canadian ice hockey goaltenders, Chicago Blackhawks players, Ice hockey people from Ontario, Living people
Paradox of thrift	Economics
Mora (ship)	Ships, History of England, Normandy, 1060s establishments, 1066 in England
Function space	Mathematics
Besov space	Mathematics

