Raymond Leppard	1927 births, 2019 deaths, Naturalized citizens of the United States, British conductors, British composers, American conductors, American composers, Writers from London, Writers from Indianapolis, Indiana
Quenemo, Kansas	Cities in Osage County, Kansas
2019 Grays incident	2019 crimes in Europe, 2019 disasters, 2010s in the United Kingdom, Crime in England, Disasters in the United Kingdom, Essex, October 2019 events
Quinter, Kansas	Cities in Kansas
Marieke Vervoort	1979 births, 2019 deaths, Deaths by euthanasia, Drug-related suicides, Competitors in athletics, Belgian sportspeople
Degenerative disease	Diseases
Miguel Saiz	1949 births, 2019 deaths, Uruguayan politicians, Argentine politicians, Deaths from heart failure, People from Montevideo, People from Buenos Aires
Zenda, Kansas	Cities in Kansas
Udall, Kansas	Cities in Cowley County, Kansas
Uniontown, Kansas	Cities in Bourbon County, Kansas
Utica, Kansas	Cities in Ness County, Kansas
Waldo, Kansas	Cities in Russell County, Kansas, 1888 establishments in Kansas
Batura Glacier	Glaciers of Pakistan
Ingalls, Kansas	Cities in Gray County, Kansas
Kanephoros	Ancient Greece, Religion, Culture, Women
Episcopal Diocese of Chicago	Anglicanism, Chicago, Illinois
Jeffrey Lee (bishop)	Living people, People from Kalamazoo, Michigan, People from Chicago, Bishops
James W. Montgomery	1921 births, 2019 deaths, Bishops, People from Chicago, People from Naperville, Illinois
Mikhail Innokentyevich Semyonov	1938 births, 2019 deaths, Disease-related deaths in Russia, Russian politicians
Eurasian plate	Tectonic plates, Europe, Asia
South American plate	Tectonic plates, South America
Indo-Australian plate	Tectonic plates, Australia, India
Eve (Bible)	Biblical people
Leonard Hofstadter	Television characters
Beurre noisette	French food, Cooking methods, Sauces
Swirly	Bullying
Fred VanVleet	1994 births, Living people, Toronto Raptors players, Sportspeople from Illinois, African-American basketball players, American basketball players
Candice Pitts	Living people, Academics, Belizean politicians, Journalists, Writers
Brecknockshire	Counties of Wales
Buddha (album)	1994 albums
Marion County, Mississippi	1810s establishments in Mississippi Territory, 1811 establishments in the United States, Mississippi counties
Marshall County, Mississippi	1836 establishments in Mississippi, Mississippi counties
Monroe County, Mississippi	1820s establishments in Mississippi, 1821 establishments in the United States, Mississippi counties
Perry County, Mississippi	1820s establishments in Mississippi, 1820 establishments in the United States, Mississippi counties
Newton County, Mississippi	1836 establishments in Mississippi, Mississippi counties
Ramah, Colorado	Towns in Colorado
Mont-sur-Rolle	Municipalities of Vaud
Perroy, Switzerland	Municipalities of Vaud
Prangins	Municipalities of Vaud
Königsheim	Tuttlingen
Mel Aull	1928 births, 2019 deaths, Sportspeople from Ontario
Peggy McIntosh	1934 births, Living people, American feminist writers, American political activists, American academics, American essayists, Researchers, Writers from New York City
USS Iowa (BB-61)	Naval ships of the United States
Jeffrey Spalding	1951 births, 2019 deaths, Artists, Canadian writers, Scottish writers, People from Edinburgh
Goodland, Kansas	Cities in Kansas, County seats in Kansas, 1887 establishments in Kansas
Michael D. Reynolds	1954 births, 2019 deaths, Deaths from cardiac arrest, Cardiovascular disease deaths in Florida, American educators, American astronomers, Scientists from Jacksonville, Florida
Tonganoxie, Kansas	Cities in Leavenworth County, Kansas, 1866 establishments in Kansas
Vicki Ann Funk	1947 births, 2019 deaths, American botanists, Female scientists, Researchers, People from Owensboro, Kentucky
Hildegard Bachert	1921 births, 2019 deaths, Naturalized citizens of the United States, German artists, American artists, People from Brattleboro, Vermont
Brattleboro, Vermont	Towns in Vermont
Ole Henrik Laub	1937 births, 2019 deaths, Danish writers, Artists
Alfred Znamierowski	1940 births, 2019 deaths, Deaths from myocardial infarction, Illustrators, Polish journalists, Editors, Writers from Warsaw
Walter Franco	1945 births, 2019 deaths, Deaths from stroke, Brazilian singers, Brazilian musicians, Rock guitarists, Composers, Record producers, People from São Paulo
Salvador Freixedo	1923 births, 2019 deaths, Critics, Jesuits, Researchers, Roman Catholic priests, Spanish Roman Catholics, Spanish writers
Hans Zender	1936 births, 2019 deaths, German composers, German conductors, People from Wiesbaden
ShopHQ	1990s establishments in Minnesota, 1991 establishments in the United States, American television networks, Minnesota
It's Showtime	Television programs
Emmett Chappelle	1925 births, 2019 deaths, Deaths from renal failure, American military personnel of World War II, American astronomers, Scientists from Arizona, People from Phoenix, Arizona
Oktibbeha County, Mississippi	1833 establishments in Mississippi, Mississippi counties
Firestone, Colorado	Towns in Colorado
Cessières-Suzy	2019 establishments in France, Communes in Aisne
Villeneuve-sur-Aisne	2019 establishments in France, Communes in Aisne
Velma, Oklahoma	Cities in Oklahoma
Pocola, Oklahoma	Towns in Oklahoma
Freedom, Oklahoma	Towns in Oklahoma
Saint-George	Municipalities of Vaud
Purfleet	Towns in Essex
Thurrock	Boroughs, Unitary authorities, Settlements in Essex
Flintshire	Flintshire
Signy-Avenex	Municipalities of Vaud
Prentiss County, Mississippi	1870 establishments in Mississippi, Mississippi counties
Momoko Sakura	Japanese manga artists, 1965 births, 2018 deaths
Corn dog	Sausage, Fast food
The Wave in the Mind	Essays, Books by Ursula K. Le Guin
Steering the Craft	Books about writing, Books by Ursula K. Le Guin
Black site	Prisons, United States intelligence agencies, Human rights abuses, George W. Bush
Mr. Satan	anime characters, Dragon Ball characters, Fictional characters introduced in 1992
Basshunter discography	Discographies, Basshunter
Piccolo (Dragon Ball)	Dragon Ball characters, Fictional characters introduced in 1988, Fictional characters with slowed ageing, Fictional extraterrestrial characters, Anime characters
Videl	Dragon Ball characters, Fictional characters introduced in 1993, anime characters
Paul Lambert	1969 births, 1998 FIFA World Cup players, Association football midfielders, British people, Living people, Scottish football managers, Sportspeople from Glasgow
Aston University	Universities in England, 1895 establishments in England
Margaret Lyons	1923 births, 2019 deaths, Canadian businesspeople, Deaths by euthanasia, People who committed suicide, People from British Columbia
Walter Fauntroy	1933 births, Living people, 1972 United States presidential candidates, 1976 United States presidential candidates, American criminals, American civil rights activists, United States representatives, Politicians from Washington, D.C., US Democratic Party politicians
Josip Elic	1921 births, 2019 deaths, Accidental deaths from falls in the United States, American movie actors, American television actors, American stage actors, American voice actors, Actors from Montana, People from Butte, Montana
Therese Zenz	1932 births, 2019 deaths, German Olympic silver medalists
Anne Phelan	1944 births, 2019 deaths, Actors from Melbourne, Australian movie actors, Australian stage actors, Australian television actors, Radio actors
Carlo Strenger	1958 births, 2019 deaths, Swiss scientists, Israeli scientists, Israeli psychologists, Swiss psychologists
Don Valentine	1932 births, 2019 deaths, Businesspeople from New York City
Vladimir Bukovsky	1942 births, 2019 deaths, Deaths from heart failure, British activists, Russian politicians, Russian writers, Crime victims, Human rights activists, Political activists, Anti-Communists, British politicians, British writers, People from Cambridge
Paul Barrere	1948 births, 2019 deaths, Deaths from liver cancer, Cancer deaths in Los Angeles, American rock guitarists, Musicians from Los Angeles, California, People from Burbank, California
Bernie Parrish	1936 births, 2019 deaths, Deaths from prostate cancer, American football cornerbacks, Cleveland Browns players, Sportspeople from California, People from Long Beach, California
Enriqueta Basilio	1948 births, 2019 deaths, Deaths from pneumonia, Mexican sportspeople, Olympians
Chuck Meriwether	1956 births, 2019 deaths, Cancer deaths in the United States, Sportspeople from Nashville, Tennessee
V. Nanammal	1920 births, 2019 deaths, Accidental deaths from falls, Indian educators
Gregory E. Pyle	1949 births, 2019 deaths, Politicians from California, Politicians from Oklahoma, US Democratic Party politicians
Pascale Roberts	1930 births, 2019 deaths, Deaths from colorectal cancer, Cancer deaths in France, French movie actors, French television actors, French stage actors, Actors from Paris
Jim Carr	1951 births, Living people, People with cancer, Canadian politicians, People from Winnipeg, Privy Councillors (Canada), Members of the House of Commons of Canada
Katie Hill (politician)	1987 births, Living people, United States representatives from California, Politicians from Texas, US Democratic Party politicians, People from Abilene, Texas
Kaoru Yachigusa	Japanese movie actors, Japanese television actors, Japanese voice actors, Deaths from pancreatic cancer, 1931 births, 2019 deaths
Mariko Okada	1933 births, Living people, Japanese movie actors, Japanese television actors
Yoshishige Yoshida	Japanese movie directors, Japanese screenwriters, 1933 births, Living people
Senkichi Taniguchi	1912 births, 2007 deaths, Movie directors from Tokyo, Japanese screenwriters, Deaths from pneumonia
Pioneer MRT station	Mass Rapid Transit (Singapore) stations
Tuas Crescent MRT station	Mass Rapid Transit (Singapore) stations
Tuas West Road MRT station	Mass Rapid Transit (Singapore) stations
Ol Doinyo Lengai	Geography of Tanzania, Volcanoes of Africa, Carbonate rocks
Howard, Kansas	Cities in Kansas, County seats in Kansas
Bee Movie	2007 animated movies, 2007 computer-animated movies, 2007 comedy movies, DreamWorks Animation movies, Internet memes, American comedy movies
Russell, Kansas	Cities in Russell County, Kansas, 1871 establishments in the United States, County seats in Kansas
Paraíso, Costa Rica	19th-century establishments in Costa Rica, 1823 establishments in North America, Cities in Costa Rica
Kay Hagan	1953 births, 2019 deaths, Deaths from encephalitis, American lawyers, Businesspeople from North Carolina, United States senators from North Carolina, People from Greensboro, North Carolina, US Democratic Party politicians
Shelby, North Carolina	Cities in North Carolina, County seats in North Carolina
Cleveland County, North Carolina	1840s establishments in North Carolina, 1841 establishments in the United States, North Carolina counties
Max Cleland	1942 births, Living people, United States senators from Georgia, American military personnel of the Vietnam War, Politicians from Atlanta, Georgia, US Democratic Party politicians
John W. Nicholson	1934 births, Living people, American generals, American military personnel of the Vietnam War, Politicians from Iowa
Minneapolis, Kansas	Cities in Ottawa County, Kansas, County seats in Kansas
Rudy Ray Moore	1927 births, 2008 deaths, Actors from Arkansas, African American comedians, African-American movie actors, African American movie producers, African-American singers, Deaths from diabetes, Disease-related deaths in Ohio, Musicians from Arkansas, Singers from Arkansas
Oriental Telephone Company	Telephone companies
Doom Eternal	Doom series, Nintendo Switch games, PlayStation 4 games, Video game sequels, Windows games, Xbox One games
Social Liberal Party (Brazil)	1990s establishments in Brazil, 1994 establishments, Conservative parties, Nationalism, Political parties of Brazil, Communism
World Anti-Doping Agency	International organizations, Sports organizations, Drugs
Muesli	Breakfast cereals
Zoltán Jeney	1943 births, Hungarian composers, 2019 deaths
The Durrells	British television series
Keeley Hawes	Actors
Year of the Rabbit (TV series)	Television, English-language television programs
Stephen P. Cohen	1936 births, 2019 deaths, American political scientists, American political writers, American educators, American critics, Writers from Chicago, Writers from Washington, D.C.
Ministry of Human Rights (Pakistan)	Government of Pakistan, Politics of Pakistan, Human rights
Shireen Mazari	Pakistani people
Gerald Baliles	1940 births, 2019 deaths, Deaths from kidney cancer, Deaths from pulmonary fibrosis, American lawyers, Governors of Virginia, US Democratic Party politicians
Shinsegae	20th century establishments in South Korea, 1955 establishments in Asia, Department stores, Companies of South Korea, Seoul
Parris Glendening	1942 births, Living people, Politicians from New York City, Governors of Maryland, US Democratic Party politicians
Table of keyboard shortcuts	Computers
Juana Maria	1811 births, 1853 deaths, 19th century births, Infectious disease deaths in California, Missing people, Native American people, People from Ventura County, California, Deaths from dysentery
Next United Kingdom general election	United Kingdom general elections, 2020s in the United Kingdom
Al Bianchi	1932 births, 2019 deaths, Deaths from congestive heart failure, Philadelphia 76ers players, Sportspeople from New York City
Hans-Peter Uhl	1944 births, 2019 deaths, Disease-related deaths in Germany, German politicians
Friday (1995 movie)	1995 movies, African-American movies, American comedy movies, American independent movies, Movies directed by F. Gary Gray
Jim Geringer	1944 births, Living people, Governors of Wyoming, US Republican Party politicians
Rosemary Harris (writer)	1923 births, 2019 deaths, British children's writers, Writers from London
ContraPoints	1988 births, Living people, Internet celebrities, American feminist writers, American political commentators, LGBT feminists, LGBT writers, Transgender and transsexual people, Writers from Virginia, People from Arlington, Virginia
Adore Delano	1989 births, Living people, American LGBT rights activists, LGBT singers, LGBT writers, American singer-songwriters, American movie actors, American television actors, LGBT people from California, Actors from California, Singers from California, Writers from California
Marion County, Oregon	Oregon counties
Lotfollah Safi Golpaygani	1919 births, Living people, Iranian politicians, Iranian centenarians
Janusz A. Brzozowski	1935 births, 2019 deaths, Cancer deaths in Canada, Polish scientists, Canadian scientists, Computer scientists, People from Warsaw, People from Ontario
Russell Brookes	1945 births, British racecar drivers, 2019 deaths, People from Worcestershire
David Price (politician)	1940 births, Living people, United States representatives from North Carolina, Politicians from Tennessee, US Democratic Party politicians
Erwin, Tennessee	County seats in Tennessee, Towns in Tennessee
1973 Chilean coup d'état	1973, Cold War, 20th century in Chile
Gove City, Kansas	County seats in Kansas, Cities in Kansas, 1885 establishments in the United States
Diosdado Peralta	1952 births, Living people, Chief Justices of the Supreme Court of the Philippines
Alan Peter Cayetano	1970 births, Living people, Speakers of the House of Representatives of the Philippines, Minority leaders of the Senate of the Philippines, Majority leaders of the Senate of the Philippines
Girard, Kansas	1868 establishments in Kansas, County seats in Kansas, Cities in Crawford County, Kansas
Hiawatha, Kansas	1857 establishments in the United States, Cities in Brown County, Kansas, County seats in Kansas
Phillipsburg, Kansas	Cities in Phillips County, Kansas, 1872 establishments in Kansas, County seats in Kansas
Norton, Kansas	1872 establishments in Kansas, Cities in Kansas, County seats in Kansas
Ness City, Kansas	Cities in Ness County, Kansas, County seats in Kansas
Dighton, Kansas	Cities in Kansas, County seats in Kansas
Troy, Kansas	Cities in Kansas, County seats in Kansas, Doniphan County, Kansas
Westmoreland, Kansas	Cities in Pottawatomie County, Kansas, County seats in Kansas
Washington, Kansas	Cities in Washington County, Kansas, County seats in Kansas, 1860 establishments in Kansas Territory
Lose You to Love Me	2019 songs, Pop ballads, Selena Gomez songs
WaKeeney, Kansas	1879 establishments in Kansas, Cities in Kansas, County seats in Kansas
Hill City, Kansas	Cities in Kansas, County seats in Kansas, Graham County, Kansas, 1876 establishments in Kansas
Holton, Kansas	1856 establishments in Kansas Territory, Cities in Kansas, County seats in Kansas
Hoxie, Kansas	Cities in Kansas, County seats in Kansas
Zápara People	Ethnic groups, Ecuadorian people, Peruvian people, Anthropology
Ron Fairly	1938 births, 2019 deaths, Cancer deaths in California, American League All-Stars, California Angels players, Los Angeles Dodgers players, Montreal Expos players, National League All-Stars, Oakland Athletics players, St. Louis Cardinals players, Toronto Blue Jays players, Sportspeople from Georgia (U.S. state), People from Macon, Georgia
Jim Gregory	1935 births, 2019 deaths, Deaths from amyloidosis, Canadian ice hockey coaches, Ice hockey people from Ontario
Mobolaji Johnson	Nigerian politicians, 1936 births, 2019 deaths, Generals, People from Lagos
Azam Taleghani	1943 births, 2019 deaths, Iranian politicians, Iranian writers, Iranian journalists, Political activists, Deaths from cerebral hemorrhage, Accidental deaths from falls, People from Tehran
Geetanjali (actress)	1947 births, 2019 deaths, Indian movie actors, Indian television actors, Deaths from cardiac arrest
Eric Stevens	1989 births, Living people, American football fullbacks, Sportspeople from California, St. Louis Rams players
Rolling Hills Estates, California	Cities in California, Settlements in Los Angeles County, California
Anne Triola	1920 births, Living people, American movie actors, American television actors, American stage actors, Actors from Los Angeles, California, Musicians from Los Angeles, California, Singers from Los Angeles, California
Khmer people	Cambodia, Buddhism
Ceropegia elegans	Apocynaceae
Kimbanguism	Democratic Republic of the Congo, New religious movements
Gary A. Lee	1933 births, Living people, United States representatives from New York, Politicians from Buffalo, New York, US Democratic Party politicians
Ken Lucas	1933 births, Living people, United States representatives from Kentucky, US Democratic Party politicians
Verdana	Fonts
Stanislav Shushkevich	1934 births, Living people, Presidents of Belarus
Bernard Slade	1930 births, 2019 deaths, Deaths from dementia with Lewy bodies, Disease-related deaths in Los Angeles, Naturalized citizens of the United States, Canadian playwrights, Canadian screenwriters, American screenwriters, American playwrights, American television writers, Writers from Ontario
Sam Bobrick	1932 births, 2019 deaths, Deaths from stroke, Cardiovascular disease deaths in Los Angeles, American songwriters, American playwrights, American television writers, American novelists, Writers from Chicago
Gerry Ryan	1956 births, 2010 deaths, Deaths from cardiac arrhythmia, Drug-related deaths, Irish radio personalities, Irish television personalities, People from Dublin
Kent County, Michigan	1836 establishments in Michigan Territory, Michigan counties
Johnson City, Kansas	1885 establishments in the United States, Cities in Kansas, County seats in Kansas
Jetmore, Kansas	Cities in Kansas, County seats in Kansas, 1879 establishments in Kansas
Kinsley, Kansas	Cities in Kansas, County seats in Kansas, 1873 establishments in Kansas
Kingman, Kansas	Cities in Kansas, County seats in Kansas, 1874 establishments in Kansas
Burlington, Kansas	Cities in Kansas, County seats in Kansas, 1857 establishments in Kansas Territory
List of vice presidents of the United States by time in office	Vice Presidents of the United States
Brave (web browser)	Web browsers
Contiguous United States	Subdivisions of the United States
Chromium (web browser)	Web browsers
Deaths in November 2019	2019 deaths, November 2019 events
Enrico Braggiotti	1923 births, 2019 deaths, Bankers, Turkish politicians, Monegasque people
Triumph the Insult Comic Dog	Puppets
Ebrahim Abadi	Iranian actors, 1934 births, 2019 deaths, Deaths from myocardial infarction
Lincoln Parish, Louisiana	1870s establishments in Louisiana, 1873 establishments in the United States, Louisiana parishes
Harmon, Louisiana	Unincorporated communities in Red River Parish, Louisiana
Kadri Gopalnath	1949 births, 2019 deaths, Deaths from cardiac arrest, Indian musicians, Saxophonists, Composers
Das alte Karussell	1956 songs, German language
Bhisadej Rajani	1922 births, Living people, Princes and princesses, Asian writers, People from Bangkok
Siân Berry	1974 births, Living people, Environmentalists, People from Gloucestershire
Olivia Williams	1968 births, Living people, British movie actors, British radio actors, British stage actors, British television actors, British voice actors, Actors from London
Archie Atkinson	1884 births, 1968 deaths, Canadian ice hockey defencemen, Ice hockey people from Ontario, Montreal Wanderers (NHA) players, People from Ottawa
Nyamuragira	Geography of the Democratic Republic of the Congo, Volcanoes of Africa
Leigh Verstraete	1962 births, Billings Bighorns players, Calgary Wranglers players, Canadian ice hockey right wingers, Ice hockey people from Alberta, Living people, Sportspeople from Calgary, Toronto Maple Leafs players
Harvie Pocza	1959 births, Billings Bighorns players, Calgary Centennials players, Canadian ice hockey left wingers, Ice hockey people from Alberta, Living people, People from Lethbridge, Washington Capitals players
Glen Irwin	1951 births, Canadian ice hockey defencemen, Estevan Bruins players, Ice hockey people from Alberta, Living people, Sportspeople from Edmonton, World Hockey Association players, Central Professional Hockey League players
Kevin Krook	1958 births, Calgary Centennials players, Canadian ice hockey defencemen, Colorado Rockies (NHL) players, Ice hockey people from Alberta, International Hockey League (1945–2001) players, Living people, New Westminster Bruins players, People from Alberta, Regina Pats players
Luke Curtin	1977 births, American ice hockey players, Kelowna Rockets players, Living people, Tacoma Rockets players, ECHL players, International Hockey League (1945–2001) players
Belleville, Kansas	1869 establishments in the United States, Cities in Kansas, County seats in Kansas
Beloit, Kansas	1868 establishments in Kansas, Cities in Kansas, County seats in Kansas, Cities in Mitchell County, Kansas
Tartegnin	Municipalities of Vaud
Alma, Kansas	Cities in Wabaunsee County, Kansas, County seats in Kansas
Trélex	Municipalities of Vaud
Anthony, Kansas	1878 establishments in the United States, Cities in Harper County, Kansas, County seats in Kansas
Ashland, Kansas	Cities in Kansas, County seats in Kansas, 1884 establishments in Kansas
Belmont-sur-Lausanne	Municipalities of Vaud
Bussigny-sur-Oron	Former municipalities of Vaud
Châtillens	Former municipalities of Vaud
Schuyler, Nebraska	Cities in Nebraska, County seats in Nebraska
Webster County, Mississippi	1870s establishments in Mississippi, 1874 establishments in the United States, Mississippi counties
Beatrice, Nebraska	Cities in Nebraska, County seats in Nebraska
Dakota City, Nebraska	Cities in Nebraska, County seats in Nebraska
Atwood, Kansas	Cities in Kansas, County seats in Kansas, 1875 establishments in Kansas
Cimarron, Kansas	Cities in Gray County, Kansas, County seats in Kansas, 1878 establishments in the United States
Coldwater, Kansas	Cities in Kansas, County seats in Kansas, Comanche County, Kansas
Sedinam Moyowasifza-Curry	1962 births, Living people, American political activists, 2016 United States presidential candidates, 2020 United States presidential candidates, Politicians from Los Angeles, California, Green Party of the United States politicians
Darcy Richardson	1955 births, Living people, American political activists, American historians, American political writers, 2020 United States presidential candidates, Politicians from Florida, Writers from Florida, Politicians from Pennsylvania, Writers from Pennsylvania, 2020 United States vice-presidential candidates, US Democratic Party politicians, American bloggers
Leonard Peltier	1944 births, Living people, American political activists, American people convicted of murder, 2020 United States vice-presidential candidates, Politicians from North Dakota, Politicians from Florida, People from Grand Forks, North Dakota
David Greaves	1946 births, 2019 deaths, Snooker players, Sportspeople from Lancashire
Francis A. Sullivan	1922 births, 2019 deaths, American theologians, American Roman Catholics, Jesuits, Roman Catholic priests, Writers from Boston, Massachusetts
Ann Crumb	1950 births, 2019 deaths, Deaths from ovarian cancer, Cancer deaths in Pennsylvania, American jazz singers, American movie actors, American television actors, American stage actors, American musical theatre actors, American animal rights activists, Actors from West Virginia, Singers from West Virginia, People from Charleston, West Virginia
Media, Pennsylvania	Boroughs in Pennsylvania, County seats in Pennsylvania
George Crumb	1929 births, Living people, Grammy Award winners, Pulitzer Prize winners, American composers, Writers from West Virginia, People from Charleston, West Virginia
Delaware County, Pennsylvania	1780s establishments in Pennsylvania, 1789 establishments in the United States, Pennsylvania counties
Gilbert Kalish	1935 births, Living people, American pianists, American composers, American educators, Musicians from New York City, Writers from New York City
Aristides Gomes	1954 births, Living people, Prime Ministers of Guinea-Bissau
List of prime ministers of Guinea-Bissau	Prime Ministers of Guinea-Bissau
João Bernardo Vieira	1939 births, 2009 deaths, Murders by firearm, Assassinated people, Presidents of Guinea-Bissau, Prime Ministers of Guinea-Bissau
Carlos Correia	1933 births, 2021 deaths, Prime Ministers of Guinea-Bissau
Buranovskiye Babushki	Eurovision Song Contest entrants
Howard Storm (author)	1946 births, Living people, American Christians, American painters, Writers from Massachusetts
Rina Lazo	1923 births, 2019 deaths, Deaths from cardiac arrest, Mexican painters, People from Guatemala City, Artists from Mexico City
Ken Blaiklock	1927 births, 2020 deaths, British explorers
B. V. Doshi	Pritzker Prize winners, 1927 births, Living people, Indian architects
Peter Zumthor	1943 births, Living people, Architects, People from Basel, Pritzker Prize winners
Richard Rogers	1933 births, Living people, British engineers, Italian architects, Pritzker Prize winners, People from Florence
Paulo Mendes da Rocha	1928 births, 2021 deaths, Deaths from lung cancer, Pritzker Prize winners, Brazilian architects, People from São Paulo
Glenn Murcutt	1936 births, Living people, Australian architects, British architects, People from London, People from Sydney
Rafael Moneo	1937 births, Living people, Spanish architects
Álvaro Siza Vieira	1933 births, Living people, Portuguese people, Architects, Portuguese educators
Luis Barragán	1902 births, 1988 deaths, Deaths from Parkinson's disease, Pritzker Prize winners, Mexican architects, Mexican engineers, Scientists from Mexico City
Chou Wen-chung	1923 births, 2019 deaths, Chinese people, American composers, Naturalized citizens of the United States, Writers from New York City
Akron, New York	Villages in New York
Oncilla	Felines
Pallas's cat	Felines
Rusty-spotted cat	Felines
Joshua King (footballer)	1992 births, Norwegian footballers, Sportspeople from Oslo, Living people
Rabindra Mishra	Nepalese politicians
Kiosk	Shops, Buildings and structures
Sachsenhausen concentration camp	Buildings and structures in Germany, Brandenburg, Nazi concentration camps in Germany
Oranienburg concentration camp	Nazi concentration camps in Germany, Buildings and structures in Germany, Brandenburg
Oranienburg	Towns in Brandenburg
Al Hunter Ashton	1957 births, 2007 deaths, English movie actors, English writers, English television actors, Television writers
Brian Warboys	1942 births, Living people, British educators, English writers
Chesalles-sur-Oron	Former municipalities of Vaud
Oron, Switzerland	2012 establishments in Switzerland, Municipalities of Vaud
Epesses	2011 disestablishments in Switzerland, Former municipalities of Vaud
Co-operative Commonwealth Federation	1930s establishments in Canada, 1932 establishments in North America, 20th century disestablishments in Canada, 1961 disestablishments, Political parties in Canada, Social democratic parties
Mézières, Vaud	Former municipalities of Vaud
Laverne, Oklahoma	Towns in Oklahoma
Bibsys	20th century establishments in Norway, 1972 establishments in Europe, Norway, Libraries in Europe
Spyderco	1970s establishments in Colorado, 1978 establishments in the United States, Companies of the United States, Cutting tools, Colorado
JCUKEN	Writing tools, Typography, Russian language
Kielbasa	Sausage, Polish food
Lukas Bärfuss	1971 births, Swiss writers, Living people, Canton of Bern
Les Thioleyres	Former municipalities of Vaud
Ecoteaux	Former municipalities of Vaud
Ishwari Prasad Gupta	1931 births, 2018 deaths, Lieutenant governors of the Andaman and Nicobar Islands
Syed Shahnawaz Hussain	People from Bihar, 1968 births, Living people
Mascarene Islands	Archipelagos, Indian Ocean, Geography of Africa
Tatums, Oklahoma	Towns in Oklahoma
Ravia, Oklahoma	Towns in Oklahoma
Shattuck, Oklahoma	Towns in Oklahoma
Verdigris, Oklahoma	Towns in Oklahoma
Good as Hell	2016 songs, R&B songs, Ariana Grande songs
Rush Springs, Oklahoma	Towns in Oklahoma
Mannsville, Oklahoma	Towns in Oklahoma
Oron-la-Ville	Former municipalities of Vaud
Les Tavernes	Former municipalities of Vaud
Forever (Chris Brown song)	2008 songs, Dance-pop songs
Association for Library Service to Children	Libraries in the United States, Children's literature
Pramoedya Ananta Toer	1925 births, 2006 deaths, Novelists, Indonesian writers, Indonesian activists, Socialists
Rudy Boesch	1928 births, 2019 deaths, Deaths from Alzheimer's disease, Disease-related deaths in Virginia, American military personnel of the Vietnam War, American television presenters, Television personalities from New York, People from Rochester, New York
Sigvard Ericsson	1930 births, 2019 deaths, Swedish sportspeople, Olympic gold medalists, Olympic silver medalists
Leo Iorga	Deaths from cancer, 1964 births, 2019 deaths, Rock singers, Rock guitarists, Romanian singers
Marie Laforêt	1939 births, 2019 deaths, French singers, French movie actors, French television actors, Swiss movie actors, Swiss television actors, Swiss singers
Walter Mercado	1931 births, 2019 deaths, Puerto Rican people, Dancers, Astrologers, Television personalities, Deaths from renal failure
James I. Robertson Jr.	1930 births, 2019 deaths, Cancer deaths in Virginia, American historians, American educators, Writers from Virginia
Gert Boyle	1924 births, 2019 deaths, Naturalized citizens of the United States, Businesspeople from Portland, Oregon, American philanthropists, American autobiographers, German businesspeople, German autobiographers, Writers from Oregon
West Linn, Oregon	Cities in Oregon
Ian Cross	1925 births, 2019 deaths, New Zealand journalists
Sorin Frunzăverde	1960 births, 2019 deaths, Deaths from kidney disease, Romanian politicians, Former MEPs
Taku Mayumura	1934 births, 2019 deaths, Deaths from pneumonia, Japanese novelists, Science fiction writers, Japanese poets
Dalia Itzik	1952 births, Living people, Former Members of Knesset, Government ministers of Israel, HaAvoda politicians, Hebrew University of Jerusalem alumni, Israeli opposition leaders, Kadima politicians, Knesset speakers, People from Jerusalem, Presidents of Israel
Yvette Lundy	1916 births, 2019 deaths, French centenarians, French writers, Holocaust survivors
Kees Driehuis	1951 births, 2019 deaths, Deaths from bladder cancer, Television presenters, People from Amsterdam
Stuart Heydinger	2019 deaths, 1927 births, British photojournalists, Writers from London
Saratoga Springs, New York	Cities in New York
Ballston Spa, New York	Villages in New York, County seats in New York
Clackamas County, Oregon	Oregon counties
Weymouth, Nova Scotia	Villages in Nova Scotia
List of people from Nova Scotia	People from Nova Scotia
I Bought a Vampire Motorcycle	1990 comedy movies, 1990 horror movies, British comedy movies, British horror movies, Outlaw biker movies
Mania (Fall Out Boy album)	2018 albums, Fall Out Boy albums, Island Records albums, Rock albums
Make America Psycho Again	Fall Out Boy albums
Ève Curie	1904 births, 2007 deaths, Writers from Paris, American writers, American centenarians, French centenarians, Legion of Honour
Shingō, Aomori	Jesus Christ, Villages in Japan
Erta Ale	Ethiopia, Volcanoes of Africa
Lake Towada	Lakes of Japan, Calderas
Lake Hibara	Lakes of Japan, Fukushima Prefecture
Lake Kuttara	Lakes of Japan, Calderas, Hokkaido Prefecture
IPhone 11 Pro	iPhone, Mobile phones released in 2019, Mobile phones with multiple rear cameras, Mobile phones with 4K video recording
Irwin Fridovich	American biochemists, 1929 births, 2019 deaths, Scientists from New York City
Jacques Dupont (cyclist)	1928 births, 2019 deaths, 1948 Summer Olympics, French cyclists, French Olympians, Olympic bronze medalists, Olympic gold medalists
Sadeque Hossain Khoka	1952 births, 2019 deaths, Bangladeshi politicians, Bangladeshi Muslims, Deaths from kidney cancer, Cancer deaths in New York City
Ahmet Altan	Turkish writers, 1950 births, Living people, People with cancer, Turkish journalists, Critics
Shani Wallis	1933 births, Living people, Naturalized citizens of the United States, American movie actors, American television actors, American stage actors, American singers, English movie actors, English television actors, English stage actors, English singers, Actors from Middlesex
Austin Pendleton	1940 births, Living people, American movie actors, American stage actors, American television actors, American theatre directors, American voice actors, American playwrights, Actors from Ohio, Writers from Ohio
Christmas with the Kranks	2004 comedy movies, American comedy movies, Movies based on books, Movies set in Chicago, Illinois, Movies shot in Chicago, Illinois, Christmas movies
Sajha Party	Political parties in Asia, Nepal
Ravi Shankar Prasad	People from Bihar, Living people, 1954 births
Aryabhata	Indian mathematicians, Astronomers
Chhipaharmai Gaupalika	Municipalities of Nepal
Kalikamai Gaupalika	Municipalities of Nepal
Thori Gaupalika	Municipalities of Nepal
Jira Bhawani Gaupalika	Municipalities of Nepal
1977 Stanley Cup Finals	Boston Bruins, Montreal Canadiens, Stanley Cup Finals
2019 Cotabato earthquakes	2019 disasters in Asia, 2010s in the Philippines, Earthquakes in Asia, Earthquakes in the 2010s, October 2019 events
SetACL	Free software, Microsoft Windows software
Dean Prentice	1932 births, 2019 deaths, Boston Bruins players, Canadian ice hockey left wingers, Detroit Red Wings players, Minnesota North Stars players, New York Rangers players, Pittsburgh Penguins players, Ice hockey people from Ontario, Memorial Cup winners
Mount Alayta	Ethiopia, Volcanoes of Africa
SNK	Video game companies
WorldCat Identities	Libraries, Databases
Hydrogen cyanide	Chemical compounds
Cottonwood Falls, Kansas	Cities in Kansas, County seats in Kansas, Chase County, Kansas
Council Grove, Kansas	Cities in Kansas, County seats in Kansas
Video game crash of 1977	Early video games and events
Elkhart, Kansas	1913 establishments in the United States, Cities in Kansas, County seats in Kansas, 20th-century establishments in Kansas
Erie, Kansas	1866 establishments in Kansas, Cities in Kansas, County seats in Kansas
Eureka, Kansas	1857 establishments in Kansas Territory, County seats in Kansas, Cities in Greenwood County, Kansas
La Crosse, Kansas	Cities in Rush County, Kansas, County seats in Kansas, 1876 establishments in Kansas
Lakin, Kansas	Cities in Kansas, County seats in Kansas, Kearny County, Kansas, 1874 establishments in Kansas
Larned, Kansas	Cities in Kansas, County seats in Kansas, Pawnee County, Kansas
Omero Antonutti	1935 births, 2019 deaths, Cancer deaths in Italy, Italian movie actors, Italian television actors, Italian voice actors
Ernest J. Gaines	1933 births, 2019 deaths, Deaths from natural causes, Writers from Louisiana
Leo Ryan	1925 births, 1978 deaths, American Roman Catholics, American military personnel of World War II, Assassinated people, American murder victims, United States representatives from California, People from Lincoln, Nebraska, Politicians from Nebraska, US Democratic Party politicians
William M. Branham	1909 births, 1965 deaths, Road accident deaths in the United States, American Christians, People from Kentucky, People from Texas
Cumberland County, Kentucky	Kentucky counties, 1798 establishments in Kentucky
Junius Ho	1962 births, Living people, Chinese politicians
Baburam Bhattarai	1954 births, Living people, Prime Ministers of Nepal, Atheists
Pridi Banomyong	1900 births, 1983 deaths, Prime Ministers of Thailand
CITES	Treaties, Endangered species
Lower Mainland	Geography of British Columbia
Fraser Valley	Regional districts in British Columbia
BET Awards	African-American history, Awards
50 Central	2010s American comedy television series, 2017 American television series endings, English-language television programs
Rob Moran	Living people, American movie actors, American television actors, Mexican movie actors, 1963 births
Micro-Hydropower	Electricity
Lev Anninsky	1934 births, 2019 deaths, Russian historians, Russian journalists, Soviet writers, Russian novelists, Essayists
Edward Nixon	1930 births, 2019 deaths, American historians, American autobiographers, Richard Nixon, Businesspeople from California, Writers from California
Bothell, Washington	Cities in Washington (U.S. state)
Knives Out	2019 comedy movies, 2010s mystery movies, American comedy movies, American mystery movies, Movies set in 2018, Lionsgate movies
Ana de Armas	1988 births, Living people, Cuban actors
MonoDevelop	Free software, GNOME, IDEs, Microsoft Windows software
Katherine Langford	1996 births, Living people, Australian movie actors, Australian television actors, Australian voice actors, Canadian movie actors, Canadian television actors, Canadian voice actors, Actors from Perth, Western Australia, Actors from Toronto
Lakeith Stanfield	1991 births, Living people, American movie actors, American television actors, American voice actors, American poets, American rap musicians from California, Actors from California, Musicians from California, Singers from California, Writers from California, People from San Bernardino, California
Redlining	Civil rights
K Callan	1936 births, Living people, American movie actors, American stage actors, American television actors, Writers from Texas, Actors from Dallas, Texas
Leoti, Kansas	Cities in Kansas, County seats in Kansas, 1885 establishments in Kansas
Lindsay Hoyle	1957 births, Living people, Former Labour MPs (UK), Independent politicians, Members of the British House of Commons for English constituencies, Politicians from Lancashire, Privy Councillors (UK), Speakers of the House of Commons of the United Kingdom, UK MPs 1997–2001, UK MPs 2001–2005, UK MPs 2005–2010, UK MPs 2010–2015, UK MPs 2015–2017, UK MPs 2017–2019, UK MPs 2019–
Speaker of the House of Commons (United Kingdom)	Speakers of the House of Commons of the United Kingdom
S. I. Hayakawa	1906 births, 1992 deaths, Deaths from bronchitis, Deaths from Alzheimer's disease, United States senators from California, American academics, Canadian educators, US Republican Party politicians, People from Vancouver
Joe Ricketts	1941 births, Living people, American billionaires, American philanthropists, Businesspeople from Nebraska
List of governors of Nebraska	Governors of Nebraska
Wadden Sea	Seas of the Atlantic Ocean, Bodies of water of Europe
Lincoln Center, Kansas	1870s establishments in Kansas, Cities in Kansas, County seats in Kansas, 1870 establishments in the United States, Lincoln County, Kansas
Lyndon, Kansas	Cities in Osage County, Kansas, County seats in Kansas, 1869 establishments in the United States, 1860s establishments in Kansas
Lyons, Kansas	Cities in Rice County, Kansas, County seats in Kansas, 1870 establishments in Kansas
Mankato, Kansas	Cities in Jewell County, Kansas, County seats in Kansas, 1872 establishments in Kansas
Marion, Kansas	Cities in Marion County, Kansas, County seats in Kansas, 1860 establishments in Kansas Territory
Xia Peisu	1923 births, 2014 deaths, Computer scientists, Chinese scientists, Female scientists, Chinese educators
Meade, Kansas	1885 establishments in Kansas, Cities in Meade County, Kansas, County seats in Kansas
Mound City, Kansas	1855 establishments in Kansas Territory, Cities in Kansas, County seats in Kansas, Linn County, Kansas
Oakley, Kansas	Cities in Thomas County, Kansas, County seats in Kansas, 1884 establishments in Kansas
Oberlin, Kansas	Cities in Kansas, County seats in Kansas, 1878 establishments in the United States, 1870s establishments in Kansas
List of governors of Delaware	Governors of Delaware
Mike Castle	1939 births, Living people, Governors of Delaware, United States representatives from Delaware, Politicians from Wilmington, Delaware, US Republican Party politicians, Lieutenant Governors of Delaware
Osborne, Kansas	Cities in Osborne County, Kansas, County seats in Kansas, 1871 establishments in Kansas
List of governors of Georgia	Governors of Georgia (U.S. state)
Roy Barnes	1948 births, US Democratic Party politicians, Governors of Georgia (U.S. state), Living people
Mableton, Georgia	Census-designated places in Georgia (U.S. state)
Governor of Maine	Governors of Maine
List of governors of Maine	Governors of Maine
John Baldacci	1955 births, Living people, Governors of Maine, United States representatives from Maine, People from Bangor, Maine, US Democratic Party politicians
Oskaloosa, Kansas	1856 establishments in Kansas Territory, Cities in Kansas, County seats in Kansas
List of governors of Mississippi	Governors of Mississippi
Ronnie Musgrove	1956 births, Governors of Mississippi, Living people, US Democratic Party politicians, Lieutenant Governors of Mississippi
Tocowa, Mississippi	Towns in Mississippi
Kirk Fordice	1934 births, 2004 deaths, Deaths from leukemia, American conservatives, Businesspeople from Tennessee, Governors of Mississippi, Politicians from Memphis, Tennessee, US Republican Party politicians
Oswego, Kansas	Cities in Labette County, Kansas, County seats in Kansas, 1867 establishments in Kansas
List of governors of Nevada	Governors of Nevada
List of governors of Utah	Governors of Utah
List of governors of New Mexico	Governors of New Mexico
David Cargo	1929 births, 2013 deaths, Deaths from stroke, American lawyers, Governors of New Mexico, Politicians from Michigan, US Republican Party politicians
Bruce King	1924 births, 2009 deaths, Deaths from heart failure, American military personnel of World War II, Businesspeople from New Mexico, Governors of New Mexico, US Democratic Party politicians
Governor of North Dakota	Governors of North Dakota
List of governors of North Dakota	Governors of North Dakota
Allen I. Olson	1938 births, American Presbyterians, Governors of North Dakota, Living people, American lawyers, US Republican Party politicians
Governor of Oregon	Governors of Oregon
List of governors of Oregon	Governors of Oregon
Governor of South Dakota	Governors of South Dakota
List of governors of South Dakota	Governors of South Dakota
Bill Janklow	1939 births, 2012 deaths, Deaths from brain cancer, American lawyers, Governors of South Dakota, United States representatives from South Dakota, Politicians from Chicago, US Republican Party politicians
Gary Locke	1950 births, Living people, Governors of Washington, United States Secretaries of Commerce, Ambassadors of the United States, Politicians from Seattle, Washington, US Democratic Party politicians
Dixy Lee Ray	1914 births, 1994 deaths, Governors of Washington, Scientists from Washington, People from Tacoma, Washington, US Democratic Party politicians
Booth Gardner	1936 births, 2013 deaths, Deaths from Parkinson's disease, Governors of Washington, Businesspeople from Washington, People from Tacoma, Washington, US Democratic Party politicians
List of governors of West Virginia	Governors of West Virginia
Cecil H. Underwood	1922 births, 2008 deaths, Deaths from cerebral hemorrhage, Deaths from congestive heart failure, Governors of West Virginia, US Republican Party politicians
Gaston Caperton	1940 births, Living people, Governors of West Virginia, People from Charleston, West Virginia, US Democratic Party politicians
Bob Wise	1948 births, United States representatives from West Virginia, US Democratic Party politicians, Governors of West Virginia, Living people
List of mayors of Washington, D.C.	Mayors of Washington, D.C.
Sharon Pratt	1944 births, Living people, Mayors of Washington, D.C., US Democratic Party politicians
Mayor of the District of Columbia	Mayors of Washington, D.C.
Anthony A. Williams	1951 births, Living people, Mayors of Washington, D.C., Politicians from Los Angeles, California, US Democratic Party politicians
Flag of Washington, D.C.	Washington, D.C.
List of governors of American Samoa	Governors of American Samoa
Togiola Tulafono	1947 births, Governors of American Samoa, Living people, US Democratic Party politicians, Lieutenant Governors of American Samoa
List of governors of Guam	Governors of Guam
List of governors of the Northern Mariana Islands	Governors of the Northern Mariana Islands
List of governors of the United States Virgin Islands	Governors of the United States Virgin Islands
Roy L. Schneider	1939 births, Living people, American military personnel of the Vietnam War, Governors of the United States Virgin Islands, American physicians, US Republican Party politicians
List of prime ministers of Czechoslovakia	Prime Ministers of Czechoslovakia
Rajni KC	Nepalese politicians
Jan Stráský	1940 births, 2019 deaths, Presidents of Czechoslovakia, Prime Ministers of Czechoslovakia
2021 Canadian federal election	21st century in Canada, 2021 elections, September 2021 events
Next Australian federal election	21st century in Australia
Rebekha Sharkie	1972 births, Living people, Australian politicians
Coalition (Australia)	Political parties in Australia
Katter's Australian Party	2011 establishments in Australia, Political parties in Australia
Centre Alliance	Political parties in Australia
Pauline Hanson's One Nation	Political parties in Australia, 1990s establishments in Australia, 1997 establishments
Pauline Hanson	1954 births, Living people, Politicians from Queensland
Fayette County, Kentucky	Kentucky counties, 1780s establishments in Virginia, 1780 establishments in North America
Bukit Batok MRT station	Mass Rapid Transit (Singapore) stations, 20th century establishments in Singapore, 1990 establishments
Bukit Gombak MRT station	Mass Rapid Transit (Singapore) stations, 1990 establishments in Asia, 20th century establishments in Singapore
Brickland MRT station	Proposed railway stations in Singapore, Mass Rapid Transit (Singapore) stations
Sungei Kadut MRT station	Mass Rapid Transit (Singapore) stations
Maria Fire	Ventura County, California, Fires in North America
Tick Fire	2019 in California, Santa Clara County, California, 2010s fires, Fires in the United States, October 2019 events
Yew Tee MRT station	Mass Rapid Transit (Singapore) stations, 1996 establishments in Asia, 20th century establishments in Singapore
AutoIt	Programming languages
Duane Vermeulen	Rugby players
Gabriel Jackson	1921 births, 2019 deaths, American historians, American journalists, Writers from New York
Margarita Salas	1938 births, 2019 deaths, Spanish scientists, Biochemists
Nabaneeta Dev Sen	1938 births, 2019 deaths, Deaths from lung cancer, Indian educators, Indian poets, Indian novelists
Liliana Segre	1930 births, Living people, Italian Jews, Italian politicians, Holocaust survivors, Italian political activists, People from Milan
Luciano Gasperini	1935 births, Living people, Italian politicians
Umberto Bossi	1941 births, Living people, Italian politicians, Criminals
Jürgen Mossack	1948 births, Living people, German lawyers, German criminals, People from Panama City
Ramón Fonseca Mora	1952 births, Living people, Lawyers, Criminals, People from Panama City
Operation Car Wash	2010s in South America
The Laundromat (movie)	2010s biographical movies, 2010s criminal comedy movies, 2019 comedy-drama movies, 2010s crime drama movies, American biographical movies, American criminal comedy movies, American comedy-drama movies, American crime drama movies, Netflix movies, Movies directed by Steven Soderbergh
USS Somerset (LPD-25)	Naval ships of the United States
St. Francis, Kansas	Cities in Kansas, County seats in Kansas, Cheyenne County, Kansas, 1887 establishments in Kansas
St. John, Kansas	Cities in Kansas, County seats in Kansas, 1875 establishments in Kansas
Scott City, Kansas	Cities in Kansas, County seats in Kansas, 1885 establishments in Kansas
Sedan, Kansas	Cities in Kansas, County seats in Kansas, 1871 establishments in Kansas, Chautauqua County, Kansas
Willy Russell	1947 births, Living people, English playwrights, English composers, People from Merseyside
Seneca, Kansas	Cities in Nemaha County, Kansas, County seats in Kansas, 1857 establishments in Kansas Territory
Sharon Springs, Kansas	Cities in Kansas, County seats in Kansas, 1868 establishments in Kansas
Smith Center, Kansas	Cities in Smith County, Kansas, County seats in Kansas, 1871 establishments in Kansas
Sublette, Kansas	Cities in Kansas, County seats in Kansas
Syracuse, Kansas	Cities in Kansas, County seats in Kansas, 1873 establishments in Kansas
Educating Rita	Open University, Plays by Willy Russell, British plays adapted into movies
Shirley Valentine	British plays adapted into movies, Plays by Willy Russell
Medicine Lodge, Kansas	Cities in Barber County, Kansas, County seats in Kansas, 1873 establishments in Kansas
Columbus, Kansas	Cities in Cherokee County, Kansas, County seats in Kansas, 1868 establishments in Kansas
Educating Rita (movie)	1983 comedy-drama movies, British comedy-drama movies, Columbia Pictures movies, Movies about educators, Movies set in universities and colleges, Open University, BAFTA Award winning movies, Movies directed by Lewis Gilbert
Pauline Collins	1940 births, BAFTA Award winners, Drama Desk Award winners, English movie actors, English Roman Catholics, English stage actors, English television actors, Laurence Olivier Award winners, Living people, Officers of the Order of the British Empire, Tony Award winning actors, People from Devon
NES Advantage	Joysticks, Nintendo
Remo Bodei	1938 births, 2019 deaths, Italian philosophers
George Tarasovic	1930 births, 2019 deaths, American football linebackers, Pittsburgh Steelers players, Philadelphia Eagles players, Denver Broncos players, Sportspeople from New York, Sportspeople from Pennsylvania
Granville, New York	Towns in New York
Fort Edward (town), New York	Towns in New York, County seats in New York
Parsa District	Districts of Nepal
Torryburn	Villages in Fife, Parishes
City of Joy (movie)	1992 movies, 1992 drama movies, English-language movies, Movies composed by Ennio Morricone, British drama movies, French drama movies, Movies set in India, Movies directed by Roland Joffé, Movies based on books
Butch Goring	1949 births, Bill Masterton Memorial Trophy winners, Boston Bruins players, Canadian ice hockey centres, Canadian ice hockey coaches, Conn Smythe Trophy winners, Ice hockey people from Manitoba, Lady Byng Memorial Trophy winners, Living people, Los Angeles Kings players, New York Islanders players, Regina Pats players, Sportspeople from Winnipeg, Stanley Cup champions, Winnipeg Jets (WHL) players
Jim Benzelock	1947 births, Canadian ice hockey right wingers, Ice hockey people from Manitoba, International Hockey League (1945–2001) players, Living people, Sportspeople from Winnipeg, Winnipeg Jets (WHL) players, World Hockey Association players, Central Professional Hockey League players
Jouko Innanen	1952 births, 2019 deaths, Finnish people, Cartoonists
Kranji MRT station	Mass Rapid Transit (Singapore) stations
Echocardiography	Cardiology
Admiralty MRT station	Mass Rapid Transit (Singapore) stations
Divo, Ivory Coast	Cities in Ivory Coast
The Firm (1989 movie)	1989 movies, English-language movies
Millook	Cornwall, Orogenies, Metamorphic rocks
Basel Mission	19th century establishments in Switzerland, 1815 establishments in Europe, Christian organizations, Basel
Duty to rescue	Law
Russian Grand Prix	Formula One Grands Prix
Monrovia, Kansas	Unincorporated communities in Kansas, 1856 establishments in Kansas Territory, Atchison County, Kansas
Canadian Home Video Rating System	Movie ratings
William Wintersole	1931 births, 2019 deaths, American movie actors, American television actors, Actors from Ohio
Hermanubis	Egyptian gods and goddesses, Greek gods and goddesses
Günter Litfin	1937 births, 1961 deaths, Berlin Wall, Deaths by firearm
Aviation Park MRT station	Mass Rapid Transit (Singapore) stations
Loyang MRT station	Mass Rapid Transit (Singapore) stations
Pasir Ris East MRT station	Mass Rapid Transit (Singapore) stations
Master Roshi	Dragon Ball characters, Fictional characters introduced in 1984, Fictional characters with slowed ageing
Santa Fe de Nuevo México	New Mexico, 1590s establishments, 1848 disestablishments
Tampines North MRT station	Mass Rapid Transit (Singapore) stations
Oron-le-Châtel	Former municipalities of Vaud
Vuibroye	Former municipalities of Vaud
André Breton	1896 births, 1966 deaths, French atheists
Ema Horvath	1994 births, Living people, American movie actors
Grandvaux, Switzerland	2011 disestablishments in Switzerland, Former municipalities of Vaud
Riex	2011 disestablishments in Switzerland, Former municipalities of Vaud
Paudex	Municipalities of Vaud
Union City, Oklahoma	Towns in Oklahoma
The Broker's Man	1990s British drama television series, BBC television dramas, British crime television series, English-language television programs
A Fish Called Wanda	1988 movies, British movies, English-language movies, American movies
Rivaz	Municipalities of Vaud
Essertes	Municipalities of Vaud
Les Cullayes	2010s disestablishments in Switzerland, 2012 disestablishments in Europe, Former municipalities of Vaud
Ferlens	Former municipalities of Vaud
Puidoux	Municipalities of Vaud
Forel (Lavaux)	Municipalities of Vaud
1993–94 Belizean municipal elections	1993 elections, 1994 elections
Stoneware	Pottery
Servion	Municipalities of Vaud
Jesse Lingard	1992 births, Living people, Black British sportspeople, English footballers, Manchester United F.C. players, West Ham United F.C. players, Premier League players, 2018 FIFA World Cup players
Chexbres	Municipalities of Vaud
Roff, Oklahoma	Towns in Oklahoma
Skedee, Oklahoma	Towns in Oklahoma
Constitutional law	Law
Heart (symbol)	Symbols
Robert Fulton	1765 births, 1815 deaths, Engineers from Pennsylvania, American inventors
Thomas Pelham-Holles, 1st Duke of Newcastle	Prime Ministers of Great Britain, Whig party (UK) politicians
VSCO	Software, Photography
Samsung Galaxy S10	Samsung mobile phones, Mobile phones released in 2019, Mobile phones with multiple rear cameras, Mobile phones with 4K video recording
Jeanine Áñez	1967 births, Living people, Presidents of Bolivia
Ringling, Oklahoma	Towns in Oklahoma
Maracon	Municipalities of Vaud
Savigny, Switzerland	Municipalities of Vaud
Wing coupling	Lepidoptera
Andijan Region	Uzbekistan, Regions
Meganisoptera	Odonata
Bitburg	Cities in Rhineland-Palatinate
Bitburg controversy	20th century in Germany, Presidency of Ronald Reagan
Azerbaijan Grand Prix	Formula One Grands Prix
Fort Jones, Calaveras County, California	Unincorporated communities in California, Settlements in Calaveras County, California
Young Adult Library Services Association	1957 establishments in the United States, Libraries
Phillip E. Johnson	1940 births, 2019 deaths, American lawyers, American educators, People from Aurora, Illinois, Writers from Berkeley, California, Writers from Illinois
Shoji Sadao	Japanese architects, 2019 deaths, 1926 births, Deaths from heart failure, Deaths from renal failure, American architects, Businesspeople from Los Angeles, California, Naturalized citizens of the United States
SKEMA Business School	Education in France
List of mountains in the Andes	Andes, Mountains of South America, Geography-related lists
Michael Hanack	1931 births, 2019 deaths, German chemists
Governor-General of Jamaica	Governors-General of Jamaica
Leo Klejn	1927 births, 2019 deaths, Russian scientists, Archaeologists, Russian writers
Heinz Höher	1938 births, 2019 deaths, German footballers, German football managers
Ivan Maksimović	1962 births, 2019 deaths, Serbian people, Rock guitarists
Maria Perego	1923 births, 2019 deaths, Italian artists, Animators, People from Venice
Fred Bongusto	1935 births, 2019 deaths, Italian singers, Italian composers
Lucette Destouches	French dancers, French centenarians, 1912 births, 2019 deaths
Edwin Bramall	1923 births, 2019 deaths, British military people, People from Kent
Salp	Chordates
Admire, Kansas	Cities in Lyon County, Kansas, 1886 establishments in Kansas
Agenda, Kansas	Cities in Kansas, 1887 establishments in Kansas
Siege of Ravenna (539-540)	History, War
Kathryn Pogson	Living people, English movie actors, 1954 births
Isabel, Kansas	Cities in Barber County, Kansas, 1887 establishments in Kansas
Nirvana discography	Nirvana (band), Discographies
Inman, Kansas	Cities in Kansas, 1887 establishments in Kansas
Hormoaning	Nirvana (band)
Ismail Mire	1861 births, 1950 deaths, Somali people
Iuka, Kansas	Cities in Pratt County, Kansas, 1877 establishments in Kansas
Jamestown, Kansas	Cities in Cloud County, Kansas, 1878 establishments in Kansas
Red Apple, California	Unincorporated communities in California, Settlements in Calaveras County, California
Sonic the Hedgehog (movie)	Movies based on video games, American action movies, Japanese movies, American adventure movies, Uncanny valley, American superhero movies, 2020s superhero movies
Chatham Islands	New Zealand, Pacific islands
Ojos del Salado	Mountains of Argentina, Mountains of Chile, Andes, Volcanoes of Chile
Monte Pissis	Mountains of Argentina, Andes
Cerro Bonete	Mountains of Argentina, Andes
Cerro Bonete (Bolivia)	Volcanoes of South America, Geography of Bolivia
Dick Dearden	1938 births, 2019 deaths, State legislators of the United States, Politicians from Des Moines, Iowa, US Democratic Party politicians
Virginia Leith	1925 births, Actors from Cleveland, Ohio, American movie actors, American television actors, 2019 deaths
John Gokongwei	1926 births, 2019 deaths, Filipino businesspeople, People from Manila, Filipino philanthropists
Noel Ignatiev	1940 births, 2019 deaths, Infectious disease deaths in the United States, American historians, American political writers, American educators, American critics, Writers from Philadelphia, Pennsylvania
Brian Mawhinney	1940 births, 2019 deaths, Former Conservative MPs (UK), Knights Bachelor, UK MPs 1979–1983, UK MPs 1983–1987, UK MPs 1987–1992, UK MPs 1992–1997, UK MPs 1997–2001, UK MPs 2001–2005
Džemma Skulme	1925 births, Latvian people, Painters, 2019 deaths
T. N. Seshan	1932 births, 2019 deaths, Deaths from cardiac arrest, Indian politicians
Bell Boeing V-22 Osprey	Bell aircraft, Boeing aircraft
István Szívós	1948 births, 2019 deaths, Olympic gold medalists, Olympic silver medalists, Hungarian water polo players, Sportspeople from Budapest
Supercarrier	Air travel
Don Cherry	1934 births, American Hockey League players, Boston Bruins players, Canadian ice hockey coaches, Canadian ice hockey defencemen, Ice hockey people from Ontario, Jack Adams Award winners, Living people, National Hockey League broadcasters, Sports commentators, Ontario Hockey League players, Central Professional Hockey League players
Premier of the Virgin Islands	Premiers of the British Virgin Islands
Andrew Fahie	Premiers of the British Virgin Islands, 1970 births, Living people
Ralph T. O'Neal	1933 births, Premiers of the British Virgin Islands, 2019 deaths
Orlando Smith	1944 births, Living people, Premiers of the British Virgin Islands
Zeke Bratkowski	1931 births, 2019 deaths, Deaths from myocardial infarction, Cardiovascular disease deaths in Florida, American football quarterbacks, Chicago Bears players, Green Bay Packers players, Los Angeles Rams players, Sportspeople from Illinois, People from Danville, Illinois
Santa Rosa Beach, Florida	Unincorporated communities in Florida
Frank Dobson	1940 births, 2019 deaths, Alumni of the London School of Economics, People from York, Politicians from Yorkshire, UK MPs 1983–1987, UK MPs 1979–1983, UK MPs 1987–1992, UK MPs 1992–1997, UK MPs 1997–2001, UK MPs 2001–2005, UK MPs 2005–2010, UK MPs 2010–2015, Former Labour MPs (UK), Politicians from London
Mount Frank Rae	Mountains of Canada, Yukon
Winston Lackin	1954 births, 2019 deaths, Deaths from cancer, Surinamese politicians
James Le Mesurier	1971 births, 2019 deaths, British military people, Humanitarians, Singaporean people
Deval Patrick 2020 presidential campaign	2020 United States presidential campaigns
Kieran Modra	1972 births, 2019 deaths, Road accident deaths, Australian swimmers, Cyclists, Sportspeople from South Australia
Raymond Poulidor	1936 births, 2019 deaths, Deaths from pulmonary edema, French cyclists
List of Ultras of Canada	Mountains of Canada, Geography of Canada, Geography-related lists, Canada-related lists
Ultra-prominent peak	Mountains
Coats, Kansas	Cities in Pratt County, Kansas, 1887 establishments in Kansas
Cuba, Kansas	Cities in Kansas, 1868 establishments in Kansas
Jennings, Kansas	Cities in Kansas
Jewell, Kansas	Cities in Jewell County, Kansas, 1870 establishments in Kansas
Anton Körberg	Living people, 1977 births, Swedish actors
Valley Falls, Kansas	Cities in Kansas, 1854 establishments in Kansas Territory
Vermillion, Kansas	Cities in Marshall County, Kansas, 1869 establishments in Kansas
Virgil, Kansas	Cities in Greenwood County, Kansas
Victoria, Kansas	Cities in Kansas, 1873 establishments in Kansas
LGBT rights	LGBT rights
Vining, Kansas	Cities in Washington County, Kansas, 1877 establishments in Kansas
Viola, Kansas	Cities in Sedgwick County, Kansas
Wormwood (Bible)	Old Testament
Tom Spurgeon	1968 births, 2019 deaths, American comics writers, American historians, American journalists, American critics, Writers from Indiana, People from Muncie, Indiana
Mümtaz Soysal	1929 births, 2019 deaths, Turkish writers, Turkish politicians, Political writers, Political activists, Human rights activists, Turkish educators, Criminals, Columnists, Political scientists
Niall Tóibín	1929 births, 2019 deaths, Irish movie actors, Irish comedians, Irish stage actors, Irish television actors, People from Cork (city)
Protobothrops elegans	Vipers
List of mountain peaks by prominence	Geography-related lists, Mountains
Saugus High School shooting	2019 mass shootings, 2019 murders in the United States, 2010s crimes in California, 2010s mass shootings in the United States, Los Angeles County, California, Mass shootings in California, Murder-suicides in California, Murders by firearm in California, November 2019 events, Suicide in the 2010s, Suicides by firearm in the United States
Víctor Manuel Pérez Rojas	1940 births, 2019 deaths, Deaths from heart failure, Deaths from diabetes, Bishops, Roman Catholics, Venezuelan people
José Luis Veloso	1937 births, 2019 deaths, Spanish footballers
Branko Lustig	Academy Award winners, 1932 births, 2019 deaths, Deaths from heart failure, Holocaust survivors, Croatian movie producers
Parent peak	Mountains
Col	Landforms
Tampa, Kansas	1887 establishments in Kansas, Cities in Marion County, Kansas
Towanda, Kansas	Cities in Butler County, Kansas, 1870 establishments in Kansas
Tescott, Kansas	1866 establishments in Kansas, Cities in Ottawa County, Kansas
Thayer, Kansas	1870 establishments in Kansas, Cities in Kansas
Timken, Kansas	Cities in Rush County, Kansas
Tipton, Kansas	Cities in Mitchell County, Kansas, 1872 establishments in Kansas
List of Ultras of Mexico	Mountains of North America, Geography of Mexico, Geography-related lists
Turon, Kansas	Cities in Reno County, Kansas, 1886 establishments in Kansas
Tyro, Kansas	Cities in Montgomery County, Kansas
Joanna Macy	1929 births, Living people, American environmentalists, Ecologists, American educators, Scientists from San Francisco, Writers from San Francisco
María Baxa	1946 births, 2019 deaths, Croatian people, Italian movie actors, Serbian people, Italian models
Dennis Prager	American conservatives, American radio personalities, American political commentators
Bob Johnson (infielder)	1936 births, 2019 deaths, Kansas City Athletics players, Oakland Athletics players, Baltimore Orioles players, New York Mets players, Cincinnati Reds players, Atlanta Braves players, St. Louis Cardinals players, Sportspeople from Omaha, Nebraska
Linda Lavin	Tony Award winning actors, Golden Globe Award winning actors, Drama Desk Award winners, 1937 births, Living people, American movie actors, American television actors, American stage actors, American voice actors, American musical theatre actors, Actors from Maine, Actors from New York City, Singers from Maine, Singers from New York City, People from Portland, Maine
Interstellar cloud	Nebulae, Hydrogen, Red giants
H I region	Milky Way, Hydrogen
Lockman Hole	Astronomy, Milky Way
Chandra Deep Field South	Telescopes, Satellites, Fornax (constellation)
Koyra Madinabad Model Secondary School	20th century establishments in Bangladesh, 1962 establishments in Asia, Schools in Bangladesh
List of Ultras of the United States	Mountains of the United States, Geography of the United States, Geography-related lists
Dearing, Kansas	Cities in Montgomery County, Kansas
Ben Shapiro	American conservatives, American radio personalities, American political commentators, Podcasters, American bloggers
Spring Hill, Kansas	Cities in Johnson County, Kansas, Cities in Miami County, Kansas, 1856 establishments in Kansas Territory
NES Satellite	Nintendo hardware
Mulvane, Kansas	Cities in Sedgwick County, Kansas, Cities in Sumner County, Kansas, 1879 establishments in Kansas
Basehor, Kansas	1889 establishments in the United States, Cities in Kansas
H.O.T. (band)	South Korean boy bands, K-pop music groups, Hip hop bands, 1996 establishments in Asia, 1990s establishments in South Korea
Montpreveyres	Municipalities of Vaud
Saint-Saphorin (Lavaux)	Municipalities of Vaud
Altamont, Kansas	Cities in Labette County, Kansas, 1879 establishments in Kansas
Abbyville, Kansas	Cities in Reno County, Kansas, Cities in Kansas
Assaria, Kansas	Cities in Saline County, Kansas, 1879 establishments in Kansas
Altoona, Kansas	Cities in Wilson County, Kansas, 1869 establishments in Kansas
Americus, Kansas	Cities in Lyon County, Kansas, 1857 establishments in Kansas Territory
Athol, Kansas	Cities in Smith County, Kansas, 1888 establishments in Kansas
Agra, Kansas	Cities in Phillips County, Kansas, 1888 establishments in Kansas
Andale, Kansas	Cities in Sedgwick County, Kansas, 1880s establishments in Kansas
Albert, Kansas	Cities in Kansas, Barton County, Kansas, 1880s establishments in Kansas
Alden, Kansas	Cities in Rice County, Kansas, 1872 establishments in Kansas
Allen, Kansas	Cities in Lyon County, Kansas, 1854 establishments in Kansas Territory
Missouri Pacific Railroad	American transport companies
Wendell Bell	1924 births, 2019 deaths, American sociologists, American educators, Writers from Chicago, Scientists from Chicago, Writers from California, Scientists from California, People from Fresno, California, American military personnel of World War II
Vladimir Hotineanu	1950 births, 2019 deaths, Moldovan politicians
Irv Noren	1924 births, 2019 deaths, Chicago Cubs players, Minnesota Twins players, Kansas City Athletics players, Los Angeles Dodgers players, New York Yankees players, St. Louis Cardinals players, American basketball players, Sportspeople from New York, Sportspeople from California, People from Pasadena, California
Juliusz Paetz	1935 births, 2019 deaths, Polish Roman Catholics, Bishops, People from Poznań
Seminole	Native American people, Florida, Oklahoma
Bern, Kansas	Cities in Nemaha County, Kansas
Appakkudathaan Perumal Temple	Hindu temples
Alexander, Kansas	Cities in Rush County, Kansas, 1869 establishments in Kansas
Oneida, Kansas	Cities in Nemaha County, Kansas
Alta Vista, Kansas	1887 establishments in Kansas, Cities in Wabaunsee County, Kansas
Eskridge, Kansas	Cities in Wabaunsee County, Kansas
Yoshiki Shibata	Living people, 1959 births, Japanese people
Daimokutate	Nara Prefecture, Japanese culture
Territories of the United States	United States-related lists
Vajira princess	Indian monarchs
Sugden, Oklahoma	Towns in Oklahoma
Yeager, Oklahoma	Towns in Oklahoma
Colombier, Vaud	2011 disestablishments in Switzerland, Former municipalities of Vaud
Lonay	Municipalities of Vaud
Emmett, Kansas	Cities in Pottawatomie County, Kansas
Haghpat Monastery	Coordinates on Wikidata, Pages with unreviewed translations
Tristan Rogers	1946 births, Living people, Actors from Melbourne, American television actors, American voice actors, Actors from California, People from Palm Springs, California, Australian television actors, Australian voice actors
Michael Kamen	1948 births, 2003 deaths, American movie score composers, Jewish American musicians, Musicians from New York City, People with multiple sclerosis
Buddy Baker (composer)	1918 births, 2002 deaths, American movie score composers, Musicians from Missouri, People from Springfield, Missouri
Yio Chu Kang MRT station	Mass Rapid Transit (Singapore) stations
Serangoon North MRT station	Mass Rapid Transit (Singapore) stations
Havensville, Kansas	Cities in Pottawatomie County, Kansas, 1878 establishments in Kansas
Onaga, Kansas	1877 establishments in Kansas, Cities in Pottawatomie County, Kansas
Whig party	Political parties in England, Political parties in Scotland
Protégé	Words
Microsoft Word Viewer	Microsoft Office
Bussigny, Vaud	Municipalities of Vaud
Bremblens	Municipalities of Vaud
Aclens	Municipalities of Vaud
Allaman	Municipalities of Vaud, Villages in Vaud
Ballens	Municipalities of Vaud
Saubraz	Municipalities of Vaud
Romainmôtier-Envy	Municipalities of Vaud, Cities in Switzerland
Etoy, Switzerland	Municipalities of Vaud
Messieurs les noyés de la Seine	1956 songs
Hudhud	Filipino culture
Victor Lindelöf	1994 births, Living people, Swedish footballers, Manchester United F.C. players, Premier League players, UEFA Euro 2016 players, 2018 FIFA World Cup players
Charles Grandison Finney	1792 births, 1875 deaths, American abolitionists, American Evangelicals, American Presbyterians, American theologians, American writers, Christian theologians, Congregationalists, People from Connecticut
Prime Minister of Iraq	Prime Ministers of Iraq
Adil Abdul-Mahdi	1942 births, Living people, Prime Ministers of Iraq, Vice Presidents of Iraq, People from Baghdad
President of Iraq	Presidents of Iraq
Barham Salih	1960 births, Living people, Presidents of Iraq, Current national leaders
Doug Bowser	1965 births, American businesspeople, American chief executives, Living people, Nintendo people
Strawberry poison-dart frog	Poison dart frogs
Nevado Tres Cruces	Mountains of Argentina, Mountains of Chile, Volcanoes of Chile, Andes
Paul Smith (composer)	1906 births, 1985 deaths, Deaths from Alzheimer's disease, American movie score composers, Musicians from Michigan
Mount Roraima	Guyana, Venezuela, Geography of Brazil, Mountains of South America
Massif	Mountains, Landforms
Mark Cady	1953 births, 2019 deaths, Deaths from myocardial infarction, American judges, Politicians from South Dakota, Politicians from Des Moines, Iowa, Independent politicians in the United States
Jim Coates	1932 births, 2019 deaths, New York Yankees players, Cincinnati Reds players, Los Angeles Angels players, Texas Rangers players, Sportspeople from Virginia
Vojtěch Jasný	1925 births, 2019 deaths, Czech movie directors
John Campbell Brown	1947 births, Scottish people, Astronomers, 2019 deaths
Diane Loeffler	1953 births, 2019 deaths, Cancer deaths in the United States, State legislators of the United States, Politicians from Minneapolis, Minnesota, US Democratic Party politicians
Zeng Guoyuan	1953 births, 2019 deaths, Suicides by jumping, People with cancer, Singaporean politicians, Singaporean businesspeople
Norodom Buppha Devi	1943 births, 2019 deaths, Princes and princesses, Civil servants, Ballerinas, Cambodian people
Almena, Kansas	Cities in Kansas
Group of Seven	G7
List of G7 leaders	G7
Zenkō Suzuki	Prime Ministers of Japan, 1911 births, 2004 deaths, Deaths from pneumonia
List of prime ministers of Japan	Prime Ministers of Japan
Giovanni Spadolini	1925 births, 1994 deaths, Presidents of Italy, Prime Ministers of Italy, People from Florence
Arlington, Kansas	Cities in Reno County, Kansas
Saburō Ōkita	1914 births, 1993 deaths, Japanese economists, Japanese politicians
Masayoshi Ōhira	1910 births, 1980 deaths, Deaths from myocardial infarction, Prime Ministers of Japan
Aurora, Kansas	Cities in Cloud County, Kansas
Takeo Miki	1907 births, 1988 deaths, Prime Ministers of Japan
Arma, Kansas	Cities in Crawford County, Kansas
Axtell, Kansas	Cities in Marshall County, Kansas
Argonia, Kansas	1881 establishments in Kansas, Cities in Sumner County, Kansas
PragerU	2009 establishments in the United States, Conservatism, American websites
Auburn, Kansas	Cities in Kansas
Barnard, Kansas	Cities in Kansas, 1888 establishments in Kansas, Lincoln County, Kansas
Bennington, Kansas	Cities in Ottawa County, Kansas, 1878 establishments in Kansas
Bucklin, Kansas	Cities in Ford County, Kansas, 1885 establishments in Kansas
Bentley, Kansas	Cities in Sedgwick County, Kansas, 1888 establishments in Kansas
Buffalo, Kansas	Cities in Wilson County, Kansas, 1867 establishments in Kansas
Barnes, Kansas	Cities in Washington County, Kansas, 1870 establishments in Kansas
Benton, Kansas	Cities in Butler County, Kansas, 1884 establishments in Kansas
Buhler, Kansas	Cities in Reno County, Kansas, 1888 establishments in Kansas
Terry O'Neill (photographer)	1938 births, 2019 deaths, Deaths from prostate cancer, Cancer deaths in London, British photographers, Businesspeople from London
Liza Weil	1977 births, Living people, American movie actors, American television actors, American child actors, American stage actors, American voice actors, Actors from New Jersey, Actors from Pennsylvania, People from Passaic, New Jersey
Lansdale, Pennsylvania	Boroughs in Pennsylvania
Donald Carcieri	1942 births, Living people, Governors of Rhode Island, Businesspeople from Rhode Island, US Republican Party politicians
Olivia Culpo	1992 births, Living people, Miss Universe winners, Businesspeople from Rhode Island, American television personalities, American movie actors, Internet celebrities, Actors from Rhode Island, People from Cranston, Rhode Island
Bruce Robinson	BAFTA Award winning writers, 1946 births, Living people, English novelists, English movie actors, English television actors, Actors from London, Movie directors from London, Screenwriters from London
New Zealand at the 2012 Summer Olympics	2012 Summer Olympics
Siruguppa	Cities in India, Settlements in Karnataka
Mount Saint Elias	Mountains of Canada, Yukon, Mountains of the United States, Geography of Alaska
Myrtle Devenish	Welsh movie actors, 1913 births, 2007 deaths
Barbara Hicks	1924 births, 2013 deaths, English movie actors, People from Wolverhampton
Nyagan	Towns in Russia
Quonset hut	Buildings and structures, World War II
R. Sampanthan	1933 births, Living people, Sri Lankan politicians
Gotabaya Rajapaksa	1949 births, Living people, Presidents of Sri Lanka, Current national leaders
Karu Jayasuriya	1940 births, Living people, Speakers of the Parliament of Sri Lanka, Mayors
Speaker of the Parliament of Sri Lanka	Speakers of the Parliament of Sri Lanka
M. H. Mohamed	1921 births, 2016 deaths, Speakers of the Parliament of Sri Lanka, Mayors
W. J. M. Lokubandara	1941 births, 2021 deaths, Speakers of the Parliament of Sri Lanka, Deaths from the COVID-19 pandemic
Chief Justice of Sri Lanka	Chief Justices of Sri Lanka
Jayantha Jayasuriya	Living people, Sri Lankan lawyers, Chief Justices of Sri Lanka
Mohan Peiris	Living people, Chief Justices of Sri Lanka
Zeca Afonso	1929 births, 1987 deaths, Deaths from motor neurone disease, Portuguese singers, Guitarists, Political activists, Communists, Folk musicians
Aveiro, Portugal	Cities in Portugal, Municipalities of Portugal
José Mário Branco	1942 births, 2019 deaths, Deaths from stroke, Portuguese singers, Portuguese musicians, Singer-songwriters, Portuguese writers, Portuguese movie actors, Record producers
Ross Barnett	Governors of Mississippi
Tom Lyle	1953 births, 2019 deaths, Deaths from intracranial aneurysm, Deaths from surgical complications, American comics artists, American comics writers, American educators, Writers from Jacksonville, Florida
Bartlett, Kansas	Cities in Labette County, Kansas, 1886 establishments in Kansas
Bunker Hill, Kansas	Cities in Russell County, Kansas, 1871 establishments in Kansas
Beverly, Kansas	Cities in Kansas, 1886 establishments in Kansas, Lincoln County, Kansas
Bassett, Kansas	20th-century establishments in Kansas, Cities in Allen County, Kansas, 1903 establishments in the United States
Nintendo 64 accessories	Nintendo hardware
Bird City, Kansas	Cities in Kansas, Cheyenne County, Kansas, 1885 establishments in Kansas
Burdett, Kansas	Cities in Kansas, Pawnee County, Kansas
Bison, Kansas	Cities in Rush County, Kansas
Burlingame, Kansas	Cities in Osage County, Kansas, 1855 establishments in Kansas Territory
Bazine, Kansas	Cities in Ness County, Kansas
Pehlwani	Sport in Pakistan
Nergis Mavalvala	1968 births, Living people, American academics, American physicists, Astrophysicists, Lesbians, LGBT people from Massachusetts, LGBT scientists, Massachusetts Institute of Technology alumni, Pakistani scientists, People from Cambridge, Massachusetts, People from Lahore, Scientists from Massachusetts, Zoroastrians
Sexual consent	Human sexuality
Consent	Rape
Oona Chaplin	1986 births, Living people, Spanish movie actors, Spanish television actors, Spanish voice actors, Spanish stage actors, British movie actors, British television actors, British stage actors, British voice actors, Actors from Madrid, Actors from London, Actors who played in James Bond movies
Katherine Maher	1983 births, Living people, New York University alumni, Wikipedia people, People from Wilton, Connecticut
William H. Brown III	1928 births, Living people, American lawyers, Politicians from Philadelphia, Pennsylvania, US Republican Party politicians
Jan Rabson	American actors, 1954 births, Living people
El Hiwar El Tounsi	Television channels
Blue Mound, Kansas	Cities in Kansas, Linn County, Kansas
Beattie, Kansas	Cities in Marshall County, Kansas
Blue Rapids, Kansas	Cities in Marshall County, Kansas, 1869 establishments in Kansas
Burns, Kansas	Cities in Marion County, Kansas, 1880 establishments, 1880s establishments in Kansas
Bluff City, Kansas	Cities in Harper County, Kansas
Burr Oak, Kansas	Cities in Jewell County, Kansas
Belle Plaine, Kansas	Cities in Sumner County, Kansas, 1871 establishments in Kansas
Bogue, Kansas	Cities in Kansas, Graham County, Kansas, 1888 establishments in Kansas
Burrton, Kansas	Cities in Kansas
Bushong, Kansas	Cities in Lyon County, Kansas
Brewster, Kansas	Cities in Thomas County, Kansas
Bushton, Kansas	Cities in Rice County, Kansas
Belpre, Kansas	Cities in Kansas, 1879 establishments in Kansas
Bronson, Kansas	Cities in Bourbon County, Kansas, 1881 establishments in Kansas
Byers, Kansas	Cities in Pratt County, Kansas, 1914 establishments
Belvue, Kansas	Cities in Pottawatomie County, Kansas
Brookville, Kansas	Cities in Saline County, Kansas
Benedict, Kansas	Cities in Wilson County, Kansas
Plat	Geography of the United States
Amos Lapidot	1934 births, 2019 deaths, Israeli military people, Israeli educators
John Mann (musician)	1962 births, 2019 deaths, Deaths from Alzheimer's disease, Cancer survivors, Folk musicians, Folk singers, Canadian rock singers, Canadian rock guitarists, Canadian singer-songwriters, Canadian movie actors, Canadian stage actors, Canadian television actors, Actors from Calgary, Musicians from Alberta
Singapore Democratic Party	1980s establishments in Singapore, 1980 establishments in Asia, Liberal parties, Politics of Asia, Singapore
Tanja M. Schuster	Living people
Giorgi Gakharia	1975 births, Living people, Prime Ministers of Georgia, Politicians from Tbilisi
Wicked Lips	Rap music, 2010s albums, 2019 in music
Planck epoch	Cosmology
No Safe Spaces	2019 movies, American documentary movies
Little Willie	Tanks
SI derived unit	Units of measurement
Brownell, Kansas	Cities in Ness County, Kansas
Kechi, Kansas	Cities in Sedgwick County, Kansas
Kismet, Kansas	Cities in Kansas, Seward County, Kansas
Kanorado, Kansas	Cities in Kansas
Kirwin, Kansas	Cities in Phillips County, Kansas, 1869 establishments in Kansas
Kincaid, Kansas	Cities in Anderson County, Kansas, 1885 establishments in Kansas
Kensington, Kansas	Cities in Smith County, Kansas, 1887 establishments in Kansas
Kiowa, Kansas	Cities in Barber County, Kansas, 1872 establishments in Kansas
Sun City, Kansas	Cities in Barber County, Kansas, 1872 establishments in Kansas
Caldwell, Kansas	Cities in Sumner County, Kansas, 1871 establishments in Kansas
Cherokee, Kansas	Cities in Crawford County, Kansas, 1870 establishments in Kansas
Jackie Moore (singer)	American soul singers, American R&B singers, Singers from Jacksonville, Florida, 1946 births, 2019 deaths
Herb Dickenson	1931 births, 2019 deaths, Canadian ice hockey left wingers, Ice hockey people from Ontario, New York Rangers players
Purita Campos	1937 births, 2019 deaths, Spanish writers, Cartoonists, Illustrators, People from Barcelona
Fred Cox	1938 births, 2019 deaths, Deaths from kidney disease, Sportspeople from Pennsylvania, American football placekickers, American inventors, Minnesota Vikings players
John Martin (American racing driver)	1939 births, 2019 deaths, American racecar drivers, Sportspeople from California, People from Long Beach, California
Michael Bloomberg 2020 presidential campaign	2020 United States presidential campaigns, Michael Bloomberg
Poison ivy	Anacardiaceae
Wataru Misaka	1923 births, 2019 deaths, New York Yankees players, People from Ogden, Utah, Sportspeople from Salt Lake City, Utah
Yaşar Büyükanıt	1940 births, 2019 deaths, Deaths from heart failure, Deaths from respiratory failure, Turkish politicians, Turkish military people, People from Istanbul
Harley D. Nygren	1924 births, 2019 deaths, American photographers, American military personnel of World War II, People from Seattle, Washington
Bengt-Erik Grahn	1941 births, 2019 deaths, Swedish Olympians, Skiers
Golden algae	Algae
Arcadia, Kansas	1862 establishments in Kansas, Cities in Crawford County, Kansas
Burden, Kansas	Cities in Cowley County, Kansas
Palmer, Kansas	Cities in Washington County, Kansas, 1878 establishments in Kansas
Colony, Kansas	Cities in Anderson County, Kansas, 1872 establishments in Kansas
Villars-sous-Yens	Municipalities of Vaud
Cambridge, Kansas	Cities in Cowley County, Kansas
Cherryvale, Kansas	Cities in Montgomery County, Kansas, 1871 establishments in Kansas
Buchillon	Municipalities of Vaud
Linn, Kansas	Cities in Washington County, Kansas, 1877 establishments in Kansas
Warner, Oklahoma	Towns in Oklahoma
Haddam, Kansas	1869 establishments in Kansas, Cities in Washington County, Kansas
Haddam, Connecticut	Towns in Connecticut
Edna, Kansas	Cities in Labette County, Kansas
Geezer Butler	1949 births, Living people, English Roman Catholics
Bima	Cities in Indonesia, West Nusa Tenggara
Yishun MRT station	Mass Rapid Transit (Singapore) stations, 1988 establishments
Toa Payoh MRT station	1987 establishments in Singapore, Mass Rapid Transit (Singapore) stations
Buru Quartet	Indonesia, Novels
Formoso, Kansas	Cities in Jewell County, Kansas
Esbon, Kansas	Cities in Jewell County, Kansas
Dresden, Kansas	1888 establishments in Kansas, Cities in Kansas
Summit, Oklahoma	Cities in Oklahoma
Cuba, Missouri	Cities in Missouri
This Earth of Mankind	Novels, Censorship, Indonesia
Widnau	Municipalities of St. Gallen
Madagascar Kartz	Video games, Madagascar (franchise)
Superior, Nebraska	Cities in Nebraska
Li Yugang	Living people, 1978 births, Chinese singers, Chinese stage actors
Arthur Marks	1927 births, 2019 deaths, American television writers, American television producers, American television directors, Movie directors from Los Angeles, California, Movie producers from Los Angeles, California, Screenwriters from Los Angeles, California
Anton Mavretič	1934 births, 2019 deaths, Engineers, Slovenian people
Gahan Wilson	1930 births, 2019 deaths, American cartoonists, American illustrators, Writers from Illinois, People from Evanston, Illinois, Deaths from dementia, Disease-related deaths in Arizona
Daniel Leclercq	1949 births, 2019 deaths, Deaths from pulmonary embolism, French footballers, French football managers
Vilters-Wangs	Municipalities of St. Gallen
Sevelen	Municipalities of St. Gallen
Kaare R. Norum	1932 births, 2019 deaths, People from Oslo, Norwegian educators
Oberuzwil	Municipalities of St. Gallen
Marbach, St. Gallen	Municipalities of St. Gallen
Henry Sobel	1944 births, 2019 deaths, Deaths from lung cancer, Cancer deaths in Florida, Naturalized citizens of the United States, People from Miami, Florida, People from Lisbon, American rabbis, Brazilian people
Bowen Stassforth	1926 births, 2019 deaths, American swimmers, American Olympic silver medalists, Sportspeople from Los Angeles, California
Rancho Palos Verdes, California	Cities in California, Settlements in Los Angeles County, California
Jessica Hecht	1965 births, Living people, American movie actors, American television actors, American stage actors, American voice actors, People from Bloomfield, Connecticut, Actors from Connecticut, Singers from Connecticut, Actors from New Jersey, People from Princeton, New Jersey, Singers from New Jersey, Actors from New York City, Singers from New York City
Ayyappan	Hindu gods and goddesses
Deo Surya Mandir	Hindu temples
Desmond Howard	1970 births, Living people, American football wide receivers, Detroit Lions players, Green Bay Packers players, Heisman Trophy winners, Jacksonville Jaguars players, Oakland Raiders players, Washington Redskins players
Borders of the United States	Geography of the United States
Canada–United States border	Geography of Canada, Geography of the United States
Gem, Kansas	Cities in Thomas County, Kansas
Copeland, Kansas	Cities in Gray County, Kansas
Montezuma, Kansas	1879 establishments in Kansas, Cities in Gray County, Kansas
Berolle	Municipalities of Vaud
Bougy-Villars	Municipalities of Vaud
Stuart, Oklahoma	Towns in Oklahoma
Soper, Oklahoma	Towns in Oklahoma
Denges	Municipalities of Vaud
Clarmont	Municipalities of Vaud
Bière	Municipalities of Vaud
Mandiraja Market	Retail markets, Java
Full Blast (1999 movie)	1999 movies, Canadian movies
Zero-sum game	Game theory
Asunción Balaguer	1925 births, 2019 deaths, Deaths from stroke, Deaths from multiple organ failure, Spanish movie actors, Spanish television actors, Actors from Madrid
2019–20 Colombian protests	2010s in South America, 2010s riots, 2020s in South America, 2020s riots, Crime in South America, December 2019 events, February 2020 events, History of Colombia, January 2020 events, November 2019 events, Protests in the 2020s
Stephen Cleobury	1948 births, 2019 deaths, Cancer deaths in England, English organists, Conductors, Writers from Kent
Teck Ghee MRT station	Mass Rapid Transit (Singapore) stations
Ensign, Kansas	Cities in Gray County, Kansas
Frank Gaffney	1953 births, Living people, American columnists, American critics, American conservatives, American political writers, Politicians from Philadelphia, Pennsylvania, Writers from Philadelphia, Pennsylvania, Politicians from Washington, D.C., Writers from Washington, D.C., US Republican Party politicians
Cedar, Kansas	Cities in Smith County, Kansas
Gaylord, Kansas	Cities in Smith County, Kansas, 1870 establishments in Kansas
Vufflens-le-Château	Municipalities of Vaud
Mauraz	Municipalities of Vaud
Chavannes-le-Veyron	Municipalities of Vaud
Chevilly, Switzerland	Municipalities of Vaud
Chigny, Switzerland	Municipalities of Vaud
Hong Kong Polytechnic University	1937 establishments, Colleges and universities, Education in Hong Kong
Lully, Vaud	Municipalities of Vaud
Bussy-Chardonney	Municipalities of Vaud
Flooding of the Nile	Geography
Oscar Tintel	1982 births
Astraea	Greek gods and goddesses
André Marinho	1978 births
Matheus Rocha	1981 births
Eugène Camara	1942 births, 2019 deaths, Prime Ministers of Guinea
Chris McNally	1988 births, Living people, Canadian television actors, Canadian movie actors, Actors from Vancouver
Francesc Gambús	1974 births, 2019 deaths, Former MEPs, Politicians from Barcelona
Gordon Sondland	1957 births, Ambassadors of the United States, Living people, Businesspeople from Washington, Politicians from Washington, US Republican Party politicians
Eros, Louisiana	Towns in Louisiana
Chatham, Louisiana	Towns in Louisiana
East Hodge, Louisiana	Villages in Louisiana
Hodge, Louisiana	Villages in Louisiana
North Hodge, Louisiana	Villages in Louisiana
Quitman, Louisiana	Villages in Louisiana
Internet Protocol TV	Broadcasting, Internet protocols, Television technology
Theodor Stolojan	1943 births, Living people, Former MEPs, Prime Ministers of Romania
Ludovic Orban	1963 births, Living people, Prime Ministers of Romania, Current national leaders
Teodor Meleșcanu	1941 births, Living people, Presidents of the Senate of Romania, Romanian politicians
President of the Senate of Romania	Presidents of the Senate of Romania
President of the Chamber of Deputies of Romania	Presidents of the Chamber of Deputies (Romania)
Mónica Fernández Balboa	1951 births, Living people, Mexican architects, Presidents of the Senate of the Republic (Mexico)
President of the Senate (Mexico)	Presidents of the Senate of the Republic (Mexico)
Senate of the Republic (Mexico)	Government of Mexico
Congress of the Union	Government of Mexico
Laura Rojas Hernández	1975 births, Living people, Politicians from Mexico City, Presidents of the Chamber of Deputies (Mexico)
President of the Chamber of Deputies (Mexico)	Presidents of the Chamber of Deputies (Mexico)
Chamber of Deputies (Mexico)	Government of Mexico
Monticello, Minnesota	Cities in Minnesota
Jaime de Armiñán	1927 births, Living people, Spanish movie directors, Spanish screenwriters, Writers from Madrid
Viki Gabor	2007 births, Living people, People from Kraków
Superhero (Viki Gabor)	2019 songs, Junior Eurovision Song Contest
Charles D. Baker	1928 births, Living people, Businesspeople from Massachusetts, Politicians from Massachusetts, US Republican Party politicians
Berta Riaza	1927 births, Living people, Spanish movie actors, Spanish television actors, Spanish stage actors, Spanish voice actors, Actors from Madrid
Baguio	Cities in the Philippines
Deaths in 2020	2020 deaths, Index lists
Deaths in December 2019	2019 deaths, December 2019 events
Heo Young-ji	1994 births, Living people, South Korean movie actors, South Korean television actors, South Korean singers, K-pop singers
Shrewsbury, Massachusetts	Towns in Massachusetts
Worcester County, Massachusetts	Massachusetts counties, 18th-century establishments in Massachusetts, 1730s establishments in the Thirteen Colonies, 1731 establishments
Artemas Ward	1727 births, 1800 deaths, United States representatives from Massachusetts, American generals
Pete Sessions	1955 births, Living people, United States representatives from Texas, People from Waco, Texas, US Republican Party politicians
Carolyn Maloney	1946 births, Living people, United States representatives from New York, Politicians from North Carolina, People from Greensboro, North Carolina, US Democratic Party politicians
Lisa Blunt Rochester	1962 births, Living people, African American politicians, United States representatives from Delaware, Politicians from Philadelphia, Pennsylvania, US Democratic Party politicians
Karyn Polito	1966 births, Living people, American lawyers, Lieutenant Governors of Massachusetts, Businesspeople from Massachusetts, US Republican Party politicians
Donald Dwight	1931 births, Living people, Businesspeople from Massachusetts, Lieutenant Governors of Massachusetts, US Republican Party politicians, People from Holyoke, Massachusetts
Francis Bellotti	1923 births, Living people, American lawyers, Lieutenant Governors of Massachusetts, Politicians from Boston, Massachusetts, US Democratic Party politicians
Edward J. King	1925 births, 2006 deaths, Governors of Massachusetts, Accidental deaths from falls in the United States, Deaths from surgical complications, US Democratic Party politicians, Sportspeople from Massachusetts, American lawyers, Indianapolis Colts players, American football offensive guards, US Republican Party politicians
Burlington, Massachusetts	Towns in Massachusetts
Middlesex County, Massachusetts	Massachusetts counties, 1640s establishments in Massachusetts, 1643 establishments
Margaret Qualley	1994 births, Living people, American movie actors, American television actors, American voice actors, American dancers, American models, Actors from Montana, Actors from North Carolina, People from Missoula, Montana, People from Asheville, North Carolina, People from Kalispell, Montana
Julia Jones	1981 births, Living people, Actors from Boston, Massachusetts, American movie actors, American television actors, American voice actors, American stage actors
Monrovia, Indiana	Towns in Indiana
Ocean Eyes (song)	2016 songs, Billie Eilish songs
Passu Sar	Mountains of Pakistan, Gilgit-Baltistan, Karakoram
Frank Caeti	1973 births, Living people, American stand-up comedians, American actors, American comedians, American movie actors, American television actors
Frank Biondi	1945 births, 2019 deaths, Deaths from bladder cancer, Cancer deaths in Los Angeles, Businesspeople from New Jersey, Businesspeople from New York City, People from Livingston, New Jersey, Princeton University alumni
Václav Pavkovič	1936 births, 2019 deaths, Czech sportspeople, Olympic bronze medalists
Ray Kappe	1927 births, 2019 deaths, Deaths from respiratory failure, Deaths from pneumonia, Disease-related deaths in Los Angeles, American architects, American educators, Businesspeople from Minneapolis, Minnesota, Businesspeople from Los Angeles, California
Alfred E. Smith IV	1951 births, 2019 deaths, Deaths from myocardial infarction, American philanthropists, Businesspeople from New York City
Colin Mawby	1936 births, 2019 deaths, Conductors, English organists, English composers
Jimmy Schulz	1968 births, 2019 deaths, Politicians from Baden-Württemberg, German businesspeople, Deaths from pancreatic cancer, Cancer deaths in Germany
Yeshi Dhonden	1927 births, 2019 deaths, Deaths from respiratory failure, Tibetan people, Indian scientists, Physicians, Humanitarians
Prince Antoine of Bourbon-Two Sicilies	1929 births, 2019 deaths, French royalty, Princes and princesses
Duchess Elisabeth of Württemberg (b. 1933)	1933 births, Living people, French royalty, Princes and princesses, People from Stuttgart
John Simon (critic)	1925 births, 2019 deaths, Deaths from stroke, Cardiovascular disease deaths in New York, American critics, American essayists, Serbian people, Naturalized citizens of the United States, Writers from New York City, American bloggers
Valhalla, New York	Hamlets in New York, Census-designated places in New York (state)
Ruth Wilson	1982 births, Living people, Golden Globe Award winning actors, English movie actors, English television actors, English stage actors, English voice actors, Actors from Surrey
Ashford, Surrey	Towns in Surrey
2019 Dresden heist	2019 crimes in Europe, 2010s crimes in Germany, Burglary, Dresden, November 2019 events
The Batman (movie)	2022 movies, Upcoming movies, Batman movies, American mystery movies, Warner Bros. movies, Movies directed by Matt Reeves, Movies shot in Chicago, Illinois, Reboot movies, American superhero movies, 2020s superhero movies
Tenet (movie)	2020 movies, 2020s thriller movies, American action thriller movies, Movies directed by Christopher Nolan, Warner Bros. movies
John David Washington	1984 births, American football running backs, Living people, Sportspeople from Los Angeles, California, St. Louis Rams players, Actors from Los Angeles, California, American movie actors, American television actors, American voice actors
BlacKkKlansman	2018 movies, American crime movies
Deontay Wilder	1985 births, Living people, African-American boxers, American Olympic bronze medalists, Medalists at the 2008 Summer Olympics, People from Tuscaloosa, Alabama, Sportspeople from Alabama
Nobuaki Kobayashi	Japanese sportspeople, Cue sports players, 1942 births, 2019 deaths
Rockville Centre, New York	Villages in New York
Yehoshua Porath	1938 births, 2019 deaths, Hebrew University of Jerusalem faculty, Israeli academics, Israeli historians, Israeli scientists, Jewish academics, Jewish scientists
Laure Killing	1959 births, 2019 deaths, Cancer deaths in France, French comedians, French movie actors, French television actors, French stage actors, French voice actors
Good Night, Little Ones!	1964 television series debuts
Carmen Sandiego	1985 in the United States
Saint Vincent College	Colleges and universities in Pennsylvania
Douglas Robert Nowicki	1945 births, Living people, American Roman Catholics, American educators, People from Latrobe, Pennsylvania
Everson, Pennsylvania	Boroughs in Pennsylvania
Uniontown, Pennsylvania	Cities in Pennsylvania, County seats in Pennsylvania
Fayette County, Pennsylvania	1780s establishments in Pennsylvania, 1783 establishments, Pennsylvania counties
Terry Gross	1951 births, Living people, American radio personalities, Writers from New York City, Writers from Philadelphia, Pennsylvania, Writers from Pittsburgh, Pennsylvania
Fresh Air	1975 establishments in the United States
Mount Othrys	Mountains of Greece, Greek mythology
Eyre Coote (East India Company officer)	1726 births, 1783 deaths, British Army generals, British politicians
Richard Neutra	1892 births, 1970 deaths, American architects, Naturalized citizens of the United States, People from Vienna, People from Los Angeles, California
Dion Neutra	1926 births, 2019 deaths, American architects, American activists, Businesspeople from Los Angeles, California
James L. Holloway III	1922 births, 2019 deaths, American aviators, American political writers, American military personnel of World War II, American military personnel of the Vietnam War, American military personnel of the Korean War, American historians, Writers from South Carolina, Writers from Virginia, People from Charleston, South Carolina, People from Alexandria, Virginia
Keystone, South Dakota	Towns in South Dakota
Malubiting	Mountains of Pakistan, Gilgit-Baltistan, Karakoram
Sia Kangri	Mountains of Pakistan, Gilgit-Baltistan, Mountains of China, Tibet, Karakoram
Ute Berling	1957 births, Living people, German singers, People from Heidelberg
General Pinto	Buenos Aires Province
Eklutna Lake	Lakes of the United States, Alaska
Zoboomafoo	PBS Kids shows, Children's television series, 1999 television series debuts, 1990s American television series, 2000s American television series, 2001 American television series endings, 1999 establishments in the United States, Emmy Award winning programs, Peabody Award winners, English-language television programs
Muiris Mac Conghail	1941 births, 2019 deaths, Irish writers
Secularization	Sociology, Secularism
Sushil Kumar (admiral)	1940 births, 2019 deaths
Laoag	Cities in the Philippines
Stenorhynchus seticornis	Crabs
Montipora	Cnidarians
Disco clam	Bivalves
Noel MacNeal	1961 births, Living people, American writers, American actors
Barbara Hillary (adventurer)	1931 births, 2019 deaths, Deaths from lung cancer, Deaths from breast cancer, Cancer deaths in New York City, American explorers, People from New York City
Howard Cruse	1944 births, 2019 deaths, Deaths from lymphoma, Cancer deaths in Massachusetts, American comics artists, American cartoonists, Gay men, LGBT artists, People from Birmingham, Alabama
Héctor García-Molina	1954 births, 2019 deaths, Naturalized citizens of the United States, American computer scientists, Mexican scientists
Bruno Nicolè	1940 births, 2019 deaths, Italian footballers
Gary Rhodes	1960 births, 2019 deaths, Deaths from subdural hematoma, English television personalities, British chefs, Businesspeople from London
Stefan Danailov	1942 births, 2019 deaths, Deaths from lymphoma, Movie actors, Bulgarian politicians, People from Sofia
Godfrey Gao	1984 births, 2019 deaths, Deaths from myocardial infarction, Taiwanese actors, Canadian movie actors, Canadian television actors, Canadian voice actors, Canadian models, Actors from Vancouver
Bala Singh	1952 births, 2019 deaths, Deaths from cardiac arrest, Deaths from food poisoning, Indian actors
Sam Watson (activist)	1952 births, 2019 deaths, Australian novelists, Australian activists, Australian educators, Writers from Queensland, Politicians from Brisbane
2019 Albania earthquake	2019 disasters, 2019 in Europe, 2010s disasters in Europe, Earthquakes in Europe, Earthquakes in the 2010s, History of Albania, November 2019 events
Daniel Martínez (politician)	1957 births, Living people, Uruguayan politicians, Mayors, Engineers, Democratic socialists, People from Montevideo
Luis Alberto Lacalle Pou	1973 births, Living people, Presidents of Uruguay, Current national leaders, Uruguayan lawyers, People from Montevideo
Hildur Guðnadóttir	Golden Globe Award winning composers, 1982 births, Living people, Composers, Cellists, People from Reykjavík
Michael Giacchino	1967 births, Living people, BAFTA Award winners, Academy Award winning composers, Grammy Award winners, Emmy Award winners, Writers from New Jersey
Riverside Township, New Jersey	Townships in New Jersey
Mount Holly, New Jersey	County seats in New Jersey, Townships in New Jersey
Evesham Township, New Jersey	Townships in New Jersey
Washington Township, Burlington County, New Jersey	Townships in New Jersey
2019–20 Perth Glory FC season	Football clubs
Marlton, New Jersey	Unincorporated communities in New Jersey, Census-designated places in New Jersey
Brad Bird	1957 births, Living people, American animators, American movie actors, American voice actors, American video game actors, Actors from Montana, Writers from Montana, Actors from Oregon, Writers from Oregon, Actors from Los Angeles, California, Pixar, Screenwriters from Los Angeles, California, Movie directors from Los Angeles, California, Movie producers from Los Angeles, California, People from Kalispell, Montana
Auburn, Washington	Cities in Washington (U.S. state)
Pierce County, Washington	19th-century establishments in Washington (state), 1852 establishments in the United States
Benton County, Oregon	Oregon counties
Hadesarchaea	Archaeans, Microbiology, Prokaryotes
Let L-610	Czechoslovakia, Military aircraft
The Irishman	Movies directed by Martin Scorsese, 2019 movies, Netflix movies, Movies based on books, American crime movies, Movies set in the 1940s, Movies set in the 1950s, Movies set in the 1960s, Movies set in the 1970s, Movies set in the 1980s, Movies set in New York City, Movies set in Philadelphia, Pennsylvania, Movies set in Chicago, Illinois, Movies set in Detroit, Michigan
Frank Sheeran	1920 births, 2003 deaths, Cancer deaths in Pennsylvania, American criminals, American murderers, People from Philadelphia, Pennsylvania
Darby, Pennsylvania	Boroughs in Pennsylvania
Jim Simons	1938 births, Living people, American billionaires, American company founders, American mathematicians, American philanthropists, Businesspeople from Massachusetts, Harvard University faculty, Jewish American academics, Jewish American scientists, Jewish billionaires, Jewish businesspeople, Jewish philanthropists, Massachusetts Institute of Technology alumni, People from Newton, Massachusetts, Scientists from Massachusetts
Fort Atkinson, Wisconsin	Cities in Wisconsin
Jefferson County, Wisconsin	Wisconsin counties
Jefferson, Wisconsin	Cities in Wisconsin, County seats in Wisconsin
Watertown, Wisconsin	Cities in Wisconsin, Dodge County, Wisconsin
Beaver Dam, Wisconsin	Cities in Wisconsin, Dodge County, Wisconsin
Pordenone	Cities in Friuli Venezia-Giulia, Capital cities in Italy
Henry County, Kentucky	Kentucky counties, 1798 establishments in Kentucky
Clay Evans (pastor)	1925 births, 2019 deaths, American civil rights activists, American gospel singers, Singer-songwriters from Chicago, Singers from Tennessee, Writers from Tennessee
Brownsville, Tennessee	Cities in Tennessee, County seats in Tennessee
Haywood County, Tennessee	Tennessee counties
Walla Walla County, Washington	19th-century establishments in Washington (state), 1854 establishments in the United States
University of Zagreb	1660s establishments in Europe, 1669 establishments, Colleges and universities in Europe, Zagreb
2019 Southeast Asian Games	Sport in Asia
Taleh	Settlements in Somalia
USP	Nationalist organizations in Africa, 1989 establishments
Subdural hematoma	Brain
Jeanne Gang	1964 births, Living people, Architects from Chicago
Louis Kahn	1901 births, 1974 deaths, Naturalized citizens of the United States, Estonian people, American architects, American educators, American critics, Writers from Philadelphia, Pennsylvania, Cardiovascular disease deaths in New York City, Deaths from myocardial infarction
North Hero, Vermont	Towns in Vermont, County seats in Vermont
The Sutherland Brothers	Duos, Scottish rock bands, Folk music groups, 1968 establishments, 1979 disestablishments
K12	Mountains of Pakistan, Gilgit-Baltistan, Mountains of India, Jammu and Kashmir, Karakoram
IG Field	Sports buildings, Sport in Manitoba
Lennart Andersson (athlete)	1914 births, 1997 deaths, Swedish sportspeople, Triple jumpers, People from Gothenburg
Un Certain Matin	1991 movies, French-language movies, Burkinabé movies, Movies set in Africa
Harry Potter and the Prisoner of Azkaban (movie)	2004 movies, 2000s fantasy movies, Harry Potter movies, Movies based on books, Movies directed by Alfonso Cuarón
Knut Agnred	Swedish actors, Swedish comedians, 1956 births, Living people, Swedish singers
Dieter Birr	Rock musicians, East German people, German people, Living people, 1944 births
Odonatoptera	Odonata
Del Boy	English television actors, English voice actors
Skil Brum	Mountains of Pakistan, Gilgit-Baltistan, Karakoram
Eddie Duran	1925 births, 2019 deaths, American jazz musicians, American guitarists, Musicians from San Francisco
Uljana Semjonova	1952 births, Living people, Soviet Olympic gold medalists, Latvian people, Basketball players
Quitman County, Mississippi	1870s establishments in Mississippi, 1877 establishments in the United States, Mississippi counties
Romanel-sur-Morges	Municipalities of Vaud
Longford, Kansas	Cities in Kansas
La Chaux (Cossonay)	Municipalities of Vaud
Ferreyres	Municipalities of Vaud
Seadrift, Texas	Cities in Texas
Jonah Goldberg	1969 births, American conservatives, American political commentators, Podcasters, Living people
NBCUniversal	NBCUniversal
Ginger beer	Fermented drinks, Soft drinks
Buru	Islands of Indonesia, Prisons
Scott Island	Islands
Lucas, Kansas	Cities in Russell County, Kansas
Dorrance, Kansas	Cities in Russell County, Kansas
2019 London Bridge stabbing	2019 crimes in Europe, 2010s crimes in London, 2010s murders in the United Kingdom, Mass stabbings in Europe, Murder in London, November 2019 events, Terrorist incidents in London, Terrorist incidents in the United Kingdom in the 2010s
Joan Staley	1940 births, 2019 deaths, Deaths from heart failure, Cardiovascular disease deaths in California, American models, American movie actors, American television actors, American stage actors, American voice actors, Actors from Minneapolis, Minnesota
Cyrus Chothia	1942 births, 2019 deaths, English chemists, English biologists
Maarit Feldt-Ranta	1968 births, 2019 deaths, Deaths from stomach cancer, Finnish politicians
Agnes Baker Pilgrim	American environmentalists, Humanitarians, People from Grants Pass, Oregon, 1924 births, 2019 deaths
Marion McClinton	1954 births, 2019 deaths, Deaths from renal failure, American playwrights, American theatre directors, American stage actors, Actors from Saint Paul, Minnesota, Writers from Saint Paul, Minnesota
Jaegwon Kim	1934 births, 2019 deaths, South Korean writers, American philosophers, Naturalized citizens of the United States, American writers
Data Gunj Buksh Town	Towns in Lahore
Huron, Kansas	1880s establishments in Kansas, 1882 establishments in the United States, Cities in Atchison County, Kansas
Lussy-sur-Morges	Municipalities of Vaud
Cottens, Vaud	Municipalities of Vaud
Cuarnens	Municipalities of Vaud
Dizy, Switzerland	Municipalities of Vaud
Pampigny	Municipalities of Vaud
Echandens	Municipalities of Vaud
L'Isle, Switzerland	Municipalities of Vaud
Willowbrook, Kansas	Cities in Reno County, Kansas
Simpson, Kansas	Cities in Cloud County, Kansas, Cities in Mitchell County, Kansas
Hunter, Kansas	Cities in Mitchell County, Kansas
Tipton St John	Villages in Devon
Montgomery County, Mississippi	1870s establishments in Mississippi, 1871 establishments in the United States, Mississippi counties
Sharkey County, Mississippi	1870s establishments in Mississippi, 1876 establishments in the United States, Mississippi counties
Fort Sumner, New Mexico	Villages in New Mexico, County seats in New Mexico
Anthony Martial	Manchester United F.C. players, 1995 births, Living people, French footballers
Fractionating column	Laboratory techniques, Laboratory equipment, Chemistry
Bismuth(III) nitrate	Bismuth compounds, Nitrogen compounds
Fairview, Kansas	Cities in Brown County, Kansas, 1872 establishments in Kansas
Wayne County, Mississippi	1800s establishments in Mississippi Territory, 1809 establishments in the United States, Mississippi counties
Panola County, Mississippi	1836 establishments in Mississippi, Mississippi counties
Pearl River County, Mississippi	19th-century establishments in Mississippi, 1890 establishments in the United States, Mississippi counties
Pike County, Mississippi	1810s establishments in Mississippi Territory, 1815 establishments, Mississippi counties
Morrill, Kansas	Cities in Brown County, Kansas
Saint-Livres	Municipalities of Vaud
Champmartin	Former municipalities of Vaud, Villages in Vaud
La Rogivue	Former municipalities of Vaud, Villages in Vaud
Lavigny, Vaud	Municipalities of Vaud
Malapalud	Former municipalities of Vaud
Mosnang	Municipalities of St. Gallen
Oberhelfenschwil	Municipalities of St. Gallen
Montherod	Municipalities of Vaud
Guam kingfisher	Coraciiformes, Birds of Oceania
Haramosh Peak	Mountains of Pakistan, Gilgit-Baltistan, Karakoram
Uranyl nitrate	Oxygen compounds, Nitrogen compounds
Acetone peroxide	Organic compounds, Oxygen compounds
Metric ton	Units of mass
Electric match	Electricity, Fire, Pyrotechnics
Boyolali Regency	Indonesia
Henri Biancheri	1932 births, 2019 deaths, Sportspeople from Marseille, French footballers
Shelley Morrison	1936 births, 2019 deaths, Deaths from heart failure, Cardiovascular disease deaths in Los Angeles, American movie actors, American television actors, American stage actors, Actors from New York City
Cedars-Sinai Medical Center	Hospitals in the United States
Paul Sirba	1960 births, 2019 deaths, Deaths from myocardial infarction, Bishops, American Roman Catholics, People from Saint Paul, Minnesota
Pat Sullivan (American football)	1950 births, 2019 deaths, Deaths from throat cancer, American football quarterbacks, American football coaches, Atlanta Falcons players, Washington Redskins players, Sportspeople from Birmingham, Alabama
Brian Tierney (medievalist)	1922 births, 2019 deaths, English historians, Writers from Lincolnshire
North Lincolnshire	Settlements in Lincolnshire
Milagrosa Tan	1950s births, 2019 deaths, Filipino politicians, Deaths from cardiac arrest
Harold Rahm	1919 births, 2019 deaths, American centenarians, American Roman Catholics, Humanitarians, Brazilian people
Petr Málek	1961 births, 2019 deaths, Olympic silver medalists, Czech sportspeople
Mariss Jansons	1943 births, 2019 deaths, Cardiovascular disease deaths in Russia, Russian conductors, Latvian people
Michael Howard (historian)	1922 births, 2019 deaths, British historians, Writers from Dorset
Irving Burgie	1924 births, 2019 deaths, Deaths from heart failure, Cardiovascular disease deaths in New York City, American songwriters, Writers from New York City
Martin Dempsey	1952 births, Living people, American generals, American educators, People from Jersey City, New Jersey
Ken Kavanagh	1923 births, 2019 deaths, Sportspeople from Melbourne
Commissioner of Food and Drugs	United States Department of Health and Human Services
Frank E. Young (physician)	1931 births, 2019 deaths, Deaths from lymphoma, American physicians, Commissioners of the Food and Drug Administration, Scientists from New York
Mineola, New York	Villages in New York, County seats in New York
Wayne Shorter	1933 births, Living people, American saxophonists, American jazz musicians, American composers, Musicians from Newark, New Jersey, Writers from Newark, New Jersey
Thelma Schoonmaker	Academy Award winners, BAFTA Award winners, 1940 births, Living people, American editors, Naturalized citizens of the United States, People from Algiers
Ronnie Hawkins	1935 births, Living people, American singer-songwriters, American rock singers, Canadian singer-songwriters, Canadian rock singers, Writers from Arkansas, Singers from Arkansas, Writers from Toronto, Singers from Toronto
Public health observatory	Medical and health organizations in the United Kingdom, Observatories, Organisations based in England
Sophie Wilmès	1975 births, Living people, Belgian Jews, Flemish politicians, Government ministers of Belgium, Jewish women politicians, Mouvement réformateur (Belgium) politicians, People from Brussels-Capital Region, Prime Ministers of Belgium, Women politicians
Sentinel (sculpture)	2000 establishments in England, History of England, Transport in England, Buildings and structures in England, Sculptures, Culture, Birmingham
Patrick Pinney	1952 births, Living people, Actors from Los Angeles, California, American voice actors, American video game actors
Fitzhugh Mullan	1942 births, 2019 deaths, Deaths from lung cancer, American physicians, American activists, American educators, Writers from New York City, Writers from Washington, D.C.
Lil Bub	2011 births, 2019 deaths, Individual cats
Kelly Loeffler	1970 births, Living people, United States senators from Georgia, Politicians from Chicago, Businesspeople from Chicago, Businesspeople from Georgia (U.S. state), US Republican Party politicians, DePaul University alumni, People from Bloomington, Illinois
Aktobe	Cities in Kazakhstan
Ivan Drago	Fictional characters introduced in 1985, Fictional murderers, Movie characters
North Sulawesi	North Sulawesi, Provinces of Indonesia
Thiệu Trị	1807 births, 1847 deaths
Typhoon Kammuri (2019)	Tropical cyclones in Asia, 2019 in Asia, 2010s in weather
Võ Thị Viên	Vietnamese people
Robert K. Massie	Pulitzer Prize winners, 1929 births, 2019 deaths, Deaths from Alzheimer's disease, Disease-related deaths in New York, American historians, Writers from Kentucky
Fumihito, Prince Akishino	1965 births, Living people, Crown Princes and Princesses of Japan, People from Tokyo
Dieter Hertrampf	1944 births, German rock musicians, Rock singers, Rock guitarists, East German people, Musicians from Berlin, Living people
Hans Gruber	Fictional European people, Fictional criminals
Goar Vartanian	1926 births, 2019 deaths, Armenian people, Spies
John, Paul, George, Ringo ... and Bert	Plays by Willy Russell
Lyudmila Verbitskaya	1936 births, 2019 deaths, Russian educators, Linguists, People from Saint Petersburg
Jorge Vergara	1955 births, 2019 deaths, Mexican businesspeople, Mexican movie producers, Deaths from myocardial infarction, Cardiovascular disease deaths in New York City
Sisterhood (2008 movie)	British movies, English-language movies, 2008 movies
Jubaland	Somalia
Instruction cycle	Computer science
Feel Good Film Festival	Movie festivals, 2008 establishments in California
Urdish	Languages of Pakistan
Today	Days
Nigel Planer	1953 births, Living people, People from Westminster, People educated at Westminster School, London, British movie actors, British stage actors, British television actors, British voice actors, British writers, British singers
Virtue, Liberty and Independence	Pennsylvania, State mottos of the United States
Walton County, Georgia	1818 establishments in Georgia (U.S. state), Georgia (U.S. state) counties
Ambazonia	Ambazonia
Samuel Ikome Sako	Ambazonia, Presidents (government), 1956 births, African politicians
Flag of Ambazonia	National flags, Ambazonia
Soar (platform)	Cartography, Satellites
Ballon d'Or	Association football, Awards, FIFA, Ballon D'Or
Jimmy Nail	1954 births, Living people, British musicians, British actors, English autobiographers, English singer-songwriters, English television producers, English television writers, British composers, English singers, English writers
The Iron Giant	1999 science fiction movies, 1990s action movies, 1999 animated movies, American science fiction movies, American action movies, American animated movies, Movies directed by Brad Bird, Movies set in the 1950s, Warner Bros. movies, Movies about giants
E. E. Evans-Pritchard	1902 births, 1973 deaths, Alumni of the London School of Economics, Alumni of the University of Oxford, British anthropologists, British military personnel of World War II, British people of World War II, British sociologists, English Roman Catholics, Fellows of the Royal Society, Knights Bachelor, People from East Sussex
Awdalland	Dependent territories, States of Somalia
Maakhir	Dependent territories, States of Somalia
George Atkinson III	1992 births, 2019 deaths, American football running backs, Cleveland Browns players, Kansas City Chiefs players, New York Jets players, Sportspeople from Oakland, California
D. C. Fontana	1939 births, 2019 deaths, Cancer deaths in California, American editors, American television writers, Screenwriters from Los Angeles, California
Sussex, New Jersey	Boroughs in New Jersey
Sussex County, New Jersey	New Jersey counties, 18th-century establishments in New Jersey, 1750s establishments in the Thirteen Colonies, 1753 establishments
Newton, New Jersey	Towns in New Jersey, County seats in New Jersey
Bertil Fiskesjö	1928 births, 2019 deaths, Swedish politicians
Vera Clemente	1941 births, 2019 deaths, Puerto Rican people, American philanthropists
John Henry Waddell	1921 births, 2019 deaths, American sculptors, American educators, American painters, Writers from Des Moines, Iowa, Writers from Arizona
Andrew Clements	1949 births, 2019 deaths, American children's writers, American novelists, People from Bangor, Maine, Writers from Maine, Writers from New Jersey, People from Camden, New Jersey, Writers from Springfield, Illinois
Baldwin, Maine	Towns in Maine
Rawshan Ara Bachchu	1932 births, 2019 deaths, Activists, Linguists, Bangladeshi people
Ján Eugen Kočiš	1926 births, 2019 deaths, Czech people, Slovakian people, Bishops
Luigi Farace	1934 births, 2018 deaths, Italian politicians, Italian businesspeople, People from Bari
Keyboard Cat	Cats, American Internet celebrities
Jamie Vardy	1987 births, 2018 FIFA World Cup players, English footballers, Living people, Premier League players, UEFA Euro 2016 players, Sportspeople from Sheffield
Aviatyrannis	Tyrannosaurids, Jurassic dinosaurs, Dinosaurs of Europe
Dorothy Rabinowitz	Living people, American  journalists, American critics, Pulitzer Prize winners, American conservatives, New York University alumni, Writers from New York City
Warsangeli sultanate	States and territories disestablished in the 20th century
25 Churchill Place	Skyscrapers in the United Kingdom, Buildings and structures in London
Colíder	Municipalities in Brazil, Mato Grosso
Jimmy Cavallo	1927 births, 2019 deaths, Deaths from heart failure, Cardiovascular disease deaths in Florida, American saxophonists, American rock musicians, American R&B musicians, American movie actors, Musicians from New York, Actors from New York, People from Syracuse, New York
Apollo Theater	Buildings and structures in Manhattan, New York City Designated Landmarks
Rosa Morena	1941 births, 2019 deaths, Spanish singers, Pop singers, Spanish movie actors, Spanish models, Dancers, Deaths from breast cancer
Bob Willis	1949 births, 2019 deaths, English cricketers, Sportspeople from Tyne and Wear
AutoHotkey	Microsoft Windows software, Programming languages
Samoa Observer	Samoa, Newspapers, Writing, English-language newspapers published in Asia
Fetoscopy	Medical procedures
Quwwat-ul-Islam mosque	Buildings and structures in India, Mamluk dynasty (Delhi), Monuments and memorials, Mughal architecture, World Heritage Sites in India
Non-volatile memory	Computer memory
Amir Farhand	Living people
Minh Mạng	1791 births, 1841 deaths, Vietnamese people
Ngô Thị Chính	1792 births, 1843 deaths, Vietnamese people
Larinus planus	Polyphaga
Ant-Man	Marvel Comics superheroes
Albany adder	Vipers, South Africa
Needle felting	Fibers
Flemish Giant Rabbit	Domesticated animals, Lagomorphs
Nuvvuagittuq Greenstone Belt	Geography of Quebec, Hadean
Thai street food	Thai food
Reedley, California	Settlements in Fresno County, California, Cities in California
African Party for the Independence of Guinea and Cape Verde	Political parties in Africa, Guinea-Bissau
National Front (UK)	Political parties in the United Kingdom
Deerfield, Kansas	Cities in Kansas, Kearny County, Kansas, 1885 establishments in Kansas
Echichens	Municipalities of Vaud
Préverenges	Municipalities of Vaud
Lütisburg	Municipalities of St. Gallen
Kaumodaki	Hindu mythology
The Angriest Dog in the World	American comic strips, Fictional dogs
Quarten	Municipalities of St. Gallen
Scottsville, Kansas	Cities in Mitchell County, Kansas
Haribo	1920s establishments in Germany, 1920 establishments in Europe, Companies of Germany, Food companies of Europe, Candy, Bonn, Rhineland-Palatinate
Eclépens	Municipalities of Vaud
Reverolle	Municipalities of Vaud
Saint-Saphorin-sur-Morges	2011 disestablishments in Switzerland, Former municipalities of Vaud
Gams, Switzerland	Municipalities of St. Gallen
2019 Hyderabad gang rape	2019 crimes, 2019 murders in Asia, 2010s in India, November 2019 events, Crime in India, Murder in India, Rape, Hyderabad, India
PartiallyClips	Webcomics, 2002 establishments, 2015 disestablishments
Uxbridge and South Ruislip (UK Parliament constituency)	Constituencies in the United Kingdom
Count Binface	British comedians, British politicians
Alibi (TV channel)	British television channels
Goodnight Sweetheart	1990s British sitcoms, 2010s British sitcoms, BBC television sitcoms, English-language television programs
Leonard Goldberg	1934 births, 2019 deaths, Accidental deaths from falls in the United States, American television producers, Movie producers from New York City
Thomas Elsaesser	1943 births, 2019 deaths, Deaths from cardiac arrest, German historians, Movie critics, Writers from Berlin
Marvin Goodfriend	1950 births, 2019 deaths, American economists, Writers from New York City
Robert Walker (actor)	Golden Globe Award winning actors, 1940 births, 2019 deaths, American movie actors, American television actors, American stage actors, American voice actors, Actors from New York City
D. E. Shaw & Co.	1988 establishments, Companies based in New York City
Janusz Dzięcioł	1953 births, 2019 deaths, Road accident deaths, Polish politicians, Television personalities
Christopher Ettridge	1948 births, Living people, English television actors
Isleworth	Areas of London, London Borough of Hounslow
Kimmi Lewis	1957 births, 2019 deaths, Deaths from breast cancer, State legislators of the United States, Politicians from Colorado, US Republican Party politicians
Tessa Peake-Jones	1957 births, English television actors, English movie actors, People from Hammersmith, Actors from London, Living people
Dandeli	Towns in Karnataka
Eunice (biblical figure)	Pauline epistles, New Testament people
Henry Lejeune	English painters
Peckham	Areas of London, London Borough of Southwark
FrogPhone	Frogs, Mobile phones released in 2019, Audio technology, Habitats
Carlton, Kansas	Cities in Dickinson County, Kansas
Manchester, Kansas	Cities in Dickinson County, Kansas
Banda Aceh	Indonesia
Clyde, Kansas	Cities in Cloud County, Kansas
Wheaton, Kansas	Cities in Pottawatomie County, Kansas
Féchy	Municipalities of Vaud
Sanger, California	Cities in California, Settlements in Fresno County, California
Rock Island, Oklahoma	Towns in Oklahoma
University of Canberra	1960s establishments in Australia, 1967 establishments in Oceania, Colleges and universities in Australia, Canberra
Selma, California	1880s establishments in California, 1880 establishments in the United States, Cities in California, Settlements in Fresno County, California
Mahidi	East Timor, Nationalist organizations in Asia, 1998 establishments in Asia
Ajanta Caves	India
Călărași County	Counties of Romania
Ellora Caves	India
Wadi Bih	Valleys, Geography of the United Arab Emirates, Geography of Oman
Alimpești	Communes in Gorj County
Grancy	Municipalities of Vaud
Moiry, Switzerland	Municipalities of Vaud
Mollens, Vaud	Municipalities of Vaud
Mont-la-Ville	Municipalities of Vaud
Montricher, Switzerland	Municipalities of Vaud
Ecublens, Vaud	Municipalities of Vaud, Cities in Switzerland
Chavannes-près-Renens	Municipalities of Vaud
Pizy	2011 disestablishments in Switzerland, Former municipalities of Vaud
83 (number)	Integers, Prime numbers
84 (number)	Integers
85 (number)	Integers
91 (number)	Integers
86 (number)	Integers
Emir Uyar	Living people, 1983 births, Turkish businesspeople
René Metge	1941 births, French sportspeople, 24 Hours of Le Mans drivers, People from Ile-de-France, Living people
Bayzo	Living people, 1947 births, 2018 deaths
Orny, Switzerland	Municipalities of Vaud
La Sarraz	Municipalities of Vaud, Cities in Switzerland
Saint-Oyens	Municipalities of Vaud
Senarclens	Municipalities of Vaud
Middle Low German	West Germanic languages
Sévery	Municipalities of Vaud
Pompaples	Municipalities of Vaud
Monnaz	2011 disestablishments in Switzerland, Former municipalities of Vaud
Saint-Sulpice, Vaud	Municipalities of Vaud
Saint-Prex	Municipalities of Vaud, Cities in Switzerland
Vullierens	Municipalities of Vaud
Juice Wrld	1998 births, 2019 deaths, Deaths from seizure, Drug-related accidental deaths in the United States, Disease-related deaths in Chicago, Illinois, African American musicians, American rap musicians from Illinois, Singers from Chicago
Bütschwil-Ganterschwil	Municipalities of St. Gallen, 2013 establishments in Switzerland
Ebnat-Kappel	Municipalities of St. Gallen
87 (number)	Integers
Woodstock, Connecticut	Towns in Connecticut
Dystonia	Neurology
Diophantine approximation	Number theory
David Yang (violist)	1967 births, Living people, Musicians from New York City
Sanna Marin	1985 births, Living people, Prime Ministers of Finland, Current national leaders
Antti Rinne	1962 births, Living people, Prime Ministers of Finland
Inge Lehmann	1888 births, 1993 deaths
Rosetta Code	Wikis
Munchkin cat	Cat breeds
101955 Bennu	Asteroids
Kenneth Allen Taylor	1954 births, 2019 deaths, Deaths from myocardial infarction, American philosophers, American radio personalities, Writers from Ohio
Sandusky, Ohio	Cities in Ohio, County seats in Ohio
John Perry (philosopher)	1943 births, Living people, American philosophers, American radio personalities, People from Lincoln, Nebraska, Writers from Nebraska
George J. Laurer	1925 births, 2019 deaths, American inventors, Engineers from New York, Scientists from New York City
Wendell, North Carolina	Towns in North Carolina, Wake County, North Carolina
Piet Huyg	1951 births, 2019 deaths, Deaths from Alzheimer's disease, Dutch footballers, Sportspeople from North Holland
Irena Laskowska	1925 births, 2019 deaths, Polish movie actors, People from Kraków
Hirokazu Kanazawa	1931 births, 2019 deaths, Japanese educators
Zvonimir Vujin	1943 births, 2019 deaths, Serbian sportspeople, Boxers, Olympic bronze medalists
Ice Bucket Challenge	2014, Internet culture
Reinhard Bonnke	1940 births, 2019 deaths, Deaths from surgical complications, German writers, Naturalized citizens of the United States, American autobiographers, Writers from Florida, People from Orlando, Florida
Bump Elliott	1925 births, 2019 deaths, American football running backs, American football coaches, American military personnel of World War II, Sportspeople from Detroit, Michigan, Sportspeople from Illinois, Sportspeople from Iowa, People from Iowa City, Iowa, People from Bloomington, Illinois
Giuseppe Frigo	1935 births, 2019 deaths, Italian politicians, Italian judges, People from Brescia
Herbert Joos	1940 births, 2019 deaths, Deaths from surgical complications, German musicians, Jazz musicians, Trumpeters
Ali Mufuruki	1958 births, 2019 deaths, Tanzanian people, African writers, African businesspeople
Zaza Urushadze	1965 births, 2019 deaths, Deaths from myocardial infarction, Movie directors from Georgia (country), Movie producers from Georgia (country), Screenwriters from Georgia (country), People from Tbilisi
Paweł Pawlikowski	Academy Award winning directors, 1957 births, Living people, Polish movie directors, Polish movie producers, Polish screenwriters, Writers from Warsaw
Ron Saunders	1932 births, 2019 deaths, English footballers, English football managers, Sportspeople from Cheshire
St. Joseph County, Indiana	Indiana counties, 1830 establishments in Indiana
2019 Whakaari / White Island eruption	2019 disasters, 2010s in New Zealand, December 2019 events
Holbrook, Arizona	Cities in Arizona, County seats in Arizona
Holding Out for a Hero	1984 songs, Bonnie Tyler songs, Shrek music
Total Eclipse of the Heart	1983 songs, Bonnie Tyler songs
UKF	British record labels, Electronic music, YouTube
It's a Heartache	1978 songs, Bonnie Tyler songs
Jim Steinman	1947 births, 2021 deaths, American composers, American singer-songwriters, American playwrights, American pop singers, American rock singers, American pop musicians, American rock musicians, American pianists, Record producers, Singers from New York City, Musicians from New York City, Writers from New York City, Businesspeople from New York City
Gavriil Kharitonovich Popov	1936 births, Living people, Economists, Mayors of Moscow, Writers from Moscow
Mayor of Moscow	Mayors of Moscow
Vladimir Resin	1936 births, Living people, Mayors of Moscow
Sergey Sobyanin	1958 births, Living people, Mayors of Moscow, Russian lawyers
William Joseph McDonough	1934 births, 2018 deaths, Deaths from heart failure, American economists, Businesspeople from Chicago, Businesspeople from New York City
Federal Reserve Bank of Chicago	Banks of the United States, Buildings and structures in Chicago, Illinois
Charles L. Evans	1958 births, Living people, American economists, Businesspeople from Chicago
Michael H. Moskow	1938 births, Living people, American economists, Businesspeople from New Jersey, Businesspeople from Chicago
Marie Fredriksson	1958 births, 2019 deaths, Deaths from brain cancer, Swedish singers, Swedish musicians, Swedish painters, Swedish writers, Songwriters, European pianists, Rock singers, Pop singers, Rock musicians, Pop musicians
Kit Kat	Candy, Nestlé
Per Gessle	1959 births, Living people, Swedish singers, Swedish musicians, Swedish writers, Songwriters, Guitarists, Rock singers, Pop singers, Rock musicians, Pop musicians
Techmoan	1971 births, Living people
Dan Tillberg	1953 births, Living people
Barrie Keeffe	1945 births, 2019 deaths, Disease-related deaths in London, English playwrights, Screenwriters from London
Brandi Chastain	1968 births, Living people, People from California, Sportswomen, Shiroki FC Serena players
Laura Arrillaga-Andreessen	Living people, People from California, Year of birth missing (living people)
Tara Vanderveer	1953 births, Living people, People from California, Sportswomen
Alice Waters	1944 births, Living people, People from California, American chefs
Dominique Crenn	1965 births, Living people, People from California, Chefs
Maha Elgenaidi	Living people, People from California, Year of birth missing (living people), Activists
Julia Morgan	1872 births, 1957 deaths, American architects, People from California
Mary C. Daly	Living people, People from California, American economists, Year of birth missing (living people)
Elaine Forbes	Living people, People from California, Year of birth missing (living people)
Jennifer Doudna	1964 births, Living people, American biochemists, American Nobel Prize winners, Female scientists, Harvard University alumni, Scientists from California, Scientists from Washington, D.C., University of California, Berkeley faculty, Wolf Prize winners, Yale University faculty
Tiffany Shlain	1970 births, Living people, People from California, American filmmakers, Writers from California
Ruth Asawa	1926 births, 2013 deaths, People from California, American sculptors
Alicia Garza	1981 births, Living people, People from California, American civil rights activists, Black Lives Matter
Ruth Brinker	1922 births, 2011 deaths, Activists, People from California
Sylvia McLaughlin	1916 births, 2016 deaths, People from California, Activists, Environmentalists
Ginetta Sagan	1925 births, 2000 deaths, People from California, Activists
Mary Tape	1857 births, 1934 deaths, People from California, Activists
Mother Wright	1921 births, 2009 deaths, People from California, Activists
Yoshie Akiba	Living people, People from California
Edythe Boone	1938 births, Living people, People from California, American artists
Luisa Buada	1968 births, Living people, People from California, Activists
Sharon Chatman	1974 births, Living people, People from California, Sportswomen, Women lawyers, Women judges
Sofia Mendoza	1934 births, 2015 deaths, People from California, Activists
K. Megan McArthur	1971 births, Living people, People from Honolulu, Scientists from Hawaii, Scientists from California, American astronauts
Economy of the United States	Economy of the United States
Shadnagar	Towns in India, Telangana
Sukhinder Singh Cassidy	1970 births, Living people, Businesspeople from California
Brenda Villa	1980 births, Living people, American Olympic bronze medalists, American Olympic gold medalists, American Olympic silver medalists, American water polo players, Sportspeople from Los Angeles County, California, Sportswomen, Water polo coaches
Anna Wang	Living people, People from California, Activists
Chengdu J-20	China, Military aircraft
Aimee Allison	1969 births, Living people, People from California, Activists
Kimberly Bryant	Living people, People from California, Year of birth missing (living people)
Bhupathy's purple frog	Frogs, India, Animals of Asia
Catahoula Leopard Dog	Dog breeds
Steven Crowder	1987 births, Living people, American comedians, American Christians, American voice actors, Canadian comedians, Fox News people
James Holzhauer	1980s births, Living people, People from Las Vegas, Nevada
Jeopardy! Battle of the Decades	Jeopardy!
John R. Broxson	1932 births, 2019 deaths, State legislators of the United States, Politicians from Florida, US Democratic Party politicians
Holley, Florida	Unincorporated communities in Florida, Census-designated places in Florida
Imre Varga	1923 births, 2019 deaths, Sculptors, Painters, People from Budapest
Philip McKeon	1964 births, 2019 deaths, Disease-related deaths in Texas, American movie actors, American television actors, American child actors, Actors from New York
Westbury, New York	Villages in New York
Polly Holliday	Golden Globe Award winning actors, Saturn Award winners, 1937 births, Living people, American movie actors, American television actors, American stage actors, Actors from Alabama, People from Jasper, Alabama
Alice (TV series)	Golden Globe Award winning programs, 1976 television series debuts, 1985 television series endings, 1980s American comedy television series, 1970s American comedy television series, CBS network shows, English-language television programs
Jim Smith (footballer, born 1940)	1940 births, 2019 deaths, Sportspeople from Sheffield, English footballers, English football managers
Public law	Types of law
Boston United F.C.	English football clubs
Bérénice Marlohe	1979 births, Living people, French movie actors, French television actors, French stage actors, French voice actors, Actors from Paris, Actresses who played Bond girls
Alison Cronin	1966 births, Naturalised citizens of the United Kingdom, Members of the Order of the British Empire, Living people
Zozibini Tunzi	Miss Universe winners, 1993 births, Living people, South African models, South African people
Percival Lowell	American astronomers, Businesspeople from Boston, Massachusetts, Scientists from Boston, Massachusetts
Jim Cronin (zookeeper)	1951 births, 2007 deaths, Naturalised citizens of the United Kingdom, American zoologists, Deaths from liver cancer, People from Yonkers, New York, Members of the Order of the British Empire, Cancer deaths in New York, Scientists from New York
Eretmophorus kleinenbergi	Teleosts
Rose Cousins	1977 births, Living people, Award winners, Canadian singer-songwriters, People from Prince Edward Island
Danielius Dolskis	1891 births, 1931 deaths, Lithuanian Jews, Pop singers
International Mountain Day	Holidays, Mountains
Jay Bruce	1987 births, Cincinnati Reds players, Cleveland Indians players, Living people, National League All-Stars, New York Mets players, People from Beaumont, Texas, Philadelphia Phillies players, Seattle Mariners players
Daisuke Matsuzaka	1980 births, Boston Red Sox players, Japanese Olympic bronze medalists, Living people, Medalists at the 2004 Summer Olympics, New York Mets players, Sportspeople from Tokyo
The Caine Mutiny	1951 books, 20th century American novels
National Center for Biotechnology Information	1998 establishments in the United States, Research organizations in the United States, United States Department of Health and Human Services, United States government agencies
Ultar Sar	Mountains of Pakistan, Gilgit-Baltistan, Karakoram
Floor leader	Politics
David Bellamy	1933 births, 2019 deaths, Environmentalists, Botanists, English television presenters, English television actors, Writers from London, Scientists from London, Actors from London
Veijo Puhjo	1948 births, 2019 deaths, Finnish politicians
Sherman Howard (American football)	1924 births, 2019 deaths, Cleveland Browns players, American military personnel of World War II, Sportspeople from Chicago, Military people from Chicago, Sportspeople from New Orleans, Louisiana
Henry Ward Beecher	1813 births, 1887 deaths, American abolitionists, American activists, Christian ministers, Congregationalists
Urethral sphincters	Anatomy of the urinary system
Chipko Movement	Protests in the 20th century, Indian culture
Gollapudi Maruti Rao	1939 births, 2019 deaths, Disease-related deaths in India, Indian movie actors, Indian playwrights, Indian stage actors, Indian screenwriters
Momhil Sar	Mountains of Pakistan, Gilgit-Baltistan, Karakoram
Atlantic cod	Bony fish
Gowling WLG	Companies of the United Kingdom, Companies of Canada, Law
Mortal Engines Quartet	Predator Cities, Fantasy books, Series of books
Icicle	Meteorology, Snow, Water
Jeopardy! Teachers Tournament	Jeopardy!
The Corsair	1814, 1810s books
Don Juan (Byron)	1819, British poems, Epic poems
Pineville, Louisiana	Cities in Louisiana
Abstraction (art)	Art
Brian Muller	1942 births, 2019 deaths, New Zealand rugby union players, Sportspeople from North Island
Łęczna	Towns in Poland
Nosrat Karimi	1924 births, 2019 deaths, Iranian actors, Artists, Iranian movie directors, Iranian movie producers, Iranian screenwriters, People from Tehran
Richard Easton	Tony Award winning actors, Drama Desk Award winners, 1933 births, 2019 deaths, Deaths from congestive heart failure, Cardiovascular disease deaths in New York City, Canadian movie actors, Canadian television actors, Canadian voice actors, Canadian stage actors, Actors from Montreal
Charles Koffi Diby	1957 births, 2019 deaths, Deaths from anorexia, Ivorian people, African politicians
William Luce	1931 births, 2019 deaths, Deaths from Alzheimer's disease, Disease-related deaths in Arizona, American playwrights, American television writers, Writers from Portland, Oregon
Green Valley, Arizona	Census-designated places in Arizona
Ashland, Oregon	Cities in Oregon
Yang di-Pertuan Negara	Political office-holders in Singapore
2020 Labour Party leadership election (UK)	Leaders of the Labour Party (UK), Elections in the United Kingdom, 2020s in the United Kingdom, 2020 elections in Europe, February 2020 events, March 2020 events, April 2020 events
2016 Labour Party leadership election (UK)	Leaders of the Labour Party (UK), Elections in the United Kingdom, 2016 in the United Kingdom, 2016 elections, August 2016 events, September 2016 events, Jeremy Corbyn
Maxwell Lord	Wonder Woman, DC Comics characters
2019 Samoa measles outbreak	Samoa, Fiji, 2010s in Oceania, September 2019 events, October 2019 events, November 2019 events, December 2019 events
Open Mind Productions	1989 establishments in the United Kingdom
Giza Plateau	Plateaus
Hemberg	Municipalities of St. Gallen
Kirchberg, St. Gallen	Municipalities of St. Gallen
Sennwald	Municipalities of St. Gallen
Neckertal	2009 establishments in Switzerland, Municipalities of St. Gallen
St. Peterzell	Former municipalities of St. Gallen
Lichtensteig	Municipalities of St. Gallen, Cities in Switzerland
Wildhaus-Alt St. Johann	2010 establishments in Switzerland, Municipalities of St. Gallen
Stein, St. Gallen	Former municipalities of St. Gallen
Bütschwil	Former municipalities of St. Gallen, Villages in St. Gallen
Brunnadern	Former municipalities of St. Gallen, Villages in St. Gallen
Ottawa County, Michigan	1837 establishments in Michigan, Michigan counties
FrogWatch	Frogs, Scientific organizations, Citizen science organizations
Conway Springs, Kansas	1880s establishments in Kansas, 1884 establishments in the United States, Cities in Sumner County, Kansas
Ganterschwil	Former municipalities of St. Gallen, Villages in St. Gallen
Hackberry, Texas	Towns in Texas
Adam Jones	1985 births, African-American baseball players, Major League Baseball players, Seattle Mariners players, Baltimore Orioles players, Arizona Diamondbacks players, Sportspeople from San Diego, California, Living people
Justin Bour	1988 births, Living people, Los Angeles Angels of Anaheim players, Los Angeles Angels players, People from Washington, D.C., Philadelphia Phillies players
Jiří Jirmal	1925 births, 2019 deaths, Czech musicians, Composers, Guitarists, Jazz musicians, People from Prague
Peter Snell	1938 births, 2019 deaths, Cardiovascular disease deaths in Texas, New Zealand sportspeople, Olympic gold medalists
Ushiomaru Motoyasu	1978 births, 2019 deaths, Deaths from blood cancer, Japanese sumo wrestlers
PHASE 2	1955 births, 2019 deaths, Deaths from motor neurone disease, Disease-related deaths in New York City, Artists from New York City
Mouse Trouble	American animated movies
Happy Shopper	1996 establishments in England, Food companies of the United Kingdom
Anthony, Texas	Towns in Texas
Horizon City, Texas	Cities in Texas
Alvin, Texas	Cities in Texas
Clarksville City, Texas	Cities in Texas
Cisco, Texas	Cities in Texas
Vega, Texas	Cities in Texas, County seats in Texas
2038	2038, Years in the future
Wattwil	Municipalities of St. Gallen
Maggie and the Ferocious Beast	2000 American television series debuts, 2000s animated television series, 2002 American television series endings, Nickelodeon television series, English-language television programs
Nesslau	Municipalities of St. Gallen, 2013 establishments in Switzerland
Mogelsberg	Former municipalities of St. Gallen
Nesslau-Krummenau	2005 establishments in Switzerland, 2013 disestablishments in Switzerland, Former municipalities of St. Gallen
Victor, California	Census-designated places in California, Settlements in San Joaquin County, California
Victor, Colorado	Cities in Colorado
Victor, Indiana	Unincorporated communities in Indiana
Victor, Montana	Census-designated places in Montana
Victor, New York	Towns in New York
Victor, South Dakota	Unincorporated communities in the United States, Settlements in South Dakota
Victor, Utah	Ghost towns in the United States, Settlements in Utah
Xbox Series X and Series S	Xbox
Luray, Kansas	Cities in Russell County, Kansas
Mertens, Texas	Towns in Texas
Gaiserwald	Municipalities of St. Gallen
Six (musical)	2010s musicals, West End musicals, British culture
Bledlow-cum-Saunderton	Civil parishes in Buckinghamshire
Skittle Green	Hamlets in England, Settlements in Buckinghamshire
Bledlow Ridge	Villages in Buckinghamshire
Latvian Soviet Socialist Republic	1940s in the Soviet Union, 1950s in the Soviet Union, 1960s in Europe, 1970s in Europe, 1980s in the Soviet Union, 1990s in the Soviet Union, 20th century in Europe, 20th century establishments in Latvia, 1940 establishments in Europe, 1991 disestablishments in the Soviet Union, 1940s establishments in the Soviet Union, Republics of the Soviet Union, History of Latvia
James McCarthy	1944 births, 2019 deaths, American educators, American biologists, Environmentalists, Scientists from Oregon
Stig Sollander	1926 births, 2019 deaths, Swedish Olympians, Olympic bronze medalists
Richard G. Hatcher	1933 births, 2019 deaths, American mayors, American lawyers, Politicians from Indiana, Politicians from Chicago, People from Gary, Indiana, People from Michigan City, Indiana, US Democratic Party politicians
Bernard Lavalette	1926 births, 2019 deaths, French movie actors, French television actors, French stage actors, French voice actors, French comedians, French singers, Actors from Paris
Vladimir Tsyplakov	1969 births, 2019 deaths, Buffalo Sabres players, Los Angeles Kings players, Belarusian ice hockey players
Sweet Home, Oregon	Cities in Oregon
Linn County, Oregon	Oregon counties
James P. McCarthy	1935 births, Living people, American generals, American educators, American military personnel of the Korean War, American military personnel of the Vietnam War, Military people from Ohio
Kohei Matsumoto	1994 births, Living people, Japanese footballers
Andwil	Municipalities of St. Gallen
Häggenschwil	Municipalities of St. Gallen
Eggersriet	Municipalities of St. Gallen
Muolen	Municipalities of St. Gallen
Waldkirch, Switzerland	Municipalities of St. Gallen
Wittenbach	Municipalities of St. Gallen
Berg, St. Gallen	Municipalities of St. Gallen
Goldach, St. Gallen	Municipalities of St. Gallen
Mörschwil	Municipalities of St. Gallen
News Gothic	Fonts
Leiocarpaea	Brassicaceae
Shajapur district	Districts of Madhya Pradesh
Rorschacherberg	Municipalities of St. Gallen
Steinach, Switzerland	Municipalities of St. Gallen
Wartau	Municipalities of St. Gallen
Degersheim	Municipalities of St. Gallen
Background music	Music
Lancaster, Texas	Cities in Texas, Settlements in Dallas County, Texas
Mississippi County, Missouri	1845 establishments in Missouri, Missouri counties
Pemiscot County, Missouri	1851 establishments in Missouri, Missouri counties
Dunklin County, Missouri	1845 establishments in Missouri, Missouri counties
Butler County, Missouri	1849 establishments in Missouri, Missouri counties
Welsh National War Memorial	Military monuments and memorials
Mortal Engines	2001 books, Children's books, Fantasy books
Predator's Gold	2003 books, Children's books, Fantasy books
A Darkling Plain	2006 books, Children's books, Fantasy books
Philip Reeve	1966 births, Living people, English novelists
Infernal Devices (Reeve novel)	2005 books, Children's books, Fantasy books
List of Xeon microprocessors	Computer hardware
Ben Acton	1927 births, Australian ice hockey players, 2020 deaths
John Nicholas (ice hockey)	1930 births, 1966 deaths, Australian ice hockey players, Sportspeople from Melbourne
Hera Hilmar	1988 births, Living people, Icelandic movie actors, Television actors, Icelandic people
Die Caufner-Schwestern	German musical groups, Disco groups, East Germany
Fall Out Boy's Evening Out with Your Girlfriend	2003 albums, Fall Out Boy albums, Fall Out Boy
Grail (web browser)	Free software, Web browsers
Car design	Vehicles, Design
Ripley County, Missouri	1833 establishments in Missouri, Missouri counties
Ozark County, Missouri	1841 establishments in Missouri, Missouri counties
Gisella Donadoni	1968 births, Living people, People from Lombardy, Italian television presenters, Italian movie actors, Italian television actors
James F. Byrnes	1882 births, 1972 deaths, United States Supreme Court justices, Governors of South Carolina, United States senators from South Carolina, United States representatives from South Carolina, United States Secretaries of State, People from Charleston, South Carolina, US Democratic Party politicians
Obazoa	Eukaryotes
Holozoa	Eukaryotes
Jane on her Own	Children's books, Books by Ursula K. Le Guin
Wonderful Alexander and the Catwings	Children's books, Books by Ursula K. Le Guin
Catwings Return	Children's books, Books by Ursula K. Le Guin
Catwings	Children's books, Books by Ursula K. Le Guin
Lawrence Bittaker and Roy Norris	1940 births, 1948 births, 2019 deaths, 2020 deaths, Duos, American rapists, American serial killers, American people convicted of manslaughter, Criminals from California, People from Pittsburgh, Pennsylvania, People from Colorado
Yury Belyayev (footballer)	1934 births, 2019 deaths, Russian footballers, Russian football managers, Sportspeople from Moscow
Gastrointestinal bleeding	Medical emergencies
Puzzle globe	Puzzles, Three-dimensional shapes
Chuy Bravo	1956 births, 2019 deaths, Deaths from myocardial infarction, Deaths from gastrointestinal hemorrhage, People with dwarfism, American movie actors, American television actors, American television personalities, American pornographic actors, Mexican movie actors, Mexican television actors, Mexican comedians, Comedians from Los Angeles, California, Actors from Los Angeles, California, Naturalized citizens of the United States
Greeley, Colorado	Cities in Colorado, County seats in Colorado
Bill Simpson	1940 births, 2019 deaths, Deaths from stroke, American racecar drivers, American autobiographers, Sportspeople from Indianapolis, Indiana, Businesspeople from Indianapolis, Indiana, Writers from Indianapolis, Indiana
Joanna Barnes	1934 births, Living people, American columnists, American journalists, American movie actors, American television actors, American stage actors, American voice actors, Actors from Boston, Massachusetts, Writers from Boston, Massachusetts
Rebecca Long-Bailey	1979 births, Living people, UK MPs 2015–2017, UK MPs 2017–2019, UK MPs 2019–, English Roman Catholics, British lawyers, People from Greater Manchester, Labour MPs (UK)
2020 Israeli legislative election	2020 elections in Asia, December 2019 events, March 2020 events, Knesset
Blue and White (political alliance)	Political parties in Israel, Zionist parties, 2010s establishments in Israel
New Right (Israel)	Political parties in Israel, Zionist parties, 2010s establishments in Israel, 2018 establishments in Asia
Labor-Gesher	Former political parties in Israel
Jewish Home-National Union	Former political parties in Israel
Democratic Union (Israel)	Former political parties in Israel
Amir Peretz	1952 births, Living people, Government ministers of Israel, HaAvoda politicians, Israeli former political leaders, Israeli mayors, Israeli opposition leaders, Israeli trade unionists, Jewish Israeli politicians, Members of Knesset, Moroccan Jews, Naturalized citizens of Israel, Moroccan politicians
Nitzan Horowitz	1965 births, Living people, Gay Jews, Israeli journalists, Israeli LGBT people, Israeli political leaders, Jewish Israeli politicians, Jewish Israeli writers, LGBT journalists, LGBT politicians, Members of Knesset, Meretz politicians
Rafi Peretz	1956 births, Living people, Chief Military Rabbis of Israel, Government ministers of Israel, Israeli former political leaders, Jewish Israeli politicians, Members of Knesset, People from Jerusalem
Elaine Hendrix	1970 births, Living people, American movie actors, American television actors, American stage actors, American voice actors, American models, American movie producers, American activists, Actors from Tennessee, Singers from Tennessee
Brian Keith	1921 births, 1997 deaths, Suicides by firearm in the United States, People with cancer, American movie actors, American television actors, American stage actors, American voice actors, Actors from New Jersey, People from Bayonne, New Jersey
Pokki	Microsoft Windows software
The Darkness of the Morning	1975 books, Novels
Marcus Rashford	1997 births, 2018 FIFA World Cup players, Association football forwards, Black British sportspeople, English footballers, Living people, Manchester United F.C. players, Premier League players, Sportspeople from Manchester, UEFA Euro 2016 players
Floppotron	Musical instruments
Taree	Towns in New South Wales
MacOS Sierra	MacOS
Intellivision Amico	Video game consoles
Gena Turgel	Holocaust survivors, 1923 births, 2018 deaths, Polish writers, Polish educators, People from Kraków
Taki Theodoracopulos	1936 births, Living people, Journalists, Greek writers
Anthony Smith (producer)	1938 births, Living people, British educators, British writers, People from Oxford
Robert Winston	1940 births, Living people, English television presenters, English physicians, British educators, Politicians from London, Scientists from London, Writers from London
Peregrine Worsthorne	1923 births, 2020 deaths, English journalists, Writers from London
Paul Oestreicher	1931 births, Living people, German critics, German political activists
Lewis Wolpert	1929 births, 2021 deaths, Deaths from the COVID-19 pandemic in the United Kingdom, South African scientists, South African writers, British biologists, Scientists from London, Writers from London
2b2t	Minecraft
Fay Weldon	1931 births, Living people, English playwrights, English novelists, English essayists
Jim Haynes	1933 births, 2021 deaths, British sociologists, Writers from London
Jerome L. Singer	1924 births, 2019 deaths, American psychologists, Writers from New York City, Scientists from New York City
Tantric yoga	Yoga, Religion
Jerome Kagan	1929 births, 2021 deaths, American psychologists, Scientists from Newark, New Jersey, Harvard University faculty
Mikey Madison	1999 births, Living people, American movie actors, American television actors, American child actors, Actors from Los Angeles, California
Hallo aus Berlin	British television series
Singleton, New South Wales	Towns in New South Wales
Glide (API)	Computer graphics, Software

