Hubbard County, Minnesota	Minnesota counties
Füllinsdorf	Municipalities of Basel-Landschaft
Giebenach	Municipalities of Basel-Landschaft
Hersberg	Municipalities of Basel-Landschaft
Seltisberg	Municipalities of Basel-Landschaft
Lupsingen	Municipalities of Basel-Landschaft
Ziefen	Municipalities of Basel-Landschaft
Ramlinsburg	Municipalities of Basel-Landschaft
Ravenden Springs, Arkansas	Towns in Arkansas
Reyno, Arkansas	Cities in Arkansas
Sunbury, Pennsylvania	Cities in Pennsylvania, County seats in Pennsylvania
Spengler Cup	Ice hockey competitions, Sport in Switzerland, Graubünden
Therwil	Municipalities of Basel-Landschaft
Arlesheim	Municipalities of Basel-Landschaft
Isanti County, Minnesota	Minnesota counties
André Holland	People from Bessemer, Alabama, African American actors, American television actors, American stage actors, American movie actors, Actors from Alabama, 1979 births, Living people
Coat of arms of Liechtenstein	National coats of arms, Liechtenstein
David Weatherall	1933 births, 2018 deaths, British physicians, British educators
2018 Strasbourg shooting	2018 crimes in Europe, 2018 mass shootings, 2010s crimes in France, 2010s mass shootings in Europe, 2010s murders in Europe, December 2018 events, Islamic terrorist incidents in Europe, Islamic terrorist incidents in the 2010s, Mass murder in 2018, Mass murder in Europe, Murders by firearm in France, Strasbourg, Terrorist incidents in 2018, Terrorist incidents in Europe in the 2010s, Terrorist incidents in France
William Blum	1933 births, 2018 deaths, Deaths from renal failure, Disease-related deaths in Virginia, American journalists, American political activists, American political writers, American critics, American historians, Writers from New York City, Writers from Washington, D.C.
C. N. Balakrishnan	1934 births, 2018 deaths, Deaths from renal failure, Deaths from heart failure, Indian politicians
Classic Shell	Computer programming, Microsoft Windows software
Alice Childress	American stage actors, American novelists, Writers from South Carolina, Actors from South Carolina, 1916 births, 1994 deaths, People from Charleston, South Carolina
Jim Florentine	1964 births, Living people, American stand-up comedians, Puppeteers, American voice actors, American movie actors, American television actors, Actors from Brooklyn, American Internet celebrities
Bob Giggie	1933 births, 2018 deaths, Atlanta Braves players, Kansas City Athletics, Sportspeople from Boston, Massachusetts
Braintree, Massachusetts	Cities in Massachusetts
Chiang Pin-kung	1932 births, 2018 deaths, Deaths from multiple organ failure, Taiwanese politicians
Robert Spaemann	1927 births, 2018 deaths, German philosophers, German Roman Catholics, Writers from Berlin
Xavier Tilliette	1921 births, 2018 deaths, Deaths from pneumonia, Disease-related deaths in Paris, French historians, French philosophers, French educators, French theologians, Writers from Paris
Bobotie	Meat dishes
Dhulbahante garaadship	Monarchy
Thutmose III	Pharaohs
Liming Family	Organizations based in Asia, China
Lee Chih-Kai	1996 births, Living people, Gymnasts, Taiwanese people, Asian sportspeople
Bagnères-de-Luchon	Communes in Haute-Garonne, Spa towns in France
Itasca County, Minnesota	Minnesota counties
Jackson County, Minnesota	Minnesota counties
Grand Rapids, Minnesota	Cities in Minnesota, County seats in Minnesota
Kanabec County, Minnesota	Minnesota counties
Kandiyohi County, Minnesota	Minnesota counties
Kittson County, Minnesota	Minnesota counties
Rock County, Minnesota	Minnesota counties
Lac qui Parle County, Minnesota	Minnesota counties
Lake County, Minnesota	Minnesota counties
Koochiching County, Minnesota	Minnesota counties
Lake of the Woods County, Minnesota	Minnesota counties
Lincoln County, Minnesota	Minnesota counties
Lyon County, Minnesota	Minnesota counties
Mahnomen County, Minnesota	Minnesota counties
Kazuo Sakamaki	1918 births, 1999 deaths, People from Tokushima Prefecture, Japanese military people, Military personnel of World War II
Marshall County, Minnesota	Minnesota counties
BLS AG	2000s establishments in Switzerland, 2006 establishments in Europe, Transport companies of Switzerland, Train operating companies
Oberwil, Basel-Landschaft	Municipalities of Basel-Landschaft, Cities in Switzerland
More4	British television channels, 2005 establishments in the United Kingdom
Sky Replay	British television channels, British Sky Broadcasting
Blaine Higgs	1954 births, Living people, Premiers of New Brunswick
Hiwi Tauroa	1927 births, 2018 deaths, New Zealand rugby union players, New Zealand educators, New Zealand politicians
Mary Lou McDonald	1969 births, Living people, Former MEPs, Sinn Féin politicians
Iraj Danaeifard	1951 births, 2018 deaths, Deaths from myocardial infarction, Iranian footballers, People from Tehran
Ferenc Kósa	1937 births, 2018 deaths, Hungarian movie directors, Hungarian screenwriters
Creepypasta	Internet, Horror
Jean-Robert de Cavel	1961 births, Living people, Naturalized citizens of the United States, American chefs, French chefs, American philanthropists, People with cancer, Businesspeople from Cincinnati, Ohio
Leiomyosarcoma	Cancer
Sedalia, Missouri	Cities in Missouri, County seats in Missouri
Mark Udall	1950 births, Living people, United States senators from New Mexico, United States representatives from New Mexico, Politicians from Arizona, People from Tucson, Arizona, US Democratic Party politicians
Newar people	Newar, Ethnic groups in Asia
Gong	Percussion instruments
Kathmandu Valley	Geography of Nepal, Valleys, Newar
Yigal Bashan	1950 births, 2018 deaths, Israeli singers, Israeli movie actors, Songwriters, People from Tel Aviv, Jewish Israeli actors, Jewish Israeli musicians
United States ten-dollar bill	Currency of the United States
The Ellen Show	2000s American sitcoms, 2001 American television series debuts, 2002 American television series endings, CBS network shows, Television series set in Los Angeles, California, English-language television programs
Gringo (ethnic slur)	Spanish language
Tony Smith	1967 births, Living people, Speakers of the Australian House of Representatives, Politicians from Melbourne
Ian Sinclair	1929 births, Living people, Speakers of the Australian House of Representatives, Politicians from Sydney
Bronwyn Bishop	1942 births, Living people, Speakers of the Australian House of Representatives, Political commentators, Politicians from Sydney
Billy Snedden	1926 births, 1987 deaths, Deaths from myocardial infarction, Leaders of the Opposition (Australia), Speakers of the Australian House of Representatives, Australian military people, Politicians from Western Australia
Gordon Scholes	1931 births, 2018 deaths, Speakers of the Australian House of Representatives, Politicians from Melbourne
Pentti Tiusanen	1949 births, 2018 deaths, Finnish politicians, Deaths from stomach cancer
James Lyons (admiral)	1927 births, 2018 deaths, Deaths from respiratory failure, American military personnel of World War II, American generals, American columnists, Writers from New Jersey
William Newsom	1934 births, 2018 deaths, American lawyers, American judges, Politicians from San Francisco, US Democratic Party politicians
Seán Garland	1934 births, 2018 deaths, Irish politicians, People from Dublin
Noah Klieger	1925 births, 2018 deaths, Cardiovascular disease deaths in Israel, Israeli journalists, Israeli Jews, Sports commentators, Holocaust survivors, People from Strasbourg
Nancy Wilson (jazz singer)	Grammy Award winners, 1937 births, 2018 deaths, Deaths from kidney cancer, Cancer deaths in California, American jazz singers, American blues singers, American R&B singers, American pop singers, American soul singers, American movie actors, American television actors, Actors from Ohio, Singers from Ohio
Pioneertown, California	Unincorporated communities in California, Settlements in San Bernardino County, California
Sheshan	Hills, Geography of China, Shanghai
Dutch Cross of Resistance	Military honors, 1946 establishments in the Netherlands
SAM Colombia Flight 501	Aviation disasters in the 1990s, History of Colombia, 1990s in South America, May events
Montsoreau	Cities in France, Communes in Maine-et-Loire
Star apple	Fruits, Sapotaceae
EgyptAir Flight 864	Bangkok, Aviation disasters in the 1970s, Aviation disasters in Asia, 1970s in Thailand, December events, 1976
Heron Tower	Buildings and structures in London, Skyscrapers in the United Kingdom
Château de Montsoreau	Museums in France, Palaces in France, Castles in France, Renaissance, 10th century establishments in Europe, Establishments in France, World Heritage Sites in France
Mesquite, Texas	1870s establishments in Texas, 1878 establishments in the United States, Cities in Texas, Settlements in Dallas County, Texas
McLeod County, Minnesota	Minnesota counties
Martin County, Minnesota	Minnesota counties
Meeker County, Minnesota	Minnesota counties
Mille Lacs County, Minnesota	Minnesota counties
Morrison County, Minnesota	Minnesota counties
Mower County, Minnesota	Minnesota counties
Grellingen	Municipalities of Basel-Landschaft
Birs	Rivers of Switzerland, Canton of Jura, Canton of Bern, Canton of Solothurn
Blauen, Basel-Landschaft	Municipalities of Basel-Landschaft
Burg im Leimental	Municipalities of Basel-Landschaft
Dittingen	Municipalities of Basel-Landschaft
Alpena, Arkansas	Towns in Arkansas
Murray County, Minnesota	Minnesota counties
Contractile vacuole	Organelles
Russell Vought	1976 births, Living people, Politicians from Illinois, US Republican Party politicians, Directors of the Office of Management and Budget
Ace Cannon	1934 births, 2018 deaths, Deaths from emphysema, American saxophonists, Musicians from Mississippi
Calhoun City, Mississippi	Towns in Mississippi
Wilhelm Genazino	1943 births, 2018 deaths, Deaths from lung cancer, Cancer deaths in Germany, German journalists, German novelists, Writers from Frankfurt
Matti Kassila	1924 births, 2018 deaths, Accidental deaths from falls, Finnish movie directors
Jean-Pierre Van Rossem	1945 births, 2018 deaths, 20th century philosophers, 21st century philosophers, Belgian economists, Belgian philosophers, Belgian politicians, Belgian writers, Criminals, Deaths from COPD, Flemish politicians
Sigi Schmid	1953 births, 2018 deaths, Deaths from heart failure, German football managers, Naturalized citizens of the United States, Sportspeople from Los Angeles, California, Sportspeople from Baden-Württemberg
Cape May, New Jersey	Cities in New Jersey
Olivier Blanchard	1948 births, Living people, French educators, French economists
Olmsted County, Minnesota	Minnesota counties
Britt Nicole discography	Discographies
Towyn	Settlements in Wales
Prudnik	Cities in Poland
Kędzierzyn-Koźle	Cities in Poland
Brzeg	Cities in Poland
Nysa	Cities in Poland
Opole Voivodeship	1999 establishments in Europe, Voivodeships of Poland
Nicollet County, Minnesota	Minnesota counties
Nobles County, Minnesota	Minnesota counties
Norman County, Minnesota	Minnesota counties
Ada, Minnesota	Cities in Minnesota, County seats in Minnesota
Bauxite, Arkansas	Towns in Arkansas
Otter Tail County, Minnesota	Minnesota counties
Pennington County, Minnesota	20th-century establishments in Minnesota, 1910 establishments in the United States, Minnesota counties
Pine County, Minnesota	Minnesota counties
Duggingen	Municipalities of Basel-Landschaft
Liesberg	Municipalities of Basel-Landschaft
Biel-Benken	Municipalities of Basel-Landschaft
Nenzlingen	Municipalities of Basel-Landschaft
Roggenburg, Basel-Landschaft	Municipalities of Basel-Landschaft
Röschenz	Municipalities of Basel-Landschaft
Wahlen	Municipalities of Basel-Landschaft
Zwingen	Municipalities of Basel-Landschaft
Allport, Arkansas	Towns in Arkansas
Denia	Towns in Spain, Municipalities in Valencia (autonomous community), Alicante Province
Steele County, Minnesota	Minnesota counties
Pipestone County, Minnesota	Minnesota counties
Stearns County, Minnesota	Minnesota counties
Polk County, Minnesota	Minnesota counties
WinCo Foods	Supermarkets of the United States, 1967 establishments in the United States, 1960s establishments in Idaho, Boise, Idaho
Pope County, Minnesota	Minnesota counties
Glenwood, Minnesota	Cities in Minnesota, County seats in Minnesota
Ramsey County, Minnesota	1849 establishments in Minnesota Territory, Minnesota counties
Red Lake County, Minnesota	Minnesota counties
Redwood County, Minnesota	Minnesota counties
Denmark, Iowa	Unincorporated communities in Iowa, Census-designated places in Iowa
Renville County, Minnesota	Minnesota counties
Dar	Ethnic groups in Pakistan, Ethnic groups in India, Pakistani tribes, Kashmir
Philippe Moureaux	1939 births, 2018 deaths, Cancer deaths in Belgium, Belgian academics, Belgian historians, Belgian mayors, Brussels-Capital Region politicians, Government ministers of Belgium, Parti socialiste (Belgium) politicians, People from Brussels-Capital Region, Walloon politicians
Walterboro, South Carolina	Cities in South Carolina, County seats in South Carolina
Islam in Georgia (country)	Islam by country, Georgia (country)
Robert Morris (merchant)	1734 births, 1806 deaths, Bankers, Episcopalians, Businesspeople from Philadelphia, Pennsylvania, Slavers, Colonial Americans, Politicians from Philadelphia, Pennsylvania, People from Liverpool, Signers of the United States Constitution, Signers of the U.S. Declaration of Independence, United States senators from Pennsylvania
Homestead Acts	1862 in the United States, American Civil War, American Old West, United States federal legislation, United States law, Western United States
Keetmanshoop	Cities in Africa, Geography of Namibia
Roseau County, Minnesota	Minnesota counties
Earliest known life forms	Biology, Earth sciences, Evolutionary biology, Molecular biology, Prokaryotes
Scott County, Minnesota	Minnesota counties
Sherburne County, Minnesota	Minnesota counties
Sibley County, Minnesota	Minnesota counties
Stevens County, Minnesota	Minnesota counties
Swift County, Minnesota	Minnesota counties
Todd County, Minnesota	Minnesota counties
Traverse County, Minnesota	Minnesota counties
Wabasha County, Minnesota	Minnesota counties
Wadena County, Minnesota	Minnesota counties
Ettingen	Municipalities of Basel-Landschaft
Everton, Arkansas	Towns in Arkansas
Mutation breeding	Botany
6ix9ine	1996 births, Living people
Eliot Engel	1947 births, Living people, United States representatives from New York, Politicians from New York City, US Democratic Party politicians
José E. Serrano	1943 births, Living people, People with Parkinson's disease, United States representatives from New York, Politicians from New York City, US Democratic Party politicians
T. K. Wetherell	1945 births, 2018 deaths, Deaths from prostate cancer, Cancer deaths in Florida, American educators, Politicians from Florida, US Democratic Party politicians, People from Daytona Beach, Florida
Joe Osborn	1937 births, 2018 deaths, Deaths from pancreatic cancer, American bass guitarists, Musicians from Louisiana
Greenwood, Louisiana	Towns in Caddo Parish, Louisiana
Ángela Ponce	1991 births, Living people, LGBT models, Spanish people, Transgender and transsexual people
Pia Wurtzbach	1989 births, Living people, Miss Universe winners, Filipino actors, German models, German movie actors, People from Stuttgart
Middle East Airlines Flight 438	Mass murder in Asia, Aviation disasters in the 1970s, 20th century in Lebanon, 20th century in Saudi Arabia, Aviation disasters in Asia, January events
Demi-Leigh Nel-Peters	1995 births, Living people, South African models, Miss Universe winners, South African people
Armi Kuusela	1934 births, Living people, Finnish people, Miss Universe winners
Christiane Martel	1932 births, Living people, French movie actors, French models, Miss Universe winners
Miguel Alemán Velasco	1932 births, Living people, Mexican politicians, Mexican businesspeople, Philanthropists, People from Veracruz
Carol Morris	1936 births, Living people, American models, American movie actors, Miss Universe winners, Actors from Omaha, Nebraska, Actors from Des Moines, Iowa
Miriam Stevenson	1933 births, Living people, Miss Universe winners, American models, American television presenters, People from South Carolina
Winnsboro, South Carolina	Towns in South Carolina, County seats in South Carolina
Janakinath Bose	1860 births, 1934 deaths, Indian activists, Indian lawyers
Aesch, Basel-Landschaft	Municipalities of Basel-Landschaft, Cities in Switzerland
Waseca County, Minnesota	Minnesota counties
Watonwan County, Minnesota	Minnesota counties
Sky Living	British television channels
Wilkin County, Minnesota	Minnesota counties
Winona County, Minnesota	Minnesota counties
Yellow Medicine County, Minnesota	Minnesota counties
Yotta-	SI units
Schönenbuch	Municipalities of Basel-Landschaft
Binningen, Switzerland	Municipalities of Basel-Landschaft, Cities in Switzerland
Bottmingen	Municipalities of Basel-Landschaft
Pfeffingen	Municipalities of Basel-Landschaft
Arlesheim (district)	Districts of Basel-Landschaft
Laufen (district)	Districts of Basel-Landschaft
Liestal (district)	Districts of Basel-Landschaft
Sissach (district)	Districts of Basel-Landschaft
Waldenburg (district)	Districts of Basel-Landschaft
Basnet	Surnames, Nepali culture
Chinook Jargon	Languages
Selsey	Towns in West Sussex
Churchill County, Nevada	Nevada counties
Douglas County, Nevada	Nevada counties
Elko County, Nevada	Nevada counties
Esmeralda County, Nevada	Nevada counties
Eureka County, Nevada	Nevada counties
Eureka, Nevada	Census-designated places in Nevada, Unincorporated communities in Nevada, County seats in Nevada
Humboldt County, Nevada	Nevada counties, 1856 establishments in the United States, 19th-century establishments in Nevada
Lander County, Nevada	Nevada counties
Casa, Arkansas	Towns in Arkansas
Adona, Arkansas	Cities in Arkansas
Perry, Arkansas	Towns in Arkansas
Stollen	Cakes, Sweet breads, German food, Christmas
Bangladesh national football team	National football teams, Sport in Bangladesh
Theory of forms	Philosophy
Lincoln County, Nevada	Nevada counties
Nissan 240SX	Nissan automobiles, Sports cars, 1980s automobiles, 1990s automobiles
Rob Sprackling	Living people, English screenwriters
Lu Jintang	1910 births, 1986 deaths, Chinese politicians
Captain (ice hockey)	Ice hockey
Curb Your Enthusiasm	2000 television series debuts, 2000s American sitcoms, 2010s American sitcoms, 2020s American sitcoms, English-language television programs, Television series about marriage, Television series set in Los Angeles, California
Harry W. Shlaudeman	1926 births, 2018 deaths, Ambassadors of the United States, Stanford University alumni, Presidential Medal of Freedom recipients, Politicians from Los Angeles, California, American military personnel of World War II
Edmond Simeoni	1934 births, 2018 deaths, Deaths from heart failure, French politicians
Milunka Lazarević	1932 births, 2018 deaths, Serbian people, Chess players, Journalists
Elmira Minita Gordon	1930 births, 2021 deaths, Psychologists, Governors-General of Belize
George Cadle Price	1919 births, 2011 deaths, Prime Ministers of Belize, Political activists
Manuel Esquivel	1940 births, Living people, Prime Ministers of Belize
Vektor R4	5.56 mm firearms, Assault rifles, Rifles of the Cold War
Mineral County, Nevada	Nevada counties
Nye County, Nevada	Nevada counties
Pershing County, Nevada	Nevada counties
Storey County, Nevada	Nevada counties
Washoe County, Nevada	Nevada counties, 1861 establishments in the United States, 19th-century establishments in Nevada
White Pine County, Nevada	Nevada counties
In the Heights	2000s musicals, Tony Award winning musicals
Appenzeller cheese	Swiss cheeses
Bappusaheb Bhosale	Living people, 1977 births, People from Pune, Indian politicians
Manila, Arkansas	Cities in Arkansas
Geetha Salam	1946 births, 2018 deaths, Indian movie actors, Indian television actors, Indian stage actors, People from Kerala
Judsonia, Arkansas	Cities in Arkansas
Sausheim	Communes in Haut-Rhin
Adams County, Idaho	Idaho counties, 1911 establishments in Idaho
Guy Standing	1948 births, Alumni of the University of Cambridge, British economists, Living people, Nonviolence advocates
Swing music	African-American history, Jazz music
Said Musa	1944 births, Living people, Lawyers, Prime Ministers of Belize
Prime Minister of Nepal	Prime Ministers of Nepal
KP Sharma Oli	1952 births, Living people, Prime Ministers of Nepal
Bidya Devi Bhandari	1961 births, Living people, Presidents of Nepal, Current national leaders
Ram Baran Yadav	1948 births, Living people, Presidents of Nepal
Girija Prasad Koirala	1924 births, 2010 deaths, Deaths from asthma, Prime Ministers of Nepal, Presidents of Nepal, People from Biratnagar
President of Nepal	Presidents of Nepal
Winifred Griffin	1932 births, 2018 deaths, Deaths from lung cancer, New Zealand sportspeople, Swimmers
Rona Ramon	1964 births, 2018 deaths, Deaths from pancreatic cancer, Israeli writers, Activists
Francis Roache	1936 births, 2018 deaths, American police officers, Politicians from Boston, Massachusetts
Tömür Dawamat	1927 births, 2018 deaths, Chinese politicians
Wile E. Coyote and the Road Runner	Fictional animals, Animated characters, Fictional birds
Julie Gonzalo	1981 births, Living people, Naturalized citizens of the United States, American movie actors, American television actors, American voice actors, Argentine movie actors, Argentine television actors, Actors from Buenos Aires
David C. H. Austin	1926 births, 2018 deaths, British educators, People from Wolverhampton
Alex Badeh	1957 births, 2018 deaths, Assassinated people, Nigerian politicians, Generals
Steve Daskewisz	1944 births, 2018 deaths, Deaths from diabetes, Disease-related deaths in Florida, American movie actors, American television actors, Police officers, Stuntmen
Kazimierz Kutz	1929 births, 2018 deaths, Deaths from respiratory failure, Polish movie actors, Polish movie directors, Polish writers, Polish journalists, Polish politicians
Peter Masterson	Drama Desk Award winners, 1934 births, 2018 deaths, Accidental deaths from falls in the United States, Accidental deaths in New York, American movie actors, American television actors, American stage actors, American movie directors, American playwrights, American movie producers, Actors from Houston, Texas, Writers from Texas
Kinderhook, New York	Towns in New York
Bill Slater (footballer)	1927 births, 2018 deaths, Deaths from Alzheimer's disease, Disease-related deaths in England, English footballers, Sportspeople from Lancashire
DJ Emenes	Canadian songwriters, Musicians from Vancouver, Living people, Year of birth missing (living people)
Costa Mesa	Cities in California, Settlements in Orange County, California, 1950s establishments in California, 1953 establishments in the United States
AK-101	Assault rifles, 5.56 mm firearms
Bannock County, Idaho	1890s establishments in Idaho, 1893 establishments in the United States, Idaho counties
Fort Hall, Idaho	Census-designated places in Idaho
Tyhee, Idaho	Census-designated places in Idaho
Owyhee County, Idaho	Owyhee County, Idaho, 1860s establishments in Idaho Territory, 1863 establishments in the United States, Idaho counties
Arbon Valley, Idaho	Census-designated places in Idaho
Banks, Idaho	Census-designated places in Idaho
Bear Lake County, Idaho	1870s establishments in Idaho Territory, 1875 establishments in the United States, Idaho counties
Bern, Idaho	Unincorporated communities in Idaho
Geneva, Idaho	Unincorporated communities in Idaho
Bennington, Idaho	Census-designated places in Idaho
Blanchard, Idaho	Census-designated places in Idaho
Benewah County, Idaho	1915 establishments in Idaho, Idaho counties
Sleepy Hollow, New York	Villages in New York
Mount Pleasant, New York	Towns in New York
Eraldo Isidori	1940 births, 2018 deaths, Deaths from surgical complications, Italian politicians
Raimo Vartia	1937 births, 2018 deaths, Basketball players, Olympians, Sportspeople from Helsinki
Klaus Hagerup	1946 births, 2018 deaths, Deaths from colorectal cancer, Norwegian writers, Norwegian actors, Novelists, Poets, Screenwriters, Norwegian movie directors
Bartolomé Bennassar	1929 births, 2018 deaths, French historians, French writers, French educators
Angelo Badalamenti	Grammy Award winners, Saturn Award winners, 1937 births, Living people, American composers, Writers from New York City
Karnali Pradesh	Provinces of Nepal
Tianmu Mountain	Mountains of China, Zhejiang
Shanghai Disneyland Park	Theme parks in Asia, Disney theme parks, Shanghai
Sudurpashchim Pradesh	Provinces of Nepal
Jim Bakker	American fraudsters, American Evangelicals, People from Michigan, 1940 births, Living people
Generative model	Artificial intelligence, Learning, Statistics
List of EastEnders characters (1996)	EastEnders characters
Censorship of YouTube	Censorship, YouTube
List of EastEnders characters (2017)	EastEnders characters
Zhang Dejiang	1946 births, Living people, Chinese politicians
Ilyushin Il-62	Soviet & Russian aircraft, Civil aircraft
Yakovlev Yak-40	Civil aircraft, Soviet & Russian aircraft
Year zero	Years
Tupolev Tu-154	Civil aircraft, Soviet & Russian aircraft
Tupolev Tu-204	Civil aircraft, Soviet & Russian aircraft
Transclusion	Computer programming
Zaynab Otiti Obanor	Nigerian people, Living people, Year of birth missing (living people)
Senses Fail discography	Discographies
Somali Sea	Seas, Somalia
University of Maryland, Baltimore County	Colleges and universities in Maryland, 20th-century establishments in Maryland, 1966 establishments in the United States
Extremaduran Wikipedia	Wikipedias
Jerome County, Idaho	Jerome County, Idaho, Idaho counties, 1919 establishments in Idaho
Hunt, Idaho	Unincorporated communities in Idaho, Jerome County, Idaho
Washington County, Idaho	1870s establishments in Idaho Territory, 1879 establishments in the United States, Idaho counties
Canyon County, Idaho	1890s establishments in Idaho, 1891 establishments in the United States, Idaho counties
Conkling Park, Idaho	Census-designated places in Idaho
Pegram, Idaho	Unincorporated communities in Idaho
Bingham County, Idaho	1880s establishments in Idaho Territory, 1885 establishments in the United States, Idaho counties
Groveland, Idaho	Census-designated places in Idaho
Moreland, Idaho	Census-designated places in Idaho
Riverside, Bingham County, Idaho	Census-designated places in Idaho
Rockford, Idaho	Census-designated places in Idaho
Banks, Arkansas	Towns in Arkansas
Boise County, Idaho	1864 establishments in Idaho Territory, Idaho counties
Ilyushin Il-12	Soviet & Russian aircraft, Civil aircraft
Tupolev Tu-134	Civil aircraft, Soviet & Russian aircraft
Mil Mi-26	Soviet military aircraft, Helicopters
Zeng Qinghong	1939 births, Living people, Chinese politicians
Google AdSense	Google, Advertising
Li Yuanchao	1950 births, Living people, Chinese politicians
Liu Yunshan	1947 births, Living people, Chinese politicians
María Fernanda Espinosa	1964 births, Living people, Ambassadors, Presidents of the United Nations General Assembly, Ecuadorian politicians
Dire wolf	Wolves
Corium	Nuclear physics, Chemistry, Safety
2 Fast 2 Furious	2000s thriller movies, 2003 action movies, Fast & Furious movies, Universal Pictures movies
Super 30 (movie)	Indian movies, 2019 movies, 2010s drama movies
Ge'ez script	Alphabets, Languages of Africa, Semitic languages
Islam in North Macedonia	Islam by country, North Macedonia
Shreepali Basnet	Nepalese people
Dean Corll	1939 births, 1973 deaths, American murder victims, American rapists, American serial killers, Criminals from Indiana, Deaths by firearm in Texas, Gay men, LGBT people from Indiana, People from Fort Wayne, Indiana
Sherman Adams	White House Chiefs of Staff, 1899 births, 1986 deaths, Governors of New Hampshire
Governor of New Hampshire	Governors of New Hampshire
Tupolev Tu-155	Soviet & Russian aircraft
Antonov An-72	Soviet & Russian aircraft
Antonov An-74	Soviet & Russian aircraft
Antonov An-71	Soviet & Russian aircraft
Antonov An-3	Soviet & Russian aircraft, Civil aircraft, Military aircraft
Antonov An-32	Soviet & Russian aircraft, Military aircraft
Antonov An-30	Soviet & Russian aircraft, Military aircraft
Yanis Varoufakis	1961 births, Living people, Greek politicians, Greek economists
2018 Sunda Strait tsunami	December 2018 events, 2018 in Indonesia, 2018 earthquakes, Earthquakes in Indonesia, Tsunamis
West Nusa Tenggara	West Nusa Tenggara
Bima Regency	Regencies_of_West_Nusa_Tenggara
Dompu Regency	Regencies_of_West_Nusa_Tenggara
West Lombok Regency	Regencies_of_West_Nusa_Tenggara
Central Lombok Regency	Regencies_of_West_Nusa_Tenggara
East Lombok Regency	Regencies_of_West_Nusa_Tenggara
North Lombok Regency	Regencies_of_West_Nusa_Tenggara
Sumbawa Regency	Regencies_of_West_Nusa_Tenggara
West Sumbawa Regency	Regencies_of_West_Nusa_Tenggara
Commando (1985 movie)	1985 action movies, American action movies, English-language movies, Movies about terrorism, Movies directed by Mark L. Lester
Kerguelen Plateau	Indian Ocean, Geological formations
East Nusa Tenggara	East Nusa Tenggara
West Sumba Regency	Regencies_of_East_Nusa_Tenggara
West Manggarai Regency	Regencies_of_East_Nusa_Tenggara
Southwest Sumba Regency	Regencies_of_East_Nusa_Tenggara
South Central Timor Regency	Regencies_of_East_Nusa_Tenggara
Sikka Regency	Regencies_of_East_Nusa_Tenggara
Sabu Raijua Regency	Regencies_of_East_Nusa_Tenggara
Rote Ndao Regency	Regencies_of_East_Nusa_Tenggara
North Central Timor Regency	Regencies_of_East_Nusa_Tenggara
Ngada Regency	Regencies_of_East_Nusa_Tenggara
Nagekeo Regency	Regencies_of_East_Nusa_Tenggara
Manggarai Regency	Regencies_of_East_Nusa_Tenggara
Malaka Regency	Regencies_of_East_Nusa_Tenggara
Lembata Regency	Regencies_of_East_Nusa_Tenggara
Kupang Regency	Regencies_of_East_Nusa_Tenggara
Ende Regency	Regencies_of_East_Nusa_Tenggara
East Sumba Regency	Regencies_of_East_Nusa_Tenggara
East Manggarai Regency	Regencies_of_East_Nusa_Tenggara
East Flores Regency	Regencies_of_East_Nusa_Tenggara
Central Sumba Regency	Regencies_of_East_Nusa_Tenggara
Belu Regency	Regencies_of_East_Nusa_Tenggara
Alor Regency	Regencies_of_East_Nusa_Tenggara
Regencies of Indonesia	Indonesia
Japan Academy Prize	Movie awards, 1978 establishments in Asia, 1970s establishments in Japan
Ilyushin Il-18	Soviet & Russian aircraft, Civil aircraft
Ilyushin Il-38	Soviet & Russian aircraft, Civil aircraft
Dadabhai Naoroji	1825 births, 1917 deaths, British academics, Former members of the British House of Commons for English constituencies, Freemasons, Gujarat, Indian academics, Indian businesspeople, Indian journalists, Indian National Congress politicians, Indian writers, Liberal Party MPs (UK), Zoroastrians
Banten	Banten
Deep Carbon Observatory	Extremophiles, 2007 establishments in the United States, Carbon compounds, Earth sciences
Bad Cat	2016 movies, 2016 comedy movies, 2010s action movies, Computer-animated movies, Movies about cats, Movies based on comics, Istanbul, Movies set in the 1990s, Turkish movies, Adult animated movies
Ilyushin Il-10	Soviet & Russian aircraft, World War II aircraft
Blaine County, Idaho	1890s establishments in Idaho, 1895 establishments in the United States, Idaho counties
Picabo, Idaho	Unincorporated communities in Idaho
Emblem of Guatemala	National coats of arms, Guatemala
Emblem of Ethiopia	National coats of arms, Ethiopia
Avery, Idaho	Unincorporated communities in Idaho
Séry Bailly	1948 births, 2018 deaths, Deaths from surgical complications, Ivorian people, Educators, Politicians
Remedios Loza	1949 births, 2018 deaths, Deaths from stomach cancer, Bolivian politicians, Television presenters
President of Bolivia	Presidents of Bolivia
Jaime Paz Zamora	1939 births, Presidents of Bolivia, Vice Presidents of Bolivia, Living people
President of Honduras	Presidents of Honduras
Jon Bluming	1933 births, 2018 deaths, Dutch movie actors
Amélie Mummendey	1944 births, 2018 deaths, German writers, German educators, German psychologists, People from Bonn
Lebak Regency	Regencies_of_Banten
Pandeglang Regency	Regencies_of_Banten
Serang Regency	Regencies_of_Banten
Tangerang Regency	Regencies_of_Banten
Cilegon	Banten, Cities in Indonesia
Serang	Banten, Cities in Indonesia
South Tangerang	Banten, Cities in Indonesia
Anca Pop	1984 births, 2018 deaths, Road accident deaths, Canadian singer-songwriters, Romanian singers, Romanian writers
Robert Neild	1924 births, 2018 deaths, British economists, Writers from Hertfordshire
Gunnar Myrdal	1898 births, 1987 deaths, Scientists from Stockholm, Economists, Writers from Stockholm
Shinobu Sekine	1943 births, 2018 deaths, Japanese Olympic gold medalists, Judoka
Joy to the World	Christmas music
Mel Hutchins	1928 births, 2018 deaths, Deaths from Alzheimer's disease, Disease-related deaths in California, New York Knicks players, Atlanta Hawks players, Detroit Pistons players, Sportspeople from California
Encinitas, California	Cities in California, Settlements in San Diego County, California
Central Sulawesi	Provinces of Indonesia
Gorontalo	Provinces of Indonesia, Sulawesi
Lowell Mason	People from Orange, New Jersey, Writers from New Jersey, American composers, Writers from Massachusetts, 1792 births, 1872 births
Boalemo Regency	Regencies of Gorontalo (province)
Bone Bolango Regency	Regencies of Gorontalo (province)
Gorontalo Regency	Regencies of Gorontalo (province)
Pohuwato Regency	Regencies of Gorontalo (province)
North Gorontalo Regency	Regencies of Gorontalo (province)
West Sulawesi	West Sulawesi
Frontier(s)	French horror movies, Swiss movies, 2007 horror movies, Movies directed by Xavier Gens
F. W. Bernstein	1938 births, 2018 deaths, German poets, Cartoonists, German educators
Gerard Bernacki	1942 births, 2018 deaths, Polish Roman Catholics, Bishops
Jiko Luveni	1946 births, 2018 deaths, Fijian politicians
Simcha Rotem	1924 births, 2018 deaths, People from Warsaw, Polish Jews, Holocaust survivors
Talal bin Abdulaziz Al Saud	1931 births, 2018 deaths, Saudi Arabian people, Princes and princesses, Political activists
Lucas Bersamin	1949 births, Chief Justices of the Supreme Court of the Philippines, Living people
Alfred Bader	1924 births, 2018 deaths, Deaths from heart failure, Canadian businesspeople, Canadian scientists, Chemists, Canadian philanthropists, Scientists from Vienna
Octobass	String instruments
Nana Chudasama	1933 births, 2018 deaths, Indian politicians, People from Mumbai
Elias M. Stein	Wolf Prize winners, 1931 births, 2018 deaths, American mathematicians, Naturalized citizens of the United States, People from Antwerp
Galaxy Express 999	1998 anime movies
Michelle Yeoh	1962 births, Living people, Actresses who played Bond girls, Movie actors, Malaysian people
Glass harmonica	Musical instruments
Charles Mattocks	United States Army Medal of Honor recipients, People from Portland, Maine, American military personnel of the Spanish-American War, 1910 deaths, 1840 births
Patrick Steptoe	British scientists, 1913 births, 1988 deaths, Fellows of the Royal Society, Commanders of the Order of the British Empire, People from Oxfordshire
Tupolev Tu-114	Soviet & Russian aircraft, Civil aircraft, Tupolev aircraft
Majene Regency	Regencies of West Sulawesi
Mamasa Regency	Regencies of West Sulawesi
Mamuju Regency	Regencies of West Sulawesi
Mamuju (city)	West Sulawesi
Achille Beltrame	1871 births, 1945 deaths, Italian painters, Italian artists, Illustrators, People from Veneto
Mustafa Ali (wrestler)	1986 births, Living people, American professional wrestlers
2018 Puebla helicopter crash	2018 aviation disasters, 2018 in Mexico, December 2018 events, Disasters in Mexico, Puebla (state), Transport disasters in North America
2018–2019 United States federal government shutdown	2018 in the United States, 2019 in the United States, December 2018 events, Donald Trump, January 2019 events
Jozef Adamec	1942 births, 2018 deaths, Slovak footballers
Osvaldo Bayer	1927 births, 2018 deaths, Argentine journalists, Photographers, Political activists, People from Buenos Aires
Martha Erika Alonso Hidalgo	1973 births, 2018 deaths, Aviation deaths, Mexican politicians
Rafael Moreno Valle Rosas	1968 births, 2018 deaths, Aviation deaths, Mexican politicians
Bill Baillie	1934 births, 2018 deaths, New Zealand sportspeople, Olympians
Larry Eisenberg	1919 births, 2018 deaths, Deaths from acute myeloid leukemia, Cancer deaths in Massachusetts, Engineers from New York, American science fiction writers, American poets, Writers from New York City, Scientists from New York City
Sulagitti Narasamma	1920 births, 2018 deaths, Deaths from COPD, Indian educators, Humanitarians
Baldur Ragnarsson	1930 births, 2018 deaths, Icelandic writers, Educators, Poets
Albert Uderzo	1927 births, 2020 deaths, Deaths from myocardial infarction, French artists
Lata Mangeshkar	1929 births, Living people, Indian singers, Bollywood playback singers
Ilyushin Il-2	Soviet & Russian aircraft, World War II aircraft
Ruthie Tompson	1910 births, Living people, American animators, American supercentenarians, Disney people, People from Portland, Maine
Sonali Bendre	1975 births, Living people, Indian movie actors, Indian television actors, Indian writers, Indian models, Television personalities, People with cancer, Actors from Mumbai
Val Bettin	1923 births, Living people, American movie actors, American television actors, American stage actors, American voice actors, Actors from Wisconsin
Herbert Kretzmer	Tony Award winners, Grammy Award winners, 1925 births, 2020 deaths, Deaths from Parkinson's disease, Disease-related deaths in London, South African writers, Lyricists, English journalists
Vogelkop bowerbird	Passeri, Birds of Indonesia
Eiza González	1990 births, Living people, Mexican movie actors, Mexican television actors
Polistes carnifex	Wasps
She's Gotta Have It	1986 comedy movies, American comedy movies, American independent movies, Movies directed by Spike Lee, Screenplays by Spike Lee
Jordan Peterson	1962 births, Living people, Canadian academics, Canadian critics, Canadian psychologists, Canadian scientists, Conservatives, Harvard University, People from Alberta
Viktor Frankl	1905 births, 1997 deaths, Scientists from Vienna, Austrian Jews, Austrian psychiatrists, Neurologists, Holocaust survivors, Jewish scientists, Order of Merit of the Federal Republic of Germany, Recipients of the Decoration for Services to the Republic of Austria
Robert de Zouche Hall	1904 births, 1995 deaths, Knights Commander of the Order of St Michael and St George, Sierra Leonean people
Paradise, Nevada	Unincorporated communities in Nevada, Census-designated places in Nevada, 1950 establishments in the United States, 20th-century establishments in Nevada
Caledonia County, Vermont	Vermont counties
Arlington, Massachusetts	Towns in Massachusetts
Álex Figueroa	1961 births, 2018 deaths, Deaths from liver cancer, Chilean politicians, Chilean physicians
Miúcha	1937 births, 2018 deaths, Deaths from respiratory failure, Brazilian singers, Composers, People from Rio de Janeiro
Antonov An-148	Aircraft
Deaths in January 2019	2019 deaths, January 2019 events
Tadeusz Pieronek	1934 births, 2018 deaths, Deaths from myocardial infarction, Bishops, Polish educators, Polish Roman Catholics
Tupolev Tu-104	Soviet & Russian aircraft, Civil aircraft
Micheál Martin	1960 births, Living people, Current national leaders, Taoisigh of Ireland, Fianna Fáil politicians
Bootleg recording	Property crimes, Copyright
Water table	Water, Aquifers
Violet Evergarden	2015 books, Light novels
Nardole	Doctor Who characters
Juan Bautista Agüero	1935 births, 2018 deaths, Paraguayan footballers
Robert Kerman	1947 births, 2018 deaths, American pornographic actors, American movie actors, American television actors, Actors from New York City
Amos Oz	1939 births, 2018 deaths, Cancer deaths in Israel, Israeli writers, Israeli journalists, Israeli activists, Israeli educators, Novelists, Philosophers, Political activists, Political writers, People from Jerusalem
Patrick M. Shanahan	1962 births, Living people, United States Secretaries of Defense, Businesspeople from California, Politicians from California, People from Palo Alto, California
David Bernhardt	1969 births, Living people, American lawyers, American lobbyists, Businesspeople from Colorado, Politicians from Colorado, United States Secretaries of the Interior, US Republican Party politicians
Rifle, Colorado	Cities in Colorado
McFlurry	Ice cream, McDonald's
Bonner County, Idaho	1900s establishments in Idaho, 1907 establishments in the United States, Idaho counties
Earle, Arkansas	Cities in Arkansas
Emmet, Arkansas	Cities in Arkansas
Clay County, Kentucky	Kentucky counties, 1800s establishments in Kentucky, 1807 establishments in the United States
Clay County, Tennessee	Tennessee counties, 19th-century establishments in Tennessee, 1870 establishments in the United States
Clay County, Mississippi	Mississippi counties, 1870s establishments in Mississippi, 1871 establishments in the United States
UNCF	1944 establishments in the United States, 20th-century establishments in Washington, D.C., Organizations based in the United States, Washington, D.C.
Sigma, Capiz	Cities in the Philippines
Capiz	Provinces of the Philippines
Aída Judith León	Living people, 1928 births, First Ladies, South American philanthropists, Ecuadorian people
Tom Weisner	1949 births, 2018 deaths, Deaths from colorectal cancer, Cancer deaths in Illinois, American mayors, Politicians from Illinois, US Democratic Party politicians, People from Aurora, Illinois
Wendy Beckett	1930 births, 2018 deaths, Nuns, British historians, British television personalities, BBC people, South African writers, Writers from Norfolk
Peritonitis	Diseases
Tomokatsu Kitagawa	1951 births, 2018 deaths, Deaths from peritonitis, Japanese politicians
Toshiko Fujita	1950 births, 2018 deaths, Japanese movie actors, Japanese television actors, Japanese voice actors, Japanese singers, Deaths from breast cancer
Peter Hill-Wood	1936 births, 2018 deaths, Businesspeople from London
Robert Costanzo	1942 births, Living people, American movie actors, American television actors, American stage actors, American voice actors, American video game actors, Actors from New York City
Brenda Vaccaro	Golden Globe Award winning actors, Emmy Award winning actors, Satellite Award winners, 1939 births, Living people, American movie actors, American stage actors, American voice actors, American television actors, Actors from New York City
Bird Box (movie)	2018 movies, Movies based on books, American thriller movies, Netflix movies, Post-apocalyptic movies
Jason Wiles	1970 births, Living people, Actors from Kansas City, Missouri, American movie actors, American television actors
Clay County, Missouri	1820s establishments in Missouri, 1822 establishments in the United States, Missouri counties
Gitega	Cities in Burundi, Capital cities in Africa
The Ant Bully	2006 movies, 2006 animated movies, 2006 computer-animated movies, Warner Bros. movies
Tripureswar	Geography of Nepal, Villages in Asia
Yakovlev Yak-18	Soviet & Russian aircraft
Yakovlev	Aircraft companies, Companies of Russia, Moscow
Kelly Burnett	1926 births, 2018 deaths, New York Rangers players, Ice hockey people from Quebec, Sportspeople from Montreal, Ice hockey centres
Børge Ring	Academy Award winners, Animators, Danish screenwriters, 1921 births, 2018 deaths, Danish movie directors
Mohammed Nadir Shah	1883 births, 1933 deaths, Pashtun people
Penny (United States coin)	Currency of the United States
Dietrich von Choltitz	1894 births, 1966 deaths, German generals of World War II, German military personnel of World War I
Mary Poppins Returns	2010s fantasy movies, 2010s musical movies, 2018 comedy-drama movies, American fantasy-comedy movies, American musical comedy movies, American comedy-drama movies, Disney movies, Movies set in the 1930s, Movies set in London
Schlierbach, Haut-Rhin	Communes in Haut-Rhin
Schweighouse-Thann	Communes in Haut-Rhin
Schwoben	Communes in Haut-Rhin
Sentheim	Communes in Haut-Rhin
Spechbach, Haut-Rhin	2016 establishments in France, Communes in Haut-Rhin
Spechbach-le-Haut	Former communes in Haut-Rhin
Spechbach-le-Bas	Former communes in Haut-Rhin
Seppois-le-Bas	Communes in Haut-Rhin
Seppois-le-Haut	Communes in Haut-Rhin
Sewen	Communes in Haut-Rhin
Sickert, Haut-Rhin	Communes in Haut-Rhin
Sierentz	Communes in Haut-Rhin
Steinbach, Haut-Rhin	Communes in Haut-Rhin
Soppe-le-Bas	Communes in Haut-Rhin
Zimmerbach	Communes in Haut-Rhin
Dierks, Arkansas	Cities in Arkansas
De Graff, Minnesota	Cities in Minnesota
Peter Popoff	Television evangelists, German people, People from California, 1946 births, Living people
Yakovlev Yak-1	Soviet & Russian aircraft, World War II aircraft
Yakovlev Yak-7	Soviet & Russian aircraft, World War II aircraft
Yakovlev Yak-52	Soviet & Russian aircraft, World War II aircraft
Lawrence Roberts	1937 births, 2018 deaths, American computer scientists, Scientists from Connecticut
Elsa Bruckmann	1865 births, 1946 deaths, Princes and princesses, Romanian people
Tupolev Tu-16	Soviet & Russian aircraft, Bombers
Tupolev Tu-14	Soviet & Russian aircraft, Bombers
Polikarpov Po-2	Soviet & Russian aircraft
Antonov An-8	Soviet & Russian aircraft
Cooking Papa	1985 manga, 1990s television series, 1992 anime television series, Anime series, Japanese television dramas based on manga, Manga series, Television series about families
Kiwano	Cucurbitaceae, Melons
A.I. Artificial Intelligence	2001 science fiction movies, 2001 drama movies, American science fiction movies, American drama movies, Post-apocalyptic movies, Movies directed by Steven Spielberg
Hachimaki	Headgear
Sembawang MRT station	Mass Rapid Transit (Singapore) stations, 20th century establishments in Singapore, 1996 establishments in Asia
Hard copy and soft copy	Media, Computing
Héctor Timerman	1953 births, 2018 deaths, Deaths from liver cancer, Argentine writers, Argentine journalists, Human rights activists, Ambassadors, Argentine politicians, People from Buenos Aires
Yehoshua Glazer	1927 births, 2018 deaths, Israeli footballers, People from Tel Aviv
Syed Jahangir	1935 births, 2018 deaths, Bangladeshi painters
Ringo Lam	1955 births, 2018 deaths, Chinese movie directors, Chinese screenwriters, People from Hong Kong, Chinese movie producers
Rosenda Monteros	1935 births, 2018 deaths, Mexican movie actors, Mexican television actors, Mexican stage actors, Mexican voice actors
Aldo Parisot	1918 births, 2018 deaths, Brazilian musicians, Naturalized citizens of the United States, American educators, American centenarians, American cellists, Musicians from New Haven, Connecticut
Dick Helling	1950 births, 2018 deaths, Deaths from stroke, Dutch footballers, People from Zaanstad, Sportspeople from North Holland
Edgar Hilsenrath	1926 births, 2018 deaths, Deaths from pneumonia, German writers, People from Leipzig
István Seregély	1931 births, 2018 deaths, Hungarian Roman Catholics, Archbishops
Peter Thompson	1942 births, 2018 deaths, English footballers, Sportspeople from Cumbria
Antonov A-1	Soviet & Russian aircraft
John McCririck	1940 births, 2019 deaths, Deaths from lung cancer, Cancer deaths in London, English journalists, English television presenters, English sports commentators, Writers from Surrey
Jimmy Osmond	1963 births, Living people, American movie actors, American television actors, American stage actors, Actors from Los Angeles, California, Actors from Utah, Singers from California, Singers from Utah, Businesspeople from California, Businesspeople from Utah
Antonov A-15	Soviet & Russian aircraft
Bamberg, South Carolina	Cities in South Carolina, County seats in South Carolina
Vibrio vulnificus	Diseases caused by bacteria
Paul Neville (politician)	1940 births, 2019 deaths, Politicians from Queensland
Raymond Ramazani Baya	1943 births, 2019 deaths, Democratic Republic of the Congo politicians, Ambassadors to France
Antonov A-11	Soviet & Russian aircraft
Denmark, South Carolina	Cities in South Carolina
Lauren Tom	1961 births, Living people, American movie actors, American television actors, American voice actors, American stage actors, Actors from Illinois, People from Highland Park, Illinois
William Gianelli	1919 births, American centenarians, American lawyers, Engineers from California, Politicians from California, Scientists from California, People from Stockton, California, 2020 deaths
Stephen Wilkinson (musician)	1919 births, 2021 deaths, BBC people, Conductors, English centenarians, English composers, People from Cambridgeshire
Basil Yamey	1919 births, 2020 deaths, South African writers, Economists, People from Cape Town
June Spencer	1919 births, Living people, English centenarians, English movie actors, English radio actors, English stage actors, English television actors, People from Nottingham
Mauro Cía	1919 births, Living people, Boxers, Olympians, Argentine movie actors, Sportspeople from Buenos Aires, Actors from Buenos Aires
Robert Morgenthau	1919 births, 2019 deaths, Disease-related deaths in New York City, American lawyers, American military personnel of World War II, Politicians from New York City, US Democratic Party politicians
Margaret Burbidge	1919 births, 2020 deaths, Accidental deaths from falls in the United States, American astronomers, American centenarians, American educators, American physicists, British astronomers, British educators, British physicists, English centenarians, Naturalized citizens of the United States, People from Greater Manchester, Scientists from California
Walter Bernstein	1919 births, 2021 deaths, Deaths from pneumonia, American centenarians, American military personnel of World War II, Movie producers from New York City, Screenwriters from New York City, Writers from Brooklyn
Gladys Davis (baseball)	1919 births, Living people, Canadian baseball players, Sportspeople from Toronto
Mario Bunge	1919 births, 2020 deaths, Argentine scientists, Political writers, Philosophers, Writers from Buenos Aires, Physicists
Edward L. Feightner	1919 births, 2020 deaths, American centenarians, American military personnel of World War II, People from Lima, Ohio
Alun Gwynne Jones, Baron Chalfont	1919 births, 2020 deaths, British centenarians, British politicians, Political writers, British historians, British military personnel of World War II
Bert J. Harris Jr.	1919 births, 2019 deaths, State legislators of the United States, Politicians from Florida, Politicians from Georgia (U.S. state), US Democratic Party politicians
Warwick, Georgia	Cities in Georgia (U.S. state)
Charles E. McGee	1919 births, Living people, American military personnel of World War II, American military personnel of the Korean War, American military personnel of the Vietnam War, People from Cleveland, Ohio
Vasily Reshetnikov	1919 births, Living people, Soviet military personnel of World War II
Pierre Soulages	1919 births, Living people, French painters, French sculptors
Thomas W. Horton	1919 births, Living people, Military personnel of World War II, New Zealand people
Kenneth O. Chilstrom	1921 births, Living people, American military personnel of World War II, People from Minnesota
Zumbrota, Minnesota	Cities in Minnesota
Zumbro River	Rivers of Minnesota
Folke Alnevik	1919 births, 2020 deaths, Centenarians, Swedish Olympians, Olympic bronze medalists
Antonov An-12	Soviet & Russian aircraft
Michael D. Griffin	1949 births, Living people, Administrators of NASA, American physicists, Engineers from Maryland, Politicians from Maryland, US Republican Party politicians
Space Shuttle Solid Rocket Boosters	Rockets, Space Shuttles
Aberdeen, Maryland	Cities in Maryland
George S. Vest	1918 births, 2021 deaths, American centenarians, Ambassadors of the United States, Politicians from Virginia, Cardiovascular disease deaths in the United States
Ninja (gamer)	1991 births, Living people, Entertainers from Michigan, Entertainers from Chicago, People from Detroit, Michigan, Twitch (service) streamers
Meadow Lane	Football stadiums in England, Nottinghamshire
Black Cat (manga)	Science fiction anime and manga
Ariel Lin	1982 births, Living people, Taiwanese television actors, Taiwanese movie actors, Taiwanese singers
Front crawl	Swimming
Windows NT 3.1	Microsoft operating systems
Windows NT 3.5	Microsoft operating systems
Edgefield, South Carolina	Towns in South Carolina, County seats in South Carolina
Bonneville County, Idaho	1911 establishments in Idaho, Idaho counties
George West, Texas	Cities in Texas, County seats in Texas
Panhandle, Texas	Towns in Texas, County seats in Texas
Anahuac, Texas	Cities in Texas, County seats in Texas
Andrews, Texas	Cities in Texas, County seats in Texas
Angleton, Texas	Cities in Texas, County seats in Texas
Wahlbach, Haut-Rhin	Communes in Haut-Rhin
Backstroke	Swimming
Lögberg	Iceland
Creativity (religion)	1973 establishments in the United States, Religion in the United States, Race
Wang Yang	1955 births, Living people, Chinese politicians
Space Shuttle Buran	Soviet spacecraft
Bob Einstein	Emmy Award winners, 1942 births, 2019 deaths, Deaths from leukemia, Cancer deaths in California, American movie actors, American television actors, American stage actors, American voice actors, American television writers, American television producers, Actors from Los Angeles, California, Writers from Los Angeles, California, Comedians from Los Angeles, California
Robbinsdale, Minnesota	Cities in Minnesota
Dagfinn Bakke	1933 births, 2019 deaths, Norwegian painters, Illustrators
Ivan Dimitrov	1935 births, 2019 deaths, Bulgarian footballers, People from Sofia
Satpura Range	Hills, Madhya Pradesh, Maharashtra
Kris Kelmi	1955 births, 2019 deaths, Deaths from cardiac arrest, Russian composers, Musicians from Moscow, Russian singers
Pegi Young	1952 births, 2019 deaths, Cancer deaths in California, American country singers, American country guitarists, American folk singers, American folk musicians, American rock singers, American rock guitarists, American jazz singers, American jazz musicians, American educators, American environmentalists, American philanthropists, Singer-songwriters from California, Musicians from California
Jerzy Turonek	1929 births, 2019 deaths, Polish historians, Belarusian writers
Robert Hogan	1933 births, 2021 deaths, Deaths from pneumonia, People with Alzheimer's disease, American movie actors, American television actors, American stage actors, American voice actors, Actors from New York City
Michael Yeung	1945 births, 2019 deaths, Deaths from liver failure, Deaths from cirrhosis, Roman Catholics, Bishops, People from Shanghai
Paulien van Deutekom	1981 births, 2019 deaths, Deaths from lung cancer, Dutch Olympians, Speed skaters, Sportspeople from The Hague
Nordstrom	1901 establishments in the United States, American department stores
Emperor Gaozong of Tang	620s births, 680s deaths, Emperors and Empresses of China
Ang Thong Province	Provinces of Thailand
Mr. Box Office	Lists of television series episodes, English-language television programs
Jonathan Cohen (diplomat)	Living people, United States Ambassadors to the United Nations, Politicians from California
Laguna Beach, California	Cities in California, Settlements in Orange County, California
Jim Clyburn	1940 births, Living people, United States representatives from South Carolina, US Democratic Party politicians
Windows NT 6.x	Microsoft operating systems
Japanese plum	Plums, Trees, Plants of Asia, Medicinal plants
Kevin J. McIntyre	1960 births, 2019 deaths, Deaths from brain cancer, Cancer deaths in Virginia, American lawyers, People from Dover, Delaware, Politicians from Delaware, Politicians from Washington, D.C., US Republican Party politicians
Bajo Hondo Train Station	Railway stations in South America, Railway accidents, Argentina
Deb Haaland	1960 births, Living people, United States representatives from New Mexico, United States Secretaries of the Interior, Politicians from Arizona, US Democratic Party politicians
Sharice Davids	1980 births, Living people, American lawyers, LGBT politicians, Lesbians, American mixed martial artists, United States representatives from Kansas, US Democratic Party politicians, People from Leavenworth, Kansas, Kansas Democrats, 21st-century American politicians
Sondernach	Communes in Haut-Rhin
Sondersdorf	Communes in Haut-Rhin
Soppe-le-Haut	Former communes in Haut-Rhin
Soultzbach-les-Bains	Communes in Haut-Rhin
Soultzeren	Communes in Haut-Rhin
Urschenheim	Communes in Haut-Rhin
Valdieu-Lutran	Communes in Haut-Rhin
Werentzhouse	Communes in Haut-Rhin
Square dance	Dance types
Goaltender mask	Headgear, Ice hockey
Ilya Spitalnik	Living people, British businesspeople, People from Tel Aviv, Year of birth missing (living people)
Antonov An-124	Soviet & Russian aircraft
Zhang Gaoli	1946 births, Living people, Chinese politicians
Wu Bangguo	1941 births, Living people, Chinese politicians
Jia Qinglin	1940 births, Living people, Chinese politicians
Li Ruihuan	1934 births, Living people, Chinese politicians
Li Xiannian	1909 births, 1992 deaths, Presidents of the People's Republic of China
Yang Shangkun	1907 births, 1998 deaths, Presidents of the People's Republic of China
Malcolm E. Beard	1919 births, 2019 deaths, State legislators of the United States, Politicians from Georgia (U.S. state), Politicians from Florida, US Republican Party politicians
Moultrie, Georgia	County seats in Georgia, Cities in Georgia (U.S. state)
Jerry Buchek	1942 births, St. Louis Cardinals players, New York Mets players, Sportspeople from St. Louis, Missouri, 2019 deaths
Herb Kelleher	1931 births, 2019 deaths, Deaths from prostate cancer, Businesspeople from New Jersey, People from Camden, New Jersey
Emperor Ruizong of Tang	660s births, 710s deaths, Emperors and Empresses of China
Emperor Wen of Sui	Emperors and Empresses of China, 6th century births, 604 deaths
Bajo Hondo Train Station (Roca Railway)	Railway stations in South America, Argentina
Paso Mayor Train Station	Railway stations in South America, Argentina
Stammheim, Zurich	Municipalities of Zürich, 2010s establishments in Switzerland, 2019 establishments in Europe
Rheinwald, Switzerland	Rheinwald GR, Municipalities of Graubünden, 2010s establishments in Switzerland, 2019 establishments in Europe
Clay County, West Virginia	West Virginia counties, 1858 establishments in the United States, 19th-century establishments in West Virginia
Clay County, Kansas	1857 establishments in Kansas Territory, Kansas counties
Essex County, Vermont	Vermont counties
Boundary County, Idaho	Idaho counties, 1915 establishments in Idaho
Lemhi County, Idaho	Idaho counties, 1860s establishments in Idaho Territory, 1869 establishments in the United States
Melbourne Beach, Florida	Towns in Florida
South Bay Lakers	2000s establishments in California, 2006 establishments in the United States, Basketball teams
Easier with Practice	American drama movies, 2009 drama movies
Emperor Zhongzong of Tang	650s births, 710s deaths, Emperors and Empresses of China
Blood Blockade Battlefront	Science fiction anime and manga
Sergey Ilyushin	1894 births, 1977 deaths, Soviet people, Russian scientists, Engineers, Recipients of the Order of Lenin
Andrei Tupolev	1888 births, 1977 deaths, Russian scientists, Russian inventors, Soviet people, Russian engineers
Nikolai Nikolaevich Polikarpov	1894 births, 1944 deaths, Russian scientists, Russian engineers, Soviet people, Deaths from stomach cancer, Disease-related deaths in the Soviet Union
Pavel Sukhoi	1895 births, 1975 deaths, Belarusian people, Engineers, Soviet politicians, Recipients of the Order of Lenin
Paso Mayor	Argentina
Petra	Cities in Jordan, World Heritage Sites in Asia
Saraiki people	Punjabi people, Ethnic groups in Pakistan
Chelmsley Wood	Birmingham
Smithville, Arkansas	Towns in Arkansas
Portia, Arkansas	Towns in Arkansas
Afton, Oklahoma	Towns in Oklahoma
Corn, Oklahoma	Towns in Oklahoma
Howey-in-the-Hills, Florida	Towns in Florida
Astatula, Florida	Towns in Florida
Alford, Florida	Towns in Florida
Altha, Florida	Towns in Florida
Malone, Florida	Towns in Florida
Campbellton, Florida	Towns in Florida
Greenwood, Florida	Towns in Florida
Butte County, Idaho	1913 establishments in Idaho, Idaho counties
Grand Isle County, Vermont	Vermont counties
Lamoille County, Vermont	Vermont counties
Orange County, Vermont	18th-century establishments in Vermont, 1781 establishments in North America, Vermont counties
Orleans County, Vermont	Vermont counties
Washington County, Vermont	Vermont counties
Windham County, Vermont	Vermont counties
Windsor County, Vermont	Vermont counties
Mil Mi-10	Soviet & Russian aircraft
Mil Mi-6	Soviet & Russian aircraft
Mikhail Mil	1909 births, 1970 deaths, Soviet people, Russian engineers, Recipients of the Order of Lenin
Serik Akhmetov	1958 births, Living people, Prime Ministers of Kazakhstan
Daniyal Akhmetov	1954 births, Living people, Prime Ministers of Kazakhstan
Karim Masimov	1965 births, Living people, Prime Ministers of Kazakhstan
Boulder City, Nevada	Cities in Nevada
Ely, Nevada	Cities in Nevada, County seats in Nevada
Lars Hindmar	1921 births, 2018 deaths, Swedish Olympians
Rosalyn Terborg-Penn	1941 births, 2018 deaths, American historians, Writers from New York City
Peter Swinnerton-Dyer	1927 births, 2018 deaths, Contract bridge players, English mathematicians, English sportspeople
Dean Ford	1946 births, 2018 deaths, Deaths from Parkinson's disease, Disease-related deaths in Los Angeles, Scottish singer-songwriters
Etty Fraser	1931 births, 2018 deaths, Deaths from heart failure, Brazilian movie actors, Brazilian television actors, Brazilian stage actors
Gülriz Sururi	1929 births, 2018 deaths, Deaths from cholangiocarcinoma, Turkish movie actors, Turkish television actors, Actors from Istanbul, Writers from Istanbul
Jamal Ahmad Mohammad Al Badawi	1960s births, 2019 deaths, Deaths by airstrike, Yemeni people, Terrorists
Dragoslav Šekularac	1937 births, 2019 deaths, Deaths from Alzheimer's disease, Serbian footballers
Ivan Bortnik	1939 births, 2019 deaths, Deaths from thrombosis, Russian movie actors, Russian television actors, Russian stage actors, Actors from Moscow
Christian Mohn	1926 births, 2018 deaths, Sportspeople from Oslo
Henri, Grand Duke of Luxembourg	1955 births, Living people, Grand Dukes of Luxembourg, Current national leaders
Bremerton, Washington	Cities in Washington (U.S. state)
John Cho	1972 births, Living people, American movie actors, American television actors, American voice actors, South Korean actors, People from Seoul
Manfred Weber	1972 births, Living people, MEPs for Germany
Jean Tiberi	1935 births, Living people, Mayors of Paris
Anne Hidalgo	1959 births, Living people, Mayors of Paris, Spanish politicians
Bertrand Delanoë	1950 births, Living people, French crime victims, French LGBT people, Gay men, LGBT politicians, LGBT rights activists, Mayors of Paris, People from Tunis, Socialist Party (France) politicians, Recipients of the Order of the Rising Sun
Barry Farber	1930 births, 2020 deaths, Accidental deaths in New York City, American conservatives, American political writers, American radio personalities, American political commentators, National Radio Hall of Fame inductees, Writers from New York City, Politicians from New York City, Politicians from Baltimore, Maryland, Writers from Baltimore, Maryland, US Republican Party politicians
Grace Napolitano	1936 births, Living people, United States representatives from California, Politicians from Texas, US Democratic Party politicians
Shanghai Noon	2000 movies, American action movies, American comedy movies
Climacoceratidae	Mammals
Fantasamagorie	Fantasy movies
Eric Haydock	1943 births, 2019 deaths, British bass guitarists, Musicians from Cheshire
The Hollies	1962 establishments in England, Musicians from Manchester, British pop rock bands, Musical groups established in 1962
Allan Clarke (singer)	1942 births, Living people, English pop singers, English pop musicians, English rock singers, English rock guitarists, Musicians from Lancashire
Tony Hicks	1945 births, Living people, English rock singers, English rock guitarists, Singers from Lancashire, Musicians from Lancashire
Bobby Elliott	1941 births, Living people, English rock drummers, English rock guitarists, Musicians from Lancashire
José Ramón Fernández	1923 births, 2019 deaths, Cuban politicians, Cuban military people, People from Havana
Pidyon haben	Judaism
The Seven Bridges of Paso Mayor	Transport in Argentina, Bridges
Zhantoro Satybaldiyev	1956 births, Living people, Prime Ministers of Kyrgyzstan
Askar Akayev	1944 births, Living people, Presidents of Kyrgyzstan
Annalise Braakensiek	1972 births, 2019 deaths, Australian movie actors, Australian television actors, Australian models, Actors from Sydney
Gene Zwozdesky	1948 births, 2019 deaths, Cancer deaths in Canada, Politicians from Alberta, People from Saskatchewan
Alexander Sergeyevich Yakovlev	1906 births, 1989 deaths, Russian scientists, Russian engineers, Soviet politicians, Writers from Moscow, Recipients of the Order of Lenin, Legion of Honour
Beny Esguerra	Living people, Musicians from Toronto, Writers from Toronto, Canadian poets, Year of birth missing (living people)
Capital Development Authority (Islamabad)	20th century establishments in Pakistan, 1960 establishments in Asia, Government of Pakistan, Islamabad
In the Aeroplane Over the Sea	1998 albums
Bal Harbour, Florida	Villages in Florida
National emblem of Turkey	National coats of arms, Turkey
Carl Gustaf Emil Mannerheim	1867 births, 1951 deaths, Presidents of Finland, Military personnel of World War II
DC Universe Online	Video games
Julian Glover	1935 births, Living people, English movie actors, English television actors, English stage actors, English voice actors, Actors from London, Actors who played Bond villains
Sylvia Chase	1938 births, 2019 deaths, Deaths from brain cancer, Cancer deaths in California, American journalists, American television news anchors, Writers from Minnesota, Writers from San Francisco
Northfield, Minnesota	Cities in Minnesota
Derek Piggott	1922 births, 2019 deaths, Deaths from stroke, British aviators, People from Essex
W. Morgan Sheppard	1932 births, 2019 deaths, Cancer deaths in Los Angeles, English movie actors, English stage actors, English television actors, English voice actors, Actors from London
Tom Rukavina	1950 births, 2019 deaths, Deaths from leukemia, State legislators of the United States, Politicians from Minnesota, US Democratic Party politicians
Chris Tucker	1971 births, Living people, American movie actors, American television actors, American voice actors, Comedians from Georgia (U.S. state), Actors from Atlanta, Georgia
Brett Ratner	1969 births, Living people, American movie directors, American movie producers, Businesspeople from Miami, Florida
José Antonio Pujante	1964 births, 2019 deaths, Deaths from myocardial infarction, Spanish politicians
Bernard Tchoullouyan	1953 births, 2019 deaths, Deaths from myocardial infarction, Judoka, French Olympians, Olympic bronze medalists, Sportspeople from Marseille
Grim Fandango	1998 video games, Point-and-click adventure games, Windows games
Semyon Lavochkin	1900 births, 1960 deaths, Russian scientists, Russian engineers, Soviet politicians, Russian Jews, Soviet Jews, Recipients of the Order of Lenin
Li Changchun	1944 births, Living people, Chinese politicians
Carmencita Reyes	1931 births, 2019 deaths, Filipino politicians
Richard Ojeda 2020 presidential campaign	2020 United States presidential campaigns
John Mendelsohn	1936 births, 2019 deaths, Deaths from glioblastoma, Cancer deaths in Texas, American physicians, Scientists from Cincinnati, Ohio
Harold Demsetz	1930 births, 2019 deaths, American economists, Scientists from Chicago, Writers from Chicago
Birdsong, Arkansas	Towns in Arkansas
Big Flat, Arkansas	Towns in Arkansas
Edwin Erickson	1938 births, 2019 deaths, State legislators of the United States, Politicians from Philadelphia, Pennsylvania, Businesspeople from Philadelphia, Pennsylvania, US Republican Party politicians, People from Bryn Mawr, Pennsylvania
Doddie Weir	1970 births, Living people, Rugby union players, Sportspeople from Edinburgh
Khas Rajput	History of India, Rajputs
Douglas DC-2	Douglas aircraft
Douglas DC-3	Douglas aircraft
Lisunov Li-2	Soviet & Russian aircraft
Boris Lisunov	1898 births, 1946 deaths, Soviet people, Russian scientists, Russian engineers, Recipients of the Order of Lenin
Vowel length	Linguistics
Great Vowel Shift	English language, Linguistics
Sound change	Linguistics
Mongolian script	Writing systems, Alphabets
Autonomous regions of China	Autonomous regions of China
Manchu language	Languages of China
Early Modern English	English language
Zuma (album)	1975 albums
On Avery Island	1996 albums, Debut albums
Kuroko's Basketball	2012 anime television series, 2013 anime television series, 2015 anime television series, Anime series based on manga, Comedy anime and manga
Jonas Furrer	1805 births, 1861 deaths, Swiss politicians, Mayors, Freemasons, Calvinists
Datto, Arkansas	Towns in Arkansas
Airbus A310 MRTT	Airbus aircraft
Urbie Green	1926 births, 2018 deaths, Deaths from congestive heart failure, American jazz musicians, American trombonists, Musicians from Pennsylvania, Musicians from Alabama, People from Mobile, Alabama
Hellertown, Pennsylvania	Boroughs in Pennsylvania
Warren Plunkett	1920 births, 2018 deaths, American football running backs, Deaths from pneumonia, Disease-related deaths in Minnesota, Los Angeles Rams players, Sportspeople from Saint Paul, Minnesota
Carlos Sánchez (actor)	1935 births, 2018 deaths, Deaths from respiratory tract infection, Colombian entertainers
Mãe Stella de Oxóssi	1925 births, 2018 deaths, Deaths from stroke, Brazilian writers, Priests
Dick Van Orden	1921 births, 2018 deaths, Deaths from prostate cancer, Cancer deaths in Virginia, Military people from Texas, People from Austin, Texas
Airbus CC-150 Polaris	Airbus aircraft, Military of Canada
Leo J. Dulacki	1918 births, 2019 deaths, American generals, American centenarians, American military personnel of World War II, American military personnel of the Korean War, American military personnel of the Vietnam War, People from Omaha, Nebraska
Sun City West, Arizona	Census-designated places in Arizona
Georgy Beriev	1903 births, People from Tbilisi, Scientists from Georgia (country), Engineers, Soviet people, Recipients of the Order of Lenin
Bernice Sandler	1928 births, 2019 deaths, American activists, American feminists, American educators, Writers from New York City
Khosro Harandi	1950 births, 2019 deaths, Chess players, People from Tehran
Óscar González-Quevedo	1930 births, 2019 deaths, Spanish writers, Brazilian writers, Deaths from cardiovascular disease
Anatoly Lukyanov	1930 births, 2019 deaths, Russian politicians
Vice (2018 movie)	2010s biographical movies, 2018 comedy-drama movies, American biographical movies, American comedy-drama movies, Movies directed by Adam McKay, Movies set in the 1960s, Movies set in the 1970s, Movies set in the 1980s, Movies set in the 1990s, Movies set in the 2000s, Movies based on the September 11 attacks
Beriev Be-200	Soviet & Russian aircraft
Mikhail Gurevich	1892 births, 1976 deaths, Russian engineers, Russian Jews, Russian inventors, Soviet Jews, Recipients of the Order of Lenin
Artem Mikoyan	1905 births, 1970 deaths, Soviet people, Russian scientists, Russian engineers, Armenian people, Academics, Soviet politicians, Soviet military people, Russian inventors, Recipients of the Order of Lenin
Han Zheng	1954 births, Living people, Chinese politicians, People from Shanghai
Wang Yi	1953 births, Living people, Chinese politicians, People from Beijing
Vital Kamerhe	1959 births, Living people
Bruno Tshibala	1955 births, Living people, Prime Ministers of the Democratic Republic of the Congo
Prime Minister of the Democratic Republic of the Congo	Prime Ministers of the Democratic Republic of the Congo
President of the Democratic Republic of the Congo	Presidents of the Democratic Republic of the Congo
Félix Tshisekedi	1963 births, Living people, Presidents of the Democratic Republic of the Congo, Current national leaders, People from Kinshasa
Laurent-Désiré Kabila	1939 births, 2001 deaths, Assassinated people, Presidents of the Democratic Republic of the Congo
Pascal Lissouba	1931 births, 2020 deaths, Deaths from Alzheimer's disease, Presidents of the Republic of the Congo, Prime Ministers of the Republic of the Congo
Fulbert Youlou	1917 births, 1972 deaths, Deaths from hepatitis, Presidents of the Republic of the Congo, Prime Ministers of the Republic of the Congo
Clément Mouamba	1944 births, Living people, Current national leaders, Prime Ministers of the Republic of the Congo
Ai Yori Aoshi	Romantic comedy television series, Comedy anime and manga, 2003 video games, 2004 video games, 2005 video games, PlayStation 2 games, Windows games
Arch Rivals	Sports video games, 1989 video games, Game Gear games, Sega Genesis games, Nintendo Entertainment System games
Sergey Ivanov	1953 births, Living people, Russian politicians, Russian diplomats, Russian generals, People from Saint Petersburg
Sergey Shoygu	1955 births, Living people, Russian politicians
Laurie Dann	1957 births, 1988 deaths, American spree killers, Criminals from Illinois, Suicides by firearm in the United States, Murderers who committed suicide, Jewish American criminals, People from Winnetka, Illinois
OpenVPN	Software
Landing craft	Ship types
Ambala district	Districts of India, Haryana
Tupolev TB-1	Tupolev aircraft
Camas County, Idaho	1910s establishments in Idaho, 1917 establishments in the United States, Idaho counties
Virginia McLaurin	1909 births, Living people, American philanthropists, American centenarians, People from South Carolina, People from Washington, D.C.
Caribou County, Idaho	1919 establishments in Idaho, Idaho counties
Cassia County, Idaho	1870s establishments in Idaho Territory, 1879 establishments in the United States, Idaho counties
Thomas V. Miller Jr.	1942 births, 2021 deaths, Deaths from prostate cancer, Cancer deaths in the United States, State legislators of the United States, Politicians from Maryland, US Democratic Party politicians
Clinton, Maryland	Unincorporated communities in Maryland, Census-designated places in Maryland
Clark County, Idaho	1919 establishments in Idaho, Idaho counties
Charlie Munger	1924 births, Living people, American billionaires, American philanthropists, Businesspeople from Omaha, Nebraska
Adams County, North Dakota	North Dakota counties
Barnes County, North Dakota	North Dakota counties
Benson County, North Dakota	North Dakota counties
Grand Forks County, North Dakota	North Dakota counties
Clute, Texas	Cities in Texas
Liu He	1952 births, Living people, Chinese politicians, Chinese economists, People from Beijing
Abakan	Siberia
Abernathy, Texas	Cities in Texas
Archer City, Texas	Cities in Texas, County seats in Texas
Igor Sergeev	1938 births, 2006 deaths, Russian politicians, Soviet military people, Soviet generals, Deaths from leukemia
Igor Ivanov	1945 births, Living people, Russian politicians, Soviet politicians, Russian diplomats
Freedom Conservative Party of Alberta	Political parties in Canada, Libertarian parties, 1999 establishments in Canada
Wildrose Party	2002 establishments in Canada, 2017 disestablishments
Anthracycline	Antibiotics
Zenzizenzizenzic	Mathematical notation
Gari	Japanese food, Condiments
Bounty (chocolate bar)	Candy
Almyra, Arkansas	Towns in Arkansas
Amagon, Arkansas	Towns in Arkansas
Anthonyville, Arkansas	Towns in Arkansas
Aubrey, Arkansas	Towns in Arkansas
Lonsdale, Arkansas	Cities in Arkansas
Marmaduke, Arkansas	Cities in Arkansas
Barton, Arkansas	Unincorporated communities in Arkansas
Buffalo City, Arkansas	Unincorporated communities in Arkansas
Avoca, Arkansas	Towns in Arkansas
Garfield, Arkansas	Towns in Arkansas
Gateway, Arkansas	Towns in Arkansas
Bethel Heights, Arkansas	Cities in Arkansas
Cave Springs, Arkansas	Cities in Arkansas
Clearwater County, Idaho	1911 establishments in Idaho, Idaho counties
Lincoln County, Idaho	1890s establishments in Idaho, 1895 establishments in the United States, Idaho counties
Little Flock, Arkansas	Cities in Arkansas
Crowley's Ridge Parkway	Arkansas
McDonnell Douglas MD-90	Douglas aircraft
McDonnell Douglas DC-9	Douglas aircraft
Edith Humphrey	1978 deaths, 1875 births, British centenarians, British chemists
Hurricane Willa	Hurricanes in Mexico, History of Mexico
Tulsi Gabbard 2020 presidential campaign	2020 United States presidential campaigns
Pacers–Pistons brawl	Violence in sports, 2004 in the United States
Venezuelan presidential crisis	2010s in South America, January 2019 events, Venezuela
2019 Gabonese coup d'état attempt	2019 in Africa, Gabon, January 2019 events
Juan Guaidó	1983 births, Living people, Presidents of Venezuela, Engineers, Venezuelan politicians
Dimitris Sioufas	1944 births, 2019 deaths, Speakers of the Hellenic Parliament, Greek lawyers
Rudolf Raff	1941 births, 2019 deaths, Canadian scientists, Naturalized citizens of the United States, American biologists, Scientists from Indiana, People from Quebec
Theo Adam	1926 births, 2019 deaths, People from Dresden, German singers
Dianne Oxberry	1967 births, 2019 deaths, Deaths from pancreatic cancer, English journalists, BBC people
KLM Cityhopper	1991 establishments in Europe, Airlines of Europe, Transport in the Netherlands, Companies of the Netherlands
Shay Mitchell	1987 births, Living people, Canadian movie actors, Canadian television actors, Canadian stage actors, Canadian voice actors, Canadian models, Filipino actors, Actors from Ontario, Writers from Ontario
2019 Alberta general election	2019 elections, 2019 in Canada, Elections in Canada
Bank Norwegian	Business, Banks, Companies of Norway, 2007 establishments in Europe, 21st century establishments in Norway
María Félix	1914 births, 2002 deaths, Deaths from myocardial infarction, Mexican movie actors, Mexican television actors, Mexican stage actors, Actors from Mexico City
Julian Castro 2020 presidential campaign	2020 United States presidential campaigns
Alan Trask	1933 births, 2019 deaths, Deaths from respiratory failure, Disease-related deaths in Florida, State legislators of the United States, US Democratic Party politicians, Politicians from Florida
Banksia oblongifolia	Proteaceae, Plants of Australia, Shrubs
Passive-aggressive behaviour	Psychology, Psychiatry, Language
2016 Atlantic hurricane season	Atlantic hurricane seasons, 2016 in weather
Gala (apple)	Apples, New Zealand food
Jazz (apple)	Apples, New Zealand food
Elmore County, Idaho	1880s establishments in Idaho Territory, 1889 establishments in the United States, Idaho counties
Teton County, Idaho	1915 establishments in Idaho, Idaho counties
Chapin, Idaho	Unincorporated communities in Idaho
Arbon, Idaho	Unincorporated communities in Idaho
Zell am Ziller	Cities and towns in Tyrol (state)
Billings County, North Dakota	North Dakota counties
Brikama	Cities in the Gambia
Bassett, Arkansas	Towns in Arkansas
Franklin County, Idaho	Idaho counties, 1913 establishments in Idaho
Valley County, Idaho	Idaho counties, 1910s establishments in Idaho, 1917 establishments in the United States
Without Me (Halsey song)	2018 songs, R&B songs, Pop songs
Dniproavia	20th century establishments in Ukraine, 1996 establishments in Europe, Airlines of Europe, Ukraine
Embraer ERJ family	Embraer
Aceh	Provinces of Indonesia
Antonov An-28	Soviet & Russian aircraft
The Roots	Musical groups from Philadelphia, Pennsylvania, Hip hop
Cachar district	Districts of Assam
Suzan DelBene	United States representatives from Washington, 1962 births, Living people, US Democratic Party politicians, Microsoft people, Politicians from Alabama, People from Selma, Alabama
Pneumodesmus	Millipedes, Fossils, Scotland
The Tonight Show Starring Jimmy Fallon	2014 American television series debuts, English-language television programs
Fremont County, Idaho	1890s establishments in Idaho, 1893 establishments in the United States, Idaho counties
Gillham, Arkansas	Towns in Arkansas
Horatio, Arkansas	Cities in Arkansas
Lockesburg, Arkansas	Cities in Arkansas
Ben Lomond, Arkansas	Towns in Arkansas
Jaime Rosenthal	1936 births, 2019 deaths, Vice presidents, Honduran people, North American politicians, North American Jews, Deaths from myocardial infarction
Alan and Marilyn Bergman	Academy Award winning composers, 1925 births, 1929 births, Living people, American songwriters, American composers, Writers from New York City, Women composers
Elizabeth Edgar	1929 births, 2019 deaths, Botanists, New Zealand scientists, New Zealand writers
Batton Lash	1953 births, 2019 deaths, Deaths from brain cancer, Writers from Brooklyn, American cartoonists, American comics artists, American comics writers
Patricia Wald	1928 births, 2019 deaths, Deaths from pancreatic cancer, Cancer deaths in Washington, D.C., American judges, Politicians from Connecticut, Politicians from Washington, D.C., US Democratic Party politicians, Women judges
Phil Masinga	1969 births, 2019 deaths, Deaths from cancer, South African footballers
Antonov An-14	Soviet & Russian aircraft
Mil Mi-4	Soviet military aircraft, Helicopters
Lionel Price	1927 births, 2019 deaths, British Olympians
Wu Chengzhang	1924 births, Living people, Chinese sportspeople, Olympians
Otto Sonnenholzner	1983 births, Living people, Vice Presidents of Ecuador, People from Guayaquil
Blasco Peñaherrera Padilla	1934 births, Living people, Vice Presidents of Ecuador, People from Quito
Eduardo Peña Triviño	1936 births, Living people, Ecuadorian lawyers, Writers, Vice Presidents of Ecuador
Alberto Dahik	1953 births, Living people, Vice Presidents of Ecuador, People from Guayaquil
Slangkop Lighthouse	Coordinates on Wikidata, Lighthouses, Buildings and structures completed in the 20th century, Buildings and structures in South Africa
Roger Staubach	Presidential Medal of Freedom recipients, 1942 births, Living people, American football quarterbacks, Dallas Cowboys players, Sportspeople from Cincinnati, Ohio
Alan Page	Presidential Medal of Freedom recipients, 1945 births, Living people, American football defensive tackles, Minnesota Vikings players, American judges, American political scientists, American philanthropists, Politicians from Ohio, Politicians from Minnesota, Sportspeople from Ohio
Martian Successor Nadesico	Comedy anime and manga
Unbiunium	Chemical elements
Unbibium	Chemical elements
Dave Laing	1947 births, 2019 deaths, British journalists, British historians
Bonnie Guitar	1923 births, 2019 deaths, American singer-songwriters, American pop singers, American country singers, American pop musicians, American country musicians, Businesspeople from Seattle, Washington, Record producers, Musicians from Seattle, Washington, Singers from Seattle, Washington
Mel Stottlemyre	1941 births, 2019 deaths, Deaths from multiple myeloma, American philanthropists, New York Yankees players, Sportspeople from Missouri
Paweł Adamowicz	1965 births, 2019 deaths, Assassinated people, Mayors, Murders by blade weapons, People from Gdańsk, Polish politicians, Polish lawyers
Suriname cherry	Berries, Myrtaceae
Lenin Rajendran	1951 births, 2019 deaths, Deaths from surgical complications, Organ transplant recipients, Indian movie directors, Indian screenwriters
Paul Koslo	1944 births, 2019 deaths, Deaths from pancreatic cancer, German movie actors, German television actors, Canadian movie actors, Canadian television actors
Arvin Vohra	2020 United States presidential candidates, 1979 births, Living people, American political writers, American educators, Politicians from Maryland, Writers from Maryland, People from Silver Spring, Maryland, US Libertarian Party politicians
Tom Campbell (California politician)	1952 births, Living people, American educators, American political writers, United States representatives from California, Politicians from Chicago, Writers from Chicago, Writers from California, US Republican Party politicians, US Libertarian Party politicians
Peter Schiff	1963 births, Living people, American political commentators, American radio personalities, Businesspeople from Connecticut, Politicians from Connecticut, US Republican Party politicians, American bloggers
Sam Seder	1966 births, Living people, American political commentators, American political writers, American movie actors, American television actors, American voice actors, American television producers, American radio personalities, American progressives, Comedians from New York City, Actors from New York City, Writers from New York City, Movie producers from New York City
Steve King	1949 births, Living people, United States representatives from Iowa, US Republican Party politicians
Mil Mi-17	Soviet military aircraft, Helicopters
Lester Wunderman	1920 births, 2019 deaths, American inventors, Businesspeople from New York City
Mil Mi-24	Helicopters, Soviet & Russian aircraft
Francis J. Weber	1933 births, Living people, American Roman Catholics, American historians, Writers from California, Writers from Indianapolis, Indiana
Bill Pitman	1920 births, Living people, American movie actors, American television actors, American jazz musicians, American rock guitarists, American pop musicians, American bass guitarists, Musicians from New Jersey, Actors from New Jersey
Jerzy Młynarczyk	1931 births, Living people, Polish politicians, Polish Olympians, Mayors, People from Gdańsk
Taejong of Joseon	1367 births, 1422 deaths, Kings of Joseon
Stephen F. Austin	1793 births, 1836 deaths, Politicians from Virginia, Politicians from Austin, Texas, Deaths from pneumonia, State legislators of the United States, Disease-related deaths in Texas
Skua	Seabirds
National Historic Sites of Canada	History of Canada
Orange Line (Lahore Metro)	Transport in Pakistan
Naagin 3	Indian television series
Osman Ali Khan, Asaf Jah VII	Indian monarchs, 1886 births, 1967 deaths, Indian revolutionaries, Nizams of Hyderabad, Royalty, Emperors and empresses
Exalted Highness	Nizams of Hyderabad
Arawak people	Ethnic groups in South America, Guyanese people, Surinamese people
Gem County, Idaho	1915 establishments in Idaho, Idaho counties
Shoshone County, Idaho	1864 establishments in Idaho Territory, Idaho counties
Tollette, Arkansas	Towns in Arkansas
Mineral Springs, Arkansas	Cities in Arkansas
Bill English (actor)	1980 births, American television actors, Living people, Actors from New York, People from Rochester, New York
FC Luzern	20th century establishments in Switzerland, 1901 establishments in Europe, Swiss football clubs, Lucerne
Gavin Smith	1968 births, 2019 deaths, Deaths from myocardial infarction, Poker players, People from Guelph
Massimiliano Neri	Living people, 1977 births, Italian models, People from Naples
Beriev A-40	Soviet & Russian aircraft
Don Black (white supremacist)	American activists, People from Alabama, 1953 births, Living people
Far-right politics	Politics of the United States
Sakurai's Object	Stars
Tao Hong	1972 births, Living people, Chinese sportspeople, Chinese movie actors, Swimmers
The Prince of Tennis	2008 anime OVAs
Murder of Dru Sjodin	People from North Dakota, American murder victims, 1981 births, 2003 deaths
Memoization	Computer science
WatchOS	Apple software, Operating systems
Susannah Martin	1621 births, 1692 deaths, Executed English people, People from Buckinghamshire
Kirsten Gillibrand 2020 presidential campaign	Kirsten Gillibrand presidential campaign, 2020, 2020 United States presidential campaigns
Alfred K. Newman	1924 births, 2019 deaths, American military personnel of World War II, People from New Mexico
Eli Grba	1934 births, 2019 deaths, Deaths from pancreatic cancer, New York Yankees players, Los Angeles Angels of Anaheim players, Sportspeople from Chicago
Lawrence Rocks (chemist)	Living people, 1933 births, American chemists, Writers from New York City
Évry-Courcouronnes	Communes in Essonne, Departmental capitals in France, 2019 establishments in France
Julio Vallejo Ruiloba	Spanish scientists, Psychiatrists, 1945 births, 2019 deaths, Deaths from liver cancer, Writers from Barcelona
Wintzenheim	Communes in Haut-Rhin
Soultz-Haut-Rhin	Communes in Haut-Rhin
Miodrag Radovanović	1929 births, 2019 deaths, Deaths from Alzheimer's disease, Serbian actors
Yu Min	1926 births, 2019 deaths, Chinese scientists, Physicists
Nairobi DusitD2 complex attack	2019 in Africa, 2019 mass shootings, 2010s explosions in Africa, 2010s murders in Africa, Al-Shabaab (militant group), Attacks on buildings and structures in 2019, Attacks on hotels, Building bombings in Africa, Islamic terrorist incidents in 2019, Islamic terrorist incidents in Africa, January 2019 events, Mass murder in 2019, Mass murder in Africa, Mass shootings in Africa, Nairobi, Suicide bombings in 2019, Suicide bombings in Africa, Terrorist incidents in Africa in the 2010s
Susan Oliver	American television actors, American stage actors, American movie actors, American aviators, American artists, American television directors, Actors from New York City, Deaths from colorectal cancer, 1932 births, 1990 deaths
Idaho County, Idaho	1864 establishments in Idaho Territory, Idaho counties
McCaskill, Arkansas	Towns in Arkansas
Paul Flynn (politician)	1935 births, 2019 deaths, British anti–Iraq War activists, Labour MPs (UK), People from Cardiff, Republicans, UK MPs 1987–1992, UK MPs 1992–1997, UK MPs 1997–2001, UK MPs 2001–2005, UK MPs 2005–2010, UK MPs 2010–2015, UK MPs 2015–2017, UK MPs 2017–2019, Welsh politicians
Jefferson County, Idaho	1913 establishments in Idaho, Idaho counties
Ira Glass	1959 births, Living people, American atheists, American movie producers, American Jews, American radio personalities, American television presenters, Writers from Baltimore, Maryland
Bottineau County, North Dakota	North Dakota counties
Bergman, Arkansas	Towns in Arkansas
T Cephei	Variable stars, Red giants
NGC 3021	Spiral galaxies
Ilyushin Il-78	Soviet & Russian aircraft
Mahbub Ali Khan, Asaf Jah VI	Nizams of Hyderabad, Indian monarchs, 1866 births, 1911 deaths
Peng Yuchang	1994 births, Living people, Chinese movie actors, Chinese television actors, Chinese voice actors, Chinese singers
Chris Wilson (Australian musician)	1956 births, 2019 deaths, Deaths from pancreatic cancer, Australian singer-songwriters, Australian guitarists, Musicians from Melbourne, Writers from Melbourne
John C. Bogle	1929 births, 2019 deaths, Deaths from esophageal cancer, Cancer deaths in Pennsylvania, American philanthropists, Writers from New Jersey, Writers from Pennsylvania, Businesspeople from New Jersey, Businesspeople from Pennsylvania, People from Montclair, New Jersey, People from Bryn Mawr, Pennsylvania
Bhangra (dance)	Dances, Punjab
Arturo Rojas de la Cámara	1930 births, 2019 deaths, Cartoonists, People from the Community of Valencia
Pass the Dutchie	1982 songs
Andrew Yang 2020 presidential campaign	2020 United States presidential campaigns
Arun Jaitley	1952 births, 2019 deaths, Deaths from diabetes, Indian politicians, Bharatiya Janata Party politicians, Organ transplant recipients, Deaths from soft-tissue sarcoma, Indian lawyers, People from New Delhi
Kate Warner	1948 births, Living people, People with cancer, Governors of Tasmania
Mirjam Pressler	1940 births, 2019 deaths, German novelists, Translators
Vicente Álvarez Areces	1943 births, 2019 deaths, Spanish politicians, Mayors
Mary Oliver	Pulitzer Prize winners, 1935 births, 2018 deaths, Deaths from lymphoma, Cancer deaths in Florida, American poets, American novelists, Cancer survivors, LGBT poets, LGBT novelists, Lesbians, LGBT people from Ohio, Writers from Ohio
Kootenai County, Idaho	1864 establishments in Idaho Territory, Idaho counties
Rockford Bay, Idaho	Census-designated places in Idaho
Beedeville, Arkansas	Towns in Arkansas
Jacksonport, Arkansas	Towns in Arkansas
Payette County, Idaho	1910s establishments in Idaho, 1917 establishments in the United States, Idaho counties
Rondo, Arkansas	Towns in Arkansas
Albireo	Binary stars
Peng Kang Hill MRT station	Mass Rapid Transit (Singapore) stations
Bhada (Saharsa)	Villages in Bihar
Urdu Nazam	Poetry, Urdu language
Heroes of Might & Magic	Media franchises, Role-playing video games, Video game series
Heroes of Might and Magic V	2006 video games, MacOS games, Windows games, Ubisoft games
Recording Industry Association of Japan	1942 establishments,  Japanese music, Music industry, Tokyo
Angels in the Court	2000 anime OVAs, 2001 anime OVAs
Kallakurichi district	Districts of Tamil Nadu
Spingarn Medal	1915 establishments in the United States, Awards
Ty Dolla Sign	1982 births, Living people, Atlantic Records artists
Latah County, Idaho	1880s establishments in Idaho Territory, 1888 establishments in the United States, Idaho counties
Sunrise Communications AG	Telephone companies, Companies of Switzerland
Lewis County, Idaho	1911 establishments in Idaho, Idaho counties
College, Alaska	Census-designated places in Alaska
Buffalo Soapstone, Alaska	Census-designated places in Alaska
Jennette, Arkansas	Towns in Arkansas
2018 United States Senate election in Tennessee	2018 United States Senate elections, November 2018 events, 2018 elections
Franklin, Tennessee	Cities in Tennessee, County seats in Tennessee
7 Rings	Ariana Grande songs, Trap songs, Pop songs, Hip hop songs, R&B songs, 2019 songs, Songs with feminist themes
Chinese Canadians	Overseas Chinese, Ethnic groups in Canada, Chinese people
Zhou Xianxin	1982 births, Chinese movie actors, Chinese television actors, Living people
Ilyushin Il-76	Soviet & Russian aircraft
Cygnus OB2	Star clusters
Province of Massachusetts Bay	History of the United States
Dutch rabbit	Pets, Mammals of Europe, Lagomorphs
Lop rabbit	Lagomorphs
Madison County, Idaho	1913 establishments in Idaho, Idaho counties
Minidoka County, Idaho	1913 establishments in Idaho, Idaho counties
Nez Perce County, Idaho	1864 establishments in Idaho Territory, Idaho counties
Oneida County, Idaho	1864 establishments in Idaho Territory, Idaho counties
Bowman County, North Dakota	North Dakota counties
Bellefonte, Arkansas	Towns in Arkansas
Coat of arms of Montenegro	National coats of arms, Montenegro
Great Seal of California	United States state seals, California
Jin Jing	1981 births, Chinese sportspeople, Fencers, Olympians, People with disabilities
Plastic waste	Polymers, Waste
Butterfly net	Tools, Collecting, Butterflies
X Carinae	Variable stars
William A. Thomas	1948 births, 2019 deaths, American football linebackers, American football coaches, People of Tennessee State University
Coat of arms of Greece	National coats of arms, Greece
Urethral sponge	Urinary system
Coat of arms of Bulgaria	National coats of arms, Bulgaria
Coat of arms of Portugal	National coats of arms, Portugal
Coat of arms of Finland	National coats of arms, Finland
Burke County, North Dakota	North Dakota counties
Cavalier County, North Dakota	North Dakota counties
Ilyushin Il-114	Soviet & Russian aircraft
Ilyushin Il-96	Soviet & Russian aircraft
Yuxiang	Food ingredients, Chinese food
Douglas M. Costle	1939 births, 2019 deaths, Deaths from stroke, Cardiovascular disease deaths in Virginia, Administrators of the United States Environmental Protection Agency, American lawyers, American environmentalists, Politicians from California, US Democratic Party politicians
Reggie Young	1936 births, 2019 deaths, American country guitarists, American rock guitarists, American singer-songwriters, American country singers, American rock singers, Singers from Missouri, Singers from Tennessee, Writers from Missouri, Writers from Tennessee
Caruthersville, Missouri	Cities in Missouri, County seats in Missouri
Japanese squirrel	Squirrels, Animals of Japan, Mammals of Asia
John Coughlin	1985 births, 2019 deaths, People who committed suicide, American figure skaters, Sportspeople from Kansas City, Missouri
Andrew G. Vajna	1944 births, 2019 deaths, Naturalized citizens of the United States, American movie producers, People from Budapest
Cees Haast	1938 births, 2019 deaths, Deaths from lung cancer, Dutch cyclists, Sportspeople from North Brabant, Tour de France cyclists
Kamala Harris 2020 presidential campaign	2020 United States presidential campaigns
Aloe vera	Asparagales
Ivan Vutsov	1939 births, 2019 deaths, Bulgarian footballers, Bulgarian football managers
Pedro Manfredini	1935 births, 2019 deaths, Argentine footballers
Tony Mendez	1940 births, 2019 deaths, Deaths from Parkinson's disease, American military people, Spies, People from Nevada
Shalom Cohen	1931 births, Living people, Israeli rabbis, People from Jerusalem
Dick Tomey	1938 births, 2019 deaths, American football players, Deaths from lung cancer, People from Bloomington, Indiana, Sportspeople from Indiana
Coat of arms of Guinea	National coats of arms, Guinea
Stark County, North Dakota	North Dakota counties
Negroid	Anthropology, Race
Fear of needles	Phobias, Health problems
Thane	Cities in India, Settlements in Maharashtra
Jean Chatillon	1937 births, 2019 deaths, Deaths from pneumonia, Canadian composers, Canadian educators, Writers from Quebec
Mario Bertoncini	1932 births, 2019 deaths, Deaths from liver cancer, Italian composers, Italian pianists, Italian educators, Writers from Rome, Musicians from Rome
Ted McKenna	1950 births, 2019 deaths, Deaths from cerebral hemorrhage, British rock drummers, Scottish musicians
Red Sullivan	1929 births, 2019 deaths, Deaths from Alzheimer's disease, Canadian ice hockey players, Boston Bruins players, Chicago Blackhawks players, New York Rangers players, Sportspeople from Ontario, American Hockey League players, Ice hockey centres
Henry Sy	1924 births, 2019 deaths, Deaths from myocardial infarction, Chinese businesspeople, Filipino businesspeople, Filipino philanthropists, Chinese philanthropists
St. Uriel's Episcopal Church	Anglican churches, Churches in the United States, Buildings and structures in New Jersey
Mount Katahdin	Mountains of the United States, Geography of Maine
Maxine Brown (country singer)	1931 births, 2019 deaths, Deaths from cardiovascular disease, Deaths from kidney disease, American country singers, Singers from Louisiana
Maxine Brown (soul singer)	1939 births, Living people, American singer-songwriters, American soul singers, American R&B singers, Singers from South Carolina, Writers from South Carolina
Kingstree, South Carolina	Cities in South Carolina, County seats in South Carolina
Berwick, Nova Scotia	Towns in Nova Scotia
Clark's Harbour	Towns in Nova Scotia
Digby, Nova Scotia	Towns in Nova Scotia
Hanna Sheehy Skeffington	1877 births, 1946 deaths, Irish politicians, Activists, Irish writers, Editors, Teachers, People from County Cork
Ali Bongo	1929 births, 2009 deaths, British magicians, British comedians, British artists, Deaths from pneumonia, Infectious disease deaths in England
The Magic Circle	1905 establishments in the United Kingdom, Organisations based in London
Elizabeth Warren 2020 presidential campaign	2020 United States presidential campaigns
Debbie McGee	1958 births, English radio personalities, English television presenters, People from London, Royal Borough of Kingston upon Thames, Living people
Know-Nothing Party	Political parties in the United States
BBC Radio Berkshire	BBC radio, Berkshire, 1992 establishments in the United Kingdom
Business Wire	Companies based in San Francisco, 1960s establishments in California, 1961 establishments in the United States
Ypsilanti, Michigan	Cities in Michigan
Emiliano Sala	1990 births, 2019 deaths, Argentine footballers, Aviation deaths
Ace (card)	Card games
James Haven	1973 births, Actors from Los Angeles, California, Movie producers from Los Angeles, California, Living people
Pete Buttigieg 2020 presidential campaign	2020 United States presidential campaigns
Swiss franc	Currency of Europe, Switzerland, Liechtenstein
Ayşen Gruda	1944 births, 2019 deaths, Actors from Istanbul, Comedians, Turkish movie actors, Turkish television actors, Turkish stage actors, Deaths from pancreatic cancer
Braeburn	Apples, New Zealand food
Dickey County, North Dakota	North Dakota counties
Stutsman County, North Dakota	North Dakota counties
Morrison Bluff, Arkansas	Towns in Arkansas
Volcano (1997 movie)	1997 movies, 1990s disaster movies, 20th Century Fox movies, American disaster movies, English-language movies
Maggie Philbin	1955 births, English television presenters, English radio personalities, Living people, People from Manchester
Tomorrow's World	BBC Television programmes, 1965 television series debuts, 1960s British television series, 1970s British television series, 1980s British television series, 1990s British television series, 2000s British television series, 2003 television series endings
Rizal state	Geography of the Philippines
Shirley Deane	1913 births, 1983 deaths, American movie actors
Google Drive	Google, Internet, Technology, File sharing
Ranjan Gogoi	1954 births, Living people, People from Assam, Chief Justices of India
Alexandre Koyré	1892 births, 1964 deaths, Russian Jews, French Jews, Russian philosophers, French philosophers, Russian writers, French writers, Russian historians, French historians
Divide County, North Dakota	North Dakota counties
Slope County, North Dakota	North Dakota counties
Dunn County, North Dakota	North Dakota counties
Aixam	1980s establishments in France, 1983 establishments in Europe, Automobile companies of France, Auvergne-Rhône-Alpes
Eddy County, North Dakota	North Dakota counties
Freienbach	Municipalities of Schwyz, Cities in Switzerland
Untereggen	Municipalities of St. Gallen
Livonian language	Uralic languages, Languages of Europe
River Leen	Rivers of England, Nottinghamshire
Philippe Méaille	1973 births, French philanthropists, Living people
Château de Montsoreau-Museum of Contemporary Art	Palaces in France, Castles in France, Art museums in France, World Heritage Sites in France, 2015 establishments in France
Art & Language	British artists, Conceptual artists
Corinth, Mississippi	Cities in Mississippi, County seats in Mississippi
Admission to the Union	History of the United States, United States Constitution
Polity	Government
Coat of arms of Bosnia and Herzegovina	National coats of arms, Bosnia and Herzegovina
Emblem of the United Arab Emirates	National coats of arms, United Arab Emirates
Emblem of Bhutan	National coats of arms, Bhutan
Coat of arms of Somalia	National coats of arms, Somalia
Flag of American Samoa	National flags, American Samoa
Vigilio Mario Olmi	1927 births, 2019 deaths, Italian Roman Catholics, Roman Catholic bishops, People from Lombardy
Emmons County, North Dakota	North Dakota counties
Kidder County, North Dakota	North Dakota counties
Yorkshire Coast Radio	Radio stations in the United Kingdom
Justin Theroux	1971 births, Living people, American movie actors, American television actors
Mulholland Drive (movie)	2001 drama movies, 2000s LGBT movies, 2000s mystery movies, American drama movies, American LGBT movies, American mystery movies, LGBT drama movies, Movies set in Los Angeles, California, Mystery drama movies, Movies directed by David Lynch, American independent movies, English-language movies
California State Legislature	State legislatures of the United States, Government of California
California State Senate	Government of California, State upper houses in the United States
Foster County, North Dakota	North Dakota counties
California State Assembly	Government of California, State lower houses in the United States
Golden Valley County, North Dakota	1912 establishments in the United States, 20th-century establishments in North Dakota, North Dakota counties
McHenry County, North Dakota	1880s establishments in North Dakota, 1884 establishments in the United States, North Dakota counties
Grant County, North Dakota	North Dakota counties
Griggs County, North Dakota	North Dakota counties
Hettinger County, North Dakota	North Dakota counties
Hettinger, North Dakota	Cities in North Dakota, County seats in North Dakota
Golden Valley, North Dakota	20th-century establishments in North Dakota, 1913 establishments in the United States, Cities in North Dakota
Mercer County, North Dakota	North Dakota counties
Logan County, North Dakota	North Dakota counties
LaMoure County, North Dakota	North Dakota counties
Oil Trough, Arkansas	Towns in Arkansas
Peter Burmeister	1941 births, 2019 deaths, German mathematicians, People from Berlin
John Rose	1965 births, United States representatives from Tennessee, US Republican Party politicians, Businesspeople from Tennessee, Living people
Test match (cricket)	Cricket
Sleep mode	Technology
Exploration Upper Stage	Rockets
Nawab of Bengal	British India, Former countries in Asia, History of Bangladesh, History of India, Indian monarchs, Mughal Empire
Lessemsauridae	Sauropods, Triassic dinosaurs, Jurassic dinosaurs, Dinosaurs of South America, Dinosaurs of Africa
Cookeville, Tennessee	Cities in Tennessee, County seats in Tennessee
Death squad	Military
Cot-caught merger	Linguistics, English language
Christopher Sholes	American inventors, 1819 births, 1890 deaths, Milwaukee, Wisconsin
The Upside	2017 movies, 2019 movies, American comedy-drama movies
Kjell Bäckman	1934 births, 2019 deaths, Swedish Olympians
Boo (dog)	2006 births, 2019 deaths, Deaths from heart failure, Individual dogs, Internet celebrities
Lamia Al-Gailani Werr	1938 births, 2019 deaths, Deaths from myocardial infarction, Iraqi people, Archaeologists
Evloghios (Hessler)	1935 births, 2019 deaths, Deaths from stroke, People from Milan
Raghbir Singh Bhola	1927 births, 2019 deaths, Deaths from multiple organ failure, Indian military people, Olympic gold medalists, Olympic silver medalists
Rosa González Román	1942 births, 2019 deaths, Deaths from cervical cancer, Chilean politicians, Chilean writers, Chilean journalists
Project Syndicate	Publishers, Websites, Non-profit organizations
Ezra Klein	1984 births, Living people, American agnostics, American political commentators, American political writers, Jewish American writers, Journalists from California, People from Irvine, California, Writers from California, Bloggers, American bloggers
Gita Gopinath	1971 births, Living people, Harvard University, Princeton University alumni
Laura Tyson	1947 births, Living people, Massachusetts Institute of Technology alumni, United States Council of Economic Advisers, Princeton University alumni
Ernest Angley	1921 births, 2021 deaths, American Christians, American television presenters, Writers from Ohio, Writers from North Carolina
Glendale Heights, Illinois	Villages in Illinois, Suburbs of Chicago, Illinois, Settlements in DuPage County, Illinois
Ladue, Missouri	Cities in Missouri
Koos Andriessen	1928 births, 2019 deaths, Christian Democratic Appeal politicians, Christian Historical Union politicians, Deaths from Parkinson's disease, Dutch Calvinists, Government ministers of the Netherlands, Politicians from Rotterdam
Andrew Fairlie	1963 births, 2019 deaths, Deaths from brain cancer, British chefs, Scottish people
Oliver Mtukudzi	1952 births, 2019 deaths, Deaths from diabetes, Guitarists, Zimbabwean businesspeople, African philanthropists, Activists
Erik Olin Wright	1947 births, 2019 deaths, Deaths from acute myeloid leukemia, American sociologists, American educators, American communists, Writers from California, Writers from Wisconsin
Charles Vandenhove	1927 births, 2019 deaths, Belgian businesspeople, Architects
Elio Berhanyer	1929 births, 2019 deaths, Spanish fashion designers
Antonio Marchesano	1930 births, 2019 deaths, Deaths from lung cancer, Uruguayan politicians, Uruguayan lawyers
Fernando Sebastián Aguilar	1929 births, 2019 deaths, Deaths from stroke, Cardinals of the Roman Catholic Church, Archbishops, Spanish people
Dario Hunter	1983 births, Living people, 2020 United States presidential candidates, African American lawyers, African American politicians, American Muslims, American rabbis, Converts to Judaism, Former Muslims, Gay Jews, Green Party of the United States politicians, Jewish American academics, Jewish American politicians, Jewish lawyers, LGBT African Americans, LGBT lawyers, LGBT people from New Jersey, LGBT people from Ohio, LGBT politicians, People from Livingston, New Jersey, People from Youngstown, Ohio, Politicians from New Jersey, Politicians from Ohio, Princeton University alumni
Bruce Corbitt	1962 births, 2019 deaths, Deaths from esophageal cancer, American heavy metal singers, Singers from Dallas, Texas
Meshulam Riklis	1923 births, 2019 deaths, Naturalized citizens of Israel, Businesspeople from Minneapolis, Minnesota, People from Istanbul, People from Tel Aviv
Krishna Sobti	1925 births, 2019 deaths, Deaths from pneumonia, Indian writers
Dale Barnstable	1925 births, 2019 deaths, American basketball players, Sportspeople from Illinois
Antioch, Illinois	Villages in Illinois, Suburbs of Chicago, Illinois
Sirdavidia	Annonaceae
Roy Apps	British writers, 1951 births, Living people
Bradley Walsh	1960 births, Living people, English television actors, English comedians, English television presenters, English footballers, Actors from Hertfordshire
Jamie Bamber	1973 births, English movie actors, English radio actors, English television actors, People from Hammersmith, Actors from London, Living people
January 0	Days
Sanford Rosenthal	1897 births, 1989 deaths, People from Albany, Georgia, Scientists from Georgia (U.S. state)
Iran Air Flight 291	Coordinates on Wikidata, Aviation disasters in the 1980s, 1980s in Iran, 1980
Cyrus Flint Stimson, Jr.	1901 births, 1968 deaths, American artists
Wadati–Benioff zone	Plate tectonics, Earthquakes
Dick Dolman	1935 births, 2019 deaths, Former members of the House of Representatives of the Netherlands, Labour Party (Netherlands) politicians, Politicians from Gelderland, Speakers of the House of Representatives of the Netherlands
Jean Guillou	1930 births, 2019 deaths, French composers, French pianists, Musicians from Paris, Writers from Paris
Henrik Jørgensen	1961 births, 2019 deaths, Deaths from myocardial infarction, Danish sportspeople, Olympians, People from Copenhagen
Missing person	Missing people
Gerry Plamondon	1924 births, 2019 deaths, Canadian ice hockey players, Montreal Canadiens players, Sportspeople from Quebec, American Hockey League players
Giuseppe Zamberletti	1933 births, 2019 deaths, Deaths from Alzheimer's disease, Italian politicians
Henry Chapier	1933 births, 2019 deaths, French journalists, French television personalities, French movie critics, French movie directors, People from Bucharest
Nina Fyodorova	1947 births, 2019 deaths, Russian sportspeople, Olympic gold medalists, Olympic silver medalists, Olympic bronze medalists
Peter Magowan	1942 births, 2019 deaths, Cancer deaths in California, Businesspeople from New York City, Sportspeople from New York City
Birds of Prey (2020 movie)	2020 movies, 2020s superhero movies, Warner Bros. movies, DC Extended Universe movies, American action movies, American superhero movies
Huntress (Helena Bertinelli)	Fictional characters introduced in 1989, DC Comics superheroes
Renee Montoya	Fictional characters introduced in 1992, DC Comics characters, Fictional lesbians
Jurnee Smollett-Bell	1986 births, Living people, American movie actors, American television actors, American voice actors, American child actors, Actors from New York City
Jurrie Koolhof	1960 births, 2019 deaths, Dutch football managers, Dutch footballers, Sportspeople from Groningen (province)
Mourad Medelci	1943 births, 2019 deaths, Deaths from cerebral hemorrhage, Algerian politicians
Pepe Smith	1947 births, 2019 deaths, Deaths from stroke, Filipino singers, Filipino writers, Songwriters, Drummers, Guitarists
Marianne Williamson 2020 presidential campaign	2020 United States presidential campaigns
Hà Tiên	Cities in Vietnam
James Wood (governor)	1741 births, 1813 deaths, Governors of Virginia, Military people from Virginia, Federalist party (US) politicians, 18th-century American politicians
Cassie Ventura	Singers from Connecticut, Models from Connecticut, Actors from Connecticut, 1986 births, Living people
Saad Ibn Aqeel Shrine	Buildings and structures in Iran
McIntosh County, North Dakota	North Dakota counties
McKenzie County, North Dakota	North Dakota counties
McLean County, North Dakota	North Dakota counties
Morton County, North Dakota	North Dakota counties
Baird, Texas	Cities in Texas, County seats in Texas
Ballinger, Texas	Cities in Texas, County seats in Texas
Murray Cook	1960 births, Living people, Singers from New South Wales, Australian songwriters, Australian guitarists, Australian rock musicians, Rock guitarists, Order of Australia
Jeff Fatt	1953 births, Living people, Australian television actors, Actors from New South Wales, Singers from New South Wales, Australian pianists, Organists, Order of Australia
Byker Grove	1989 television series debuts, 2006 television series endings, 1980s television series, 1990s children's television series, 2000s children's television series, BBC Television programmes, LGBT television programs, British children's television series, British teen television series, British teen drama television series, English-language television programs
Rain and snow mixed	Precipitation
List of political ideologies	Politics, Politics-related lists
Indigestion	Digestive system
REWE Group	1920s establishments in Germany, 1927 establishments in Europe, Companies of Germany, Shops, Cologne
Penny (supermarket)	Supermarkets of Germany, Cologne
Norma (supermarket)	1960s establishments in Germany, 1964 establishments in Europe, Supermarkets of Germany, Nuremberg
Mountrail County, North Dakota	North Dakota counties
Aspermont, Texas	Towns in Texas, County seats in Texas
Bandera, Texas	Cities in Texas, County seats in Texas
Bastrop, Texas	Cities in Texas, County seats in Texas
Selective Service System	Law
Wolfgang Thonke	1938 births, 2019 deaths, Deaths from stomach cancer, German journalists, German generals, German scientists
Strausberg	Towns in Brandenburg
Rosemary Bryant Mariner	1953 births, 2019 deaths, Deaths from ovarian cancer, American military people, American aviators
Norman Orentreich	1922 births, 2019 deaths, Deaths from congestive heart failure, Cardiovascular disease deaths in New York City, Scientists from New York City
Superpermutation	Pages with unreviewed translations, Mathematics
Vrelo (Babušnica)	Villages in Europe, Settlements in Serbia
Sheniz Janmohamed	Living people, Canadian poets, Year of birth missing (living people)
Shane Dawson	1988 births, Living people, American movie actors, American television actors, LGBT actors, LGBT comedians, LGBT writers, Bisexual people, Internet celebrities, Movie directors from Los Angeles County, California, Actors from Long Beach, California, Comedians from Los Angeles County, California, Writers from Los Angeles County, California, LGBT people from California
Jeffree Star	1985 births, Living people, Internet celebrities, American artists, Gay men, LGBT artists, LGBT businesspeople, LGBT people from California, Businesspeople from California, Singer-songwriters from California, American bloggers
Mohammad Nabi Habibi	1945 births, 2019 deaths, Deaths from myocardial infarction, Mayors, Iranian politicians
Charles J. Hynes	1935 births, 2019 deaths, Deaths from surgical complications, Deaths from leukemia, Cancer deaths in Florida, American lawyers, Politicians from New York City, US Democratic Party politicians
Per Jorsett	1920 births, 2019 deaths, Deaths from cardiopulmonary arrest, Norwegian historians, Norwegian journalists, Sport shooters, Writers from Oslo
James Ingram	Grammy Award winners, 1952 births, 2019 deaths, Deaths from brain cancer, Cancer deaths in Los Angeles, American R&B singers, American pop singers, American soul singers, American R&B musicians, American pop musicians, American soul musicians, American keyboard players, American movie actors, American television actors, American voice actors, Record producers, Singer-songwriters from California, Actors from Los Angeles, California, Singers from Los Angeles, California, Writers from Los Angeles, California, Businesspeople from Los Angeles, California, Actors from Akron, Ohio, Singers from Ohio, Writers from Akron, Ohio, Businesspeople from Ohio
Ladysmith, Wisconsin	Cities in Wisconsin, County seats in Wisconsin
Mount Asgard	Mountains of Canada, Nunavut
Fate/stay night	2004 video games, 2006 anime television series, 2006 manga, 2011 anime OVAs, 2014 anime television series, PlayStation 2 games, PlayStation Vita games, Video games developed in Japan, Visual novels, Windows games
Real (hypermarket)	1990s establishments in Germany, 1992 establishments in Europe, Supermarkets of Germany, North Rhine-Westphalia
Media Markt	Companies of Germany, Shops
Fairfield, Texas	Cities in Texas, County seats in Texas
Bay City, Texas	Cities in Texas, County seats in Texas
Memphis, Texas	Cities in Texas, County seats in Texas
Nelson County, North Dakota	1880s establishments in North Dakota, 1883 establishments in the United States, North Dakota counties
Deaths in February 2019	2019 deaths, February 2019 events
Maidan Shar attack	2019 mass shootings, 2019 murders in Asia, 2010s explosions in Asia, 2010s in Afghanistan, Attacks on buildings and structures in 2019, Attacks on buildings and structures in Asia, Attacks on military installations, Car and truck bombings in Asia, Crime in Afghanistan, Explosions in 2019, Explosions in Afghanistan, Islamic terrorist incidents in 2019, Islamic terrorist incidents in Asia, January 2019 events, Mass murder in 2019, Mass murder in Asia, Mass shootings in Asia, Suicide car and truck bombings, Taliban, Terrorist incidents in Asia in 2019
2019 South Sulawesi floods	2019 disasters in Asia, 2010s floods, 2010s in Indonesia, Disasters in Indonesia, Floods in Asia, History of Sulawesi, January 2019 events
Brumadinho dam disaster	January 2019 events, 2010s in Brazil, 2019 disasters, Dams, Minas Gerais
Manny Pacquiao	1978 births, Living people, Filipino sportspeople, Filipino politicians, Boxers
2019 Jolo Cathedral bombings	2019 murders in Asia, 2010s explosions in Asia, 2010s in the Philippines, Attacks on churches, Attacks on buildings and structures in 2019, Attacks on religious buildings and structures in Asia, Building bombings in Asia, Explosions in 2019, Islamic State, Islamic terrorist incidents in 2019, Islamic terrorist incidents in Asia, January 2019 events, Mass murder in 2019, Mass murder in Asia, Terrorist incidents in Asia in 2019
January–February 2019 North American cold wave	January 2019 events, 2019 in Canada, 2010s in Michigan, 2010s in New York (state), 2010s in Illinois, 21st century in Wisconsin, Minnesota, North Dakota, Indiana, 2010s in Chicago, 2019 in the United States, February 2019 events, 2019 in weather
Jean-Marc Fontaine	1944 births, 2019 deaths, Deaths from thyroid cancer, Cancer deaths in France, French mathematicians
Andy Hebenton	1929 births, 2019 deaths, American Hockey League players, Boston Bruins players, Deaths from bladder cancer, Canadian ice hockey left wingers, Ice hockey people from Manitoba, Lady Byng Memorial Trophy winners, New York Rangers players, Sportspeople from Winnipeg, Central Professional Hockey League players
Stewart Adams	1923 births, 2019 deaths, Deaths from pneumonia, British chemists, British inventors, People from Nottingham
Kálmán Ihász	1941 births, 2019 deaths, Deaths from cerebral infarction, Olympians, Sportspeople from Budapest, Hungarian footballers
Pierre Nanterme	1959 births, 2019 deaths, Deaths from colorectal cancer, French businesspeople
Georges Sarre	1935 births, 2019 deaths, Deaths from coronary artery disease, French politicians, Former MEPs, MEPs for France
Don Laughlin	1931 births, Living people, American philanthropists, Businesspeople from Minnesota, Businesspeople from Las Vegas, Nevada
Robert Ettinger	1918 births, 2011 deaths, American atheists, American military personnel of World War II, Cryonically preserved people, Scientists from New Jersey, Scientists from Michigan
FM-2030	1930 births, 2000 deaths, Cryonically preserved people, Deaths from pancreatic cancer, Cancer deaths in New York City, Belgian writers, Iranian writers, American philosophers, Naturalized citizens of the United States, Writers from New York, People from Brussels, 20th century philosophers, American atheists, American novelists, Vegetarians
Dick Clair	Emmy Award winners, 1931 births, 1988 deaths, Deaths from AIDS, Infectious disease deaths in California, Cryonically preserved people, Gay men, LGBT writers, LGBT actors, American television producers, American television writers, American movie actors, American television actors, LGBT people from California, Actors from San Francisco, Writers from San Francisco
Gendarmerie	Law enforcement agencies, Police
Argentine food	Argentine food
Kaufland	1980s establishments in Germany, 1984 establishments in Europe, Supermarkets of Germany, Neckarsulm
Paralympic agitos	Paralympic Games, Symbols
Surjoux-Lhopital	2019 establishments in France, Communes in Ain
Valserhône	2019 establishments in France, Communes in Ain
Bresse Vallons	2019 establishments in France, Communes in Ain
Arvière-en-Valromey	2019 establishments in France, Communes in Ain
Valromey-sur-Séran	2019 establishments in France, Communes in Ain
Plateau d'Hauteville	2019 establishments in France, Communes in Ain
Pierce County, North Dakota	North Dakota counties
Fitawrari Gebeyehu	1840s births, 1896 deaths, Ethiopian people, African military people
U.S. territory	Government of the United States, Territories of the United States
The Housemaid (movie)	2010s thriller movies, 2010 drama movies, South Korean movies
Cory Booker 2020 presidential campaign	Cory Booker presidential campaign, 2020, 2020 United States presidential campaigns
Bernie Sanders 2020 presidential campaign	Bernie Sanders, 2020 United States presidential campaigns
Canoe.com	Companies of Canada, Websites
Oliver County, North Dakota	North Dakota counties
Pembina County, North Dakota	North Dakota counties
Ramsey County, North Dakota	North Dakota counties
Fist	Body parts
Williams County, North Dakota	North Dakota counties
Ward County, North Dakota	North Dakota counties
Soultzmatt	Communes in Haut-Rhin
Otto Schubiger	1925 births, 2019 deaths, Swiss ice hockey players, Swiss Olympic medalists, Olympic bronze medalists, Ice hockey centres
Prilly	Municipalities of Vaud, Cities in Switzerland
Rachel Pollack	1945 births, Living people, American science fiction writers, American comics writers, American short story writers, American novelists
Parliament (Eswatini)	Politics of Africa, National legislatures
Unbiquadium	Chemical elements, Periodic table
Paul Sereno	1957 births, American paleontologists, Living people, Scientists from Chicago, People from Aurora, Illinois
Nebulasaurus	Dinosaurs of Asia, Jurassic dinosaurs, Sauropods
Dze with caron	Cyrillic letters
Super Bowl LIII	Super Bowl, 2019 in sports, New England Patriots, Los Angeles Rams, 2019 in the United States, 2010s in Georgia (U.S. state), February 2019 events
New Aspiration Party	20th century establishments in Thailand, 1990 establishments in Asia, Political parties in Asia, Thailand
Kangding Qingge	Sichuan, Chinese music
İlkay Gündoğan	1990 births, German footballers, Sportspeople from North Rhine-Westphalia, People from Gelsenkirchen, Living people
Super Bowl LII	Super Bowl, 2018 in sports, February 2018 events, 2018 in the United States, New England Patriots, Philadelphia Eagles
Yvonne Clark	1929 births, 2019 deaths, Engineers from Texas, American educators, Scientists from Houston, Texas, Scientists from Kentucky, People of Tennessee State University
Alf Lüdtke	1943 births, 2019 deaths, Deaths from stroke, German educators, German historians, People from Dresden
Ron Joyce	1930 births, 2019 deaths, Canadian businesspeople, Canadian philanthropists, People from Nova Scotia, People from Ontario
Johnny Lion	1941 births, 2019 deaths, Deaths from Alzheimer's disease, Deaths from lung cancer, Dutch journalists, Dutch movie actors, Dutch singers, Writers from The Hague
Lori Wilson	1937 births, 2019 deaths, Deaths from dementia, Disease-related deaths in Florida, American lawyers, State legislators of the United States, Politicians from North Carolina, Politicians from Florida, Independent politicians in the United States
Waynesville, North Carolina	Towns in North Carolina, County seats in North Carolina
Jeremy Hardy	1961 births, 2019 deaths, Deaths from cancer, British movie actors, British television actors, British comedians, Political activists, British radio personalities, British television personalities, Actors from Hampshire
Ursula Karusseit	1939 births, 2019 deaths, Cardiovascular disease deaths in Germany, German movie actors, German television actors
Clive Swift	1936 births, 2019 deaths, Deaths from respiratory failure, Disease-related deaths in London, English movie actors, English television actors, English stage actors, English songwriters, Actors from Liverpool, Writers from Liverpool
Walter James Edyvean	1938 births, 2019 deaths, American Roman Catholics, People from Boston, Massachusetts
Grandpa Danger	2001 manga, 2004 anime television series, Anime series based on manga
Justin Fairfax	1979 births, Living people, American lawyers, Lieutenant Governors of Virginia, Politicians from Pittsburgh, Pennsylvania, US Democratic Party politicians
Bernard Lietaer	1942 births, 2019 deaths, Belgian writers, Belgian scientists, Engineers, Belgian educators, Belgian economists
Detsl	1983 births, 2019 deaths, Deaths from myocardial infarction, Russian singers
Bob Friend	1930 births, 2019 deaths, Deaths from cardiac arrest, Pittsburgh Pirates players, New York Yankees players, New York Mets players, Sportspeople from Indiana
Salesforce Tower	Buildings and structures completed in the 21st century, Buildings and structures in San Francisco, Skyscrapers in the United States, Landmarks in San Francisco, 2018 establishments in the United States, 2010s establishments in California
Wilshire Grand Center	Buildings and structures in Los Angeles, California, Skyscrapers in the United States, 2018 establishments in the United States, 2010s establishments in California
Carmen Duncan	1942 births, 2019 deaths, Cancer deaths in Sydney, Australian movie actors, Australian television actors, Actors from New South Wales
Ransom County, North Dakota	North Dakota counties
Beeville, Texas	Cities in Texas, County seats in Texas
Judy Cornwell	1940 births, Living people
Josephine Tewson	1931 births, Living people
Martyrs (movie)	2008 movies, 2000s thriller movies, 2000s horror movies, 2000s psychological movies, French horror movies, Canadian horror movies
Raphine, Virginia	Unincorporated communities in Virginia
Jüri Pihl	1954 births, 2019 deaths, Estonian politicians
Kristoff St. John	1966 births, 2019 deaths, Deaths from heart failure, Actors from New York City, American movie actors, American television actors
Joe P. Tolson	1941 births, 2019 deaths, Deaths from respiratory failure, State legislators of the United States, Politicians from North Carolina, American educators, US Democratic Party politicians
Pinetops, North Carolina	Towns in North Carolina
Tarboro, North Carolina	Towns in North Carolina, County seats in North Carolina
Edgecombe County, North Carolina	18th-century establishments in North Carolina, 1741 establishments in the Thirteen Colonies, North Carolina counties
Rocky Mount, North Carolina	Cities in North Carolina
Isacio Calleja	1936 births, 2019 deaths, Spanish footballers
Chomsky hierarchy	Language education, Linguistics
Leonie Ossowski	1925 births, 2019 deaths, Writers from Berlin
Frederick Terman	1900 births, 1982 deaths, American academics, People from Indiana
Jeffrey Kramer	1945 births, Living people
David Griffin	1943 births, Living people, English actors
Aztec Ruins National Monument	National Monuments of the United States, New Mexico
Flag of Anguilla	National flags, Anguilla
Renville County, North Dakota	North Dakota counties
Letona, Arkansas	Towns in Arkansas
Richland County, North Dakota	North Dakota counties
Doug Supernaw	1960 births, 2020 deaths, Deaths from bladder cancer, Deaths from lung cancer, American country singers, American country guitarists, Singer-songwriters from Texas, Musicians from Texas
Bryan, Texas	Cities in Texas
Sam Lloyd	1963 births, 2020 deaths, Deaths from brain cancer, American movie actors, American television actors, American stage actors, American voice actors, Actors from Vermont, Singers from Vermont
Weston, Vermont	Towns in Vermont
Carol Emshwiller	1921 births, 2019 deaths, American feminist writers, American science fiction writers, Writers from Michigan, People from Ann Arbor, Michigan
Izzy Young	1928 births, 2019 deaths, American columnists, Businesspeople from New York City, Writers from New York City, Writers from Stockholm
Broad Peak	Karakoram, Mountains of Pakistan, Mountains of China
Amy Klobuchar 2020 presidential campaign	2020 United States presidential campaigns
Kurt Diemberger	1932 births, Living people, Mountain climbers, Austrian sportspeople, Writers from Vienna
Tibor Baranski	1922 births, 2019 deaths, Naturalized citizens of the United States, American educators, American activists, Hungarian writers, People from Budapest
Thurston County, Washington	Washington (state) counties, 19th-century establishments in Washington (state), 1852 establishments in the United States
Nayib Bukele	1981 births, Living people, Presidents of El Salvador, Current national leaders, Mayors
Sandrine Doucet	1959 births, 2019 deaths, Cancer deaths in France, French politicians
Václav Vorlíček	1930 births, 2019 deaths, Deaths from lung cancer, Czech movie directors, People from Prague
Todor Kavaldzhiev	1934 births, 2019 deaths, Bulgarian politicians, Political activists, Generals, Vice presidents
Petar Stoyanov	1952 births, Living people, Presidents of Bulgaria
Petar Mladenov	1936 births, 2000 deaths, Presidents of Bulgaria, European diplomats, Communists
President of Bulgaria	Presidents of Bulgaria
Georgi Parvanov	1957 births, Living people, Presidents of Bulgaria
Rumen Radev	1963 births, Living people, Presidents of Bulgaria, Current national leaders, Generals
Prime Minister of Bulgaria	Prime Ministers of Bulgaria
Georgi Atanasov (politician)	1933 births, Living people, Prime Ministers of Bulgaria
Rolette County, North Dakota	North Dakota counties
President of Hungary	Presidents of Hungary
Traill County, North Dakota	North Dakota counties
Mátyás Szűrös	1933 births, Living people, Presidents of Hungary
Walsh County, North Dakota	North Dakota counties
Ferenc Mádl	1931 births, 2011 deaths, Presidents of Hungary, Hungarian writers
Sioux County, North Dakota	North Dakota counties
László Sólyom	1942 births, Living people, Presidents of Hungary
Sargent County, North Dakota	North Dakota counties
Pál Schmitt	1942 births, Living people, Presidents of Hungary, Hungarian sportspeople, Olympic gold medalists
Sheridan County, North Dakota	North Dakota counties
László Kövér	1959 births, Living people, Presidents of Hungary
Steele County, North Dakota	1880s establishments in North Dakota, 1883 establishments in the United States, North Dakota counties
Towner County, North Dakota	North Dakota counties
Wells County, North Dakota	North Dakota counties
Prime Minister of Hungary	Prime Ministers of Hungary
Rainer Stadelmann	1933 births, 2019 deaths, German archaeologists, People from Bavaria
Rudi Assauer	1944 births, 2019 deaths, Deaths from Alzheimer's disease, German footballers, German football managers, Sportspeople from Saarland
Sulzbach, Saarland	Cities in Saarland, Towns in Saarland, Saarbrücken (district)
Bardonnex	Municipalities of Geneva
Howie Hawkins	1952 births, Living people, 2020 United States presidential candidates, American political activists, American political commentators, Politicians from San Francisco, Politicians from New York, People from Syracuse, New York, Green Party of the United States politicians
Yechiel Eckstein	1951 births, 2019 deaths, Deaths from myocardial infarction, Naturalized citizens of Israel, American rabbis, Israeli rabbis, American philanthropists, People from Ottawa, Businesspeople from New York City, Businesspeople from Chicago, People from Jerusalem
The Cooler	2000s romantic drama movies, 2003 romance movies, 2003 drama movies, American romantic drama movies, American independent movies, Lionsgate movies
Susan Bayh	1959 births, 2021 deaths, Deaths from glioblastoma, American lawyers, Writers from Indiana
Rockport, Texas	Cities in Texas, County seats in Texas
Bellville, Texas	Cities in Texas, County seats in Texas
Claude, Texas	Cities in Texas, County seats in Texas
Seymour, Texas	Cities in Texas, County seats in Texas
Gail, Texas	Cities in Texas, County seats in Texas
Linden, Texas	Cities in Texas, County seats in Texas
Rusk, Texas	Cities in Texas, County seats in Texas
Coleman, Texas	Cities in Texas, County seats in Texas
Crane, Texas	Cities in Texas, County seats in Texas
Bonham, Texas	Cities in Texas, County seats in Texas
Roby, Texas	Cities in Texas, County seats in Texas
Edinburg, Texas	Cities in Texas, County seats in Texas
Jasper, Texas	Cities in Texas, County seats in Texas
Edna, Texas	Cities in Texas, County seats in Texas
Llano, Texas	Cities in Texas, County seats in Texas
Brady, Texas	Cities in Texas, County seats in Texas
Boston, Texas	Unincorporated communities in Texas, County seats in Texas
Chris Duncan	1981 births, 2019 deaths, Deaths from glioblastoma, St. Louis Cardinals players, American radio personalities, People from Tucson, Arizona, Sportspeople from Arizona
Cabaret (1972 movie)	1972 movies, 1970s musical movies, American musical movies, Movies directed by Bob Fosse, Movies set in the 1930s, American LGBT movies, 1970s LGBT movies, English-language movies
Majungasaurus	Abelisauridae, Cretaceous dinosaurs, Dinosaurs of Africa
War of the Austrian Succession	War, History of Austria
Qutub Minar	World Heritage Sites in India, Islamic culture, Mosques in India
Benjamin, Texas	Cities in Texas, County seats in Texas
Hebbronville, Texas	Census-designated places in Texas, County seats in Texas
Big Lake, Texas	Cities in Texas, County seats in Texas
Big Spring, Texas	Cities in Texas, County seats in Texas
Zapata, Texas	Census-designated places in Texas, County seats in Texas
Boerne, Texas	Cities in Texas, County seats in Texas
Brackettville, Texas	Cities in Texas, County seats in Texas
Breckenridge, Texas	Cities in Texas, County seats in Texas
Brownfield, Texas	Cities in Texas, County seats in Texas
Brownwood, Texas	Cities in Texas, County seats in Texas
Gonten	Districts of Appenzell Innerrhoden
Oberegg	Districts of Appenzell Innerrhoden
Rüte	Districts of Appenzell Innerrhoden
Schlatt-Haslen	Districts of Appenzell Innerrhoden
Schwende	Districts of Appenzell Innerrhoden
Manfred Eigen	1927 births, 2019 deaths, German chemists, German biologists, German physicists, People from Bochum
Burnet, Texas	Cities in Texas, County seats in Texas
Rosamunde Pilcher	1924 births, 2019 deaths, Deaths from stroke, British novelists, People from Cornwall
Gumelar	Villages in Indonesia, Java
Alan Mandell	1927 births, Living people, Naturalized citizens of the United States, Canadian movie actors, Canadian stage actors, Canadian television actors, American movie actors, American stage actors, American television actors, Actors from Toronto, Actors from San Francisco
Zawe Ashton	1984 births, Living people, English movie actors, English child actors, English television actors, English stage actors, English radio actors, English voice actors, English playwrights, English television directors, Actors from London, Writers from London
Sansepolcro	Cities in Tuscany
Frank Robinson	Presidential Medal of Freedom recipients, 1935 births, 2019 deaths, Deaths from bone cancer, Cancer deaths in Los Angeles, Cincinnati Reds players, Baltimore Orioles players, Los Angeles Dodgers players, California Angels players, Cleveland Indians players, Washington Nationals, San Francisco Giants, African-American baseball players, Sportspeople from Texas
Robert Moog	1934 births, 2005 deaths, Deaths from glioblastoma, Engineers from New York, Scientists from New York City, Businesspeople from New York City
Gladys West	1930s births, Living people, American mathematicians, Scientists from Virginia
Walter B. Jones Jr.	1943 births, 2019 deaths, Deaths from fractured hip, Deaths from motor neurone disease, United States representatives from North Carolina, US Republican Party politicians
Farmville, North Carolina	Towns in North Carolina
Highland cattle	Cattle breeds
August Zaleski	1883 births, 1972 deaths, Presidents of Poland, Polish economists, Polish historians, Ambassadors of Poland, Writers from Warsaw, Freemasons, Anti-Communists
Phlogiston theory	History of science, Chemical reactions, Thermodynamics
Caldwell, Texas	Cities in Texas, County seats in Texas
Cameron, Texas	Cities in Texas, County seats in Texas
Hero Group	19th century establishments in Switzerland, 1886 establishments in Europe, Food companies of Switzerland, Aargau
Feldschlösschen	Food companies of Switzerland, Beer, Aargau
Staffelfelden	Communes in Haut-Rhin
Steinbrunn-le-Bas	Communes in Haut-Rhin
Steinbrunn-le-Haut	Communes in Haut-Rhin
Steinsoultz	Communes in Haut-Rhin
Sternenberg, Haut-Rhin	Communes in Haut-Rhin
Stetten, Haut-Rhin	Communes in Haut-Rhin
Wittenheim	Communes in Haut-Rhin
Liberty, Texas	Cities in Texas, County seats in Texas
Barking tree frog	Frogs
Michael Rice (singer)	1997 births, Living people
Intel 4004	Computer processors
Aleksander Čeferin	1967 births, Living people, Slovenian sportspeople, Lawyers, Business people, Presidents of UEFA, People from Ljubljana
Rocky Lockridge	1959 births, 2019 deaths, Deaths from stroke, Cardiovascular disease deaths in New Jersey, American boxers, Internet celebrities, Sportspeople from Washington, People from Tacoma, Washington
Gloucester City, New Jersey	Cities in New Jersey
Sergei Yursky	1935 births, 2019 deaths, Deaths from cardiac arrest, Russian movie actors, Russian stage actors, Russian television actors
Jörg Schönbohm	1937 births, 2019 deaths, German generals, German politicians
Edwin Barnes	1935 births, 2019 deaths, Anglican bishops, Anglican priests, English Anglicans, English priests, English Roman Catholics, People from Oxford, Roman Catholic priests
Joe Presko	1928 births, 2019 deaths, Detroit Tigers players, St. Louis Cardinals players, Sportspeople from Kansas City, Missouri
El-ghe	Cyrillic letters
Specific weight	SI units
Michael Kidd-Gilchrist	Basketball players, 1993 births
Storckensohn	Communes in Haut-Rhin
Steve Vai	American musicians, 1960 births, Living people
Stosswihr	Communes in Haut-Rhin
Strueth	Communes in Haut-Rhin
Sundhoffen	Communes in Haut-Rhin
Tagolsheim	Communes in Haut-Rhin
Tagsdorf	Communes in Haut-Rhin
Frank Barnett	1933 births, 2016 deaths, Governors of American Samoa, Federal Bureau of Investigation, Spies, American lawyers, Politicians from Atlanta, Georgia, Politicians from Tennessee, People from Knoxville, Tennessee, US Republican Party politicians, Lieutenant Governors of American Samoa
Portage, Michigan	Cities in Michigan
Étupes	Communes in Doubs
Thannenkirch	Communes in Haut-Rhin
Ueberstrass	Communes in Haut-Rhin
Canton, Texas	Cities in Texas, County seats in Texas
Canyon, Texas	Cities in Texas, County seats in Texas
Blue Eye, Arkansas	Towns in Arkansas
Tomi Ungerer	1931 births, 2019 deaths, French artists, French writers
Unbitrium	Chemical elements, Nuclear physics
Unbipentium	Periodic table, Chemical elements
Suhayl ibn Amr	Converts to Islam, Sahaba, Pages with unreviewed translations
Romanization of Greek	Romanization, Greek language
Falmer Stadium	2011 establishments in England, Football stadiums in England, East Sussex
Lake Mweru	Lakes of Africa, Geography of Zambia, Geography of the Democratic Republic of the Congo
ITV Encore	ITV, British television channels
Film4	Companies of the United Kingdom, Television networks
Super Bowl LIV	Super Bowl, 2020 in sports, February 2020 events
Jerry Falwell Jr.	American conservatives, American Baptists, People from Lynchburg, Virginia, 1962 births, Living people
Wayne Messam	1974 births, Living people, 2020 United States presidential candidates, American mayors, Businesspeople from Florida, Politicians from Florida, People from Miramar, Florida, US Democratic Party politicians
Zyklon B	The Holocaust, Chemical warfare, Nazi Germany
Charging Bull	Sculptures, Manhattan
Rachel Zegler	2001 births, Actors from New Jersey, American singers, Living people, People from Hackensack, New Jersey
Sony Pictures	Movie studios, Sony
Traubach-le-Bas	Communes in Haut-Rhin
Traubach-le-Haut	Communes in Haut-Rhin
Sanjay's Super Team	2015 animated movies, Pixar short movies
Beaverhead County, Montana	Montana counties, 1865 establishments in Montana Territory
Big Horn County, Montana	Montana counties, 1913 establishments in Montana
Playmobil	1970s establishments in Germany, 1974 establishments in Europe, Companies of Germany, Toys, Bavaria
Hornbach (retailer)	1970s establishments in Germany, 1977 establishments in Europe, Companies of Germany, Rhineland-Palatinate
Carrizo Springs, Texas	Cities in Texas, County seats in Texas
Lexa, Arkansas	Towns in Arkansas
Blade II	Blade movies, 2000s superhero movies, Movies directed by Guillermo del Toro, New Line Cinema movies, Superhero horror movies, African-American superhero movies
Blaine County, Montana	Montana counties, 1912 establishments in the United States, 1910s establishments in Montana
Tutwiler, Mississippi	Towns in Mississippi
WarnerMedia	1990 establishments in New York (state), American entertainment companies, Companies based in New York City, Time Warner
Green New Deal	Climate change, Alexandria Ocasio-Cortez
The Red Room (short story)	British short stories
Christian Weber	1946 births, 2019 deaths, Politicians of the Social Democratic Party of Germany, Politicians from Bremen (state), Disease-related deaths in Germany
Rolf Böhme	1934 births, 2019 deaths, German mayors, Politicians of the Social Democratic Party of Germany, Politicians from Baden-Württemberg, People from Konstanz, People from Freiburg im Breisgau, Order of Merit of the Federal Republic of Germany
Turckheim	Communes in Haut-Rhin
Uffheim	Communes in Haut-Rhin
Burdette, Arkansas	Towns in Arkansas
BBC Asian Network	BBC radio
Trivago	2000s establishments in Germany, 2005 establishments in Europe, Travel, Websites, Companies of Germany, Düsseldorf, Companies listed on NASDAQ
Burton Albion F.C.	1950s establishments in England, 1950 establishments in Europe, English football clubs, Staffordshire
Bill Freehan	1941 births, 2021 deaths, Deaths from Alzheimer's disease, Detroit Tigers players, Sportspeople from Detroit, Michigan
Rhaetian Railway	World Heritage Sites in Italy, World Heritage Sites in Switzerland, Train operating companies, Transport in Italy, Transport companies of Switzerland, Graubünden, Lombardy
Robert Caro	Pulitzer Prize winners, 1935 births, Living people, American political writers, American political commentators, Journalists from New York City, Columbia University alumni, Jewish American writers, Princeton University alumni
Robert Moses	1888 births, 1981 deaths, Cardiovascular disease deaths in New York City, American architects, Politicians from New Haven, Connecticut, Politicians from New York City, Businesspeople from New York City, Businesspeople from New Haven, Connecticut, US Republican Party politicians
Black Springs, Arkansas	Towns in Arkansas
Bruno Messerli	1931 births, 2019 deaths, Swiss writers, Swiss scientists, European geographers, Swiss educators
Vano Zodelava	1957 births, 2019 deaths, Road accident deaths, Mayors, Politicians from Georgia (country)
Tilly van der Zwaard	1938 births, 2019 deaths, Deaths from Alzheimer's disease, Disease-related deaths in Florida, Dutch Olympians, People from Leiden, Sportspeople from South Holland, Sprinters
Maria Itkina	1932 births, 2020 deaths, Soviet sportspeople, Olympians
Dick Kempthorn	1926 births, 2019 deaths, American football players, Sportspeople from Michigan, Sportspeople from Ohio, Businesspeople from Michigan, Businesspeople from Ohio, People from Canton, Ohio
Wolfgang Rindler	1924 births, 2019 deaths, Deaths from pneumonia, Naturalized citizens of the United States, Austrian physicists, American physicists, Scientists from Vienna, Writers from Vienna
Robert Ryman	1930 births, 2019 deaths, American painters, Artists from New York City
Olli Lindholm	Finnish singers, Guitarists, 1964 births, 2019 deaths
Lou Sossamon	1921 births, 2019 deaths, American football centers, American football linebackers, Sportspeople from South Carolina
Gaffney, South Carolina	Towns in South Carolina, County seats in South Carolina
Ricardo Boechat	1952 births, 2019 deaths, Aviation deaths, Argentine writers, Brazilian writers, Brazilian journalists, People from Buenos Aires, Argentine journalists
Ron W. Miller	1933 births, 2019 deaths, American chief executives, American football tight ends, American movie producers, Businesspeople from Los Angeles, California, Deaths from congestive heart failure, Disney people, Los Angeles Rams players, Sportspeople from Los Angeles, California
Shelley Lubben	1968 births, 2019 deaths, Drug-related accidental deaths in the United States, American pornographic actors, American activists, Singers from Los Angeles County, California, Writers from Los Angeles County, California, Actors from Pasadena, California
Springville, California	Census-designated places in California, Settlements in Tulare County, California
Salvatore Bellomo	1951 births, 2019 deaths, Deaths from stomach cancer, Belgian sportspeople, Wrestlers
Robert Helpmann	1909 births, 1986 deaths, Actors from South Australia, Australian movie actors, Australian stage actors, Dancers, Deaths from COPD, Disease-related deaths in Sydney, Commanders of the Order of the British Empire, Choreographers, Knights Bachelor
Paul Hellyer	1923 births, 2021 deaths, Accidental deaths from falls, Canadian engineers, Political commentators, Canadian scientists, Writers from Ontario, Politicians from Ontario, Privy Councillors (Canada), Members of the House of Commons of Canada from Ontario
Carmen Argenziano	1943 births, 2019 deaths, American movie actors, American television actors, American stage actors, American voice actors, Actors from Pennsylvania
Sharon, Pennsylvania	Cities in Pennsylvania
Yonatan Netanyahu	1946 births, 1976 deaths, Burials at Mount Herzl, Colonels, Israeli Jews, Israeli military people, Military people killed in action, Jewish military people, People from New York City, Benjamin Netanyahu
British Red Cross	Red Cross, Organisations based in London, 1870s establishments in England, 1870 establishments in Europe
Super Bowl LI	Super Bowl, New England Patriots, Atlanta Falcons, 2010s in Texas, February 2017 events, 2017 in sports, 2017 in the United States
Heinz Fütterer	1931 births, 2019 deaths, German Olympic bronze medalists, Male athletes, Sportspeople from Baden-Württemberg, Sprinters
Roderick MacFarquhar	1930 births, 2019 deaths, British educators, British journalists, British historians, UK MPs 1974–1979
Maximilian Reinelt	1988 births, 2019 deaths, Deaths in sport, German Olympic gold medalists, German Olympic silver medalists, German doctors, Rowers
Michael Wilson (politician)	1937 births, 2019 deaths, Cancer deaths in Canada, Canadian businesspeople, Canadian activists, Politicians from Toronto, Privy Councillors (Canada), Members of the House of Commons of Canada from Ontario
Super Bowl 50	2016 in California, 2016 in sports, Denver Broncos, Carolina Panthers, February 2016 events, Super Bowl
Mark Kelly	1964 births, Living people, United States senators from Arizona, American astronauts, Engineers from New Jersey, American political activists, American aviators, American military people, Politicians from New Jersey, Writers from New Jersey, Scientists from New Jersey, Writers from Arizona, Scientists from Arizona, People from Orange, New Jersey, People from Tucson, Arizona, US Democratic Party politicians, Twin people from the United States
Liz Cheney	1966 births, Living people, United States representatives from Wyoming, Politicians from Wisconsin, People from Madison, Wisconsin, US Republican Party politicians
Super Bowl XLIX	Super Bowl, New England Patriots, 2015 in sports, 2015 in the United States, February 2015 events, 2010s in Arizona
Cherokee County, South Carolina	South Carolina counties, 1897 establishments in South Carolina
Aiken County, South Carolina	1870s establishments in South Carolina, 1871 establishments in the United States, South Carolina counties
Sherrelwood, Colorado	Census-designated places in Colorado
Broadwater County, Montana	1890s establishments in Montana, 1897 establishments in the United States, Montana counties
Avilla, Arkansas	Census-designated places in Arkansas
College Station, Arkansas	Census-designated places in Arkansas, Pulaski County, Arkansas
Eminem albums discography	Eminem albums, Discographies
Wrightsville, Arkansas	Cities in Arkansas, Pulaski County, Arkansas
McAlmont, Arkansas	Census-designated places in Arkansas, Pulaski County, Arkansas
Super Bowl XLVIII	Super Bowl, Seattle Seahawks, Denver Broncos, 2010s in New Jersey, 2014 in the United States, 2014 in sports
Alexander, Arkansas	Cities in Arkansas, Pulaski County, Arkansas
Sweet Home, Arkansas	Census-designated places in Arkansas, Pulaski County, Arkansas
Gibson, Arkansas	Census-designated places in Arkansas, Pulaski County, Arkansas
Landmark, Arkansas	Census-designated places in Arkansas, Pulaski County, Arkansas
Roland, Arkansas	Census-designated places in Arkansas, Pulaski County, Arkansas
Scott, Arkansas	Census-designated places in Arkansas, Pulaski County, Arkansas
Woodson, Arkansas	Census-designated places in Arkansas, Pulaski County, Arkansas
Bonanza, Arkansas	Cities in Arkansas, Sebastian County, Arkansas
Huntington, Arkansas	Cities in Arkansas, Sebastian County, Arkansas
Hackett, Arkansas	Cities in Arkansas, Sebastian County, Arkansas
Hartford, Arkansas	Cities in Arkansas, Sebastian County, Arkansas
Zendikar	Card games
Central City, Arkansas	Cities in Arkansas, Sebastian County, Arkansas
Midland, Arkansas	Towns in Arkansas, Sebastian County, Arkansas
Amity, Arkansas	Cities in Arkansas
Caddo Valley, Arkansas	Towns in Arkansas
Gum Springs, Arkansas	Towns in Arkansas
Okolona, Arkansas	Towns in Arkansas
Whelen Springs, Arkansas	Towns in Arkansas
Colorado City, Texas	Cities in Texas, County seats in Texas
João Lourenço	1954 births, Living people, Presidents of Angola, Current national leaders
Ralph Abraham (politician)	1954 births, Living people, United States representatives from Louisiana, American physicians, Scientists from Louisiana, US Republican Party politicians, Veterinarians
Double-headed serpent	Aztec, Archaeology, Legendary creatures, History of Mexico, British Museum
Makaji Meghpar	Villages in Gujarat
Louis Antoine, Duke of Angoulême	1775 births, 1844 deaths, Kings and Queens of France
Deltarune	Indie video games, MacOS games, Role-playing video games, Windows games, 2018 video games
Jack Coghill	1925 births, 2019 deaths, People from Fairbanks, Alaska, Businesspeople from Alaska, Lieutenant Governors of Alaska, US Republican Party politicians
Eric Harrison	1938 births, 2019 deaths, English footballers, English football managers, Sportspeople from Yorkshire, Members of the Order of the British Empire
Ron Atkinson	1939 births, Living people, English footballers, English football managers, Sportspeople from Liverpool
Vitaliy Khmelnytskyi	1943 births, 2019 deaths, Ukrainian footballers, Ukrainian football managers
Michel Bernard (runner)	1931 births, 2019 deaths, French sportspeople, French Olympians
Chun-Ming Kao	1929 births, 2019 deaths, Deaths from liver failure, Chinese people, Political activists, Presbyterians
Michael Nudelman	1938 births, 2019 deaths, Deaths from acute myeloid leukemia, Former Members of Knesset, Jewish Israeli politicians, Kadima politicians, Naturalized citizens of Israel, People from Kiev, Soviet Jews, Ukrainian Jews, Yisrael Beiteinu politicians
Sergei Zakharov	1950 births, 2019 deaths, Deaths from heart failure, Russian singers
Andrew Wakefield	1957 births, Living people, British physicians, British activists, Immunologists, Vaccinologists, People from Berkshire
MMR vaccine	Immunization
John Starling	1940 births, 2019 deaths, American bluegrass musicians, American composers, Deaths from congestive heart failure, Grammy Award winners, Musicians from North Carolina, People from Durham, North Carolina
Colonia, New Jersey	Unincorporated communities in New Jersey, Census-designated places in New Jersey, Middlesex County, New Jersey
Chingchai Mongkoltham	Thai politicians
Keiser, Arkansas	Cities in Arkansas
Joiner, Arkansas	Cities in Arkansas
Carbon County, Montana	1890s establishments in Montana, 1895 establishments in the United States, Montana counties
Carter County, Montana	1910s establishments in Montana, 1917 establishments in the United States, Montana counties
Cascade County, Montana	1880s establishments in Montana Territory, 1887 establishments in the United States, Montana counties
Dezső Tandori	1938 births, 2019 deaths, Hungarian poets, Translators, People from Budapest
Leisuretowne, New Jersey	Unincorporated communities in New Jersey, Census-designated places in New Jersey
Lane County, Oregon	Oregon counties
Decatur, Texas	Cities in Texas, County seats in Texas
Dell, Arkansas	Towns in Arkansas
Carthage, Texas	Cities in Texas, County seats in Texas
Opportunity (rover)	NASA spacecraft, Planetary rovers
Margo Price	1983 births, American country singers, Singers from Illinois, Singers from Nashville, Tennessee, Living people
Puella Magi Madoka Magica	Manga series, 2011 manga, 2012 manga, 2011 anime television series
List of cities and towns in East Prussia	Towns in Poland
432 Park Avenue	2016 establishments in the United States, Buildings and structures in Manhattan, Skyscrapers in New York City
The Perks of Being a Wallflower (novel)	Novels
Chouteau County, Montana	1865 establishments in Montana Territory, Montana counties
Daniels County, Montana	1920 establishments in Montana, Montana counties
Mysterious Times	1998 songs, Sash! songs
Dawson County, Montana	1860s establishments in Montana Territory, 1869 establishments in the United States, Montana counties
Deer Lodge County, Montana	1865 establishments in Montana Territory, Montana counties
President of Northern Cyprus	Presidents of Northern Cyprus
Bakau	Cities in the Gambia
Fallon County, Montana	1913 establishments in Montana, Montana counties
Fergus County, Montana	1880s establishments in Montana Territory, 1885 establishments in the United States, Montana counties
List of towns in Indiana	Towns in Indiana
Flathead County, Montana	1893 establishments in Montana, Montana counties
Golden Valley County, Montana	1920 establishments in Montana, Montana counties
2236 Austrasia	Asteroids
1223 Neckar	Asteroids
It's My Life (Sash! song)	1995 songs, Sash! songs
Grozny	Chechnya
East Prussia	1945 disestablishments in Europe, Regions of Europe
Connie Jones	1934 births, 2019 deaths, Deaths from heart failure, American jazz musicians, Trumpeters, Musicians from New Orleans, Louisiana
Andrea Levy	1956 births, 2019 deaths, Deaths from breast cancer, Cancer deaths in London, English novelists, Writers from London
Al Mahmud	1936 births, 2019 deaths, Deaths from pneumonia, Bangladeshi poets
John Horton Conway	1937 births, 2020 deaths, Deaths from the COVID-19 pandemic in the United States, English mathematicians, Writers from Liverpool
Adriano Ossicini	1920 births, 2019 deaths, Accidental deaths from falls, Italian educators, Politicians from Rome
Teller (magician)	1948 births, Living people, American inventors, American magicians, American movie actors, American television actors, American painters, Actors from Philadelphia, Pennsylvania, Writers from Philadelphia, Pennsylvania, Movie directors from Pennsylvania
Marisa Solinas	Italian movie actors, Italian television actors, Italian singers, Italian writers, Pop singers, Songwriters, 1939 births, 2019 deaths, Deaths from lymphoma, People from Genoa
Dave Smith	1940 births, 2019 deaths, American historians, Disney people, People from Pasadena, California, People from Burbank, California, Writers from California
365 (song)	Katy Perry songs, Dance-pop songs, 2019 songs
Prime factorization	Number theory, Prime numbers
Encore une fois	1997 songs, Sash! songs
Ecuador (song)	1997 songs, Sash! songs
Beril Böcekler	2004 births, People from Ankara, Swimmers, Sportswomen, Turkish sportspeople
Stay (Sash! song)	1997 songs, Sash! songs
La Primavera (song)	1998 songs, Sash! songs
Gallatin County, Montana	1865 establishments in Montana Territory, Montana counties
Move Mania	1998 songs, Sash! songs
Garfield County, Montana	1919 establishments in Montana, Montana counties
Glacier County, Montana	1919 establishments in Montana, Montana counties
Royal Rumble (2019)	2010s in American television, 2019 in sports, Royal Rumble, Sports in Phoenix, Arizona, 2010s in Phoenix, 2019 in the United States
Dillon, Montana	1880s establishments in Montana Territory, 1880 establishments in the United States, Cities in Montana, County seats in Montana
Granite County, Montana	1893 establishments in Montana, Montana counties
Philipsburg, Montana	Towns in Montana, County seats in Montana
Dyess, Arkansas	Towns in Arkansas
Akiachak, Alaska	Census-designated places in Alaska
Newtok, Alaska	Census-designated places in Alaska
Hill County, Montana	1910s establishments in Montana, 1912 establishments in the United States, Montana counties
Pfäffikon, Schwyz	Villages in Schwyz
Nelson Lagoon, Alaska	Census-designated places in Alaska
Marie, Arkansas	Towns in Arkansas
WWE Worlds Collide	2019 in the United States, 2010s in Phoenix, Professional wrestling, January 2019 events, WWE
Etowah, Arkansas	Towns in Arkansas
Victoria, Arkansas	Towns in Arkansas
St. Charles, Arkansas	Towns in Arkansas
Governor of North Carolina	Governors of North Carolina
Austin Lake	Lakes of the United States, Geography of Michigan
Fox Point Hurricane Barrier	Providence, Rhode Island, Buildings and structures in the United States
Kofi Burbridge	1961 births, 2019 deaths, Musicians from New York City, Grammy Award winners
Gene Littler	1930 births, 2019 deaths, Deaths from peripheral neuropathy, American golfers, Sportspeople from San Diego, California
Patrick Caddell	1950 births, 2019 deaths, Deaths from stroke, American political commentators, American political writers, Fox News people, Democrats (United States), Writers from Florida, Writers from South Carolina
Rock Hill, South Carolina	Cities in South Carolina
York, South Carolina	County seats in South Carolina, Cities in South Carolina
Paget Brewster	1969 births, Living people, American movie actors, American television actors, American stage actors, American voice actors, Singers from Massachusetts, Actors from Massachusetts
Sam Bass (artist)	1961 births, 2019 deaths, Deaths from sepsis, Deaths from kidney disease, Deaths from diabetes, American artists, NASCAR, People from Virginia, People from North Carolina
York County, South Carolina	South Carolina counties, 1785 establishments in South Carolina
Colour the World	1999 songs, Sash! songs
Ma Baker (Sash! song)	1998 songs, Sash! songs
Adelante (Sash! song)	1999 songs, Sash! songs
Just Around the Hill	2000 songs, Sash! songs
With My Own Eyes	2000 songs, Sash! songs
Together Again (Sash! song)	2000 songs, Sash! songs
Ganbareh	2002 songs, Sash! songs
Run (Sash! song)	2002 songs, Sash! songs
I Believe (Sash! song)	2002 songs, Sash! songs
Kamikaze (Eminem album)	2018 albums, Eminem albums
Raindrops (Encore Une Fois)	2008 songs, Sash! songs
It's My Life – The Album	Sash! albums, 1997 albums, Dance albums
Life Goes On (Sash! album)	Sash! albums, 1998 albums, Dance albums
Trilenium	Sash! albums, 2000 albums, Dance albums
S4!Sash!	Sash! albums, 2002 albums, Eurodance albums
Life Is A Beach	Sash! albums, 2012 albums, Eurodance albums
Life Changes (Sash! album)	Sash! albums, 2013 albums, Eurodance albums
Encore Une Fois – The Greatest Hits	Sash! albums, 2000 albums, Eurodance albums, Techno music
10th Anniversary (Sash! album)	Sash! albums, 2007 albums, Trance music, Eurodance albums
The Best Of (Sash! album)	Sash! albums, 2008 albums, Trance music, Eurodance albums
Sash! discography	Discographies, Sash! songs
Mary Lee Woods	1924 births, 2017 deaths, English mathematicians, English computer scientists, People from Birmingham
Conway Berners-Lee	1921 births, 2019 deaths, English mathematicians, English computer scientists, People from Birmingham
Cadet (rapper)	1990 births, 2019 deaths, Road accident deaths in the United Kingdom, British rap musicians, Musicians from London
Jerry Casale	1933 births, 2019 deaths, Boston Red Sox players, Los Angeles Angels players, Detroit Tigers players, Sportspeople from New York City, Sportspeople from New Jersey
Paramus, New Jersey	Boroughs in New Jersey
Šaban Šaulić	1951 births, 2019 deaths, Road accident deaths, Serbian singers
Alexis Arquette	1969 births, 2016 deaths, Deaths from cardiac arrest, Deaths from AIDS, Cardiovascular disease deaths in Los Angeles, LGBT actors, LGBT singers, Arquette family, Transgender and transsexual people, American movie actors, American television actors, American LGBT rights activists, American cartoonists, LGBT people from Los Angeles, California, Actors from Los Angeles, California, Singers from Los Angeles, California
Saint Alphonsa	1910 births, 1946 deaths, Saints, People from Kerala
David Frederick Hepburn	1956 births, Canadian writers, Living people
Pierre Pincemaille	1956 births, 2018 deaths, French composers, French organists, 20th century composers, Musicians from Paris, Deaths from lung cancer, Cancer deaths in France
Peter Wells (director)	1950 births, 2019 deaths, Deaths from prostate cancer, New Zealand writers, LGBT novelists, LGBT directors, Gay men, People from Auckland
Ethel Ennis	1932 births, 2019 deaths, Deaths from stroke, American jazz singers, Singers from Baltimore, Maryland
Eduardo Bauzá	1939 births, 2019 deaths, Deaths from Alzheimer's disease, Argentine politicians
Chris Doleman	1961 births, 2020 deaths, Deaths from glioblastoma, American football defensive ends, American football linebackers, Atlanta Falcons players, Minnesota Vikings players, San Francisco 49ers players, Sportspeople from Indianapolis, Indiana
Don Bragg	1935 births, 2019 deaths, Deaths from dementia, Disease-related deaths in California, American track and field athletes, American Olympic gold medalists, Sportspeople from New Jersey
Penns Grove, New Jersey	Boroughs in New Jersey
Salem, New Jersey	Cities in New Jersey, County seats in New Jersey
WWE Women's Tag Team Championship	World Wrestling Entertainment championships
Jefferson County, Montana	1865 establishments in Montana Territory, Montana counties
Jefferson County, Oregon	Oregon counties
José de Jesús Pimiento Rodríguez	1919 births, 2019 deaths, Deaths from heart failure, Accidental deaths from falls, Colombian people, Bishops, Centenarians, Roman Catholics
Five card draw	Poker
CHBE-FM	Radio stations, Victoria, British Columbia
Judith Basin County, Montana	1920 establishments in Montana, Montana counties
Blue Mountain, Arkansas	Towns in Arkansas
Caulksville, Arkansas	Towns in Arkansas
Riverdale (2017 TV series)	2010s American drama television series, 2010s drama television series, 2010s television series, 2017 television series debuts, American drama television series, American science fiction television series, American teen drama television series, Children's television series, Drama television series, High school television series, LGBT television programs, Movies based on comics, Television series about dysfunctional families, Television series about friendship, Television series about sisters, English-language television programs
New Blaine, Arkansas	Census-designated places in Arkansas
Lake County, Montana	1920s establishments in Montana, 1923 establishments in the United States, Montana counties
Giulio Brogi	1935 births, 2019 deaths, Italian movie actors, People from Verona
Southern Ming	Chinese dynasties
Tupolev Tu-334	Soviet & Russian aircraft
Belle Époque	History of Europe
Auronzo di Cadore	Settlements in Veneto
Midwife	Medicine
Akbar's tomb	Buildings and structures in India, Uttar Pradesh
Mewar	Regions of India, Rajasthan
Muiz ud din Qaiqabad	1260s births, 1290 deaths, Mamluk dynasty (Delhi), Muslims
Alberto Gutman	1959 births, 2019 deaths, Cuban politicians, Naturalized citizens of the United States, American fraudsters, Politicians from Miami, Florida, People from Havana, US Republican Party politicians
Koper	Cities in Slovenia
Comblanchien	Communes in Côte-d'Or
Lewis and Clark County, Montana	1865 establishments in Montana Territory, Montana counties
Antons Justs	1931 births, 2019 deaths, Bishops, Latvian people
Wallace Smith Broecker	1931 births, 2019 deaths, American geologists, American physicists, Scientists from Chicago
Fairfield, California	Cities in California, Cities in the San Francisco Bay Area, County seats in California, Settlements in Solano County, California, 1856 establishments in California
Liberty County, Montana	1920 establishments in Montana, Montana counties
Lincoln County, Montana	1900s establishments in Montana, 1909 establishments in the United States, Montana counties
2019 Pulwama attack	2019 in Asia, February 2019 events, Islamic terrorist incidents in Asia, Islamic terrorist incidents in the 2010s, Mass murder in 2019, Mass murder in Asia, Murder in India, Terrorist incidents in 2019, Terrorist incidents in Asia in the 2010s
Negaunee, Michigan	Cities in Michigan
McCone County, Montana	1919 establishments in Montana, Montana counties
Cale, Arkansas	Towns in Arkansas
Chester, Arkansas	Towns in Arkansas
Rowena Ravenclaw	Harry Potter characters
Concord, Arkansas	Towns in Arkansas
Presidency of Donald Trump	2010s in the United States, 2017 establishments in the United States, Donald Trump
Don Newcombe	1926 births, 2019 deaths, Los Angeles Dodgers players, Cincinnati Reds players, Cleveland Indians players, Sportspeople from New Jersey
Namvar Singh	1926 births, 2019 deaths, Deaths from pneumonia, Indian writers
Chelo Alonso	1933 births, 2019 deaths, Deaths from Parkinson's disease, Cuban actors, Italian movie actors, Italian television actors, Italian stage actors, People from Havana, People from Tuscany
Teotónio de Souza	1947 births, 2019 deaths, Deaths from myocardial infarction, Historians, Portuguese writers
Francisco Mañosa	1931 births, 2019 deaths, Deaths from prostate cancer, Filipino people, Architects
Unbiseptium	Chemical elements, Hypothetical chemical elements
Group 3 element	Chemical elements, Periodic table
Confignon	Municipalities of Geneva
O'Neal Compton	1951 births, 2019 deaths, American movie actors, American television actors, American stage actors, American voice actors, Businesspeople from South Carolina, Actors from South Carolina
Sumter, South Carolina	Cities in South Carolina, County seats in South Carolina
Sumter County, South Carolina	South Carolina counties, 1800 establishments in South Carolina
Daniel Olivares Viniegra	1961 births, Living people, Hidalgo (state), Mexican poets, Mexican essayists
Bernex, Switzerland	Municipalities of Geneva
Madison County, Montana	1865 establishments in Montana Territory, Montana counties
Mineral County, Montana	1914 establishments in Montana, Montana counties
Missoula County, Montana	1860s establishments in Montana Territory, 1860 establishments in the United States, Montana counties
Coat of arms of Hungary	National coats of arms, Hungary, 1990 establishments in Europe, Establishments in Hungary
Corinth, Arkansas	Towns in Arkansas
Bodcaw, Arkansas	Towns in Arkansas
Buckner, Arkansas	Towns in Arkansas
Helvetica	Fonts
Franklin Gothic	Fonts
Optima	Fonts
Misfire	Queen songs
Cubbon Park	1870 establishments, 1870s establishments in India, Parks, Bangalore
Gulab jamun	desserts, Indian food
Lyme Regis Museum	Museums in England, Dorset
Dinosaurland Fossil Museum	Museums in England, Dorset
February 30	Days
Times New Roman	Fonts
Claude Goretta	1929 births, 2019 deaths, Swiss movie directors, Swiss screenwriters, Swiss movie producers, Television producers, People from Geneva, Protestants
Cove, Arkansas	Towns in Arkansas
Crawfordsville, Arkansas	Cities in Arkansas
Denning, Arkansas	Towns in Arkansas
João Paulo dos Reis Veloso	1931 births, 2019 deaths, Brazilian politicians, Brazilian economists, Piauí
Ljubljana Jože Pučnik Airport	1963 establishments in Europe, 20th-century establishments in Slovenia, Airports in Europe, Buildings and structures in Slovenia, Ljubljana
Musselshell County, Montana	1910s establishments in Montana, 1911 establishments in the United States, Montana counties
Emerson, Arkansas	Towns in Arkansas
Patmos, Arkansas	Towns in Arkansas
Park County, Montana	1880s establishments in Montana Territory, 1887 establishments in the United States, Montana counties
Mercy (Madame Monsieur song)	2018 songs
Madame Monsieur	French pop singers, Eurovision Song Contest entrants, Pop music groups
Zoli Ádok	1976 births, Living people
Forres	Towns in Scotland
Bridgnorth	Towns in Shropshire, Civil parishes in Shropshire
Bridgnorth Castle	Castles in England, Shropshire
Lavington's Hole	Shropshire
February 31	Days
Electronic signature	Law, Computing, Internet
NXT UK Women's Championship	World Wrestling Entertainment championships
Petroleum County, Montana	1920s establishments in Montana, 1925 establishments in the United States, Montana counties
Bellevue, Switzerland	Municipalities of Geneva
Enola, Arkansas	Towns in Arkansas
Edmondson, Arkansas	Towns in Arkansas
Felsenthal, Arkansas	Towns in Arkansas
Huttig, Arkansas	Cities in Arkansas
Fourche, Arkansas	Towns in Arkansas
Wabbaseka, Arkansas	Towns in Arkansas
Alexander Alexandrov	1883 births, 1946 deaths, Russian composers, Soviet generals
NXT UK Tag Team Championship	World Wrestling Entertainment championships
NXT North American Championship	World Wrestling Entertainment championships
Mansfield, Connecticut	Towns in Connecticut
J. A. Preston	1932 births, Living people, American movie actors, American television actors, American stage actors, Actors from Washington, D.C.
Planck (spacecraft)	Spacecraft, 2009 in Europe, 2013 disestablishments, Space telescopes
Serotiny	Plant physiology
Halftime Heat	Professional wrestling, WWE
NXT TakeOver	Professional wrestling, WWE
Andover, Connecticut	Towns in Connecticut, 19th-century establishments in Connecticut, 1848 establishments in the United States
Phillips County, Montana	1910s establishments in Montana, 1915 establishments in the United States, Montana counties
NXT UK TakeOver	Professional wrestling, WWE
University of Ljubljana	1919 establishments in Europe, 20th-century establishments in Slovenia, Colleges and universities in Europe, Buildings and structures in Slovenia, Ljubljana
Chant du Départ	Songs, France
Pondera County, Montana	1919 establishments in Montana, Montana counties
Berlin, Connecticut	Towns in Connecticut
Powder River County, Montana	1919 establishments in Montana, Montana counties
Prairie County, Montana	1910s establishments in Montana, 1915 establishments in the United States, Montana counties
Center, Texas	Cities in Texas, County seats in Texas
Franklin, Arkansas	Towns in Arkansas
Ebbe Schwartz	1901 births, 1964 deaths, Danish people, Presidents of UEFA
List of presidents of UEFA	Presidents of UEFA
Gustav Wiederkehr	1905 births, 1972 deaths, Presidents of UEFA, People from Zürich
Artemio Franchi	1922 births, 1983 deaths, Presidents of UEFA, Road accident deaths, People from Florence
Jacques Georges	1916 births, 2004 deaths, Presidents of UEFA, French sportspeople, People from Grand Est
Dorothy Masuka	1935 births, 2019 deaths, Deaths from hypertension, Zimbabwe, South African people, Jazz singers
Nestor Espenilla Jr.	1958 births, 2019 deaths, Deaths from oral cancer, Filipino politicians, Economists
Véronique Schiltz	1942 births, 2019 deaths, French historians, French archaeologists, Writers from Paris
Anouk (singer)	1975 births, Living people, Dutch singers, Record producers, Singer-songwriters
Valentina Monetta	1975 births, Living people, Sammarinese people, Singers
Work hardening	Materials science
Japanese giant flying squirrel	Squirrels, Animals of Japan, Mammals of Asia
Rainbow bee-eater	Coraciiformes, Birds of Australia
Dance with Me (Zoli Ádok song)	2009 songs, Debut singles
Ranchu	Aquarium fish
Takydromus tachydromoides	Animals of Japan, Lizards
Gekko	Lizards
Phase-locked loop	Science, Electronics, Technology
Sándor Barcs	1912 births, 2010 deaths, Hungarian writers, Hungarian politicians, Journalists, Hungarian sportspeople, Hungarian businesspeople, Presidents of UEFA
Quicksort	Searching and sorting algorithms
Kensington, Maryland	Towns in Maryland, Montgomery County, Maryland
Mark Hollis	1955 births, 2019 deaths, Disease-related deaths in London, English singer-songwriters, English composers, English pop singers, English pop musicians, English guitarists, English pianists, Singer-songwriters from London, Musicians from London
Ewald Weibel	1929 births, 2019 deaths, Biologists, Swiss scientists
Giuseppe Mifsud Bonnici	1930 births, 2019 deaths, Deaths from lung cancer, Maltese writers, Chief Justices of Malta, Philosophers
Ángel María Villar	1950 births, Spanish footballers, Presidents of UEFA, People from Bilbao, Living people
Ravalli County, Montana	1893 establishments in Montana, Montana counties
Salem, Connecticut	Towns in Connecticut
Richland County, Montana	1914 establishments in Montana, Montana counties
Fulton, Arkansas	Towns in Arkansas
Goshen, Arkansas	Towns in Arkansas
Garland, Arkansas	Towns in Arkansas
Lexington, Oregon	Cities in Oregon
Interstate 95 in Pennsylvania	Pennsylvania
Greg Page	1972 births, Actors from Sydney, Musicians from Sydney, Australian singers, Australian guitarists, Multi-instrumentalists, Order of Australia, Living people
Anthony Field	1963 births, Australian singers, Australian drummers, Australian rock musicians, Australian Roman Catholics, Musicians from Sydney, Bass guitarists, Violinists, Keyboardists, Multi-instrumentalists, Rock guitarists, Living people, Order of Australia
Premarital sex	Human sexuality
Japanese serow	Caprids, Animals of Japan, Mammals of Asia
Japanese striped snake	Snakes
Six Gun Sal	2015 establishments, American musical groups
Ernst-Wolfgang Böckenförde	1930 births, 2019 deaths, German politicians, German writers, German judges
Leszek the Black	1240s births, 1280s deaths, Polish Roman Catholics, Polish people, Nobility
Holographic algorithm	Algorithms, Computer science
Ludhiana	Cities in India, Settlements in Punjab, India
Haridwar	Cities in India, Settlements in Uttarakhand
Trams in Kraków	Tram transport, Transport in Poland, Kraków
Garner, Arkansas	Towns in Arkansas
Georgetown, Arkansas	Towns in Arkansas
Gilbert, Arkansas	Towns in Arkansas
Griffithville, Arkansas	Towns in Arkansas
Harrell, Arkansas	Towns in Arkansas
Thornton, Arkansas	Cities in Arkansas
Tinsman, Arkansas	Towns in Arkansas
Coat of arms of Egypt	National coats of arms, Egypt
Roosevelt County, Montana	1919 establishments in Montana, Montana counties
Silver Bow County, Montana	1880s establishments in Montana Territory, 1881 establishments in the United States, Montana counties
Rosebud County, Montana	1900s establishments in Montana, 1901 establishments in the United States, Montana counties
Treasure County, Montana	1919 establishments in Montana, Montana counties
Edgemoor, Delaware	Census-designated places, Settlements in Delaware
Faridabad	Cities in India, Settlements in Haryana, Cities and towns in Haryana
Ghaziabad	Cities and towns in Uttar Pradesh
Bank of Slovenia	1991 establishments in Slovenia, Banks, Ljubljana
Gazprom	1989 establishments in Europe, 20th century establishments in Russia, Companies of Russia, Moscow
Paulo Nogueira Neto	1922 births, 2019 deaths, Deaths from pneumonia, Brazilian politicians, Environmentalists, People from São Paulo
Kidney stone disease	Diseases
Marella Agnelli	1927 births, 2019 deaths, Italian businesspeople, Royalty, People from Florence
Alojzy Orszulik	1928 births, 2019 deaths, Polish Roman Catholics, Roman Catholic bishops
Beverley Owen	1937 births, 2019 deaths, Deaths from ovarian cancer, American television actors, Actors from Iowa, Cancer deaths in Vermont
Hilde Zadek	1917 births, 2019 deaths, German centenarians, German singers
Christa Ludwig	1928 births, 2021 deaths, German singers
Frank Ballance	1942 births, 2019 deaths, Deaths from surgical complications, United States representatives from North Carolina, People from Winston-Salem, North Carolina, US Democratic Party politicians
Massillon, Ohio	Cities in Ohio
Jeff Adachi	1959 births, 2019 deaths, Deaths from myocardial infarction, American civil rights activists, American lawyers, Politicians from San Francisco, US Democratic Party politicians
Clark James Gable	1988 births, 2019 deaths, Drug-related accidental deaths in the United States, American movie actors, American television presenters, Models from California, American television actors, Actors from Malibu, California
Victor J. Banis	1937 births, 2019 deaths, Deaths from liver cancer, American novelists, LGBT writers, Gay men, LGBT people from Pennsylvania, Writers from Pennsylvania
Brody Stevens	1970 births, 2019 deaths, Suicides by hanging in the United States, American movie actors, American television actors, American voice actors, Actors from Los Angeles, California, Comedians from Los Angeles, California
Lisa Seagram	1936 births, 2019 deaths, Deaths from dementia, Disease-related deaths in California, American movie actors, American television actors, Actors from New York City

