William Dampier	1651 births, 1715 deaths, English explorers, People from Somerset
Alto Paraná Department	Departments of Paraguay
Ghana Kanta Basumatary	Actors, 1952 births, 2013 deaths
Tropical Storm Gamma (2005)	Atlantic tropical storms
Kherai Puja	Religious festivals, Indian culture
Ausserferrera	Villages in Graubünden, Former municipalities of Graubünden
Partial fraction decomposition	Algebra
Pygmy slow loris	Lorisoidea, Mammals of Asia
Punta La Marmora	Mountains of Italy, Sardinia
Joanne (album)	2016 albums, Pop albums, Dance albums, Rock albums, Lady Gaga albums
Milky Way–Andromeda collision	Spiral galaxies, Local galaxies, Milky Way
Slow loris	Lorisoidea
Scrapie	Animal diseases
Stone slab	Architecture
Marecchia	Rivers of Italy, Emilia-Romagna, Tuscany
Shijiazhuang	Cities in China
Manchu queue	Hairstyles
War bride	Marriage
Neravy	Towns in India, Settlements in Puducherry, Karaikal District
Catenary	Geometry
Perfect information	Mathematics
Holon Children's Museum	Museums in Israel, 2001 establishments, 2000s establishments in Israel
Compromise of 1850	Origins of the American Civil War, 1850s in California
Timeline of events leading to the American Civil War	Origins of the American Civil War
West London Synagogue	Synagogues, Buildings and structures in London
Julio César Turbay Ayala	1916 births, 2005 deaths, Presidents of Colombia
Conan the Barbarian (1982 movie)	1982 movies
Aisne (river)	Rivers of France, Grand Est, Hauts-de-France
Damodar River	Rivers of West Bengal, Rivers of Jharkhand
History of the United States (1789–1849)	History of the United States, 18th century in the United States, 19th century in the United States, Origins of the American Civil War
Domain name registrar	Internet standards, Computing, Electronics
Magnetic storage	Computers, Magnetism
Arrondissements of the Aisne department	Arrondissements of France
Union Defence Force (UAE)	United Arab Emirates, Military
Tecumseh	1768 births, 1813 deaths
Arrondissement of Château-Thierry	Arrondissements of France
Croquet	Sports
Computational linguistics	Computing
Arrondissement of Laon	Arrondissements of France
Arrondissement of Saint-Quentin	Arrondissements of France
Arrondissement of Soissons	Arrondissements of France
Arrondissement of Vervins	Arrondissements of France
Dhuys-et-Morin-en-Brie	Communes in Aisne
Gennifer Flowers	American television actors, American movie actors, Models from Oklahoma, Actors from Oklahoma City, 1950 births, Living people
IOS 10	Operating systems, IOS
Ivory-billed woodpecker	Piciformes
McCollough effect	Vision
Vallées-en-Champagne	Communes in Aisne
Mitch Hedberg	1968 births, Actors from Minnesota, American comedians, American stand-up comedians, Living people
Les Septvallons	Communes in Aisne
Decongestant	Drugs
2016–17 NHL season	National Hockey League seasons, 2016 in ice hockey, 2017 in ice hockey, 2016 in North America, 2017 in North America
Metropolitan Division	National Hockey League divisions
2015–16 NHL season	2015 in ice hockey, 2016 in ice hockey, National Hockey League seasons, 2015 in North America, 2016 in North America
List of United States senators from Utah	United States senators from Utah, Lists of politicians
Bagnes	Municipalities of Valais
Verbier	Ski areas and resorts in Switzerland, Villages in Valais
Piezoelectricity	Electricity
Bourg-Saint-Pierre	Municipalities of Valais, Cities in Switzerland
Liddes	Municipalities of Valais
Orsières	Cities in Switzerland, Municipalities of Valais
Yvan Cournoyer	1943 births, Living people, Canadian ice hockey right wingers, Conn Smythe Trophy winners, Hockey Hall of Fame inductees, Ice hockey people from Quebec, Montreal Canadiens players, Stanley Cup champions
2016 IIHF Challenge Cup of Asia	2016 in ice hockey, March 2016 events
2015–16 Euro Hockey Tour	2015 in ice hockey, 2016 in ice hockey
2015 IIHF Challenge Cup of Asia	2015 in ice hockey, 2015 in Asia, 2010s in Taiwan, March 2015 events
2016–17 NLA season	2016 in ice hockey, 2017 in ice hockey
John Gilliland	1935 births, 1998 deaths, American radio personalities, Entertainers from Texas
Eva Doležalová	Czech movie actors, Czech stage actors, Living people, 1991 births
2017 IIHF World U18 Championships	2017 in ice hockey, April 2017 events, Poprad, Sport in Slovakia
GNU Anubis	Free software
2014–15 NHL season	National Hockey League seasons, 2014 in ice hockey, 2015 in ice hockey, 2014 in North America, 2015 in North America
2013 World Junior A Challenge	2013 in ice hockey
2013 IPC Ice Sledge Hockey World Championships	2013 in ice hockey, April 2013 events, 2013 in Asia, 2010s in South Korea
2011–12 NLA season	2011 in ice hockey, 2012 in ice hockey
2013–14 NHL season	2013 in ice hockey, 2014 in ice hockey, National Hockey League seasons, 2014 in North America
2013–14 NLA season	2013 in ice hockey, 2014 in ice hockey
2012–13 NHL season	2012 in ice hockey, 2013 in ice hockey, National Hockey League seasons
2014 Pan American Ice Hockey Tournament	2014 in ice hockey
2011–12 NHL season	2011 in ice hockey, 2012 in ice hockey, National Hockey League seasons, 2011 in North America, 2012 in North America
2015 Stanley Cup Finals	Stanley Cup Finals, 2015 in ice hockey, Ice hockey competitions, Chicago Blackhawks, Tampa Bay Lightning, 2015 in Illinois, 2010s in Chicago, 2010s in Tampa, Florida, June 2015 events
2014 Stanley Cup Finals	Ice hockey competitions, Stanley Cup Finals, 2014 in ice hockey, June 2014 events, New York Rangers, 2014 in the United States, 2010s in Los Angeles, California, 2010s in New York City
2013 Stanley Cup Finals	Stanley Cup Finals, 2013 in ice hockey, Ice hockey competitions, June 2013 events, Boston Bruins, Chicago Blackhawks, 2013 in the United States, 2010s in Boston, Massachusetts, 2010s in Chicago
Hoek van Holland Haven metro station	Railway stations in Europe, Transport in the Netherlands, Rotterdam, 1893 establishments in Europe, 19th century establishments in the Netherlands
Dark web	Internet
Vollèges	Municipalities of Valais
Bellwald	Municipalities of Valais
Forever (Brooke Valentine song)	2012 songs
Virtual image	Light
Adult Use of Marijuana Act	2016 California elections
Novolac	Steroid hormones
Marxism–Leninism	Politics of the Soviet Union, Communism
Mahesh Chandra Mehta	1946 births, Living people, Indian lawyers
Dairy farming	Agriculture
Mambru Went to War	1986 movies, Spanish movies, Black comedy movies, Drama movies
Binn	Municipalities of Valais
Blitzingen	Former municipalities of Valais
The Many Adventures of Mr. Mailman	2006 American television series debuts, 2010 American television series endings, 2010 television series endings, American animated television series, British television series, 2000s television series, 2000s British television series, 2010s television series, 2010s British television series
Ukraine International Airlines	Airlines of Europe, Ukraine, 1992 establishments in Europe, 20th century establishments in Ukraine
MAX Linux	Operating systems, Community of Madrid
Nouvelle cuisine	Cooking, French culture
Afonso Africano (epic poem)	Epic poems
Sumitra Mahajan	1943 births, Living people, Speakers of the Lok Sabha
Kingdom of Galicia	Former countries in Europe, 5th century establishments in Europe, 409 establishments, 1230 disestablishments, Disestablishments in Europe
Sikandar Lodi	Indian monarchs
Talca Province	Provinces of Chile
Gertrude Bell	English writers
Orchard Island, Ohio	Unincorporated communities in Ohio
Ernen	Municipalities of Valais
Theory of mind	Science
Fiesch	Municipalities of Valais
Fieschertal	Villages in Valais, Municipalities of Valais
Grafschaft	Former municipalities of Valais
Lax, Switzerland	Municipalities of Valais
Niederwald, Switzerland	Former municipalities of Valais
Secession in the United States	Origins of the American Civil War
Curicó Province	Provinces of Chile
My Own Prison	1997 albums
Magnús Scheving	1964 births, Living people, Icelandic writers, Male athletes, Television actors, Television producers
Institut supérieur international du parfum, de la cosmétique et de l'aromatique alimentaire	Technical colleges and universities in France, 1970 establishments in France, Versailles
South African Border War	20th century conflicts, Wars involving Portugal, Wars involving South Africa, History of Namibia, 20th century in Angola, 1960s, 1970s, 1980s, 1990
Lindisfarne Castle	Castles in England
Curicó	Cities in Chile
Vasco Mouzinho de Quevedo	16th century births, 17th century deaths, Portuguese writers
Lyudmila Pavlichenko	1916 births, 1974 deaths, Soviet military personnel of World War II, Ukrainian people
Institut des sciences et techniques des Yvelines	Technical colleges and universities in France, 1992 establishments in Europe, 1990s establishments in France
2016 clown sightings	2016 in the United States, Clowns
Trident	Weapons, Greek mythology, Hindu mythology
Mary Anna Custis Lee	1808 births, 1873 deaths
Fred Hampton	1948 births, 1969 deaths, People from Chicago, American revolutionaries, Socialists, American civil rights activists, People shot dead by law enforcement officers in the United States
Patrick De Lacey	1835 births, 1915 deaths, United States Army Medal of Honor recipients, People from Pennsylvania
Norman F. Bates	1839 births, 1915 deaths, United States Army Medal of Honor recipients, People from Vermont
Carbondale, Pennsylvania	Cities in Pennsylvania
States' rights	Origins of the American Civil War
Mk 19	Weapons
Lampeter	Towns in Ceredigion
Obergesteln	Villages in Valais, Former municipalities of Valais
Oberwald	Villages in Valais, Former municipalities of Valais
Champex-Lac	Villages in Valais
Scripting language	Programming languages
Reckingen-Gluringen	Former municipalities of Valais
Ulrichen	Villages in Valais, Former municipalities of Valais
Emilia Lanier	1569 births, 1645 deaths, English poets
Satyameva Jayate	National symbols of India
Angioedema	Health problems
Institut d'études politiques de Saint-Germain-en-Laye	Education in France
Obergoms	2009 establishments in Switzerland, Municipalities of Valais
Ain (river)	Rivers of France, Bourgogne-Franche-Comté, Auvergne-Rhône-Alpes
WSTRN	2010s establishments in England, 2015 establishments in Europe, Hip hop bands, Musical groups from London, Musical groups established in 2015, Musical trios
Human skeleton	Bones, Human body features
Brihadisvara Temple, Gangaikonda Cholapuram	World Heritage Sites in India, Hindu temples, Temples in India, 11th century establishments in Asia, Establishments in India
Didier Guillemot	Living people, 1960 births, French educators, French biologists, Presidents of the Université de Versailles Saint-Quentin-en-Yvelines, Versailles Saint-Quentin-en-Yvelines University faculty
Joseph Gérard	1831 births, 1914 deaths, Christian saints, French people, Missionaries
Ambattur	Settlements in Tamil Nadu
SJ T21	MaK locomotives
Vossloh DE 18	Vossloh locomotives, Bo-Bo locomotives
SNCF Class BB 61000	Vossloh locomotives, Bo-Bo locomotives
SNCF 040.DF	SNCF locomotives, Bo-Bo locomotives
TCDD DH3600	MaK locomotives, C locomotives
SNCF Class BB 7200	SNCF locomotives, B-B locomotives
Composition of the Russian Regional Parliaments	Politics of Russia
Crêt de la Neige	Mountains of France, Auvergne-Rhône-Alpes
2016 United States presidential election in California	2016 California elections, 2016 United States presidential election by state
Udara	Lycaenidae
President-elect of the United States	United States presidential elections
O.T. Genasis	American hip hop musicians, 1987 births, Singers from Atlanta, Georgia, Living people, Musicians from Atlanta, Georgia, Stage names
Laura Ashley	1925 births, 1985 deaths, Welsh people, Fashion designers
Javanese gamelan	Orchestras
Itapúa	Departments of Paraguay
2016 United States presidential election in Alaska	History of Alaska, 2016 United States presidential election by state
Dakota people	Native American
Mie Jans	1994 births, Living people, Danish footballers
President Lincoln's 75,000 volunteers	Origins of the American Civil War
Survivor Series (2016)	2016 in sports, November 2016 events, Sport in Toronto, Survivor Series, 2010s in Toronto
Hérémence	Municipalities of Valais
Corporate tax	Taxation
Cooperative	Business
WWE Raw Tag Team Championship	World Wrestling Entertainment championships, 2002 establishments
Perfect Illusion	Lady Gaga songs, 2016 songs, Pop songs, Lady Gaga
Georgian Wikipedia	Wikipedias
Malagasy Wikipedia	Wikipedias
Breton Wikipedia	Wikipedias, Websites established in 2004
Vítězslav Nezval	1900 births, 1958 deaths, Czech poets
Bamboo floor	Building materials, Bamboo
Vinča culture	Stone Age
Vinča script	Stone Age
American Expeditionary Force	World War I, American military personnel of World War I
Ministers of Foreign Affairs of Azerbaijan	Lists of politicians, Government of Azerbaijan, Azerbaijani politicians, Azerbaijan-related lists
Hair clipper	Tools, Hair
Merry Christmas with Love	2004 albums
Arauco Province	Provinces of Chile
Rocky De La Fuente	1954 births, Living people, 2020 United States presidential candidates, 2016 United States presidential candidates, Businesspeople from California, Politicians from Florida, Politicians from San Diego, California, US Democratic Party politicians
Rocky De La Fuente 2016 presidential campaign	2016 United States presidential campaigns
Catherine Cortez Masto	1964 births, Living people, United States senators from Nevada, American lawyers, Politicians from Las Vegas, Nevada, US Democratic Party politicians
Todd Young	1972 births, Living people, American military people, United States representatives from Indiana, United States senators from Indiana, US Republican Party politicians, University of Chicago alumni
Evan Bayh	1955 births, Living people, United States senators from Indiana, Governors of Indiana, US Democratic Party politicians
John C. Carney Jr.	1956 births, Living people, American Roman Catholics, Governors of Delaware, Politicians from Wilmington, Delaware, United States representatives from Delaware, US Democratic Party politicians, Lieutenant Governors of Delaware
Eric Holcomb	1968 births, Living people, Governors of Indiana, Lieutenant Governors of Indiana, Politicians from Indianapolis, Indiana, US Republican Party politicians
Eric Greitens	1974 births, Living people, Governors of Missouri, Writers from St. Louis, Missouri, American military people, American activists, US Republican Party politicians, Politicians from St. Louis, Missouri
Chris Sununu	1974 births, Living people, Governors of New Hampshire, US Republican Party politicians
Doug Burgum	1956 births, Living people, Governors of North Dakota, Businesspeople from North Dakota, American philanthropists, US Republican Party politicians
Phil Scott	1958 births, Living people, Governors of Vermont, Businesspeople from Vermont, US Republican Party politicians, Lieutenant Governors of Vermont
Jim Justice	1951 births, Living people, Governors of West Virginia, Businesspeople from West Virginia, US Republican Party politicians
Jodo	Martial arts
Conor McGregor	1988 births, Living people, Boxers, Mixed martial artists, Sportspeople from Dublin
The Nutshack	Sitcoms, English-language television programs
Aquarius (astrology)	Astrological signs
Roger Joseph Boscovich	Croatian scientists, Mathematicians
Les Agettes	Former municipalities of Valais, Sion, Switzerland
Mase, Switzerland	Former municipalities of Valais
Nax	Former municipalities of Valais
Saint-Martin, Valais	Municipalities of Valais
Ventilation	Buildings and structures
African Americans in the American Civil War	African-American history, American Civil War
Arrondissements of the Ardennes department	Arrondissements of France
Gwen Ifill	1955 births, 2016 deaths, Cancer deaths in Washington, D.C., Deaths from endometrial cancer, American television news anchors, American journalists, Writers from New York City
Leon Russell	1942 births, 2016 deaths, Deaths from surgical complications, Deaths from heart failure, American singer-songwriters, American country singers, American country guitarists, American rock guitarists, American rock singers, American folk singers, American blues musicians, American pianists, People from Lawton, Oklahoma, Musicians from Oklahoma, Singers from Oklahoma, Singers from Nashville, Tennessee, Musicians from Tennessee
Lincolnshire, Illinois	Villages in Illinois
Arrondissement of Charleville-Mézières	Arrondissements of France
Ricardo Rosselló	1979 births, Living people, Governors of Puerto Rico, US Democratic Party politicians, People from San Juan, Puerto Rico
Charles Wesley Turnbull	1935 births, Living people, Governors of the United States Virgin Islands, US Democratic Party politicians
Pedro Tenorio	1934 births, 2018 deaths, Deaths from stroke, Governors of the Northern Mariana Islands, US Republican Party politicians
Paul McDonald Calvo	1934 births, Living people, Governors of Guam, US Republican Party politicians
Carlos G. Camacho	1924 births, 1979 deaths, Deaths from myocardial infarction, Governors of Guam, US Republican Party politicians
Carlos S. Camacho	1937 births, Living people, Governors of the Northern Mariana Islands, US Democratic Party politicians
Peter Tali Coleman	1919 births, 1997 deaths, Deaths from liver cancer, Governors of American Samoa, US Republican Party politicians
A. P. Lutali	1919 births, 2002 deaths, Deaths from stroke, Governors of American Samoa, US Democratic Party politicians
Kay Starr	1922 births, 2016 deaths, Deaths from Alzheimer's disease, Disease-related deaths in California, American pop singers, Singers from Oklahoma
Blinky Bill (2015 movie)	Animated movies, Australian comedy movies, Movies about animals, Movies set in Australia
Ryan Kwanten	Australian movie actors, Australian voice actors
David Wenham	1965 births, Living people, Actors from Sydney, Australian movie actors, Australian stage actors, Australian television actors, Australian voice actors, Screen Actors Guild Award winners
Robin McLeavy	Australian movie actors, Australian voice actors
Deborah Mailman	Australian movie actors, Australian voice actors
Enantiornithes	Cretaceous birds
Barry Otto	Australian movie actors, Australian voice actors
History of the automobile	Automobiles, History of transport
Arrondissement of Rethel	Arrondissements of France
Arrondissement of Sedan	Arrondissements of France
Antero de Quental	1842 births, 1891 deaths, Poets
Arrondissement of Vouziers	Arrondissements of France
Mose Allison	1927 births, 2016 deaths, Deaths from natural causes, American jazz musicians, American blues musicians, American pianists, American songwriters, Trumpeters, Singers from Mississippi, Musicians from Mississippi, Writers from Mississippi
Robert A. McDonald	1953 births, Living people, United States Secretaries of Veterans Affairs, Politicians from Indiana, People from Gary, Indiana, American chief executives, Businesspeople from Indiana, US Republican Party politicians
Steven Mnuchin	1962 births, Living people, Bankers, Businesspeople from California, Businesspeople from New York City, Movie producers from California, Movie producers from New York City, Jewish American politicians, Jewish businesspeople, Politicians from California, Politicians from New York City, United States Secretaries of the Treasury, US Republican Party politicians, Yale University alumni
Fugitive slave laws	Origins of the American Civil War, Slavery, African-American history
Jack Vettriano	1951 births, Living people, Scottish painters, Officers of the Order of the British Empire
Devendra Jhajharia	1981 births, Living people
Umayyad conquest of Hispania	History of Portugal, History of Spain, Caliphates, 8th century
John Brown's Body (epic poem)	Epic poems
Slave Power	Origins of the American Civil War, Slavery
Neotribalism	Sociology
Rory's Place	1997 American television series debuts, 1999 American television series endings, 1990s American television series, 2000s American television series, American animated television series, American children's television series
Protests against Donald Trump	Politics, 2010s, Donald Trump
Tory Lanez	1992 births, Living people, Hip hop musicians, Singers
Turkification	Turkey, Nationalism
Zugangserschwerungsgesetz	Law, Germany
Newton Aycliffe	Towns in County Durham
NP-hardness	Theoretical computer science
Vernamiège	Former municipalities of Valais
Lake Louise (Alberta)	Lakes of Canada, Alberta
Anastasio Somoza García	1896 births, 1956 births, Presidents of Nicaragua
Stevo Todorčević	Living people, 1955 births
Mont-Noble	2011 establishments in Switzerland, Municipalities of Valais
Bratsch	Villages in Valais, Former municipalities of Valais
Ergisch	Municipalities of Valais
Erschmatt	Former municipalities of Valais
Ritzingen	Villages in Valais, Former municipalities of Valais
Selkingen	Villages in Valais, Former municipalities of Valais
Burlington County, New Jersey	17th-century establishments in New Jersey, 1690s establishments in the Thirteen Colonies, 1694, New Jersey counties
Judea (Roman province)	Provinces
Mut	Egyptian gods and goddesses
Sopdet	Egyptian gods and goddesses
Monthu	Egyptian gods and goddesses
Qetesh	Egyptian mythology
Arrondissements of the Var department	Arrondissements of France
Wosret	Egyptian mythology
Wepwawet	Egyptian mythology
East Africa Time	Time zones
Arrondissement of Draguignan	Arrondissements of France
Tatenen	Egyptian mythology
Heka (god)	Egyptian gods and goddesses
Arrondissement of Brignoles	Arrondissements of France
Cree language	Languages
Arrondissement of Toulon	Arrondissements of France
The Humane Society of the United States	Animal rights, Non-profit organizations of Washington, D.C., Ethics, 1954 establishments in the United States, 20th-century establishments in Washington, D.C.
Blockade runners of the American Civil War	American Civil War
Franklin Township, Somerset County, New Jersey	Townships in New Jersey
Valles Marineris	Mars, Canyons
Beatboxing	Percussion instruments
Golaghmuli Valley	Gilgit-Baltistan
Battle of Stamford Bridge	Battles involving England, Battles of the Middle Ages, 1066 in England
François Villon	1431 births, 1460s deaths, French poets
David Gentleman	1930 births, Living people, British artists
Gampel	Former municipalities of Valais, Villages in Valais
Gampel-Bratsch	Municipalities of Valais, 2009 establishments in Switzerland
Weather vane	Ancient Greece, Weather instruments
Tatar Wikipedia	Wikipedias
Arrector pili	Anatomy
Guttet-Feschel	Municipalities of Valais
Inden, Switzerland	Municipalities of Valais
Leukerbad	Ski areas and resorts in Switzerland, Municipalities of Valais
Oberems, Switzerland	Municipalities of Valais
Var (river)	Rivers of France, Provence-Alpes-Côte d'Azur
Friesian horse	Horse breeds, Frisian culture
Beverly Tyler	1927 births, 2005 deaths, Actors from Pennsylvania, American movie actors, American stage actors, American television actors, Singers from Pennsylvania
Irving A. Fradkin	1921 births, 2016 deaths, American philanthropists, Businesspeople from Massachusetts
Sharon Jones	1956 births, 2016 deaths, American funk singers, American R&B singers, American soul singers, Cancer deaths in New York, Deaths from pancreatic cancer, People from Augusta, Georgia, Singers from Georgia (U.S. state), Singers from New York City
António Guterres	1949 births, Living people, People from Lisbon, Prime Ministers of Portugal, Socialists, United Nations High Commissioners for Refugees
Christos Sartzetakis	1929 births, Living people, Chief justices, Presidents of Greece
Michael Flynn	1958 births, Living people, American generals, Politicians from Rhode Island, United States National Security Advisors, US Democratic Party politicians
Steve Bannon	1953 births, Living people, Politicians from Virginia, Businesspeople from Virginia, US Republican Party politicians
Joe Kennedy III	1980 births, Living people, American lawyers, American Roman Catholics, Harvard University alumni, Kennedy family, Politicians from Boston, Massachusetts, Stanford University alumni, United States representatives from Massachusetts, US Democratic Party politicians
Adam Kokesh	1982 births, Living people, American political activists, American military people, American political writers, Politicians from New Mexico, Politicians from Arizona, Politicians from San Francisco, People from Santa Fe, New Mexico, Writers from San Francisco, Writers from New Mexico, Writers from Arizona, US Libertarian Party politicians, 2020 United States vice-presidential candidates, 2020 United States presidential candidates
Black Awareness Day	Holidays, Brazil
Pukhrayan train derailment	Railway accidents in India, 2016 in India
Mount Selinda	Cities in Zimbabwe
Afrocarpus falcatus	Conifers
Latin rock	Rock music, Latin music, Music genres
New York City Hall	Government buildings, Buildings and structures in Manhattan, New York City Designated Landmarks, 1812 establishments in the United States, 1810s establishments in New York (state)
Gateway drug theory	Drugs, Health
Kavaratti	Cities in India, Atolls
Jnaneswari Express train derailment	2010 crimes, 2010 disasters, 2010 in India, Mass murder in Asia, Mass murder in the 2010s, May events, Murder in India, Railway accidents in India, Terrorist incidents in Asia in the 2010s, West Bengal
2004 Sri Lanka tsunami train wreck	2004, 2000s in Asia, 21st century in Sri Lanka, December events, Disasters in the 2000s, Railway accidents in Asia
Charlottetown Conference	History of Canada
National Anthem of Saudi Arabia	Saudi Arabia, National anthems
Agave nectar	Mexican food, Sweeteners, Syrup
Chuvash language	Chuvash Republic, Languages of Russia, Turkic languages
Playback singer	Music industry, Singers
Bihar train derailment	1981 in Asia, 1980s in India, Bihar, Disasters in the 1980s, June events, Railway accidents in India
Firozabad rail disaster	1995, 1990s in India, August events, Disasters in the 1990s, Railway accidents in India, Uttar Pradesh
Gordon Welchman	1906 births, 1985 deaths, Alumni of the University of Cambridge, British academics, English mathematicians, English writers, Massachusetts Institute of Technology faculty, People from Bristol
Accession	Politics
Charkhi Dadri mid-air collision	Aviation disasters in Asia, Haryana, Disasters in India, Aviation disasters in the 1990s, 1996, 1990s in India
Church of the Company Fire	1863, Fires, History of Chile, December events
1931 China floods	Floods in Asia, Natural disasters in China, 1931, 1930s in China
Trans-Siberian Orchestra	American rock bands, 1996 establishments in the United States
Great Chinese Famine	Disasters in the 20th century, Natural disasters in China, 1950s in China, 1960s in China
Confederate States Navy	Confederate States of America
Joan Chen	American movie producers, American movie directors, American movie actors, Chinese movie directors, Chinese movie actors, Chinese movie producers, 1961 births, Living people
Sylvia Chang	Chinese movie actors, Chinese movie directors, Chinese movie producers, 1953 births, Living people
Azerbaijanfilm	Movie studios, 1920 establishments in Azerbaijan, Azerbaijani culture, Buildings and structures in Baku
Cognitive impairment	Disability
Borderline intelligence	Disability
2016 United States presidential election in Texas	2016 in Texas, 2016 United States presidential election by state
Profilage	French television series, Police television series, 2009 establishments in France
Vegas Golden Knights	Vegas Golden Knights
Salgesch	Municipalities of Valais
Turtmann	Former municipalities of Valais
Janjaweed	Sudan, Rebel militia groups in Africa
Unterems	Former municipalities of Valais
Turtmann-Unterems	Municipalities of Valais, 2013 establishments in Switzerland
Varen, Switzerland	Municipalities of Valais
Bovernier	Municipalities of Valais
Septic shock	Medicine
Evan McMullin	1976 births, Living people, American Latter Day Saints, Civil servants, Politicians from Utah, 2016 United States presidential candidates
Bulgogi	Korean food, Meat dishes
They	Pronouns
Lençóis Maranhenses National Park	National parks in South America, Habitats
Military glider	World War II aircraft
Freedom of Information Act 2000	Acts of the Parliament of the United Kingdom, 2000s in the United Kingdom
Cannabis (drug)	Cannabis
Draguignan	Subprefectures in France, Communes in Var
The Conquest of Malacca (epic poem)	Epic poems, Portuguese culture, 17th century works
Bielski partisans	World War II, Nazi Germany, Holocaust survivors
Roman dictator	Roman Republic
Vargas tragedy	Floods, 20th century in Venezuela, 1999, December events, 1990s in South America
Charrat	Municipalities of Valais
Fully	Municipalities of Valais
Isérables	Municipalities of Valais
Leytron	Municipalities of Valais
Martigny-Combe	Municipalities of Valais
Riddes	Municipalities of Valais
Viriato Trágico	Epic poems
Saillon	Municipalities of Valais, Cities in Switzerland
SPQR	Roman Republic
The National Museum of Computing	Museums in England, National museums, Computing, Scientific organizations
Day of the Dead	Mexican culture, Festivals in North America, November events
Betsy DeVos	1958 births, Living people, American activists, American billionaires, American educators, American Evangelicals, American philanthropists, People from Holland, Michigan, Businesspeople from Grand Rapids, Michigan, Politicians from Grand Rapids, Michigan, Richard DeVos, United States Secretaries of Education, US Republican Party politicians
Orville Turnquest	1929 births, Living people, Governors-General of the Bahamas
Ivy Dumont	1930 births, Living people, Governors-General of the Bahamas
Luis García Meza Tejada	1929 births, 2018 deaths, Deaths from myocardial infarction, Anti-Communists, Former dictators, Generals, Presidents of Bolivia, South American military people
Gonzalo Sánchez de Lozada	1930 births, Living people, Presidents of Bolivia
I'll Be Missing You	1997 songs
Hate groups in the United States	Hatred, United States
SMS Posen	German Empire, Warships, World War I
No. 77 Squadron RAAF	Military of Australia
Gautam	Hindu mythology
Atri	Hindu mythology
Bodo language	Languages of India, Sino-Tibetan languages
Piotta	Villages in Ticino
Ambrì	Villages in Ticino
Saxon, Switzerland	Municipalities of Valais
Trient, Switzerland	Municipalities of Valais
Champéry	Municipalities of Valais
The Fall of Nineveh (poem)	Epic poems
Sir Breunor	Arthurian legend, Fictional knights
1936 North American heat wave	Droughts, 1936 in North America, 1930s in the United States
Collombey-Muraz	Municipalities of Valais
Port-Valais	Municipalities of Valais
Saint-Gingolph, Switzerland	Municipalities of Valais
Troistorrents	Municipalities of Valais
Val-d'Illiez	Municipalities of Valais
La Fouly	Villages in Valais
Everton Kempes dos Santos Gonçalves	1982 births, 2016 deaths, Brazilian footballers
Alappuzha	Cities in Kerala
Zakir Husain (politician)	Vice Presidents of India, 1897 births, 1969 deaths
Puducherry district	Puducherry
Yellowstone fires of 1988	1980s fires, 1988 establishments in the United States, Natural disasters in the United States
Confederate States Marine Corps	Confederate States of America
Chennai district	Chennai District
Thanjavur district	Thanjavur District
Cuddalore district	Cuddalore district
Manchester Metropolitan University	Universities in England
Vionnaz	Municipalities of Valais
Vouvry	Municipalities of Valais
Ausserberg	Municipalities of Valais
Arrondissements of the Indre-et-Loire department	Arrondissements of France
Arrondissement of Chinon	Arrondissements of France
Azerbaijani independence referendum, 1991	Soviet Union, 1991 in Europe, 1990s in Azerbaijan, Politics of Azerbaijan, 1991 in Asia
Arrondissement of Tours	Arrondissements of France
West Indian manatee	Sirenia
Arrondissement of Loches	Arrondissements of France
Xeroderma pigmentosum	Genetic disorders
James Bradley	1693 births, 1762 deaths, English astronomers
1962 Stanley Cup Finals	Stanley Cup Finals, Toronto Maple Leafs, Chicago Blackhawks, 1962 in ice hockey, 1962 in the United States, 1960s in Chicago, 1960s in Canada
Betten	Former municipalities of Valais
Silesian Wikipedia	2008 establishments, Wikipedias
Eshtaol Forest	Forests, Geography of Israel
Ganges Delta	River deltas
Piedmontese Wikipedia	Wikipedias
Latvian Wikipedia	Websites established in 2003, Wikipedias
Bosnian Wikipedia	Websites established in 2002, Wikipedias
Luxembourgish Wikipedia	Wikipedias
Neapolitan Wikipedia	Wikipedias
Salem district	Salem District
École nationale supérieure d'électrotechnique, d'électronique, d'informatique, d'hydraulique et des télécommunications	Technical colleges and universities in Toulouse, 1907 establishments in Europe, 1900s establishments in France
Thiruvarur district	Thiruvarur district
Madurai district	Madurai district
2016 Kaikoura earthquake	2016 earthquakes, Earthquakes in New Zealand, November 2016 events, 2010s in New Zealand
Infobot	Internet Relay Chat, Software
Parole	Legal terms
Coverture	Legal terms
Form-based interface	Computers
Metric space	Functions and mappings, Set theory
Brahmanas	Hinduism
Bister, Switzerland	Municipalities of Valais
Bitsch, Switzerland	Municipalities of Valais
Blatten (Lötschen)	Municipalities of Valais, Villages in Valais
Bürchen	Municipalities of Valais
Land of Punt	Ancient Egypt
Eischoll	Municipalities of Valais
Ferden	Municipalities of Valais
Filet, Switzerland	Former municipalities of Valais
Grengiols	Municipalities of Valais
Sihlbrugg	Villages in Zürich
Mülenen	Villages in Bern
Auressio	Villages in Ticino, Former municipalities of Ticino
Dumbarton	Towns in Scotland
Roy Cooper	1957 births, Living people, Governors of North Carolina, American lawyers, US Democratic Party politicians
Marne (river)	Rivers of France, Grand Est, Hauts-de-France, Île-de-France
Wilbur Ross	1937 births, Living people, Businesspeople from New Jersey, Politicians from New Jersey, American billionaires, United States Secretaries of Commerce, US Republican Party politicians
Elaine Chao	1953 births, Living people, Harvard University alumni, Naturalized citizens of the United States, Politicians from Kentucky, Businesspeople from Kentucky, Taiwanese businesspeople, United States Secretaries of Labor, United States Secretaries of Transportation, US Republican Party politicians
Tom Price	1954 births, Living people, American physicians, People from Dearborn, Michigan, People from Lansing, Michigan, Politicians from Michigan, United States representatives from Georgia, United States Secretaries of Health and Human Services, US Republican Party politicians
James Mattis	1950 births, Living people, American generals, Independent politicians in the United States, Politicians from Washington, United States Secretaries of Defense
Bernardo Bertolucci	1940 births, 2018 deaths, Deaths from lung cancer, Italian movie directors, Italian screenwriters, People from Emilia-Romagna
Giuseppe Caselli	1893 births, 1976 deaths, Italian painters
Sultan Rahi	1938 births, 1996 deaths, Cinema of Pakistan, Pakistani movie actors, Movie producers, Pakistani people, Punjabi people, People from Uttar Pradesh
Madurai Meenakshi Amman temple	Hinduism, Madurai district
2015 South Indian floods	2015 disasters in Asia, 2015 in India, 2010s floods, Andhra Pradesh, December events, Floods in India, November 2015 events, Tamil Nadu
Cuddalore	Cuddalore district
Adyar River	Chennai District, Rivers of Tamil Nadu
Cooum River	Rivers of Tamil Nadu, Chennai District
Hugues Quiéret	1290 births, 1340 deaths, French military people, Hundred Years' War
Hamamatsu festival	Japanese culture, Festivals in Asia, 1558 establishments, 16th century establishments in Japan, May events
Wat Yai Chai Mongkhon	Buddhist temples in Thailand
Hyeokgeose	Korea, History of Korea, 69 BC births
Selenocysteine	Amino acids
Hohtenn	Former municipalities of Valais, Villages in Valais
Kippel	Municipalities of Valais
Animal track	Zoology
Congress of the Confederate States	Confederate States of America
The Bridge (poem)	Epic poems
Postal codes in Switzerland and Liechtenstein	Switzerland-related lists, Liechtenstein, Postal codes
Nendeln	Villages in Liechtenstein
Schaanwald	Villages in Liechtenstein
Connor McDavid	1997 births, Art Ross Trophy winners, Canadian ice hockey centres, Edmonton Oilers players, Hart Memorial Trophy winners, Ice hockey people from Ontario, Living people, Ontario Hockey League players
American Eskimo Dog	Dog breeds
Machalilla National Park	National parks in South America, Geography of Ecuador
Street cricket	Cricket
Synchronized diving	Diving, Summer Olympic sports
TWA Flight 800	Aviation disasters in the United States, 1996 in the United States, Accidental deaths, Aviation disasters in the 1990s, 1990s in New York (state), Conspiracy theories
Arrondissements of the Haute-Marne department	Arrondissements of France
Arrondissements of the Marne department	Arrondissements of France
2016 Oakland warehouse fire	2016 disasters, 2016 in California, 2010s fires, December 2016 events, Fires in the United States, Oakland, California
Arrondissement of Châlons-en-Champagne	Arrondissements of France
Arrondissement of Épernay	Arrondissements of France
Arrondissement of Reims	Arrondissements of France
Vaganova Ballet Academy	Ballet companies
Kishiwada Danjiri Festival	Festivals in Asia
Alissa White-Gluz	1985 births, Living people, Canadian singers
UEFA Euro 2016 squads	UEFA Euro 2016 players
Arrondissement of Vitry-le-François	Arrondissements of France
Arrondissement of Sainte-Menehould	Arrondissements of France
Multiplication table	Mathematics
Magistrate	Law occupations, Judges
Arrondissement of Chaumont	Arrondissements of France
Arrondissement of Langres	Arrondissements of France
Arrondissement of Saint-Dizier	Arrondissements of France
Herod the Great	Kings and queens, Jerusalem, 4 BC
Linus Sebastian	YouTube
1824 United States presidential election	1824 in the United States, United States presidential elections
Wigan Warriors	Rugby
Super League	Rugby
Nissan Navara	Nissan automobiles, 1990s automobiles, 2000s automobiles, 2010s automobiles
Andrew Puzder	1950 births, Living people, Businesspeople from Cleveland, Ohio, Businesspeople from Tennessee, Politicians from Cleveland, Ohio, Politicians from Tennessee, US Republican Party politicians
Joseph Mascolo	1929 births, 2016 deaths, Deaths from Alzheimer's disease, American movie actors, American television actors, Musicians from Connecticut, Actors from Connecticut, People from West Hartford, Connecticut
Associação Chapecoense de Futebol	Brazilian football clubs, 1976 establishments in Brazil
Virtual reality	Computer graphics, Electronics
Martisberg	Former municipalities of Valais
Mörel, Switzerland	Former municipalities of Valais
Bettmeralp	2014 establishments in Switzerland, Ski areas and resorts in Switzerland, Municipalities of Valais, Villages in Valais
Vincent Laforet	Living people, American movie directors, American photographers, 1975 births
Associação Atlética Ponte Preta	Brazilian football clubs
Clube Náutico Capibaribe	Brazilian football clubs, Recife, 1931 establishments in Brazil
Raising Hope	American sitcoms, 2010s American television series, 2010 American television series debuts, English-language television programs
Citropsis articulata	Citrus
Mannheim Steamroller	Rock bands, 1970s American music groups, 1980s American music groups, 1990s American music groups, 2000s American music groups, 2010s American music groups
Christmas music	Christmas music
Ta Moko	Maori, Body art
Sekkizhar	Indian poets
Turkish Airlines Flight 981	1974 in Europe, 20th century in France, Aviation disasters in Europe, Aviation disasters in the 1970s, Hauts-de-France, March events
Cuttack	India, Cities in India
Deomali (mountain)	Mountains of India
Danish Football Association	1889 establishments in Europe
Mörel-Filet	2009 establishments in Switzerland, Municipalities of Valais
Niedergesteln	Municipalities of Valais
Tryptophan	Amino acids
Saint-Dizier	Communes in Haute-Marne, Subprefectures in France
Adam Ries	German mathematicians
Robot lawyer	Artificial intelligence, Law
Cheryl	Given names
Al-Masih ad-Dajjal	Islam, Mythology
Australian impact structure	Impact craters, Geography of Australia
Azerbaijan Red Crescent Society	Red Cross, Baku, Charities, 1920 establishments in Azerbaijan
Shoemaker crater	Impact craters, Geography of Western Australia
Immortals (2011 movie)	2011 movies, Movies based on Greek and Roman mythology
Capital asset pricing model	Economics
Wisconsin in the American Civil War	American Civil War, 19th century in Wisconsin
John Howard Northrop	1891 births, 1987 deaths, American biochemists, American Nobel Prize winners, Nobel Prize in Chemistry winners
California in the American Civil War	American Civil War, 19th century in California
Quassel	IRC clients
Palisade cell	Plant anatomy, Plant physiology
Extermination through labor	The Holocaust
GN-z11	Galaxies
Konversation	IRC clients
Lagerordnung	The Holocaust
Guanacaste	Fabaceae, Trees
Rex Tillerson	1952 births, Living people, Businesspeople from Texas, Politicians from Texas, United States Secretaries of State, US Republican Party politicians, 21st-century American politicians, People from Irving, Texas
John F. Kelly	1950 births, Living people, American military people, White House Chiefs of Staff, United States Secretaries of Homeland Security, Politicians from Boston, Massachusetts, Independent politicians in the United States
Scott Pruitt	1968 births, Living people, Administrators of the United States Environmental Protection Agency, American lawyers, Politicians from Kentucky, Politicians from Oklahoma, US Republican Party politicians, State legislators of the United States
Linda McMahon	1948 births, Living people, Businesspeople from North Carolina, Businesspeople from Connecticut, Administrators of the Small Business Administration, Politicians from North Carolina, Politicians from Connecticut, US Republican Party politicians
Azerbaijan State Symphony Orchestra	Orchestras, 1920 establishments in Azerbaijan, Azerbaijani culture
Diana Lynn	Actors from Los Angeles, California, American movie actors, American stage actors, American television actors, Deaths from stroke, 1926 births, 1971 deaths
Jason Kander	1981 births, Living people, Politicians from Kansas, Politicians from Missouri, US Democratic Party politicians, State legislators of the United States
John Neely Kennedy	1951 births, Living people, United States senators from Louisiana, Politicians from Mississippi, US Republican Party politicians
Sun of May	National symbols
Peter van Straaten	1935 births, 2016 deaths, Cartoonists, Comics artists, Dutch artists, People from Amsterdam, People from Arnhem, Writers from Gelderland
Alan Thicke	1947 births, 2016 deaths, Actors from Ontario, Canadian movie actors, Canadian songwriters, Canadian television actors, Canadian television presenters, Cardiovascular disease deaths in Los Angeles County, California, Deaths from aortic dissection, Writers from Ontario
Jewish diaspora	Jewish history
Shirley Hazzard	1931 births, 2016 deaths, Deaths from dementia, Naturalized citizens of the United States, Writers from Sydney
Frederick Wiseman	1930 births, Living people, American movie directors, American historians, Writers from Boston, Massachusetts
Anne V. Coates	Academy Award winners, BAFTA Award winners, 1925 births, 2018 deaths, British movie editors, People from Surrey
David Somerset, 11th Duke of Beaufort	1928 births, 2017 deaths, People from Gloucestershire, British billionaires
Lester L. Wolff	1919 births, 2021 deaths, American centenarians, Jewish American politicians, Politicians from New York City, United States representatives from New York, US Democratic Party politicians
Field hockey at the 2012 Summer Olympics – Men's tournament	2012 Summer Olympics, Field hockey
Fisher-Price	Companies of the United States, 1920 establishments in the United States
Matchbox (brand)	Toys, 1930 establishments in the United States
Die-cast toy	Toys
West African Vodun	African traditional religions, Voodoo
Caaguazú Department	Departments of Paraguay
Ulisseia (epic poem)	Epic poems
Kevin Shinick	Actors from New York, American voice actors, American television producers, American television writers, 1969 births, Living people
Bill English	1961 births, Living people, Prime Ministers of New Zealand, Deputy Prime Ministers of New Zealand, Leaders of the Opposition (New Zealand)
Big data	Computing, Information, Statistics, Privacy
European Women's Handball Championship	Handball, Sport in Europe, 1994 establishments in Europe
Thirunallar Saniswaran temple	Hindu temples, Temples in India
Nagore	Nagapattinam district
Nellore	Settlements in Andhra Pradesh, Cities in India
Protologism	Language
Riederalp	Municipalities of Valais
Steg, Switzerland	Former municipalities of Valais
Tirupati	Settlements in Andhra Pradesh, Cities in India
Chittoor	Settlements in Andhra Pradesh, Cities in India
Ajmer	Settlements in Rajasthan, Cities in India
Arrondissements of the Aube department	Arrondissements of France
Arrondissement of Bar-sur-Aube	Arrondissements of France, Grand Est
Arrondissement of Nogent-sur-Seine	Arrondissements of France, Grand Est
Arrondissement of Troyes	Arrondissements of France, Grand Est
A14 road (Great Britain)	Roads in England
Karaikal Ammaiyar Temple	Hindu temples, Temples in India, Karaikal District, 1929 establishments, 1920s establishments in India
Kadapa	Cities in India, Settlements in Andhra Pradesh
Vadodara	Settlements in Gujarat, Cities in India
Vijayawada	Cities in India
Vellore	Cities in Tamil Nadu, Vellore District
Warangal	Cities in India
James Gillray	Cartoonists
The Elf on the Shelf	2004 books, Christmas
Debutante	Social groups
Fentanyl	Analgesics
Aube (river)	Rivers of France, Grand Est, Bourgogne-Franche-Comté
Terza rima	Poetry forms
Therapeutic index	Medicine
Geodetic datum	Coordinate systems, Cartography, Navigation, Geodesy
Sic semper tyrannis	Virginia, Latin state mottos of the United States
Karl Ernst von Baer	1792 births, 1876 deaths
European Russia	Geography of Russia
Foreign and Commonwealth Office	Departments of the United Kingdom Government
École nationale supérieure de mécanique et d'aérotechnique	Technical colleges and universities in France, 1948 establishments in Europe, Poitiers, 1940s establishments in France
Steg-Hohtenn	2009 establishments in Switzerland, Municipalities of Valais
Fuller House (TV series)	2016 establishments in the United States, 2016 television series debuts, 2010s American sitcoms, Television series about families, Television series about siblings, Television series set in San Francisco, Works about widowhood, Netflix original shows, English-language television programs
Italian Renaissance	Renaissance, 14th century in Europe, 15th century in Europe, 16th century in Italy, 17th century in Europe
Transiting Exoplanet Survey Satellite	NASA spacecraft, Satellites
Barron Hilton	1927 births, 2019 deaths, Deaths from natural causes in the United States, Disease-related deaths in Los Angeles, American philanthropists, American billionaires, Humanitarians, Businesspeople from Los Angeles, California, Businesspeople from Dallas, Texas
Machine learning	Artificial intelligence, Learning
Arrondissements of the Meurthe-et-Moselle department	Arrondissements of France
Indian Act	Law, 1876, 19th century in Canada
Mark-Paul Gosselaar	American television actors, American movie actors, Actors from Los Angeles, California, 1974 births, Living people
Arrondissement of Briey	Arrondissements of France, Grand Est
École nationale supérieure des mines d'Albi-Carmaux	Technical colleges and universities in France, 1993 establishments in France
Arrondissement of Lunéville	Arrondissements of France, Grand Est
Arrondissement of Nancy	Arrondissements of France, Grand Est
Lady Jane Grey (poem)	Epic poems
Chigger	Arachnids, Parasites
Arrondissement of Toul	Arrondissements of France, Grand Est
Mick Mulvaney	1967 births, Living people, People from Alexandria, Virginia, United States Special Envoy for Northern Ireland, American Roman Catholics, Directors of the Office of Management and Budget, Directors of the Consumer Financial Protection Bureau, Politicians from Virginia, United States representatives from South Carolina, US Republican Party politicians, South Carolina Republicans
Charles Zwick	1926 births, 2018 deaths, Cancer deaths in Florida, American economists, Directors of the Office of Management and Budget, People from Connecticut, US Democratic Party politicians
Series and parallel circuits	Electricity
Assassination of Andrei Karlov	2016 in Asia, Ankara, Crime in Turkey, December 2016 events, Murder in 2016, Murder in Asia, Murders by firearm, Terrorist incidents in 2016, Terrorist incidents in Asia in the 2010s
Chromebook	Laptops, Google
Gavialis	Gharials
Andrei Karlov	1954 births, 2016 deaths, Ambassadors of Russia, Assassinated people, Murders by firearm, Russian murder victims, Russian politicians
Jackson's Valley Campaign	American Civil War battles, 1862 in Virginia
Mattel	Companies of the United States, 1945 establishments in the United States
2016 United States presidential election in Florida	2016 United States presidential election by state, 2010s in Florida
2016 United States presidential election in New Jersey	2016 United States presidential election by state
2016 Berlin truck attack	2016 in Germany, 2010s crimes in Germany, 2010s murders in Europe, Attacks on buildings and structures in 2016, Attacks on buildings and structures in Germany, December 2016 events, History of Berlin, Islamic State, Islamic terrorist incidents in 2016, Islamic terrorist incidents in Europe, Mass murder in 2016, Mass murder in Germany, Religion in Germany, Terrorist incidents in Europe in 2016, Terrorist incidents in Germany, Terrorist incidents involving vehicular attacks
2016 Irkutsk mass methanol poisoning	2016 disasters, 2010s in Russia, December 2016 events, 2010s disasters in Asia
2015 Kyrgyz parliamentary election	2015 elections, Kyrgyzstan
Kyrgyzstan Party	2015 establishments in Asia, Political parties, Kyrgyzstan
Branchiobdellida	Annelids
Patrick H. Grace	1832 births, 1896 deaths, United States Navy Medal of Honor recipients, Year of birth unknown
Kelly (name)	Surnames, Given names
Joanne Dru	American television actors, American stage actors, American movie actors, 1922 births, 1996 deaths
All the King's Men (1949 movie)	1949 movies, 1940s drama movies, American drama movies, Movies based on books, Movies directed by Robert Rossen
The Waste Land	Poems
Monster High	2010 establishments in the United States, Dolls
Azərpoçt	1999 establishments in Asia, Postal service, Companies of Asia, Companies of Europe, Economy of Azerbaijan, 20th century establishments in Azerbaijan
2012 Stanley Cup Finals	Stanley Cup Finals, 2012 in ice hockey, Ice hockey competitions, May 2012 events, June events, New Jersey Devils, 2012 in the United States, 2010s in Los Angeles, California, 2010s in New Jersey
Mevlut Mert Altintas	1994 births, 2016 deaths, Assassins, Police officers, Turkish people
Arrondissements of the Moselle department	Arrondissements of France
Chad Robinson	1980 births, 2016 deaths, Australian rugby league players, Sportspeople from Sydney
Significant figures	Numbers, Measurement
Institut national polytechnique de Toulouse	Technical colleges and universities in Toulouse, 1969 establishments in Europe, 1960s establishments in France
Arrondissement of Forbach-Boulay-Moselle	Arrondissements of France, Grand Est
Bamburgh Castle	Listed buildings, Northumberland, Castles in England
Arrondissement of Sarrebourg-Château-Salins	Arrondissements of France, Grand Est
Arrondissement of Sarreguemines	Arrondissements of France, Grand Est
Arrondissement of Thionville	Arrondissements of France, Grand Est
Christmas truce	World War I, Christmas
Kellyanne Conway	US Republican Party politicians, Politicians from New Jersey, 1967 births, Living people
Arrondissement of Metz	Arrondissements of France, Grand Est
Ashwaq Moharram	Yemeni people, Living people, Physicians, BBC 100 Women
Mobile operating system	Operating systems
Dunstanburgh Castle	Castles in England, Northumberland, 14th century establishments in England, 1313 establishments, 1310s establishments in Europe
Oberstdorf	Oberallgäu
Saksri Sriaksorn	1937 births, 2005 deaths
The Grand Tour (TV series)	British television series, English-language television programs
Doaa el-Adl	Living people, Egyptian people, Cartoonists, BBC 100 Women
Jair Bolsonaro	1955 births, Living people, Presidents of Brazil, Current national leaders, Anti-Communists, Roman Catholics
Independiente Medellín	Colombian football clubs, 1913 establishments in South America, 1910s establishments in Colombia
List of attacks on U.S. territory	United States-related lists, History-related lists
Drum machine	Drum machines
100 Women (BBC)	2013 establishments in the United Kingdom, BBC 100 Women, Awards
Riham El Hour	1977 births, Living people, Cartoonists, Moroccan writers, BBC 100 Women
Swissair Flight 111	1998 in North America, Aviation disasters in the 1990s, Disasters in Canada, September events
Unary function	Mathematics
Arity	Logic, Mathematics, Computer science
Institut catholique d'arts et métiers	Technical colleges and universities in France, 1898 establishments in Europe, Lille, Nantes, Toulouse, 1890s establishments in France
Fore-and-aft rig	Sailing, Boats
Sloop	Sailing, Boats
East Croydon station	1841 establishments in Europe, 1840s establishments in England
Courage in Journalism Award	Journalism awards
Brig	Sailing, ships
1956 Grand Canyon mid-air collision	Aviation disasters in the United States, 1956 in the United States, 20th century in Arizona
Glyfada	Athens
Shelby County, Tennessee	Tennessee counties
Cutter (boat)	Sailing, Ships
Plastic wrap	Polymer chemistry, Materials
Bad Moms	2016 comedy movies, American comedy movies, English-language movies, Movies about dysfunctional families, 2010s feminist movies
Unterbäch	Municipalities of Valais
Wiler (Lötschen)	Municipalities of Valais
Carshalton railway station	1868 establishments in the United Kingdom, 1860s establishments in England, Railway stations opened in 1868
Beah Richards	American television actors, American stage actors, American movie actors, Actors from Mississippi, 1920 births, 2000 deaths, People from Vicksburg, Mississippi, Emmy Award winning actors
ER (TV series)	1994 American television series debuts, 2009 American television series endings, 1990s American drama television series, 1990s American workplace television series, 1990s medical television series, 2000s American drama television series, 2000s American workplace television series, 2000s medical television series, American medical television series, American workplace drama television series, Emmy Award winning programs, English-language television programs
ZooParc de Beauval	1980 establishments in France, Zoos, Centre-Val de Loire
Jib	Sailing
Brian (name)	Given names, Surnames
LaMia Airlines Flight 2933	Aviation disasters in the 2010s, November 2016 events, 2010s in South America, History of Colombia
List of accidents and incidents involving commercial aircraft 1919 – 1959	Aviation disasters
List of accidents and incidents involving commercial aircraft 1960 – 1989	Aviation disasters
List of accidents and incidents involving commercial aircraft 1990 – 2021	Aviation disasters
Hurricane Otto	2016 in weather, Hurricanes, November 2016 events, History of Panama, History of Costa Rica, History of Nicaragua, 2016 in North America
NES Classic Edition	Nintendo video game consoles
Morton Sobell	1917 births, Living people, Engineers from New York, Criminals from New York City
Sumner Redstone	1923 births, 2020 deaths, American billionaires, American Jews, Businesspeople from Boston, Massachusetts, Businesspeople from Los Angeles, California
Sid Hartman	1920 births, 2020 deaths, American centenarians, American journalists, Writers from Minneapolis, Minnesota
Aharon Yehuda Leib Shteinman	1913 births, 2017 deaths, Deaths from respiratory failure, Belarusian Jews, Israeli centenarians, Israeli rabbis, Jewish centenarians, Naturalized citizens of Israel, People from Brest, Belarus, Polish Jews, Refugees from Nazism
Bob Dold	1969 births, Living people, Businesspeople from Illinois, United States representatives from Illinois, US Republican Party politicians, People from Evanston, Illinois
Jonas Mekas	1922 births, 2019 deaths, American movie directors, American poets, Lithuanian writers, Naturalized citizens of the United States
Camren Bicondova	1999 births, Living people, American television actors, American dancers, Models from San Diego, California, Actors from San Diego, California, American child actors
Institut national universitaire Jean-François Champollion	Technical colleges and universities in France, 2002 establishments in France
Desmond Morris	1928 births, Living people, English painters, British zoologists, British educators, Ethologists, People from Wiltshire
Clarel (poem)	Epic poems
Mauisaurus	Plesiosaurs
Dapedium	Extinct fish
Komlosaurus	Dinosaurs of Europe, Jurassic
Ludvik Dolezal	1956 births, 2016 deaths
Parts of a sail	Sailing
Pterygotus	Chelicerata, Arthropods, Extinct species
American Airlines Flight 96	Ontario, Disasters in Canada, 1972 in North America, Aviation disasters in the 1970s, 1970s in Canada, June events
Buriolestes	Sauropods
Lariniscotes	Fossils
Sonnet on the Great Suffering of Jesus Christ	Poems
Eurypterus	Chelicerata, Arthropods, Extinct species
64-bit computing	Computer science
Sutton Common railway station	1930 establishments in Europe, 1930s establishments in England
Singapore Airlines Flight 006	2000 in Asia, Aviation disasters in the 2000s, History of Singapore, 2000s in Taiwan, October events
LOT Polish Airlines Flight 16	2011 in Europe, Aviation, 21st century in Poland, Warsaw
Forestay	Sailing
Arrondissements of the Bas-Rhin department	Arrondissements of France, Grand Est
Šiprage	Settlements in Bosnia and Herzegovina
Kotor Varoš	Settlements in Bosnia and Herzegovina, Republika Srpska
Deck (ship)	Sailing, Ships
Vrbanja river	Rivers of Bosnia and Herzegovina
Wole Soyinka	1934 births, Living people, Nigerian writers, Playwrights, Poets
Vrbas (river)	Rivers of Bosnia and Herzegovina
Banja Luka	Cities in Bosnia and Herzegovina
Ugar (river)	Rivers of Bosnia and Herzegovina
Ilomska	Rivers of Bosnia and Herzegovina
Vlašić (mountain)	Geography of Bosnia and Herzegovina
Travnik	Settlements in Bosnia and Herzegovina
Central Bosnia Canton	Bosnia and Herzegovina
Arrondissement of Haguenau-Wissembourg	Arrondissements of France, Grand Est
Versace	1978 establishments in Europe, Italian fashion houses, 1970s establishments in Italy
Arrondissement of Molsheim	Arrondissements of France, Grand Est
Nanotyrannus	Cretaceous dinosaurs, Tyrannosaurids
Arrondissement of Saverne	Arrondissements of France, Grand Est
Bosniaks	Slavic peoples, Bosnia and Herzegovina people
Arrondissement of Sélestat-Erstein	Arrondissements of France, Grand Est
Arrondissement of Strasbourg	Arrondissements of France, Grand Est
Joe Ranft	1960 births, 2005 deaths, Movie directors from California, Pixar, American animators, American voice actors
Bosnian War	Wars, 1990s in Bosnia and Herzegovina
Flåm, Norway	Settlements in Norway
Laetitia Casta	1978 births, Living people, French models, French movie actors, French stage actors, French television actors, People from Normandy
Muck, Scotland	Geography of Scotland
North Rona	Geography of Scotland
Ischigualasto Provincial Park	Geography of Argentina, World Heritage Sites in South America
Martin Sjögren	1977 births, Living people, Swedish footballers
Port Mòr	Settlements in Scotland
Andrew Kishino	1970s births, Living people, American voice actors
Collonges, Switzerland	Municipalities of Valais
Dorénaz	Municipalities of Valais
List of protected areas of Bosnia and Herzegovina	Lists of national parks, Europe-related lists, Geography of Bosnia and Herzegovina
Sutjeska National Park	Geography of Bosnia and Herzegovina, IUCN Category II, National parks in Europe
Cockpit (sailing)	Sailing
Gummy bear	Candy
Kruševo Brdo	Settlements in Bosnia and Herzegovina, Villages in Europe
Misiones Department	Departments of Paraguay
Eigg	Inner and Outer Hebrides
Dayton S. Mak	1917 births, Living people, Ambassadors of the United States, American centenarians, Civil servants, People from Sioux Falls, South Dakota
Leah Bracknell	1964 births, 2019 deaths, Deaths from lung cancer, English movie actors, English television actors, British educators, Actors from London
Gord Downie	1964 births, 2017 deaths, Deaths from glioblastoma, Cancer deaths in Canada, Canadian rock musicians, Musicians from Ontario, Actors from Ontario, Writers from Ontario
Nobby Stiles	1942 births, 2020 deaths, English footballers, English football managers, Deaths from prostate cancer, Deaths from dementia, Manchester United F.C. players, Sportspeople from Manchester
Jill Gascoine	1937 births, 2020 deaths, Deaths from Alzheimer's disease, Disease-related deaths in Los Angeles, British movie actors, British television actors, British stage actors, Actors from London, Writers from London
Ian St John	1938 births, 2021 deaths, Liverpool F.C. players, People with cancer, Scottish footballers, Scottish football managers
Canna	Inner and Outer Hebrides
Rum (island)	Islands of Scotland
Sanday	Inner and Outer Hebrides
Raasay	Inner and Outer Hebrides
Gay Byrne	1934 births, 2019 deaths, Deaths from prostate cancer, Irish radio personalities, Irish television presenters, People from Dublin
Elizabeth Dawn	1939 births, 2017 deaths, Deaths from emphysema, English movie actors, English television actors, English stage actors, People with cancer, Actors from Leeds
Errol Christie	1963 births, 2017 deaths, Deaths from lung cancer, Cancer deaths in London, People with cancer, British boxers, Sportspeople from Leicester
Paul Rycaut	1629 births, 1700 deaths, British diplomats, Knights Bachelor
Cantor's theorem	Mathematics
Small Isles	Islands of Scotland
Lycorhinus	Heterodontosaurs, Jurassic dinosaurs
Concepción, Paraguay	Cities in Paraguay
Square rig	Sailing
Water Under the Bridge	Adele songs
Večići	Settlements in Bosnia and Herzegovina
Merchant vessel	Ships
Cvrcka	Rivers of Bosnia and Herzegovina
Vrbanjci	Settlements in Bosnia and Herzegovina
Bosanka (river)	Rivers of Bosnia and Herzegovina
Tony Atkinson	1944 births, 2017 deaths, Deaths from multiple myeloma, British economists, Welsh writers
Hilarion Capucci	1922 births, 2017 deaths, Activists, Archbishops, Eastern Catholics, Syrian Christians
Memo Morales	1937 births, 2017 deaths, Deaths from myocardial infarction, Venezuelan singers
Uzlomac	Mountains of Europe, Geography of Bosnia and Herzegovina
Yaakov Neeman	1939 births, 2017 deaths, Government ministers of Israel, Israeli academics, Israeli lawyers, Jewish academics, Jewish Israeli politicians, Jewish lawyers, People from Tel Aviv
Get Dumb	2007 songs
Small-cell carcinoma	Cancer
Ciarán Hinds	1953 births, Living people, Irish movie actors, Irish television actors, Irish stage actors, People from Belfast
Olivia (name)	Given names
Wonder Woman (2017 movie)	2017 movies, Warner Bros. movies, American superhero movies, American action movies, DC Extended Universe movies, 2010s superhero movies, Wonder Woman movies, 2010s feminist movies, Movies directed by Patty Jenkins
Muriel (name)	Surnames, Given names
Emmanuel Niyonkuru	1962 births, 2017 deaths, Deaths by firearm, Civil servants, Burundian people, Assassinated people, African businesspeople
Joseph A. Califano Jr.	1931 births, Living people, United States Secretaries of Health, Education, and Welfare, Politicians from New York City, US Democratic Party politicians
Usora (river)	Rivers of Bosnia and Herzegovina
Echinodon	Heterodontosaurs, Cretaceous dinosaurs
Mel Lopez	1935 births, 2017 deaths, Deaths from myocardial infarction, Mayors of Manila
Megalosauridae	Megalosauridae
François Chérèque	1956 births, 2017 deaths, Cancer deaths in France, Deaths from leukemia, People from Nancy, Trade unionists
Squash (drink)	Soft drinks
Viktor Tsaryov	1931 births, 2017 deaths, Russian footballers, Sportspeople from Moscow, Soviet sportspeople
Bogdan Tuszyński	1932 births, 2017 deaths, Disease-related deaths in Poland, Polish historians, Polish journalists, People from Łódź, Polish writers
Lateen	Sailing, ships
John Berger	Booker Prize winners, 1926 births, 2017 deaths, Artists from London, English painters, English poets, People from Hackney
Tacking (sailing)	Sailing
The Lego Ninjago Movie	2010s action movies, 2010s adventure movies, 2017 comedy movies, 2017 animated movies, English-language movies, American action comedy movies, American adventure movies, American animated movies, Computer-animated movies, Danish movies, Lego, Warner Bros. movies, Prequel movies
Derek Parfit	1942 births, 2017 deaths, British philosophers, British writers, People from Oxford
Battle of Austerlitz	Wars involving France, 19th century in Europe
Rogue One	2016 science fiction movies, American epic movies, American sequel movies, Prequel movies, Movie spin-offs, Star Wars movies
Richard Machowicz	1965 births, 2017 deaths, American martial artists, American military people, American television personalities, Cancer deaths in the United States, Deaths from brain cancer, People from Detroit, Michigan
Alfonso Wong	1925 births, 2017 deaths, Comics artists, Comics writers, Chinese writers, Deaths from multiple organ failure, Disease-related deaths in California, People from Hong Kong
Granny (orca)	1910s births, 2017 deaths, Cetaceans, Individual animals
Prince Oscar, Duke of Skåne	2016 births, Living people, Princes and princesses, Swedish royalty
SOCATA MS.880 Rallye	Aviation in France, Civil aircraft
Sir Thaddeus	Epic poems
Charles J. Colgan	1926 births, 2017 deaths, American military personnel of World War II, Businesspeople from Maryland, Businesspeople from Virginia, Cardiovascular disease deaths in Virginia, Politicians from Maryland, Politicians from Virginia, US Democratic Party politicians
Ivo Brešan	1936 births, 2017 deaths, Croatian screenwriters, Novelists, Playwrights, Yugoslavian people
Rolf Noskwith	1919 births, 2017 deaths, Alumni of the University of Cambridge, British businesspeople, British Jews, German Jews, Jewish businesspeople, Naturalised citizens of the United Kingdom, People from Chemnitz
Halal snack pack	Australia, Fast food
Diego Luna	1979 births, Living people, Actors from Mexico City, Child actors, Mexican movie actors, Mexican movie directors, Mexican television actors
Donnie Yen	1963 births, Living people, Actors from Hong Kong, Chinese movie directors, Choreographers, Judoka, Mixed martial artists, Chinese movie actors, Chinese movie producers, Chinese television actors
Hercules (2014 movie)	2014 movies, American movies, Movies based on Greek and Roman mythology
Igor Volk	1937 births, 2017 deaths, Colonels, Cosmonauts, Russian military people, Recipients of the Order of Lenin
René Ballet	1928 births, 2017 deaths, Communists, French journalists, French novelists, People from Auvergne-Rhône-Alpes
Wayne Westner	1961 births, 2017 deaths, People from Johannesburg, South African golfers, Sportspeople who committed suicide, Suicides by firearm
Rigging	Sailing, ships
Djoser	Pharaohs
Abdul Halim Jaffer Khan	1927 births, 2017 deaths, Deaths from cardiac arrest, Indian musicians, Composers
Sonny Perdue	1946 births, Living people, United States Secretaries of Agriculture, Veterinarians, Businesspeople from Georgia (U.S. state), Governors of Georgia (U.S. state), US Republican Party politicians
Joe Manganiello	1976 births, Living people, American movie actors, American television actors, American voice actors, American activists, American philanthropists, American movie directors, American movie producers, American television directors, American television producers, Actors from Pittsburgh, Pennsylvania, Writers from Pennsylvania
Deathstroke	DC Comics characters
Stoning	Capital punishment
Hypnic jerk	Sleep
Mads Mikkelsen	1965 births, Living people, Actors who played Bond villains, Danish movie actors, Danish television actors, People from Copenhagen, Voice actors
Jiang Wen	1963 births, Living people, Chinese television actors, Chinese movie directors, Chinese screenwriters, Chinese movie actors
Dick Latessa	Tony Award winning actors, Drama Desk Award winners, 1929 births, 2016 deaths, Deaths from heart failure, American movie actors, American television actors, American stage actors, Actors from Cleveland, Ohio, Actors from New York City
Sharpeville massacre	Apartheid-related violence, 20th century in South Africa
Tullio De Mauro	1932 births, 2017 deaths, Italian politicians, Italian writers, Linguists
Kafr Bara	Local government in Israel, Settlements in Israel, Villages in Asia
Snowy owl	Strigiformes
Poyang Lake	Lakes of China
Nanuqsaurus	Tyrannosaurids
Madoc (poem)	Epic poems
Arrondissements of the Bouches-du-Rhône department	Arrondissements of France, Provence-Alpes-Côte d'Azur
Arrondissement of Aix-en-Provence	Arrondissements of France, Provence-Alpes-Côte d'Azur
Arrondissement of Arles	Arrondissements of France, Provence-Alpes-Côte d'Azur
Arrondissement of Istres	Arrondissements of France, Provence-Alpes-Côte d'Azur
Nata de coco	Foods
Arrondissement of Marseille	Arrondissements of France, Provence-Alpes-Côte d'Azur
Carl Johnson	Video game characters
Nisha Ayub	Human rights activists
Justice for Sisters	Human rights organizations in Asia
Jeremy Stone	1935 births, 2017 deaths, Deaths from prostate cancer, Cancer deaths in California, American activists, Writers from New York City
Willie Evans	1937 births, 2017 deaths, American football players, Sportspeople from Buffalo, New York
Jordi Pagans i Monsalvatje	1932 births, 2017 deaths, Deaths from congestive heart failure, Spanish painters, People from Barcelona
Christopher Weeramantry	1926 births, 2017 deaths, Deaths from natural causes, Sri Lankan lawyers, Judges, People from Colombo
Om Puri	1950 births, 2017 deaths, Cardiovascular disease deaths in India, Deaths from myocardial infarction, Indian movie actors, Indian television actors, Haryana, Honorary Officers of the Order of the British Empire
Jill Saward	1965 births, 2017 deaths, Deaths from cerebral hemorrhage, English activists, Crime victims, English politicians, Writers from Liverpool
Penelope Wilton	1946 births, Living people, Actors from Yorkshire, English movie actors, English stage actors, English television actors, Knights and Dames Commander of the Order of the British Empire, People from North Yorkshire
Mighty Magiswords (International TV Series)	2005 American television series debuts, 2010 American television series endings, English-language television programs
Decoration of Honour for Services to the Republic of Austria	Austria, Orders, decorations, and medals, 1952 establishments in Europe, 20th century establishments in Austria
Mint (money)	Money, Manufacturing, Coins
Vlissingen	Port cities and towns of the North Sea, Cities in the Netherlands, Settlements in Zeeland, Municipalities of Zeeland
BOAC Flight 911	Aviation disasters in Asia, 1966, 1960s in Japan
Jerusalem Delivered	Epic poems
Bermuda rig	Sailing, ships
Agricultural fencing	Agriculture
Robotics	Robots
Outsourcing	Economics
Time in Armenia	Time by country, Armenia
SilkAir Flight 185	Aviation disasters in the 1990s, December events, 1997 in Asia
James Adomian	1980 births, Living people, American movie actors, American television actors, American voice actors, American radio actors, American comedians, American television personalities, American radio personalities, American television presenters, Actors from Omaha, Nebraska, Writers from Omaha, Nebraska
Grass jelly	Desserts
Sago	Carbohydrates, Food ingredients
Tapioca	Carbohydrates, Food ingredients
Konjac	Araceae, Plants of Asia
Iveta Mukuchyan	1986 births, Living people
Leg-of-mutton sail	Sailing
Medical laboratory	Health care
Central Africa Time	Time zones, Africa
Lelio Lagorio	1925 births, 2017 deaths, Italian politicians, People from Trieste, Socialist politicians
Buckingham Canal	Chennai District
Kosasthalaiyar River	Rivers of Tamil Nadu
Vattaparai Falls	Waterfalls, Bodies of water of Asia, Geography of India, Kanyakumari district
Agaya Gangai	Waterfalls, Bodies of water of Asia, Geography of India, Namakkal district
Tilikum (orca)	1981 births, 2017 deaths, Infectious disease deaths in the United States, Cetaceans, Individual animals
James Mancham	1939 births, 2017 deaths, Deaths from stroke, Presidents of Seychelles, Prime Ministers of Seychelles, Knights Commander of the Order of the British Empire
Nat Hentoff	1925 births, 2017 deaths, Deaths from natural causes, Critics, Writers from Boston, Massachusetts
Shameless (U.S. TV series)	2011 American television series debuts, American comedy-drama television series, Television series set in Chicago, Illinois, English-language television programs
Jerzy Kossela	1942 births, 2017 deaths, Polish musicians, Guitarists
Lech Trzeciakowski	1931 births, 2017 deaths, Deaths from cancer, Polish historians, People from Poznań, Polish writers
Ricardo Piglia	1941 births, 2017 deaths, Deaths from motor neurone disease, Argentine writers
Francine York	1936 births, 2017 deaths, Cancer deaths in California, American movie actors, American television actors, Actors from Minnesota
Tom Harpur	1929 births, 2017 deaths, Alumni of the University of Oxford, Anglican priests, Canadian Christians, Canadian journalists, Canadian radio personalities, Canadian television presenters, Christian theologians, Columnists, Writers from Toronto
Géori Boué	1918 births, 2017 deaths, French singers, People from Toulouse
Paul Goble	1933 births, 2017 deaths, Deaths from Parkinson's disease, Writers from Surrey
Brinicle	Oceans
Angelo Sodano	1927 births, Living people, Cardinals of the Roman Catholic Church, Italian Roman Catholics, People from Piedmont, Roman Catholic bishops
Spartak Belyaev	1923 births, 2017 deaths, Russian physicists, People from Moscow
Cedarosaurus	Sauropods, Dinosaurs of North America
Saurexallopus	Fossils
Dijon FCO	1990s establishments in France, 1998 establishments in Europe, French football clubs, Dijon
Otto Wichterle	Czech people, Chemists
Quentin Matsys	1460s births, 1530 deaths, Dutch painters
Peoria, Arizona	Cities in Arizona, 1954 establishments in the United States, 20th-century establishments in Arizona
Waterbed	Furniture
2017 Fort Lauderdale airport shooting	2017 mass shootings in the United States, 2017 murders in the United States, 2010s in Florida, Attacks on buildings and structures in the United States, Fort Lauderdale, Florida, January 2017 events, Mass murder in 2017, Mass murder in Florida, Massacres in the United States, Murders by firearm in Florida
Devil (Islam)	Islam
Punica	Myrtales
Unadilla, Georgia	Cities in Georgia (U.S. state)
Needed Me	Rihanna songs
Mentha arvensis	Lamiaceae, Plants of Asia
John Deely	1942 births, 2017 deaths, Cancer deaths in Pennsylvania, American philosophers, American educators, Writers from Pennsylvania, Writers from Chicago, People from Latrobe, Pennsylvania, Writers from Houston, Texas
Heinz Billing	1914 births, 2017 deaths, German centenarians, German computer scientists, German educators, German physicists, German writers, People from Saxony-Anhalt
Robert Lighthizer	1947 births, Living people, American lawyers, United States Trade Representatives, Politicians from Ohio, US Republican Party politicians
Lois Smith	Drama Desk Award winners, 1930 births, Living people, American movie actors, American television actors, American stage actors, American voice actors, Actors from Kansas, People from Topeka, Kansas
Eddie Garcia	1925 births, 2019 deaths, Accidental deaths from falls, Filipino actors, Movie directors
Henry Haller	1923 births, 2020 deaths, Naturalized citizens of the United States, Swiss people, American chefs
Greg Jelks	1961 births, 2017 deaths, African-American baseball players, Australian sportspeople, Philadelphia Phillies players
Sex Tape (movie)	2014 comedy movies, 2010s sex comedy movies, American sex comedy movies, English-language movies, Movies about families, Movies about marriage, Movies about suburbia, Movies set in Los Angeles, California, Movies about pornography, Movies directed by Jake Kasdan
Michael Chamberlain	1944 births, 2017 deaths, New Zealand writers, Australian writers, Australian educators, New Zealand educators, Deaths from acute myeloid leukemia
Phil Rudd	1954 births, Living people, AC/DC, Australian criminals, Australian drummers, Australian rock musicians, Musicians from Melbourne, Rock and Roll Hall of Fame inductees, Rock drummers
Urk	Settlements in Flevoland, Municipalities of Flevoland, Former municipalities of North Holland, Former municipalities of Overijssel
Dokkum	Cities in Friesland, Noardeast-Fryslân
Ulf Dinkelspiel	1939 births, 2017 deaths, Cancer deaths in Sweden, Government ministers of Sweden, Politicians from Stockholm
Winschoten	Cities in the Netherlands, Settlements in Groningen (province), Former municipalities of Groningen (province), Oldambt
Zierikzee	Cities in the Netherlands, Settlements in Zeeland, Former municipalities of Zeeland, Schouwen-Duiveland
Torgny (village)	Former municipalities of Belgium, Luxembourg (Belgium)
Tithe	Religion
Gouda, Netherlands	Gouda, Cities in the Netherlands, Settlements in South Holland
Jacob Cats	1577 births, 1660 deaths, Dutch jurists, Dutch local politicians, Dutch poets, Dutch provincial politicians, Politicians from Zeeland, Writers from Zeeland
The Bottom	Saba, Capital cities in North America
ENAC Foundation	French Civil Aviation University
List of Baku metro stations	Baku Metro, Railway stations in Asia, Rail transport in Azerbaijan, Buildings and structures in Baku, Rail transport lists
La La Land (movie)	2016 romance movies, 2016 comedy-drama movies, 2010s musical movies, 2010s romantic comedy movies, 2010s romantic drama movies, American comedy-drama movies, American musical comedy movies, American romantic comedy movies, American romantic drama movies, Dance movies, English-language movies, Movies about entertainers, Movies set in Los Angeles, California
Angelica Ross	1980s births, Living people, Year of birth missing (living people), American LGBT rights activists, People from Kenosha, Wisconsin
Charlie Brotman	1927 births, Living people, Sportspeople from Washington, D.C.
Leanne Pittsford	1981 births, Living people, American LGBT rights activists, Lesbians, LGBT businesspeople, LGBT people from California, Businesspeople from San Diego, California
Deaths in 2017	2017 deaths, Index lists
Deaths in January 2017	2017 deaths, January 2017 events
Ramanuja Devnathan	1959 births, 2017 deaths, Deaths from myocardial infarction, Indian educators, Indian writers
Miriam Goldberg	1916 births, 2017 deaths, American centenarians, Businesspeople from Chicago
Zygmunt Bauman	1925 births, 2017 deaths, 20th century philosophers, 21st century philosophers, British philosophers, British sociologists, Continental philosophers, Jewish academics, Jewish British academics, Jewish British writers, Jewish scientists, Naturalised citizens of the United Kingdom, People from Poznań, Polish academics, Polish communists, Polish Jews, Polish scientists, Polish writers, Writers from Leeds
Ali Shariatmadari	1924 births, 2017 deaths, Iranian politicians, Iranian educators
Bayezid Osman	1924 births, 2017 deaths, Turkish people, People from Paris
Progressive supranuclear palsy	Diseases
Peter Sarstedt	1941 births, 2017 deaths, Disease-related deaths in Sussex, English singer-songwriters, English pop singers, English pop musicians, English guitarists, Singers from London, Musicians from London, Writers from London
Buddy Bregman	1930 births, 2017 deaths, Deaths from Alzheimer's disease, American composers, American television directors, American television producers, Writers from Chicago
Rauda Morcos	1974 births, Living people, Lesbians, LGBT rights activists, Palestinian people
Temple Run 2	2013 video games
Our Revolution	Bernie Sanders, Political organizations based in the United States
Versailles University Foundation	Université de Versailles Saint-Quentin-en-Yvelines
Boško Krunić	1929 births, 2017 deaths, Deaths from stroke, Yugoslavian people, Communists
Gombojavyn Ochirbat	1929 births, Living people, Communists, Mongolian people
Eduardo Martínez Somalo	1927 births, 2021 deaths, Deaths from myocardial infarction, Cardinals of the Roman Catholic Church, Roman Catholic bishops, Spanish Roman Catholics
Kim Yong-ju	1920 births, Living people, Communists, North Korean politicians
Nebelhorn	Allgäu Alps, Geography of Bavaria, Mountains of Germany
Fellhorn	Allgäu Alps, Geography of Bavaria, Vorarlberg, Mountains of Austria, Mountains of Germany
Back to the Future (franchise)	Back to the Future movies, English-language movies, Comedy science fiction movies, Universal Pictures movies
Ben Feringa	1951 births, Living people, Dutch academics, Dutch chemists, Dutch Nobel Prize winners, People from Drenthe
Milada Horáková	1901 births, 1950 deaths
Leen Verbeek	1954 births, Living people, Aldermen of the Netherlands, Dutch civil servants, Dutch councillors, Dutch mayors, Dutch provincial politicians, Labour Party (Netherlands) politicians, Politicians from South Holland
Heliskiing	Skiing
Quirine Oosterveld	1990 births, Living people, Dutch volleyball players, People from Flevoland
Kanzelwand	Allgäu Alps, Geography of Bavaria, Mountains of Austria, Mountains of Germany, Vorarlberg
Michiel van Hulten	1969 births, Living people, Dutch party chairs, Former MEPs, Labour Party (Netherlands) politicians, MEPs for the Netherlands, People from Flevoland
Clare Hollingworth	1911 births, 2017 deaths, English centenarians, English journalists, People from Leicester, Writers from Leicestershire
Mojave Desert	Deserts, Geography of Arizona, Landforms of California
Arrondissements of the Gard department	Arrondissements of France, Occitanie
The Daughter of Sláva	Epic poems
Honeyberry	Dipsacales, Berries, Shrubs
Arrondissement of Alès	Arrondissements of France, Occitanie
Gol Transportes Aéreos Flight 1907	Aviation disasters in the 2000s, 2000s in Brazil, 2006, September events
Arrondissement of Le Vigan	Arrondissements of France, Occitanie
Arrondissement of Nîmes	Arrondissements of France, Occitanie
Roy Innis	1934 births, 2017 deaths, Deaths from Parkinson's disease, American civil rights activists, Politicians from New York City
Jovanka Nikolić	1952 births, 2017 deaths, Poets, Serbian people
Buddy Greco	1926 births, 2017 deaths, American jazz musicians, American pop musicians, American pop singers, American pianists, American movie actors, American television actors, Singers from Philadelphia, Pennsylvania, Musicians from Philadelphia, Pennsylvania, Actors from Philadelphia, Pennsylvania
Gardon	Rivers of France, Occitanie
Uta Ranke-Heinemann	1927 births, 2021 deaths, German academics, German politicians, German Roman Catholics, German theologians, German writers, People from Essen, Politicians from North Rhine-Westphalia, Writers from North Rhine-Westphalia
Mir Hazar Khan Khoso	1929 births, 2021 deaths, Prime Ministers of Pakistan, Deaths from myocardial infarction
Jamshid bin Abdullah of Zanzibar	1929 births, Living people
Orbital revolution	Astronomy
Adenan Satem	1944 births, 2017 deaths, Deaths from myocardial infarction, Malaysian politicians
American Pit Bull Terrier	Dog breeds, Terriers
Kerime Nadir	1917 births, 1984 deaths, Turkish writers
Tekin Akmansoy	1924 births, 2013 deaths, Turkish actors
Cem Özer	1959 births, Turkish writers
Sırrı Gültekin	1924 births, 2008 deaths, Turkish actors
Ekrem Bora	1934 births, 2012 deaths
Filiz Taçbaş	1964 births, Turkish actors
Osman Alyanak	1916 births, 1991 deaths, Turkish actors
Güzin Özipek	1925 births, 2000 deaths, Turkish actors
Esra Akkaya	1970 births
Ahmet Üstel	1930 births, 1983 deaths, Turkish writers, Turkish actors
Savaş Başar	1938 births, 1985 deaths, Turkish actors, Turkish screenwriters
Yücel Erten	1945 births, Turkish actors
Zeyno Günenç	1967 births, Turkish actors
Alper Kul	1975 births, Turkish writers, Turkish actors, Living people
Münibe Millet	1980 births, Turkish actors
François Van der Elst	1954 births, 2017 deaths, Belgian footballers, Cardiovascular disease deaths in Belgium, Deaths from cardiac arrest, People from Flemish Brabant
List of caravanserais in Azerbaijan	Accommodations, Buildings and structures in Azerbaijan, Lists of buildings, Azerbaijan-related lists
Egyptian goose	Geese, Birds of Africa
St. Helier railway station	1930 establishments in Europe, 1930s establishments in England
Richard Lydekker	British naturalists
Rubihorn	Allgäu Alps, Geography of Bavaria, Mountains of Germany
Saeeduzzaman Siddiqui	1938 births, 2017 deaths, Chief Justices of Pakistan
Martin Brandtner	1938 births, 2017 deaths, American military people, People from Minneapolis, Minnesota
Bob McCullough	2017 deaths, Australian sportspeople
David Shulkin	1959 births, Living people, American physicians, United States Secretaries of Veterans Affairs, Independent politicians in the United States, Politicians from Illinois, Politicians from Pennsylvania, Politicians from Washington, D.C., People from Highland Park, Illinois
Warren Allen Smith	1921 births, 2017 deaths, LGBT writers, Gay men, LGBT businesspeople, LGBT people from New York City, Writers from New York City
Takobeya (Japanese bureaucrats)	Government of Japan, Japanese language, Rooms
Manlio Rocchetti	Academy Award winning make-up artists, Emmy Award winners, 1943 births, 2017 deaths, Make-up artists, People from Rome
Tommy Allsup	1931 births, 2017 deaths, Deaths from surgical complications, American country guitarists, Musicians from Oklahoma, Native American people, American record producers, Grammy Award winners, People from Springfield, Missouri, Deaths from hernia
Kenny Wharram	1933 births, 2017 deaths, Canadian ice hockey right wingers, Chicago Blackhawks players, Deaths from heart failure, Lady Byng Memorial Trophy winners, Sportspeople from Ontario
Jean-Jacques Annaud	1943 births, Living people, French movie directors, French movie producers, French screenwriters, People from Ile-de-France
Mont Aigoual	Mountains of France, Occitanie
Stanley Russ	1930 births, 2017 deaths, Cancer deaths in the United States, Deaths from acute myeloid leukemia, Disease-related deaths in Arkansas, Politicians from Arkansas, US Democratic Party politicians, State legislators of the United States
Russell Trood	1948 births, 2017 deaths, Cancer deaths in Queensland, Deaths from thyroid cancer, Liberal Party of Australia politicians, Members of the Australian Senate, Politicians from Melbourne, Politicians from Queensland
Mark Andrews	1926 births, 2020 deaths, United States representatives from North Dakota, United States senators from North Dakota, US Republican Party politicians
Roger Angell	1920 births, Living people, Writers from New York City
Douglas Wass	1923 births, 2017 deaths, Civil servants, British politicians, People from Nottingham
Tony Rosato	1954 births, 2017 deaths, Actors from Toronto, Canadian comedians, Canadian movie actors, Canadian television actors, Canadian voice actors, Cardiovascular disease deaths in Canada, Deaths from myocardial infarction, Disease-related deaths in Ontario, People from Naples
Gavin Whittaker	1970 births, 2017 deaths, Australian rugby league players, Cancer deaths in Queensland, Deaths from stomach cancer, Sportspeople from Queensland
Allgäu Alps	Allgäu Alps, Mountain ranges of the Alps, Mountain ranges of Germany, Mountains of Austria
Lucina da Costa Gomez-Matheeuws	1929 births, 2017 deaths, Dutch women politicians, Netherlands Antilles
Großer Krottenkopf	Allgäu Alps, Mountains of Austria, Tyrol (state)
Tony Booth (artist)	1933 births, 2017 deaths, Cancer deaths in England, English artists, People from Merseyside
Party for Freedom	Islamophobia, Nationalist organizations in Europe, Eurosceptic parties, Political parties in the Netherlands, 2006 establishments in the Netherlands
Anthony King (professor)	1934 births, 2017 deaths, British academics, British educators, British scientists, Canadian scientists, Political scientists
Claudia Poll	1972 births, Living people, Costa Rican sportspeople, Olympic bronze medalists, Olympic gold medalists, Swimmers
Silvia Poll	1970 births, Living people, Costa Rican sportspeople, Olympic silver medalists, Swimmers
Yelko Gómez	1989 births, Living people, Cyclists, Panamanian sportspeople
Igloofest	Music festivals, 2007 establishments in Canada
Graham Taylor	1944 births, 2017 deaths, Cardiovascular disease deaths in England, Deaths from myocardial infarction, English footballers, England national football team managers, English football managers, Officers of the Order of the British Empire, Sportspeople from Nottinghamshire
Dash	Punctuation
Hohes Licht	Allgäu Alps, Mountains of Austria, Tyrol (state)
Oil refining	Industries
Barbary	History of Africa, 16th-century establishments, 19th-century disestablishments
New Braunfels, Texas	Cities in Texas, County seats in Texas, 1845 establishments in the United States, 1840s establishments in Texas
Brian Fletcher	1947 births, 2017 deaths, Cancer deaths in England, English sportspeople
Partisan	International law
Nikolay Neprimerov	1921 births, 2017 deaths, Russian academics, Russian physicists
One-Two-GO Airlines Flight 269	2007 aviation disasters, 2007 in Asia, 2000s in Thailand
Giulio Angioni	1939 births, 2017 deaths, Italian writers, European anthropologists, People from Sardinia
Central Department	Departments of Paraguay
Jim Bunning	1931 births, 2017 deaths, Cardiovascular disease deaths in the United States, Deaths from stroke, Detroit Tigers players, Los Angeles Dodgers players, Philadelphia Phillies players, Pittsburgh Pirates players, Sportspeople from Kentucky, United States representatives from Kentucky, United States senators from Kentucky, US Republican Party politicians
Meir Banai	1961 births, 2017 deaths, Cancer deaths in Israel, Israeli pop singers, Israeli singers, Jewish Israeli musicians, People from Beer Sheba, Pop musicians, Rock musicians, Rock singers, Singer-songwriters, Soul musicians
2010 Dutch general election	2010 elections, 2010s in the Netherlands, Elections in the Netherlands
Venkateswara Temple, Tirumala	Temples in India
Christian Democratic Appeal	Christian democratic parties, Political parties in the Netherlands, Christianity in the Netherlands, 1980s establishments in the Netherlands, 1980 establishments in Europe
Democrats 66	Liberal parties, Political parties in the Netherlands, 1960s establishments in the Netherlands, 1966 establishments in Europe
Euroscepticism	European Union
Sweden Democrats	1988 establishments in Sweden, Eurosceptic parties, Political parties in Sweden
Ari Rath	1925 births, 2017 deaths, Austrian Jews, Israeli journalists, Jewish Israeli writers, Naturalized citizens of Israel, Refugees from Nazism, Writers from Vienna
Alexandra Föderl-Schmid	1971 births, Living people, Austrian journalists, People from Upper Austria
Palakkad	Cities in Kerala
Irfan Pathan	1984 births, Living people, Indian cricketers
Anton Nanut	1932 births, 2017 deaths, Classical musicians, Conductors, Deaths from disease, Slovenian people
Oude IJsselstreek	2005 establishments in the Netherlands, Municipalities of Gelderland
Aa en Hunze	Aa en Hunze, 1990s establishments in the Netherlands, 1998 establishments in Europe
Tracer	Comics characters, Fictional lesbians, Fictional British people, Video game characters
Noordoostpolder	Municipalities of Flevoland, Former municipalities of Overijssel
Dronten	Settlements in Flevoland, Municipalities of Flevoland
Zeewolde	Settlements in Flevoland, Municipalities of Flevoland
Kosi River	Rivers of Bihar, Rivers of India, Rivers of Nepal
Jallikattu	Events in India, History of Tamil Nadu
Scallion	Vegetables
Achtkarspelen	Municipalities of Friesland
Ameland	West Frisian Islands, Municipalities of Friesland
Hochfrottspitze	Allgäu Alps, Geography of Bavaria, Tyrol (state), Mountains of Austria, Mountains of Germany
Stadskanaal	Settlements in Groningen (province), Municipalities of Groningen (province)
Kapelle	Municipalities of Zeeland, Settlements in Zeeland
Blattodea	Insects
Milton Metz	1921 births, 2017 deaths, American radio personalities, American television personalities, People from Cleveland, Ohio, People from Louisville, Kentucky
Paleoconservatism	Conservatism, Political movements, Anti-Communists
Vsevolod Murakhovsky	1926 births, 2017 deaths, Ukrainian politicians, Russian politicians
John Jacobs (English golfer)	1925 births, 2017 deaths, British golfers, English businesspeople, Sportspeople from Yorkshire, Writers from Yorkshire
Antony Armstrong-Jones, 1st Earl of Snowdon	1930 births, 2017 deaths, English photographers, Movie directors from London, Writers from London
Gilberto Agustoni	1922 births, 2017 deaths, Cardinals of the Roman Catholic Church, Roman Catholic priests, Swiss people, Schaffhausen
Horacio Guarany	1925 births, 2017 deaths, Argentine singers, Argentine writers, Deaths from cardiac arrest, Disease-related deaths in Argentina, Folk singers, Guitarists
Magic Alex	2017 deaths, 1942 births, The Beatles, Deaths from pneumonia, Engineers, Greek businesspeople, People from Athens
Nationalist Movement Party	Political parties in Asia
National Alliance (Latvia)	Political parties in Europe, Eurosceptic parties, 2011 establishments in Europe, Establishments in Latvia
Bonaire	Bonaire
Epsom Downs railway station	Railway stations in England, 1865 establishments in England
Surjit Singh Barnala	1925 births, 2017 deaths, Disease-related deaths in India, Lieutenant governors of the Andaman and Nicobar Islands, Lieutenant Governors of Puducherry, Governors of Andhra Pradesh, Governors of Tamil Nadu, Governors of Uttarakhand, Punjabi people, Sikhism
Prayagraj	Allahabad district, Cities and towns in Uttar Pradesh
Mädelegabel	Allgäu Alps, Geography of Bavaria, Tyrol (state), Mountains of Austria, Mountains of Germany
Udo Ulfkotte	1960 births, 2017 deaths, Cardiovascular disease deaths in Germany, Deaths from myocardial infarction, German journalists, German Protestants, German political scientists, Writers from North Rhine-Westphalia
Jupiter Ghosh	1989 births, Living people, Bangladeshi cricketers
Mexicana Flight 940	Aviation disasters in the 1980s
Mark Fisher (theorist)	1968 births, 2017 deaths, Bloggers, British journalists, Suicides in the United Kingdom, Writers who committed suicide
Gil Cuerva	1995 births, Living people, Actors
ASAP (variety show)	Philippine television series, English-language television programs
Urbeleskarspitze	Allgäu Alps, Mountains of Austria, Tyrol (state)
Dabwali fire accident	1995, 1990s in India, Building and structure fires in Asia, December events, Disasters in India, Disasters in the 1990s, Haryana
Chopper (movie)	2000 comedy-drama movies, 2000 crime movies, 2000s biographical movies, 2000s black comedy movies, 2000s crime drama movies, 2000s criminal comedy movies, 2000s prison movies, Antisocial personality disorder, Australian biographical movies, Australian comedy movies, Australian crime movies, Australian drama movies, Cult movies, English-language movies, Melbourne, Movies based on books, Movies set in the 1980s, Movies set in the 1990s, Movies set in Australia, Prison comedy movies, Prison drama movies, Movies directed by Andrew Dominik
Interstate 275 (Michigan)	Interstate Highways, Transport in Michigan
Addis Ababa–Djibouti Railway	Rail transport, Djibouti, Transport in Africa
Smith & Wesson M&P	Pistols
Supergirl (TV series)	American television series, Action television series, Drama television series, CBS network shows, English-language television programs
Steinschartenkopf	Allgäu Alps, Mountains of Austria, Tyrol (state)
Aswan High Dam	Buildings and structures in Egypt, Dams, 1971 establishments in Africa, 1970s establishments in Egypt
Dick Gautier	1931 births, 2017 deaths, Actors from Culver City, California, American movie actors, American stage actors, American television actors, American voice actors, Comedians from Los Angeles County, California, Disease-related deaths in Los Angeles, Singers from Los Angeles County, California
Yama Buddha	1987 births, 2017 deaths, Nepalese singers, Rap musicians
Inner peace	Peace, Meditation
Marchspitze	Allgäu Alps, Mountains of Austria, Tyrol (state)
Bretterspitze	Allgäu Alps, Mountains of Austria, Tyrol (state)
Bockkarkopf	Allgäu Alps, Geography of Bavaria, Tyrol (state), Mountains of Austria, Mountains of Germany
Lieutenant Governor of Iowa	Lieutenant Governors of Iowa
Rudolf Slánský	1901 births, 1952 deaths, Communist politicians, Czech Jews, Czechoslovak politicians, Jewish politicians, People executed by hanging
Aero Caribbean Flight 883	2010 aviation disasters, 2010 in North America, 2010s disasters in North America, November 2010 events
Herbert Mies	1929 births, 2017 deaths, German communist politicians, People from Mannheim, Politicians from Baden-Württemberg
Ferdinand Peroutka	1895 births, 1978 deaths, Czech journalists, Czech writers
Richard Divall	1945 births, 2017 deaths, Conductors, Disease-related deaths in Victoria (Australia), Musicians from Sydney, Officers of the Order of the British Empire, Order of Australia
After Eight	Candy
Biberkopf	Allgäu Alps, Geography of Bavaria, Tyrol (state), Mountains of Austria, Mountains of Germany
Hornbach chain	Allgäu Alps, Mountain ranges of the Alps, Mountain ranges of Germany, Mountains of Austria
Carlos Fernández Gondín	1938 births, 2017 deaths, Cuban politicians
Ryszard Parulski	1938 births, 2017 deaths, Polish sportspeople, People from Warsaw
James Fairfax	1933 births, 2017 deaths, Australian businesspeople, Australian philanthropists, People from Sydney
James Ferguson-Lees	1929 births, 2017 deaths, British scientists, Ornithologists
Jan Szczepański	1939 births, 2017 deaths, Polish sportspeople, Boxers
Eddie Long	1953 births, 2017 deaths, Deaths from cancer, American Baptists, People from North Carolina, People from Georgia (U.S. state)
Frank Spellman	1922 births, 2017 deaths, Jewish American sportspeople, Sportspeople from Pennsylvania
Xavier University	Big East Conference, 1931 establishments in the United States, Colleges and universities in Ohio, 20th-century establishments in Ohio
Greg Trooper	1956 births, 2017 deaths, Deaths from pancreatic cancer, Cancer deaths in Tennessee, American singer-songwriters, American guitarists, American pianists, Singers from New Jersey, Musicians from New Jersey, Writers from New Jersey
Super Mario Run	2016 video games, IOS games, Mario platform games, Nintendo video games, Video games developed in Japan, Android (operating system) games
David Modell	1960 births, 2017 deaths, Deaths from lung cancer, Businesspeople from Ohio, Businesspeople from Baltimore, Maryland, People from Willoughby, Ohio, Sportspeople from Baltimore, Maryland
Willoughby, Ohio	Cities in Ohio
Harwood Heights, Illinois	Villages in Illinois, Settlements in Cook County, Illinois, Suburbs of Chicago, Illinois
Mohammed bin Faisal Al Saud	1937 births, 2017 deaths, Saudi Arabian businesspeople
Nicodemo Scarfo	1929 births, 2017 deaths, American gangsters, People from Brooklyn
John Wightman	1938 births, 2017 deaths, Deaths from respiratory failure, American mayors, Politicians from Nebraska, US Republican Party politicians, State legislators of the United States, People from North Platte, Nebraska
Claude Steiner	1935 births, 2017 deaths, Naturalized citizens of the United States, American psychologists, Writers from Paris, Writers from California
Kevin Starr	1940 births, 2017 deaths, Deaths from myocardial infarction, American historians, Writers from San Francisco
Steve Dillon	1962 births, 2016 deaths, Artists from London, Comics artists, Deaths from appendicitis, Disease-related deaths in New York City, People from Bedfordshire
The Chainsmokers	Musical groups from New York City, American pop music groups
Krottenspitze	Allgäu Alps, Geography of Bavaria, Tyrol (state), Mountains of Austria, Mountains of Germany
Rick Parfitt	1948 births, 2016 deaths, Deaths from sepsis, Infectious disease deaths in Spain, English singer-songwriters, English rock guitarists, English rock singers, Singers from Surrey, Musicians from Surrey, Writers from Surrey, People from Woking
Marbella	Cities in Andalusia, Municipalities in Andalusia
Howard Shore	Academy Award winning composers, Golden Globe Award winning composers, Grammy Award winners, 1946 births, Living people, Canadian composers, People from Toronto
Inauguration of Donald Trump	2017 in the United States, Donald Trump, January 2017 events, United States presidential inaugurations, 2010s in Washington, D.C.
Sumiko Mizukubo	1916 births, Living people, Japanese movie actors, Japanese centenarians, Silent movie actors, Actors from Tokyo
Amin Nasir	1968 births, 2017 deaths, Asian footballers, Deaths from colorectal cancer, Football managers, Singaporean people
Barry Cassin	1924 births, 2017 deaths, Irish movie actors, Irish television actors, Irish stage actors, Actors from Dublin
List of longest-living state leaders	Lists of heads of state, Heads of government
Lists of state leaders by age	Lists of state leaders by age
Shigeru Kōyama	1929 births, 2017 deaths, Deaths from pneumonia, Disease-related deaths in Japan, Japanese stage actors, Japanese military people, Japanese movie actors, People from Hiroshima Prefecture, Japanese television actors
Franca Sozzani	1950 births, 2016 deaths, Disease-related deaths in Italy, Italian writers, Italian journalists, Mantua, People from Lombardy
Aleksandr Ezhevsky	1915 births, 2017 deaths, Centenarians, Russian engineers, Recipients of the Order of Lenin, Russian politicians, Soviet politicians
Franz Jarnach	1943 births, 2017 deaths, Actors from North Rhine-Westphalia, Cardiovascular disease deaths in Germany, Deaths from myocardial infarction, German pianists, German rock musicians, German television actors, Musicians from North Rhine-Westphalia, People from Bonn
Zdeněk Svěrák	1936 births, Living people, Czech screenwriters
Vicki Lansky	1942 births, 2017 deaths, American children's writers, Deaths from cirrhosis, Disease-related deaths in Minnesota, Writers from Louisville, Kentucky, Writers from New York
Cuvier's dwarf caiman	Crocodilia, Animals of South America
Věra Čáslavská	1942 births, 2016 deaths, Czechoslovak people, Female athletes, Gymnasts, Sportspeople from Prague
Brachistochrone curve	Mathematics, Mechanics, Physics
Heliodor Píka	1897 births, 1949 deaths, Czechoslovak people, European military people, Generals
Dermot Gallagher	1944 births, 2017 deaths, Irish politicians, Civil servants, Ambassadors to the United States
Han Peixin	1919 births, 2017 deaths, Deaths from cardiac arrest, Chinese politicians, Communists
Jiří Navrátil	1923 births, 2017 deaths, Activists, Anti-Communists, People from Prague
Eugene Cernan	1934 births, 2017 deaths, Apollo astronauts, Engineers from Illinois, American aviators, Scientists from Chicago
Jan Jánský	Czechoslovak scientists, 1873 births, 1921 deaths, Deaths from coronary artery disease
Emil Zátopek	1922 births, 2000 deaths, Czech sportspeople, Czechoslovak people, Male athletes, Olympic gold medalists
John W. Young	1930 births, Apollo astronauts, 2018 deaths, Deaths from pneumonia, Disease-related deaths in Texas, American astronauts, American aviators, Engineers from California, Scientists from San Francisco
Len Deighton	1929 births, Living people, British historians, Writers from London
Sergei Makarov	1958 births, Olympic gold medalists, Russian ice hockey players
Aswat	Human rights organizations in Asia, 2001 establishments in Asia
Kaliningrad Time	Time zones
Hans Berliner	1929 births, 2017 deaths, American chess players, American computer scientists, German Jews, Jewish American academics, Jewish American sportspeople, Naturalized citizens of the United States, Refugees from Nazism, Scientists from Berlin
David Poythress	1943 births, 2017 deaths, American military people, Politicians from Georgia (U.S. state), US Democratic Party politicians
M. M. Ruhul Amin	1942 births, 2017 deaths, Bangladeshi politicians, Bangladeshi Muslims, Chief justices, Deaths from disease
Great Comet of 1811	Comets
Dion, Pieria	Ancient Greece, Villages in Greece
Chrysaor	Greek legendary creatures
Christen-Democratisch en Vlaams	Christian democratic parties, Political parties in Europe, Politics of Belgium
Colo (gorilla)	1956 births, 2017 deaths, Individual animals, Ohio
Killing of Harambe	1999 births, 2016 deaths, Deaths by firearm in the United States, Individual animals, 2016 in the United States, 2010s in Ohio, Cincinnati, Ohio, Deaths by firearm, May 2016 events
American Pharoah	Thoroughbred racehorses
Rockabye	Pop songs, 2016 songs
Donald Trump Jr.	1977 births, Living people, Businesspeople from New York City, Children of Presidents of the United States, Trump family, Writers from New York City, American conservatives, American political writers, Television personalities from New York City, American political activists
Eric Trump	1984 births, Living people, American philanthropists, Businesspeople from New York City, Children of Presidents of the United States, Trump family
Tiffany Trump	1993 births, Living people, Models from Florida, Businesspeople from New York City, Children of Presidents of the United States, American Internet celebrities, Businesspeople from Florida, Trump family
Fred Trump	1905 births, 1999 deaths, American criminals, American philanthropists, Businesspeople from New York City, Deaths from pneumonia, Real estate developers, People with Alzheimer's disease, Trump family
Maryanne Trump Barry	1937 births, Living people, American judges, Politicians from New York City, Trump family, US Republican Party politicians, Women judges
William A. Hilliard	1927 births, 2017 deaths, American editors, Journalists from Chicago
Oscar López Rivera	1943 births, Living people, Puerto Rican people, Terrorists
Christopher C. Kraft Jr.	1924 births, 2019 deaths, Engineers from Virginia, NASA, Scientists from Virginia
Peter Jones (politician)	1933 births, 2017 deaths, Liberal Party of Australia politicians, Order of Australia, Politicians from Tasmania, Politicians from Western Australia, People from Launceston, Tasmania
Ronald Buxton	1923 births, 2017 deaths, British engineers, Conservative MPs (UK), English politicians, People from Norfolk
Nigel Spearing	1930 births, 2017 deaths, Deaths from Alzheimer's disease, Disease-related deaths in England, English politicians, Labour MPs (UK), People from Hammersmith, Politicians from London
Les Lazarowitz	1941 births, 2017 deaths, American engineers, Cancer deaths in Florida
Claude Lebey	1923 births, 2017 deaths, French critics
Steve Wright (bassist)	1950s births, 2017 deaths, American bass guitarists, Cardiovascular disease deaths in California, Deaths from myocardial infarction, Musicians from California
Sergei Aman	1957 births, Living people, People from Moscow, Russian writers, Russian novelists, Writers from Moscow, Russian journalists
Brenda C. Barnes	1950s births, 2017 deaths, Businesspeople from Chicago, American chief executives, Cardiovascular disease deaths in Chicago, Deaths from stroke
Yaron Ben-Dov	1970 births, 2017 deaths, Disease-related deaths in Israel, Israeli footballers, Jewish Israeli sportspeople
Srirangam	Islands of India, Tiruchirapalli District
Ion Besoiu	1931 births, 2017 deaths, Romanian movie actors, Romanian television actors, Romanian stage actors
Gustav Frištenský	Czech sportspeople, 1879 births, 1957 deaths, Strength athletes
Dzemijetul Hajrije	Islam, Immigration, Organizations based in the United States, 1906 establishments in the United States
Nagham Nawzat Hasan	Women who received the International Women of Courage Award, Kurdish people, Living people
Sinjar	Cities in Iraq
Takobeya labour	History of Japan, Imprisonment and detention, Labor, Poverty
Latifa Ibn Ziaten	French people, Living people, Activists, Women who received the International Women of Courage Award
Peter Abrahams	1919 births, 2017 deaths, People from Johannesburg, Jamaican people, South African writers
Yosl Bergner	1920 births, 2017 deaths, Austrian Jews, Israeli Jews, Israeli painters, Jewish artists, Naturalized citizens of Israel, People from Vienna, People from Warsaw, Polish Jews
Charles "Bobo" Shaw	1947 births, 2017 deaths, American drummers, American jazz musicians, Disease-related deaths in Missouri, Musicians from Mississippi
Rachael Heyhoe Flint, Baroness Heyhoe Flint	1939 births, 2017 deaths, English sportspeople, English philanthropists, English businesspeople, People from Wolverhampton
Kingston Parish, Jamaica	Parishes of Jamaica
Saint Andrew Parish, Jamaica	Parishes of Jamaica
Portland Parish, Jamaica	Parishes of Jamaica
Saint Thomas Parish, Jamaica	Parishes of Jamaica
Clarendon Parish, Jamaica	Parishes of Jamaica
Manchester Parish, Jamaica	Parishes of Jamaica
Saint Ann Parish, Jamaica	Parishes of Jamaica
Saint Catherine Parish, Jamaica	Parishes of Jamaica
Saint Mary Parish, Jamaica	Parishes of Jamaica
Saint Elizabeth Parish, Jamaica	Parishes of Jamaica
Saint James Parish, Jamaica	Parishes of Jamaica
Hanover Parish, Jamaica	Parishes of Jamaica
Trelawny Parish, Jamaica	Parishes of Jamaica
Westmoreland Parish, Jamaica	Parishes of Jamaica
Willow Shields	2000 births, Living people, American child actors, American dancers, American movie actors, American television actors, Actors from Albuquerque, New Mexico, Twin people from the United States
New Medical Gazette	Newspapers, Russia, 1992 establishments in Russia
Andrei Gusev	1952 births, Living people, People from Moscow, Russian writers, Russian novelists, Writers from Moscow, Russian journalists
William Margold	1943 births, 2017 deaths, Actors from Washington, D.C., American movie directors, American pornographic actors, Pornographic movie directors
Rodney Bennett	1935 births, 2017 deaths, British television directors
Hisham Al-Otaibi	1946 births, 2017 deaths, Asian politicians, Engineers, Kuwaiti people
John Little (footballer)	1930 births, 2017 deaths, Scottish footballers, Sportspeople from Calgary
Yaacov Zilberman	1954 births, Living people, Chess grandmasters, Jewish Israeli sportspeople, Naturalized citizens of Israel, Soviet sportspeople
École nationale supérieure d'informatique pour l'industrie et l'entreprise	Technical colleges and universities, Colleges and universities in France, 1968 establishments in Europe, Strasbourg, 1960s establishments in France
Eddie Filgate	1915 births, 2017 deaths, Centenarians, Fianna Fáil politicians, People from County Louth
Robert Timlin	1932 births, 2017 deaths, American judges, Politicians from Buffalo, New York
Daniel Vischer	1950 births, 2017 deaths, Cancer deaths in Switzerland, People from Basel, Swiss politicians
Ludvík Svoboda	1895 births, 1979 deaths
Kendang	Drums
Vasco Núñez de Balboa	Spanish explorers, 1475 births, 1519 deaths, Executed people
Eldar Kuliev	1951 births, 2017 deaths, Soviet writers, Russian screenwriters, Russian movie directors, Writers from Moscow
Ciel Bergman	1938 births, 2017 deaths, American painters, People from Berkeley, California
Babette Cole	1950 births, 2017 deaths, English children's writers
Steven Plaut	1951 births, 2017 deaths, American economists, Deaths from kidney cancer, Israeli academics, Israeli Jews, Israeli scientists, Jewish academics, Jewish American academics, Jewish American scientists, Naturalized citizens of Israel, Writers from Philadelphia, Pennsylvania
Jalal Allakhverdiyev	1929 births, 2017 deaths, Azerbaijani people, Mathematicians
Teori Zavascki	1948 births, 2017 deaths, Aviation deaths, Judges, Brazilian politicians
Loalwa Braz	1953 births, 2017 deaths, Murdered musicians, Brazilian singers, Brazilian writers, Singer-songwriters, People from Rio de Janeiro
Miguel Ferrer	1955 births, 2017 deaths, Deaths from throat cancer, American movie actors, American television actors, American voice actors, Actors from Santa Monica, California
José Ferrer	Academy Award winning actors, Golden Globe Award winning actors, Tony Award winning actors, 1912 births, 1992 deaths, Deaths from colorectal cancer, Puerto Rican actors, Puerto Rican movie actors, Puerto Rican television actors, Stage actors, Movie directors, People from San Juan, Puerto Rico
Mike Kellie	1947 births, 2017 deaths, English rock guitarists, English rock drummers, Musicians from Birmingham
Wayne Barrett	1945 births, 2017 deaths, Deaths from lung cancer, American journalists, Writers from Connecticut, Writers from New York City, Columbia University faculty
Shaimaa Sabbagh	1984 births, 2015 deaths, Activists, Egyptian poets, Poets
Red Adams	1921 births, 2017 deaths, Baseball players from California, Chicago Cubs players, California Angels players
Samayapuram Mariamman Temple	Hindu temples, Tiruchirapalli District
Alanganallur	Madurai district
Akhilesh Yadav	1973 births, Politicians from Uttar Pradesh, Living people
Abdul Kalam Island	Islands of India
Pulicat Lake	Andhra Pradesh, Lakes of India
Primogeniture	Law
Journalists (novel)	2010s books, Fantasy books, Novels
Jimmy Cliff	1948 births, Living people, Converts to Islam, Jamaican singers, Reggae musicians
Padma River	Rivers of Bangladesh, National symbols of Bangladesh
Molecular machine	Machines, Molecular biology
Trent Robinson	1977 births, Living people, Australian rugby league players, Coaches
National parks of Fiji	National parks in Oceania, Fiji, Lists of national parks, Oceania-related lists
Hans Breukhoven	1946 births, 2017 deaths, Cancer deaths in London, Deaths from pancreatic cancer, Dutch businesspeople, People from Rotterdam
Château Frontenac	Hotels
Western Region (Iceland)	Regions of Iceland
Öfnerspitze	Allgäu Alps, Geography of Bavaria, Tyrol (state), Mountains of Austria, Mountains of Germany
Les Demoiselles d'Avignon	Paintings, Works about prostitution
James S. Vlasto	1934 births, 2017 deaths, Deaths from COPD, Writers from New York City
Jan Kruis	1933 births, 2017 deaths, Comics artists, People from Rotterdam
Ger van Mourik	1931 births, 2017 deaths, Dutch footballers, Sportspeople from Amsterdam
Edwin Pope	1928 births, 2017 deaths, Cancer deaths in Florida, American journalists, Writers from Georgia (U.S. state)
Klaus Huhn	1928 births, 2017 deaths, German journalists, Writers from Berlin
Harry J. Middleton	1921 births, 2017 deaths, American journalists, American historians, Writers from Iowa
JYP Entertainment	South Korean record labels
Trettachspitze	Allgäu Alps, Geography of Bavaria, Mountains of Germany
Wakinosaurus	Dinosaurs of Asia
Sixpence (British coin)	British currency
Survival mode	Video game design, Video game gameplay
Noppenspitze	Allgäu Alps, Mountains of Austria
Altusried	Oberallgäu
Nemegtosaurus	Titanosaurs, Cretaceous dinosaurs
Bad Hindelang	Oberallgäu
Oberstaufen	Oberallgäu
Nomen dubium	Zoology, Taxonomy
Wiggensbach	Oberallgäu
Hochvogel	Allgäu Alps, Geography of Bavaria, Tyrol (state), Mountains of Austria, Mountains of Germany
Shaft (movie)	1970s crime drama movies, 1971 drama movies, American crime drama movies
Arrondissements of the Cantal department	Arrondissements of France, Auvergne-Rhône-Alpes
Gordon Parks	Musicians from Kansas, Writers from Kansas, American photographers, American movie directors, Cancer deaths in New York City, 1912 births, 2006 deaths
Ahmed Gailani	2017 deaths, 1932 births, Afghan politicians, Deaths from disease, Muslims, Pashtun people
Charles Liteky	1931 births, 2017 deaths, American activists, American military personnel of the Vietnam War, American Roman Catholics, People from Washington, D.C., United States Army Medal of Honor recipients
Philip Bond (actor)	1934 births, 2017 deaths, English movie actors, English television actors, People from Staffordshire
Balderschwang	Oberallgäu
Diana Thorneycroft	1956 births, Living people, Canadian photographers
Opisthocoelicaudia	Titanosaurs, Cretaceous dinosaurs
Betzigau	Oberallgäu
Acorn squash	Vegetables
Blaichach	Oberallgäu
Obermaiselstein	Oberallgäu
Bolsterlang	Oberallgäu
Arrondissement of Aurillac	Arrondissements of France, Auvergne-Rhône-Alpes
Arrondissement of Mauriac	Arrondissements of France, Auvergne-Rhône-Alpes
Buchenberg	Oberallgäu
Arrondissement of Saint-Flour	Arrondissements of France, Auvergne-Rhône-Alpes
Burgberg im Allgäu	Oberallgäu
Nurosaurus	Sauropods, Cretaceous dinosaurs
Stanley Park	1888 establishments in Canada, Vancouver, Botanical gardens, Zoos, Aquariums
Dietmannsried	Oberallgäu
Durach	Oberallgäu
Fischen	Oberallgäu
Lída Baarová	1914 births, 2000 deaths, Czech movie actors
Walter Benz	1931 births, 2017 deaths, German academics, German mathematicians, People from Mainz, University of Waterloo
Tibetan antelope	Caprids, Mammals of Asia
John Hanson	1938 births, 2017 deaths, British businesspeople, British historians, British educators, British politicians, British writers, People from Sheffield
Vahit Melih Halefoğlu	1919 births, 2017 deaths, Turkish politicians, Ambassadors of Turkey
The Roches	1973 establishments in the United States, Folk music groups, American rock bands, People from Park Ridge, New Jersey, 1970s establishments in New Jersey
Veljo Tormis	1930 births, 2017 deaths, Composers, Estonian musical entertainers
John Watkiss	1961 births, 2017 deaths, Deaths from cancer, British artists, Comics artists, People from Stoke-on-Trent
Dan Caspi	1945 births, 2017 deaths, Israeli academics, Israeli activists, Israeli journalists, Jewish academics, Jewish activists, Jewish Israeli writers, Naturalized citizens of Israel, Romanian Jews
İlhan Cavcav	1935 births, 2017 deaths, Deaths from cerebral hemorrhage, Turkish businesspeople, People from Ankara
Chen Yu-mei	1966 births, 2017 deaths, Taiwanese politicians, Civil servants
Cristina Adela Foișor	1967 births, 2017 deaths, Deaths from pneumonia, Romanian sportspeople, Chess players
Andy Marte	1983 births, 2017 deaths, Road accident deaths, Dominican Republic sportspeople, Atlanta Braves players, Cleveland Indians players, Arizona Diamondbacks players
József Torgyán	1932 births, 2017 deaths, Deaths from heart failure, Hungarian politicians, Lawyers
Pete Overend Watts	1947 births, 2017 deaths, Deaths from throat cancer, English rock guitarists, Musicians from Birmingham
Yordano Ventura	1991 births, 2017 deaths, Road accident deaths, Dominican Republic sportspeople, Kansas City Royals players
Jaki Liebezeit	1938 births, 2017 deaths, Deaths from pneumonia, German pianists, Saxophonists, Drummers, People from Dresden
Park Ridge, New Jersey	Boroughs in New Jersey
ELF/Filecoder.A	Malware
Parliament of India	Government of India
Hollywood Sign	Buildings and structures in Los Angeles, California
Jefferson Memorial	Thomas Jefferson, Buildings and structures in Washington, D.C.
The World According to Novikoff (novel)	2006 books, Novels, Fantasy books
Moshe Gershuni	1936 births, 2017 deaths, Israeli Jews, Israeli painters, Israeli sculptors, Jewish artists, People from Tel Aviv
Special Administrative Region	Geography of China
Kasaragod	Kerala
Sri Jayawardenepura Kotte	Settlements in Sri Lanka, Capital cities in Asia
Haldenwang, Oberallgäu	Oberallgäu
Deinocheirus	Cretaceous dinosaurs
Dmytro Grabovskyy	1985 births, 2017 deaths, Cyclists, Deaths from myocardial infarction, Jewish Israeli sportspeople, Naturalized citizens of Israel, Soviet Jews, Ukrainian Jews, Ukrainian sportspeople
Gorden Kaye	1941 births, 2017 deaths, English movie actors, English television actors, English stage actors, English comedians, Actors from Yorkshire, People from Huddersfield
Ruth Samuelson	1959 births, 2017 deaths, Deaths from ovarian cancer, Politicians from South Carolina, Politicians from North Carolina, US Republican Party politicians
Time in Russia	Time by country, Russia
SpongeBob SquarePants (season 1)	SpongeBob SquarePants seasons, 1999 television seasons, 2000 television seasons, 2001 television seasons
SpongeBob SquarePants (season 3)	SpongeBob SquarePants seasons, 2000s television seasons, 2001 television seasons
Samhain	Festivals
Andrew Telegdi	1946 births, 2017 deaths, Hungarian politicians, People from Budapest, Politicians from Ontario, Privy Councillors (Canada)
FAW Group	China
Richard DeVos	1926 births, 2018 deaths, Infectious disease deaths in the United States, American Calvinists, Businesspeople from Grand Rapids, Michigan, Richard DeVos
Cère	Rivers of France, Auvergne-Rhône-Alpes, Nouvelle-Aquitaine, Occitanie
California National Party	Political parties in the United States, 2015 establishments in California, Politics of California
Yes California	Political activists
Administrator of the Small Business Administration	Administrators of the Small Business Administration, 1953 establishments in the United States
Vincent Viola	1956 births, Living people, American philanthropists, American military people, Businesspeople from New York City
Heather Wilson	1960 births, Living people, Businesspeople from New Hampshire, Businesspeople from New Mexico, American military people, American educators, Politicians from New Hampshire, United States representatives from New Mexico, United States Secretaries of the Air Force, US Republican Party politicians
The Mirage	Hotels, Buildings and structures in Nevada, Las Vegas, Nevada
Marta Kubišová	1942 births, Living people, Czech singers
Ouija board	Board games
Plomb du Cantal	Mountains of France, Auvergne-Rhône-Alpes
Xin Zhui	Emperors and Empresses of China, Chinese royalty, Deaths from hypertension
Table (landform)	Landforms
Meierijstad	Meierijstad, 2017 establishments in the Netherlands
Chandannagar	Cities in India
Abenaki language	Languages of North America
Stencil	Printing
Virender Sehwag	Indian cricketers, Living people, Year of birth missing (living people)
Place of articulation	Anatomy
Naqsh Lyallpuri	1927 births, 2017 deaths, Indian writers, Songwriters
Henry McMaster	1947 births, Living people, Governors of South Carolina, US Republican Party politicians, Lieutenant Governors of South Carolina
Lawrence Kudlow	1947 births, Living people, Directors of the National Economic Council, American columnists, American economists, American journalists, American Roman Catholics, American television personalities, Bloggers, Jewish American entertainers, Jewish American writers, People from Englewood, New Jersey, Television personalities from New Jersey, University of Rochester alumni, Writers from New Jersey, American bloggers
Daya (singer)	American R&B singers, American pop musicians, Musicians from Pittsburgh, Pennsylvania, Singers from Pittsburgh, Pennsylvania, 1998 births, Living people
Immenstadt	Oberallgäu
Tiliqua scincoides	Reptiles of Australia
Soweto Uprising	20th century riots, Apartheid-related violence
Siewert Öholm	1939 births, 2017 deaths, Cancer deaths in Sweden, Deaths from liver cancer, Swedish journalists, Swedish radio personalities, Swedish television presenters
Carlos Verdejo	1934 births, 2017 deaths, Chilean footballers
Chuck Weyant	1923 births, 2017 deaths, American racecar drivers, Sportspeople from Ohio
Fred André	1941 births, 2017 deaths, Dutch football managers, Dutch footballers, People from Haarlem, Sportspeople from North Holland
Søren Elung Jensen	1928 births, 2017 deaths, Danish movie actors, Danish television actors, Deaths from lung cancer, Disease-related deaths in Denmark
Perthshire	Counties of Scotland
Trehafod	Villages in Wales, 1850s establishments in the United Kingdom
Cantons of Bolivia	Cantons, Geography of Bolivia
Ad astra (phrase)	Latin phrases
Politics of the Netherlands	Politics of the Netherlands
P53	Genetics, Cancer
PIA Flight 268	1992 in Asia, 1990s disasters in Asia, Aviation disasters in Asia, Aviation disasters in the 1990s, History of Nepal, September events
Mauriac, Cantal	Subprefectures in France, Communes in Cantal
Rudolf Wille	1937 births, 2017 deaths, German mathematicians, People from Bremen (state)
Ralph Guglielmi	1933 births, 2017 deaths, American football quarterbacks, New York Giants players, Sportspeople from Columbus, Ohio, Philadelphia Eagles players, St. Louis Cardinals players, Washington Redskins players
Butch Trucks	1947 births, 2017 deaths, American rock drummers, Musicians from Jacksonville, Florida, Rock and Roll Hall of Fame inductees, Suicides by firearm in the United States
Giovanni Corrieri	1920 births, 2017 deaths, Italian cyclists, People from Sicily, Tour de France cyclists
Chuck Canfield	1932 births, 2017 deaths, Deaths from natural causes, Disease-related deaths in Minnesota, American mayors, American Christians, Businesspeople from Minnesota, Politicians from Minnesota, Independent politicians in the United States, People from Rochester, Minnesota
TAM Airlines Flight 3054	2007 aviation disasters, 2000s in Brazil
Byron Dobell	1927 births, 2017 deaths, Deaths from Parkinson's disease, Disease-related deaths in New York City, American artists, American journalists, Writers from New York City
Leslie Koo	1954 births, 2017 deaths, Accidental deaths from falls, Deaths from cerebral hemorrhage, Billionaires, Taiwanese businesspeople
Tom Wolfe	1930 births, 2018 deaths, Infectious disease deaths in New York City, American journalists, Writers from Virginia, People from Richmond, Virginia
Nigel Rodley	1941 births, 2017 deaths, British activists, British lawyers, Disease-related deaths in England, Human rights activists, Jewish activists, Jewish British academics, Knights Bachelor
Alagnon	Rivers of France, Auvergne-Rhône-Alpes
Fondation IONIS	Non-profit organizations of France, Education in France
Gil Ray	1957 births, 2017 deaths, American rock drummers, American rock guitarists, American rock singers, Cancer deaths in the United States, Entertainers from Charlotte, North Carolina
Alexander Kadakin	1949 births, 2017 deaths, Ambassadors of Russia, Cardiovascular disease deaths in India, Deaths from heart failure, People from Chișinău
Katja of Sweden	1920 births, 2017 deaths, Fashion designers, Swedish people
Province of Georgia	1730s establishments in the Thirteen Colonies, 1732 establishments, 18th-century establishments in Georgia (U.S. state)
Lauben	Oberallgäu
Siamogale melilutra	Extinct species, Mustelids
Caning	Torture, Punishments
Drumchapel	Towns in Scotland
2017 Women's March	2017 in the United States, Donald Trump, Feminism, January 2017 events, Protests in the 2010s, 2010s in Washington, D.C.
Harry Mathews	1930 births, 2017 deaths, Deaths from natural causes, Disease-related deaths in Florida, American poets, American historians, American journalists, Writers from New York City, Writers from Massachusetts
Niki de Saint Phalle	1930 births, 2002 deaths, Deaths from emphysema, Cancer deaths in California, French painters, French sculptors, French movie directors, People from Hauts-de-France, Pop artists
Angelino Alfano	1970 births, Living people, Italian politicians
Saint-Flour, Cantal	Subprefectures in France, Communes in Cantal
Bernard Cazeneuve	1963 births, Living people, French mayors, Prime Ministers of France, Government ministers of France, Socialist Party (France) politicians
Jack Mendelsohn	1926 births, 2017 deaths, Deaths from lung cancer, American television writers, American screenwriters, American comics artists, American painters, Writers from New York City
Azerbaijan Basketball Federation	1992 establishments in Azerbaijan, Basketball in Azerbaijan, Sport in Azerbaijan
Tam Dalyell	1932 births, 2017 deaths, Scottish politicians, Scottish writers, People from Edinburgh
River Edge, New Jersey	Towns in New Jersey
Robert Garcia (New York politician)	1933 births, 2017 deaths, Deaths from emphysema, Infectious disease deaths in the United States, People from the Bronx, Politicians from New York City, United States representatives from New York, US Democratic Party politicians
Robert Garcia (California politician)	1977 births, Living people, American mayors, Gay men, LGBT people from California, LGBT politicians, People from Lima, People from Long Beach, California, US Democratic Party politicians
Missen-Wilhams	Oberallgäu
Robert Folsom	1927 births, 2017 deaths, Mayors of Dallas, Real estate developers, Deaths from natural causes
Billy Simpson	1929 births, 1958 FIFA World Cup players, 2017 deaths, Northern Irish footballers, People from Belfast
Rory McIlroy	1989 births, Living people, British golfers, Members of the Order of the British Empire, Northern Irish sportspeople
Banggai cardinalfish	IUCN Red List endangered species
Ofterschwang	Oberallgäu
Bimba Bosé	1975 births, 2017 deaths, Actors from Madrid, Actors from Rome, Cancer deaths in Spain, Deaths from breast cancer, Spanish models, Spanish movie actors, Spanish singers, Spanish television actors
Valery Bolotov	1970 births, 2017 deaths, Heads of state, Ukrainian military people, Ukrainian politicians
Northeast Italy	Geography of Italy
Oy-Mittelberg	Oberallgäu
Painted lady	Nymphalidae
Bob Fosse	American dancers, Tony Award winners, 1927 births, 1987 deaths, Actors from Chicago, American choreographers
Dylan McDermott	Actors from Connecticut, Golden Globe Award winning actors, 1961 births, Living people, American movie actors, American television actors, American voice actors, American stage actors, People from Waterbury, Connecticut
Cupbearer	Occupations
Liao dynasty	Chinese dynasties
Luciano Ravaglia	1923 births, 2017 deaths, Italian scientists, Italian engineers
Rayville, Louisiana	Towns in Louisiana, Parish seats in Louisiana
Time in Iran	Time by country, Iran
Čelinac	Settlements in Bosnia and Herzegovina
Northwest Italy	Geography of Italy
Kevin Geer	1952 births, 2017 deaths, Actors from Nevada, American movie actors, American stage actors, American television actors, Cardiovascular disease deaths in New York City, Deaths from myocardial infarction
Heng Freylinger	1926 births, 2017 deaths, Luxembourgian sportspeople, Olympians, Wrestlers
Bob Holiday	1932 births, 2017 deaths, Actors from Brooklyn, American stage actors
Gisella Sofio	1931 births, 2017 deaths, Actors from Milan, Italian movie actors, Italian television actors, Italian stage actors
Bill Fischer (American football)	1927 births, 2017 deaths, American football offensive guards, American football offensive tackles, Arizona Cardinals players, Sportspeople from Chicago
Alexander Tikhanovich	1952 births, 2017 deaths, People from Minsk, Pop singers, Soviet singers
Rettenberg	Oberallgäu
Sonthofen	Oberallgäu
Lennart Nilsson	1922 births, 2017 deaths, Swedish photographers
Sulzberg, Oberallgäu	Oberallgäu
Lauda Air Flight 004	Aviation disasters in the 1990s, May events, 1991 in Asia
Geoff Nicholls	1948 births, 2017 deaths, Cancer deaths in England, Deaths from lung cancer, English rock musicians, Heavy metal musicians, Keyboardists, Musicians from Birmingham
Insular Italy	Geography of Italy
Lucia Bosè	1931 births, 2020 deaths, Actors from Milan, Beauty pageant winners, Deaths from the COVID-19 pandemic in Spain, Deaths from pneumonia, Italian models, Italian movie actors, Italian television actors
Many Clouds	2007 births, 2017 deaths, Thoroughbred racehorses
Wim Anderiesen Jr.	1931 births, 2017 deaths, Dutch footballers, Sportspeople from Amsterdam
Smith & Wesson	Firearms, Springfield, Massachusetts, Companies based in Massachusetts, 1852 establishments in the United States, 19th-century establishments in Massachusetts
Ni Yulan	Women who received the International Women of Courage Award, Living people, Chinese people, Lawyers, 1960 births
Tirso (river)	Sardinia, Rivers of Italy
Theo Brokmann Jr.	1922 births, Living people, Dutch footballers, Sportspeople from Amsterdam
Michael Tönnies	1959 births, 2017 deaths, German footballers, Sportspeople from Essen
Piet Ouderland	1933 births, 2017 deaths, Dutch basketball players, Dutch footballers, Sportspeople from Amsterdam
Henry-Louis de La Grange	1924 births, 2017 deaths, Deaths from pneumonia, Musicologists, French music critics, Writers from Paris
Christopher Bland	1938 births, 2017 deaths, BBC, British businesspeople, British politicians, Cancer deaths in England, Deaths from prostate cancer
Number One Observatory Circle	Buildings and structures in Washington, D.C., Vice Presidents of the United States
Waltenhofen	Oberallgäu
Weitnau	Oberallgäu
Kaniyan Pungundranar	Tamil people
Andreas Sparman	Swedish writers, Swedish physicians, 1609 births, 1658 deaths
Elkin Ramírez	1962 births, 2017 deaths, Colombian singers, Deaths from brain cancer, Rock singers, Singer-songwriters
Walt Streuli	1935 births, 2017 deaths, Detroit Tigers players, Sportspeople from Memphis, Tennessee
R-dropping	Pronunciation, Linguistics
Jamshid Giunashvili	1931 births, 2017 deaths, Scientists from Georgia (country), Linguists, Ambassadors, People from Tehran
Brunhilde Pomsel	1911 births, 2017 deaths, German centenarians, People from Berlin
Anne-Marie Colchen	1925 births, 2017 deaths, French sportspeople
Sachet d'épices	Cooking methods
Laurie Salas	1922 births, 2017 deaths, Human rights activists, People from Wellington
Atanas Kirov	1946 births, 2017 deaths, Deaths from myocardial infarction, Bulgarian sportspeople
Fine Air Flight 101	1997 in the United States, Aviation disasters in the 1990s, Aviation disasters in the United States, August events, 1990s in Florida, History of Miami, Florida
Zakia Soman	Activists, Living people, Indian activists, Year of birth missing (living people)
Howard Frank Mosher	1942 births, 2017 deaths, Deaths from prostate cancer, American educators, Writers from New York, Writers from Vermont
Stuart Timmons	1957 births, 2017 deaths, American historians, American journalists, American LGBT rights activists, Deaths from cardiac arrest, Gay men, LGBT journalists, LGBT people from Los Angeles, California, Writers from Minneapolis, Minnesota, Writers from Los Angeles, California
Ion Ungureanu	1935 births, 2017 deaths, Moldovan politicians, Moldovan people, Movie actors
Rocket League	2015 video games, Sports video games, Windows games, PlayStation 4 games, Xbox One games
Psyonix	2000 establishments in the United States, Video game companies
Darryl Sutton	1952 births, 2017 deaths, Australian rules footballers, Deaths from pneumonia, Infectious disease deaths in Australia, People from Tasmania
Richard Portman	1934 births, 2017 deaths, Academy Award winners, Accidental deaths from falls in the United States, Engineers from California, People from Los Angeles, California
Arthur H. Rosenfeld	1926 births, 2017 deaths, American physicists, Deaths from pneumonia, Infectious disease deaths in California, Scientists from Birmingham, Alabama
Impasto	Painting
Azerbaijan Volleyball Federation	1991 establishments, Volleyball, Sport in Azerbaijan, 1990s establishments in Azerbaijan
Iraqi Airways	Airlines of the Middle East, 1946 establishments in Asia, 20th century establishments in Iraq
Tokitenkū Yoshiaki	1979 births, 2017 deaths, Deaths from lymphoma, Disease-related deaths in Japan, Mongolian people, Sport in Mongolia, Sumo wrestlers
Leonard H. Perroots	2017 deaths, 1933 births, American generals, Disease-related deaths in the United States, United States Air Force, People from West Virginia
Deaths in February 2017	2017 deaths, February 2017 events
Thomas Joseph Simpson	1921 births, 2017 deaths, Canadian military personnel of World War II, People from Ontario
Masaya Nakamura (Namco)	1925 births, 2017 deaths, Businesspeople from Tokyo, Japanese movie producers, Namco
Erland Kolding Nielsen	1947 births, 2017 deaths, Danish academics
Sambre	Rivers of France, Rivers of Belgium, Hauts-de-France, Wallonia, Hainaut (province), Namur (province), Charleroi
Elizabeth Báthory	1560 births, 1614 deaths, Hungarian people, Prisoners sentenced to life imprisonment, Royalty and nobility, Serial killers
Charles Michel	1975 births, Living people, Alderman of Belgium, Belgian lawyers, Belgian mayors, Government ministers of Belgium, Mouvement réformateur (Belgium) politicians, People from Namur, Presidents of the European Council, Prime Ministers of Belgium, Walloon politicians
Louis d'Orléans, Prince of Condé	1845 births, 1866 deaths, House of Orléans
Dana Air Flight 992	2012 disasters, 2010s in Nigeria, Aviation disasters in the 2010s, July events, Lagos, Transport in Nigeria
Bocas del Toro Province	Provinces of Panama
Marta Becket	1924 births, 2017 deaths, Deaths from congestive heart failure, American dancers, American painters, American choreographers, Entertainers from New York City
James S. C. Chao	1927 births, Living people, Naturalized citizens of the United States, Chinese businesspeople, Businesspeople from New York City, American philanthropists, People from Shanghai
John Wetton	1949 births, 2017 deaths, Deaths from colorectal cancer, Cancer deaths in England, British singer-songwriters, British bass guitarists, British keyboardists, People from Derbyshire
Philip M. Bilden	1964 births, Living people, Businesspeople from Indiana, American philanthropists, American activists
James Comey	1960 births, Living people, American lawyers, Directors of the Federal Bureau of Investigation, Independent politicians in the United States, Politicians from New York, United States Deputy Attorneys General
E. Ahamed	1938 births, 2017 deaths, Deaths from cardiac arrest, Indian politicians, Civil servants, People from Kerala
Filostrato (poem)	Epic poems
Concha Ibáñez	1926 births, Living people, Spanish painters, Spanish writers
Etel Adnan	1924 births, Living people, Naturalized citizens of the United States, Lebanese poets, American feminist writers, American poets, American artists, Lesbian feminists, LGBT writers, LGBT people from California, Writers from California
Grethe Bartram	1924 births, 2017 deaths, Danish people, World War II people, Communists
Neil Gorsuch	1967 births, Living people, American judges, United States Supreme Court justices, Politicians from Denver, Colorado, US Republican Party politicians
Frank Pellegrino (actor)	1944 births, 2017 deaths, Actors from Manhattan, American movie actors, American television actors, Cancer deaths in New York City, Deaths from lung cancer, Restaurateurs, Writers from Manhattan
David Burhani	1990 births, 2017 deaths, African footballers, Tanzanian people
Side chain	Organic chemistry
John N. Mather	1942 births, 2017 deaths, American mathematicians, Harvard University alumni, People from Los Angeles, California, Princeton University alumni
Bharati Mukherjee	1940 births, 2017 deaths, Deaths from cardiomyopathy, American educators, American writers, Cardiovascular disease deaths in New York City, People from Kolkata
Eli Zelkha	1950 births, 2017 deaths, Businesspeople from California, Iranian Jews, Jewish American academics, Jewish businesspeople, Naturalized citizens of the United States, People from Tehran, Stanford University alumni
Tabor	Percussion instruments
Queenstown, New Zealand	Cities in New Zealand
Sandy Gandhi	1958 births, 2017 deaths, Australian comedians, Columnists, People from New Delhi, Writers from New South Wales, Writers from Victoria (Australia)
Deke Leonard	1944 births, 2017 deaths, British rock guitarists, Welsh rock musicians
Rhondda	Geography of Wales
Porth	Villages in Wales
Cymmer, Rhondda Cynon Taf	Villages in Wales
Ynyshir	Villages in Wales
Trealaw	Villages in Wales
Klootschieten	Sport in Europe
German Americans	Ethnic groups in the United States
Étienne Tshisekedi	1932 births, 2017 deaths, African politicians, Deaths from pulmonary embolism, Disease-related deaths in Belgium, Prime Ministers of the Democratic Republic of the Congo
Paul-Eerik Rummo	Poets, 1942 births, Living people, Estonian people
Dan Spiegle	1920 births, 2017 deaths, American comics artists, American cartoonists, People from Washington
Guitar Gable	1937 births, 2017 deaths, American singer-songwriters, American blues musicians, American pop musicians, American pop singers, American guitarists, Singers from Louisiana, Writers from Louisiana, Musicians from Louisiana
Aleksander Jackowski	1920 births, 2017 deaths, Polish writers, European anthropologists, Polish historians, Critics, Polish educators, People from Warsaw
Air France Flight 358	Aviation, Ontario, Disasters in Canada, 2005 in Canada
Bobby Freeman	1940 births, 2017 deaths, American singer-songwriters, American soul musicians, American R&B musicians, American R&B singers, Singers from California, Musicians from San Francisco, Writers from San Francisco, People from Richmond, California
Marcel Prud'homme	1934 births, 2017 deaths, Deaths from myocardial infarction, Politicians from Montreal
Desmond Carrington	1926 births, 2017 deaths, Deaths from Alzheimer's disease, British television actors, British radio actors, British stage actors, British radio personalities, Actors from Kent
Ken Morrison	1931 births, 2017 deaths, English businesspeople, People from Yorkshire
Abdulkadir Kure	1956 births, 2017 deaths, Disease-related deaths in Germany, Governors, Nigerian politicians
José Antonio Alonso	1960 births, 2017 deaths, Cancer deaths in Spain, Deaths from lung cancer, Government ministers, Spanish judges, Socialist politicians, Spanish politicians, Spanish socialists
Albano Bortoletto Cavallin	1930 births, 2017 deaths, Brazilian people, Deaths from surgical complications, Roman Catholic archbishops
Stig Grybe	1928 births, 2017 deaths, Swedish comedians, Disease-related deaths in Sweden, Actors from Stockholm, Swedish movie actors, Swedish stage actors, Swedish television actors, Swedish voice actors
Ramón Martínez Pérez	1929 births, 2017 deaths, Spanish footballers, Melilla
Ahmed Aboutaleb	1961 births, Living people, Deputy government ministers of the Netherlands, Aldermen of the Netherlands, Dutch civil servants, Dutch journalists, Dutch mayors, Dutch Muslims, Labour Party (Netherlands) politicians, Moroccan politicians, Naturalised citizens of the Netherlands, Politicians from Amsterdam, Politicians from Rotterdam
David Copperfield	Books by Charles Dickens, English novels, English-language novels
Dadou	Rivers of France, Occitanie
Oran	Cities in Algeria, 903 establishments, Establishments in Algeria, 10th-century establishments in Africa
Boston accent	Dialects of English, Pronunciation
Flag of Portland, Oregon	Portland, Oregon
Patria (novel)	Non-fiction literature, 2016 books
Princess Françoise, Mademoiselle d'Estouteville	1728 births, 1743 deaths, House of Grimaldi, Deaths from smallpox
Marisa Letícia Lula da Silva	1950 births, 2017 deaths, Brazilian people, Deaths from stroke, Disease-related deaths in Brazil
Predrag Matvejević	1932 births, 2017 deaths, Academics, Bosnia and Herzegovina writers, Croatian writers
Jeff Sauer	1943 births, 2017 deaths, American ice hockey players, Cancer deaths in the United States, Deaths from pancreatic cancer, Ice hockey coaches, Sportspeople from Wisconsin
Cor van der Hoeven	1921 births, 2017 deaths, Dutch footballers, Sportspeople from Amsterdam
Imljani	Settlements in Bosnia and Herzegovina, Villages in Europe
Marie Anne Éléonore de Bourbon	1690 births, 1760 deaths, House of Bourbon, Nuns, People from Versailles
Debra Baptist-Estrada	Women who received the International Women of Courage Award, Living people, Belizean people, Immigration, Year of birth missing (living people)
Sara Hossain	Living people, Bangladeshi lawyers, Women who received the International Women of Courage Award, Year of birth missing (living people), Women lawyers
Flash Airlines Flight 604	Aviation disasters in the 2000s, 2004, 21st century in Egypt, 2000s in France, 2000s in Africa
Fatemeh Ekhtesari	Living people, Year of birth missing (living people), Iranian poets, 1984 births
Asim Basu	1935 births, 2017 deaths, Deaths from respiratory tract infection, Designers, Infectious disease deaths in India, Painters, People from Odisha
Lou Rowan	2017 deaths, 1925 births, Australian police officers, Cricket, People from New South Wales
Hassan Joharchi	1968 births, 2017 deaths, Deaths from cardiac arrest, Deaths from liver disease, Disease-related deaths in Iran, Iranian actors, People from Tehran
Elliot Sperling	1951 births, 2017 deaths, American academics, American activists, American historians, Human rights activists, People from New York City, Translators
Kneževo, Bosnia and Herzegovina	Settlements in Bosnia and Herzegovina
Čemernica (Bosnia)	Geography of Bosnia and Herzegovina
Zabrđe (Kotor-Varoš)	Settlements in Bosnia and Herzegovina
Grabovica (Kotor-Varoš)	Settlements in Bosnia and Herzegovina
Tunceli	Cities in Turkey
Lufengosaurus	Prosauropods, Jurassic dinosaurs, 1940s in Asia
Fusome	Cell biology
Cartago Province	Provinces of Costa Rica
Robert Dahlqvist	1976 births, 2017 deaths, Rock guitarists, Swedish singers
Rob Stewart (filmmaker)	1979 births, 2017 deaths, Accidental deaths by drowning in the United States, Canadian movie directors, Canadian photographers, Writers from Toronto
Sang Chul Lee	1924 births, 2017 deaths, Canadian Christians, Christian clergy
Mario R. Ramil	1946 births, 2017 deaths, American judges, Cancer deaths in the United States, People from Quezon City, Politicians from San Francisco
Eiður Svanberg Guðnason	1939 births, 2017 deaths, Ambassadors, Icelandic politicians, People from Reykjavík
Gordon Aikman	1985 births, 2017 deaths, British activists, Scottish LGBT people, Deaths from motor neurone disease, Disease-related deaths in Scotland, Gay men, People from Fife
Georgi Taratorkin	1945 births, 2017 deaths, Disease-related deaths in Moscow, People from Saint Petersburg, Russian movie actors, Russian television actors, Russian stage actors
Yoshiro Hayashi (politician)	1927 births, 2017 deaths, Deaths from multiple organ failure, Japanese politicians, People from Yamaguchi Prefecture
Aito Mäkinen	1927 births, 2017 deaths, Finnish movie directors, Finnish movie producers, Finnish screenwriters
Marquesas Islands	Islands of French Polynesia
Cerium(IV) oxide	Oxides
Jaguarundi	Felines
West Kalimantan	Provinces of Indonesia
Jacques I, Prince of Monaco	House of Grimaldi, 1689 births, 1751 deaths, Dukes and duchesses of France, Princes and princesses of Monaco
Starboy (album)	2016 albums, The Weeknd
MVG Class B	Rolling stock, Munich, 1981 establishments in Europe, 1980s establishments in Germany
We've Only Just Begun	Pop songs, Pop ballads, 1970 songs
Nickelodeon Animation Studios	Nickelodeon, Animation studios
MVG Class A	Munich, Rolling stock, 1971 establishments in Germany
Heredia Province	Provinces of Costa Rica
Desmosome	Cell biology
Cell junction	Cell biology
Basil Hetzel	1922 births, 2017 deaths, Australian medical doctors, Order of Australia, People from Adelaide, Scientists from South Australia
Björn Granath	1946 births, 2017 deaths, Disease-related deaths in Sweden, People from Gothenburg, Swedish movie actors, Swedish stage actors, Swedish television actors, Swedish voice actors
Sonny Geraci	1947 births, 2017 deaths, American rock singers, Musicians from Cleveland, Ohio
Miltos Papapostolou	1936 births, 2017 deaths, Greek footballers, Greek football managers
Dritëro Agolli	1931 births, 2017 deaths, Albanian politicians, Deaths from lung disease, Poets
Luis Gómez-Montejano	1922 births, 2017 deaths, People from Madrid
Shumon Miura	1926 births, 2017 deaths, Deaths from pneumonia, Japanese novelists, Japanese educators, Writers from Tokyo
Benny Perrin	1959 births, 2017 deaths, People who committed suicide, Arizona Cardinals players, Sportspeople from California, People from Orange County, California
Lars-Erik Berenett	1942 births, 2017 deaths, Deaths from spinal cancer, Swedish movie actors, Swedish television actors
Marc Spitz	1969 births, 2017 deaths, American journalists, American playwrights, Writers from New York City
Amteka	Villages in India
Puntarenas Province	Provinces of Costa Rica
Electric locomotive	Locomotives
Sean Spicer	1971 births, Living people, White House Press Secretaries, White House Communications Directors, Politicians from New York, US Republican Party politicians
Heckler & Koch MSG90	Rifles
Hans van der Hoek	1933 births, 2017 deaths, Dutch footballers, Sportspeople from Rotterdam
Edward Shames	1922 births, Living people, American military people, People from Virginia
Edward Tipper	1921 births, 2017 deaths, American military people, People from Detroit, Michigan, People from Colorado
Gurudev Kalicharan Brahma Academy	Schools in India, 2009 establishments in Asia, 2000s establishments in India
George E. Smith	1939 births, Living people, American physicists, Scientists from New York
Amteka High School	Assam, Schools in India, 1996 establishments in Asia, 1990s establishments in India
Rosa Taikon	1926 births, 2017 deaths, Activists, Swedish movie actors
Steve Lang	1949 births, 2017 deaths, Canadian rock guitarists, Musicians from Montreal
Carmen Contreras-Bozak	1919 births, 2017 deaths, American military personnel of World War II, People from New York City, Puerto Rican people
Crewe railway station	1830s establishments in England, 1837 establishments in Europe, Railway stations in England, Listed buildings, Cheshire
Ichnogenus	Taxonomy, Ichnology
José Gea Escolano	1929 births, 2017 deaths, People from the Community of Valencia, Roman Catholic bishops, Spanish Roman Catholics
Roger Walkowiak	1927 births, 2017 deaths, French cyclists, Sportspeople from Auvergne-Rhône-Alpes, Tour de France winners
Subgenus	Taxonomy
Ritchie Yorke	1944 births, 2017 deaths, Australian journalists, Deaths from COPD, Disease-related deaths in Queensland, Australian critics, People from Brisbane, Writers from Queensland
Klagenfurt	Austrian state capitals, Districts of Carinthia (state), Cities and towns in Carinthia (state)
Wilhelm Eduard Weber	1804 births, 1891 deaths, German physicists, Fellows of the Royal Society, Foreign Members of the Royal Society, German academics, German inventors, German philosophers, German scientists, People from Saxony-Anhalt
Eisenstadt	Austrian state capitals, Districts of Burgenland, Cities and towns in Burgenland
Sankt Pölten	Austrian state capitals, Districts of Lower Austria, Cities and towns in Lower Austria
Tyrol (region)	Tyrol, Alps
Iran Air Flight 655	1988 in Asia, Aviation disasters in the 1980s, 1980s in Iran
Boy Asistio	1936 births, 2017 deaths, Filipino politicians, Mayors
Hans Rosling	1948 births, 2017 deaths, Deaths from pancreatic cancer, Swedish academics, Swedish scientists, Swedish physicians, People from Uppsala
Smail Hamdani	1930 births, 2017 deaths, Ambassadors of Algeria, Deaths from myocardial infarction, Prime Ministers of Algeria
Svend Asmussen	1916 births, 2017 deaths, Danish musicians, Jazz musicians, Violinists
Tzvetan Todorov	1939 births, 2017 deaths, Bulgarian writers, French historians, French sociologists, French philosophers, French literary critics, Writers from Paris, People from Sofia
Richard Hatch	1945 births, 2017 deaths, Deaths from pancreatic cancer, Cancer deaths in Los Angeles, American movie actors, American television actors, American voice actors, American stage actors, American television producers, American television writers, Actors from Santa Monica, California, Actors from Chicago, Writers from California, Writers from Chicago
Sotsha Dlamini	1940 births, 2017 deaths, Accidental deaths from falls, Prime Ministers of Swaziland
Richard Lyon (U.S. Admiral)	1923 births, 2017 deaths, Admirals, American mayors, Military people from California, People from Pasadena, California, Politicians from Los Angeles County, California, Yale University alumni
Steve Sumner	1955 births, 2017 deaths, Deaths from prostate cancer, English footballers, New Zealand sportspeople, People from Blackpool, Sportspeople from Lancashire
Mark Rylance	Academy Award winning actors, BAFTA Award winning actors, Tony Award winning actors, Drama Desk Award winners, 1960 births, Living people, English movie actors, English television actors, English stage actors, English voice actors, English playwrights, English theatre directors, Actors from Kent, Writers from Kent, People from Ashford, Kent
Guillermo Lasso	1955 births, Living people, Ecuadorian businesspeople, Presidents of Ecuador, Current national leaders, People from Guayaquil, Conservatives, Bankers, Political writers
Neil Gehrels	1952 births, 2017 deaths, American astronomers, American physicists, Astrophysicists, Scientists from Wisconsin
Timothy West	1934 births, Living people, English movie actors, English television actors, English stage actors, Actors from Bradford
Arthur Lehning	1899 births, 2000 deaths, Anarchists, Dutch centenarians, Dutch historians, Translators, Writers from Utrecht (city)
Paul Di'Anno	1958 births, Living people, Criminals from London, English rock singers, Fraudsters, Heavy metal singers, People from Chingford, Singers from London
Ólöf Nordal	1966 births, 2017 deaths, Deaths from pancreatic cancer, Government ministers, Icelandic politicians, People from Reykjavík
Tara Palmer-Tomkinson	1971 births, 2017 deaths, Deaths from ulcers, Deaths from peritonitis, Disease-related deaths in England, People with cancer, English models, English pianists, English television personalities, English television presenters, I'm a Celebrity...Get Me Out of Here! contestants, Socialites, Writers from Hampshire
Alan Simpson (scriptwriter)	1929 births, 2017 deaths, Deaths from lung disease, Disease-related deaths in London, English television writers, Screenwriters from London
Ray Galton	1930 births, 2018 deaths, Deaths from dementia, English television writers, Screenwriters from London
Mikhail Tolstykh	1980 births, 2017 deaths, Assassinated people, Colonels, Ukrainian military people
Antonín Přidal	1935 births, 2017 deaths, Deaths from stroke, Czech people, Czech journalists, Czech educators
Richard B. Wright	1937 births, 2017 deaths, Accidental deaths from falls, Accidental deaths in Canada, Writers from Ontario
Vladimir Vladimirovich Kara-Murza	1981 births, Living people, Russian politicians, Russian writers, Russian journalists, Human rights activists, Critics, People from Moscow
Arabesque (group)	German musical groups, 1977 establishments in Europe, 1984 disestablishments in Europe, Girl groups, Musical groups established in 1977, 1970s establishments in Germany, Musical groups disestablished in 1984
Val Demings	1957 births, Living people, African American politicians, American police officers, Politicians from Jacksonville, Florida, United States representatives from Florida, US Democratic Party politicians
Ron Rifkin	Drama Desk Award winners, Tony Award winning actors, 1939 births, Living people, American movie actors, American television actors, American stage actors, American voice actors, Actors from New York City
Mohamud Muse Hersi	1937 births, 2017 deaths, African military people, African politicians, Generals, Heads of state, Muslims, Somali politicians
Windsor Davies	1930 births, 2019 deaths, Actors from Essex, British movie actors, British television actors, British voice actors
Brendan Rodgers	1973 births, Living people, Northern Irish football managers, British Protestants, Northern Irish Christians, Northern Irish footballers
States of Austria	States of Austria
Power Rangers (movie)	English-language movies, Movies about autism, American superhero movies, 2010s superhero movies, Lionsgate movies
Arrondissements of the Vaucluse department	Arrondissements of France, Provence-Alpes-Côte d'Azur
Luxembourg (region)	Divided regions, Regions of Europe
Arrondissement of Apt	Arrondissements of France, Provence-Alpes-Côte d'Azur
Lumberton High School	Schools
Convoy	War, Transport
Luther Strange	1953 births, Living people, United States senators from Alabama, Politicians from Birmingham, Alabama, US Republican Party politicians
Dana Boente	1954 births, Living people, United States Attorneys General, American lawyers, Politicians from Illinois, Politicians from Virginia
Rod J. Rosenstein	1965 births, Living people, American lawyers, Harvard University alumni, Jewish American politicians, Jewish lawyers, Politicians from Maryland, Politicians from Philadelphia, Pennsylvania, US Republican Party politicians, United States Deputy Attorneys General
Serge Baguet	1969 births, 2017 deaths, Belgian cyclists, Cancer deaths in Belgium, Deaths from colorectal cancer, People from East Flanders
Brendan McGahon	1936 births, 2017 deaths, Irish politicians, Conservatives
Packy (elephant)	1962 births, 2017 deaths, Deaths by euthanasia, Elephants, Individual animals, Portland, Oregon
Arrondissement of Avignon	Arrondissements of France, Provence-Alpes-Côte d'Azur
Arrondissement of Carpentras	Arrondissements of France, Provence-Alpes-Côte d'Azur
John Cullum	Drama Desk Award winners, Tony Award winning actors, 1930 births, Living people, American movie actors, American television actors, American stage actors, American voice actors, Actors from Tennessee, Singers from Tennessee, People from Knoxville, Tennessee
John Salt (bishop)	1941 births, 2017 deaths, Anglican bishops, Anglican priests, English Anglicans, English priests, People from Stoke-on-Trent
Sudan Liberation Movement	Sudan, Darfur conflict
John Whetton	1941 births, Living people, British male athletes, Sportspeople from Nottinghamshire
Mario Fasino	1920 births, 2017 deaths, Italian politicians, People from Apulia, People from Sicily
Ugo Crescenzi	1930 births, 2017 deaths, Abruzzo, Deaths from renal failure, Disease-related deaths in Italy, Italian politicians, Marche
Malcolm Shabazz	1984 births, 2013 deaths, American criminals, American Muslims, arsonists
Obed Dlamini	1937 births, 2017 deaths, Disease-related deaths in South Africa, Prime Ministers of Swaziland
Thomas Barlow (Kentucky)	1940 births, 2017 deaths, Politicians from Washington, D.C., United States representatives from Kentucky, US Democratic Party politicians
Lev Navrozov	1928 births, 2017 deaths, Disease-related deaths in New York City, Deaths from Parkinson's disease, Russian translators, Writers from Moscow
Utrecht University	1636 establishments, Colleges and universities in the Netherlands, Utrecht (city), 17th century establishments in the Netherlands, 1630s establishments in Europe
Erasmus University Rotterdam	1973 establishments in Europe, Colleges and universities in the Netherlands, Rotterdam, 1970s establishments in the Netherlands
Maastricht University	1976 establishments in Europe, Colleges and universities in the Netherlands, Maastricht, 1970s establishments in the Netherlands
Tilburg University	Christian colleges and universities, Colleges and universities in the Netherlands, Roman Catholicism in the Netherlands, 1980s establishments in the Netherlands, 1986 establishments in Europe, Tilburg
Gopal Vasudev Menon	Indian musicians
Deputy Prime Minister of the United Kingdom	Deputy Prime Ministers of the United Kingdom, Politics of the United Kingdom, United Kingdom-related lists
Tromelin Island	Territorial disputes
John M. Hayes	1940 births, 2017 deaths, Deaths from pulmonary fibrosis, American educators, American chemists, Scientists from Seattle, Washington, Scientists from Berkeley, California
Yuriy Poyarkov	1937 births, 2017 deaths, Ukrainian volleyball players
Raymond Smullyan	1919 births, 2017 deaths, American mathematicians, American pianists, American philosophers, American educators, American magicians, Scientists from New York, Writers from New York, Musicians from New York, Entertainers from New York
Tom Raworth	1938 births, 2017 deaths, Deaths from prostate cancer, Cancer deaths in London, British poets, British artists, Writers from London
Valeriu Bularca	1931 births, 2017 deaths, Romanian sportspeople, Wrestlers
Mike Ilitch	1929 births, 2017 deaths, Businesspeople from Detroit, Michigan, Disease-related deaths in Michigan
André Salvat	1920 births, 2017 deaths, Colonels, French military people, Legion of Honour, Military personnel of World War II, People from Occitanie
Angry Grandpa	1950 births, 2017 deaths, American YouTubers, Deaths from cirrhosis, Disease-related deaths in South Carolina, Firefighters, Internet celebrities, Pen names, People from Charleston, South Carolina, People with bipolar disorder, People with cancer
Morgan Spurlock	1970 births, Living people, American activists, American agnostics, American movie directors, American screenwriters, American television producers, Writers from West Virginia
University of Groningen	1614 establishments, 1610s establishments in Europe, Colleges and universities in the Netherlands, Groningen (city), 17th century establishments in the Netherlands
Radboud University Nijmegen	Christian colleges and universities, Colleges and universities in the Netherlands, Roman Catholicism in the Netherlands, 20th century establishments in the Netherlands, 1923 establishments in Europe, Nijmegen
Chidambaram	Cuddalore district
Piet Keizer	1943 births, 2017 deaths, Cancer deaths in the Netherlands, Deaths from lung cancer, Dutch footballers, Sportspeople from Amsterdam
Filmfare Award for Best Actor-Tamil	Indian awards, Movie awards
Hans Kraay Sr.	1936 births, 2017 deaths, Dutch football managers, Dutch footballers, Dutch journalists, Sportspeople from Utrecht (city), Writers from Utrecht (city)
Hans Kraay Jr.	1959 births, Living people, Dutch football managers, Dutch footballers, Dutch television presenters, Sportspeople from Utrecht (city)
Edward Bryant	1945 births, 2017 deaths, American science fiction writers, Deaths from diabetes, Disease-related deaths in Colorado, Writers from Wyoming, Writers from New York
Hiag Akmakjian	1926 births, 2017 deaths, American painters, American photographers, Cancer deaths in the United Kingdom, Deaths from lung cancer, People from Jersey City, New Jersey, Writers from New Jersey
Arabesque	Art, Design
Arabesque (ballet)	Ballet terminology
Anna Dravida Munnetra Kazhagam	Political parties in India, Political parties in Tamil Nadu, 1972 establishments in Asia, 1970s establishments in India
Dravida Munnetra Kazhagam	Political parties in India, Political parties in Tamil Nadu, 1949 establishments in Asia, 1940s establishments in India
Monstera deliciosa	Araceae, Vines
Buffalo Niagara International Airport	Airports in New York
Icelandair	Airlines of Europe, Transport in Iceland
Jiro Taniguchi	1947 births, 2017 deaths, Japanese manga artists, Japanese writers
MVG Class C	Rolling stock, Munich, 2002 establishments in Europe, 2000s establishments in Germany
Sione Lauaki	1981 births, 2017 deaths, New Zealand rugby union players, Sportspeople from Auckland
Fab Melo	1990 births, 2017 deaths, Basketball players, Brazilian sportspeople, Minas Gerais
John Barnes (footballer)	1963 births, Living people, 1986 FIFA World Cup players, 1990 FIFA World Cup players, Black British sportspeople, British rap musicians, English footballers, English football managers, Liverpool F.C. players, Members of the Order of the British Empire, Musicians from London, Naturalised citizens of the United Kingdom, People from Kingston, Jamaica, Sportspeople from London, Premier League players
Tom Pryce	1949 births, 1977 deaths, British racecar drivers, Deaths in sport, Formula One drivers, Welsh sportspeople
Paragahadeniya	Towns in Asia
Bob Paisley	1919 births, 1996 deaths, Deaths from Alzheimer's disease, Disease-related deaths in England, English footballers, English football managers, Liverpool F.C. players, Officers of the Order of the British Empire, Sportspeople from County Durham
2017 United Kingdom general election	2017 in the United Kingdom, June 2017 events, United Kingdom general elections
J. D. Tippit	1924 births, 1963 deaths, American military personnel of World War II, Deaths by firearm in Texas
El amor brujo	Classical music
Live at Leeds	Rock albums
Desiya Murpokku Dravida Kazhagam	Political parties in Tamil Nadu, 2005 establishments in Asia, 2000s establishments in India
Naam Tamilar Katchi	Political parties in Tamil Nadu
Marumalarchi Dravida Munnetra Kazhagam	Political parties in Tamil Nadu, 1994 establishments in Asia, 1990s establishments in India
Pattali Makkal Katchi	Political parties in Tamil Nadu
Carbon sink	Carbon, Geochemistry
Tim Raines	1959 births, African-American baseball players, Baltimore Orioles players, Chicago White Sox players, Florida Marlins players, Living people, Montreal Expos players, National League All-Stars, New York Yankees players, Oakland Athletics players
Laura Innes	American television actors, American stage actors, American movie actors, People from Pontiac, Michigan, Actors from Michigan, 1957 births, Living people
Tactopoda	Groups of phyla
Ethiopian Airlines Flight 961	1990s in Africa, Aviation disasters in the 1990s, Comoros, History of Ethiopia, Mass murder in 1996, November events, Terrorist incidents in the 1990s
Al Jarreau	1940 births, 2017 deaths, African-American singers, American jazz singers, Deaths from respiratory failure, Disease-related deaths in Los Angeles, Grammy Award winners, Singers from Milwaukee, Wisconsin
Quentin Moses	1983 births, 2017 deaths, Deaths from fire, Accidental deaths in the United States, Arizona Cardinals players, American football defensive ends, American football linebackers, Miami Dolphins players, Oakland Raiders players, Sportspeople from Georgia (U.S. state)
Dave Adolph	1937 births, 2017 deaths, American football coaches, American football linebackers, Sportspeople from Akron, Ohio
Krystyna Sienkiewicz	1935 births, 2017 deaths, Polish movie actors, Polish painters, Polish singers
Jarmila Šuláková	1929 births, 2017 deaths, Czech people, Folk singers
Chavo Guerrero Sr.	1949 births, 2017 deaths, Deaths from liver cancer, Cancer deaths in Texas, American wrestlers, Sportspeople from El Paso, Texas
John Howes	1924 births, 2017 deaths, American educators, Writers from Chicago
Arrondissements of the French Guiana department	Arrondissements of France, French Guiana
Arrondissement of Cayenne	Arrondissements of France, French Guiana
Arrondissement of Saint-Laurent-du-Maroni	Arrondissements of France, French Guiana
Melanne Verveer	1994 births, Living people, American diplomats, American writers, People from Pennsylvania, Women diplomats
Yitzhak Livni	1934 births, 2017 deaths, Israeli journalists, Jewish Israeli writers, Naturalized citizens of Israel, People from Łódź, People from Tel Aviv, Polish Jews
James Hunt	1947 births, 1993 deaths, Cardiovascular disease deaths in London, Deaths from myocardial infarction, English racecar drivers, Formula One drivers, Sportspeople from Surrey
Ring toss	Games
Wiesław Adamski	1947 births, 2017 deaths, Polish sculptors
Evionnaz	Municipalities of Valais
Finhaut	Municipalities of Valais
Massongex	Municipalities of Valais
Keat Chhon	1934 births, Living people, Asian politicians, Cambodian people
Mex, Valais	Former municipalities of Valais
Salvan, Switzerland	Municipalities of Valais
Goms, Valais	Municipalities of Valais, 2017 establishments in Switzerland
Kongunadu Makkal Desia Katchi	Political parties in Tamil Nadu
People's Welfare Front	Political parties in Tamil Nadu, 2015 establishments in India
Eilat Airport	1949 establishments, Airports in Israel, Eilat, 1940s establishments in Israel
Lactate dehydrogenase	Enzymes
Million Reasons	2016 songs, Lady Gaga songs, Pop ballads, 2010s ballads
Barbara Carroll	1925 births, 2017 deaths, American jazz musicians, American pianists, People from Worcester, Massachusetts, Singers from Massachusetts
Damian (musician)	1964 births, 2017 deaths, Cancer deaths in England, English pop singers, Musicians from Manchester
Aidan Harrington	1928 births, 2017 deaths, Deaths from natural causes, Actors from London, English movie actors, English stage actors, English television actors
Saint-Laurent-du-Maroni	Communes in French Guiana, Subprefectures in France
Jan Grabowski	1950 births, 2017 deaths, Coaches, Polish sportspeople, Speedway riders
Keith Kellogg	1944 births, Living people, United States National Security Advisors, American military people, Politicians from Dayton, Ohio
Clint Roberts	1935 births, 2017 deaths, Deaths from COPD, Disease-related deaths in the United States, United States representatives from South Dakota, US Republican Party politicians
Loukianos Kilaidonis	1943 births, 2017 deaths, Composers, Greek writers, Greek singers, Songwriters, People from Athens
Ren Xinmin	1915 births, 2017 deaths, Chinese scientists, Chinese educators, Centenarians, People from Beijing
Harvey Lichtenstein	1929 births, 2017 deaths, Deaths from stroke, American educators, American artists, People from Brooklyn
Lucky Pulpit	2001 births, 2017 deaths, Deaths from myocardial infarction, Thoroughbred racehorses
Åsleik Engmark	1965 births, 2017 deaths, Actors from Oslo, Disease-related deaths in Belgium, Musicians from Oslo, Norwegian comedians, Norwegian movie actors, Norwegian singers, Norwegian stage actors, Norwegian television actors, Norwegian voice actors, Writers from Oslo
Tsuyoshi Yamanaka	1939 births, 2017 deaths, Deaths from pneumonia, Disease-related deaths in Japan, Japanese Olympic bronze medalists, Japanese Olympic silver medalists, Japanese swimmers, Medalists at the 1964 Summer Olympics, Medalists at the 1960 Summer Olympics, Medalists at the 1956 Summer Olympics, People from Ishikawa Prefecture
Bobby Murdoch (footballer, born 1936)	1936 births, 2017 deaths, English footballers, English football managers, Liverpool F.C. players, Sportspeople from Liverpool
Sara Coward	1948 births, 2017 deaths, Actors from London, English radio actors, English stage actors, English television actors, Cancer deaths in England, Deaths from breast cancer
Communist Party of India (Marxist)	Communist parties, 1964 establishments in Asia, 1960s establishments in India, Political parties in India
Beam balance	Machines, Measuring tools
M. K. Stalin	Tamil Nadu politicians, Dravida Munnetra Kazhagam politicians
Goyescas	1910s operas, Operas set in Spain, 1916 works
Sarah Knauss	1880 births, 1999 deaths, American supercentenarians, People from Pennsylvania
Bilice (Kotor Varoš)	Settlements in Bosnia and Herzegovina
Baština (Kotor Varoš)	Settlements in Bosnia and Herzegovina
Jonathan Russell	Democratic Republican party (US) politicians, American diplomats, United States representatives from Massachusetts, 19th-century American politicians
Inferior temporal gyrus	Anatomy of the brain
Ta Phong Tan	Women who received the International Women of Courage Award, Living people, Vietnamese people, Bloggers
Stefán Karl Stefánsson	1975 births, 2018 deaths, Deaths from cholangiocarcinoma
Pusheen	Internet celebrities, Fictional cats, Individual animals
Mary Akrami	1970s births, Living people, BBC 100 Women
Hans Trass	1928 births, 2017 deaths, Botanists, Ecologists, People from Tallinn, Estonian scientists
Ricardo Arias Calderón	1933 births, 2017 deaths, People from Panama City, Politicians, Vice presidents
The Proclaimers	1962 births, Living people, Musical groups established in 1983, People from Edinburgh, Scottish musical groups, Scottish singers, Sibling musical duos, Twin people from the United Kingdom
Jared Kushner	1981 births, Living people, Businesspeople from New Jersey, Harvard University alumni, Jewish businesspeople, New York University alumni, Real estate developers, Trump family, People from Livingston, New Jersey
Woody Johnson	1947 births, Living people, American philanthropists, Businesspeople from New Jersey, Businesspeople from New York City, Ambassadors of the United States to the United Kingdom, Politicians from New Jersey, Politicians from New York City, US Republican Party politicians
Israel Kamakawiwoʻole	1959 births, 1997 deaths, American activists, American singer-songwriters, Deaths from heart failure, Deaths from respiratory failure, Disease-related deaths in the United States, Musicians from Hawaii, People from Honolulu, Singers from Hawaii, Native Hawaiians
Elisabeth Rehn	1935 births, Living people, Breast cancer survivors, Finnish politicians, People from Helsinki
Talking Body	Pop songs, 2014 songs
Bang Bang (Jessie J, Ariana Grande and Nicki Minaj song)	Pop ballads, 2014 songs, Ariana Grande songs
Albion, Jackson County, Wisconsin	Towns in Wisconsin, Jackson County, Wisconsin
Alma, Jackson County, Wisconsin	Towns in Wisconsin
Province of South Carolina	18th century in South Carolina, 1776 disestablishments, Former British colonies, 1712 establishments in the Thirteen Colonies, 1770s disestablishments in the United States
Bear Bluff, Wisconsin	Towns in Wisconsin
Brockway, Wisconsin	Towns in Wisconsin
Jayalalithaa	Tamil Nadu politicians
City Point, Wisconsin	Towns in Wisconsin
Cleveland, Jackson County, Wisconsin	Towns in Wisconsin
Curran, Wisconsin	Towns in Wisconsin
Franklin, Jackson County, Wisconsin	Towns in Wisconsin
Garden Valley, Wisconsin	Towns in Wisconsin
Garfield, Jackson County, Wisconsin	Towns in Wisconsin
Hixton (town), Wisconsin	Towns in Wisconsin, Jackson County, Wisconsin
Irving, Wisconsin	Towns in Wisconsin
Knapp, Jackson County, Wisconsin	Towns in Wisconsin
Komensky, Wisconsin	Towns in Wisconsin
Dinocephalosaurus	Archosaurs
Manchester, Wisconsin	Towns in Wisconsin
Melrose, Wisconsin	Towns in Wisconsin
Millston, Wisconsin	Towns in Wisconsin
North Bend, Wisconsin	Towns in Wisconsin
Northfield, Wisconsin	Towns in Wisconsin
Springfield, Jackson County, Wisconsin	Towns in Wisconsin
Ashwaubenon, Wisconsin	Villages in Wisconsin, Brown County, Wisconsin
Auburndale, Wisconsin	Villages in Wisconsin, Wood County, Wisconsin
Avoca, Wisconsin	Villages in Wisconsin, Iowa County, Wisconsin
Bagley, Wisconsin	Villages in Wisconsin, Grant County, Wisconsin
Baldwin, Wisconsin	Villages in Wisconsin
Cady, Wisconsin	Towns in Wisconsin
Cylon, Wisconsin	Towns in Wisconsin
Eau Galle, St. Croix County, Wisconsin	Towns in Wisconsin
Emerald, Wisconsin	Towns in Wisconsin
Erin Prairie, Wisconsin	Towns in Wisconsin
Forest, St. Croix County, Wisconsin	Towns in Wisconsin
Glenwood, Wisconsin	Towns in Wisconsin
Hammond, Wisconsin	Towns in Wisconsin
Kinnickinnic, Wisconsin	Towns in Wisconsin
Pleasant Valley, Wisconsin	Towns in Wisconsin
Rush River, Wisconsin	Towns in Wisconsin
St. Joseph, Wisconsin	Towns in Wisconsin
Manfred Kaiser	1929 births, 2017 deaths, East German sportspeople, German footballers, Sportspeople from Saxony-Anhalt
Helen Sharman	1963 births, Living people, British chemists, Astronauts, People from Sheffield
Azerbaijan State Russian Drama Theatre	Theatres in Baku, 1937 establishments, 20th century establishments in Azerbaijan
Guiana Shield	Regions of South America, Guyana, Suriname, French Guiana
Saudia Flight 163	Aviation disasters in the 1980s, 1980, 20th century in Saudi Arabia, 1980s in Asia
Violet Brown	1900 births, 2017 deaths, Deaths from heart failure, Jamaican people, Supercentenarians
Prince William Sound	Geography of Alaska, Bodies of water of the United States
Infante Henrique, Duke of Coimbra	1949 births, 2017 deaths, Portuguese royalty
Anthony Lake	1939 births, Living people, American diplomats, Converts to Judaism, Harvard University alumni, Jewish American academics, Jewish American politicians, Jewish American writers, Politicians from New York City, Princeton University alumni, United Nations officials, United States National Security Advisors, US Democratic Party politicians, Writers from New York City, Recipients of the Order of the Rising Sun
Stuart McLean	1948 births, 2017 deaths, Deaths from melanoma, Cancer deaths in Ontario, Canadian radio personalities, Canadian comedians, Writers from Quebec
Peter Simonischek	1946 births, Living people, Austrian movie actors, Austrian stage actors
Bruce Lansbury	1930 births, 2017 deaths, Deaths from Alzheimer's disease, Disease-related deaths in California, Naturalized citizens of the United States, American screenwriters, American television producers, American television writers, English screenwriters, English television writers, English television producers, Writers from London
Pete McCloskey	1927 births, Living people, United States representatives from California, US Democratic Party politicians, 1972 United States presidential candidates
Jenny Slate	1982 births, Living people, American movie actors, American television actors, American voice actors, American comedians, American children's writers, Actors from Massachusetts, Writers from Massachusetts, People from Milton, Massachusetts
Grant Hackett	1980 births, Living people, Australian Olympic gold medalists, Australian Olympic silver medalists, Australian swimmers, Medalists at the 2000 Summer Olympics, Medalists at the 2004 Summer Olympics, Medalists at the 2008 Summer Olympics, Order of Australia, Sportspeople from Queensland
Aoi festival	Festivals in Asia, Kyoto, May events, 7th century establishments in Japan
Pointer aliasing (computer programming)	Computer programming, Computer science
Stećak	History of Bosnia and Herzegovina, World Heritage Sites in Europe
Alderman	Aldermen, Government occupations
Deputy mayor	Deputy mayors, Government occupations
Vernayaz	Municipalities of Valais
Vérossaz	Municipalities of Valais
Šibovi (Kotor Varoš)	Settlements in Bosnia and Herzegovina
Hot stick	Safety
Source region	Meteorology
Josef Augusta (ice hockey)	1946 births, 2017 deaths, Ice hockey coaches, Czech ice hockey players, Czechoslovak ice hockey players, Deaths from pancreatic cancer, Disease-related deaths in the Czech Republic, Olympic silver medalists
Alexander Acosta	1969 births, Living people, United States Secretaries of Labor, American lawyers, American educators, Politicians from Miami, Florida, US Republican Party politicians
Cipriano Chemello	1945 births, 2017 deaths, Italian cyclists, Italian Olympians, Medalists at the 1968 Summer Olympics, Sportspeople from Veneto
Michael Cole (public relations)	1943 births, Living people, English journalists, BBC newsreaders and journalists
Antisuppressor	Genetics
Gelek Rimpoche	1939 births, 2017 deaths, Deaths from heart failure, Deaths from surgical complications, Naturalized citizens of the United States, Tibetan Buddhist lamas, American Buddhists, People from Ann Arbor, Michigan
J. G. Hertzler	1950 births, Living people, Actors from Georgia (U.S. state), Actors from Missouri, Actors from New York, American animal rights activists, American environmentalists, American movie actors, American political activists, American screenwriters, American television actors, American voice actors, Actors from El Paso, Texas, People from Savannah, Georgia, Politicians from Georgia (U.S. state), Politicians from Missouri, Politicians from New York, Politicians from Texas, US Democratic Party politicians, People from Ithaca, New York, Writers from Georgia (U.S. state), Writers from Missouri, Writers from New York, Writers from Texas
Nicole Bass	1964 births, 2017 deaths, Actors from Queens, American movie actors, American professional wrestlers, American television actors, Cardiovascular disease deaths in New York City, Deaths from myocardial infarction, Deaths from stroke, Bodybuilders, Sportspeople from Queens
Loren Wiseman	1951 births, 2017 deaths, Deaths from heart failure, Cardiovascular disease deaths in Illinois, American editors, Video game designers, People from Bloomington, Illinois
Yellowjacket	Wasps
Jannis Kounellis	1936 births, 2017 deaths, Greek people, Italian sculptors, Italian painters
Public utility	Business, Economics, Public services
Siegfried Herrmann	1932 births, 2017 deaths, Coaches, German Olympians, German sportspeople, Male athletes, Sportspeople from Thuringia
Ban Bong River	Rivers of Thailand
Unreachable code	Computer programming
The Guianas	Regions of South America, Guyana, Suriname, French Guiana
Vijayakanth	Indian politicians
Microburst	Natural events
Michael Novak	1933 births, 2017 deaths, American diplomats, American journalists, American political writers, American philosophers, American Roman Catholics, American theologians, Cancer deaths in Washington, D.C., Deaths from colorectal cancer, Writers from Pennsylvania, Politicians from Pennsylvania, People from Johnstown, Pennsylvania
Dick Bruna	1927 births, 2017 deaths, Dutch children's writers, Illustrators, Writers from Utrecht (city)
European hornet	Wasps
Börge Hellström	1957 births, 2017 deaths, Cancer deaths in Sweden, Criminals, Swedish writers
Ep Wieldraaijer	1927 births, 2017 deaths, Aldermen of the Netherlands, Dutch councillors, Dutch mayors, Former members of the House of Representatives of the Netherlands, Former MEPs, Labour Party (Netherlands) politicians, MEPs for the Netherlands, Politicians from Overijssel
Joop Gouweleeuw	1940 births, 2017 deaths, Judoka, People from Delft, Sportspeople from South Holland
Djelloul Khatib	1936 births, 2017 deaths, Activists, Algerian politicians, African diplomats, People from Algiers
Veyrier	Municipalities of Geneva, Cities in Switzerland
Krinau	Former municipalities of St. Gallen
NASCAR on Sky	NASCAR, 2007 television series debuts, 2012 television series endings
Lineman (technician)	Electricity
Tom Regan	1938 births, 2017 deaths, 20th century philosophers, 21st century philosophers, American academics, American animal rights activists, American philosophers, Deaths from pneumonia, Disease-related deaths in North Carolina, Writers from Pittsburgh, Pennsylvania
Erland Kops	1937 births, 2017 deaths, Badminton players, Danish sportspeople, People from Copenhagen
Linesman (soccer)	Association football
Panarthropoda	Groups of phyla
Chembarambakkam Lake	Lakes of Tamil Nadu, Chennai District
Puzhal Lake	Lakes of Tamil Nadu, Chennai District
Cycloneuralia	Animals
Kodaikanal Lake	Lakes of Tamil Nadu
Luke M. Griswold	1837 births, 1892 deaths, United States Navy Medal of Honor recipients, Military personnel of the American Civil War, People from Massachusetts
Omar Abdel-Rahman	1938 births, 2017 deaths, Blind people, Deaths from coronary artery disease, Deaths from diabetes, Cardiovascular disease deaths in North Carolina, Egyptian Muslims, Muslim terrorists
Ivan Koloff	1942 births, 2017 deaths, Canadian professional wrestlers, Cancer deaths in North Carolina, Deaths from liver cancer, Sportspeople from Montreal
Lawrence F. Snowden	1921 births, 2017 deaths, American generals, American military personnel of the Korean War, American military personnel of the Vietnam War, American military personnel of World War II, Military people from Virginia, United States Marine Corps personnel, People from Charlottesville, Virginia
Pyruvic acid	Cellular respiration, Metabolism
Pasquale Squitieri	1938 births, 2017 deaths, Italian movie directors, People from Naples
Clyde Stubblefield	1943 births, 2017 deaths, African American musicians, American funk musicians, American drummers, Deaths from renal failure, Disease-related deaths in Wisconsin, Musicians from Wisconsin, People from Chattanooga, Tennessee, People from Madison, Wisconsin
Alan Aldridge	1943 births, 2017 deaths, Artists from London, British illustrators
Theodore J. Lowi	1931 births, 2017 deaths, American academics, American political scientists, Scientists from Alabama
Williams Street	American animation studios, Adult Swim, 1994 establishments in the United States
Dan Vickerman	1979 births, 2017 deaths, Australian rugby union players, People from Cape Town, Suicides in Australia
Michael Ogio	1942 births, 2017 deaths, Commanders of the Order of the British Empire, Knights Grand Cross of the Order of St Michael and St George, Governors-General of Papua New Guinea
Luigi Canepa	1849 births, 1914 deaths, Italian composers
Ready Set Learn	American children's television series
Letter from Birmingham Jail	Martin Luther King Jr., American civil rights, Letters
Sabha, Libya	Cities in Libya
Nintendo Switch	2017 establishments, Nintendo video game consoles
Nephrozoa	Taxonomy
Paul Nguyên Van Hòa	1931 births, 2017 deaths, Roman Catholic bishops, Vietnamese people
Four sons of Horus	Egyptian gods and goddesses
Rem (mythology)	Egyptian gods and goddesses
Norma McCorvey	1947 births, 2017 deaths, Deaths from heart failure, American activists, American Roman Catholics, Writers from Louisiana, Writers from Texas
José Solé	1929 births, 2017 deaths, Deaths from cardiac arrest, Mexican stage actors, Mexican movie directors
Peter Skellern	1947 births, 2017 deaths, Anglican priests, Cancer deaths in England, Deaths from brain cancer, English Anglicans, English pianists, English pop musicians, English pop singers, English priests, English singer-songwriters, Musicians from Lancashire, Singers from Lancashire, Writers from Lancashire
Warren Frost	1925 births, 2017 deaths, American movie actors, American stage actors, American television actors, Actors from Massachusetts, Actors from Vermont
Jørgen Kieler	1919 births, 2017 deaths, Danish writers, Physicians
Altamas Kabir	1948 births, 2017 deaths, Deaths from kidney disease, Indian lawyers, Chief Justices of India
Roger Hynd	1942 births, 2017 deaths, Scottish footballers, Crystal Palace F.C. players
Richard Schickel	1933 births, 2017 deaths, Deaths from stroke, American historians, American movie critics, American educators, American journalists, American screenwriters, Writers from Milwaukee, Wisconsin
Andrew Schneider	Pulitzer Prize winners, 1942 births, 2017 deaths, Deaths from heart failure, American journalists, Writers from New York City
Lavell Crawford	1968 births, Living people, American movie actors, American television actors, American comedians, Actors from St. Louis, Missouri
Magnus Wenninger	1919 births, 2017 deaths, American mathematicians, Benedictines, People from Wisconsin
Martin Schulz	1955 births, Living people, Former MEPs, MEPs for Germany, People from Eschweiler, Politicians from North Rhine-Westphalia, Politicians of the Social Democratic Party of Germany, Presidents of the European Parliament
Alejandro Atchugarry	1952 births, 2017 deaths, Deaths from aneurysm, Uruguayan politicians, Uruguayan lawyers, People from Montevideo
Marty Schottenheimer	1943 births, 2021 deaths, Deaths from Alzheimer's disease, American football coaches, Buffalo Bills players, New England Patriots players, Sportspeople from Pennsylvania
Kaci Kullmann Five	1951 births, 2017 deaths, Deaths from breast cancer, Cancer deaths in Norway, Norwegian politicians, Norwegian Nobel Committee
Per Kleppe	1923 births, 2021 deaths, Norwegian economists, Politicians from Oslo
Jan Balstad	1937 births, Living people, Politicians from Oslo
Non-separable wavelets	Digital signal processing
Sclera	Eye anatomy
Blister beetle	Polyphaga
Oil beetle	Polyphaga
Brachiozoa	Animals
Peterlee	Towns in County Durham
Cow killer	Wasps
Regal Entertainment Group	Companies of the United States
Vitaly Churkin	1952 births, 2017 deaths, Ambassadors of Russia, Cardiovascular disease deaths in New York City, Child actors, Russian movie actors, Russian politicians
Larry Coryell	1943 births, 2017 deaths, Deaths from cardiac arrest, Cardiovascular disease deaths in New York City, American jazz musicians, American guitarists, Musicians from Texas, Musicians from Washington, Musicians from New York City, People from Galveston, Texas
Sofía Ímber	1924 births, 2017 deaths, Deaths from congestive heart failure, Jewish philanthropists, Jewish writers, Romanian journalists, Moldovan people, Romanian Jews, South American Jews, Venezuelan people
H. R. McMaster	1962 births, Living people, United States National Security Advisors, American military people, Writers from Philadelphia, Pennsylvania
Eric Jacobson	Living people, 1970 births
Roman Zhuravskyi	1948 births, 2017 deaths, Deaths from pancreatic cancer, Ukrainian footballers
Yury Solomin	1935 births, Living people, Russian movie actors, Russian stage actors, Russian politicians
Aleksandr Yakovlevich Mikhailov	1944 births, Living people, Russian movie actors
Kamran Mirza	1509 births, 1557 deaths, People from Kabul
E-dubble	1982 births, 2017 deaths, American hip hop musicians, American rap musicians from Pennsylvania, Infectious disease deaths in the United States, Musicians from Philadelphia, Pennsylvania, Musicians from Baltimore, Maryland, American rap musicians from Maryland
New Synagogue, Berlin	Synagogues, Judaism in Germany
Youssef Lemrini	1960 births, Living people, Football managers, Moroccan footballers
Maha Haddioui	1988 births, Living people, Golfers, Moroccan sportspeople, People from Casablanca
B chromosome	Chromosomes
Northeast Region of Brazil	Regions of Brazil
Henri Cohen	Year of birth missing, 1930 deaths, Belgian Jews, Belgian sportspeople, Jewish sportspeople, Olympic silver medalists, Water polo players
Yigal Amir	1970 births, Living people, Israeli prisoners, Jewish Israeli criminals, Murderers, Prisoners sentenced to life imprisonment
Mildred Dresselhaus	1930 births, 2017 deaths, American physicists, Jewish American academics, Jewish American scientists, Scientists from Brooklyn
Max Lüscher	1923 births, 2017 deaths, Swiss writers, Swiss scientists, Swiss psychologists
Lüscher color test	Tests
Little Sammy Davis	1928 births, 2018 deaths, Deaths from heart failure, Cardiovascular disease deaths in New York, American blues musicians, American guitarists, American songwriters, African American musicians, People from Winona, Mississippi, Musicians from Mississippi, Writers from Mississippi, Writers from New York, Musicians from New York
Madame de Montesson	1738 births, 1806 deaths, People from Paris, House of Orléans
Lavelle White	1929 births, Living people, American blues musicians, American soul musicians, American singer-songwriters, Singers from Louisiana, Writers from Louisiana, Singers from Houston, Texas, Writers from Texas
Downe	London Borough of Bromley, Villages in England
Stanisław Skrowaczewski	1923 births, 2017 deaths, Naturalized citizens of the United States, Polish composers, American composers, American conductors, Writers from Minneapolis, Minnesota, Musicians from Minneapolis, Minnesota
Joseph Blatchford	1934 births, Living people, American philanthropists, Civil servants, People from Milwaukee, Wisconsin, People from Beverly Hills, California
Steve Hewlett (journalist)	1958 births, 2017 deaths, British academics, British journalists, Cancer deaths in London, Deaths from esophageal cancer, Writers from London
Desmond Connell	1926 births, 2017 deaths, Cardinals of the Roman Catholic Church, People from Dublin, Roman Catholic archbishops
Anthony Downs	1930 births, Living people, American economists, American educators, Writers from Illinois, People from Evanston, Illinois
Reinhard Selten	1930 births, 2017 deaths, German academics, German economists, People from former German territories, People from Wrocław, German Nobel Prize winners
Sex industry	Sex industry
Keisha Castle-Hughes	1990 births, Living people, Child actors, Entertainers from North Island, New Zealand Māori people, New Zealand movie actors, New Zealand television actors, People from Auckland, People with bipolar disorder
Taulupe Faletau	1990 births, Living people, Oceanic sportspeople, Tonga, Welsh rugby union players
Dana International	1972 births, Living people, Eurovision Song Contest winners, Israeli LGBT people, Israeli pop singers, Jewish Israeli musicians, LGBT singers, People from Tel Aviv, Transgender and transsexual Jews, Israeli singers
Steve Gleason	Congressional Gold Medal recipients, 1977 births, Living people, American football linebackers, American football safeties, Indianapolis Colts players, New Orleans Saints players, People from Spokane, Washington, Sportspeople from Washington
Francis Pollet	1964 births, Living people, French aviators, French generals
Chifley Tower	Buildings and structures in Sydney, Skyscrapers in Australia, 1992 establishments in Australia
Florac Trois Rivières	2016 establishments in France, Subprefectures in France, Communes in Lozère
Maccabi Ahi Nazareth F.C.	1968 establishments in Israel, Israeli football clubs, Nazareth
Executive Order 13769	United States law, Immigration, 2017 in the United States

