List of Billboard number-one singles of the 1940s (U.S.)	Billboard charts, Lists of songs, 1940s songs
M110 howitzer	Howitzers, Military of the United States
Flyball	Sports involving animals, Dogs
Eishō (Heian period)	Japanese eras
Tengi	Japanese eras
Kōhei	Japanese eras
Sengoku period	Periods in Japanese history, Samurai
École des Ponts ParisTech	Buildings and structures in Paris, Colleges and universities in France, 1747 establishments, 18th century establishments in France, 1740s establishments in Europe
Mitochondrial DNA	DNA, Organelles
MDNA (album)	Madonna albums, 2012 albums
Pinkie	18th century paintings, British paintings, San Marino, California
Girl Gone Wild	2012 songs, Madonna songs
Thomas Lawrence	1769 births, 1830 deaths, English painters
Jiryaku	Japanese eras
Enkyū	Japanese eras
Jōhō	Japanese eras
Leave It to Beaver	1957 establishments in the United States, 1963 disestablishments in the United States, 1950s American television series, 1960s American television series, American sitcoms, Black and white television series, CBS network shows, ABC network shows, English-language television programs
Plan 9 from Outer Space	American science fiction movies, English-language movies, 1959 movies, B-movies, Movies directed by Ed Wood, American independent movies, Movies set in California
Alannah Myles	Living people, 1958 births, Singers from Toronto
Henry IV, Pt. 1	Plays by William Shakespeare, Plays based on British history
Portland Winterhawks	1976 establishments in the United States, Canadian Hockey League teams, Ice hockey teams in the United States, Western Hockey League, Oregon, Portland, Oregon, 1970s establishments in Canada, 1970s establishments in Oregon
Bal du moulin de la Galette	1870s paintings, Paintings in the Musée d'Orsay, Paris, French paintings, Impressionism
Federal University of Rio de Janeiro	Colleges and universities in Brazil, 1920 establishments in South America, Rio de Janeiro, 1920s establishments in Brazil
Bride of Frankenstein	1935 movies, 1930s horror movies, American horror movies, American LGBT movies, American science fiction movies, Black-and-white movies, English-language movies, Frankenstein movies, Monster movies, Sequel movies, United States National Film Registry movies, Universal Pictures movies, Mad scientist movies
The Wild One	1953 movies, 1950s crime movies, 1953 drama movies, American crime drama movies, American teen drama movies, Gangster movies, Movies based on short stories, Movies set in California, Outlaw biker movies, Columbia Pictures movies, Movies directed by László Benedek
Matilda (1996 movie)	1996 movies, 1990s family movies, 1990s fantasy movies, American fantasy movies, Movies based on books, English-language movies, Movies directed by Danny DeVito
Switching Channels	1988 movies, 1988 comedy movies, American comedy movies, Movies based on plays, English-language movies, Movies directed by Ted Kotcheff
W.G. Grace	1848 births, 1915 deaths, Cardiovascular disease deaths in England, Deaths from myocardial infarction, English cricketers, British physicians, Sportspeople from Gloucestershire
Jōryaku	Japanese eras
Eihō	Japanese eras
Ōtoku	Japanese eras
Kanji (era)	Japanese eras
Terry Crews	1968 births, Living people, African American actors, African American comedians, American movie actors, American television actors, American voice actors, Comedians from Michigan, San Diego Chargers players, Washington Redskins players, Actors from Michigan, Sportspeople from Michigan, People from Flint, Michigan
Galette	French food, Cakes
Air Buddies	Disney movies, 2006 movies, Movies about animals, English-language movies
List of bridges in Canada	Bridges in Canada, Lists of bridges
List of bridges in the United Kingdom	Bridges in the United Kingdom, Lists of bridges
Kahō	Japanese eras
New Girl	2011 American television series debuts, 2018 television series endings, 2010s American sitcoms, 2010s romance television series, Romantic comedy television series, Television series about friendship, Television series set in Los Angeles, California, English-language television programs
Oppuurs	Municipalities of Antwerp
List of languages by writing system	Language-related lists, Writing systems
Lucille Ball	1911 births, 1989 deaths, Deaths from aortic aneurysm, Actors from New York, American movie actors, American radio actors, American television actors, American television producers, Cardiovascular disease deaths in the United States, Emmy Award winners, Kennedy Center honorees, Presidential Medal of Freedom recipients
The Blob	1958 movies, 1950s horror movies, 1950s science fiction movies, American science fiction horror movies, American monster movies, English-language movies, American independent movies
Akita, Akita	Cities in Japan, Settlements in Akita Prefecture
Japanese clock	Clocks, Japanese culture
Eichō	Japanese eras
Polonaises Op. 40 (Chopin)	Solo piano pieces, Compositions by Frédéric Chopin
Kinderszenen	Solo piano pieces, Compositions by Robert Schumann
Giselle	Ballets choreographed by Jules Perrot, Ballets, 1841
IONIS School of Technology and Management	Technical colleges and universities in France, 2009 establishments in France
Jōtoku	Japanese eras
Kōwa (Heian period)	Japanese eras
Robert Vince	Canadian movie directors, Canadian writers, Living people, Year of birth missing (living people)
Chōji	Japanese eras
Roux	French food, Sauces
Minute Waltz	Compositions by Frédéric Chopin, Solo piano pieces, Waltzes
LGBT rights in Cyprus	LGBT rights by country, Cyprus
Tennin (era)	Japanese eras
LGBT rights in Turkey	LGBT rights by country, Turkey
Piano Sonata No. 16 (Mozart)	Compositions by Wolfgang Amadeus Mozart, Solo piano pieces, Sonatas
Minuet in G (Beethoven)	Compositions by Ludwig van Beethoven, Solo piano pieces
Ten'ei	Japanese eras, 1110 establishments, 1110s establishments in Japan, 1113 disestablishments, 12th century disestablishments in Japan
Come On Over (Shania Twain album)	Shania Twain albums, 1997 albums
Up! (album)	Shania Twain albums, 2002 albums
Newbery Medal	Literary awards, Children's literature, Lists of books
Masuho, Yamanashi	Towns in Japan, Settlements in Yamanashi Prefecture
Fujikawa, Yamanashi	Towns in Japan, Settlements in Yamanashi Prefecture
Muroran, Hokkaidō	Cities in Hokkaido
Eikyū	Japanese eras, 1113 establishments, 1110s establishments in Japan, 1118 disestablishments, 12th century disestablishments in Japan
Gen'ei	Japanese eras, 1118 establishments, 1120 disestablishments, 1110s establishments in Japan, 1120s disestablishments in Japan
Hōan	Japanese eras, 1120 establishments, 1120s establishments in Japan, 1124 disestablishments, 1120s disestablishments in Japan
Tenji (era)	Japanese eras, 1124 establishments, 1120s establishments in Japan, 1126 disestablishments, 1120s disestablishments in Japan
Daiji (era)	Japanese eras, 1126 establishments, 1120s establishments in Japan, 1131 disestablishments, 1130s disestablishments in Japan
Tenshō (Heian period)	Japanese eras, 1131 establishments, 1130s establishments in Japan, 1132 disestablishments, 1130s disestablishments in Japan
Standing start	Motor sports
Communist Party of the Russian Federation	Communist parties, Political parties in Russia
Set Fire to the Rain	Pop songs, 2011 songs, Adele songs
Lippelo	Municipalities of Antwerp
Seattle Thunderbirds	1976 establishments in the United States, Canadian Hockey League teams, Ice hockey teams in the United States, Western Hockey League, Sports in Seattle, Washington, 1970s establishments in Canada
Twelve Variations on "Ah vous dirai-je, Maman"	Compositions by Wolfgang Amadeus Mozart, Solo piano pieces, Variations (music)
Russian Communist Workers' Party – Revolutionary Party of Communists	Communist parties, Political parties in Russia
List of Japan international footballers	Lists of Japanese football players
François Pierre La Varenne	French chefs, 1615 births, 1678 deaths
École des technologies numériques appliquées	Technical colleges and universities in France, 2005 establishments in France
Handel's Largo	Compositions by George Frideric Handel, Arias, 1738, 1730s operas
Water Music (Handel)	Compositions by George Frideric Handel, Suites
Yoshio Fujiwara	Year of birth missing, Year of death missing, Japanese footballers, Japan international footballers
Naoemon Shimizu	Year of birth missing, 1945 deaths, Footballers from Hiroshima Prefecture, Japan international footballers
Ryuzo Shimizu	1902 births, Year of death missing, Japanese footballers, Japan international footballers
Fukusaburo Harada	Year of birth missing, Year of death missing, Japanese footballers, Japan international footballers
Usaburo Hidaka	Year of birth missing, Year of death missing, Japanese footballers, Japan international footballers
Shizuo Miyama	Year of birth missing, Year of death missing, Footballers from Hiroshima Prefecture, Japan international footballers
Toshio Hirabayashi	Year of birth missing, Year of death missing, Japanese footballers, Japan international footballers
Setsu Sawagata	Year of birth missing, Year of death missing, Japanese footballers, Japan international footballers
Kikuzo Kisaka	Year of birth missing, Year of death missing, Japanese footballers, Japan international footballers
Shumpei Inoue	Year of birth missing, Year of death missing, Japanese footballers, Japan international footballers
Shiro Azumi	Year of birth missing, Year of death missing, Japanese footballers, Japan international footballers
Kiyoo Kanda	Year of birth missing, 1970 deaths, Japanese footballers, Japan international footballers
Yanosuke Watanabe	Year of birth missing, Year of death missing, Japanese footballers, Japan international footballers
Yoshimatsu Oyama	Year of birth missing, Year of death missing, Japanese footballers, Japan international footballers
Toshio Miyaji	Year of birth missing, Year of death missing, Japanese footballers, Japan international footballers
Uichiro Hatta	1903 births, 1989 deaths, Footballers from Osaka Prefecture, Japan international footballers
Hifuyo Uchida	Year of birth missing, Year of death missing, Japanese footballers, Japan international footballers
Alcina	Compositions by George Frideric Handel, 1730s operas, 1735
Jiro Miyake	Year of birth missing, 1984 deaths, Japanese footballers, Japan international footballers
Sachi Kagawa	Year of birth missing, Year of death missing, Footballers from Hiroshima Prefecture, Japan international footballers
Masao Takada	Year of birth missing, Year of death missing, Japanese footballers, Japan international footballers
Masuzo Madono	Year of birth missing, Year of death missing, Japanese footballers, Japan international footballers
Sakae Takahashi	Year of birth missing, Year of death missing, Japanese footballers, Japan international footballers
Kiyonosuke Marutani	Year of birth missing, Year of death missing, Japanese footballers, Japan international footballers
Kinjiro Shimizu	Year of birth missing, Year of death missing, Japanese footballers, Japan international footballers
Shojiro Sugimura	1905 births, 1975 deaths, Footballers from Osaka Prefecture, Japan international footballers
Junji Nishikawa	1907 births, Year of death missing, Japanese footballers, Japan international footballers
Daigoro Kondo	1907 births, 1991 deaths, Footballers from Tokyo Prefecture, Japan international footballers, Deaths from intracranial hemorrhage
Ko Takamoro	1907 births, 1995 deaths, Footballers from Saitama Prefecture, Japan international footballers
Haruo Arima	Year of birth missing, Year of death missing, Japanese footballers, Japan international footballers
Tamotsu Asakura	Year of birth missing, Year of death missing, Japanese footballers, Japan international footballers
Shigeru Takahashi	Year of birth missing, Year of death missing, Japanese footballers, Japan international footballers
Michiyo Taki	Year of birth missing, Year of death missing, Japanese footballers, Japan international footballers
Tameo Ide	1908 births, 1998 deaths, Footballers from Shizuoka Prefecture, Japan international footballers
Nagayasu Honda	Year of birth missing, Year of death missing, Japanese footballers, Japan international footballers
Yasuo Haruyama	1906 births, 1987 deaths, Footballers from Tokyo Prefecture, Japan international footballers
Shiro Teshima	1907 births, 1982 deaths, Footballers from Hiroshima Prefecture, Japan international footballers
Teruo Abe	Year of birth missing, Year of death missing, Japanese footballers, Japan international footballers
Shiro Misaki	Year of birth missing, Year of death missing, Japanese footballers, Japan international footballers
Hideo Sakai	1909 births, 1996 deaths, Footballers from Osaka Prefecture, Japan international footballers
Klein-Brabant	Antwerp (province)
Takashi Kawanishi	Year of birth missing, Year of death missing, Japanese footballers, Japan international footballers
Shunichi Kumai	Year of birth missing, Year of death missing, Japanese footballers, Japan international footballers
Takeshi Natori	Year of birth missing, Year of death missing, Japanese footballers, Japan international footballers
Lee Yoo-hyung	1911 births, 2003 deaths, Japanese footballers, South Korean footballers, South Korean football managers, Japan international footballers
Takashi Kasahara	1918 births, Year of death missing, Japanese footballers, Japan international footballers
Saburo Shinosaki	Year of birth missing, Year of death missing, Japanese footballers, Japan international footballers
Kazu Naoki	1918 births, Year of death missing, Japanese footballers, Japan international footballers
Yozo Aoki	1929 births, Living people, Japanese footballers, Japan international footballers
South India	Regions of India
Nara National Research Institute for Cultural Properties	Independent Administrative Institutions of Japan
Still Got It	2011 songs, Drake songs
Barkerville, British Columbia	Ghost towns in Canada, Settlements in British Columbia
Chōshō	Japanese eras, 1132 establishments, 1130s establishments in Japan, 1135 disestablishments, 1130s disestablishments in Japan
Chōkan	Japanese eras
Sup'Internet	Technical colleges and universities in Paris, 2011 establishments in France
Eiman	Japanese eras
Le Kremlin-Bicêtre	Communes in Val-de-Marne
Nin'an	Japanese eras
Villejuif	Communes in Val-de-Marne
Kaō (era)	Japanese eras
Exception handling	Programming languages
Giulio Cesare	Compositions by George Frideric Handel, 18th century operas
Microsoft InfoPath	Microsoft Office
Jōan (era)	Japanese eras
Angen	Japanese eras
Lana Clarkson	1962 births, 2003 deaths, Actors from Long Beach, California, American movie actors, American murder victims, American television actors, Murdered actors, Murders by firearm in California, People from Long Beach, California, People murdered in California
Hoax	Hoaxes
Daigaku-ryō	Colleges and universities in Japan, 7th century establishments in Japan, 19th century disestablishments in Japan
Parrotfish	Teleosts
Jishō	Japanese eras
Ariodante	Compositions by George Frideric Handel, 1730s operas, 1735
The Phantom of the Opera (1925 movie)	American horror movies, American silent movies, English-language movies, 1925 movies, 1920s horror movies, Universal Pictures movies, United States National Film Registry movies, Movies based on books
Hanwha Eagles	Baseball teams, Sport in South Korea
Gidget	1959 drama movies, 1950s romance movies, American romantic drama movies, American teen drama movies, American teen romance movies, Columbia Pictures movies, English-language movies, Movies based on books, Movies set in California, Movies directed by Paul Wendkos
E-Artsup	Technical colleges and universities in France, 2001 establishments in Europe, 2000s establishments in France
Sekiji Sasano	Year of birth missing, Year of death missing, Footballers from Shizuoka Prefecture, Footballers at the 1936 Summer Olympics
Institut supérieur européen de formation par l'action	Schools in France, Brussels, 2000 establishments in Europe, 2000s establishments in France
Jesu, Joy of Man's Desiring	Compositions by Johann Sebastian Bach, Choral compositions
Puzzle Pirates	Online games
Sonny Bono	Accidental deaths in the United States, Actors from Detroit, Michigan, Singer-songwriters from California, American television actors, Deaths in sport, Politicians from Michigan, Singers from Detroit, Michigan, United States representatives from California, 1935 births, 1998 deaths
Ghatkopar	Mumbai
Prime Minister of India	Politics of India, Prime Ministers of India
Over the Rainbow	Pop songs, 1930s songs, Best Original Song Academy Award-winning songs, 1939
Runaway (movie)	1984 movies, 1980s science fiction movies, English-language movies
Orphans of the Storm	1921 movies, 1920s drama movies, American silent movies, American drama movies, Historical movies, Women's movies, Movies directed by D. W. Griffith
The Terminator	1984 action movies, 1980s science fiction movies, American action movies, American science fiction movies, Chase movies, English-language movies, Movies directed by James Cameron, Movies set in Los Angeles, California, Robot movies, Science fiction action movies, Terminator (franchise), Time travel movies, Drone movies, Post-apocalyptic movies, Dystopian movies, American independent movies
Little House in the Big Woods	20th century American novels, English-language novels, 1932 books, Children's books
Kuroshio, Kōchi	Towns in Japan, Settlements in Kōchi Prefecture, 2006 establishments in Asia, 2000s establishments in Japan
Moutiers-au-Perche	Communes in Orne
Gacé	Communes in Orne
Fontenai-Les-Louvets	Former communes in Orne
Mortrée	Communes in Orne
Carrouges	Communes in Orne
Kavadikaranoor	Villages in Tamil Nadu
Sport in Japan	Sport in Japan
Spencer Fox	American voice actors, Comedians from New York City, Living people, American television actors, 1993 births, Actors from New York City
Tucker Albrizzi	2000 births, Living people, American child actors, Comedians from Florida, American movie actors, American television actors, American voice actors, Actors from Florida
Yōwa	Japanese eras
Siamese cat	Colorpoint cat breeds
Kanpyō (era)	Japanese eras, 889 establishments, 9th century establishments in Japan, 898 disestablishments, 9th century disestablishments in Japan
Johann Wolfgang Döbereiner	1780 births, 1849 deaths, German academics, German chemists, German inventors, People from Bavaria
Khabab	Cities in Syria
The Birth of a Nation	1915 movies, 1910s drama movies, American silent movies, American drama movies, Historical movies, Movies based on books, Movies directed by D. W. Griffith
Micula (surname)	Surnames
Wayne Knight	1955 births, Living people, Actors from New York City, American movie actors, American television actors, American voice actors, Comedians from New York City, Democrats (United States), Seinfeld
Lose Control (Let Me Down)	2011 songs, Nelly songs
The Sheik (1921 movie)	1921 movies, 1920s romance movies, American silent movies, American romance movies, Movies based on books
List of lakes of Australia	Lakes of Australia, Lists of lakes, Australia-related lists
A Daughter of the Congo	1930 movies, American silent movies, Movies based on books, Movies directed by Oscar Micheaux
Oscar Micheaux	Movie directors from Illinois, Movie producers from Illinois, Writers from Illinois, 1884 births, 1951 deaths, People from Metropolis, Illinois
The Blood of Jesus	American drama movies, United States National Film Registry movies, 1941 movies, English-language movies
Spokane Chiefs	1985 establishments in the United States, Canadian Hockey League teams, Ice hockey teams in the United States, Western Hockey League, Sports in Washington (U.S. state), Spokane, Washington, 1980s establishments in Washington (state)
Karuizawa, Nagano	Towns in Japan, Settlements in Nagano Prefecture
Tri-City Americans	1988 establishments in North America, Canadian Hockey League teams, Ice hockey teams in the United States, Western Hockey League, Sports in Washington (U.S. state)
Doge's Palace, Venice	Venice, Palaces in Italy, 1924 establishments in Europe, 1920s establishments in Italy
Craig Venter	1946 births, Living people, American geneticists, Businesspeople from Utah, Scientists from Utah, American atheists
Leslie Orgel	1927 births, 2007 deaths, English chemists, Fellows of the Royal Society, Jewish British academics, Jewish British scientists
LGBT rights in Azerbaijan	LGBT rights by country, Politics of Azerbaijan
LGBT rights in the Maldives	LGBT rights by country, Maldives
Chrissie Maher	1938 births, Living people, British people, English language
Faust (1926 movie)	1926 movies, 1920s horror movies, German silent movies, German horror movies, Fantasy movies, Movies directed by F. W. Murnau
Synapomorphy	Cladistics
Jonathan Soriano	1985 births, Living people, Spanish footballers
Conquest of the Pole	1912 movies, Silent movies, French movies, Science fiction movies, Fantasy movies, Movies based on books by Jules Verne
View of Delft	17th century paintings, Paintings by Johannes Vermeer, Dutch paintings, Delft
Philip Larkin	Alumni of the University of Oxford, Cancer deaths in England, Deaths from esophageal cancer, English novelists, English poets, People from Coventry, 1922 births, 1985 deaths
Skyler Gisondo	1996 births, Actors from Florida, American voice actors, Comedians from Florida, American movie actors, American television actors, Living people, American child actors
Lee Remick	1935 births, 1991 deaths, Actors from Massachusetts, American movie actors, American stage actors, American television actors, BAFTA Award winning actors, Cancer deaths in the United States, Deaths from kidney cancer, Golden Globe Award winning actors
Miranda Lambert	1983 births, Living people, Country musicians, Singers from Texas
Blake Shelton	Country musicians, American guitarists, Musicians from Oklahoma, Singers from Oklahoma, 1973 births, Living people
Battle of Balaclava	1854, Battles involving France, Battles involving Russia, Battles involving the United Kingdom, Ottoman Empire
Plano, Texas	Plano, Texas
Fargo (movie)	1996 crime movies, 1990s black comedy movies, 1996 comedy-drama movies, 1990s crime drama movies, 1990s crime thriller movies, 1990s criminal comedy movies, 1990s drama thriller movies, Academy Award winning movies, American criminal comedy movies, American crime drama movies, American crime thriller movies, American comedy-drama movies, American drama thriller movies, English-language movies, Fargo, North Dakota, Film noir, Movies set in Minnesota, Movies set in 1987
Viktor Kozin	Living people, Russian inventors, Russian engineers, 1953 births
The Gold Rush	American silent movies, 1925 movies, 1920s comedy movies, American comedy movies, United States National Film Registry movies, Gold, Movies directed by Charlie Chaplin
The Thief of Bagdad	American silent movies, 1924 movies, American fantasy movies, Swashbuckler movies, Movies directed by Raoul Walsh
Sinbad the Sailor	Persian literature, Arabic literature, Fictional characters
Mount Vernon	George Washington, Presidential homes in the United States, 1757 establishments, 1750s establishments in the Thirteen Colonies, 18th-century establishments in Virginia
Str8 off tha Streetz of Muthaphukkin Compton	1995 albums, Eazy-E albums
Rajesh Khanna	Indian movie actors, Indian movie producers, 1942 births, 2012 deaths, Punjabi people, Bollywood playback singers
Megalomania	Mental illnesses
The Great Train Robbery	1903 movies, American silent movies, American western movies, United States National Film Registry movies
Les Patineurs	Waltzes
Blue Danube Waltz	Waltzes, Compositions by Johann Strauss II
Segmentation	Zoology
Waltz of the Flowers	Waltzes, Compositions by Pyotr Ilyich Tchaikovsky
Okazaki, Aichi	Cities in Japan, Settlements in Aichi Prefecture
Apollo 7	Apollo program
Arata Isozaki	Pritzker Prize winners, 1931 births, Living people, Japanese architects, People from Ōita Prefecture
Rumour Has It (Adele song)	2011 songs, Adele songs
What Makes You Beautiful	Pop songs, 2011 songs, One Direction
Kitakyushu Municipal Museum of Art	Art museums in Japan, Kitakyūshū, 1974 establishments in Asia, 1970s establishments in Japan
Xerophile	Extremophiles, Ecology
John Gielgud	Academy Award winning actors, Actors from London, BAFTA Award winning actors, British radio actors, Emmy Award winning actors, English movie actors, English stage actors, English television actors, English theatre directors, English LGBT people, Gay men, Golden Globe Award winning actors, LGBT actors, Movie directors from London, Tony Award winning actors, 1904 births, 2000 deaths, Alumni of the Royal Academy of Dramatic Art, Best Actor Academy Award winners, Best Supporting Actor Academy Award winners, Drama Desk Award winners, Grammy Award winners, Knights Bachelor, LGBT directors, Order of Merit, People educated at Westminster School, London, People from Kensington and Chelsea (London borough)
Kaley Cuoco	1985 births, Actors from Ventura County, California, American child actors, American movie actors, American television actors, Living people, People from Ventura County, California
Molly Ringwald	Actors from California, American child actors, American movie actors, American television actors, 1968 births, Living people
Ensemble	Music, Performing arts, Words
Dirty Dancing	1987 drama movies, 1987 romance movies, 1980s coming-of-age movies, 1980s romantic drama movies, 1980s teen drama movies, 1980s teen romance movies, American coming-of-age movies, American romantic drama movies, American teen drama movies, American teen romance movies, Coming-of-age drama movies, Coming-of-age romance movies, Dance movies, English-language movies, Movies about vacationing, Movies set in New York, Movies set in the 1960s, Movies that won the Best Original Song Academy Award, American independent movies, Lionsgate movies
New Japan Pro Wrestling roster	Professional wrestlers
Cursive (band)	1990s American music groups, 2000s American music groups, 2010s American music groups, Emo bands, Post-hardcore bands, Musicians from Omaha, Nebraska
Ternary form	Song forms, Musical forms
La Dispute	American punk bands, American rock bands, Post-hardcore bands, Emo bands, Blues bands, Musical groups from Michigan, Grand Rapids, Michigan, Musical groups established in 2004, 2004 establishments in the United States, 2000s establishments in Michigan
Staffa	Inner and Outer Hebrides
Good Charlotte (album)	2000 albums, Good Charlotte albums, Pop punk albums
The Fall of the House of Usher	19th-century American short stories, Short stories by Edgar Allan Poe
Snow White	Grimms' Fairy Tales
Mud bogging	Motor sports
Moonshine	Alcoholic drink, Illegal drugs
Rochelle Humes	Black British actors, Black British musicians, British child singers, English movie actors, English pop singers, English television actors, People from Barking and Dagenham (London borough), Singers from London, 1989 births, Living people
Rumer Willis	American child actors, American movie actors, American television actors, Actors from Kentucky, 1988 births, Living people
Timothy Spall	1957 births, Living people, Actors from London, English movie actors, English television actors, English television presenters, English voice actors, People from Wandsworth (London borough), Television personalities from London
Pop Tarts	Snack foods
Gran Premio Latinoamericano	Horse racing, Sport in Argentina, 1981 establishments in South America
Carlos Knight	1993 births, African American actors, American movie actors, American television actors, Living people, American child actors, Actors from South Carolina, People from Columbia, South Carolina
Antonio del Pollaiuolo	1429 births, 1498 deaths, 15th century Italian painters
Kevin McDonald	1960 births, Living people, Actors from Montreal, Canadian movie actors, Canadian television actors, Canadian voice actors, Comedians from Quebec
Angels in the Outfield (1994 movie)	1994 comedy movies, 1990s fantasy movies, 1990s sports movies, American comedy movies, American fantasy movies, American sports movies, English-language movies, Movies set in Los Angeles, California, Sports comedy movies, Disney movies
Jamal Woolard	Comedians from New York City, American movie actors, American rap musicians from New York, Actors from New York City, Singers from New York City, Living people, 1975 births
Thursday (band)	Post-hardcore bands, American punk bands, Emo bands, Musical groups from New Jersey
Monticello	Presidential homes in the United States, World Heritage Sites in the United States, 1772 establishments in the Thirteen Colonies, 18th-century establishments in Virginia
Fermionic condensate	Astrophysics, Nuclear physics, Matter, Physical chemistry, Quantum mechanics
Lincoln Home National Historic Site	Presidential homes in the United States, Abraham Lincoln, Buildings and structures in Springfield, Illinois
Evangeline	19th-century American poems, Poems by Henry Wadsworth Longfellow
The Village Blacksmith	19th-century American poems, Poems by Henry Wadsworth Longfellow
The Wreck of the Hesperus	Poems by Henry Wadsworth Longfellow, 19th-century American poems
The Young and the Hopeless	2002 albums, Good Charlotte albums, Pop punk albums
The Chronicles of Life and Death	2004 albums, Good Charlotte albums, Pop punk albums
Massage	Health
Good Morning Revival	2007 albums, Good Charlotte albums, Pop punk albums
Cardiology (album)	2010 albums, Good Charlotte albums, Pop punk albums
Yulara, Northern Territory	Towns in the Northern Territory, 2006 establishments in Australia
Kata Tjuta	Mountains of the Northern Territory, World Heritage Sites in Australia, Pitjantjatjara
Lymphogranuloma venereum	Sexually transmitted diseases, Lymphatic system, Diseases caused by bacteria
Geoffrey Howe	1926 births, 2015 deaths, Alumni of the University of Cambridge, British lawyers, Cardiovascular disease deaths in England, Chancellors of the Exchequer, Deaths from myocardial infarction, Deputy Prime Ministers of the United Kingdom, Former Conservative MPs (UK), Former members of the British House of Commons for English constituencies, People from Port Talbot, Politicians from Glamorgan, UK MPs 1964–1966, UK MPs 1970–1974, UK MPs 1974, UK MPs 1974–1979, UK MPs 1979–1983, UK MPs 1983–1987, UK MPs 1987–1992
Common pipistrelle	Bats, Mammals of Europe, Mammals of Asia, Mammals of Great Britain
Dragonfruit	Fruits
Britney (album)	2001 albums, Britney Spears albums
The Singles Collection	2009 albums, Britney Spears albums
Toxic (song)	Song articles missing an audio sample, Articles with infobox errors, 2003 songs, Britney Spears songs
From the Bottom of My Broken Heart	1999 songs, Britney Spears songs
A Few Good Men	1992 crime movies, 1992 drama movies, 1990s crime drama movies, American crime drama movies, Cuba, English-language movies, Legal movies, Movies set in Washington, D.C., Columbia Pictures movies, Movies directed by Rob Reiner
Angry Kid	British television series, Animated television series
Tales of a Wayside Inn	19th-century American poems, Poems by Henry Wadsworth Longfellow
Wayside Inn	Buildings and structures in Massachusetts, Taverns, 1716 establishments in the Thirteen Colonies
Paul Revere's Ride (poem)	Poems by Henry Wadsworth Longfellow, 19th-century American poems
Bundaberg	Cities in Queensland
Old North Church	Churches in the United States, Buildings and structures in Boston, Massachusetts, 1720s establishments in the Thirteen Colonies, 1723 establishments, 18th-century establishments in Massachusetts
Pitjantjatjara language	Languages, Pitjantjatjara
Aṉangu	Indigenous peoples of Australia
House of the Seven Gables	Buildings and structures in Massachusetts, 1668 establishments, 1660s establishments in Massachusetts
Colossus computer	Computers, World War II
Communic	Norwegian heavy metal bands, Power metal bands
Sublime (philosophy)	Philosophy
Shōnan	Geography of Japan
Renata Scotto	1934 births, sopranos, Living people, Italian opera singers
Madama Butterfly	Compositions by Giacomo Puccini, 1904 works, 1900s operas
La Gioconda	operas
Europa (mythology)	Greek mythology, National personifications
Marot jar	Containers, Fluid mechanics
The Lorax	1971 books, Books by Dr. Seuss, English-language picture books
Andrew Castle	1963 births, British male tennis players, English television presenters, Living people, Reality television participants, Sportspeople from Surrey, Strictly Come Dancing participants, Television personalities from Surrey
The Cat in the Hat	1957 books, English-language picture books, Books by Dr. Seuss
Les contes d'Hoffmann	operas
The Song of Hiawatha	19th-century American poems, Poems by Henry Wadsworth Longfellow, Epic poems
Ed Sullivan	1901 births, 1974 deaths, American screenwriters, American television presenters, American television producers, Deaths from esophageal cancer, Writers from New York City
Psychological nativism	Psychology
Syphon	Fluid mechanics, Tools
DSM IV	Mental illnesses
The House of the Seven Gables	1851 books, American novels, Works by Nathaniel Hawthorne
Mandy Capristo	1990 births, Living people, Entertainers from Hesse, German models, German pop singers, German television presenters, People from Mannheim, German musicians, German singers
Baia de Criș	Communes in Romania, Transylvania
Constitution of India	Government of India, Constitutions, 1950, 1950s in India, B. R. Ambedkar
Preamble	Documents
Gil Jae	1353 births, 1419 deaths, Korean educators, Korean politicians, Murder victims, Korean writers
Little Things (Good Charlotte song)	2001 songs, Good Charlotte songs
The Motivation Proclamation	2001 songs, Good Charlotte songs
Spaceballs	1987 comedy movies, American comedy movies, American science fiction movies, Movies set on fictional planets, English-language movies, MGM movies, Parody movies, Movies directed by Mel Brooks
Little Women	1868 books, 1869 books, Books by Louisa May Alcott, Children's books, Works about sisters, 19th century American novels, Children's literature, English-language novels, Young adult novels
Mario Del Monaco	1915 births, 1982 deaths, Deaths from nephritis, Disease-related deaths in Italy, Italian singers, Musicians from Tuscany, Italian opera singers, People from Florence, Tenors
Thornhill (Alabama)	Plantations in the United States, Houses in the United States, 1833 establishments in the United States, 1830s establishments in Alabama
Stadtholder	Heads of state, History of Europe
The Click (song)	2001 songs, Good Charlotte songs
Reductionism	Philosophy of science, Philosophical movements and positions
Sagami Bay	Bodies of water of Japan, Bays
OneDrive	Web software, Microsoft Office, File sharing
Otello	Operas, Compositions by Giuseppe Verdi
The Watchtower	American magazines, Jehovah's Witnesses, Monthly magazines, Religious media
Cavalleria rusticana	Operas
Arrietty	2009 movies, 2010s anime, 2000s fantasy movies, Disney movies, Studio Ghibli, Movies based on books
Cytokinin	Hormones, Plant physiology
Haskell (programming language)	Programming languages
Second Boer War	Boer Wars, Wars involving the British Empire, History of South Africa
Enoshima	Islands of Japan
Henny Penny	Fairy tales, Idioms
Louisa May Alcott	19th-century American children's writers, Cardiovascular disease deaths in the United States, Writers from Pennsylvania, 19th-century American novelists, 1832 births, 1888 deaths
Sir Gawain	Characters in written fiction
Donna Reed	Academy Award winning actors, Actors from Iowa, American movie actors, American television actors, Cancer deaths in the United States, Deaths from pancreatic cancer, Golden Globe Award winning actors, 1921 births, 1986 deaths
Danny Dyer	Actors from London, English movie actors, English stage actors, English television actors, 1977 births, Living people, Officers of the Order of the British Empire
The Bill	1984 television series debuts, 2010 British television series endings, 1980s British drama television series, 1980s British workplace television series, 1980s crime television series, 1980s workplace drama television series, 1990s British drama television series, 1990s British workplace television series, 1990s crime television series, 1990s workplace drama television series, 2000s British drama television series, 2000s British workplace television series, 2000s crime television series, 2000s workplace drama television series, 2010s British drama television series, 2010s British workplace television series, 2010s crime television series, 2010s workplace drama television series, British crime drama television series, British workplace drama television series, Crime drama television series, ITV television programmes, Police television series, Television series set in London, English-language television programs
The Courtship of Miles Standish	19th-century American poems, Poems by Henry Wadsworth Longfellow
Darren Walsh (footballer)	1984 births, Living people, Australian rules footballers
Darren Walsh (director)	British movie directors, British writers, Animators, British movie actors, British voice actors, British comedians, Living people, Year of birth missing (living people)
Aardman Animations	1975 establishments in the United Kingdom, Academy Award winners, British animation studios
Regis Felisberto Masarim	1971 births, Living people, Brazilian footballers
Seiichi Makita	1968 births, Living people, Footballers from Tokyo Prefecture
Yasushi Matsumoto	1969 births, Living people, Footballers from Mie Prefecture
Edoson Silva Martins	1974 births, Living people, Brazilian footballers
Hideyuki Imakura	1972 births, Living people, Footballers from Saitama Prefecture
Chuda	Villages in India
Kenji Sakaguchi	1975 births, Living people, Footballers from Saitama Prefecture
Akiyoshi Yoshida	1966 births, Living people, Footballers from Nagasaki Prefecture
Yukinori Muramatsu	1969 births, Living people, Footballers from Shizuoka Prefecture
Nobuyuki Hosaka	1970 births, Living people, Footballers from Saitama Prefecture
Tadashi Koya	1970 births, Living people, Footballers from Kanagawa Prefecture
Shin Je-Bon	1971 births, Living people, North Korean footballers
Kinya Takehara	1974 births, Living people, Footballers from Hyōgo Prefecture
Hirokazu Goshi	1966 births, Living people, Footballers from Shizuoka Prefecture
Osamu Chiba	1968 births, Living people, Footballers from Miyagi Prefecture
Shuji Kusano	1970 births, Living people, Footballers from Fukushima Prefecture
Kazuhisa Irii	1970 births, Living people, Footballers from Ibaraki Prefecture
Keisuke Makino	1969 births, Living people, Footballers from Hyōgo Prefecture
Teppei Isaka	1974 births, Living people, Footballers from Ibaraki Prefecture
Nobutaka Tanaka	1971 births, Living people, Footballers from Saitama Prefecture
Satoshi Oishi	1972 births, Living people, Footballers from Shizuoka Prefecture
Fujio Yamamoto	1966 births, Living people, Footballers from Kanagawa Prefecture
Kozo Hosokawa	1971 births, Living people, Footballers from Kyoto Prefecture
Yosuke Sakamoto	1974 births, Living people, Footballers from Kyoto Prefecture
Masahiro Ota	1970 births, Living people, Footballers from Kyoto Prefecture
Takayuki Sugiyama	1976 births, Living people, Footballers from Shizuoka Prefecture
Kenichi Hashimoto	1975 births, Living people, Footballers from Kanagawa Prefecture
Marcelo Mabilia	1972 births, Living people, Brazilian footballers
Masaru Hirayama	1972 births, Living people, Footballers from Fukui Prefecture
Cléber Eduardo Arado	1972 births, 2021 deaths, Deaths from the COVID-19 pandemic in Brazil, Brazilian footballers
Marcio dos Santos Silva	1969 births, Living people, Brazilian footballers
Mobbing	Bullying
James Fenimore Cooper	Writers from New Jersey, 19th-century American novelists, 1789 births, 1851 deaths
Kenichi Serata	1973 births, Living people, Footballers from Fukuoka Prefecture
Claudio Batista dos Santos	1967 births, Living people, Brazilian footballers
Alex Lopes de Nasciment	1969 births, Living people, Brazilian footballers
Shinichi Kawano	1969 births, Living people, Footballers from Miyazaki Prefecture
Yoichi Kajiyama	1971 births, Living people, Footballers from Hiroshima Prefecture
Yoshihiko Matsuoka	1977 births, Living people, Footballers from Hyōgo Prefecture
Naoki Matsushita	1978 births, Living people, Footballers from Fukushima Prefecture
Kentaro Ishikawa	1970 births, Living people, Footballers from Chiba Prefecture
Buiu	1980 births, Living people, Brazilian footballers
Anderson Gils de Sampaio	1977 births, Living people, Brazilian footballers
Alicilio Pinto Silva Junior	1977 births, Living people, Brazilian footballers
Takahiro Sasaki	1974 births, Living people, Footballers from Tokyo Prefecture
Albert Tomas	1970 births, Living people, Spanish footballers
Koji Okamoto	1976 births, Living people, Footballers from Hyōgo Prefecture
Takuya Suzumura	1978 births, Living people, Footballers from Aichi Prefecture
Atsuo Watanabe	1974 births, Living people, Footballers from Tokyo Prefecture
Robert Vancea	1976 births, Living people, Romanian footballers
Júlio César Rocha Costa	1980 births, Living people, Brazilian footballers
Jefferson Fred Rodriguez	1978 births, Living people, Brazilian footballers
Carlos Henrique Raimundo Rodriguez	1976 births, Living people, Brazilian footballers
Chay Hews	1976 births, Living people, Australian footballers, Sportspeople from Queensland
Jailton Nunes de Oliviera	1974 births, Living people, Brazilian footballers
Kenji Ito	1976 births, Living people, Footballers from Mie Prefecture
Paulo Magino	1979 births, Living people, Brazilian footballers
Luizinho Vieira	1972 births, Living people, Brazilian footballers, Brazilian football managers
Tetsu Yamato	1978 births, Living people, Footballers from Osaka Prefecture
Kleber Romero	1976 births, Living people, Brazilian footballers
Valdinei Rocha de Oliveira	1971 births, Living people, Brazilian footballers
Hiromasa Tokioka	1974 births, Living people, Footballers from Saitama Prefecture
Alan David Dotti	1977 births, Living people, Brazilian footballers
Taisuke Hiramoto	1974 births, Living people, Footballers from Tokyo Prefecture
Yasuhiro Toyota	1976 births, Living people, Footballers from Oita Prefecture
Otsego Hall	Buildings and structures in New York
Genilson da Rocha Santos	1971 births, Living people, Brazilian footballers
Ricardo Frederico Rodrigues Antunes	1974 births, Living people, Brazilian footballers
Yuki Imamura	1976 births, Living people, Footballers from Yamanashi Prefecture
Takeshi Shimizu	1975 births, Living people, Footballers from Yamanashi Prefecture
Keiji Koizumi	1976 births, Living people, Footballers from Yamanashi Prefecture
Atsuto Oishi	1976 births, Living people, Footballers from Osaka Prefecture
Shinya Hagihara	1971 births, Living people, Footballers from Yamanashi Prefecture
Eiichi Uemura	1975 births, Living people, Footballers from Yamanashi Prefecture
Saulo Estevao da Costa Pimenta	1974 births, Living people, Brazilian footballers
Makoto Ikeda	1977 births, Living people, Footballers from Niigata Prefecture
Takeshi Kawaharazuka	1975 births, Living people, Footballers from Saitama Prefecture
Tomonori Tsunematsu	1976 births, Living people, Footballers from Kagoshima Prefecture
Yuji Nakayoshi	1972 births, Living people, Footballers from Tokyo Prefecture
Alex (born in 1976)	1976 births, Living people, Brazilian footballers
Kazumasa Shimizu	1976 births, Living people, Footballers from Ehime Prefecture
Jose Pedro Santos	1976 births, Living people, Brazilian footballers
Daniel Rossi	1981 births, Living people, Brazilian footballers
Raul Maldonado	1975 births, Living people, Argentine footballers
Romild Santos Rosa	1973 births, Living people, Brazilian footballers
Fabricio Andre Pires	1982 births, Living people, Brazilian footballers
Takashi Kojima	1973 births, Living people, Footballers from Shiga Prefecture
Fabio Augusto Justino	1974 births, Living people, Brazilian footballers
Motoki Imagawa	1980 births, Living people, Footballers from Tokyo Prefecture
Jeferson Antonio Alves Dupin	1972 births, Living people, Brazilian footballers
Washington Luigi Garucia	1978 births, Living people, Brazilian footballers
Satoshi Yashiro	1974 births, Living people, Footballers from Ibaraki Prefecture
Adsorption	Matter, Physical chemistry
Kota Minami	1979 births, Living people, Footballers from Oita Prefecture
Watch Tower Bible and Tract Society of Pennsylvania	Christianity in the United States, Jehovah's Witnesses, New York City, 1881 establishments in the United States, 1880s establishments in Pennsylvania
Jun Mizuno	1974 births, Living people, Footballers from Chiba Prefecture
Shigeo Onoue	1976 births, Living people, Footballers from Hiroshima Prefecture
Takashi Imoto	1976 births, Living people, Footballers from Saga Prefecture
Fumiaki Nakamura	1981 births, Living people, Footballers from Ibaraki Prefecture
Cleber Alessandro Gomes	1976 births, Living people, Brazilian footballers
Leandro Tomaz Perez	1979 births, Living people, Brazilian footballers
Ángel Ortiz	1977 births, Living people, Paraguayan footballers
Jiro Hiratsuka	1979 births, Living people, Footballers from Saitama Prefecture
Maruco Antonio Urunau	1970 births, Living people, Brazilian footballers
Masahiro Shimmyo	1972 births, Living people, Footballers from Chiba Prefecture
Shinichi Fujita	1973 births, Living people, Footballers from Osaka Prefecture
Yoshinobu Akao	1975 births, Living people, Footballers from Yamanashi Prefecture
Daichi Fukushima	1977 births, Living people, Footballers from Kanagawa Prefecture
Sandro Luis Zamboni Britzke	1978 births, Living people, Brazilian footballers
Marcos Antonio García Nascimento	1978 births, Living people, Brazilian footballers
Marco Tulio	1981 births, Living people, Brazilian footballers
Pak Yong-Ho	1974 births, Living people, Footballers from Aichi Prefecture
Hiroshi Sakai	1976 births, Living people, Footballers from Mie Prefecture
Ryohei Koike	1980 births, Living people, Footballers from Shizuoka Prefecture
Takuma Sugano	1980 births, Living people, Footballers from Kanagawa Prefecture
Jun Enomoto	1977 births, Living people, Footballers from Saitama Prefecture
Masakazu Senuma	1978 births, Living people, Footballers from Tokyo Prefecture
Takashi Seki	1978 births, Living people, Footballers from Ibaraki Prefecture
Marco Luiz Brito	1977 births, Living people, Brazilian footballers
Shadows-on-the-Teche	Plantations in the United States, 1830s establishments in Louisiana
Kazuo Shimizu	1975 births, Living people, Footballers from Shizuoka Prefecture
Taichi Sato	1977 births, Living people, Footballers from Saitama Prefecture
Junji Sato	1975 births, Living people, Footballers from Yamagata Prefecture
Genichi Takahashi	1980 births, Living people, Footballers from Saitama Prefecture
Makoto Takeya	1977 births, Living people, Footballers from Kanagawa Prefecture
Masaaki Koido	1978 births, Living people, Footballers from Gifu Prefecture
Masahiro Miyashita	1975 births, Living people, Footballers from Hokkaidō Prefecture
Daniel Carlos Silva Anjos	1979 births, Living people, Brazilian footballers, Bahia
Aílton de Oliveira Modesto	1980 births, Living people, Brazilian footballers
Luiz Renato Viana da Silva	1982 births, Living people, Brazilian footballers
James Angulo	1974 births, Living people, Colombian footballers
Teppei Uchida	1975 births, Living people, Footballers from Osaka Prefecture, People from Osaka
Alex Felipe Nery	1975 births, Living people, Brazilian footballers
Ricardo de Freitas Carreir	1978 births, Living people, Brazilian footballers
Vagner da Silva Sarti	1978 births, Living people, Brazilian footballers
Deili Custodio da Silva	1980 births, Living people, Brazilian footballers
Wataru Ota	1981 births, Living people, Footballers from Osaka Prefecture, People from Osaka
Satoru Yoshida	1970 births, Living people, Footballers from Saitama Prefecture
Lindomar Ferreira de Oliveira	1977 births, Living people, Brazilian footballers
Naotaka Takeda	1978 births, Living people, Footballers from Shizuoka Prefecture
Takamichi Kobayashi	1979 births, Living people, Footballers from Niigata Prefecture
Masayuki Onishi	1977 births, Living people, Footballers from Hokkaidō Prefecture
Kenji Miyazaki	1977 births, Living people, Footballers from Fukuoka Prefecture
Goichi Ishitani	1979 births, Living people, Footballers from Kagoshima Prefecture
Luciano Asley Rocha Carlos	1977 births, Living people, Brazilian footballers
Takamasa Watanabe	1977 births, Living people, Footballers from Tokyo Prefecture
Shinya Yabusaki	1978 births, Living people, Footballers from Chiba Prefecture
Gesiel José de Lima	1968 births, Living people, Brazilian footballers
Srđan Pecelj	1975 births, Living people, Bosnia and Herzegovina footballers
Daniel Conceicao Silva	1970 births, Living people, Brazilian footballers
Toru Ojima	1976 births, Living people, Footballers from Ibaraki Prefecture
Nozomu Kanaguchi	1981 births, Living people, Footballers from Kyoto
Hidetoyo Watanabe	1971 births, Living people, Footballers from Kanagawa Prefecture
Tetsuya Nishiwaki	1977 births, Living people, Footballers from Chiba Prefecture
Tomohide Nakazawa	1980 births, Living people, Footballers from Kanagawa Prefecture
Kleber Rogerio do Carmo Silva	1981 births, Living people, Brazilian footballers
Hiromasa Azuma	1977 births, Living people, Footballers from Wakayama Prefecture
Masahiro Kano	1977 births, Living people, Footballers from Chiba Prefecture
Makoto Kaneko	1975 births, Living people, Footballers from Kanagawa Prefecture
Yusuke Yoshizaki	1981 births, Living people, Footballers from Shizuoka Prefecture
Hitoshi Matsushima	1980 births, Living people, Footballers from Hokkaidō Prefecture
Kosuke Suzuki	1981 births, Living people, Footballers from Shizuoka Prefecture
Koichi Yokozeki	1979 births, Living people, Footballers from Osaka Prefecture
Shinya Hoshido	1978 births, Living people, Footballers from Saitama Prefecture
Naoki Makino	1976 births, Living people, Footballers from Shizuoka Prefecture
Tsuyoshi Nakao	1983 births, Living people, Footballers from Kagoshima Prefecture
Satoru Kobayashi	1973 births, Living people, Footballers from Gunma Prefecture
Takao Yamauchi	1978 births, Living people, Footballers from Hyōgo Prefecture
Claudecir Aparecido de Aguiar	1975 births, Living people, Brazilian footballers
Sandro Andre da Silva	1974 births, Living people, Brazilian footballers
Dai Sato	1971 births, Living people, Footballers from Saitama Prefecture
Hiroyuki Takahashi	1983 births, Living people, Footballers from Chiba Prefecture
Slave breeding in the United States	Slavery, History of the United States, African-American history
Meadowlawn (Alabama)	Buildings and structures in Alabama, Houses in the United States, 1853 establishments in the United States, 1850s establishments in Alabama
Magnolia Hall (Alabama)	Buildings and structures in Alabama, Houses in the United States
List of New York Rangers players	Lists of National Hockey League players, New York Rangers players
List of Montreal Canadiens players	Montreal Canadiens players, Lists of National Hockey League players, Canada-related lists
Kipper the Dog	1997 British television series debuts, 1990s British television series, Animated television series, Fictional characters
Uluṟu-Kata Tjuṯa National Park	National parks in Australia, Protected areas of the Northern Territory, Pitjantjatjara
George Willis	1828 births, 1898 deaths, English politicians, British physicians, People from County Cavan
Death row	Imprisonment and detention, Punishments, Capital punishment
Animation Domination	Fox television series, 2005 television series debuts
William Willis	1837 births, 1894 deaths, British physicians
Ernani	operas, Compositions by Giuseppe Verdi
La forza del destino	operas, Compositions by Giuseppe Verdi
Mirella Freni	1935 births, 2020 deaths, Deaths from neurodegenerative disease, Deaths from stroke, Italian singers, Musicians from Emilia-Romagna, Italian opera singers, People from Modena, Sopranos
Rachel Crow	1998 births, Living people, Singers from Colorado, American television actors, Comedians from Colorado, African American actors, African American comedians, Actors from Colorado, The X Factor contestants
Rachel McAdams	Actors from London (Ontario), Canadian movie actors, Canadian television actors, 1978 births, Living people, Actors from Toronto, Canadian stage actors, Canadian voice actors, Screen Actors Guild Award winners
Big Momma's House	2000 movies, American comedy movies, English-language movies, 20th Century Fox movies
Cape Henry Light	Buildings and structures in Virginia, Virginia Beach, Virginia, Lighthouses, 1792 establishments in the United States, 1881 establishments in the United States
Washington Irving	1783 births, 1859 deaths, Writers from New York City, Ambassadors of the United States
Sunnyside (Tarrytown, New York)	Buildings and structures in New York, National Historic Landmarks of the United States, Houses in the United States
The Legend of Sleepy Hollow	19th-century American short stories, Works by Washington Irving
George Li	Living people, American pianists, 1995 births
Yin Chengzong	1941 births, Living people, Chinese pianists
Fou Ts'ong	1934 births, 2020 deaths, Chinese pianists, British pianists, Deaths from the COVID-19 pandemic in the United Kingdom, People from Shanghai
Philipp Kohlschreiber	1983 births, Living people, German tennis players, Male tennis players, People from Augsburg, Sportspeople from Bavaria
Murray Perahia	1947 births, Living people, American pianists, American conductors
The General Strike	2012 albums, Punk albums
Études (Chopin)	Compositions by Frédéric Chopin
Mono Lake Tufa State Reserve	State parks in the United States, Geography of California
Lev Ivanov	Choreographers, 1834 births, 1901 deaths, Russian people
Arthur Ashe	1943 births, 1993 deaths, African-American tennis players, American activists, American male tennis players, Deaths from AIDS, Deaths from pneumonia, Infectious disease deaths in New York City, Male tennis players, People from Richmond, Virginia, Presidential Medal of Freedom recipients, Sportspeople from Virginia, US Open (tennis) champions, Wimbledon champions
Italian Concerto	Compositions by Johann Sebastian Bach, Concertos
Steps (group)	1997 establishments in England, 1990s British music groups, 2000s British music groups, 2010s British music groups, British pop music groups, Musical groups established in 1997, Musical groups from London
Falstaff	Characters in Shakespeare's plays
Laura Linney	1964 births, Living people, Actors from New York City, American movie actors, American stage actors, American television actors, American voice actors, Emmy Award winning actors, Golden Globe Award winning actors
Sammy Davis Jr.	1925 births, 1990 deaths, Actors from New York City, African American actors, African American musicians, American movie actors, American movie producers, American television actors, Cancer deaths in the United States, Converts to Judaism, Deaths from throat cancer, Jewish American actors, Jewish American musicians, Jewish businesspeople, Kennedy Center honorees, Musicians from New York City, Singers from New York City
Lang Lang	Chinese pianists, 1982 births, Living people
Erhu	String instruments, Chinese culture
Billie Jean	Pop songs, 1983 songs, Grammy Award winning songs, Michael Jackson songs
Evgeny Kissin	1971 births, Living people, Russian pianists
Camryn Manheim	American television actors, American movie actors, Actors from New Jersey, 1961 births, Living people
Inflow	Rivers, Waterways
Fox Entertainment Group	American entertainment companies, News Corporation, 21st Century Fox, Disney, Defunct companies
Sexy Bitch	2009 songs, Pop songs, David Guetta songs
Steinway & Sons	1853 establishments, Companies of Germany, Companies of the United States, Musical instrument companies
Lamian	Chinese food, Noodles
Gullah Gullah Island	1994 American television series debuts, Nickelodeon television series, 1998 American television series endings, English-language television programs
Inventions and Sinfonias (Bach)	Compositions by Johann Sebastian Bach
List of Joan of Arcadia episodes	Lists of television series episodes, American drama television series
Piano Sonata No. 1 (Mozart)	Compositions by Wolfgang Amadeus Mozart, Solo piano pieces, Sonatas
List of Detroit Red Wings players	Detroit Red Wings players, Lists of National Hockey League players
List of NHL players (A)	Lists of National Hockey League players
List of NHL players (B)	Lists of National Hockey League players
List of Sagan Tosu players	Lists of Japanese football players
List of NHL players (C)	Lists of National Hockey League players
List of Albirex Niigata players	Lists of Japanese football players, Albirex Niigata players
The Nightingale (Andersen)	Fairy tales, Works by Hans Christian Andersen
List of Avispa Fukuoka players	Lists of Japanese football players, Avispa Fukuoka players
List of NHL players (J)	Lists of National Hockey League players
List of NHL players (L)	Lists of National Hockey League players
List of NHL players (M)	Lists of National Hockey League players
Larry Johnson (running back)	1979 births, Living people, Kansas City Chiefs players, Cincinnati Bengals players, Washington Redskins players, Miami Dolphins players
Little Britain	2003 British television series debuts, 2006 British television series endings, 2000s British comedy television series, 2000s LGBT television series, 2000s satirical television series, BBC television comedy, British LGBT television programmes, British satirical television series, Cross-dressing, LGBT comedy television series, Television sketch shows, English-language television programs
Tyrod Taylor	1989 births, Living people, Baltimore Ravens players, Buffalo Bills players, Cleveland Browns players, American football quarterbacks, Sportspeople from Virginia, People from Hampton, Virginia
Yuja Wang	Chinese pianists, 1987 births, Living people
French Suites	Compositions by Johann Sebastian Bach, Suites
Baltimore Colts	Indianapolis Colts, Sports in Baltimore, Maryland, 1953 establishments in the United States, 1984 disestablishments in the United States, 20th-century establishments in Maryland
Cultigen	Botany
Oil spill	Water pollution
List of Cerezo Osaka players	Lists of Japanese football players
Lenticular galaxy	Lenticular galaxies
List of Ehime FC players	Lists of Japanese football players
Fishing industry	Industries
John Wesley Hillman	1832 births, 1915 deaths, People from New York
Stability	Physics, Mathematics
Type specimen	Taxonomy
Gene flow	Genetics
List of Sanfrecce Hiroshima players	Lists of Japanese football players
Fusion power	Nuclear energy
List of Gamba Osaka players	Lists of Japanese football players
First Coast	Geography of Florida
Gainare Tottori	Japanese football clubs, Tottori Prefecture
Matukituki River	Rivers of Oceania, Bodies of water of New Zealand
Buddhist crisis	Vietnam War, 1963, 1960s in Asia
News Corporation	News Corporation, 1979 establishments, 2013 disestablishments
Aizuwakamatsu, Fukushima	Cities in Fukushima Prefecture
Concorde	Aircraft, Aviation in France
Date, Fukushima	Cities in Fukushima Prefecture
Canyoneering	Sports, Canyons
Logan Lerman	1992 births, Living people, Actors from Beverly Hills, California, American movie actors
Ernest Giles	1835 births, 1897 deaths, English explorers, People from Bristol, Deaths from pneumonia
William Gosse	1842 births, 1881 deaths, Deaths from myocardial infarction, English explorers, People from Hertfordshire
German wine	German food, Rhineland-Palatinate, Hesse, Baden-Württemberg
Adolphe Adam	1803 births, 1856 deaths, French composers, Writers from Paris, Burials at Montmartre Cemetery, Paris
Henry Ayers	1821 births, 1897 deaths, Knights Grand Cross of the Order of St Michael and St George, People from Portsmouth, Premiers of South Australia
Bushfood	Australian culture, Foods, Indigenous Australian culture
List of J.League players	Lists of Japanese football players
Station (agriculture)	Agriculture in Australia, Australian culture
Mikhail Fokine	1880 births, 1942 deaths, Choreographers, Russian people, Ballets Russes
Lasseter's Reef	Australian folklore, History of Australia
Altar lamp	Christian symbols, Judaism
Le Spectre de la rose	Ballets choreographed by Michel Fokine, Ballets Russes productions, Ballets starring Nijinsky
FC Machida Zelvia	Japanese football clubs, 1977 establishments in Asia, 1970s establishments in Japan
Dunscaith Castle	Castles in Scotland, Ruins
Park Yong-Ho	1981 births, Living people, South Korean footballers, People from Incheon
Willem Dafoe	People from Appleton, Wisconsin, Actors from Wisconsin, American movie actors, American television actors, American voice actors, 1955 births, Living people
Les Sylphides	Ballets choreographed by Michel Fokine, Ballets Russes productions, Ballets starring Nijinsky
Alain Delon	1935 births, Living people, Actors from Ile-de-France, French movie actors, French movie directors, French movie producers, French screenwriters, French television actors, Swiss movie actors, Swiss screenwriters, Television producers, Writers from Ile-de-France
Peter Finch	Academy Award winning actors, Actors from London, Actors from Sydney, Australian movie actors, Australian radio personalities, Australian stage actors, BAFTA Award winning actors, Cardiovascular disease deaths in the United States, Deaths from myocardial infarction, Golden Globe Award winning actors, 1916 births, 1977 deaths
Depressant	Drugs
Barbiturate	Drugs, Drugs used in psychiatry
Whose Line Is It Anyway?	American comedy television series, British comedy television series, English-language television programs
Dez Bryant	Dallas Cowboys players, American football wide receivers, Sportspeople from Texas, 1988 births, Living people
Pontifical Catholic University of Chile	Colleges and universities in Chile, Santiago de Chile, 1888 establishments, 19th-century establishments in Chile
Jude Law	1972 births, Living people, Actors from London, BAFTA Award winners, English movie actors, English movie producers, English stage actors, English television actors
Connellan Airways	Airlines of Australia, 1943 establishments, 1980 disestablishments, 1940s establishments in Australia
Jacaranda	Bignoniaceae
Ion Television	American television networks
UniMás	American television networks, 2002 establishments in the United States, 2000s establishments in Florida
Olaf Rose	1956 births, Living people, German historians, German politicians, Neo-Nazis, Politicians from North Rhine-Westphalia
Kaltukatjara	Towns in the Northern Territory, Indigenous Australian communities, Pitjantjatjara, 1968 establishments in Australia
The Honeymooners	American sitcoms, Black and white television series, 1950s television series, CBS network shows, English-language television programs
What's My Line?	Television game shows, CBS network shows, Emmy Award winning programs, Golden Globe Award winning programs, 1950s television series, First run syndicated television programs, English-language television programs
Queen for a Day	Television game shows, 1950s television series, English-language television programs
Handicraft	Manufacturing
Margo Martindale	American movie actors, American stage actors, American television actors, Actors from Texas, Emmy Award winners, 1951 births, Living people
Dawan Landry	1982 births, Sportspeople from Louisiana, Baltimore Ravens players, Jacksonville Jaguars players, Living people
Quarterback sack	American football, Sports words
Tackle (football)	Sports words
Releaser	Ethology
Fruit fly	Flies
Copper Age	Periods and ages in history
Blaine Gabbert	1989 births, American football quarterbacks, Sportspeople from Missouri, Jacksonville Jaguars players, Living people
Part of Me	2012 songs, Katy Perry songs, Songs about infidelity, Songs with feminist themes
Waking Up in Vegas	2009 songs, Katy Perry songs
The Cleveland Show	The Cleveland Show, 2009 American television series debuts, 2000s American television series, 2010s American television series, Adult Swim, American animated television series, Fox television series, Television spin-offs, Virginia in fiction, Family Guy, English-language television programs
Bob's Burgers	2011 American television series debuts, 2010s American sitcoms, 2020s American sitcoms, 2010s American workplace television series, 2010s animated television series, 2020s animated television series, American animated television series, American workplace comedy television series, Television series about families, English-language television programs
Napoleon Dynamite (TV series)	2012 American television series debuts, 2012 American television series endings, 2010s American television series, American sitcoms, Animated television series, Idaho, English-language television programs
The Flintstones	1960 establishments in the United States, 1966 disestablishments in the United States, 1960s American television series, American sitcoms, Animated television series, Fictional families, Period television series, Television series about dinosaurs, Television series about families, The Flintstones, English-language television programs, 1960 television series debuts, 1966 television series endings
Off-label use	Drugs
Sit Down, Shut Up (American TV series)	American sitcoms, Animated television series, English-language television programs
Global Television Network	Canadian television networks, 1974 establishments in North America, 1970s establishments in Canada
So You Think You Can Dance	Reality television series, Dance
Fox News Sunday	American television news programs, Fox television series
Fringe	American drama television series, Fox television series, American science fiction television series, English-language television programs
The Finder	2012 American television series debuts, 2012 American television series endings, 2010s American television series, American drama television series, Television series set in Florida, Television spin-offs, English-language television programs
Wolf Vostell	1932 births, 1998 deaths, German artists
Alcatraz (TV series)	American drama television series, English-language television programs
Touch (TV series)	2012 American television series debuts, 2013 American television series endings, 2010s American television series, American drama television series, Autism in fiction, Fox television series, Television series set in New York City, English-language television programs
List of Yokohama F. Marinos players	Lists of Japanese football players
Klamath County, Oregon	Oregon counties
Cornerback	American football positions
The One That Got Away	2011 songs, Katy Perry songs
Jonathan Ogden	1974 births, Living people, Sportspeople from Washington, D.C., Baltimore Ravens players, American football offensive tackles
Entertainment Tonight Canada	Canadian television series
Entertainment Tonight	American television series, First run syndicated television programs, English-language television programs
The Good Wife	2009 American television series debuts, 2000s American television series, 2010s American television series, American crime drama television series, Legal television series, Television series set in Chicago, Illinois, CBS network shows, English-language television programs
Hawaii Five-0	2010s American drama television series, CBS network shows, 2010 American television series debuts, English-language television programs
Terrell Owens	1973 births, Living people, American football wide receivers, Sportspeople from Alabama
Titanic (TV series)	2012 television series debuts, 2012 television series endings, 2010s British television series, Drama television series, Miniseries, RMS Titanic, 2010s establishments in Canada, 2010s establishments in the United Kingdom, 2010s disestablishments in Canada, 2010s disestablishments in the United Kingdom, English-language television programs
Burnout (vehicle)	Motor sports
Jamboree	Scouting, Events
Scarecrow	Agriculture
The Wonderful Wizard of Oz	1900 books, 20th century American novels, English-language novels, Children's books
Arvo Pärt	Composers, Estonian musical entertainers, 1935 births, Living people
List of Hokkaido Consadole Sapporo players	Lists of Japanese football players, Sapporo
William Wallace Denslow	American illustrators, 1856 births, 1915 deaths, Deaths from pneumonia, American cartoonists
Margaret Hamilton	Actors from Cleveland, Ohio, American movie actors, American television actors, Cardiovascular disease deaths in Connecticut, Deaths from myocardial infarction, 1902 births, 1985 deaths
Joseph Kony	1961 births, Living people, Terrorists, Ugandan people
List of FC Tokyo players	Lists of Japanese football players
NYC 22	CBS network shows, American drama television series, Crime television series, Television series set in New York City, English-language television programs
2011–12 United States network television schedule	2011 in American television, 2012 in American television
Comedytime Saturday	Television programs
Crimetime Saturday	Television programs
How to Be a Gentleman	American sitcoms, 2011 American television series debuts, 2012 American television series endings, English-language television programs
The Firm (2012 TV series)	American drama television series, 2012 television series debuts, 2012 establishments in Canada, 2012 establishments in the United States, English-language television programs
Bokmål	Languages of Norway, Germanic languages
Bío Bío Region	Regions of Chile
Samari Rolle	1976 births, Living people, American football cornerbacks, Tennessee Titans players, Baltimore Ravens players, Sportspeople from Miami, Florida
Frank Morgan	American movie actors, Actors from New York City, 1890 births, 1949 deaths, Deaths from myocardial infarction, Silent movie actors
Little Nemo	American comic strips
Krazy Kat	American comic strips, Comics characters
Pierre-Simon Laplace	1827 deaths, 1749 births, Foreign Members of the Royal Society, French astronomers, French mathematicians, Theoretical physicists
Château-Arnoux-Saint-Auban	Communes in Alpes-de-Haute-Provence
Inselberg	Landforms
Great Slave Lake	Northwest Territories, Lakes of Canada
List of NHL players (S)	Lists of National Hockey League players
Johann Friedrich Blumenbach	1752 births, 1840 deaths, German doctors, Naturalists, Foreign Members of the Royal Society, Human body features
List of Canadian painters	Canadian painters, Lists of Canadian people
Homare Sawa	1978 births, Living people, Footballers from Tokyo Prefecture, Japan women's international footballers, Nadeshiko League players, Nippon TV Tokyo Verdy Beleza players, INAC Kobe Leonessa players, Footballers at the 1996 Summer Olympics, Footballers at the 2004 Summer Olympics, Footballers at the 2008 Summer Olympics, Footballers at the 2012 Summer Olympics, 1995 FIFA Women's World Cup players, 1999 FIFA Women's World Cup players, 2003 FIFA Women's World Cup players, 2007 FIFA Women's World Cup players, 2011 FIFA Women's World Cup players, 2015 FIFA Women's World Cup players, 1993 AFC Women's Championship players, 1995 AFC Women's Championship players, 1997 AFC Women's Championship players, 2001 AFC Women's Championship players, 2003 AFC Women's Championship players, 2006 AFC Women's Asian Cup players, 2008 AFC Women's Asian Cup players, 2010 AFC Women's Asian Cup players, 2014 AFC Women's Asian Cup players, Footballers at the 1994 Asian Games, Footballers at the 1998 Asian Games, Footballers at the 2002 Asian Games, Footballers at the 2006 Asian Games, Footballers at the 2010 Asian Games, Olympic medalists in football, Japanese Olympic silver medalists, Medalists at the 2012 Summer Olympics, FIFA Women's World Cup-winning players, AFC Women's Asian Cup-winning players, Asian Games medalists in football, Asian Games gold medalists for Japan, Asian Games silver medalists for Japan, Asian Games bronze medalists for Japan, Medalists at the 1994 Asian Games, Medalists at the 1998 Asian Games, Medalists at the 2002 Asian Games, Medalists at the 2006 Asian Games, Medalists at the 2010 Asian Games
Yanick Dupre Memorial Award	Ice hockey trophies and awards
List of Júbilo Iwata players	Lists of Japanese football players
Foot fetishism	Human sexuality
List of Kashima Antlers players	Lists of Japanese football players
CTV Two	Canadian television networks, 1995 establishments in Canada
Billy Bean	1964 births, Living people, People from Santa Ana, California, LGBT people from California, Gay men, Detroit Tigers players, Los Angeles Dodgers players, San Diego Padres players
America's Funniest Home Videos	American comedy television series, American reality television series, ABC network shows, 1989 American television series debuts, 1990s television series, 2000s television series, English-language television programs
The X Factor (U.S.)	2011 American television series debuts, 2013 American television series endings, 2010s American television series, American reality television series, The X Factor, English-language television programs
The Yellow Kid	American comic strips, Comics characters
2010–11 United States network television schedule	2010 in American television, 2011 in American television
Citytv	Television stations, 1972 establishments in Canada
Toon Disney	American television channels, Disney, 1998 establishments in the United States, 2009 disestablishments in the United States
MTV2	American television channels, 1996 establishments in the United States, Viacom
Iwata, Shizuoka	Cities in Japan, Settlements in Shizuoka Prefecture
Kashima, Ibaraki	Cities in Japan, Settlements in Ibaraki Prefecture
Marcus Salvius Otho	32 births, 69 deaths, Roman Emperors
Bornhardt	Landforms
Tosu, Saga	Cities in Kyushu, Settlements in Saga Prefecture
Lorenzo de' Medici	1449 births, 1492 deaths, House of Medici, Renaissance, People from Florence, Italian artists
Kashiwa, Chiba	Cities in Chiba Prefecture
List of Kashiwa Reysol players	Lists of Japanese football players
Offal	Offal
Kyūshū Shinkansen	Shinkansen
Jura Mountains	Mountains of Europe
Arkose	Sandstones
Justified (TV series)	2010 American television series debuts, 2015 American television series endings, 2010s American television series, American crime drama television series, Harlan County, Kentucky, Spy television series, English-language television programs
Jason Donovan	1968 births, Living people, Actors from Melbourne, Australian child actors, Australian movie actors, Australian pop musicians, Australian radio personalities, Australian singers, Australian television actors, I'm a Celebrity...Get Me Out of Here! contestants, Musicians from Melbourne, Strictly Come Dancing participants
Jarret Johnson	1981 births, Living people, Sportspeople from Florida, Baltimore Ravens players
Linebacker	American football positions
Lambeau Field	Football stadiums in the United States, Green Bay Packers, Buildings and structures in Wisconsin, 1957 establishments in the United States, 20th-century establishments in Wisconsin
Kelly McGillis	1957 births, Living people, People from Newport Beach, California, Actors from Orange County, California, LGBT people from California, American movie actors, American television actors, American voice actors, Lesbians, LGBT actors
Disney XD	Disney companies, American television networks, 2007 establishments in the United States, Cable television
Samkranthi	Hinduism, Andhra Pradesh, Festivals in Asia
D. W. Griffith	American movie directors, 1875 births, 1948 deaths, Deaths from stroke
Service d'exploitation de la formation aéronautique	Aviation in France, Schools in France, 1993 establishments in France
Paris Opéra Ballet	Ballet companies
Alexis Weissenberg	1929 births, 2012 deaths, Bulgarian Jews, French pianists, Holocaust survivors, Jewish French musicians, People from Sofia
Carlos Soria	1949 births, 2012 deaths, Argentine politicians
Bolshoi Ballet	Ballet companies
American Ballet Theatre	Ballet companies, 1937 establishments in the United States, 1930s establishments in New York (state)
List of bridges in Calgary	Bridges in Canada, Lists of bridges
Joan Crawford	1904 births, 1977 deaths, Christian Scientists, Actors from San Antonio, Texas, American movie actors, American radio actors, American silent movie actors, American television actors, Cardiovascular disease deaths in the United States, Deaths from myocardial infarction
List of bridges to the Island of Montreal	Bridges in Canada, Lists of bridges
List of governors of Japan	Lists of governors, Governors of Japanese prefectures, Lists of Japanese people
Fukui Prefecture	Fukui Prefecture, Prefectures of Japan
Nagano Prefecture	Nagano Prefecture, Prefectures of Japan
Nara Prefecture	Nara Prefecture, Prefectures of Japan
Ezo	Islands of Japan, Hokkaido Prefecture, Akita Prefecture, Aomori Prefecture, Fukushima Prefecture, Iwate Prefecture, Miyagi Prefecture, Yamagata Prefecture
Jules-Henri Vernoy de Saint-Georges	French writers, Librettists, 1799 births, 1875 deaths
Mildred Pierce	1945 movies, Film noir, American crime movies, Women's movies, United States National Film Registry movies, Movies based on books, English-language movies, Movies directed by Michael Curtiz
Our Dancing Daughters	1928 movies, 1920s romance movies, 1920s drama movies, American silent movies, American romantic drama movies, Women's movies, MGM movies
The Cabinet of Dr. Caligari	1920 movies, 1920s horror movies, German silent movies, German horror movies
Lake Biel	Lakes of Bern
Brandon Marshall	1984 births, Living people, African American players of American football, American football wide receivers, Chicago Bears players, People with borderline personality disorder, Sportspeople from Pittsburgh, Pennsylvania
Theda Bara	Silent movie actors, 1885 births, 1955 deaths
The King of Kings	1927 movies, American silent movies, American epic movies
Mary Pickford	1892 births, 1979 deaths, Deaths from cerebral hemorrhage, Canadian movie actors, American movie actors, Actors from Toronto, Silent movie actors, Best Actress Academy Award winners
Mark Clayton (American football, born 1982)	1982 births, Living people, African American players of American football, American football wide receivers, Baltimore Ravens players, Sportspeople from Oklahoma City, St. Louis Rams players
Douglas Fairbanks	1883 births, 1939 deaths, Silent movie actors, American stage actors, Deaths from myocardial infarction
Alluvial fan	Geology, Landforms, River deltas
Robin Hood (1922 movie)	1922 movies, American silent movies, Movies directed by Allan Dwan, American adventure movies, Swashbuckler movies
Matt Flynn	Sportspeople from Texas, American football quarterbacks, Green Bay Packers players, 1985 births, Living people
Jonathan Demme	1944 births, 2017 deaths, Deaths from esophageal cancer, Cancer deaths in New York City, Cardiovascular disease deaths in New York City, Academy Award winning directors, Actors from New York, American movie actors, American television actors, American television directors, American television producers, American television writers, Movie directors from New York, Movie producers from New York, Screenwriters from New York
Defensive tackle	American football positions
Shiga Prefecture	Shiga Prefecture, Prefectures of Japan
List of national universities in Japan	Colleges and universities in Japan, Lists of universities, Japan-related lists
Coffin Bay National Park	National parks in Australia, Protected areas of South Australia
Surface runoff	Ecology, Environmental chemistry, Water pollution
Way Down East	1920 movies, Women's movies, American silent movies, Movies based on plays, Movies directed by D. W. Griffith
Lillian Gish	1893 births, 1993 deaths, Silent movie actors, American movie actors, American stage actors, American television actors, Actors from Ohio, Episcopalians, People from Springfield, Ohio
John Newlands	1837 births, 1898 deaths, English chemists
Gotham City	Fictional locations, Batman
Fracture (geology)	Geology
Joint (geology)	Geology
List of Kawasaki Frontale players	Lists of Japanese football players
List of Nagoya Grampus players	Lists of Japanese football players
Pollyanna (1920 movie)	1920 movies, 1920s comedy movies, 1920s drama movies, American silent movies, American comedy-drama movies, Movies based on books
The Hunchback of Notre Dame (1923 movie)	American silent movies, 1923 movies, 1920s horror movies, 1920s drama movies, American horror movies, American drama movies, Universal Pictures movies, Movies based on books
Tottori Prefecture	Tottori Prefecture, Prefectures of Japan
The Mark of Zorro (1920 movie)	Silent movies, 1920 movies, Swashbuckler movies, Movies based on books
Yamagata Prefecture	Yamagata Prefecture, Prefectures of Japan
Swashbuckler movie	Swashbuckler movies
Tomboy	Gender, Pejoratives
West Point (1928 movie)	1928 movies, 1920s drama movies, American silent movies, American drama movies, Movies directed by Edward Sedgwick
Pope Victor	Papal names
William Haines	1900 births, 1973 deaths, Actors from Virginia, American LGBT people, American silent movie actors, American stage actors, Cancer deaths in the United States, Deaths from lung cancer, Gay men, LGBT actors
Martine McCutcheon	1976 births, Living people, Actors from London, British child actors, English movie actors, English pop singers, English stage actors, English television actors, People from Hackney, Singers from London
Love Actually	2003 comedy-drama movies, 2003 romance movies, 2000s romantic comedy movies, 2000s romantic drama movies, British comedy-drama movies, British romantic comedy movies, British romantic drama movies, English-language movies, French-language movies, Marseille, Movies set in France, Movies set in London, Wisconsin
Saint-Cyr-l'École	Communes in Yvelines
Floodplain	Wetlands, Landforms, Waterways, Flood control
Satch Boogie	1987 songs
Monomer	Chemical compounds, Polymers
Anne Tenney	1954 births, Living people, Australian movie actors, Australian television actors, Actors from Sydney
Elio Di Rupo	1951 births, Living people, Alderman of Belgium, Belgian atheists, Belgian chemists, Belgian educators, Belgian LGBT people, Belgian mayors, Former MEPs, Freemasons, Gay men, Government ministers of Belgium, LGBT politicians, MEPs for Belgium, Parti socialiste (Belgium) politicians, People from Hainaut (province), Prime Ministers of Belgium, Walloon politicians
Kyoto Prefecture	Kyoto Prefecture, Prefectures of Japan
Batik	Clothing, Textile arts, Cloth
Payment protection insurance	Insurance
Otoya Yamaguchi	1943 births, 1960 deaths, Anti-Communists, People from Tokyo, Murder victims, Japanese activists
West Hollywood, California	West Hollywood, California, 1984 establishments in California
Steve Reeves	Actors from Montana, American movie actors, American television actors, Bodybuilders, Deaths from lymphoma, 1926 births, 2000 deaths
Hercules (1958 movie)	Epic movies, 1958 movies, 1950s fantasy movies, Peplum movies, Movies based on Greek and Roman mythology, Hercules movies, Italian-language movies
Peplum movie	Peplum movies
Muscular Christianity	History of Christianity, 19th century
List of Omiya Ardija players	Lists of Japanese football players
Sean Stone	1984 births, Living people, Actors from New York City, American movie actors, American movie producers, American Muslims, Movie directors from New York
Machinima	Animation, Computer graphics
Oswald (TV series)	2001 American television series debuts, 2003 American television series endings, 2000s American television series, American children's television series, Nickelodeon television series, Television series about animals, Animals in fiction, English-language television programs
Jason and the Argonauts (1963 movie)	Peplum movies, 1960s fantasy movies, 1960s adventure movies, American fantasy movies, American adventure movies, Epic movies, Movies based on Greek and Roman mythology, 1963 movies, Movies directed by Don Chaffey
Ulysses (1954 movie)	1955 movies, Adventure movies, Epic movies, 1950s fantasy movies, Italian movies, Italian-language movies, Movies based on Greek and Roman mythology, Peplum movies
Clash of the Titans	Epic movies, 1980s fantasy movies, Movies based on Greek and Roman mythology, 1981 movies
Childhood	Childhood
Engen	Japanese eras, 1336 establishments in Japan, 1340 disestablishments, 1340s disestablishments in Japan
Kōkoku	Japanese eras, 1340 establishments, 1340s establishments in Japan, 1346 disestablishments, 1340s disestablishments in Japan
Anglo-Saxon runes	Runes, Anglo-Saxons, 5th century establishments in Europe, 8th-century disestablishments
Shōhei	Japanese eras, 1346 establishments, 1340s establishments in Japan, 1370 disestablishments, 1370s disestablishments in Japan
Hercules vs. the Moon Men	1960s science fiction movies, Peplum movies, Movies based on Greek and Roman mythology, 1960s fantasy movies, Epic movies, Italian movies, French movies, 1964 movies, Italian-language movies
Kentoku	Japanese eras, 1370 establishments, 1370s establishments in Japan, 1372 disestablishments, 1370s disestablishments in Japan
Bunchū	Japanese eras, 1372 establishments, 1370s establishments in Japan, 1375 disestablishments, 1370s disestablishments in Japan
Tenju	Japanese eras, 1375 establishments, 1370s establishments in Japan, 1381 disestablishments, 1380s disestablishments in Japan
Kōwa (Muromachi period)	Japanese eras, 1381 establishments, 1380s establishments in Japan, 1384 disestablishments, 1380s disestablishments in Japan
Ryakuō	Japanese eras, 1338 establishments, 1330s establishments in Japan, 1342 disestablishments, 1340s disestablishments in Japan
Kōei (era)	Japanese eras, 1342 establishments, 1340s establishments in Japan, 1345 disestablishments, 1340s disestablishments in Japan
Women's movies	Women's movies
Handshakes and Middle Fingers	2011 albums
The Wedding Singer	1998 romance movies, 1998 comedy movies, 1990s romantic comedy movies, American romantic comedy movies, English-language movies, Movies about weddings, Movies set in the 1980s, New Line Cinema movies
Rafael Landry Tanubrata	1986 births, Living people, Pop musicians, R&B musicians, Indonesian singers
In Search of the Castaways	American adventure movies, American musical movies, Disney movies, American fantasy movies, American family movies, Movies based on books by Jules Verne, 1962 movies, English-language movies
Man and the Biosphere Programme	Biosphere reserves
Around the World in 80 Days (1956 movie)	American adventure movies, Movies based on books by Jules Verne, 1956 movies, English-language movies, Movies directed by Michael Anderson
Lake retention time	Lakes
Mysterious Island (1961 movie)	1960s science fiction movies, Adventure movies, Movies based on books by Jules Verne, 1961 movies, 1960s fantasy movies, British movies, English-language movies
Discharge (hydrology)	Lakes, Waterways
Bagnolet	Communes in Seine-Saint-Denis
Orly	Communes in Val-de-Marne
Georges Méliès	1861 births, 1938 deaths, Movie directors from Paris, Burials at Père Lachaise Cemetery
The Haunted Castle	1896, French movies, Horror movies
Koei	Video game companies
Loreen	1983 births, Living people, Musicians from Stockholm, Singers from Stockholm, Pop musicians, Pop singers, Eurovision Song Contest winners
Computer speaker	Computer hardware, Audio technology
List of bridges in Ottawa	Bridges in Canada, Canada-related lists, Lists of bridges, Ottawa
Triodia	Poaceae, Plants of Australia
38th G8 summit	G8, 2012 in the United States, 2010s in Maryland
Alpine marmot	Squirrels, Mammals of Europe
Western Christianity	Church organization
Paul Signac	French painters, 1863 births, 1935 deaths
FIFA (video game series)	FIFA, Sports video games
FIFA 14	2013 video games, FIFA, Sports video games, PlayStation 2 games, PlayStation 3 games, PlayStation 4 games, PlayStation Portable games, PlayStation Vita games, Xbox 360 games, Xbox One games, Wii games, Nintendo 3DS games, Windows games
Biosphere reserve	UNESCO, Ecology, Biosphere reserves
Lake Amadeus	Lakes of the Northern Territory
Elder Futhark	Runes, Germanic languages
Adam Faith	Actors from London, Cardiovascular disease deaths in England, Deaths from myocardial infarction, English movie actors, English pop musicians, English television actors, Journalists from London, Singers from London, 1940 births, 2003 deaths
A Trip to the Moon	Silent movies, 1900s movies, Science fiction movies, Fantasy movies, French movies, Movies based on books by Jules Verne
Younger Futhark	Runes
Hard Candy (Madonna album)	2008 albums, Madonna albums, R&B albums
Dord	Words
ETalk	1995 television series debuts, 1990s Canadian television series, 2000s Canadian television series, 2010s Canadian television series
Edwin S. Porter	American movie directors, 1870 births, 1941 deaths, People from Pennsylvania
Life of an American Fireman	1903 movies, American silent movies
Pentane	Alkanes
Max Schreck	1879 births, 1936 deaths, Actors from Berlin, Cardiovascular disease deaths in Germany, Deaths from myocardial infarction, German movie actors
Greater Yellowstone Ecosystem	Biosphere reserves, Calderas, Ecosystems, Animals of North America, National parks in the United States, Volcanoes of the United States, Wilderness Areas of the United States, Idaho, Montana, Wyoming
Old Frisian	Frisian languages
Mount Takao	Mountains of Japan, Tokyo Prefecture, Japanese culture
It (1927 movie)	1927 movies, 1920s romance movies, 1920s comedy movies, American silent movies, American romantic comedy movies, United States National Film Registry movies
Kim Jong-un	1983 births, Kim Jong-un, Living people, Dictators, Generals, North Korean military people, North Korean politicians, Current national leaders, People from Pyongyang
Anthony Perkins	Actors from New York City, American movie actors, American movie directors, American pop musicians, American television actors, Bisexual people, Deaths from AIDS, Golden Globe Award winning actors, Infectious disease deaths in Los Angeles, LGBT actors, LGBT musicians, LGBT people from Massachusetts, LGBT people from New York City, Actors from Boston, Massachusetts, Singers from Boston, Massachusetts, Singers from New York City, 1932 births, 1992 deaths
Online Mendelian Inheritance in Man	Public databases, Classical genetics, Humans
Valdagno	Settlements in Veneto
Un ballo in maschera	Compositions by Giuseppe Verdi, Operas
Aboriginal land rights in Australia	Indigenous Australian politics, Indigenous land rights
Safety Last!	United States National Film Registry movies, 1923 movies, 1920s romance movies, 1920s comedy movies, American silent movies, American romantic comedy movies
Mario Manningham	1986 births, Living people, American football wide receivers, New York Giants players, San Francisco 49ers players, Sportspeople from Ohio
Broken Blossoms	1919 movies, American silent movies, United States National Film Registry movies, Movies based on short stories, Movies directed by D. W. Griffith
Monsters University	2013 comedy movies, 2013 animated movies, 2013 3D movies, American comedy movies, American animated movies, Prequel movies, Pixar movies, Buddy movies, English-language movies, American fantasy movies, 2010s fantasy movies, Monsters, Inc., Movies about fraternities and sororities, Movies composed by Randy Newman, Movies set in universities and colleges
Vinny Testaverde	1963 births, Living people, American football quarterbacks, Carolina Panthers players, New England Patriots players, New York Jets players, Dallas Cowboys players, Baltimore Ravens players, Cleveland Browns players, Tampa Bay Buccaneers players, Sportspeople from New York City, Heisman Trophy winners
Florida Seminoles	College football, Sports in Florida
Marvin Lewis	1958 births, Living people, Sportspeople from Pennsylvania, National Football League coaches, Cincinnati Bengals
Mike Nolan	1959 births, Living people, Sportspeople from Maryland, National Football League coaches, San Francisco 49ers
Shannon Sharpe	1968 births, Living people, Sportspeople from Chicago, Denver Broncos players, Baltimore Ravens players, Pro Football Hall of Fame
Sterling Sharpe	1965 births, Living people, Sportspeople from Chicago, Green Bay Packers players
Silicate mineral	Minerals
Akili Smith	1975 births, Living people, Cincinnati Bengals players, Green Bay Packers players, Tampa Bay Buccaneers players, Frankfurt Galaxy, Sportspeople from San Diego, California
Rex Ryan	National Football League coaches, 1962 births, Living people, Sportspeople from Oklahoma
Jamal Lewis	1979 births, American football running backs, Baltimore Ravens players, Living people, Cleveland Browns players, Sportspeople from Atlanta, Georgia
Chuck Pagano	National Football League coaches, American football safeties, Sportspeople from Colorado, People from Boulder, Colorado, 1960 births, Living people
Jason Witten	American football tight ends, 1982 births, Living people, Dallas Cowboys players, People from Knoxville, Tennessee, Sportspeople from Tennessee
University of North Carolina at Asheville	Colleges and universities in North Carolina, 1927 establishments in the United States, 20th-century establishments in North Carolina, Asheville, North Carolina
Tight end	American football positions, Sports words
Cecil B. DeMille	American movie directors, American movie producers, American screenwriters, American movie actors, 1881 births, 1959 deaths, Academy Award winners, Actors from Massachusetts, Deaths from heart failure, Episcopalians, Writers from Massachusetts, 19th-century American entertainers
Miles Austin	Dallas Cowboys players, American football wide receivers, Sportspeople from New Jersey, 1984 births, Living people
Kalininskaya Line	Rail transport in Europe, Moscow Metro
Jameel McClain	1985 births, Baltimore Ravens players, American football linebackers, Living people, Sportspeople from Philadelphia, Pennsylvania
Jōwa (Muromachi period)	Japanese eras, 1345 establishments, 1340s establishments in Japan, 1350 disestablishments, 1350s disestablishments in Japan
Chelation	Physical chemistry, Analytical chemistry
List of Shimizu S-Pulse players	Lists of Japanese football players
Father's day	Holidays
List of Urawa Red Diamonds players	Lists of Japanese football players
Mother's Day	Holidays, 1908 establishments in the United States
Anjelica Huston	1951 births, Living people, Actors from Santa Monica, California, American movie actors, American stage actors, American television actors, American voice actors, Golden Globe Award winning actors, Movie directors from California
Yundi Li	1982 births, Living people, Chinese pianists
Port Moody	Port Moody, British Columbia, Cities in British Columbia, 1913 establishments in North America, 1910s establishments in Canada
Anders Behring Breivik	1979 births, Living people, Murderers, Norwegian people, People from Oslo, People with antisocial personality disorder, People with narcissistic personality disorder, Prisoners, Terrorists
2011–12 Canadian network television schedule	2010s in Canada, 2011 in television, 2012 in television
Once Upon a Time (TV series)	American drama television series, 2011 American television series debuts, Fantasy television series, English-language television programs
Joe Dirt	2001 movies, American comedy movies, English-language movies, Columbia Pictures movies
Xenoturbella	Invertebrates, Minor phyla
Christian VII of Denmark	Kings and Queens of Denmark, Dukes and duchesses, 1749 births, 1808 deaths
Torrey Smith	1989 births, Living people, Baltimore Ravens players, Sportspeople from Virginia
List of Vegalta Sendai players	Lists of Japanese football players, Sendai, Miyagi
Klamath Falls, Oregon	Cities in Oregon, County seats in Oregon
List of Vissel Kobe players	Lists of Japanese football players
List of Fagiano Okayama players	Lists of Japanese football players
Okayama, Okayama	Cities in Japan, Settlements in Okayama Prefecture
Cycliophora	Minor phyla, Invertebrates
List of FC Gifu players	Lists of Japanese football players
Marksistskaya	Moscow Metro
Meiju Suvas	1959 births, Living people, Finnish singers, People from Helsinki
List of FC Machida Zelvia players	Lists of Japanese football players
Pachuca	Capital cities in Mexico, Hidalgo (state)
Jules Perrot	1810 births, 1892 deaths, French choreographers, French ballet dancers
Kashiba, Nara	Cities in Nara Prefecture
Miyaki, Saga	Towns in Japan, Settlements in Saga Prefecture
Matsusaka, Mie	Cities in Japan, Settlements in Mie Prefecture
Primera División de Costa Rica	Sport in Costa Rica, Football leagues, 1921 establishments in North America, 20th-century establishments in Costa Rica
Nagakute, Aichi	Cities in Japan, Settlements in Aichi Prefecture
L.D. Alajuelense	Sport in Costa Rica, Football clubs, 1919 establishments in North America, 20th-century establishments in Costa Rica
Song Ikp'il	1534 births, 1599 deaths, Korean writers, Korean politicians, Korean philosophers
Ben Kingsley	1943 births, Living people, Actors from Yorkshire, BAFTA Award winning actors, Best Actor Academy Award winners, Commanders of the Order of the British Empire, English movie actors, English stage actors, English television actors, English voice actors, Golden Globe Award winning actors, Grammy Award winners, Knights Bachelor, People from North Yorkshire
Samantha Fox	Actors from London, English movie actors, I'm a Celebrity...Get Me Out of Here! contestants, LGBT actors, LGBT singers, Models from London, Singers from London, 1966 births, Living people, Lesbians
Night of the Hurricane	2011 in American television, Animated television series, Family Guy episodes, The Cleveland Show, American Dad!
Higashihiroshima, Hiroshima	Cities in Japan, Settlements in Hiroshima Prefecture
Bridge router	Computer networking
White Rock, British Columbia	Cities in British Columbia
Abd al-Rahman al-Sufi	903 births, 986 deaths, Astronomers, Persian people
Rajat Gupta	1948 births, Living people, Indian businesspeople
Mario Monti	1943 births, Living people, Italian Roman Catholics, Politicians from Lombardy, Prime Ministers of Italy, Yale University alumni
Saint-Lambert-sur-Dive	Communes in Orne
Aunou-le-Faucon	Communes in Orne
Oberlin University	Colleges and universities in Tokyo, 1921 establishments in Asia, 1920s establishments in Japan
Frederick Roberts, 1st Earl Roberts	1832 births, 1914 deaths, British Army generals, Knights Grand Cross of the Order of the Bath, Knights of the Garter, Knights of the Order of St John, Order of Merit, Order of the Indian Empire, People of the Boer Wars, Victoria Cross winners
Club de Foot Montréal	Canadian soccer teams, Sport in Montreal, Major League Soccer teams
Jean Frederick Oberlin	1740 births, 1826 deaths, People from Grand Est
List of Gainare Tottori players	Lists of Japanese football players
Tottori, Tottori	Cities in Japan, Settlements in Tottori Prefecture
Kannō	Japanese eras, 1350 establishments, 1350s establishments in Japan, 1352 disestablishments, 1350s disestablishments in Japan
Bunna	Japanese eras, 1352 establishments, 1350s establishments in Japan, 1356 disestablishments, 1350s disestablishments in Japan
Hurricane Floyd (1987)	Category 1 Atlantic hurricanes, 1987 Atlantic hurricane season, October events, 20th century in Cuba, 20th century in the Bahamas, 1980s in Florida, 1987 in the United States
Cleveland Brown	Fictional African-American people, Family Guy characters, Fictional characters introduced in 1999, The Cleveland Show
Caramel	Food ingredients
East Side Mario's	Canadian restaurants, 1987 establishments in Canada
Cartoon Network	Cartoon Network, 1992 establishments in the United States
Criminal Minds	2005 American television series debuts, 2000s American television series, 2010s American television series, American crime drama television series, CBS network shows, English-language television programs
Lake Wobegon	Fictional locations, Radio programs, Minnesota in fiction
La Fille mal gardée	Ballets
Treaty of Portsmouth	20th century treaties, 20th century in Russia, 20th century in Japan, 1905
August Bournonville	Choreographers, 1805 births, 1879 deaths, Danish people
Napoli (ballet)	Ballets
Royal Danish Ballet	Ballet companies
Marie Taglioni	Ballet dancers, Ballerinas, 1804 births, 1884 deaths, Swedish entertainers, Burials at Père Lachaise Cemetery, Disease-related deaths in France
Curiosity	Emotions, Creativity, Problem solving
Indoor Football League	Sports leagues, 2008 establishments in the United States, Sports organizations of the United States
Malay race	Race, Austronesian peoples
List of programming blocks	Television programs, Television lists
Chilean Communist Party (Proletarian Action)	Communist parties, Political parties in South America, Government of Chile, 1979 establishments, 20th-century establishments in Chile, 1970s establishments in South America
Subalpine zone	Ecozones
Bidsar	Villages in India, Settlements in Rajasthan
Meet Me in St. Louis	American musical movies, United States National Film Registry movies, 1944 movies, 1940s musical movies, Movies based on books, MGM movies, Movies directed by Vincente Minnelli
Love Finds Andy Hardy	1938 movies, American teen movies, Romantic comedy movies, United States National Film Registry movies, English-language movies, Movies directed by George B. Seitz
Topfreedom	Human rights, Nudity, Women
Dorland's Medical Dictionary	Dictionaries
Throat culture	Medical tests
List of Giravanz Kitakyushu players	Lists of Japanese football players
Tomakomai, Hokkaidō	Cities in Hokkaido
Saigawa, Fukuoka	Towns in Fukuoka Prefecture
Play with Me Sesame	Children's television series, 2002 television series debuts, 2007 television series endings, Sesame Street
Heguri, Nara	Towns in Japan, Settlements in Nara Prefecture
Casino	Entertainment venues, Gambling
Casino (movie)	1995 crime movies, 1995 drama movies, 1990s crime drama movies, American crime drama movies, American gangster movies, Antisocial personality disorder in fiction, English-language movies, Golden Globe Award winning movies, Movies based on books, Movies based on real life events, Movies directed by Martin Scorsese, Movies set in California, Movies set in Las Vegas, Movies set in the 1970s, Movies set in the 1980s, Universal Pictures movies
Cinderella (ballet)	Ballets, Compositions by Sergei Prokofiev
Judy Garland as gay icon	LGBT
Ugly Americans	Animated television series, American comedy television series, English-language television programs
60 Minutes	1968 television series debuts, 1960s American television series, 1970s American television series, 1980s American television series, 1990s American television series, 2000s American television series, 2010s American television series, CBS network shows, English-language television programs
The Cay (movie)	1974 movies, NBC network shows, Movies based on books
Carlo Bergonzi	1924 births, 2014 deaths, Italian singers, Musicians from Emilia-Romagna, Tenors
2006 Chicago Bears–Arizona Cardinals game	Arizona Cardinals, Chicago Bears, 2000s in Phoenix, 2000s in Chicago, 2006 in Illinois
List of Thespakusatsu Gunma players	Lists of Japanese football players
Hines Ward	1976 births, Living people, Pittsburgh Steelers players, African-American people, Sportspeople from Atlanta, Georgia, Participants in American reality television series
Peyton Place (1957 movie)	American drama movies, 1957 drama movies, Movies based on books, Women's movies, English-language movies, Movies directed by Mark Robson
A Summer Place (movie)	1959 drama movies, 1950s romantic drama movies, American teen movies, American romantic drama movies, Movies based on books, English-language movies, Movies directed by Delmer Daves
Mirin	Japanese food
David Oaks	Psychiatry, People from Eugene, Oregon, Harvard University alumni, American activists, Living people
MindFreedom International	1990 establishments in the United States, Psychiatry, Medical and health organizations in the United States, Human rights organizations in the United States, Eugene, Oregon
Toby Bourke	1965 births, Living people, Irish singers, Songwriters
Marbles (game)	Toys, Games
1950 Assam–Tibet earthquake	1950, 1950s in China, 1950s in India, Earthquakes in China, Earthquakes in Asia, August events
Joachim Gauck	1940 births, Living people, Christian ministers, Former members of the German Bundestag, German Lutherans, Members of the Volkskammer, People from Rostock, Politicians from Mecklenburg-Vorpommern, Presidents of Germany, Honorary Knights Grand Cross of the Order of the Bath
ZDF	1963 establishments in Europe, Television stations, German television networks, Mainz, 1960s establishments in Germany
Graham Greene	Alumni of the University of Oxford, British children's writers, Cancer deaths in Switzerland, Deaths from leukemia, English autobiographers, English journalists, English novelists, English playwrights, English Roman Catholics, English screenwriters, People with bipolar disorder, Writers from Hertfordshire, 1904 births, 1991 deaths
International Bear Brotherhood Flag	Bear (gay male), Flags
The Natural Bears Classification System	LGBT, Bear (gay male), Signalling
BEAR Magazine	Bear (gay male), LGBT in the United States, 1987 establishments in California
Antwaan Randle El	1979 births, Living people, American Christians, African-American people, American football wide receivers, Pittsburgh Steelers players, Washington Redskins players, Sportspeople from Illinois
Jay Cutler	American football quarterbacks, Chicago Bears players, Denver Broncos players, 1983 births, Living people, Sportspeople from Indiana
Celebrity Deathmatch	1998 American television series debuts, 2007 American television series endings, 1990s American television series, 2000s American television series, American comedy television series, Black comedy, English-language television programs
Mike Wallace (American football)	Living people, 1986 births, American football wide receivers, Sportspeople from New Orleans, Louisiana, Pittsburgh Steelers players
Leather Pride Flag	LGBT, Flags, 1989 establishments
International Mr. Leather	Competitions, LGBT, Events in the United States, 1979 establishments in the United States, 1970s establishments in Illinois
Seven trumpets	New Testament, Christian eschatology
There's Something About Mary	1998 romance movies, 1998 comedy movies, 1990s romantic comedy movies, 1990s sex comedy movies, 20th Century Fox movies, American romantic comedy movies, American sex comedy movies, English-language movies, Movies set in Miami, Florida, Rhode Island in fiction
Music from and Inspired by the Motion Picture 8 Mile	Rap music, 2002 albums
Seong Hon	1535 births, 1598 deaths, Korean educators, South Korean politicians, Autobiographers
Alveolar trill	Pronunciation
Bilabial trill	Pronunciation
Lon Chaney Sr.	American movie actors, American television actors, American stage actors, American radio actors, Silent movie actors, American movie directors, American screenwriters, Actors from Colorado, Deaths from lung cancer, Deaths from anemia, 1883 births, 1930 deaths, People from Colorado Springs, Colorado
Jo Gwang-jo	1482 births, 1519 deaths, Korean educators, South Korean politicians, Autobiographers
Twink	Gay slang
Kim Jong-jik	1431 births, 1492 deaths, Korean educators, South Korean politicians, Autobiographers
Kashihara, Nara	Cities in Nara Prefecture
Plutonism	Geology, History of science
List of JEF United Chiba players	Lists of Japanese football players
Jermaine Stewart	1957 births, 1997 deaths, African American musicians, American dancers, American R&B singers, American singer-songwriters, Deaths from AIDS, Infectious disease deaths in the United States, Musicians from Chicago, Singers from Ohio
Deborah Kerr	1921 births, 2007 deaths, Actors from Glasgow, Actresses who played Bond girls, Disease-related deaths in England, Golden Globe Award winning actors, Scottish movie actors, Scottish stage actors, Scottish television actors
Tea bag (sexual act)	Sexual acts
Troll (gay slang)	Gay slang, Pejoratives
Ichihara, Chiba	Cities in Chiba Prefecture
Lauren Holly	1963 births, Living people, American movie actors, Actors from Pennsylvania
List of counties in Arizona	Arizona-related lists, Lists of counties of the United States, Arizona counties
List of counties in Arkansas	Arkansas counties, Lists of counties of the United States, Arkansas-related lists
1600 Penn	American sitcoms, NBC network shows, English-language television programs
List of counties in California	California counties, Lists of counties of the United States, California-related lists
Brian Urlacher	Chicago Bears players, 1978 births, Living people, Sportspeople from Washington
List of boroughs and census areas in Alaska	Lists of counties of the United States, Alaska boroughs, Alaska-related lists
List of counties in Colorado	Colorado counties, Lists of counties of the United States
List of counties in Connecticut	Connecticut counties, Lists of counties of the United States
List of counties in Delaware	Delaware counties, Lists of counties of the United States, Delaware-related lists
'Round Springfield	The Simpsons (season 6) episodes, 1995 television episodes
List of counties in Hawaii	Hawaii-related lists, Lists of counties of the United States, Hawaii counties
List of counties in Vermont	Vermont counties, Lists of counties of the United States
Wounded Knee Massacre	South Dakota, Massacres, 1890s in the United States
Television producer	Television producers
Tok Pisin	Languages
Emmanuel Sanders	Living people, American football wide receivers, Pittsburgh Steelers players, 1987 births, Sportspeople from Texas, San Francisco 49ers players
Bean queen	Gay slang
Drag queen	Gay slang, Drag queens, Performing arts
French kiss	Human sexuality
RuPaul	1960 births, Living people, Actors from San Diego, California, Singers from San Diego, California, Writers from San Diego, California, African American actors, African-American singers, African American television personalities, African American writers, American television presenters, Drag queens, LGBT actors, LGBT African Americans, LGBT models, LGBT people from California, LGBT singers, LGBT songwriters, LGBT writers, Gay men, Models from San Diego, California, Musicians from San Diego, California, Singer-songwriters from California, Writers from California, American bloggers
I Hate My Teenage Daughter	2011 American television series debuts, American sitcoms, Fox television series, English-language television programs
Chi Chi LaRue	1959 births, Living people, American LGBT sex industry people, American movie directors, Drag queens, LGBT directors, People from Hibbing, Minnesota, Pornographic movie directors
John Epperson	1955 births, Living people, Actors from Mississippi, American LGBT people, American pianists, Drag queens, LGBT actors, LGBT singers, LGBT writers, Singers from Mississippi, Writers from Mississippi
José Sarria	1922 births, 2013 deaths, American military personnel of World War II, American political activists, Deaths from natural causes, Drag queens, Gay men, LGBT people from California, People from San Francisco
Kuch Toh Log Kahenge	Soap operas, 2011 Indian television series debuts
Natalie West	American movie actors, American television actors, Actors from North Dakota, Actors from Indiana, 1956 births, Living people, People from Grand Forks, North Dakota
Elisabeth Shue	American movie actors, American television actors, Actors from Wilmington, Delaware, Actors from New Jersey, 1963 births, Living people
Yi See-young	1868 births, 1953 deaths, Anti-Communists, People of the Korean War, Vice Presidents of South Korea
Alveolar approximant	Pronunciation
Mena Suvari	1979 births, Actors from Rhode Island, American child actors, American movie actors, American television actors, Living people
Jo Sik	Korean people, Confucianism, 1501 births, 1572 deaths
Crown group	Cladistics
Vampire Lesbians of Sodom	Plays
Digital audio player	Audio technology
Daniel Levy	1962 births, People from Essex, English football managers, British businesspeople, Living people
Municipalities in Japan	Settlements in Japan, Municipalities
Sodom and Gomorrah	Cities in Asia, Old Testament
Tradeston Bridge	Tradeston Bridge, Glasgow, Bridges in the United Kingdom, Buildings and structures in Glasgow, Steel bridges
Windsor Railway Bridge	Bridges in the United Kingdom, Berkshire, Steel bridges, Concrete bridges, Grade II* listed buildings
Saint Sebastian	Christian saints, LGBT, 260s deaths
Menace II Society	1993 crime movies, 1993 drama movies, 1990s crime drama movies, American crime drama movies, American gangster movies, English-language movies, Movies about drugs, Movies set in Los Angeles, California, Warner Bros. movies
Aurelius and Natalia	Christian saints, 852 deaths, Year of birth unknown, People executed by decapitation
Charlotte Corday	Assassins, Executed French people, French criminals, People executed by decapitation, 1768 births, 1793 deaths, People of the French Revolution
Robert Devereux, 2nd Earl of Essex	1565 births, 1601 deaths, English Earls, Knights of the Garter, People executed by decapitation, Earls and countesses, Executed English people
The Private Lives of Elizabeth and Essex	1939 movies, Historical movies, Romance movies, Movies based on plays, English-language movies, Movies directed by Michael Curtiz
Batman Bridge	Bridges in Australia, Buildings and structures in Tasmania, Steel bridges, 1968 establishments in Australia
Tacoma Narrows Bridge (1940)	1940 establishments in the United States, 1940 disestablishments, 1940s disestablishments in the United States, Bridges in the United States, Buildings and structures in Washington, Concrete bridges, National Register of Historic Places, Steel bridges, Tacoma, Washington, Transport in Washington, Suspension bridges, 20th-century establishments in Washington (state), 20th-century disestablishments in Washington (state)
West Gate Bridge	Bridges in Australia, Buildings and structures in Melbourne, Steel bridges, 1978 establishments in Australia
The Blair Witch Project	1999 horror movies, 1990s supernatural movies, American horror movies, American supernatural movies, English-language movies, Found footage movies, Movies set in Maryland, Supernatural horror movies, Witches, American independent movies
The Helix Bridge	Buildings and structures in Singapore, Steel bridges, 2010 establishments in Asia, 2010s establishments in Singapore
Ross Bridge	Bridges in Australia, Stone bridges, Buildings and structures in Tasmania, 1836 establishments, 1830s establishments in Australia
Spean Praptos	Archaeological sites in Asia, Stone bridges, Buildings and structures in Asia, 12th-century establishments in Asia, Establishments in Cambodia
Carly Rae Jepsen	1985 births, Living people, Canadian pop singers, Canadian singer-songwriters, Musicians from British Columbia, Reality television participants
Richmond Bridge (Tasmania)	Bridges in Australia, Buildings and structures in Tasmania, Stone bridges, 1825 establishments, 1820s establishments in Australia
Red Bridge (Tasmania)	Bridges in Australia, Stone bridges, Buildings and structures in Tasmania, 1838 establishments, 1830s establishments in Australia
Cable-stayed bridge	Bridge types
Ford Center	Sports buildings in the United States, 2002 establishments in the United States, 2000s establishments in Oklahoma, 2010 disestablishments in the United States
Pontoon bridge	Bridge types
Cantilever bridge	Cantilever bridges
Dallas Clark	American football tight ends, Indianapolis Colts players, 1979 births, Living people, People from Sioux Falls, South Dakota, Sportspeople from South Dakota
Marion Barber III	1983 births, Living people, American football running backs, Dallas Cowboys players, Chicago Bears players, Sportspeople from Minnesota
The Sixth Sense	1999 drama movies, 1999 horror movies, 1999 thriller movies, 1990s drama thriller movies, 1990s horror thriller movies, 1999 mystery movies, 1990s ghost movies, 1990s psychological movies, 1990s supernatural movies, American drama thriller movies, American ghost movies, American mystery movies, American psychological movies, English-language movies, Movies composed by James Newton Howard, Movies directed by M. Night Shyamalan, Movies set in Philadelphia, Pennsylvania, Murder-suicide in movies, Screenplays by M. Night Shyamalan, Supernatural horror movies
Orc	Fictional races, Middle-earth
Hideo Shinojima	1910 births, 1975 deaths, Footballers from Tochigi Prefecture, Japan international footballers
Azimuntium	Ancient Greece, Towns in Greece
Districts of Japan	Districts of Japan
Tokizo Ichihashi	1909 births, Year of death missing, Footballers from Hyōgo Prefecture, Japan international footballers
Saizo Saito	1908 births, 2004 deaths, Footballers from Osaka Prefecture, Japan international footballers
Masao Nozawa	Year of birth missing, Year of death missing, Footballers from Hiroshima Prefecture, Japan international footballers
Hiroshi Kanazawa	Year of birth missing, Year of death missing, Japanese footballers, Japan international footballers
Yukio Goto	Year of birth missing, 1976 deaths, Footballers from Hyōgo Prefecture, Japan international footballers
Akira Nozawa	Year of birth missing, Year of death missing, Footballers from Hiroshima Prefecture, Japan international footballers
Teiichi Matsumaru	1909 births, 1997 deaths, Footballers from Tokyo Prefecture, Japan international footballers
Convex function	Functions and mappings
Koichi Oita	1914 births, 1996 deaths, Footballers from Tokyo Prefecture, Japan international footballers, Footballers at the 1936 Summer Olympics
Weighted average	Mathematics
Epigraph (mathematics)	Mathematics
Kunitaka Sueoka	1917 births, 1998 deaths, Footballers from Hiroshima Prefecture, Japan international footballers
Kim Sung-gan	1912 births, 1984 deaths, People from Pyongyang, Japanese footballers, South Korean footballers, Japan international footballers
Taro Kagawa	1922 births, 1990 deaths, Footballers from Hyōgo Prefecture, Japan international footballers, Tanabe Mitsubishi Pharma SC players
David Coverdale	1951 births, Living people, American rock singers, English rock musicians, English singers, Musicians from Yorkshire, Naturalized citizens of the United States
Takashi Mizuno	1931 births, Living people, Japanese footballers, Japan international footballers
Super Bowl XL	Super Bowl, 2006 in sports, Pittsburgh Steelers, 2006 in the United States, 2000s in Detroit, Michigan
Gulf of Honduras	Gulfs, Atlantic Ocean, Geography of Central America, Geography of Belize, Geography of Guatemala
Swan Islands, Honduras	Atlantic islands, Islands of Central America, Honduras
Roman Catholic Archdiocese of Concepción	1563 establishments, Roman Catholicism, Concepción, 1560s establishments in South America, 16th-century establishments in Chile
Matthew Hopkins	People from Suffolk, 1647 deaths, 1620s births
Inflow (meteorology)	Meteorology
Hurricane Bob (1985)	1985 in the United States, Category 1 Atlantic hurricanes
List of Shonan Bellmare players	Lists of Japanese football players
Cudjoe Key, Florida	Islands of Florida, Census-designated places in Florida
Whenever, Wherever	2001 songs, Shakira songs
Laundry Service	Shakira, 2001 albums
Tay Bridge	Bridges in the United Kingdom, Buildings and structures in Scotland, Steel bridges, 1878 establishments in Scotland, 1879 disestablishments, 1870s disestablishments in the United Kingdom, 1887 establishments, 1880s establishments in Scotland
Jeff Saturday	1975 births, Living people, Sportspeople from Atlanta, Georgia, Baltimore Ravens players, Indianapolis Colts players, Green Bay Packers players
Underneath Your Clothes	2002 songs, Shakira songs
Salle Le Peletier	Opera houses in France, Theatres in France, Buildings and structures in Paris
Darmstadt University of Technology	Darmstadt, Education in Hesse, Technical colleges and universities in Germany, 1877 establishments in Europe, 1870s establishments in Germany
Carlotta Grisi	1819 births, 1899 deaths, Ballet dancers, Italian people
Brian Dawkins	1973 births, Living people, American football safeties, Sportspeople from Florida, Denver Broncos players, Philadelphia Eagles players
Romantic ballet	Ballets
Bolte Bridge	Bridges in Australia, Cantilever bridges, Buildings and structures in Melbourne, 1999 establishments in Australia
Norm (mathematics)	Mathematics
1991 Bangladesh cyclone	Deadly storms, 20th century in Bangladesh, Cyclonic storms, 1991 in Asia
Akashi Kaikyō Bridge	Buildings and structures in Japan, Steel bridges, Suspension bridges, 1998 establishments in Japan
Chittagong	Cities in Bangladesh, Chittagong Division, 1340 establishments, Establishments in Bangladesh, 14th century establishments in Asia
Gamekeeper	Agricultural occupations
Seishiro Shimatani	1938 births, 2001 deaths, Footballers from Kyoto Prefecture, Japan international footballers, Japan Soccer League players, JEF United Chiba players, Kyoto Sanga FC players
Tatsuya Shiji	1938 births, Living people, Footballers from Aichi Prefecture, Japan international footballers, Japan Soccer League players, Nagoya Grampus players
List of counties in Georgia (U.S. state)	Lists of counties of the United States, Georgia (U.S. state) counties
Saburo Kawabuchi	1936 births, Living people, Footballers from Osaka Prefecture, Japan international footballers, Japanese football managers, Japan Soccer League players, JEF United Chiba players, Japan national football team managers, Footballers at the 1964 Summer Olympics
List of counties in Idaho	Idaho counties, Idaho-related lists, Lists of counties of the United States
List of counties in Illinois	Illinois counties, Lists of counties of the United States
List of counties in Indiana	Indiana counties, Lists of counties of the United States
List of counties in Iowa	Iowa counties, Lists of counties of the United States
List of counties in Kansas	Kansas counties, Lists of counties of the United States, Kansas-related lists
List of counties in Kentucky	Kentucky counties, Lists of counties of the United States
Maribyrnong River Viaduct	Bridges in Australia, Buildings and structures in Melbourne, Rail transport in Australia, 1929 establishments, 1920s establishments in Australia
List of parishes in Louisiana	Louisiana parishes, Lists of counties of the United States
List of counties in Maine	Maine counties, Lists of counties of the United States
List of counties in Maryland	Maryland counties, Lists of counties of the United States
Bridge of Sighs	Bridges, Stone bridges
List of counties in Massachusetts	Massachusetts counties, Lists of counties of the United States
Jeff Hornacek	1963 births, Living people, American basketball players, Sportspeople from Illinois, Philadelphia 76ers players, Phoenix Suns players, Utah Jazz players, National Basketball Association players with retired numbers
Cyclone Gonu	Tropical cyclones in Asia, Cyclonic storms, 2007 in weather, 2007 in Asia, Oman, 21st century in Iran
Sargent and Greenleaf	Companies of the United States, Locks
Marashiyan	Mazandaran, Arab world, Royal dynasties
Jonathan Nolan	Christopher Nolan, Screenwriters from Illinois, British screenwriters, Writers from Chicago, Writers from London, Living people
Afrikaner nationalism	Politics of South Africa, Nationalism, Political movements, 19th century in South Africa
List of counties in Michigan	Lists of counties of the United States, Michigan counties
Numerical analysis	Mathematics, Technology, Computer science
List of counties in Texas	Lists of counties of the United States, Texas counties
Barbara Windsor	1937 births, 2020 deaths, Actors from London, English voice actors, English movie actors, English stage actors, English television actors, Deaths from Alzheimer's disease
List of counties in Virginia	Lists of counties of the United States, Virginia counties
Ryōgoku Bridge	Buildings and structures in Tokyo, Wooden bridges, Bridges in Japan
List of counties in Missouri	Lists of counties of the United States, Missouri counties
List of counties in Tennessee	Lists of counties of the United States, Tennessee counties
List of counties in Nebraska	Lists of counties of the United States, Nebraska counties
Boyzone	1990s establishments in the Republic of Ireland, 1990s Irish music groups, 2000s Irish music groups, 2010s Irish music groups, Boy bands, Irish pop music groups, Musical groups established in 1993, Musical groups from Dublin, Musical quartets, Musical quintets, 1993 establishments in Europe, Musical groups disestablished in 2000, 2000 disestablishments in Europe, Musical groups established in 2007, 2007 establishments in Europe, 2000s establishments in the Republic of Ireland
List of counties in Ohio	Lists of counties of the United States, Ohio counties
List of counties in Minnesota	Lists of counties of the United States, Minnesota counties
List of counties in Pennsylvania	Pennsylvania counties, Lists of counties of the United States
Dorothy Gish	1898 births, 1968 deaths, American child actors, American movie actors, American silent movie actors, Deaths from pneumonia, Disease-related deaths in Italy, Episcopalians, Actors from Dayton, Ohio
Nihonbashi	Tokyo, Japanese culture, Stone bridges, Bridges in Japan
List of counties in South Dakota	Lists of counties of the United States, South Dakota counties
List of counties in New York	New York (state) counties, Lists of counties of the United States, New York-related lists
List of counties in Montana	Lists of counties of the United States, Montana counties
List of counties in West Virginia	Lists of counties of the United States, West Virginia counties
List of counties in North Dakota	Lists of counties of the United States, North Dakota counties
List of counties in South Carolina	Lists of counties of the United States, South Carolina counties
List of counties in Washington	Lists of counties of the United States, Washington (state) counties
Sanjō Ōhashi Bridge	Bridges in Japan, Concrete bridges
Interpolation	Mathematical approximation, Graphics
Gay icon	Popular culture, LGBT
Afternoon of a Faun (Nijinsky)	Ballets Russes productions, Ballets starring Nijinsky, Ballets choreographed by Nijinsky
Kintai Bridge	Bridges in Japan, Wooden bridges, Japanese culture
Civil religion	Religion, Politics
List of counties in Oregon	Lists of counties of the United States, Oregon counties
List of counties in New Mexico	Lists of counties of the United States, New Mexico counties
Victoria Falls Bridge	Steel bridges, Zimbabwe, Zambia, Transport in Africa, 1905 establishments, 1900s establishments in Africa, Establishments in Zambia
List of counties in Utah	Lists of counties of the United States, Utah counties
The Mysteries of Alfred Hedgehog	2010 television series debuts, 2010 television series endings, Children's television series, Animated television series, French television series, Canadian animated television series, 2010 establishments in North America, 2010s establishments in Canada, 2010 establishments in Europe, 2010s establishments in France, 2010 disestablishments in North America, 2010s disestablishments in Canada, 2010 disestablishments in Europe
List of counties in Wyoming	Lists of counties of the United States, Wyoming counties
List of counties in New Jersey	New Jersey counties, Lists of counties of the United States
List of counties in Nevada	Lists of counties of the United States, Nevada counties
Ragheb Harb	1952 births, 1984 deaths, Assassinated people, Lebanese Muslims, Lebanese nationalists, Lebanese terrorists, Muslim terrorists
List of counties in New Hampshire	New Hampshire counties, Lists of counties of the United States
List of counties in Rhode Island	Lists of counties of the United States, Rhode Island counties
Chillin	2009 songs, Lady Gaga songs
Universidade Federal de Minas Gerais	Colleges and universities in Brazil, Belo Horizonte, 1927 establishments in South America, 1920s establishments in Brazil
Centro Federal de Educação Tecnológica de Minas Gerais	Colleges and universities in Brazil, Minas Gerais, 1909 establishments in Brazil
Universidade Estadual de Feira de Santana	Colleges and universities in Brazil, Bahia, 1976 establishments in Brazil
Universidade Federal da Bahia	Colleges and universities in Brazil, Bahia, 1946 establishments, 1940s establishments in Brazil
Théâtre du Châtelet	Opera houses in France, Theatres in France, Buildings and structures in Paris
Bailey bridge	Bridge types
Serial Mom	1994 movies, American comedy movies, English-language movies, American independent movies
Oresund Bridge	2000 establishments in Sweden, Buildings and structures in Denmark, Concrete bridges, Copenhagen, Malmo, Transport in Sweden
John Waters	1946 births, Living people, Actors from Baltimore, Maryland, American cinematographers, American LGBT people, American movie actors, American movie editors, American stand-up comedians, American television actors, American television writers, American voice actors, Comedians from Maryland, Gay men, LGBT actors, LGBT comedians, LGBT directors, LGBT producers, LGBT writers, Movie directors from Maryland, Movie producers from Maryland, Screenwriters from Maryland, Writers from Baltimore, Maryland
Morell Bridge	Bridges in Australia, Concrete bridges, Buildings and structures in Melbourne, 1899 establishments, 1890s establishments in Australia
Verrazano-Narrows Bridge	Bridges in New York, Steel bridges, Staten Island, Brooklyn, Suspension bridges, 1964 establishments in New York (state), 1969 establishments in the United States, 1960s establishments in New York (state)
Great Belt Fixed Link	1998 establishments in Europe, Buildings and structures in Denmark, Concrete bridges, Steel bridges, Suspension bridges
Bleeding	Blood
Toshiya Fujita	1971 births, Living people, Footballers from Shizuoka Prefecture, Japan international footballers, J1 League players, J2 League players, Júbilo Iwata players, Nagoya Grampus players, Roasso Kumamoto players, JEF United Chiba players, 2001 FIFA Confederations Cup players
Rumpelstiltskin	Grimms' Fairy Tales
Edward Thorndike	1874 births, 1949 deaths, American psychologists, Harvard University alumni, Columbia University alumni, American atheists, Scientists from Massachusetts, Ethologists
Nasty Party	Slang, Conservatism, Conservative Party (UK)
Argentan	Communes in Orne, Subprefectures in France
Special wards of Tokyo	Wards of Tokyo, Settlements in Tokyo Prefecture, Japan-related lists
Guru Har Krishan	Deaths from smallpox, Religious leaders, Sikhism, Punjabi people, Spiritual teachers
Adachi, Tokyo	Wards of Tokyo, Settlements in Tokyo Prefecture
Academy Award for Best Actress	Academy Award categories
Tallit	Judaism, Religious clothing
Paul-Louis Arslanian	Living people, Alumni of the École nationale de l'aviation civile, French aviators, Year of birth missing (living people), Alumni of the École Polytechnique
Gérard Mestrallet	French businesspeople, 1949 births, Alumni of the École nationale de l'aviation civile, Living people, Chief executives, Alumni of the École Polytechnique
Easington Community Science College	Colleges and universities in England
Pas de Quatre	Ballets choreographed by Jules Perrot
Victorian Heritage Register	Victoria, Australia, History of Australia
Don Ho	1930 births, 2007 deaths, Actors from Hawaii, American movie actors, American television actors, Singers from Hawaii, Musicians from Hawaii, American military people, People from Honolulu
Anaïs Mitchell	1981 births, Living people, American composers, American singer-songwriters, American guitarists, Singers from Vermont, Musicians from Vermont, American folk musicians, People from Montpelier, Vermont
Shrikant Jichkar	1954 births, 2004 deaths, Indian politicians, Road accident deaths
Color of Night	1994 crime movies, 1994 thriller movies, 1990s crime thriller movies, 1990s erotic movies, 1994 LGBT movies, 1994 mystery movies, American crime thriller movies, American erotic movies, American LGBT movies, American mystery movies, English-language movies, Mental disorders in fiction, Movies set in Los Angeles, California, Movies set in New York City, American independent movies
Muriel's Wedding	1994 drama movies, 1994 romance movies, 1994 comedy-drama movies, 1990s romantic comedy movies, 1990s romantic drama movies, Australian comedy movies, Australian drama movies, Australian romance movies, English-language movies, Movies about weddings, Movies set in Australia, New South Wales
Pony	Horses, Animals used for transport
Lloyd Sherr	American voice actors, 1959 births, Living people
T helper cell	blood cells
Jezebel (1938 movie)	1938 movies, 1930s drama movies, American drama movies, English-language movies, Movies set in Louisiana, United States National Film Registry movies, Women's movies, Movies directed by William Wyler
Alveolo-palatal consonant	Pronunciation
Michel Bernard	1943 births, Living people, Alumni of the École nationale de l'aviation civile, Alumni of the École Polytechnique, French aviators, People from Centre-Val de Loire
Bilabial nasal	Pronunciation
John Thaw	1942 births, 2002 deaths, Actors from Manchester, BAFTA Award winners, Cancer deaths in England, Deaths from esophageal cancer, Disease-related deaths in Wiltshire, English movie actors, English stage actors, English television actors, English television producers
Dirk Bogarde	Actors from London, BAFTA Award winning actors, British autobiographers, Cardiovascular disease deaths in England, Deaths from myocardial infarction, English LGBT people, English movie actors, English novelists, English stage actors, Gay men, LGBT actors, LGBT writers, Writers from London, 1921 births, 1999 deaths
Autauga County, Alabama	Alabama counties, 1818 establishments in Alabama Territory
Samuel L. Jackson	Actors from Tennessee, Actors from Washington, D.C., African American actors, American movie actors, American movie producers, American political activists, American television actors, American television producers, American voice actors, BAFTA Award winners, People from Chattanooga, Tennessee, 1948 births, Living people
Clayton, Alabama	Towns in Alabama, County seats in Alabama
Bibb County, Alabama	Alabama counties, 1818 establishments in Alabama Territory
Mubariz Ibrahimov	1988 births, 2010 deaths, Azerbaijani military people, National Hero of Azerbaijan, Murders by firearm, Burials at Alley of Honor
Mehdi Huseynzade	Azerbaijani military people, 1918 births, 1944 deaths, Recipients of the Order of Lenin
Ahmadiyya Jabrayilov	Azerbaijani military people, 1920 births, 1994 deaths
Leyla Mammadbeyova	1909 births, 1989 deaths, Aviators, Azerbaijani military people, People from Baku
Centreville, Alabama	Cities in Alabama, County seats in Alabama
Tofik Bahramov	1925 births, 1993 deaths, Azerbaijani footballers, Soviet sportspeople, Referees
Blount County, Alabama	Alabama counties, 1818 establishments in Alabama Territory
Uzeyir Hajibeyov	1885 births, 1948 deaths, Composers, Soviet people, Azerbaijani musicians, Translators, Burials at Alley of Honor
Jeux	Ballets Russes productions, Ballets starring Nijinsky, Ballets choreographed by Nijinsky
Mining (military)	War, Engineering
Spotify	Music software
Bullock County, Alabama	Alabama counties, 1866 establishments in Alabama
Jeff Conine	Living people, 1966 births, Florida Marlins players, Kansas City Royals players, Baltimore Orioles players, National League All-Stars, People from Tacoma, Washington
Butler County, Alabama	Alabama counties, 1819 establishments in Alabama
KCPQ	American television stations, Tacoma, Washington, 1953 establishments in the United States, 20th-century establishments in Washington (state)
Chambers County, Alabama	Alabama counties, 1832 establishments in Alabama
Arakawa, Tokyo	Wards of Tokyo, Settlements in Tokyo Prefecture
Bunkyō, Tokyo	Wards of Tokyo, Settlements in Tokyo Prefecture, 1947 establishments in Japan
Mary Elizabeth Winstead	Actors from North Carolina, Actors from Utah, American movie actors, American television actors, 1984 births, Living people, American Baptists, People from Rocky Mount, North Carolina
Provinces of Bolivia	Bolivia, Provinces
Provinces of Burkina Faso	Provinces of Burkina Faso
Communes of Burundi	Burundi
Maggie Q	Actors from Honolulu, American movie actors, American television actors, American models, 1979 births, Living people
Provinces of Costa Rica	Provinces of Costa Rica
List of Kataller Toyama players	Lists of Japanese football players
Gutterballs	2008 comedy movies, 2008 horror movies, 2000s LGBT movies, Canadian horror movies, Comedy horror movies, English-language movies
Saw (movie)	2004 horror movies, 2000s crime movies, 2000s psychological movies, 2000s thriller movies, American horror movies, American psychological movies, American thriller movies, English-language movies, Saw movies, American independent movies, Lionsgate movies
Émile Allegret	1907 births, 1990 deaths, Alumni of the École nationale de l'aviation civile, French aviators, French military people, French people of World War II, People from Dijon
Naoki Yamada	1990 births, Living people, Footballers from Saitama Prefecture, Japan international footballers, J1 League players, J2 League players, Urawa Red Diamonds players, Shonan Bellmare players
Kosuke Ota	1987 births, Living people, Footballers from Tokyo Prefecture, Japan international footballers, J1 League players, J2 League players, J3 League players, Yokohama FC players, Shimizu S-Pulse players, FC Tokyo players, FC Tokyo U-23 players, Nagoya Grampus players
Kazuya Yamamura	1989 births, Living people, Footballers from Nagasaki Prefecture, Japan international footballers, J1 League players, J2 League players, Kashima Antlers players, Cerezo Osaka players, Kawasaki Frontale players, Footballers at the 2012 Summer Olympics
Takuji Yonemoto	1990 births, Living people, Footballers from Hyōgo Prefecture, Japan international footballers, J1 League players, J2 League players, J3 League players, FC Tokyo players, FC Tokyo U-23 players, Nagoya Grampus players
Kensuke Nagai	1989 births, Living people, Footballers from Hiroshima Prefecture, Japan international footballers, J1 League players, J2 League players, Avispa Fukuoka players, Vissel Kobe players, Nagoya Grampus players, FC Tokyo players, Footballers at the 2012 Summer Olympics
Junichi Inamoto	1979 births, Living people, Footballers from Osaka Prefecture, Japan international footballers, J1 League players, J2 League players, J3 League players, Gamba Osaka players, Kawasaki Frontale players, Hokkaido Consadole Sapporo players, SC Sagamihara players, 2002 FIFA World Cup players, 2006 FIFA World Cup players, 2010 FIFA World Cup players, 2001 FIFA Confederations Cup players, 2003 FIFA Confederations Cup players, 2005 FIFA Confederations Cup players, Footballers at the 2000 Summer Olympics, 2000 AFC Asian Cup players, AFC Asian Cup-winning players
Nightmare disorder	Sleep disorders
Hiroshi Kiyotake	1989 births, Living people, Footballers from Oita Prefecture, Japan international footballers, J1 League players, Oita Trinita players, Cerezo Osaka players, 2014 FIFA World Cup players, 2013 FIFA Confederations Cup players, Footballers at the 2012 Summer Olympics
Junya Tanaka (footballer, born 1987)	1987 births, Living people, Footballers from Tokyo Prefecture, Japan international footballers, J1 League players, J2 League players, Kashiwa Reysol players, Vissel Kobe players
Franche-Comté	Former administrative regions of France, Bourgogne-Franche-Comté
Yuto Nagatomo	1986 births, Living people, Footballers from Ehime Prefecture, Japan international footballers, J1 League players, FC Tokyo players, 2010 FIFA World Cup players, 2014 FIFA World Cup players, 2018 FIFA World Cup players, 2013 FIFA Confederations Cup players, Footballers at the 2008 Summer Olympics
Takashi Inui	1988 births, Living people, Footballers from Shiga Prefecture, Japan international footballers, J1 League players, J2 League players, Yokohama F. Marinos players, Cerezo Osaka players, 2018 FIFA World Cup players, 2013 FIFA Confederations Cup players
The Substitute (Glee)	Glee, 2010 television episodes
S Club 8	2001 establishments in England, 2000s British music groups, 2005 disestablishments in England, British pop music groups, Musical groups established in 2001, Musical groups disestablished in 2005, Musical groups from London
Ian Brennan	1978 births, Living people, Writers from Illinois, American movie actors, American musical theatre actors, American television actors, Actors from Illinois, American television writers, American television producers
David Fincher	American movie actors, American movie directors, American movie producers, BAFTA Award winners, Golden Globe Award winning directors, Grammy Award winners, People from California, People from Denver, Colorado, People from Ashland, Oregon, 1962 births, Living people
Sisyphus	People in Greek mythology
Dangerous Minds	1995 movies, American teen drama movies, English-language movies, Movies set in California, Spanish-language movies, Multilingual movies
Cherokee County, Alabama	Alabama counties, 1836 establishments in the United States, 1830s establishments in Alabama
John Mills	1908 births, 2005 deaths, Academy Award winning actors, Actors from Norfolk, English autobiographers, English movie actors, English movie directors, English movie producers, English stage actors, English television actors
Seven islands of Bombay	Mumbai
Ganbaru	Japanese culture
Ryan Murphy	American television writers, American television directors, American television producers, Gay men, LGBT directors, LGBT producers, LGBT people from Indiana, LGBT screenwriters, Movie directors from Indiana, Movie producers from Indiana, Writers from Indianapolis, Indiana, 1965 births, Living people
Matthew Morrison	American television actors, 1978 births, Living people, American movie actors, American musical theatre actors, Actors from Monterey County, California
Amber Riley	1986 births, American television actors, Living people, Democrats (United States), Actors from Los Angeles, California, Singers from Los Angeles, California
Adhesion	Physics
Time Inc.	1922 establishments in the United States, 1920s establishments in New York (state), Companies based in New York City, Magazines published in New York City, Time Warner
List of awards and nominations received by Up	Lists of awards and nominations
Centre, Alabama	Cities in Alabama, County seats in Alabama
Cincinnati Zoo and Botanical Garden	Zoos in the United States, Cincinnati, Ohio, Botanical gardens in the United States
Provinces of Ethiopia	Ethiopia, Provinces
Provinces of Greece	Subdivisions of Greece, 1887 disestablishments
Prefectures of Greece	Prefectures of Greece
Provinces of Italy	Provinces of Italy, Italy-related lists
Eggshell	Tetrapods
Pacheco, California	Census-designated places in California, 1857 establishments in California, Settlements in Contra Costa County, California
June 2011 Christchurch earthquake	2010s in New Zealand, Earthquakes in New Zealand, 2011 earthquakes, June events
Bombyliidae	Flies
Gérard Feldzer	1944 births, Living people, Alumni of the École nationale de l'aviation civile, French engineers, French aviators
Phototropism	Plant physiology
Proboscis	Animal anatomy
Tuckman's stages of group development	Psychology
Clerks	1994 comedy movies, American comedy movies, English-language movies, Movies set in New Jersey, Miramax movies, American independent movies
Utagawa Kuniyoshi	Japanese printmakers, 1798 births, 1861 deaths
The Weinstein Company	Movie studios, 2002 establishments in the United States
Dimension Films	Movie studios
Chilton County, Alabama	Alabama counties, 1868 establishments in the United States, 1860s establishments in Alabama
Clanton, Alabama	Cities in Alabama, County seats in Alabama
Port	Ports and harbours
Choctaw County, Alabama	Alabama counties, 1847 establishments in the United States, 1840s establishments in Alabama
Clarke County, Alabama	Alabama counties, 1812 establishments in the United States, 1810s establishments in Alabama
Grove Hill, Alabama	Towns in Alabama, County seats in Alabama
Lisette Melendez	singers from New York City, Pop musicians, 1967 births, Living people
Sydney Pollack	1934 births, 2008 deaths, Academy Award winning directors, Actors from South Bend, Indiana, American movie actors, American television actors, American television directors, American television producers, American voice actors, Cancer deaths in Los Angeles, Deaths from cancer of unknown primary origin, Emmy Award winning directors, Jewish American actors, Movie directors from Indiana, Movie producers from Indiana
Cleburne County, Alabama	Alabama counties, 1866 establishments in Alabama
Colbert County, Alabama	Alabama counties, 1867 establishments in the United States, 1860s establishments in Alabama
Conecuh County, Alabama	Alabama counties, 1818 establishments in Alabama Territory
Zooey Deschanel	Actors from Los Angeles, California, American movie actors, Singer-songwriters from California, American television actors, American voice actors, Musicians from Los Angeles, California, Singers from Los Angeles, California, 1980 births, Living people
Coosa County, Alabama	Alabama counties, 1832 establishments in Alabama
Rockford, Alabama	Towns in Alabama, County seats in Alabama, 1832 establishments in Alabama
Covington County, Alabama	Alabama counties, 1821 establishments in the United States, 1820s establishments in Alabama
Crenshaw County, Alabama	Alabama counties, 1866 establishments in Alabama
Pastygate	2012 in the United Kingdom, Political scandals
Eastern black-and-white colobus	Mammals of Africa, Old World monkeys
Cullman County, Alabama	Alabama counties, 1877 establishments in the United States, 1870s establishments in Alabama
Dolores	Given names
Cullman, Alabama	Cities in Alabama, County seats in Alabama, 1878 establishments in the United States, 1870s establishments in Alabama
Freeway (movie)	1996 movies, American crime movies, English-language movies, American independent movies
Dale County, Alabama	Alabama counties, 1824 establishments in the United States, 1820s establishments in Alabama
Dallas County, Alabama	Alabama counties, 1818 establishments in Alabama Territory
DeKalb County, Alabama	Alabama counties, 1836 establishments in the United States, 1830s establishments in Alabama
Elmore County, Alabama	Alabama counties, 1866 establishments in Alabama
Escambia County, Alabama	Alabama counties, 1868 establishments in the United States, 1860s establishments in Alabama
20th Television	American television networks, 1949 establishments in the United States, News Corporation, 21st Century Fox, Disney
Grey's crowned guenon	Mammals of Africa, Old World monkeys
Axiom of choice	Set theory
Chang Taek-sang	1893 births, 1969 deaths, People of the Korean War, Prime Ministers of South Korea
Bound	1996 crime movies, 1996 romance movies, 1990s crime thriller movies, 1990s erotic movies, 1990s LGBT movies, American crime thriller movies, American erotic movies, American LGBT movies, American romance movies, English-language movies, Film noir, LGBT crime movies, LGBT erotic movies, LGBT romance movies, LGBT thriller movies, Movies about murderers, American independent movies
Gina Gershon	American movie actors, American television actors, Actors from Los Angeles, California, singers from Los Angeles, California, 1962 births, Living people
Kwon Sang-ha	1641 births, 1721 deaths, Korean educators, South Korean politicians, Autobiographers, Korean writers
Powys Castle	Castles in Wales, National Trust properties
Islam in China	Religion in China, Islam by country
Campbell Newman	1963 births, Living people, Liberal Party of Australia politicians, Mayors, Politicians from Brisbane, People from Canberra, Premiers of Queensland
New Red Sandstone	Sandstones
Glee (season 2)	Glee, American television seasons, 2010 television seasons, 2011 television seasons
Chris Colfer	1990 births, Actors from Fresno County, California, LGBT people from California, American movie actors, American television actors, American voice actors, Countertenors, Gay men, Golden Globe Award winning actors, LGBT actors, Living people, Singers from California
Mash-up	Songs
Subplot	Fiction
National Alliance on Mental Illness	1979 establishments in the United States, Non-profit organizations of the United States, Medical and health organizations in the United States
Chūō, Tokyo	Wards of Tokyo, Settlements in Tokyo Prefecture, 1947 establishments in Japan
Edogawa, Tokyo	Wards of Tokyo, Settlements in Tokyo Prefecture
Jackie Brown	1997 crime movies, 1997 drama movies, 1990s crime drama movies, American crime drama movies, English-language movies, Film noir, Heist movies, Movies directed by Quentin Tarantino, Movies set in Los Angeles, California, American independent movies
100 Landscapes of Japan (Heisei period)	Japanese culture
Pieter de Grebber	1600s births, 1650s deaths, Dutch painters
Archipelago of San Andrés, Providencia and Santa Catalina	Departments of Colombia
100 Landscapes of Japan (Shōwa period)	Japanese culture
Amélie Mauresmo	1979 births, Australian Open champions, Coaches, Female tennis players, French LGBT people, French tennis players, Lesbians, Living people, LGBT sportspeople, Medalists at the 2004 Summer Olympics, Olympic silver medalists, People from Ile-de-France, Wimbledon champions, World No. 1 tennis players
Erin Brockovich	1960 births, Living people, American environmentalists, American television presenters, American lawyers, Writers from Kansas, People from Lawrence, Kansas
Indirect speech	Grammar
Erin Brockovich (movie)	2000 drama movies, 2000s biographical movies, Academy Award winning movies, American biographical movies, American drama movies, American legal movies, English-language movies, Feminist movies, Golden Globe Award winning movies, Movies set in California, Movies set in the 1990s, Movies directed by Steven Soderbergh
32-bit	Computers
Anticyclonic storm	Weather
Nutcracker	Tools
Ballet Master	Ballet, Entertainment occupations
Celesta	Percussion instruments, Keyboard instruments
Provinces of South Korea	Provinces of South Korea, Geography-related lists
The Walking Dead (TV series)	2010 American television series debuts, 2010s American television series, American horror television series, Atlanta, Georgia in fiction, Emmy Award winning programs, Saturn Award winners, The Walking Dead, English-language television programs
Pas de deux	Ballet terminology
Bananas in Pyjamas	Children's television series, Australian television, English-language television programs
A Time to Kill	1996 crime movies, 1996 drama movies, 1996 thriller movies, 1990s crime drama movies, 1990s crime thriller movies, 1990s drama thriller movies, 1990s legal movies, American crime drama movies, American crime thriller movies, American drama thriller movies, American legal movies, English-language movies, Movies about murderers, Movies about revenge, Movies set in Mississippi, Rape in movies, Warner Bros. movies, Movies directed by Joel Schumacher
Gerard Lawson	American football cornerbacks, Cleveland Browns players, Philadelphia Eagles players, Sportspeople from Las Vegas, Nevada, 1985 births, Living people
Killer Joe	2011 comedy movies, 2011 crime movies, 2010s criminal comedy movies, American criminal comedy movies, English-language movies, Movies set in Texas, NC-17 rated movies, Movies directed by William Friedkin, American independent movies
Katsushika	Wards of Tokyo, Settlements in Tokyo Prefecture
A Free Ride	1915 movies, Pornographic movies, American silent movies
Chilean Navy	Chile, Navies
Milton Cruz	1957 births, Living people, Brazilian footballers
Carlos Soares Garrit	1971 births, Living people, Brazilian footballers
Tadashi Sasaki	1966 births, Living people, Japanese footballers
Takeshi Motoyoshi	1967 births, Living people, Footballers from Kanagawa Prefecture, J1 League players, Japan Soccer League players, Shonan Bellmare players, Urawa Red Diamonds players, Tokushima Vortis players, FC Tokyo players, 1988 AFC Asian Cup players
Akinori Mikami	1969 births, Living people, Footballers from Shizuoka Prefecture
Koichi Nakazato	1973 births, Living people, Footballers from Saitama Prefecture
Neurolinguistic programming	Pseudoscience
František Mysliveček	1965 births, Living people, Czech footballers
Kenji Yamamoto	1965 births, Living people, Footballers from Yamanashi Prefecture
Kazuya Igarashi	1965 births, Living people, Footballers from Iwate Prefecture
Martin Hřídel	1968 births, Living people, Czech footballers
Naoki Hommachi	1968 births, Living people, Footballers from Hyōgo Prefecture
Kei Hirata	1969 births, Living people, Footballers from Kanagawa Prefecture
Florida Suncoast	Geography of Florida
Hirokazu Sasaki	1962 births, Living people, Footballers from Okayama Prefecture
Davi Cortes da Silva	1963 births, Living people, Footballers from Rio de Janeiro
Jeorá Matos Ferreira	1964 births, Living people, Brazilian footballers
Yoshiyuki Kato	1964 births, Living people, Footballers from Tokyo Prefecture
Mitsuhiro Kawamoto	1971 births, Living people, Footballers from Tokyo Prefecture
Koichi Togashi	1971 births, Living people, Footballers from Kanagawa Prefecture
Paulo Cezar Bonfim	1971 births, Living people, Brazilian footballers
Koji Seki	1972 births, Living people, Footballers from Tokyo Prefecture
Bactria	Geography of Afghanistan
North Central Florida	Geography of Florida
Jaipur	Capital cities in India, Settlements in Rajasthan, 1727 establishments, 1720s establishments in Asia, 18th century establishments in India
Orion (mythology)	Greek mythology
Boric acid	Acids
Sky1	British television channels, British Sky Broadcasting
Lost and found	Property
Registration, Evaluation, Authorisation and Restriction of Chemicals	International law
Luke Bryan	American country musicians, American singer-songwriters, Singers from Georgia (U.S. state), 1976 births, Living people
Paquita	Ballets by Marius Petipa, Ballets
Henry Youngman	1865 births, 1936 deaths, American baseball players, Naturalized citizens of the United States, People from Dortmund, Sportspeople from North Rhine-Westphalia
Herb Mitchell	Boston Bruins players, People from Ontario, 1895 births, 1969 deaths
Fratczak	Surnames
List of Mito HollyHock players	Lists of Japanese football players
Liberal National Party of Queensland	Liberal parties, Political parties in Australia, Liberal Party of Australia, National Party of Australia
Naoto Kan	1946 births, Living people, Prime Ministers of Japan, People from Yamaguchi Prefecture, Deputy Prime Ministers of Japan
Web hosting service	Internet
Speed skating	Speed skating
Brodus Clay	1980 births, American movie actors, Actors from Pasadena, California, American professional wrestlers, Former WWE wrestlers, Living people, Sportspeople from California
Condé-sur-Sarthe	Communes in Orne
Ann M. Martin	writers from New Jersey, Living people, 1955 births, Children's writers
Lim Sa-hong	1445 births, 1506 deaths, South Korean politicians, Autobiographers, Korean writers
Schoolhouse Rock!	Animated television series, 1970s television series, ABC network shows, 1980s Nickelodeon shows, English-language television programs
Ring-tailed lemur	Lemuriformes, Mammals of Africa
Radio edit	Music industry
1994 Northridge earthquake	1994 in California, 1990s in Los Angeles, California, Earthquakes in the 1990s, Earthquakes in California
Blue (group)	2000 establishments in England, 2000s British music groups, 2010s British music groups, English boy bands, English pop music groups, English R&B bands, Eurovision Song Contest entrants, Musical groups established in 2000
Magical thinking	Psychology
Neilsen rating	Television
List of Glee episodes	Lists of television series episodes, Glee
Christina Milian	Actors from Maryland, Actors from New Jersey, American child actors, American dancers, American movie actors, American R&B singers, American pop singers, American hip hop musicians, American soul musicians, American singer-songwriters, American television actors, American voice actors, Entertainers from Jersey City, New Jersey, Singers from Maryland, Singers from New Jersey, 1981 births, Living people
Eastern black rhinoceros	Rhinoceroses
Tribunal	Trials
Dominance (ethology)	Ethology, Psychology
Fujiidera, Osaka	Cities in Osaka Prefecture
Takahagi, Ibaraki	Cities in Japan, Settlements in Ibaraki Prefecture
Public holidays in Thailand	Lists, Holidays, Thai culture
César Chávez Day	Holidays, California, Colorado, Texas, Arizona, Michigan, History of Nebraska, New Mexico
Robin Thicke	Actors from Los Angeles, California, American R&B musicians, American R&B singers, American television actors, Canadian singers, Canadian television actors, Musicians from Los Angeles, California, Singers from Los Angeles, California, 1977 births, Living people
Robin Givens	1964 births, Living people, Actors from New York, African American actors, American movie actors, American stage actors, American television actors
Kodaira, Tokyo	Cities in Japan, Settlements in Tokyo Prefecture
Heather Matarazzo	1982 births, Living people, Actors from New York, American movie actors, LGBT actors, LGBT people from New York
Provinces of Oman	Oman
Scream 3	2000 crime movies, 2000 horror movies, 2000s horror thriller movies, American sequel movies, Impact of the Columbine High School massacre, Scream movies, Screenplays by Ehren Kruger, American independent movies
Ranzan, Saitama	Towns in Japan, Settlements in Saitama Prefecture
Provinces of Panama	Provinces of Panama
Hitachi, Ibaraki	Cities in Japan, Settlements in Ibaraki Prefecture
Third Geneva Convention	Geneva Conventions, 1929 in Europe, 20th century in Geneva
Cranberry	Berries, Vaccinium
Victoria Tolstoganova	1972 births, Living people, Russian actors
Nakano, Tokyo	Wards of Tokyo, Settlements in Tokyo Prefecture
Assembly line	Manufacturing
Outer planet	Solar System planets
Ōta, Tokyo	Wards of Tokyo, Settlements in Tokyo Prefecture, 1947 establishments in Japan
Hypothyroidism	Diseases, Endocrine system
Charnia	Fossils, Invertebrates
Institute of Space and Astronautical Science	Japanese space program, 1955 establishments in Japan, Space research organizations
Ōsumi (satellite)	Japanese space program, Satellites
Tansei	Japanese space program, Satellites
Shinsei	Japanese space program, Satellites
Paul Eddington	Actors from London, Cancer deaths in London, Deaths from skin cancer, English movie actors, English television actors, 1927 births, 1995 deaths
Provinces of the Philippines	Provinces of the Philippines
Nursery	Types of educational institutions, Children
Kingsway (London)	Roads in London
Denpa (satellite)	Japanese space program, Satellites
Provinces of Libya	History of Libya, 1934 establishments, 20th-century establishments in Libya, 1963 disestablishments
Japan Aerospace Exploration Agency	Independent Administrative Institutions of Japan, Space agencies, Japanese space program, 2003 establishments in Japan
Hong Kong Island (constituency)	Hong Kong
Kowloon West (constituency)	Hong Kong
Akebono (satellite)	Japanese space program, Satellites
Peter Andre	1973 births, Living people, Australian businesspeople, Australian pop singers, Australian singer-songwriters, British R&B musicians, Businesspeople from London, British pop singers, British singer-songwriters, Gold Coast, Queensland, I'm a Celebrity...Get Me Out of Here! contestants, Musicians from Queensland, People from Brent (London borough), Singers from London, Television personalities from London
A Visit from St. Nicholas	19th-century American poems
Sleeping with the Enemy	1991 crime movies, 1991 drama movies, 1990s crime drama movies, 1991 thriller movies, 1990s psychological movies, American crime drama movies, American thriller movies, American psychological movies, English-language movies, Iowa, Movies about domestic violence, Movies based on books, Movies set in Massachusetts, Movies directed by Joseph Ruben
Hiten (spacecraft)	Japanese space program, Satellites
Taiyo (satellite)	Japanese space program, Satellites
Kyokko	Japanese space program, Satellites
Jikiken	Japanese space program, Satellites
Hinotori (satellite)	Japanese space program, Satellites
Ohzora	Japanese space program, Satellites
Suzaku (satellite)	Japanese space program, Satellites
Glaciology	Earth sciences, Landforms
The Devil Inside	American horror movies, 2012 movies, English-language movies
Kowloon East (constituency)	Hong Kong
New Territories West (constituency)	Hong Kong
New Territories East (constituency)	Hong Kong
Heung Yee Kuk (constituency)	Functional constituencies of Hong Kong
Agriculture and Fisheries (constituency)	Functional constituencies of Hong Kong
Insurance (constituency)	Functional constituencies of Hong Kong
Transport (constituency)	Functional constituencies of Hong Kong
Education (constituency)	Functional constituencies of Hong Kong
Legal (constituency)	Functional constituencies of Hong Kong
Accountancy (constituency)	Functional constituencies of Hong Kong
Medical (constituency)	Functional constituencies of Hong Kong
Health Services (constituency)	Functional constituencies of Hong Kong
Engineering (constituency)	Functional constituencies of Hong Kong
Architectural, Surveying, Planning and Landscape (constituency)	Functional constituencies of Hong Kong
Box office	Economics, Movie terminology, Movie production
Labour (constituency)	Functional constituencies of Hong Kong
Social Welfare (constituency)	Functional constituencies of Hong Kong
Real Estate and Construction (constituency)	Functional constituencies of Hong Kong
Tourism (constituency)	Functional constituencies of Hong Kong
Commercial (First)	Functional constituencies of Hong Kong
Commercial (Second)	Functional constituencies of Hong Kong
Industrial (First)	Functional constituencies of Hong Kong
Industrial (Second)	Functional constituencies of Hong Kong
Finance (constituency)	Functional constituencies of Hong Kong
Financial Services (constituency)	Functional constituencies of Hong Kong
Battersea Bridge	1890 establishments in the United Kingdom, 1890s establishments in England, Battersea, Bridges and tunnels in London, Chelsea, London
Saint	Saints
Anne Bancroft	Academy Award winning actors, Actors from the Bronx, American movie actors, American television actors, American voice actors, BAFTA Award winning actors, Cancer deaths in New York City, Deaths from uterine cancer, Emmy Award winning actors, Golden Globe Award winning actors, Tony Award winning actors, 1931 births, 2005 deaths
Apples and oranges	Idioms, Apples, Oranges
Hardness	Materials science, Physics
Asia Pacific	Geography of Asia, Oceania
Small Island Developing States	Countries, Development
Provinces of Vanuatu	Vanuatu, Provinces
List of rivers of Afghanistan	Rivers of Afghanistan, Lists of rivers by country, Lists of rivers of Asia
List of rivers of Algeria	Lists of rivers by country, Lists of rivers of Africa, Geography of Algeria
Gran Valira	Geography of Andorra, Rivers of Europe
List of rivers of Angola	Lists of rivers by country, Lists of rivers of Africa, Geography of Angola
List of rivers of Antigua and Barbuda	Geography of Antigua and Barbuda, Lists of rivers by country, Lists of rivers of North America
List of rivers of Armenia	Lists of rivers by country, Geography of Armenia, Lists of rivers of Europe
Water bodies of Azerbaijan	Geography of Azerbaijan, Geography-related lists, Bodies of water, Azerbaijan-related lists
List of rivers of Azerbaijan	Lists of rivers by country, Geography of Azerbaijan, Lists of rivers of Europe
Hulme	Districts of Manchester
List of rivers of the Bahamas	Geography of the Bahamas, Lists of rivers by country, Lists of rivers of North America
List of countries without rivers	Rivers, Lists of countries
Jean Coralli	1779 births, 1854 deaths, French choreographers, French ballet dancers
List of rivers of Barbados	Barbados, Lists of rivers of North America, Lists of rivers by country
List of rivers of Belarus	Rivers of Belarus, Lists of rivers of Europe, lists of rivers by country
List of rivers of Belgium	Rivers of Belgium, Lists of rivers of Europe, Lists of rivers by country
List of rivers of Belize	Rivers of Belize, Lists of rivers by country, Lists of rivers of North America
List of rivers of Bhutan	Rivers of Bhutan, Lists of rivers of Asia, Lists of rivers by country
Ann Landers	Pen names
Heather Whitestone	1973 births, Living people, People from Alabama, Miss America winners
Major Lance	1939 births, 1994 deaths, African American musicians, American soul musicians, Musicians from Mississippi, Cardiovascular disease deaths in the United States
Shin Saimdang	1504 births, 1551 deaths, Korean painters, Poets, Korean writers
Hwang Jinyi	Dancers, Korean writers, 1520 births, 1560 deaths, Korean poets
Enamorada de Ti (album)	2012 albums, Selena albums
List of rivers of Bolivia	Lists of rivers by country, Rivers of Bolivia, Lists of rivers of South America
List of rivers of Bosnia and Herzegovina	Lists of rivers by country, Rivers of Bosnia and Herzegovina, Lists of rivers of Europe
Citroën AX	Citroen automobiles, Front wheel drive vehicles, 1980s automobiles, 1990s automobiles
Margalla Hills	Mountain ranges of Pakistan
Kherimurat	Mountain ranges of Pakistan, Rawalpindi District
Kherimar	Mountain ranges of Pakistan, Punjab (Pakistan)
Çankaya University	Colleges and universities in Turkey, 1997 establishments in Asia, Ankara, 20th century establishments in Turkey
Marlee Matlin	1965 births, Living people, Actors from Chicago, American television actors, American stage actors, American movie actors, Golden Globe Award winning actors, Best Actress Academy Award winners, People from Arlington Heights, Illinois, Deaf people

