Eriswil	Municipalities of Bern
Secunderabad	Cities in India, Telangana
Erlach, Switzerland	Municipalities of Bern, Cities in Switzerland
Erlenbach im Simmental	Municipalities of Bern
Ersigen	Municipalities of Bern
Thrombolite	Fossils, Bacteria, Sedimentary rocks
Eschert	Municipalities of Bern
Etzelkofen	Former municipalities of Bern
Free-Stater (Kansas)	Political movements, 1850s in Kansas, Bleeding Kansas
Evilard	Municipalities of Bern
Lucca Borges de Brito	1990 births, Living people, Brazilian footballers
Fahrni	Municipalities of Bern
Farnern	Municipalities of Bern
Graziano Pellè	1985 births, Living people, Italian footballers, People from Apulia, UEFA Euro 2016 players
Omar Mateen	1986 births, 2016 deaths, American Muslims, American spree killers, American terrorists, Criminals from New York City, Deaths by firearm in Florida, Islamic State people, People from Florida
Bogdan Stancu	1987 births, Living people, Romanian footballers, UEFA Euro 2016 players
Farhiyo Farah Ibrahim	Women who received the International Women of Courage Award, Somalia, Living people, Year of birth missing (living people), Human rights activists
The Carsey-Werner Company	Companies of the United States, 1981 establishments in the United States
Serious (Gwen Stefani song)	2004 songs, Gwen Stefani songs, Dance-pop songs, New wave, R&B songs
Pasophae	People in Greek mythology
Long Way to Go (Gwen Stefani and André 3000 song)	2004 songs, Gwen Stefani songs, Hip hop songs, Electro songs, R&B songs
Ferenbalm	Municipalities of Bern
Forst, Switzerland	Former municipalities of Bern, Villages in Bern
Forst-Längenbühl	2000s establishments in Switzerland, 2007 establishments in Europe, Municipalities of Bern
Fraubrunnen	Municipalities of Bern
Frauenkappelen	Municipalities of Bern
Plains Indians	History of North America, Native American people
Wind It Up (Gwen Stefani song)	2006 songs, Gwen Stefani songs, Hip hop songs, R&B songs
Osage Nation	History of Native Americans, Native American people
Isenthal	Municipalities of Uri
Shielding effect	Physical chemistry
Ádám Szalai	1987 births, Living people, Hungarian footballers, Sportspeople from Budapest
Ackee	Fruits, Sapindaceae
Atchison, Kansas	Cities in Atchison County, Kansas, County seats in Kansas, 1854 establishments in Kansas Territory, History of Kansas, Bleeding Kansas
Gadmen	Former municipalities of Bern
New York Tribune	Newspapers in New York City
Gals	Municipalities of Bern
Pawnee people	History of the United States, Native American people
Eagle nebula	Nebulae
William Adams	1564 births, 1620 deaths, Gillingham, Kent, People from Kent
New England Emigrant Aid Company	History of the United States, History of Kansas, Bleeding Kansas, 1854 establishments in the United States, 19th-century establishments in Massachusetts
Gampelen	Municipalities of Bern
2012 Campeonato Brasileiro Série A	Campeonato Brasileiro Série A, 2012 in association football
Kansas Territory	19th century in the United States, History of Kansas, Bleeding Kansas, 1854 establishments in the United States, 1861 disestablishments, Former territories of the United States
Gelterfingen	Former municipalities of Bern
Gerzensee	Municipalities of Bern
Realp	Municipalities of Uri
Golaten	Former municipalities of Bern
Gondiswil	Municipalities of Bern
Schattdorf	Municipalities of Uri
Seedorf, Uri	Municipalities of Uri
Seelisberg	Municipalities of Uri
Club de Regatas Vasco da Gama	Football clubs in Rio de Janeiro, 1898 establishments, 1890s establishments in Brazil
LDU Quito	Football clubs, 1930 establishments in South America
Central Italy	Geography of Italy
Chinese Super League	Football leagues, Football in China, 2004 establishments in Asia, 2000s establishments in China
Queen Ratna of Nepal	1928 births, Living people, Nepalese people, Kings and queens
Jo Cox	1974 births, 2016 deaths, Alumni of the London School of Economics, Alumni of the University of Cambridge, English murder victims, Former Labour MPs (UK), Former members of the British House of Commons for English constituencies, Murders by firearm in England, People from West Yorkshire, UK MPs 2015–2017
Adolph Cornelis van Bruggen	1929 births, 2016 deaths, Botanists, Dutch scientists, Writers from The Hague, Zoologists
Gil Bartosh	1930 births, 2016 deaths, American football players, Sportspeople from Texas
Villefranche-d'Albigeois	Communes in Tarn
Sulabha Deshpande	1937 births, 2016 deaths, Indian movie actors, Indian television actors, People from Mumbai
Antti Hyry	1931 births, 2016 deaths, Finnish writers
Lois Duncan	1934 births, 2016 deaths, Deaths from stroke, American children's writers, Writers from Philadelphia, Pennsylvania, Writers from Florida
Iron ore	Iron compounds, Ores
Beijing Guoan F.C.	Chinese football clubs, 1992 establishments in Asia, Beijing, 1990s establishments in China
Shandong Luneng Taishan F.C.	Chinese football clubs, 1993 establishments in Asia, 1990s establishments in China
2015 Chinese Super League	Football leagues, Football in China
Graben, Switzerland	Municipalities of Bern
Grafenried, Switzerland	Former municipalities of Bern
Haute-Ajoie	2009 establishments in Switzerland, Municipalities of Jura
Silenen	Municipalities of Uri
Sisikon	Municipalities of Uri
Spiringen	Municipalities of Uri
Unterschächen	Municipalities of Uri
Wassen	Municipalities of Uri
Cyrus K. Holliday	1826 births, 1900 deaths, Bleeding Kansas, History of Kansas, Politicians from Pennsylvania
CAQC Certification	China, Standards
Grandval, Switzerland	Municipalities of Bern
Alvaschein	Former municipalities of Graubünden
Andeer	Municipalities of Graubünden
Grossaffoltern	Municipalities of Bern
This Is What You Came For	2016 songs, Calvin Harris songs, Dance songs, Rihanna songs
Grosshöchstetten	Municipalities of Bern
Gsteig bei Gstaad	Municipalities of Bern
Hotel for Dogs	1971 books
Exothermic reaction	Thermodynamics, Chemical reactions
Endothermic reaction	Chemical reactions
Banana split	Desserts, Ice cream
List of comuni of the Province of Ancona	Ancona
Hawthorn Football Club	Australian Football League, Football clubs
Andiast	Former municipalities of Graubünden
Ardez	Former municipalities of Graubünden
Arosa	Municipalities of Graubünden, Ski areas and resorts in Switzerland
Gsteigwiler	Municipalities of Bern
Guggisberg	Municipalities of Bern
Arvigo	Former municipalities of Graubünden
Eli Thayer	1819 births, 1899 deaths, Bleeding Kansas, United States representatives from Massachusetts, US Republican Party politicians
Gündlischwand	Municipalities of Bern
Breggia, Switzerland	2009 establishments in Switzerland, Municipalities of Ticino
Cugnasco-Gerra	2008 establishments in Switzerland, Municipalities of Ticino
The Sweet Escape (song)	2006 songs, Gwen Stefani songs, R&B songs
Masada	Archaeological sites in Israel, World Heritage Sites in Asia
Cave of the Patriarchs	Archaeological sites in Israel, History of Palestine, West Bank
Dongio	Former municipalities of Ticino, Villages in Ticino
Leontica	Former municipalities of Ticino, Villages in Ticino
Fusio	Former municipalities of Ticino, Villages in Ticino
Pottawatomie massacre	1850s in Kansas, Bleeding Kansas, 1856
Gurbrü	Municipalities of Bern
Arch, Switzerland	Municipalities of Bern
Nablus	Cities in the West Bank
The Museum of Philistine Culture	1990 establishments, Museums in Israel, 1990s establishments in Israel
Abrahams Well International Visitors Center	Beer Sheba, Archaeological sites in Israel, 2013 establishments in Asia, Museums in Israel, 2010s establishments in Israel
Esino	Marche, Rivers of Italy
Data corruption	Data input, Computer science
Anton Yelchin	1989 births, 2016 deaths, Actors from Los Angeles, California, American movie actors, American television actors, American voice actors, Naturalized citizens of the United States, People from Saint Petersburg, Road accident deaths in California, Russian movie actors, Russian television actors
Sweat lodge	Native American, Ceremonies
John Brown's raid on Harpers Ferry	1859 in the United States, Origins of the American Civil War, October events
Ponto Valentino	Villages in Ticino, Former municipalities of Ticino
Guttannen	Municipalities of Bern
Habkern	Municipalities of Bern
Border Ruffian	19th century in the United States, 19th century in Kansas, Bleeding Kansas, 1850s in the United States
Ernesto Maceda	1935 births, 2016 deaths, Deaths from multiple organ failure, Presidents of the Senate of the Philippines, Presidents pro tempore of the Senate of the Philippines, Minority leaders of the Senate of the Philippines
Odometer	Measuring tools
Galícia Esporte Clube	Brazilian football clubs, Salvador, Bahia, 1933 establishments, 1930s establishments in Brazil
Clash of the Titans (2010 movie)	2010 movies, 2010s adventure movies, 2010s fantasy movies, American adventure movies, American fantasy movies, American movie remakes, British adventure movies, British fantasy movies, English-language movies, Movies based on Greek and Roman mythology, Warner Bros. movies
Hagneck	Municipalities of Bern
Hasle bei Burgdorf	Municipalities of Bern
Wakarusa War	Bleeding Kansas, 1850s in Kansas, 1855, Lawrence, Kansas
Lecompton, Kansas	Cities in Douglas County, Kansas, 1854 establishments in Kansas Territory
Skirmisher	Military terminology
George Brett	1953 births, Living people, Kansas City Royals players, American baseball players, Sportspeople from West Virginia, National Baseball Hall of Fame members
Avers	Municipalities of Graubünden
Bergün/Bravuogn	Former municipalities of Graubünden
Villa Epecuén	Villages, Settlements in Argentina, 1985 disestablishments, Disestablishments in South America
Hasliberg	Municipalities of Bern
Mountain biking	Cycling
Häutligen	Municipalities of Bern
Battle of Osawatomie	1850s in Kansas, Bleeding Kansas, 1856, August events
Neot Kedumim	Parks in Israel, Israeli culture
Pitch, yaw, and roll	Mechanics
Heatwave (band)	American R&B bands, 1975 establishments in the United States
Someo	2004 disestablishments in Switzerland, Former municipalities of Ticino, Villages in Ticino
Heiligenschwendi	Municipalities of Bern
Marais des Cygnes massacre	1850s in Kansas, Bleeding Kansas
2003 European heat wave	Droughts, 2003 in Europe, 2003 in weather
Heimberg, Switzerland	Municipalities of Bern
Heimenhausen	Municipalities of Bern
Heimiswil	Municipalities of Bern
Moghegno	2004 disestablishments in Switzerland, Former municipalities of Ticino, Villages in Ticino
Aurigeno	2004 disestablishments in Switzerland, Former municipalities of Ticino, Villages in Ticino
Alberswil	Municipalities of Lucerne
Terre di Pedemonte	Municipalities of Ticino, 2013 establishments in Switzerland
Blockhouse	Military terminology, Fortification
Electoral fraud	Elections, Fraudsters
Muhammad Azam Shah	Mughal emperors, Mughal Empire
Douglas County, Kansas	Douglas County, Kansas, 1855 establishments in Kansas Territory
Marais des Cygnes River	Rivers of Kansas
List of comuni of the Province of Pesaro and Urbino	Settlements in Marche
Bever, Switzerland	Municipalities of Graubünden
Bivio	Former municipalities of Graubünden
Brexit	Brexit, 2010s in the United Kingdom, 2020s in the United Kingdom
Madame de Montespan	1640 births, 1707 deaths, French people
Jayhawker	History of Kansas, Bleeding Kansas, Origins of the American Civil War
Hellsau	Municipalities of Bern
Foglia	Marche, Rivers of Italy, Tuscany
Herbligen	Municipalities of Bern
Hermiswil	Former municipalities of Bern, 2016 disestablishments in Switzerland
Hermrigen	Municipalities of Bern
Altbüron	Municipalities of Lucerne
Entlebuch	Municipalities of Lucerne
Doppleschwand	Municipalities of Lucerne
Escholzmatt	Former municipalities of Lucerne
Elle King	Singers from Los Angeles, California, Singers from New York City, American rock musicians, American country musicians, 1989 births, Living people
Serravalle, Switzerland	2012 establishments in Switzerland, Municipalities of Ticino
Gambarogno	Municipalities of Ticino, 2010 establishments in Switzerland
Flühli	Municipalities of Lucerne
Herzogenbuchsee	Municipalities of Bern
Freimettigen	Municipalities of Bern
Hilterfingen	Municipalities of Bern
2015–16 Superleague Greece	2015 in association football, 2016 in association football
Joe Walsh (Illinois politician)	1961 births, Living people, United States representatives from Illinois, 2020 United States presidential candidates, American radio personalities, US Republican Party politicians
FC Rapid București	Romanian football clubs, 1923 establishments in Europe, 20th century establishments in Romania
FC Dinamo București	Romanian football clubs, 1948 establishments in Europe, 1940s establishments in Romania
CFR Cluj	Romanian football clubs
2016–17 Liga I	2016 in association football, 2017 in sports
Cupa României	Football competitions, Football in Romania, 1993 establishments in Europe, 20th century establishments in Romania
FC Politehnica Iași (2010)	Romanian football clubs, 2010 establishments in Europe, 21st century establishments in Romania
Hasle, Lucerne	Municipalities of Lucerne
FC Astra Giurgiu	Romanian football clubs, 1921 establishments in Europe, 20th century establishments in Romania
Marbach, Lucerne	Former municipalities of Lucerne
Escholzmatt-Marbach	Municipalities of Lucerne, 2013 establishments in Switzerland
Liga II	Football competitions, Football in Romania, 1934 establishments, 1930s establishments in Europe, 20th century establishments in Romania
FC Botoșani	Romanian football clubs, 2001 establishments in Europe, 2000s establishments in Romania
Stadionul Municipal (Botoșani)	Stadiums in Europe
United Nations General Assembly Resolution 68/262	United Nations
CS Universitatea Craiova (football)	Romanian football clubs, 1948 establishments in Europe, 1940s establishments in Romania
Richenthal	Former municipalities of Lucerne, Villages in Lucerne
Azzedine Alaïa	1940 births, 2017 deaths, Fashion designers, Legion of Honour, People from Tunis, Twin people
Sandy Springs, Georgia	Cities in Georgia (U.S. state), Fulton County, Georgia
Slave states and free states	Slavery, History of the United States
Romoos	Municipalities of Lucerne
Hindelbank	Municipalities of Bern
Province of Fermo	Provinces of Marche
Höchstetten	Municipalities of Bern
Höfen, Thun	Former municipalities of Bern
List of comuni of the Province of Fermo	Settlements in Marche
Bonaduz	Municipalities of Graubünden
Hofstetten bei Brienz	Municipalities of Bern
Homberg, Switzerland	Municipalities of Bern
Jenni Williams	Activists, Living people, Women who received the International Women of Courage Award, Year of birth missing (living people), Zimbabwean people
If Only I Could	Singapore, Chinese language, 2010s television series, Drama television series
CS Gaz Metan Mediaș	Romanian football clubs, 1945 establishments in Europe, 1940s establishments in Romania
FC Viitorul Constanța	Romanian football clubs, 2009 establishments in Europe, 2000s establishments in Romania
Schüpfheim	Municipalities of Lucerne
Mason–Dixon line	Geography of Maryland, Pennsylvania, Territorial disputes
Horrenbach-Buchen	Municipalities of Bern
Huttwil	Municipalities of Bern, Cities in Switzerland
Son Heung-min	Living people, South Korean footballers, 1992 births
Ring (diacritic)	Alphabetic diacritics
Werthenstein	Municipalities of Lucerne
Wolhusen	Municipalities of Lucerne
Harpers Ferry Armory	American Civil War, 18th-century establishments in Virginia, Harpers Ferry, West Virginia, 1797 establishments in the United States
Entlebuch (district)	Districts of Lucerne
Sixth form	Education in England, Education in the United Kingdom
Inkwil	Municipalities of Bern
Innertkirchen	Municipalities of Bern, Villages in Bern
Ins, Switzerland	Municipalities of Bern
Gaultheria	Ericaceae
Interlaken	Municipalities of Bern, Cities in Switzerland
Leopold, Duke of Lorraine	1679 births, 1729 deaths, Dukes and duchesses, House of Lorraine
List of comuni of the Province of Macerata	Settlements in Marche
Joe Pavelski	1984 births, American Hockey League players, American ice hockey players, Dallas Stars players, Ice hockey centres, Living people, People from Wisconsin, San Jose Sharks players, United States Hockey League players
Agnetha Fältskog	1950 births, Living people, Swedish singers, Swedish writers, Swedish actors, Songwriters, Swedish musicians
Björn Ulvaeus	1945 births, Living people, Swedish screenwriters, Songwriters, Composers, Swedish movie producers, People from Gothenburg
Dynamo Dresden	Dresden, German football clubs, Sport in Saxony
Chromophore	Chemical compounds
Himeros	Greek gods and goddesses
Harpers Ferry, West Virginia	Harpers Ferry, West Virginia
Battle of Harpers Ferry	Harpers Ferry, West Virginia, American Civil War battles, 1862 in the United States, Maryland Campaign, History of West Virginia, September 1862 events
Giumaglio	2004 disestablishments in Switzerland, Former municipalities of Ticino, Villages in Ticino
Maryland Campaign	Maryland Campaign, September 1862 events
Ipsach	Municipalities of Bern
Iseltwald	Municipalities of Bern, Villages in Bern
Time in Egypt	Time by country, Egypt
Mithankot	Cities in Pakistan, Punjab (Pakistan)
Moscow Time	Time zones, Moscow
Siti Musdah Mulia	1958 births, Indonesian writers, Indonesian activists, Human rights activists, Living people, Women who received the International Women of Courage Award
Shenandoah River	Rivers of West Virginia, Rivers of Virginia
Ittigen	Municipalities of Bern, Cities in Switzerland
Langnau bei Reiden	Villages in Lucerne, Former municipalities of Lucerne
Kottwil	Villages in Lucerne, Former municipalities of Lucerne
Dixon S. Miles	1804 births, 1862 deaths, Colonels, Military personnel of the American Civil War, People from Baltimore, Maryland
Monte Vettore	Mountains of Italy, Marche
2016 Stanley Cup Finals	2016 in ice hockey, 2016 in Pennsylvania, 2016 in California, 21st century in Pittsburgh, History of San Jose, California, June 2016 events, May 2016 events, Pittsburgh Penguins, San Jose Sharks, Stanley Cup Finals
List of Italian regions by highest point	Mountains of Italy, Italy-related lists
Hochdorf (district)	Districts of Lucerne
Howards End	1992 drama movies, British drama movies, Japanese movies, British novels, Movies directed by James Ivory
Jaberg	Municipalities of Bern
Jegenstorf	Municipalities of Bern
Kallnach	Municipalities of Bern
Kandergrund	Municipalities of Bern
Kandersteg	Municipalities of Bern, Ski areas and resorts in Switzerland
Altwis	Municipalities of Lucerne
Bouillabaisse	Soups, French food
Sword Art Online	Series of books, 2012 anime television series, 2014 anime television series, 2018 anime television series, Light novels
Salade niçoise	French food, Salads, Nice
Light novel	Light novels
Ballwil	Municipalities of Lucerne
Punitive damages	Law
Ilze Jaunalksne	Latvian people, Journalists, Year of birth missing (living people), Living people
Kappelen	Municipalities of Bern
Samia al-Amoudi	Women who received the International Women of Courage Award, Saudi Arabian people, Educators, Living people, Year of birth missing (living people), Physicians, Academics
Gurzelen	Municipalities of Bern
Kaufdorf	Municipalities of Bern
Battle of South Mountain	American Civil War battles, 1862 in the United States, Maryland Campaign, September 1862 events
Mariya Ahmed Didi	Women who received the International Women of Courage Award, Political activists, Maldivian people, Year of birth missing (living people), Living people
Kehrsatz	Municipalities of Bern
Kernenried	Municipalities of Bern
Kienersrüti	Former municipalities of Bern
Hal Robson-Kanu	1989 births, Welsh footballers
Neil Taylor (footballer)	1989 births, Welsh footballers
Burak Yılmaz	1985 births, Living people, Turkish footballers, UEFA Euro 2016 players
Birkir Bjarnason	1988 births, Living people, Icelandic footballers, UEFA Euro 2016 players
Arnór Ingvi Traustason	1993 births, Living people, Icelandic footballers, UEFA Euro 2016 players
Fimleikafélag Hafnarfjarðar	1928 establishments in Europe, Sports clubs, Sport in Iceland, Icelandic football clubs, 20th century establishments in Iceland
San Francisco–Oakland Bay Bridge	1936 establishments in the United States, Buildings and structures in San Francisco, Landmarks in San Francisco, Oakland, California, Suspension bridges, National Register of Historic Places, 1930s establishments in California, Bridges in the San Francisco Bay Area
Vestmannaeyjar	Towns in Iceland, Municipalities of Iceland
List of comuni of the Province of Ascoli Piceno	Settlements in Marche, Lists of settlements in Europe
2015–16 Golden State Warriors season	2015 in sports, 2015 in California, 2016 in sports, 2016 in California, Golden State Warriors, Oakland, California
San Mateo–Hayward Bridge	1929 establishments in the United States, Bridges in the San Francisco Bay Area
Heimaey	Atlantic islands, Islands of Europe, Geography of Iceland
Kolbeinn Sigþórsson	1990 births, Icelandic footballers, Living people
Rúnar Kristinsson	1969 births, Living people, Icelandic footballers
Kingdom of Iceland	1918 establishments in Europe, 1944 disestablishments, Former monarchies of Europe
Steyr AUG	Bullpup rifles, Assault rifles, 5.56 mm firearms
Emmen, Switzerland	Municipalities of Lucerne, Cities in Switzerland
Kiesen	Municipalities of Bern
Xiumin	South Korean singers, 1990 births, Living people, Exo members, K-pop singers
Kirchberg, Bern	Municipalities of Bern
Mama	2012 albums, Exo albums
Oh Se-hun	1994 births, Living people, South Korean singers, Exo members, K-pop singers
Kai	1994 births, Living people, South Korean singers, Exo members, K-pop singers
Suho	South Korean singers, 1991 births, Living people, Exo members, K-pop singers
Lay	1991 births, Chinese singers, Dancers, Chinese television actors, Singer-songwriters, Exo members, Living people, Chinese movie actors, Chinese musicians
Park Chan-yeol	South Korean singers, 1992 births, Living people, Exo members
Byun Baek-hyun	1992 births, Living people, South Korean singers, Exo members, K-pop singers
Luhan	Chinese singers, 1990 births, Living people
4 in the Morning	2006 songs, 2007 songs, Gwen Stefani songs, Pop songs, R&B songs
Kirchdorf, Switzerland	Municipalities of Bern
Kirchenthurnen	Former municipalities of Bern
Kirchlindach	Municipalities of Bern
Chiggiogna	Former municipalities of Ticino, Villages in Ticino
Diesbach, Glarus	Former municipalities of Glarus, Villages in Glarus, 2004 disestablishments in Switzerland
Pesaro	Cities in Marche, Capital cities in Italy
Gylfi Sigurðsson	1989 births, Icelandic footballers, Tottenham Hotspur F.C. players, UEFA Euro 2016 players, Living people
Kleindietwil	Former municipalities of Bern
Köniz	Cities in Switzerland, Municipalities of Bern
Konolfingen	Municipalities of Bern
Koppigen	Municipalities of Bern
Bettingen	Municipalities of Basel-Stadt
Riehen	Municipalities of Basel-Stadt, Cities in Switzerland
Ragnar Sigurðsson	1986 births, Icelandic footballers, Living people
Jón Daði Böðvarsson	1992 births, Icelandic footballers
Special Order 191	American Civil War, Maryland Campaign, 1862 in the United States, September 1862 events
Birkir Már Sævarsson	1984 births, Icelandic footballers
Hannes Þór Halldórsson	1984 births, Icelandic footballers, Movie directors
Krattigen	Municipalities of Bern
Ermensee	Ermensee, Municipalities of Lucerne
Hätzingen	Villages in Glarus, Former municipalities of Glarus, 2004 disestablishments in Switzerland
Glarus Nord	Municipalities of Glarus, Cities in Switzerland, 2011 establishments in Switzerland
Myco-heterotrophy	Parasitic plants, Fungi, Ecology, Plant physiology
Suet	Food ingredients
Kriechenwil	Municipalities of Bern
La Ferrière	Municipalities of Bern
La Heutte	Former municipalities of Bern
Englisberg	Villages in Bern, Former municipalities of Bern
Herlisberg	Villages in Lucerne, Former municipalities of Lucerne
Yves Bonnefoy	1923 births, 2016 deaths, French academics, French art critics, French critics, French poets, People from Centre-Val de Loire, Translators
Abderrahmane Meziani	1942 births, 2016 deaths, Algerian footballers, Deaths from cardiovascular disease, People from Algiers
István Halász	1951 births, 2016 deaths, Hungarian footballers
Westfjords	Peninsulas, Regions of Iceland
Carmen Pereira	1937 births, 2016 deaths, Presidents of Guinea-Bissau
Southern Region (Iceland)	Regions of Iceland
Manohar Aich	1912 births, 2016 deaths, Indian sportspeople, Centenarians
Gianluca Buonanno	1966 births, 2016 deaths, Former MEPs, Italian politicians, MEPs for Italy, Road accident deaths
Jerome Bruner	1915 births, 2016 deaths, American psychologists, American centenarians, Scientists from New York City
Jarbas Passarinho	1920 births, 2016 deaths, Presidents of the Federal Senate
Ayaz Jani	1967 births, 2016 deaths, Deaths from myocardial infarction, Pakistani people, Poets, Journalists
Steve Pisanos	1919 births, 2016 deaths, American aviators, American military personnel of the Vietnam War, American military personnel of World War II, Colonels, Deaths from heart failure, Naturalized citizens of the United States, People from Athens, Writers from California
Theresa Saldana	1954 births, 2016 deaths, American movie actors, American television actors, American crime victims, American adoptees, Actors from New York City, Writers from New York City
Johnny Brooks	1931 births, 2016 deaths, Deaths from vascular dementia, English footballers, People from Berkshire, Chelsea F.C. players, Crystal Palace F.C. players, Tottenham Hotspur F.C. players
Amber Gurung	1938 births, 2016 deaths, Deaths from esophageal cancer, Nepalese singers, Composers, Writers
Thomas J. Perkins	1932 births, 2016 deaths, Disease-related deaths in California, Businesspeople from New York, Businesspeople from California
La Neuveville	Municipalities of Bern, Cities in Switzerland
Landiswil	Municipalities of Bern
Längenbühl	Villages in Bern, Former municipalities of Bern
Eschenbach, Lucerne	Municipalities of Lucerne
Langenthal, Switzerland	Municipalities of Bern, Cities in Switzerland
Ouroboros	Symbols, Mythology
Gelfingen	Former municipalities of Lucerne
Lauenen	Municipalities of Bern
Laupen, Bern	Municipalities of Bern, Cities in Switzerland
Glarus Süd	2011 establishments in Switzerland, Municipalities of Glarus
Biel, Valais	Villages in Valais, Former municipalities of Valais
Arica y Parinacota Region	Regions of Chile
Khamseh	Iran, 1861 establishments, Establishments in Iran, 1860s establishments in Asia
Khamseh Arabs	Iran
Susana Trimarco	1954 births, Living people, Argentine people, Human rights activists, Women who received the International Women of Courage Award
Cecilia Bowes-Lyon, Countess of Strathmore and Kinghorne	Royal Victorian Order, 1862 births, 1938 deaths, People from London
Lauperswil	Municipalities of Bern
Lauterbrunnen	Municipalities of Bern, Villages in Bern
Ruzizi River	Rivers of Africa
Leimiswil	Former municipalities of Bern
Popi Maliotaki	1971 births, Living people, Greek singers, Crete
Leissigen	Municipalities of Bern
Lenk	Ski areas and resorts in Switzerland, Municipalities of Bern
Leuzigen	Municipalities of Bern
Ligerz	Municipalities of Bern
Limpach, Switzerland	Former municipalities of Bern
Daniel Harvey Hill	1821 births, 1889 deaths, Confederate Army generals, British educators, People from South Carolina
Belpberg	Former municipalities of Bern
Linden, Switzerland	Municipalities of Bern
Lohnstorf	Former municipalities of Bern
Lotzwil	Municipalities of Bern
Loveresse	Municipalities of Bern
Brevet (military)	Military ranks, Military terminology
Parinacota Province	Provinces of Chile
Abbas Kiarostami	1940 births, 2016 deaths, Deaths from gastrointestinal cancer, Cancer deaths in France, Disease-related deaths in Paris, Iranian movie directors, Iranian movie producers, People from Tehran, Photographers, Iranian poets, Iranian screenwriters
Kathryn Beaumont	1938 births, Living people, Actors from London, English child actors, English movie actors, English television actors, English voice actors, Singers from London
Parinacota Volcano	Andes, Geography of Bolivia, Volcanoes of Chile
Steven Adams	1993 births, Living people, New Zealand sportspeople, New Orleans Pelicans players, Oklahoma City Thunder players, Sportspeople from North Island
Enes Kanter	1992 births, Living people, New York Knicks players, Oklahoma City Thunder players, Utah Jazz players, Turkish basketball players
Param Vir Chakra	Orders, decorations, and medals, Military honors, Military of India, Indian awards, 1950 establishments in Asia, 1950s establishments in India
Robin Hardy	1929 births, 2016 deaths, English movie directors, English screenwriters, Writers from Surrey
Caroline Aherne	BAFTA Award winning actors, 1963 births, 2016 deaths, Deaths from throat cancer, English television actors, English television writers, English television personalities, Comedians from London, Writers from London, Actors from London
Roscoe Brown	1922 births, 2016 deaths, American military people, World War II people, People from Washington, D.C.
Rudolf E. Kálmán	1930 births, 2016 deaths, Naturalized citizens of the United States, Hungarian scientists, American engineers, American mathematicians, American inventors, People from Budapest
Robert Nye	1939 births, 2016 deaths, English poets, Writers from London
Jack C. Taylor	1922 births, 2016 deaths, American billionaires, American philanthropists, Businesspeople from St. Louis, Missouri
Michael Beaumont, 22nd Seigneur of Sark	1927 births, 2016 deaths, English people
Roger Dumas	1932 births, 2016 deaths, French movie actors, French television actors, French comedians
Lou Fontinato	1932 births, 2016 deaths, New York Rangers players, Montreal Canadiens players, Sportspeople from Ontario, People from Guelph, Memorial Cup winners, Ice hockey defencemen
Beatrice de Cardi	1914 births, 2016 deaths, Accidental deaths from falls, Accidental deaths in the United Kingdom, British archaeologists, British centenarians, Scientists from London
Lüscherz	Municipalities of Bern
Kim Chaek	1903 births, 1951 deaths, Deaths from myocardial infarction, North Korean politicians
UEFA Euro 2016 Final	2016 in association football, 2016 in France, 2010s in Île-de-France, July 2016 events, Football in France, UEFA Euro 2016
Sperlinga	Middle Ages, Settlements in Sicily, Italian-speaking countries, French-speaking countries, History of Italy
Lütschental	Municipalities of Bern
Italy national under-21 football team	National under-21 football teams, Football in Italy
Lützelflüh	Municipalities of Bern
Lyssach	Municipalities of Bern
Madiswil	Municipalities of Bern
Gutenburg, Switzerland	Villages in Bern, Former municipalities of Bern
Malleray	Former municipalities of Bern, 2015 disestablishments in Switzerland
Hämikon	Former municipalities of Lucerne
Hitzkirch	Municipalities of Lucerne
Brief (law)	Legal terms, Law
Matten bei Interlaken	Municipalities of Bern
Letters patent	Legal terms, Law
Mattstetten	Municipalities of Bern
Ravichandran Ashwin	1986 births, Living people, Indian cricketers, People from Chennai, Tamil Nadu sportspeople
Iffwil	Municipalities of Bern
Meienried	Municipalities of Bern
La Baroche	2009 establishments in Switzerland, Municipalities of Jura
Uma Shankar Mishra	1923 births, 2016 deaths, Activists, Politicians from Uttar Pradesh
Mauricio Walerstein	1945 births, 2016 deaths, Mexican movie directors, Mexican screenwriters, Mexican movie producers, Writers from Mexico City
William Hawkins (writer)	1940 births, 2016 deaths, Canadian songwriters, Canadian poets, Canadian journalists, Canadian musicians, People from Ottawa
Markus Werner	1944 births, 2016 deaths, Swiss writers
Gordon Murray (puppeteer)	1921 births, 2016 deaths, British television producers, Puppeteers, Entertainers from London
Martin Lundström	1918 births, 2016 deaths, Swedish sportspeople
Geoffrey Hill	1932 births, 2016 deaths, English poets, British educators, People from Worcestershire
Juan Habichuela	1933 births, 2016 deaths, Spanish musicians, Guitarists
Don Friedman	1935 births, 2016 deaths, American jazz musicians, American pianists, American educators, Musicians from San Francisco, Musicians from New York City
Pat Summitt	1952 births, 2016 deaths, Deaths from dementia, Disease-related deaths in Tennessee, People with Alzheimer's disease, College basketball coaches, Sportspeople from Tennessee, Writers from Tennessee
Xu Jiatun	1916 births, 2016 deaths, Centenarians, Chinese politicians, Communists
Sean Rooks	1969 births, 2016 deaths, Cardiovascular disease deaths in the United States, Dallas Mavericks players, Minnesota Timberwolves players, Atlanta Hawks players, Los Angeles Lakers players, Los Angeles Clippers players, New Orleans Hornets players, Orlando Magic players, Sportspeople from New York City
Stephen Keshi	1962 births, 2016 deaths, Deaths from myocardial infarction, Nigerian footballers
Sascha Lewandowski	1971 births, 2016 deaths, German football managers, People from Dortmund, Sportspeople from North Rhine-Westphalia
Qahhor Mahkamov	1932 births, 2016 deaths, Presidents of Tajikistan
Marina Malfatti	1940 births, 2016 deaths, People from Florence, Italian movie actors, Italian television actors, Italian stage actors
Hamza Ali	1995 births, 2016 deaths, Deaths by drowning, English cricketers, People from Bristol
Meikirch	Municipalities of Bern
Nicole Courcel	1931 births, 2016 deaths, French movie actors, French television actors, French stage actors, Actors from Paris
Seven Days Battles	American Civil War battles, 1862 in Virginia, Peninsula Campaign, June events, July events
Meinisberg	Municipalities of Bern
Siege of Yorktown (1862)	American Civil War battles, 1862 in Virginia, Peninsula Campaign
Bill Cunningham	1929 births, 2016 deaths, Deaths from stroke, Cardiovascular disease deaths in New York City, American photographers, People from Boston, Massachusetts, People from New York City
Meiringen	Municipalities of Bern
Ron Lester	1970 births, 2016 deaths, Deaths from liver failure, Deaths from renal failure, Disease-related deaths in Texas, American movie actors, American television actors, Actors from Georgia (U.S. state)
David Morgenthaler	1919 births, 2016 deaths, People from Chester, South Carolina, Businesspeople from South Carolina
Betty Reid Soskin	1921 births, Living people, People from Detroit, Michigan, American centenarians, People from San Francisco
Mary Feik	Cancer deaths in Maryland, American aviators, 1924 births, 2016 deaths
William L. Armstrong	1937 births, 2016 deaths, Cancer deaths in Colorado, Politicians from Nebraska, United States representatives from Colorado, United States senators from Colorado, US Republican Party politicians
Alexander Gorlov	1931 births, 2016 deaths, Russian scientists, Engineers from Massachusetts, American educators, People from Moscow, Scientists from Boston, Massachusetts
Alex Govan	1929 births, 2016 deaths, Scottish footballers, Sportspeople from Glasgow
Habib (singer)	1947 births, 2016 deaths, Deaths from myocardial infarction, Iranian singers, Iranian musicians, Singer-songwriters, Composers
Gopal Gurung	1935 births, 2016 deaths, Futurists, Journalists, Nepalese politicians
Mimmo Palmara	1928 births, 2016 deaths, Italian movie actors
Deaths in July 2016	2016 deaths, July 2016 events
Vasyl Slipak	1974 births, 2016 deaths, Ukrainian singers
Alfred Oftedal Telhaug	1934 births, 2016 deaths, Norwegian educators
Giuseppe Virgili	1935 births, 2016 deaths, Italian footballers, People from Udine
Rudi Altig	1937 births, 2016 deaths, German cyclists, People from Mannheim, Sportspeople from Baden-Württemberg
Scotty Moore	1931 births, 2016 deaths, American guitarists, American engineers, Musicians from Tennessee
Buddy Ryan	1931 births, 2016 deaths, Cancer deaths in the United States, American football coaches, Sportspeople from Oklahoma
Lake Chungará	Lakes of South America, Geography of Chile
Shaibu Amodu	1958 births, 2016 deaths, Nigerian footballers, Nigerian football managers
Dan Patrick	Emmy Award winners, 1956 births, Living people, American radio personalities, American movie actors, Actors from Ohio, People from Zanesville, Ohio
Sully (movie)	2016 drama movies, 2010s biographical movies, American biographical movies, American drama movies, English-language movies, Movies set in New York City, Movies set in the 2000s, Warner Bros. movies, Movies directed by Clint Eastwood
Asghar Bichareh	Iranian actors, 1927 births, 2016 deaths, Deaths from laryngeal cancer, Cancer deaths in Los Angeles, Photographers, People from Tehran
Bryan Robinson	1974 births, 2016 deaths, African American players of American football, American football defensive ends, American football defensive tackles, Arizona Cardinals players, Chicago Bears players, Cincinnati Bengals players, Miami Dolphins players, People from Toledo, Ohio, Sportspeople from Ohio, St. Louis Rams players
Lars Skytøen	1929 births, 2016 deaths, Norwegian politicians, Civil servants
Kunio Hatoyama	1948 births, 2016 deaths, Japanese politicians, Civil servants
Henk Hofland	1927 births, 2016 deaths, Dutch columnists, Dutch essayists, Dutch journalists, Writers from Rotterdam
Al Howie	1945 births, 2016 deaths, Deaths from diabetes, Disease-related deaths in Canada, Canadian sportspeople, People from Glasgow
Joan Acker	1924 births, 2016 deaths, American sociologists, American educators, Writers from Illinois
John William Ashe	1954 births, 2016 deaths, Antigua and Barbuda people, Deaths from myocardial infarction, Presidents of the United Nations General Assembly
Zurlon Tipton	1990 births, 2016 deaths, Deaths by firearm in the United States, Accidental deaths in the United States, Indianapolis Colts players, Sportspeople from Detroit, Michigan
Mrinal Sen	1923 births, 2018 deaths, Deaths from myocardial infarction, Indian movie directors
Inocente Carreño	1919 births, 2016 deaths, Deaths from pneumonia, Venezuelan people, Composers
Pee-wee's Big Holiday	2016 comedy movies, 2010s road movies, American comedy movies, American road movies, Comedy road movies, Netflix movies
UEFA Euro 1992	UEFA European Championship, 1992 in association football, 1992 in Europe, 1990s in Sweden, Football in Sweden, June events
UEFA Euro 2016 qualifying	2015 in association football, UEFA Euro 2016, 2014 in association football
Kuk (mythology)	Egyptian gods and goddesses
Schönwald, Bavaria	Towns in Bavaria
Ingólfr Arnarson	Icelandic people
Keflavík	Towns in Iceland, 16th century establishments in Europe, Establishments in Iceland
Hochdorf, Switzerland	Municipalities of Lucerne
Melchnau	Municipalities of Bern
Berken	Municipalities of Bern
Merzligen	Municipalities of Bern
Spanish treasure fleet	Spain, 16th century, 17th century, 18th century
Node.js	Free software, Linux software, Microsoft Windows software, JavaScript
World Population Day	Days
Stayin' Alive	1977 songs
Mirchel	Municipalities of Bern
Monible	Former municipalities of Bern
Romesh Chandra	1919 births, 2016 deaths, Indian activists
Turgay Şeren	1932 births, 2016 deaths, Turkish footballers
Valentino Zeichen	1938 births, 2016 deaths, Italian writers, Poets
Gunnar Garbo	1924 births, 2016 deaths, Ambassadors of Norway, Norwegian journalists, Norwegian politicians
Ojo Maduekwe	1945 births, 2016 deaths, Nigerian politicians
Donald Carr	1926 births, 2016 deaths, English cricketers
Vladimir Dolgopolov	1961 births, 2016 deaths, Russian footballers, People from Saint Petersburg
Alfonso Portugal	1934 births, 2016 deaths, Mexican footballers
Vasily Bochkaryov	1949 births, 2016 deaths, Russian politicians
Jim Boyd (musician)	1956 births, 2016 deaths, Actors from Los Angeles County, California, Actors from Washington, American movie actors, American singer-songwriters, Singers from Los Angeles County, California, Singers from Washington, Writers from Los Angeles County, California, Writers from Washington
David J. Hickson	1931 births, 2016 deaths, British educators, People from Manchester
Yaşar Nuri Öztürk	1951 births, 2016 deaths, Deaths from stomach cancer, Turkish politicians, Turkish lawyers, Turkish educators
Harry Rabinowitz	1916 births, 2016 deaths, Composers, Conductors, Jewish centenarians, Jewish musicians, People from Johannesburg, South African entertainers, South African Jews, White South African people
Samir Roychoudhury	1933 births, 2016 deaths, Indian poets
Amjad Sabri	1976 births, 2016 deaths, Deaths by firearm, Pakistani singers
James Green	1944 births, 2016 deaths, Deaths from leukemia, American historians, American educators, American activists, Writers from Illinois, People from Oak Park, Illinois
Stanley Mandelstam	1928 births, 2016 deaths, Alumni of the University of Cambridge, American physicists, Foreign Members of the Royal Society, Jewish American academics, Jewish American scientists, Naturalized citizens of the United States, People from Johannesburg, South African Jews, Theoretical physicists
Paul Cox	1940 births, 2016 deaths, Australian educators, Australian movie directors, Australian screenwriters, Cancer deaths in Australia, Deaths from liver cancer, Naturalised citizens of Australia, People from Venlo, Photographers, Writers from Limburg (Netherlands)
William J. Livsey	1931 births, 2016 deaths, American military people, People from Georgia (U.S. state)
Claude Confortès	1928 births, 2016 deaths, French movie directors, French movie actors, French stage actors, Actors from Paris
Ofelya Hambardzumyan	1925 births, 2016 deaths, Armenian people, Folk singers
Giuseppe Ferrara	1932 births, 2016 deaths, Deaths from cardiac arrest, Deaths from pneumonia, Italian movie directors, Italian screenwriters, People from Florence
Vittorio Merloni	1933 births, 2016 deaths, Italian businesspeople
Wu Jianmin	1939 births, 2016 deaths, Chinese politicians, Ambassadors of China
Randy Jones (drummer)	1944 births, 2016 deaths, Naturalized citizens of the United States, British drummers, British jazz musicians, American jazz musicians, American drummers, Musicians from Berkshire
Oleg Karavaychuk	1927 births, 2016 deaths, Russian composers, Russian writers, People from Kiev
Bur’i Mohamed Hamza	2016 deaths, Somali politicians, 1940s births
Freehold Township, New Jersey	Townships in New Jersey, Monmouth County, New Jersey
Ocean City, New Jersey	Cities in New Jersey
Titan (Six Flags Over Texas)	2001 establishments in the United States, Roller coasters in Texas, 2000s establishments in Texas
Chips Moman	1937 births, 2016 deaths, American guitarists, American songwriters, Deaths from emphysema, Disease-related deaths in Georgia (U.S. state), Grammy Award winners, Musicians from Georgia (U.S. state), Writers from Georgia (U.S. state)
Patrick Mayhew	1929 births, 2016 deaths, British politicians
James Gilbert (producer)	1923 births, 2016 deaths, Television directors, Television producers, People from Edinburgh
Riddick Bowe	1967 births, Living people, African-American boxers, American Olympic silver medalists, Medalists at the 1988 Summer Olympics, Sportspeople from Brooklyn
Bill Berkson	1939 births, 2016 deaths, Deaths from myocardial infarction, American poets, American art critics, American educators, Writers from New York City
Mohapatra Nilamani Sahoo	1926 births, 2016 deaths, Deaths from multiple organ failure, Indian writers
Irving Moskowitz	1928 births, 2016 deaths, American Jews, American philanthropists, American physicians, Businesspeople from New York City, Jewish businesspeople, Jewish philanthropists
Anatoli Grishin	1939 births, 2016 deaths, Soviet sportspeople, People from Moscow
Ann Morgan Guilbert	1928 births, 2016 deaths, Deaths from cancer of unknown primary origin, Cancer deaths in Los Angeles, American movie actors, American television actors, Actors from Minneapolis, Minnesota
UEFA Euro 1988	UEFA European Championship, 1988 in association football, 1980s in Germany, Football in Germany
Pat Suggate	1922 births, 2016 deaths, New Zealand scientists, Geologists, Scientists from London
Jerome Teasley	1948 births, 2016 deaths, Deaths from lung cancer, Deaths from liver cancer, American drummers, American soul musicians, Musicians from Detroit, Michigan
Elmer Cravalho	1926 births, 2016 deaths, American mayors, Politicians from Hawaii, US Democratic Party politicians
Pelle Gudmundsen-Holmgreen	1932 births, 2016 deaths, Deaths from cancer, Danish composers, People from Copenhagen
Harry Halbreich	1931 births, 2016 deaths, Belgian musicians, Belgian writers, Belgian educators, Musicologists, Writers from Berlin
Mack Rice	1933 births, 2016 deaths, Deaths from Alzheimer's disease, American singer-songwriters, Singers from Mississippi, Writers from Mississippi
Alvin Toffler	1928 births, 2016 deaths, Businesspeople from New York City, Futurists, Writers from New York City
Gertrude Kerbis	1926 births, 2016 deaths, Deaths from liver cancer, Cancer deaths in Chicago, Architects from Chicago
Henry McCullough	1943 births, 2016 deaths, Irish musicians, Irish singers, Songwriters
Gregory Rabassa	1922 births, 2016 deaths, American educators, Writers from New York City
Austin Clarke (novelist)	1934 births, 2016 deaths, Barbadian people, Canadian educators, Canadian writers, People from Toronto
Military orders, awards and decorations	Orders, decorations, and medals
Arrondissements of the Corrèze department	Arrondissements of France
Barbara Goldsmith	1931 births, 2016 deaths, Deaths from heart failure, American journalists, American philanthropists, Writers from New York City
Irma Roy	1932 births, 2016 deaths, Accidental deaths from falls, Argentine politicians, Argentine movie actors, Actors from Buenos Aires
Robert T. Paine	1933 births, 2016 deaths, Deaths from acute myeloid leukemia, Cancer deaths in the United States, Ecologists, American educators, Scientists from Massachusetts, Scientists from Washington, People from Cambridge, Massachusetts
Acute myeloid leukemia	Cancer
Appendix cancer	Cancer
Gastrointestinal cancer	Cancer
Ryan Jimmo	1981 births, 2016 deaths, Murder victims, Canadian sportspeople, Mixed martial artists, People from New Brunswick
Kim Sung-min	1973 births, 2016 deaths, Suicides by hanging, South Korean movie actors, South Korean television actors, People from Seoul
Kavalam Narayana Panicker	1928 births, 2016 deaths, Deaths from respiratory failure, Indian poets, People from Kerala
Rostislav Yankovsky	1930 births, 2016 deaths, Belarusian people, Movie actors, Stage actors, People from Odessa
Nicolás García Uriburu	1937 births, 2016 deaths, Artists, Architects, Ecologists, People from Buenos Aires
Sverre Kjelsberg	1946 births, 2016 deaths, Norwegian singers, Norwegian composers, Guitarists
Ricardo Obregón Cano	1917 births, 2016 deaths, Argentine politicians
Götz George	1938 births, 2016 deaths, German movie actors, German television actors, Actors from Berlin
Frank Chapot	1932 births, 2016 deaths, Sportspeople from New Jersey, People from Camden, New Jersey
Benoîte Groult	1920 births, 2016 deaths, French journalists, Activists, Writers from Paris
Rich Olive	1949 births, 2016 deaths, Politicians from Maryland, Politicians from Iowa, Businesspeople from Iowa, Businesspeople from Maryland, US Democratic Party politicians, People from Bethesda, Maryland
Chayito Valdez	1945 births, 2016 deaths, Deaths from cerebral hemorrhage, Naturalized citizens of the United States, Mexican singers, Mexican movie actors, Sinaloa, Actors from Los Angeles, California, Singers from Los Angeles, California
Edgard Pisani	1918 births, 2016 deaths, 20th century philosophers, 21st century philosophers, French philosophers, French writers, Government ministers of France
Cinna Lomnitz	1925 births, 2016 deaths, Chilean scientists, German Jews, Jewish scientists, Mexican Jews, Mexican scientists, People from Cologne, South American Jews
Leonard Lee	1938 births, 2016 deaths, Deaths from vascular dementia, Canadian businesspeople, People from Saskatchewan
Eora	People from New South Wales, Indigenous Australian people
2016 shooting of Dallas police officers	2016 in Texas, 2016 mass shootings, 2016 murders in the United States, 2010s crimes in Texas, 2010s mass shootings in the United States, 21st century in Dallas, Texas, July 2016 events, Law enforcement in the United States, Mass murder in 2016, Mass murder in Texas, Mass shootings in Texas, Murders by firearm in Texas
Thrift Shop (song)	2012 songs
Mont-Tramelan	Municipalities of Bern
Moosseedorf	Municipalities of Bern
Mörigen	Municipalities of Bern
Javed Akhtar (cricketer)	1940 births, 2016 deaths, Pakistani cricketers
John O'Rourke (footballer)	1945 births, 2016 deaths, English footballers, People from Northampton
Rahul Dravid	Indian cricketers, 1973 births, Living people
Bühl	Municipalities of Bern
Mötschwil	Municipalities of Bern
Moutier	Cities in Switzerland, Municipalities of Bern
Altenhohenau	Buildings and structures in Bavaria, Christianity in Germany, Monasteries
Mühleberg	Municipalities of Bern
Arrondissement of Brive-la-Gaillarde	Arrondissements of France
Mühledorf, Bern	Former municipalities of Bern
Mühlethurnen	Former municipalities of Bern
Carmelo Borg Pisani	1915 births, 1942 deaths, British artists, Italian military people, Maltese activists, Military personnel of World War II, People executed by hanging, People who lost citizenship, Spies
Arrondissement of Tulle	Arrondissements of France
Arrondissement of Ussel	Arrondissements of France
Choi-Yong-kun	1900 births, 1976 deaths, North Korean politicians, Deaths from myocardial infarction, Communists
Comma-separated values	Data structures
Mülchi	Former municipalities of Bern
Münchenbuchsee	Municipalities of Bern
Angiosperm Phylogeny Group	Plant taxonomy, Scientific organizations
Attiswil	Municipalities of Bern
Abdul Sattar Edhi	1928 births, 2016 deaths, Deaths from renal failure, Asian philanthropists, Activists, Pakistani people
Kapil Dev	1959 births, Indian cricketers, Living people
Münchenwiler	Municipalities of Bern
Münchringen	Former municipalities of Bern
Münsingen	Municipalities of Bern, Cities in Switzerland
Müntschemier	Municipalities of Bern
Battle of Shepherdstown	American Civil War battles, 1862 in the United States, Maryland Campaign, September 1862 events
Ussel, Corrèze	Subprefectures in France, Communes in Corrèze
Hekatonkheires	Greek legendary creatures
Neuenegg	Municipalities of Bern
Nidau	Cities in Switzerland, Municipalities of Bern
Niederbipp	Municipalities of Bern
Ebbs	Cities and towns in Tyrol (state)
Milos Raonic	1990 births, Living people, Canadian tennis players, Canadian Olympians, Competitors at the 2012 Summer Olympics, Male tennis players, Montenegrin sportspeople, Naturalized citizens of Canada, Sportspeople from Ontario
Antonino Natoli of Patti	Roman Catholic priests
Greg Rusedski	1973 births, 1996 Summer Olympics, 2000 Summer Olympics, British columnists, British male tennis players, British Olympians, Canadian tennis players, Dancing on Ice participants, Living people, Sportspeople from Montreal, Tennis broadcasters
Eugenie Bouchard	1994 births, Living people, Canadian tennis players, Female tennis players, Sportspeople from Montreal, Twin people from Canada
Niederhünigen	Municipalities of Bern
Dotzigen	Municipalities of Bern
Niedermuhlern	Municipalities of Bern
Niederönz	Municipalities of Bern
Niederösch	Former municipalities of Bern, 2016 disestablishments in Switzerland
Johnny Barnes	1923 births, 2016 deaths, Bermudian people, North American entertainers
Geneviève Castrée	1981 births, 2016 deaths, Comics artists, Deaths from pancreatic cancer, Musicians from Quebec
Vaughn Harper	1945 births, 2016 deaths, Deaths from diabetes, American radio personalities, People from New York City
Wolfram Siebeck	1928 births, 2016 deaths, German critics, German journalists, People from Duisburg
Silvano Piovanelli	1924 births, 2016 deaths, Cardinals of the Roman Catholic Church, Italian Roman Catholics, People from Florence, Roman Catholic archbishops
Jacques Rouffio	1928 births, 2016 deaths, French movie directors, French screenwriters
Harold A. Linstone	1924 births, 2016 deaths, American academics, American mathematicians, Futurists, German mathematicians, Naturalized citizens of the United States, People from Hamburg
Mamnoon Hussain	1940 births, 2021 deaths, Presidents of Pakistan, Pakistani businesspeople, Deaths from cancer
FreeThe20 campaign	Human rights
Sydney Schanberg	1934 births, 2016 deaths, American war correspondents, Cardiovascular disease deaths in New York, Deaths from myocardial infarction, Pulitzer Prize winners, Writers from Massachusetts
Clinton, Massachusetts	Towns in Massachusetts, 1654 establishments, 1650s establishments in Massachusetts
Anatoli Isayev	1932 births, 2016 deaths, Russian footballers, Sportspeople from Moscow
Aziza Siddiqui	Women who received the International Women of Courage Award, Afghan activists, Year of birth missing (living people), Living people, Human rights activists
Sundus Abbas	Year of birth missing (living people), Living people, Iraqi people, Human rights activists, Women who received the International Women of Courage Award
Shatha Abdul Razzak Abbousi	1964 births, Living people, Human rights activists, Iraqi politicians, People from Baghdad, Women who received the International Women of Courage Award
Corrèze (river)	Rivers of France, Nouvelle-Aquitaine
Alfred G. Knudson	1922 births, 2016 deaths, Scientists from Philadelphia, Pennsylvania, Scientists from Los Angeles, California
Marcelo Rebelo de Sousa	1949 births, Living people, Presidents of Portugal, Current national leaders, People from Lisbon
António Ramalho Eanes	1935 births, Living people, Generals, Portuguese military people, Presidents of Portugal, Roman Catholics
Manuel Alegre	1936 births, Living people, Portuguese politicians, Portuguese writers, Poets, Socialists
Dith Pran	1942 births, 2016 deaths, Deaths from pancreatic cancer, Cancer deaths in New Jersey, Cambodian people, Photojournalists, War correspondents
Sally Yates	1960 births, Living people, American lawyers, Politicians from Atlanta, Georgia, United States Attorneys General, US Democratic Party politicians, United States Deputy Attorneys General
Sylvia Mathews Burwell	1965 births, Living people, Politicians from West Virginia, United States Secretaries of Health and Human Services, Directors of the Office of Management and Budget
Simone Veil	1927 births, 2017 deaths, Abortion-rights activists, Christian democrats, Civil servants, Former MEPs, French lawyers, Government ministers of France, Holocaust survivors, Jewish activists, Jewish French politicians, Jewish lawyers, Jewish women politicians, Legion of Honour, MEPs for France, People from Nice, Presidents of the European Parliament
United States Deputy Attorney General	United States Attorneys General, 1950 establishments in the United States, United States Deputy Attorneys General
List of prime ministers of India	Prime Ministers of India, India-related lists
Prugiasco	Villages in Ticino, Former municipalities of Ticino
Niederried bei Interlaken	Municipalities of Bern
Jens, Switzerland	Municipalities of Bern
Niederried bei Kallnach	Former municipalities of Bern
Vindhyas	Mountain ranges, Mountains of India
Niederstocken	Former municipalities of Bern
Nods, Switzerland	Municipalities of Bern
Noflen	Former municipalities of Bern
Antiarchi	Fossils, Placoderms
Sally Beauman	1944 births, 2016 deaths, Deaths from pneumonia, English journalists, Writers from Devon
Robert E. Cooper, Sr.	1920 births, 2016 deaths, American judges, People from Chattanooga, Tennessee, Politicians from Tennessee
Odette Krempin	1973 births, Living people, African businesspeople, People from the Democratic Republic of the Congo, African philanthropists
Racine, Wisconsin	Cities in Wisconsin, County seats in Wisconsin
Oberbalm	Municipalities of Bern
Green Party (Norway)	Political parties in Norway, Green political parties
Motion of no confidence	Voting, Politics
Angela Eagle	1961 births, Living people, Alumni of the University of Oxford, English LGBT people, Labour MPs (UK), Lesbians, LGBT politicians, Members of the British House of Commons for English constituencies, Politicians from Yorkshire, UK MPs 1992–1997, UK MPs 1997–2001, UK MPs 2001–2005, UK MPs 2005–2010, UK MPs 2010–2015, UK MPs 2015–2017, UK MPs 2017–2019
Heidi Alexander	1975 births, Living people, Labour MPs (UK), People from Wiltshire
Gloria de Piero	1972 births, Living people, Labour MPs (UK), British journalists
Ian Murray (British politician)	1976 births, Living people, Labour MPs (UK)
Lilian Greenwood	1966 births, Living people, Labour MPs (UK)
John McDonnell	1951 births, Living people, British anti–Iraq War activists, Labour MPs (UK), UK MPs 1997–2001, UK MPs 2001–2005, UK MPs 2005–2010, UK MPs 2010–2015, UK MPs 2015–2017, UK MPs 2017–2019, UK MPs 2019–, People from Liverpool
Jon Trickett	1950 births, Living people, Labour MPs (UK)
Angela Smith, Baroness Smith of Basildon	1959 births, Living people, Labour MPs (UK), Politicians from London
Emily Thornberry	1960 births, Living people, Labour MPs (UK), People from Surrey
Steve Bassam, Baron Bassam of Brighton	1953 births, Living people, Labour Party (UK) people, Members of the House of Lords, Politicians from Essex, Privy Councillors (UK)
Lucy Powell	1979 births, Living people, Labour MPs (UK)
Kerry McCarthy	1956 births, Living people, Labour MPs (UK)
Seema Malhotra	1972 births, Living people, Labour MPs (UK)
Vernon Coaker	1953 births, Living people, Labour MPs (UK), Members of the British House of Commons for English constituencies, Politicians from London, UK MPs 1997–2001, UK MPs 2001–2005, UK MPs 2005–2010, UK MPs 2010–2015, UK MPs 2015–2017, UK MPs 2017–2019
Charles Falconer, Baron Falconer of Thoroton	1951 births, Living people, Alumni of the University of Cambridge, British lawyers, People from Edinburgh
Chris Bryant	1962 births, Living people, Alumni of the University of Oxford, BBC people, Labour MPs (UK), LGBT Christians, LGBT politicians, Members of the British House of Commons for Welsh constituencies, People from Cardiff, Politicians from Glamorgan, UK MPs 2001–2005, UK MPs 2005–2010, UK MPs 2010–2015, UK MPs 2015–2017, UK MPs 2017–2019
John Chilcot	1939 births, Living people, Alumni of the University of Cambridge, Civil servants
Time in Algeria	Time by country, Algeria
Tarapacá Region	Regions of Chile
Adewale Akinnuoye-Agbaje	1967 births, Living people, British movie actors, British television actors, British voice actors, Actors from London
John Brademas	1927 births, 2016 deaths, Alumni of the University of Oxford, American educators, American Methodists, Harvard University alumni, Politicians from New York City, United States representatives from Indiana, US Democratic Party politicians
Jusztin Nándor Takács	1927 births, 2016 deaths, Deaths from pneumonia, Hungarian Roman Catholics, Roman Catholic bishops
CS Pandurii Târgu Jiu	Romanian football clubs, 1963 establishments in Europe, 20th century establishments in Romania
2015–16 Liga I	2016 in association football
Hooghly River	Rivers of India, Rivers of West Bengal
Oberbipp	Municipalities of Bern
Oberburg	Municipalities of Bern
Oberdiessbach	Municipalities of Bern
Hematopoiesis	Blood cells
Møre og Romsdal	Counties of Norway
Ålesund	Cities in Norway, Municipalities of Norway, 1837 establishments, 1830s establishments in Europe, 19th century establishments in Norway
Iquique Province	Provinces of Chile
William H. McNeill (historian)	1917 births, 2016 deaths, American educators, American historians, American military personnel of World War II, American writers, Canadian educators, Canadian historians, Cornell University alumni, People from Vancouver, University of Chicago alumni, Writers from British Columbia
María Dolores Pradera	1924 births, 2018 deaths, Spanish movie actors, Spanish singers, People from Madrid
Emma Cohen	1946 births, 2016 deaths, Cancer deaths in Spain, Spanish movie actors, Spanish movie directors, Spanish movie producers, Spanish screenwriters, People from Barcelona
Corrado Farina	1939 births, 2016 deaths, Deaths from myocardial infarction, Italian movie directors, Italian screenwriters
Jim Metzen	1943 births, 2016 deaths, Deaths from lung cancer, Cancer deaths in Minnesota, Politicians from Minnesota
Tamarugal	Provinces of Chile
Goran Hadžić	1958 births, 2016 deaths, Deaths from brain cancer, Presidents (government), Serbian people
Terence Hill	1939 births, Living people, Italian movie actors, People from Venice
Time in Jordan	Time by country, Jordan
Time in Belarus	Time by country, Belarus
Alexander Chizhevsky	1897 births, 1964 deaths, Russian scientists, Soviet people
Andrés Bello Catholic University	Colleges and universities in South America, Caracas, 1953 establishments in South America, 20th-century establishments in Venezuela
FC Pyunik	Armenian football clubs
2017 Africa Cup of Nations	2017 in association football, 2017 in Africa, Africa Cup of Nations, February 2017 events, January 2017 events, Sport in Gabon
Bridge Road (Impington)	1962 establishments in England, Football stadiums in England, Cambridgeshire
Jamui	Settlements in Bihar, Towns in India
International Braille Chess Association	Disability, Chess organizations, International organizations
Padma Shri	Indian awards
Marit Nybakk	1947 births, Norwegian politicians
Padma Vibhushan	Indian awards
Oberhofen am Thunersee	Municipalities of Bern
Oberhünigen	Municipalities of Bern
Padma Bhushan	Indian awards
Oberlangenegg	Municipalities of Bern
Duncan Fletcher	Cricketers
Oberönz	Former municipalities of Bern
Oberösch	Former municipalities of Bern, 2016 disestablishments in Switzerland
Elaine Fantham	1933 births, 2016 deaths, British educators, Writers from Liverpool
Oberried am Brienzersee	Municipalities of Bern
Bernardo Provenzano	1933 births, 2016 deaths, Deaths from bladder cancer, Criminals, People from Sicily
Obersteckholz	Municipalities of Bern
Zygmunt Zimowski	1949 births, 2016 deaths, Deaths from pancreatic cancer, Polish Roman Catholics, Roman Catholic bishops
Oberstocken	Former municipalities of Bern
Stocken-Höfen	Municipalities of Bern, 2014 establishments in Switzerland
Oberthal, Switzerland	Municipalities of Bern
Oberwil bei Büren	Municipalities of Bern
Oberwil im Simmental	Municipalities of Bern
Ochlenberg	Municipalities of Bern
Oeschenbach	Municipalities of Bern
Oppligen	Municipalities of Bern
Bui Thi Minh Hang	Vietnamese people, Political activists, Year of birth missing (living people), Living people, Political prisoners
El Lebrijano	1941 births, 2016 deaths, Spanish singers
Armando León Bejarano	1916 births, 2016 deaths, Deaths from pneumonia, Mexican politicians, Mexican physicians, Surgeons
Amber Rudd	1963 births, Living people, Writers from London, Conservative MPs (UK), UK MPs 2010–2015, UK MPs 2015–2017, UK MPs 2017–2019, Secretaries of State for the Home Department, Privy Councillors (UK)
Michael Fallon	1952 births, Living people, Conservative MPs (UK)
Xavier Becerra	1958 births, Living people, United States Secretaries of Health and Human Services, United States representatives from California, Politicians from Sacramento, California, US Democratic Party politicians, State legislators of the United States, 21st-century American politicians, 20th-century American politicians
James G. Stavridis	1955 births, Living people, American military people, American educators, People from Florida
Tim Ryan (politician)	1973 births, Living people, 2020 United States presidential candidates, American Roman Catholics, United States representatives from Ohio, US Democratic Party politicians
Hallard White	1929 births, 2016 deaths, Deaths from Alzheimer's disease, New Zealand rugby union players, People from Auckland
The Adventures of Milo and Otis	1986 drama movies, 1980s adventure movies, 1980s family movies, Japanese-language movies, Japanese movies, Movies about cats, Movies about dogs
Orpund	Municipalities of Bern
Orvin	Municipalities of Bern
Ostermundigen	Municipalities of Bern, Cities in Switzerland
Ashoka Chakra (military decoration)	Indian awards
The Missing Link (movie)	1980 comedy movies, French animated movies, Belgian movies
Dadasaheb Phalke Award	Indian awards, 1962 establishments in Asia, Movie awards, 1960s establishments in India
Arrondissements of the Charente department	Arrondissements of France
Perrefitte	Municipalities of Bern
Coglio	2004 disestablishments in Switzerland, Villages in Ticino, Former municipalities of Ticino
Exo discography	Exo, Discographies
Overdose (EP)	2014 albums, Exo albums
2016 Nice attack	2016 in France, 2010s crimes in France, 2010s murders in Europe, Islamic terrorist incidents in 2016, Islamic terrorist incidents in Europe, July 2016 events, Massacres in Europe, Mass murder in 2016, Mass murder in France, Nice, Terrorist incidents in Europe in 2016, Terrorist incidents in France, Terrorist incidents involving vehicular attacks
Miracles in December	Exo albums, 2013 albums
Wilfredo Gómez	Boxers, Sportspeople from Puerto Rico, Living people, Year of birth missing (living people)
Zuzana Stevulova	1984 births, Living people, Slovakian people, Women who received the International Women of Courage Award, Human rights activists
Péry	Former municipalities of Bern
Péry-La Heutte	Municipalities of Bern, 2015 establishments in Switzerland
Pieterlen	Municipalities of Bern
Hohenrain	Municipalities of Lucerne
Plagne, Switzerland	Former municipalities of Bern
Pohlern	Municipalities of Bern
Pontenet	Former municipalities of Bern, 2015 disestablishments in Switzerland
Valbirse	Municipalities of Bern, 2015 establishments in Switzerland
Port, Switzerland	Municipalities of Bern
Sivaji Ganesan	1928 births, 2001 deaths, Indian actors, Tamil actors
Prêles	Former municipalities of Bern
Plateau de Diesse	Municipalities of Bern, 2014 establishments in Switzerland
Pokémon Go	Android (operating system) games, 2016 video games, IOS games, Pokémon video games
Sing for You	Exo albums, 2015 albums
Time in North Korea	Time by country, North Korea
Radelfingen	Municipalities of Bern
Nassau (state)	Former countries in Europe
Exo's Showtime	Exo
Arrondissement of Angoulême	Arrondissements of France
Rise (Katy Perry song)	2016 songs, Katy Perry songs, Pop songs
Arrondissement of Cognac	Arrondissements of France
Time in China	Time by country, China
Arrondissement of Confolens	Arrondissements of France
List of districts in Jammu and Kashmir	Divisions of Jammu and Kashmir, India-related lists
2016 Turkish coup d'état attempt	2016 in Turkey, Ankara, Coups d'état, Istanbul, July 2016 events, Politics of Turkey
Rapperswil, Bern	Municipalities of Bern
Army of Mississippi	Confederate States of America, 1862 establishments in the United States
Holding company	Law, Economics
Blen Mesfin	20th century births, Ethiopian people, Ethiopian politicians, Living people, Political activists, Political prisoners
Confolens	Subprefectures in France, Communes in Charente
Bluebird	Thrushes
Lemon Tree (Fool's Garden song)	1995 songs, Pop songs
Corps	Military terminology
Carnivorous fungus	Fungi
Army of the Mississippi	Union Army
Battle of Chancellorsville	American Civil War battles, 1863 in the United States, 1860s in Virginia
Hugo Niebeling	1931 births, 2016 deaths, German movie directors, German movie producers
Erny Brenner	1931 births, 2016 deaths, European footballers, Luxembourgian sportspeople
Robert Burren Morgan	1925 births, 2016 deaths, Deaths from heart failure, United States senators from North Carolina, US Democratic Party politicians
Kazimieras Uoka	1951 births, 2016 deaths, Lithuanian politicians
Torpor	Physiology
Moju Chowdhury Hat	Settlements in Bangladesh
The Da Vinci Code (movie)	Controversies, 2006 drama movies, American drama movies, British drama movies, French drama movies, Maltese movies, Buena Vista International movies, Columbia Pictures movies, Movies directed by Ron Howard, Screenplays by Akiva Goldsman
Fatshe leno la rona	National anthems, Botswana
God Bless America	20th century songs
Cochineal	Insects
Battle of Fredericksburg	American Civil War battles, 1862 in Virginia, December events
Charente (river)	Rivers of France, Nouvelle-Aquitaine
Nate Thurmond	1941 births, 2016 deaths, Deaths from leukemia, Golden State Warriors players, Cleveland Cavaliers players, Chicago Bulls players, Sportspeople from Akron, Ohio, National Basketball Association players with retired numbers
Bloeme Evers-Emden	1927 births, 2016 deaths, Dutch academics, Dutch columnists, Dutch Jews, Dutch scientists, Holocaust survivors, Jewish academics, Jewish scientists, Jewish writers, Dutch psychologists, Writers from Amsterdam
Qandeel Baloch	1990 births, 2016 deaths, Activists, Actors, Deaths from asphyxiation, Models, Pakistani people, People murdered in Pakistan, Assassinated people, Murdered musicians, Pakistani murder victims, Pakistani singers
Janez Bernik	1933 births, 2016 deaths, Slovenian poets, Painters, Educators
Billy Name	1940 births, 2016 deaths, American photographers, LGBT people from New York, People from Poughkeepsie, New York
Duncan M. Gray, Jr.	1926 births, 2016 deaths, American civil rights activists, Bishops, Episcopalians, People from Jackson, Mississippi
Sharon Runner	1954 births, 2016 deaths, Deaths from respiratory failure, Politicians from California, Businesspeople from California, US Republican Party politicians, State legislators of the United States
Helena Benitez	1914 births, 2016 deaths, Filipino politicians, Activists, Centenarians, People from Manila
Péter Esterházy	1950 births, 2016 deaths, Deaths from pancreatic cancer, Hungarian writers, People from Budapest
Rappahannock River	Rivers of Virginia
Dronne	Rivers of France, Nouvelle-Aquitaine
Michael J. Elliott	1951 births, 2016 deaths, Alumni of the University of Oxford, Cancer deaths in Washington, D.C., Deaths from bladder cancer, Disease-related deaths in Washington, D.C., English journalists, Writers from Liverpool
Gary S. Paxton	Grammy Award winners, 1939 births, 2016 deaths, Deaths from hepatitis, Disease-related deaths in Missouri, American songwriters, Writers from Kansas
Abu Omar al-Shishani	1986 births, 2016 deaths, Deaths by airstrike, Asian military people, European military people, Georgian people, Islamic State people
Carolyn See	1934 births, 2016 deaths, Cancer deaths in California, American educators, American critics, Writers from California, People from Pasadena, California
Hollis L. Harris	1931 births, 2016 deaths, Businesspeople from Georgia (U.S. state)
Héctor Babenco	1946 births, 2016 deaths, Deaths from myocardial infarction, Argentine movie directors, Argentine movie producers, Argentine movie actors, Brazilian screenwriters, Brazilian movie producers, Brazilian movie actors, Brazilian movie directors, People from Buenos Aires
Robert Ross (Royal Marines officer)	Year of birth unknown, 1794 deaths, First Fleet, Majors, Royal Navy officers
Quota	Latin words used in English
The Intern	2015 comedy movies, American comedy movies, English-language movies, Movies set in Brooklyn, Warner Bros. movies
Manuel G. Batshaw	1915 births, 2016 deaths, Civil servants, Centenarians, People from Montreal
XOXO	2013 albums, Exo albums
Ex'Act	2016 albums, Exo albums
List of awards and nominations received by Exo	Exo, Lists of awards and nominations
Thrombus	Blood
Mud March	Union Army, 1863 in the United States, 1860s in Virginia
Political prisoner	Human rights abuses, Freedom
Yuya Matsushita	Japanese singers, 1990 births
Matlyuba Kamilova	1960 births, Living people, Uzbekistani people, Human rights activists, Political prisoners
David Farragut	1801 births, 1870 deaths, Admirals, Military personnel of the American Civil War, People from Knoxville, Tennessee, American folklore, Freemasons, United States Navy
Graeae	Greek mythology
Mymensingh Division	Divisions of Bangladesh
Demonstration (military)	Military terminology
Battle of Falling Waters	American Civil War battles, 1863 in the United States, 19th century in Maryland, July 1863 events
Rasha Sharbaji	1982 births, Syrian people, Living people
Elizabeth Morgan case	Trials in the United States, 20th century in law, 20th century in Washington, D.C., 20th century in New Zealand
Frankfurt Galaxy	Frankfurt Galaxy
Colobinae	Old World monkeys
Vervet monkey	Old World monkeys, Mammals of Africa
Wagon train	Land transport
D minor	Musical keys, Minor scales
List of communes of the Province of Terni	Settlements in Umbria, Lists of settlements in Europe
Ballotpedia	Websites, Non-profit organizations of the United States, 2007 establishments in the United States
Anne Holton	1958 births, Living people, American educators, Politicians from Virginia
Karen Pence	1958 births, Living people, American educators, American painters, People from Indianapolis, Indiana, People from Kansas, Second Ladies of the United States
Football at the 2016 Summer Olympics	2016 Summer Olympics, 2016 in association football, Olympic football tournaments
Pointe-Noire	Settlements in the Republic of the Congo
Bouenza Department	Departments of the Republic of the Congo
Cuvette Department	Departments of the Republic of the Congo
Cuvette-Ouest Department	Departments of the Republic of the Congo
Lékoumou Department	Departments of the Republic of the Congo
Likouala Department	Departments of the Republic of the Congo
Niari Department	Departments of the Republic of the Congo
Plateaux Department (Republic of the Congo)	Departments of the Republic of the Congo
The Fold	Musical groups from Chicago
Gambler's fallacy	Mathematics
Repentless	Slayer albums, 2015 albums
Remi Sonaiya	1955 births, Living people, Nigerian politicians, Nigerian writers
David Woodard	1964 births, Living people, Writers from California, American conductors, People from Santa Barbara, California, American artists
Field artillery in the American Civil War	American Civil War, Artillery
Rebévelier	Municipalities of Bern
Reconvilier	Municipalities of Bern
Pome	Fruits, Rosaceae
Nera (Italy)	Rivers of Italy
Jacqueline Fernandez	1985 births, Living people, Sri Lankan people, Beauty pageant winners, University of Sydney alumni
John Abraham	1972 births, Living people, Indian actors, People from Mumbai
Agadir	Cities in Morocco
Cheap Thrills	2016 songs, Reggae songs
Merced, California	Cities in California, County seats in California, Settlements in Merced County, California
Slaughterhouse-Five	Science fiction books, 1969 books, Time travel
Antofagasta Region	Regions of Chile
Levi's Stadium	San Francisco 49ers, Stadiums in the San Francisco Bay Area, Santa Clara County, California, Santa Clara, California
Gunmetal	Alloys
GNK Dinamo Zagreb	Establishments in Croatia, 1945 establishments in Europe, Croatian football clubs
FC Astana	2009 establishments in Asia, Football clubs, Nur-Sultan
Ashdod	Ports and harbours of Israel, Cities in Israel
The end justifies the means	Phrases, Political philosophy, Ethics
Political philosophy	Philosophy, Politics
Courtelary (district)	Former districts of Bern
Reichenbach im Kandertal	Municipalities of Bern, Villages in Bern
Reisiswil	Municipalities of Bern
Renan, Switzerland	Municipalities of Bern
Model 1857 12-Pounder Napoleon Field Gun	American Civil War, Artillery
Reutigen	Municipalities of Bern
Riggisberg	Municipalities of Bern
Ringgenberg	Municipalities of Bern
Roches, Switzerland	Municipalities of Bern
Rohrbach, Switzerland	Municipalities of Bern
Rohrbachgraben	Municipalities of Bern
Romont, Bern	Municipalities of Bern
Loa River	Rivers of Chile
Rajesh Hamal	20th century births, Living people, Nepalese movie actors, People from Kathmandu, Year of birth missing (living people), Nepalese movie producers
Nepal Standard Time	Time by country, Nepal
Erlach (district)	Former districts of Bern
Fraubrunnen (district)	Former districts of Bern
Gamboma	Settlements in the Republic of the Congo
Frutigen (district)	Former districts of Bern
Djambala	Settlements in the Republic of the Congo
Ewo	Settlements in the Republic of the Congo
Impfondo	Settlements in the Republic of the Congo
Jenny von Westphalen	1814 births, 1881 deaths
Röthenbach bei Herzogenbuchsee	Former municipalities of Bern
Röthenbach im Emmental	Municipalities of Bern
Rubigen	Municipalities of Bern
Rüderswil	Municipalities of Bern
Rüdtligen-Alchenflüh	Municipalities of Bern
Smoothbore	Firearms, Weapons
Rüeggisberg	Municipalities of Bern
Rüegsau	Municipalities of Bern
Rumendingen	Municipalities of Bern
Rumisberg	Municipalities of Bern
Rümligen	Municipalities of Bern
Muzzleloader	Firearms, Weapons
The Charge of the Light Brigade (poem)	British poems
Blowback	Firearms
Llullaillaco	Volcanoes of Chile, Mountains of Argentina, Andes, Archaeological sites
List of Nepalese actors	Lists of entertainers, Nepalese actors
Province of Antofagasta	Provinces of Chile
Province of El Loa	Provinces of Chile
Bill Burr	1968 births, American comedians, Living people
Asprovalta	Towns in Greece
Elizabeth Lada	Year of birth missing (living people), Living people, American academics, American astronomers, Yale University alumni
Meessen De Clercq	Art, Belgian culture, Brussels
Ruppoldsried	Former municipalities of Bern, 2013 disestablishments in Switzerland
Rüschegg	Municipalities of Bern
Rüti bei Büren	Municipalities of Bern
Rüti bei Lyssach	Municipalities of Bern
Rüti bei Riggisberg	Former municipalities of Bern
Rütschelen	Municipalities of Bern
Saanen	Municipalities of Bern
Ignasi Aballí	1958 births, Living people, Spanish artists
Gstaad	Ski areas and resorts in Switzerland, Villages in Bern
Chevron (geology)	Landforms
Meteorite strewnfield	Meteorites
Rifling	Firearms
Interlaken (district)	Former districts of Bern
Province of Tocopilla	Provinces of Chile
Konolfingen (district)	Former districts of Bern
Laupen (district)	Former districts of Bern
Moutier (district)	Former districts of Bern
La Neuveville (district)	Former districts of Bern
Nidau (district)	Former districts of Bern
Frederick McDonald	Missing people, Members of the Australian House of Representatives, Year of death unknown
Aster Yohannes	Year of birth missing, Living people, African people, Eritrea, Prisoners
Tocopilla	Cities in Chile
Damian Lillard	Portland Trail Blazers players, 1990 births, Living people, Sportspeople from Oakland, California
Niedersimmental (district)	Former districts of Bern
Oberhasli (district)	Former districts of Bern
Obersimmental (district)	Former districts of Bern
Saanen (district)	Former districts of Bern
Schwarzenburg (district)	Former districts of Bern
Seftigen (district)	Former districts of Bern
Signau (district)	Former districts of Bern
Thun (district)	Former districts of Bern
Trachselwald (district)	Former districts of Bern
Wangen (district)	Former districts of Bern
Bern-Mittelland (administrative district)	Districts of Bern, 2010 establishments in Switzerland
Year 100 problem	Computing
Frank E. Sagendorph, 2nd	American inventors, 1883 births, 1972 deaths, Businesspeople from Cincinnati, Ohio
L. Lewis Sagendorph	American inventors, 1842 births, 1909 deaths, People from Virginia, People from New York
Adam Basanta	1985 births, Living people, 21st century composers, Canadian composers
Pennsylvania rifle	Rifles
Company (military unit)	Military terminology
Selçuk İnan	1985 births, Turkish footballers
Arrondissements of the Vienne department	Arrondissements of France
Hakan Balta	1983 births, Living people, Turkish footballers, Sportspeople from Berlin
Arrondissement of Châtellerault	Arrondissements of France
Gunsmith	Occupations, Firearms
Mehmet Topal	Turkish footballers, 1986 births, Living people
Binali Yıldırım	1954 births, Living people, Speakers of the Parliament of Turkey, Prime Ministers of Turkey
Arrondissement of Montmorillon	Arrondissements of France
List of programs broadcast by Playhouse Disney	Lists of television series by network, Disney
Arrondissement of Poitiers	Arrondissements of France
Ozan Tufan	1995 births, Living people, Turkish footballers, UEFA Euro 2016 players
Jura bernois (administrative district)	2010 establishments in Switzerland, Districts of Bern
Ashton Gate Stadium	Football stadiums in England, Bristol
Door bolt	Locks
Armorer	Firearms, Occupations
Montmorillon	Subprefectures in France, Communes in Vienne
List of renamed cities in Azerbaijan	Cities in Azerbaijan, Lists of cities in Asia, Azerbaijan-related lists, Lists of cities by country
Ananta Bijoy Das	Bloggers, Murders by blade weapons, Murder in the 21st century
Gartempe	Rivers of France, Nouvelle-Aquitaine, Centre-Val de Loire
Safnern	Municipalities of Bern
Saicourt	Municipalities of Bern
Saint-Imier	Municipalities of Bern
Saules, Switzerland	Municipalities of Bern
Saxeten	Municipalities of Bern
Schalunen	Former municipalities of Bern
Schangnau	Municipalities of Bern
Schattenhalb	Municipalities of Bern
Schelten	Municipalities of Bern
Etching	Printmaking
Colgan Air Flight 3407	2009 in New York (state), 2009 aviation disasters, Aviation disasters in the United States, February 2009 events
Metonic cycle	Astronomy, Calendars
Shahidul Alam	Bangladeshi people, Bangladeshi bloggers, Photographers, Living people, CPJ International Press Freedom Award winners, 1955 births
Nazimuddin Samad	Bangladeshi people, 2016 deaths, Bangladeshi bloggers
Ahmed Rajib Haider	Bangladeshi bloggers, 2013 deaths
Creuse (river)	Rivers of France, Nouvelle-Aquitaine, Centre-Val de Loire
Guðni Th. Jóhannesson	1968 births, Living people, Presidents of Iceland, Current national leaders, People from Reykjavík
Hapoel Be'er Sheva F.C.	Israeli football clubs, 1949 establishments in Asia, 1940s establishments in Israel
2016–17 UEFA Champions League	2016 in association football, UEFA Champions League seasons, 2017 in association football
FK Vardar	1947 establishments in Europe, Football clubs, Sport in North Macedonia, Skopje
Lincoln Red Imps F.C.	Football clubs, Gibraltar, 1976 establishments in Europe
Falmouth, Virginia	Census-designated places in Virginia
Vienne (river)	Rivers of France, Nouvelle-Aquitaine, Centre-Val de Loire
Aquia Creek	Waterways, Rivers of Virginia
C96	Pistols
Plumcot	Plums
Flintlock	Firearms
War of Attrition	Middle East, War, 1967, 1968, 1969, 1970, 20th century in Egypt, 1960s in Israel, 1970s in Israel
Secret (Madonna song)	Madonna songs, Pop songs, 1994 songs
Express Yourself (Madonna song)	Madonna songs, Dance-pop songs, 1989 songs
Fast & Furious (2009 movie)	2000s action movies, 2009 thriller movies, Fast & Furious movies, Movies directed by Justin Lin
Arda Turan	1987 births, Living people, Turkish footballers, Muslims, UEFA Euro 2016 players
FN F2000	Bullpup rifles, Assault rifles
Gold Star family	Military
Sex hormone	Steroid hormones
Darwin Day	Charles Darwin, Evolution, Secularism
SPAS-12	Shotguns
Lucille Dumont	Musicians from Quebec, Canadian pop singers, 1919 births, 2016 deaths
Mukto-Mona	Human rights organizations in Asia, Organisations based in Bangladesh
International Humanist and Ethical Union	Humanism
Thesis statement	Writing
Metropolitan City of Bari	Provinces of Apulia
California Republic	1846, 1840s in California, 1840s in Mexico
Scheunen	Former municipalities of Bern
BC Budivelnyk	Basketball teams
Scheuren	Municipalities of Bern
Candidate	Politics
Biel/Bienne (administrative district)	2010 establishments in Switzerland, Districts of Bern
Brown Bess	British Army equipment, Firearms
Emmental (administrative district)	2010 establishments in Switzerland, Districts of Bern
Schlosswil	Former municipalities of Bern
Battle of Pirano	Battles involving France, 1812, Battles involving the United Kingdom
Emirates Flight 521	2016 disasters in Asia, August 2016 events, Aviation disasters in Asia, Aviation disasters in the 2010s, Dubai
Province of Barletta-Andria-Trani	Provinces of Apulia
Schüpfen	Municipalities of Bern
Dissociative	Drugs
Schwadernau	Municipalities of Bern
Springfield Model 1795 Musket	Firearms, 1795 establishments in the United States
Schwanden bei Brienz	Municipalities of Bern
Schwarzhäusern	Municipalities of Bern
Roggwil, Berne	Municipalities of Bern
RPK machine gun	Machine guns
South Italy	Geography of Italy
Champdor-Corcelles	2016 establishments in France
Le Poizat-Lalleyriat	2016 establishments in France
Val-Revermont	2016 establishments in France
Schwendibach	Former municipalities of Bern
Seeberg	Municipalities of Bern
Interchangeable parts	Manufacturing, History of technology
Social media in the 2016 United States presidential election	Social networking, 2016 United States presidential election
FN BRG-15	Heavy machine guns
Mettauertal	Municipalities of Aargau, 2010 establishments in Switzerland
Münchwilen, Aargau	Municipalities of Aargau
Unterehrendingen	Former municipalities of Aargau, Villages in Aargau
Lodano	2004 disestablishments in Switzerland, Former municipalities of Ticino, Villages in Ticino
Honoré Blanc	1736 births, 1807 deaths, French inventors
Seedorf, Bern	Municipalities of Bern
Seehof, Switzerland	Municipalities of Bern
Long range shooting	Firearms
Battle rifle	Battle rifles
Ofanto	Rivers of Italy
Apple Maps	Cartography, Apple software
Ajamu Baraka	1953 births, Living people, African American politicians, American educators, American human rights activists, Politicians from Chicago, Politicians from Washington, D.C., 2016 United States vice-presidential candidates, Green Party of the United States politicians
The Parent Trap (1998 movie)	1998 romance movies, 1998 comedy movies, 1990s romantic comedy movies, American romantic comedy movies, Disney movies
Seftigen	Municipalities of Bern
Signau	Municipalities of Bern
Frutigen-Niedersimmental (administrative district)	Districts of Bern, 2010 establishments in Switzerland
Interlaken-Oberhasli (administrative district)	2010 establishments in Switzerland, Districts of Bern
Tonia Sotiropoulou	1987 births, Living people, Actresses who played Bond girls, Greek actors, Models
Shermine Shahrivar	1982 births, Living people, German models, People from Tehran
Sigriswil	Municipalities of Bern
Social structure	Sociology
Social Investment	Finance, Social sciences
Siselen	Municipalities of Bern
Sonceboz-Sombeval	Municipalities of Bern
Sonvilier	Municipalities of Bern, Villages in Bern
List of flag bearers for Azerbaijan at the Olympics	Olympic Games, Sport in Azerbaijan, Azerbaijani sportspeople
List of programs broadcast by Disney Junior (USA)	Lists of television series by network, Disney
Combat boot	Footwear, Military
Jump boot	Footwear
Vogue (Madonna song)	Madonna songs, Dance-pop songs, 1990 songs
Assassination of Orlando Letelier	1976 in the United States, 1970s explosions, 1970s in South America, 1970s in Washington, D.C., 20th century in Chile, Assassinations in the United States, Car and truck bombings, Crime in Washington, D.C., Explosions in the United States, Murder in the 1970s, Murder in the United States, Political scandals, September events, Terrorist attacks in the United States, Terrorist incidents in the 1970s
Beauty of Loulan	History of China, Xinjiang, European people
Orlando Letelier	1932 births, 1976 deaths, Ambassadors, Chilean politicians
2015 Rugby World Cup	2015 in sports, 2015 in the United Kingdom, Rugby union, Sport in the United Kingdom, September 2015 events, October 2015 events
Qarabağ FK	Football clubs, 1951 establishments in Europe, 20th century establishments in Azerbaijan, 1951 establishments in Asia
Maryam Zakaria	1985 births, Swedish actors, Iranian actors, Living people
Sornetan	Former municipalities of Bern
Fusil de chasse	Firearms
List of programs broadcast by Discovery Kids	Lists of television series by network
Sorvilier	Municipalities of Bern
Sun Myung Moon	Korean people, Conservatives, 1920 births, 2012 deaths
The Dream Job	Singapore, Chinese language, 2010s television series, Drama television series
Souboz	Former municipalities of Bern, Villages in Bern
Oberaargau (administrative district)	2010 establishments in Switzerland, Districts of Bern
Sirkazhi	Settlements in Tamil Nadu, Nagapattinam district
Gypsy Taub	1970 births, Living people, American political activists
E-flat major	Musical keys, Major scales
D-flat major	Musical keys, Major scales
C-flat major	Musical keys, Major scales
Rafida Bonya Ahmed	Bangladeshi bloggers, Activists, Bangladeshi writers, American writers
Hayes School	Schools in London, 1956 establishments in Europe, 1950s establishments in England
Petit-Val	Municipalities of Bern, 2015 establishments in Switzerland
Obersimmental-Saanen (administrative district)	2010 establishments in Switzerland, Districts of Bern
Spiez	Municipalities of Bern, Cities in Switzerland
Recoil	Firearms
Lego Ninjago	Lego
Ceratonia	Fabaceae
Carob	Fabaceae, Fruits
2016 Turkish purges	2016 in Turkey
Araucanía Region	Regions of Chile
Los Ríos Region	Regions of Chile
Los Lagos Region	Regions of Chile
Maule Region	Regions of Chile
Hurricane Earl	2016 in weather, August 2016 events, Hurricanes in Mexico, 2010s in Mexico, 21st century in the Dominican Republic, 2010s in Belize, 2016 in North America
Gwangju	Cities in South Korea
Kerckhoffs's principle	Cryptography
Charleville musket	Firearms, 1717 establishments, 1710s establishments in the Thirteen Colonies
Arrondissements of the Charente-Maritime department	Arrondissements of France
Arrondissement of Jonzac	Arrondissements of France
Atacama Region	Regions of Chile
Coquimbo Region	Regions of Chile
Valparaíso Region	Regions of Chile
Arrondissement of Rochefort	Arrondissements of France
Arrondissement of La Rochelle	Arrondissements of France
St. Stephan	Municipalities of Bern
Stettlen	Municipalities of Bern
Studen, Bern	Municipalities of Bern
Sumiswald	Municipalities of Bern
Sutz-Lattrigen	Municipalities of Bern, World Heritage Sites in Switzerland
Tägertschi	Former municipalities of Bern
Siege of Petersburg	American Civil War battles, Sieges, 1864 in Virginia, 1865 in the United States
Arrondissement of Saintes	Arrondissements of France
Arrondissement of Saint-Jean-d'Angély	Arrondissements of France
Attacks by Islamic extremists in Bangladesh	Bangladesh, Secularism, Islamic terrorism, Journalism
Aysén Region	Regions of Chile
Magallanes Region	Regions of Chile
Santiago Metropolitan Region	Regions of Chile
Täuffelen	Municipalities of Bern
Tavannes, Switzerland	Municipalities of Bern
Île d'Oléron	Islands of France, Nouvelle-Aquitaine
Owen Smith	1970 births, Living people, Labour MPs (UK), Lobbyists, UK MPs 2010–2015, UK MPs 2015–2017, UK MPs 2017–2019, Politicians from Lancashire
Lobbying	Politics
Pontypridd	Wales
Princess of Xiaohe	European people, History of China, Xinjiang
Teuffenthal	Municipalities of Bern
Thierachern	Municipalities of Bern
Thörigen	Municipalities of Bern
Thun	Thun
Jerusalem Archaeological Park	Jerusalem, Archaeological sites in Israel
Kawhi Leonard	1991 births, African-American basketball players, Basketball players from California, Sportspeople from Los Angeles, California, Living people, San Antonio Spurs players, Toronto Raptors players, American basketball players
Jonzac	Subprefectures in France, Communes in Charente-Maritime
Alex Higgins	1949 births, 2010 deaths, British Anglicans, Deaths from bronchopneumonia, Northern Irish Christians, Northern Irish sportspeople, Snooker players, Sportspeople from Belfast
Thunstetten	Municipalities of Bern
Toffen	Municipalities of Bern
Stitch (Lilo & Stitch)	Animated characters, Disney characters, Fictional characters introduced in 2002, Kingdom Hearts characters, Lilo & Stitch
Berga (Spain, Catalonia)	Cities in Catalonia, Municipalities in Catalonia, Former national capitals
Planum	Journals, Urban planning
Power (Kanye West song)	Kanye West songs
The Life of Pablo	2016 albums, Kanye West albums, Hip hop albums
T24	Television networks, 2015 establishments in Asia, Television stations, Moscow
Seugne	Rivers of France, Nouvelle-Aquitaine
Trachselwald	Municipalities of Bern
Tramelan	Municipalities of Bern
National Liberation Day of Korea	Holidays, Korean culture
United States of America Mathematical Olympiad	Mathematics, Competitions
Joey Graceffa	1991 births, Living people, Gay men, LGBT actors, LGBT people from Massachusetts, American YouTubers
Lake Erie Monsters	2007 establishments in the United States, 2000s establishments in Ohio, 2016 disestablishments in the United States, Disestablishments in Ohio
Treiten	Municipalities of Bern
Trimstein	Former municipalities of Bern
Departments of Paraguay	Departments of Paraguay
Trubschachen	Municipalities of Bern
Tschugg	Municipalities of Bern
Kalika purana	Hindu texts
Trabzon	Cities in Turkey
Wabern bei Bern	Villages in Bern
Branching	Linguistics
Mürren	Ski areas and resorts in Switzerland, Villages in Bern
Ghasem Rezaei	1985 births, Living people, Competitors at the 2012 Summer Olympics, Sportsmen, Mazandaran Province
Seeland (administrative district)	2010 establishments in Switzerland, Districts of Bern
Concepción Department, Paraguay	Departments of Paraguay
Calonico	Former municipalities of Ticino, Villages in Ticino
Rossura	Former municipalities of Ticino, Villages in Ticino
Angora goat	Domesticated animals
Tüscherz-Alfermée	Former municipalities of Bern
Twann	Former municipalities of Bern
Bümpliz	Villages in Bern, Former municipalities of Bern, Bern
Spencer repeating rifle	Rifles, 1860s, American Civil War
Strongpoint	Fortification, Military terminology
Banshee	Mythology, Celtic peoples
Ethnic minorities in Azerbaijan	Azerbaijan, Ethnic groups in Asia, Ethnic groups in Europe
Waterloo International Airport	Transport in Ontario, Airports in Canada
Chañaral Province	Provinces of Chile
Chamber (firearms)	Firearm components
Uebeschi	Municipalities of Bern
Uetendorf	Municipalities of Bern
2013 Africa Cup of Nations	2013 in association football, Africa Cup of Nations, Football in South Africa, 2010s in South Africa
Unterlangenegg	Municipalities of Bern
1994 African Cup of Nations	1994 in association football, Africa Cup of Nations, Football in Tunisia, 1994 in Africa, 20th century in Tunisia
Unterseen	Municipalities of Bern, Cities in Switzerland
Castro, Ticino	Villages in Ticino, Former municipalities of Ticino
Corzoneso	Villages in Ticino, Former municipalities of Ticino
Largario	Villages in Ticino, Former municipalities of Ticino
Lottigna	Villages in Ticino, Former municipalities of Ticino
Marolta	Villages in Ticino, Former municipalities of Ticino
Bosco Luganese	Villages in Ticino, Former municipalities of Ticino
Ulsan	Cities in South Korea
AC Sparta Prague	Prague, Czech football clubs
George Meade	American Civil War generals, 1815 births, 1872 deaths
Clementi MRT station	Mass Rapid Transit (Singapore) stations
Queenstown MRT station	Mass Rapid Transit (Singapore) stations
Commonwealth MRT station	Mass Rapid Transit (Singapore) stations
Chañaral	Cities in Chile
Linda Partridge	Living people, Knights and Dames Commander of the Order of the British Empire, 1950 births, Fellows of the Royal Society, British geneticists, Female scientists
Now That You Got It	2006 songs, 2007 songs, Gwen Stefani songs, Hip hop songs, Reggae songs, R&B songs
Diego de Almagro, Chile	Cities in Chile
Copiapó Province	Provinces of Chile
Huasco Province	Provinces of Chile
Sun Life Stadium	2011 establishments in the United States, 2010s establishments in Florida, 2016 disestablishments in the United States, 2010s disestablishments in Florida
Cimo, Ticino	Former municipalities of Ticino, Villages in Ticino
Breno, Ticino	Former municipalities of Ticino, Villages in Ticino
Sirtuin	Enzymes
Euryale	Greek legendary creatures
MTOR	Enzymes
Rapamycin	Antibiotics
Bristoe Campaign	American Civil War battles, 1863 in the United States, 1860s in Virginia
Turning movement	Military terminology, Military tactics
Geoffroea decorticans	Trees, Fabaceae
Cyclone Bobby	1995, Tropical cyclones in Oceania, 1990s in Australia, Western Australia
Postal codes in Azerbaijan	Azerbaijan, Postal codes
ENSAE ParisTech	Technical colleges and universities in Paris, 1942 establishments in Europe, 1940s establishments in France
Hayflick limit	Chromosomes
Cantor's diagonal argument	Set theory
Arrondissements of the Deux-Sèvres department	Arrondissements of France
Arrondissement of Bressuire	Arrondissements of France
Cynthia Kenyon	Female scientists, American geneticists, American biochemists, Biophysicists, Massachusetts Institute of Technology alumni, 1955 births, Living people
Randall Woolf	1959 births, Living people, American composers
Arrondissement of Niort	Arrondissements of France
Arrondissement of Parthenay	Arrondissements of France
Arosio, Switzerland	Villages in Ticino, Former municipalities of Ticino
Envelopment	Military terminology, Military tactics
Knap of Howar	Settlements in Scotland
DeAndre Yedlin	1993 births, African-American sportspeople, American footballers, Jewish American sportspeople, Sportspeople from Seattle, Washington, Premier League players, Tottenham Hotspur F.C. players, 2014 FIFA World Cup players, Living people
Sèvre Nantaise	Rivers of France, Nouvelle-Aquitaine, Pays de la Loire
Ricardo Lucarelli	1992 births, Living people, Brazilian volleyball players, Competitors at the 2016 Summer Olympics
Aaron Russell	American volleyball players, 1993 births, Living people, Competitors at the 2016 Summer Olympics
Artem Volvich	Russian volleyball players, 1990 births, Living people, Competitors at the 2016 Summer Olympics
Lazarus	Given names, Surnames
Cagiallo	Villages in Ticino, Former municipalities of Ticino
Lopagno	Villages in Ticino, Former municipalities of Ticino
Roveredo, Ticino	Villages in Ticino, Former municipalities of Ticino
Vaglio	Villages in Ticino, Former municipalities of Ticino
Sala Capriasca	Villages in Ticino, Former municipalities of Ticino
Tesserete	Villages in Ticino, Former municipalities of Ticino
Ardfern	Villages in Scotland, Argyll and Bute
Rosh Chodesh	Jewish festivals and holidays
Sèvre Niortaise	Rivers of France, Nouvelle-Aquitaine, Pays de la Loire
Intersectionality	Civil rights, Discrimination, Feminism
Daniel Sickles	1819 births, 1914 deaths, Ambassadors of the United States, American Civil War generals, American police officers, Politicians from New York City, United States Army Medal of Honor recipients, United States representatives from New York, US Democratic Party politicians
Thouet	Rivers of France, Nouvelle-Aquitaine, Pays de la Loire
Amambay	Departments of Paraguay
Darwin–Wallace Medal	Orders, decorations, and medals, Science awards
Khan Academy	Educational organizations, American websites
Untersteckholz	Former municipalities of Bern
Ursenbach	Municipalities of Bern
Urtenen-Schönbühl	Municipalities of Bern
Uttigen	Municipalities of Bern
Political general	Politics
E. Ray Lankester	1847 births, 1929 deaths, English biologists, British zoologists
August 2016 Central Italy earthquake	2016 disasters in Europe, 2016 earthquakes, 2010s in Italy, Abruzzo, August 2016 events, Earthquakes in Italy, Lazio, Marche, Umbria
Citation	Writing
Nihal Naj Ali Al-Awlaqi	Yemeni people, Living people, Lawyers, Politicians, 1977 births, Women who received the International Women of Courage Award
Elqui Province	Provinces of Chile
Limarí Province	Provinces of Chile
Choapa Province	Provinces of Chile
LGBT rights in Tunisia	LGBT rights by country, Tunisia
Institut national des sciences appliquées de Toulouse	Technical colleges and universities in Toulouse, 1963 establishments in Europe, 1960s establishments in France
1909 Cherry Mine disaster	1909, 1900s in the United States, Disasters in the United States, 20th century in Illinois
Prosopis tamarugo	Trees, Fabaceae
Margaret Anstee	1926 births, 2016 deaths, Alumni of the University of Cambridge, British diplomats, People from Essex, United Nations officials
Maria Eugénia	1927 births, 2016 deaths, Portuguese movie actors, Portuguese television actors, Portuguese voice actors, Portuguese stage actors, Portuguese singers, People from Lisbon
Justin du Fresne	2016 deaths, New Zealand radio personalities
Warren Hinckle	1938 births, 2016 deaths, American journalists
Neo-futurism	Art movements
Appeal to emotion	Logical fallacies
Appeal to tradition	Logical fallacies
Red herring	Logical fallacies
Appeal to popularity	Logical fallacies
Twann-Tüscherz	2010 establishments in Switzerland, Municipalities of Bern
Utzenstorf	Municipalities of Bern
Inwil, Switzerland	Municipalities of Lucerne
Lieli, Switzerland	Villages in Lucerne, Former municipalities of Lucerne
Feigned retreat	Military terminology, Military tactics
Magnicharters	Mexico, Airlines
Constructive proof	Mathematics
Vauffelin	Former municipalities of Bern
Involuntary celibacy	Internet memes, Sexuality
Sauge	Municipalities of Bern, 2014 establishments in Switzerland
Jailhouse Rock (movie)	1957 movies, Elvis Presley, 1950s musical movies, English-language movies
Vechigen	Municipalities of Bern
Villeret, Switzerland	Municipalities of Bern
Vinelz	Municipalities of Bern
Thun (administrative district)	2010 establishments in Switzerland, Districts of Bern
The Beginning (The Black Eyed Peas album)	2010 albums, The Black Eyed Peas albums, Hip hop albums, Pop albums, Dance albums
Shock tactics	Military terminology, Military tactics
Monkey Business (album)	2005 albums, The Black Eyed Peas albums, Hip hop albums, R&B albums
Elephunk	2003 albums, The Black Eyed Peas albums, Hip hop albums, R&B albums, A&M Records albums, Pop albums
Broglio, Switzerland	Villages in Ticino, Former municipalities of Ticino
Azadliq (newspaper)	Newspapers published in Azerbaijan, Azerbaijani-language newspapers, 1989 establishments, 20th century establishments in Azerbaijan, Free Media Award winners
Behind the Front	1998 albums, Debut albums, The Black Eyed Peas albums, Hip hop albums, Alternative hip hop albums
Bridging the Gap (Black Eyed Peas album)	2000 albums, The Black Eyed Peas albums, Hip hop albums, Alternative hip hop albums
Arrondissements of the Haute-Vienne department	Arrondissements of France
Rodjaraeg Wattanapanit	1967 births, Living people, Activists, Thai people, Women who received the International Women of Courage Award
Vicky Ntetema	Human rights activists, Living people, Women who received the International Women of Courage Award, Journalists, Tanzanian people, 1958 births
Arrondissement of Bellac	Arrondissements of France
Awadeya Mahmoud	Women who received the International Women of Courage Award, Living people, Sudanese people, Activists
Forever Marilyn	Statues
Arrondissement of Limoges	Arrondissements of France
Hysterical strength	Physiology
Pot calling the kettle black	Logical fallacies
Association fallacy	Logical fallacies
Arrondissement of Rochechouart	Arrondissements of France
Rajasthani language	Indo-Aryan languages
LoveWave	2016 songs, Eurovision Song Contest
Oblique order	Military terminology, Military tactics
Haut-Bocage	Communes in Allier
Miami Lakes, Florida	Towns in Florida
Armenia in the Eurovision Song Contest 2016	Eurovision Song Contest, 21st century in Armenia, 2016
Social issue	Social issues
Martin Ryle	Nobel Prize in Physics winners, 1918 births, 1984 deaths, People from Brighton
Monte Cimone	Mountains of Italy, Emilia-Romagna
Richie Rich (comics)	Comics characters
Preemptive war	Military terminology, Military tactics
2006 Lebanon War	2006 in Asia, 21st century in Israel, 21st century in Lebanon, August events, Golan Heights, July 2006 events, Wars involving Israel, Wars involving Lebanon
Howard Wolowitz	Television characters
Vladimir Grbić	1970 births, 2004 Summer Olympics, Living people, Medalists at the 1996 Summer Olympics, Medalists at the 2000 Summer Olympics, Olympic bronze medalists, Olympic gold medalists, Serbian volleyball players, Sportsmen, Yugoslavian sportspeople
Judy Martz	1943 births, 1964 Winter Olympics, 2017 deaths, American Olympians, Deaths from pancreatic cancer, Governors of Montana, People from Butte, Montana, Speed skaters, Sportswomen, US Republican Party politicians, Lieutenant Governors of Montana
Subliminal stimuli	Psychology
Rodolfo Illanes	Deaths by beating, 2016 deaths, Bolivian politicians, 1958 births
Sonia Rykiel	1930 births, 2016 deaths, French fashion designers
Eddy Silitonga	1949 births, 2016 deaths, Indonesian singers
Rudy Van Gelder	2016 deaths, Engineers from New Jersey
Battle of New Market	American Civil War battles, 1864 in Virginia, May 1864 events
Amnesic shellfish poisoning	Toxicology, Protista
Salak	Fruits
Reno (river)	Rivers of Italy
Fatih Terim	1953 births, Living people, Turkish footballers, Turkish football managers
Agglutinative language	Languages
Suffocation (band)	Musical groups established in 1988, Musical groups from New York
Steve Hickner	American movie directors, American animators, Living people
Paul Bostaph	1964 births, American musicians
Homologous series	Organic chemistry
Canada men's national volleyball team	National volleyball teams, Sport in Canada
Czech Republic men's national volleyball team	National volleyball teams, Sport in the Czech Republic
Egypt men's national volleyball team	National volleyball teams, Sport in Egypt
Tunisia men's national volleyball team	National volleyball teams, Sport in Tunisia
Shenandoah Valley	Valleys of the United States
Reductio ad Hitlerum	Logical fallacies
Leo Strauss	1899 births, 1973 deaths, 20th century philosophers, American philosophers, American political scientists, Continental philosophers, German military personnel of World War I, German philosophers, Hebrew University of Jerusalem faculty, Jewish American academics, Jewish American scientists, Jewish American writers, Jewish German scientists, Jewish German writers, Jewish philosophers, Naturalized citizens of the United States, Refugees from Nazism, Writers from Hesse
Wachseldorn	Municipalities of Bern
Wahlern	Former municipalities of Bern
Schwarzenburg	2011 establishments in Switzerland, Municipalities of Bern
Mosen, Lucerne	Former municipalities of Lucerne
Müswangen	Former municipalities of Lucerne
Brontallo	Villages in Ticino, Former municipalities of Ticino
Menzonio	Villages in Ticino, Former municipalities of Ticino
Peccia	Villages in Ticino, Former municipalities of Ticino
Web crawler	Web browsers
Per capita income	Income, Economics, Economic indicators
Sunnyvale, California	Cities in California, Cities in the San Francisco Bay Area, Settlements in Santa Clara County, California
Booby trap	Weapons
San Pedro Department, Paraguay	Departments of Paraguay
Jeju Island	Islands of South Korea, World Heritage Sites in South Korea
Sinusitis	Medical signs, Symptoms
Rain, Switzerland	Municipalities of Lucerne
Retschwil	Former municipalities of Lucerne
Queen Anne of Romania	1923 births, 2016 deaths, People from Paris, French people of World War II, Kings and Queens consort, Princes and princesses
Colin Bean	1926 births, 2009 deaths, Actors from Greater Manchester, Actors from Lancashire, English movie actors, English radio actors, English television actors
A. P. Hill	1825 births, 1865 deaths, American Civil War generals, Military people from Virginia, Military people killed in action
Römerswil	Municipalities of Lucerne
Rothenburg, Lucerne	Municipalities of Lucerne
Schongau, Switzerland	Municipalities of Lucerne
Lucerne (district)	Former districts of Switzerland, Districts of Lucerne, 2013 disestablishments in Switzerland
Frank Blas	1941 births, 2016 deaths, Lieutenant Governors of Guam
Dai Dower	1933 births, 2016 deaths, Boxers, Welsh sportspeople, Members of the Order of the British Empire, 1952 Summer Olympics
Hurricane Hermine	2016 in the United States, August 2016 events, Hurricanes in the United States, September 2016 events
Jonathan Borwein	1951 births, 2016 deaths, Scottish people, British mathematicians
Wald, Bern	Municipalities of Bern
Walkringen	Municipalities of Bern
Walliswil bei Niederbipp	Municipalities of Bern
Walliswil bei Wangen	Municipalities of Bern
Jamkaran	Villages in Asia, Settlements in Iran
Post hoc fallacy	Logical fallacies
Tarn Taran Sahib	Punjab, India, Cities in India
Gurmukhī alphabet	Alphabets, Languages of India
Gionee	Electronics companies, China
Bözberg	Municipalities of Aargau, 2013 establishments in Switzerland
Hans Schmidt	Roman Catholic priests, 1881 births, 1916 deaths, German Roman Catholics, People from Bavaria
Zhanna Nemtsova	1984 births, Living people, Activists, Russian journalists, Russian people, Women who received the International Women of Courage Award
Fatimata M’baye	1959 births, Living people, Human rights activists, Lawyers, Mauritanian people, Women who received the International Women of Courage Award, Women lawyers
Bernardo Rezende	1959 births, Living people, Brazilian sportspeople, Volleyball coaches
Los Andes Province, Chile	Provinces of Chile
Deaths in August 2016	2016 deaths, August 2016 events
Arakkal Museum	Museums in Asia
Mount Kyllini	Mountains of Greece
Walperswil	Municipalities of Bern
2018 FIFA World Cup qualification – UEFA Group C	2016 in sports, 2017 in sports, 2018 FIFA World Cup qualification (UEFA)
Walterswil, Bern	Municipalities of Bern
Wangen an der Aare	Municipalities of Bern, Cities in Switzerland
Wangenried	Municipalities of Bern
Wanzwil	Former municipalities of Bern
Railroad company	Rail transport
Wattenwil	Municipalities of Bern
Wengi	Municipalities of Bern
Wichtrach	Municipalities of Bern
Wiedlisbach	Municipalities of Bern, Cities in Switzerland
Anthocyanin	Pigments, Plant physiology
Williamson County, Texas	Texas counties
Susanna Griso	1969 births, Living people, Spanish journalists, Writers from Barcelona
Electric blanket	Home, Electronics
Nguyen Van Thieu	1923 births, 2001 deaths, Presidents (government), Vietnamese people
U Nu	1907 births, 1995 deaths, Prime Ministers of Myanmar, Writers, Buddhists
Iodine test	Chemistry
Mauritanian Association for Human Rights	Mauritania, Human rights organizations, 1991 establishments in Africa
Las Lomas, California	Towns in California, Settlements in Monterey County, California
Arrondissements of the Creuse department	Arrondissements of France
Heart block	Heart disease
W (New York City Subway)	New York City Subway
North Gyeongsang Province	Provinces of South Korea
Postural orthostatic tachycardia syndrome	Syndromes
Frederick County, Virginia	Virginia counties, 1740s establishments in the Thirteen Colonies
Orange County, Virginia	Virginia counties, 1734 establishments, 1730s establishments in Virginia
Ne Win	1910 births, 2002 deaths, Asian military people, Generals, Presidents of Myanmar, Prime Ministers of Myanmar
Wiggiswil	Municipalities of Bern
Hua Guofeng	1921 births, 2008 deaths, Premiers of the People's Republic of China, Chinese communist politicians
Sulz, Lucerne	Former municipalities of Lucerne, Villages in Lucerne
Arrondissement of Aubusson	Arrondissements of France
Buchrain, Switzerland	Municipalities of Lucerne
Dierikon	Municipalities of Lucerne
Barra do Bugres	Cities in Mato Grosso do Sul
Arrondissement of Guéret	Arrondissements of France
Yosemite Decimal System	Rock climbing
Function (biology)	Biology, Physiology, Words
British princess	British royalty
Amar Singh (cricketer)	Indian cricketers, 1910 births, 1940 deaths
Pietro Martorana	1705 births, 1759 deaths, 18th century Italian painters, People from Palermo
Siad Barre	1919 births, 1995 deaths, Presidents of Somalia
Roger Binny	Indian cricketers, Living people, Year of birth missing (living people), Bangalore
Mohammad Mosaddegh	1882 births, 1967 deaths, Prime Ministers of Iran, Time People of the Year, Iranian writers, Humanitarians, People from Tehran
First Battle of Kernstown	American Civil War battles, 1862 in Virginia, March 1862 events
Jan Sokol	Czech politicians, Philosophers, European translators, 1936 births, 2021 deaths
Anastasio Somoza Debayle	1925 births, 1980 deaths, Presidents of Nicaragua, Assassinated people
Autism Speaks	2005 establishments in the United States, Non-profit organizations of the United States, Medical and health organizations, Autism
Aubusson, Creuse	Subprefectures in France, Communes in Creuse
Institut des sciences et industries du vivant et de l'environnement	Technical colleges and universities in Paris, 2007 establishments in France
Tiger Electronics	Entertainment companies, 1979 establishments in the United States
First Battle of Winchester	American Civil War battles, 1862 in Virginia, May events
Akasaka Station	Railway stations in Tokyo
List of language regulators	Language regulators, Language-related lists
Cordillera Department	Departments of Paraguay
Zhao Ziyang	1919 births, 2005 deaths, General Secretaries of the Communist Party of China, Premiers of the People's Republic of China
Nikolai Ryzhkov	1929 births, Living people, Russian engineers, Heads of government of the Soviet Union, Recipients of the Order of Lenin
Marga Marga Province	Provinces of Chile
Missal	Christian genres
Wilderswil	Municipalities of Bern
American Civil War casualties	American Civil War
Tuncay Şanlı	1982 births, Living people, Turkish footballers
Marko Podraščanin	1987 births, Living people, Serbian volleyball players, Sportsmen, Yugoslavian sportspeople
Andrea Sartoretti	1971 births, Living people, Medalists at the 2004 Summer Olympics, Medalists at the 2000 Summer Olympics, Medalists at the 1996 Summer Olympics, Italian volleyball players
Earvin N'Gapeth	1991 births, Living people, French sportspeople, Competitors at the 2016 Summer Olympics, Volleyball players
North Chungcheong Province	Provinces of South Korea
Port of Amsterdam	Amsterdam, 13th century establishments in Europe, Establishments in the Netherlands
Khalji dynasty	Delhi Sultanate, 1290 establishments, 1320 disestablishments, Khalji dynasty, 13th-century establishments in Asia, 14th century disestablishments in Asia
Larry Roberts (actor)	1926 births, 1992 deaths, Actors from Cleveland, Ohio, Deaths from AIDS, Infectious disease deaths in New York
Bulk cargo	Transport
Sepoy	Military ranks, British India
Vicente Martín y Soler	1754 births, 1806 deaths, Spanish composers
Les Rodanes	Forests of Europe, Geography of Spain
Arrondissements of the Indre department	Arrondissements of France
Field hospital	Medical emergencies, Health care, Military terminology
Anarkali Salwar Suit	Clothing, Asian culture
China Northwest Airlines Flight 2303	1994, 1990s disasters in Asia, 1990s in China, Aviation disasters in Asia, Aviation disasters in the 1990s, Disasters in China, June events
Arrondissement of Le Blanc	Arrondissements of France
Arrondissement of Châteauroux	Arrondissements of France
Law of Azerbaijan	Azerbaijan, Law
Arrondissement of La Châtre	Arrondissements of France
British Motor Corporation	Companies of the United Kingdom
Arrondissement of Issoudun	Arrondissements of France
Jonas Savimbi	1934 births, 2002 deaths, Angolan people
Babrak Karmal	1929 births, 1996 deaths, Presidents of Afghanistan, Prime Ministers of Afghanistan
Truyère	Rivers of France, Occitanie, Auvergne-Rhône-Alpes
Military terminology	Military terminology
Célé	Rivers of France, Occitanie, Auvergne-Rhône-Alpes
Patty Judge	1943 births, Living people, Lieutenant Governors of Iowa, US Democratic Party politicians
Suntec City	Places in Singapore
Esplanade MRT station	Mass Rapid Transit (Singapore) stations
City Hall MRT station	Mass Rapid Transit (Singapore) stations, 1987 establishments in Singapore
Raffles Place MRT station	Mass Rapid Transit (Singapore) stations, 1987 establishments in Singapore
Marina Bay MRT station	Mass Rapid Transit (Singapore) stations, 1987 establishments in Singapore
Bishan MRT station	Mass Rapid Transit (Singapore) stations, 1987 establishments in Asia, 2017 establishments in Asia, 2010s establishments in Singapore, 20th century establishments in Singapore
Nicoll Highway MRT station	Mass Rapid Transit (Singapore) stations
Stadium MRT station	Mass Rapid Transit (Singapore) stations
Singapore Armed Forces	Singapore
Wiler bei Utzenstorf	Municipalities of Bern
Ebikon	Municipalities of Lucerne, Cities in Switzerland
Qapik	Currency of Asia, Currency of Europe, Economy of Azerbaijan
History of baseball in the United States	Baseball
List of Pashto-language movies	Lists of movies
Qom	Cities in Iran
Wileroltigen	Municipalities of Bern
Willadingen	Municipalities of Bern
Wimmis	Municipalities of Bern
Lanyard	Clothing
Controlled flight into terrain	Aircraft
Savio (river)	Emilia-Romagna, Rivers of Italy
Alexander Dubček	1921 births, 1992 deaths, Communist politicians, Presidents of Czechoslovakia, Humanists, Military personnel of World War II, Road accident deaths, Slovakian politicians
Walter Hallstein	1901 births, 1982 deaths, European Commissioners, Former members of the German Bundestag, German academics, German diplomats, German military personnel of World War II, German writers, Jurists, People from Mainz, Politicians from Rhineland-Palatinate, Politicians of the Christian Democratic Union of Germany, Prisoners of war
Todor Zhivkov	1911 births, 1998 deaths, Communist politicians, Prime Ministers of Bulgaria
Decisive victory	Military terminology
Blek le Rat	Living people, 1952 births, Artists from Paris
Murray Gell-Mann	1929 births, 2019 deaths, American physicists, Nobel Prize in Physics winners, People from Manhattan, Scientists from New York City, Theoretical physicists
Limited war	War
Beatriz Montañez	1977 births, Living people, Spanish journalists, Spanish people
Gōjū-ryū	Martial art techniques, Karate
Tirthankara	Jainism
Palmiro Togliatti	1893 births, 1964 deaths, Communist politicians, Deaths from cerebral hemorrhage, Italian communists, People from Genoa
Keith Holyoake	1904 births, 1983 deaths, Governors General of New Zealand, Prime Ministers of New Zealand, Anti-Communists, Knights Grand Cross of the Order of St Michael and St George, Knights of the Garter, Deputy Prime Ministers of New Zealand
Gaafar Nimeiry	1930 births, 2009 deaths, Presidents of Sudan, Prime Ministers of Sudan
Alikovsky District	Alikovsky District
Thirunallar	Towns in India, Settlements in Puducherry, Karaikal District
Tirumalairayanpattinam	Towns in India, Settlements in Puducherry, Karaikal District
Germania	History of Germany
Paraguarí Department	Departments of Paraguay
Oswald the Lucky Rabbit	Animated characters, Disney characters, Fictional hares and rabbits
Ataxia	Neurology
Fátima Bernardes	1962 births, Living people, Brazilian people, Brazilian journalists
San Felipe de Aconcagua Province	Provinces of Chile
1926 Miami hurricane	1926, Hurricanes in the United States, September events, 20th century in the Bahamas, 1920s in Florida, 20th century in Alabama, 20th century in Mississippi, 20th century in Louisiana
Miami metropolitan area	Miami, Florida, Metropolitan areas of the United States
Valparai	Coimbatore district
Yanam district	Puducherry, Districts of India
Mahe district	Puducherry
Vice-President of India	Vice Presidents of India
Chalumeau	Woodwind instruments
54th Massachusetts Infantry Regiment	Union Army, African-American military personnel
Typhoon Meranti	2016 in weather, Pacific typhoons, September 2016 events
San Felipe, Chile	Cities in Chile
Macmillan Cancer Support	Cancer
Conventional weapon	Weapons
Edward Gierek	1913 births, 2001 deaths, Polish communist politicians
Chiang Ching-kuo	1910 births, 1988 deaths, Anti-Communists, Methodists, Prime ministers, Presidents of the Republic of China
Aconcagua River	Rivers of Chile
Andrei Gromyko	1909 births, 1989 deaths, Ambassadors of the Soviet Union, Heads of state, Russian communists, Soviet politicians, Recipients of the Order of Lenin
Luis Carrero Blanco	1904 births, 1973 deaths, Admirals, Anti-Communists, Assassinated people, Prime Ministers of Spain, Spanish military people, Spanish Roman Catholics
Lon Nol	1913 births, 1985 deaths, Anti-Communists, Asian military people, Buddhists, Cambodian people, Government ministers, People of the Vietnam War, Presidents (government), Prime ministers
Hu Yaobang	1915 births, 1989 deaths, General Secretaries of the Communist Party of China, Deaths from cardiovascular disease, Deaths from myocardial infarction
Gennady Yanayev	1937 births, 2010 deaths, Russian communists
Tinnitus	Hearing, Health problems, Symptoms
Ernest Bevin	1881 births, 1951 deaths, Anti-Communists, Baptists, British people of World War II, English Protestants, Former Labour MPs (UK), Former members of the British House of Commons for English constituencies, Politicians from Somerset, Privy Councillors (UK), Secretaries of State of the United Kingdom, Trade unionists, UK MPs 1935–1945, UK MPs 1945–1950, UK MPs 1950–1951
Hellenistic period	Ancient Greece
Frankfurt Universe	2007 establishments in Germany, American football, Frankfurt, Sport in Hesse, Sports organizations
Arrondissements of the Alpes-de-Haute-Provence department	Arrondissements of France
Arrondissement of Barcelonnette	Arrondissements of France
Arrondissement of Castellane	Arrondissements of France
Arrondissement of Digne-les-Bains	Arrondissements of France
Conductive hearing loss	Hearing, Disability, Health problems
Arrondissement of Forcalquier	Arrondissements of France
Sensorineural	Hearing
Helen Prejean	Capital punishment in the United States
Diosdado Macapagal	1910 births, 1997 deaths, Deaths from pneumonia, Anti-Communists, Filipino lawyers, Presidents of the Philippines, Roman Catholics, Vice Presidents of the Philippines
Alain Poher	1909 births, 1996 deaths, Former MEPs, French Roman Catholics, MEPs for France, Presidents of France, Presidents of the European Parliament, Presidents of the Senate (France)
Bishop, California	Cities in California, Settlements in Inyo County, California
Noise-induced hearing loss	Hearing, Health problems
North Jeolla Province	Provinces of South Korea
United Nations Secretariat	United Nations
Mohammad Hamid Ansari	1937 births, Living people, Vice Presidents of India
Cashtown, Pennsylvania	Census-designated places in Pennsylvania
Camp Curtin	Union Army, United States Army, 1860s in Pennsylvania, 1861 in the United States, 1862 in the United States, 1863 in the United States, 1864 in the United States, 1865 in the United States
Aiguille de Chambeyron	Alps, Mountains of France, Provence-Alpes-Côte d'Azur
American Civil War Corps Badges	Union Army
Jeh Johnson	1957 births, Living people, African-American people, American lawyers, People from New York City, United States Secretaries of Homeland Security
Immigration Act of 1917	1917 in the United States, Immigration, United States law
Durance	Rivers of France, Provence-Alpes-Côte d'Azur
Bhatgaon, Raipur	Towns in India, Settlements in Chhattisgarh
Agender	Gender
Omar Torrijos	1929 births, 1981 deaths, Anti-Communists, Aviation deaths, Heads of state, Panamanian people
Anatoly Dobrynin	1919 births, 2010 deaths, Russian communists, Recipients of the Order of Lenin, Ambassadors of the Soviet Union
Enrico Berlinguer	1922 births, 1984 deaths, Italian atheists, Italian communists, Italian politicians, People from Sardinia
Oosterscheldekering	Flood control, Buildings and structures in the Netherlands, Geography of the Netherlands, Zeeland, Schouwen-Duiveland
Shem And Eber Cave	Archaeological sites in Israel
Pasquotank County, North Carolina	1730s establishments in North Carolina, 1739 establishments, North Carolina counties
Ichirō Hatoyama	1883 births, 1959 deaths, Prime Ministers of Japan, Baptists, University of Tokyo alumni
Nobusuke Kishi	1896 births, 1987 deaths, Anti-Communists, Prime Ministers of Japan, Japanese politicians, World War II people, University of Tokyo alumni
Camden, North Carolina	Unincorporated communities in North Carolina, Census-designated places in North Carolina, County seats in North Carolina
Hearing test	Hearing
Audiologist	Occupations, Hearing
Safed Old Jewish Cemetery	Cemeteries in Israel
Tiberias Ancient Jewish Cemetery	Cemeteries in Israel, Tiberias
State school	Educational institutions
Ñeembucú	Departments of Paraguay
Wohlen bei Bern	Municipalities of Bern
Wolfisberg	Former municipalities of Bern
Worb	Municipalities of Bern, Cities in Switzerland
Worben	Municipalities of Bern
Wynau	Municipalities of Bern
Pontiac (Ottawa leader)	1769 deaths, Native American people
Wynigen	Municipalities of Bern
Los Andes, Chile	Cities in Chile
Hayato Ikeda	1899 births, 1965 deaths, Deaths from pneumonia, Disease-related deaths in Japan, People from Hiroshima, Prime Ministers of Japan
Marcelo Caetano	1906 births, 1980 deaths, Portuguese lawyers, People from Lisbon, Prime Ministers of Portugal, Roman Catholics
Álvaro Cunhal	1913 births, 2005 deaths, Communist politicians, Recipients of the Order of Lenin, Atheists, Portuguese writers
San Antonio Province	Provinces of Chile
San Antonio, Chile	Cities in Chile
Salgueiro Maia	1944 births, 1992 deaths, Portuguese military people
Black Lives Matter	2013 establishments in the United States, Black Lives Matter, American civil rights
Rabi crops	Agriculture
Death of Freddie Gray	2015 in Baltimore, Maryland, April 2015 events, Black Lives Matter
Rizal Park	Parks, Philippines
Presidency of Abraham Lincoln	Abraham Lincoln
Wyssachen	Municipalities of Bern
Zauggenried	Former municipalities of Bern
Zäziwil	Municipalities of Bern
PK machine gun	Machine guns
Zielebach	Municipalities of Bern
Zimmerwald	Villages in Bern, Former municipalities of Bern
Chiloé Island	Islands of Chile
Chiloé Archipelago	Archipelagos, Islands of Chile
Maipo (river)	Rivers of Chile
Maipo (volcano)	Volcanoes of Chile, Mountains of Argentina
Black marlin	Perciformes
Lindi Region	Tanzania
Seven Kings School	Ilford, Schools in London
Shyampur Thana	Settlements in Bangladesh
Pulau Ubin	Geography of Singapore, Islands of Asia, Places in Singapore
Aljunied MRT station	Mass Rapid Transit (Singapore) stations
Regional Science Association International	International organizations, 1954 establishments, Urban and regional sciences
Meteomont	Skiing, Meteorology, Organizations based in Europe, Italy
Whitelist	Computers
Otelo Saraiva de Carvalho	1936 births, 2021 deaths, Deaths from heart failure, Generals, Portuguese politicians, Portuguese military people
António de Spínola	1910 births, 1996 deaths, Generals, Portuguese military people, Presidents of Portugal, Roman Catholics
Vasco Gonçalves	1922 births, 2005 deaths, Generals, People from Lisbon, Portuguese military people, Prime Ministers of Portugal
Francisco de Sá Carneiro	1934 births, 1980 deaths, Prime Ministers of Portugal, Roman Catholics, Portuguese lawyers, People from Porto
Nederlandse Spoorwegen	Transport in the Netherlands, 1938 establishments in Europe, 1930s establishments in the Netherlands
Zollikofen	Municipalities of Bern, Cities in Switzerland
Whitechapel	Areas of London, London Borough of Tower Hamlets
Holywood	Towns in County Down
Zuzwil, Bern	Municipalities of Bern
Zablon Simintov	1959 births, Living people, Afghan people, Asian Jews
History of hearing aids	Hearing
Presbycusis	Hearing, Health problems
Hyperacusis	Hearing, Health problems
Bolesław Bierut	1892 births, 1956 deaths, Polish communist politicians, Presidents of Poland, Prime Ministers of Poland, Atheists
Władysław Gomułka	1905 births, 1982 deaths, Atheists, Polish communist politicians, Recipients of the Order of Lenin
Tinnitus masker	Medical equipment, Audio technology, Hearing
Fengning	Counties of China
Zweisimmen	Municipalities of Bern
Zwieselberg	Municipalities of Bern
Emanuel Swedenborg	1688 births, 1772 deaths, 18th century philosophers, Christian mystics, Christian theologians, Lutherans, Writers from Stockholm, Scientists from Stockholm
Little Robots	BBC Television programmes, 2003 British television series debuts, 2005 British television series endings, British children's television series, English-language television programs
Panaro	Emilia-Romagna, Rivers of Italy
Numa Pompilius	Kings and queens, Roman people
Exposure action value	Hearing, Health problems
Nazi salute	Nazism, Fascism
Wengen	Ski areas and resorts in Switzerland, Villages in Bern
Stechelberg	Villages in Bern
Coimbatore district	Coimbatore district
Slime Rancher	MacOS games, Windows games, 2016 video games, Xbox One games, PlayStation 4 games
Soledad Giménez	1963 births, Living people, French singers, Musicians from Paris, Singer-songwriters, Spanish singers
Gisikon	Municipalities of Lucerne
Greppen	Municipalities of Lucerne
Honau, Switzerland	Municipalities of Lucerne
Arrondissements of the Hautes-Alpes department	Arrondissements of France
Connecticut Compromise	United States Constitution, 1787 in the United States
Fort Sumter	American Civil War
Arrondissement of Briançon	Arrondissements of France
Prerogative	Legal terms, Rights
Arrondissement of Gap	Arrondissements of France
Cosgrove Hall Films	Companies of the United Kingdom, 1976 establishments in the United Kingdom, 2009 disestablishments in the United Kingdom
T2 phage	Viruses
Rhyme royal	Poetry forms
Ottava rima	Poetry forms
Buëch	Rivers of France, Auvergne-Rhône-Alpes, Provence-Alpes-Côte d'Azur
Agnes Nixon	Writers from Chicago, American television producers, Actors from Chicago, 1922 births, 2016 deaths
Cultured meat	Agriculture, Meat
Umutsuz Ev Kadınları	Turkish television series
Richard Aldington	1892 births, 1962 deaths, British military personnel of World War I, British poets, British novelists
Edwin Atherstone	1788 births, 1872 deaths, English poets, English writers, English playwrights
Yuzu	Citrus
Horw	Cities in Switzerland, Municipalities of Lucerne
The Swiss Family Robinson	1810s books
Kriens	Cities in Switzerland, Municipalities of Lucerne
Barre des Écrins	Alps, Mountains of France, Provence-Alpes-Côte d'Azur
Rubble	Building materials
Francisco de Sá de Miranda	1481 births, 1558 deaths, Portuguese writers, Renaissance
Alicia Machado	Venezuelan models, American models, Miss Universe winners, 1976 births, Living people, Naturalized citizens of the United States
Religious order	Religion
Gregorio Honasan	1948 births, Living people, Colonels, Filipino military people
Nur Misuari	1939 births, Living people, Filipino military people, Filipino politicians
Ryder Cup	Golf tournaments, 1927 establishments in the United States, 1927 establishments in Europe
Hazeltine National Golf Club	Golf, Buildings and structures in Minnesota
Indie game	Indie video games
Oscar Stanton De Priest	1871 births, 1951 deaths, Burials at Graceland Cemetery, United States representatives from Illinois, Politicians from Alabama, African American politicians, US Republican Party politicians, People from Florence, Alabama
Pinus pinaster	Conifers
Littau	Former municipalities of Lucerne, Lucerne
Malters	Municipalities of Lucerne
Nevinnomyssk	Cities in Russia
Giuseppe Natoli	1815 births, 1867 deaths, Italian politicians, Italian lawyers
Startup company	Companies by type
Meggen, Switzerland	Municipalities of Lucerne
Meierskappel	Municipalities of Lucerne
Root, Switzerland	Municipalities of Lucerne
Schwarzenberg, Switzerland	Municipalities of Lucerne
Udligenswil	Municipalities of Lucerne
Jose Maria Sison	1939 births, Living people, Filipino writers, Activists, Communists, Atheists
Mengistu Haile Mariam	1937 births, Living people, Presidents of Ethiopia, Communists
B. J. Vorster	1915 births, 1983 deaths, Afrikaner people, People associated with Apartheid, Calvinists, Presidents of South Africa, Prime Ministers of South Africa
Vitznau	Municipalities of Lucerne
Weggis	Municipalities of Lucerne
Sursee (district)	Districts of Lucerne
Beromünster	Municipalities of Lucerne, Cities in Switzerland
Büron	Municipalities of Lucerne
Buttisholz	Municipalities of Lucerne
Eich, Switzerland	Eich LU, Municipalities of Lucerne
Geuensee	Municipalities of Lucerne
Grosswangen	Municipalities of Lucerne
Gunzwil	Former municipalities of Lucerne
Hildisrieden	Municipalities of Lucerne
Knutwil	Municipalities of Lucerne
Mauensee, Lucerne	Municipalities of Lucerne
Cachapoal Province	Provinces of Chile
Hair tie	Headgear
Wrath of the Titans	2012 movies, Movies based on Greek and Roman mythology, Warner Bros. movies
Macy's	Department stores, Cincinnati, Ohio, 1858 establishments in the United States
Scotland, Connecticut	Towns in Connecticut, 1857 establishments in the United States, 1850s establishments in Connecticut
Colchagua Province	Provinces of Chile
Azov	Towns in Russia
Neudorf, Lucerne	Former municipalities of Lucerne
Neuenkirch	Municipalities of Lucerne
Filippo Juvarra	1678 births, 1736 deaths, Italian architects
Nottwil	Municipalities of Lucerne
Hurricane Matthew	2016 in weather, Hurricanes, September 2016 events, 2016 in North America, 2010s in Jamaica, 2010s in Cuba, 21st century in the Dominican Republic, 2010s in the Bahamas
Oberkirch, Switzerland	Municipalities of Lucerne
Pfeffikon, Switzerland	Former municipalities of Lucerne, Villages in Lucerne
Life simulation game	Role-playing games, Video game genres
Zenón Díaz	1880 births, 1948 deaths
Ronssoy	Communes in Somme
Acheux-en-Amiénois	Communes in Somme
Agenville	Communes in Somme
Ailly-le-Haut-Clocher	Communes in Somme
Ailly-sur-Somme	Communes in Somme
Airaines	Communes in Somme
Aizecourt-le-Bas	Communes in Somme
Aizecourt-le-Haut	Communes in Somme
Albert, Somme	Communes in Somme
Allaines	Communes in Somme
Allenay	Communes in Somme
Allonville	Communes in Somme
Andainville	Communes in Somme
Andechy	Communes in Somme
Argœuves	Communes in Somme
Arguel, Somme	Communes in Somme
Battlefield 1	Electronic Arts video games, Shooter video games, PlayStation 4 games, Windows games, Xbox One games, Video games developed in Sweden
Neutrality (international relations)	Politics
English law	Legal terms, Law
Travis County, Texas	Texas counties
Rickenbach, Lucerne	Municipalities of Lucerne
Ruswil	Municipalities of Lucerne
Arrondissements of the Alpes-Maritimes department	Arrondissements of France, Alpes-Maritimes
Arrondissement of Grasse	Arrondissements of France, Alpes-Maritimes
Arrondissement of Nice	Arrondissements of France, Alpes-Maritimes
Schenkon	Municipalities of Lucerne
Schlierbach, Switzerland	Municipalities of Lucerne
Sempach	Municipalities of Lucerne, Cities in Switzerland
Sursee	Cities in Switzerland, Municipalities of Lucerne
Superalloy	Metals
The Age of Extremes	1994 books
Triengen	Municipalities of Lucerne
ShelterBox	Charities
Château de Blois	Palaces in France, Former royal residences, Museums in France
Winikon	Former municipalities of Lucerne
Willisau (district)	Districts of Lucerne
Altishofen	Municipalities of Lucerne
Growth medium	Microbiology, Laboratory equipment
Cime du Gélas	Alps, Mountains of France, Mountains of Italy, Alpes-Maritimes, Piedmont
John Martin (painter)	1789 births, 1854 deaths, People from Northumberland, English painters
Siagne	Rivers of France, Provence-Alpes-Côte d'Azur
Lorenzo Ghiberti	1378 births, 1455 deaths, Italian sculptors, Italian painters, Italian architects, People from Florence
Al Nahyan	Names
György Ligeti	1923 births, 2006 deaths, 20th century composers, 21st century composers, Hungarian composers
Geo (microformat)	Internet, Geography
Njál's saga	Poems
World Geodetic System	Geography, Geodesy
GfK Entertainment charts	Record charts
Prometheus Global Media	Publishing companies of the United States, 2009 establishments in New York (state), Companies based in New York City
Disk read/write head	Computing
Dagmersellen	Municipalities of Lucerne
Buchs, Lucerne	Former municipalities of Lucerne, Villages in Lucerne
Uffikon	Villages in Lucerne, Former municipalities of Lucerne
Ebersecken	Former municipalities of Lucerne
Thomas Kyd	1558 births, 1616 deaths, English playwrights, Literature since 1500
LIGO	Physics
Emma Lazarus	1849 births, 1887 deaths, Deaths from Hodgkin's lymphoma, American poets, American playwrights, American Jews
Algonquin Provincial Park	Parks, Ontario, 1893 establishments in North America, 1890s establishments in Canada
University of Trieste	Colleges and universities in Italy, 1924 establishments in Europe, Trieste, 1920s establishments in Italy
Ladies' Code	K-pop music groups, 2013 establishments in Asia, 2010s establishments in South Korea, South Korean girl groups
Jan Kochanowski	Polish writers
Assassination of Archduke Franz Ferdinand of Austria	1914 in Europe, Assassinations in Europe, Murders by firearm, Sarajevo, World War I, Assassinated people, June events
South Mills, North Carolina	Unincorporated communities in North Carolina, Census-designated places in North Carolina
Quantum tunnelling	Quantum mechanics
Caazapá Department	Departments of Paraguay
Olmec figurine	Pre-Columbian cultures
Sigismund II Augustus	1520 births, 1572 deaths, Kings of Poland
Yoshinori Ohsumi	1945 births, Living people, Cell biology, Japanese academics, Japanese biologists, Japanese Nobel Prize winners
Autophagy	Cell biology
Mikołaj Sęp Szarzyński	1581 deaths, Polish writers, 1550s births
Great Green Wall	Forestry, Africa
California's Gold	1990s American television series
Taurine	Physiology
Wladyslaw I of Poland	1333 deaths, Kings of Poland, Piast dynasty, 1261 births, Polish Roman Catholics
Simone Biles	1997 births, Living people, Olympic gold medalists, Olympic bronze medalists, BBC 100 Women
Corps of Topographical Engineers	United States Army, 1838 establishments in the United States, 1860s disestablishments in the United States, 1863 disestablishments
Lluta River	Rivers of Chile
Henry Howard, Earl of Surrey	1517 births, 1547 deaths, English poets, Executed English people, People executed by decapitation, Writers from Hertfordshire
Harry Hamlin	1951 births, American movie actors
Cancioneiro Geral	Portuguese culture, Poetry, 1516 books
Research and development	Economics, Research, Innovation
Institut d'optique Graduate School	Technical colleges and universities, Colleges and universities in France, 1917 establishments in Europe, 1910s establishments in France
Mary Sidney	English poets, 1561 births, 1621 deaths
Vladimír Holan	Czech poets, 1905 births, 1980 deaths, People from Prague
Iambic pentameter	Poetry forms
John Fitchett	Epic poems, English poets, 1776 births, 1838 deaths
Currituck County, North Carolina	North Carolina counties, 1730s establishments in North Carolina, 1739 establishments
Tyrrell County, North Carolina	1730s establishments in North Carolina, 1739 establishments, North Carolina counties
Gates County, North Carolina	North Carolina counties, 1779 establishments in North Carolina
United States Revenue Cutter Service	Military of the United States, History of the United States, 1790 establishments in the United States, 1915 disestablishments, 1910s disestablishments in the United States
Vittoria Colonna	1490 births, 1547 deaths, Italian poets
Kordshuli	Iran, Ethnic groups in the Middle East
Anil Kumble	Indian cricketers
Canindeyú Department	Departments of Paraguay
Guido Guinizelli	1276 deaths, Italian poets, 1230s births
Church of St. Anthony in Jerzmanice-Zdrój	Roman Catholic churches, Buildings and structures in Poland, 14th century establishments in Europe, Establishments in Poland
Eurovision Song Contest 2017	2017 in Europe, 2010s in Ukraine, Eurovision Song Contest, 21st century in Kiev
Philip Sidney	English poets, British diplomats, 1554 births, 1586 deaths
Technologist	Technology
South Jamaica, Queens	Queens (New York City), Neighborhoods of New York City
Egolzwil	Municipalities of Lucerne
Ettiswil	Municipalities of Lucerne
Fischbach, Switzerland	Municipalities of Lucerne
Gettnau	Municipalities of Lucerne
Gandria	Former municipalities of Ticino
Viganello	Former municipalities of Ticino
Linares Province	Provinces of Chile
Names for ordinal numbers	Numbers
Ministro Pistarini International Airport	Airports in Argentina
Arturo Merino Benítez International Airport	Airports in South America, Buildings and structures in Chile, Santiago de Chile
São Paulo–Guarulhos International Airport	Airports in South America, Buildings and structures in Brazil
Linares, Chile	Cities in Chile
Camilo Pessanha	1867 births, 1926 deaths, Portuguese writers, Poets
Enid Lyons	1897 births, 1981 deaths, Members of the Australian House of Representatives, Politicians from Tasmania, Australian Roman Catholics
Kappa Mikey	Animated television series, Nicktoons, English-language television programs, 2006 television series debuts, 2008 television series endings
List of programs broadcast by Nick Jr. (block)	Lists of television series by network
Sapphic stanza	Poetry forms
International Youth Arts Festival	Royal Borough of Kingston upon Thames, Entertainment in London, Festivals in the United Kingdom, 2009 establishments in England
Olea capensis	Lamiales
USRC Vigilant (1791)	Military of the United States, History of the United States
USRC Massachusetts (1791)	Military of the United States, History of the United States
Lucrezia Marinella	1571 births, 1653 deaths, Italian poets, People from Venice
USRC Active (1791)	Military of the United States, History of the United States
National Serbian Clarinet Association	Musical groups, Serbia, 2015 establishments in Europe
International Clarinet Association	Music, Organizations based in the United States
European Clarinet Association	Woodwind instruments, Clarinetists
Educational technologist	Education
Māori religion	Maori
Vincent du Vigneaud	1901 births, 1978 deaths, American biochemists, American biologists, American Nobel Prize winners
Stove fan	Cooking appliances
Englischer Garten	Parks
Benjamin Zephaniah	British writers, British poets, Rastafari, Living people, 1958 births
Gabriel Pereira de Castro	1571 births, 1632 deaths, Portuguese writers, Poets
Grossdietwil	Municipalities of Lucerne
Hergiswil bei Willisau	Municipalities of Lucerne
Télécom ParisTech	Technical colleges and universities in Paris, 1878 establishments in Europe, 19th century establishments in France
Luthern	Municipalities of Lucerne
Menznau	Municipalities of Lucerne
USRC General Green (1791)	Military of the United States, History of the United States
Armancourt, Somme	Communes in Somme
Arrest, Somme	Communes in Somme
Arvillers	Communes in Somme
Assainvillers	Communes in Somme
Assevillers	Communes in Somme
Athies, Somme	Communes in Somme
Aubercourt	Communes in Somme
Development regions of the Dominican Republic	Dominican Republic
Aubigny, Somme	Communes in Somme
Aubvillers	Communes in Somme
Auchonvillers	Communes in Somme
Aumâtre	Communes in Somme
Aumont, Somme	Communes in Somme
Authie, Somme	Communes in Somme
Avelesges	Communes in Somme
Avesnes-Chaussoy	Communes in Somme
Ayencourt	Communes in Somme
Bacouel-sur-Selle	Communes in Somme
Bailleul, Somme	Communes in Somme
Baizieux	Communes in Somme
Balâtre	Communes in Somme
Barleux	Communes in Somme
Bavelincourt	Communes in Somme
Bayencourt	Communes in Somme
Bazentin	Communes in Somme
Beaucamps-le-Jeune	Communes in Somme
Bangarra Dance Theatre	Ballet companies, Indigenous Australian culture, Musical groups established in 1989
Smokey Mountain	 Smokey Mountain (Tondo, Manila), Manila
Vulnicura	2015 albums, Björk albums
1932 Cuba hurricane	Hurricanes, 20th century in Cuba, 1932 in North America, 20th century in Jamaica, History of the Cayman Islands, 20th century in the Bahamas, History of Bermuda
Nebikon	Municipalities of Lucerne
Ohmstal	Former municipalities of Lucerne
Pfaffnau	Municipalities of Lucerne
Schwarzenbach, Lucerne	Former municipalities of Lucerne, Villages in Lucerne
United States Life-Saving Service	Military of the United States, United States government agencies, 1848 establishments in the United States, 1915 disestablishments, 1910s disestablishments in the United States
Jan Matejko	1838 births, 1983 deaths, Polish painters
Union of Azerbaijani Writers	Literature, Azerbaijani culture, 1934 establishments
USRC Scammel (1791)	Military of the United States, History of the United States
Moon landing	Moon, Astronomy
Lady Mary Wortley Montagu	Lady Mary Wortley Montagu, 1689 births, 1762 deaths, Writers from London, English poets, English playwrights
Xu Zhimo	Chinese poets
Reiden	Municipalities of Lucerne
Canary Wharf	Areas of London
Antonina Domańska	1853 births, 1917 deaths, Polish writers
USRC Argus (1791)	Military of the United States, History of the United States
Garuda Indonesia Flight 152	1997 in Asia, 1990s disasters in Asia, Aviation disasters in Asia, Aviation disasters in the 1990s, Disasters in Indonesia, History of Indonesia, September events
Guairá Department	Departments of Paraguay
Julie Trustrup Jensen	1994 births, Living people, Danish footballers
Acanthuridae	Perciformes
State of Palestine	Palestine
Cauquenes Province	Provinces of Chile
Acanthuroidei	Perciformes
21 Mincing Lane	City of London
Julian Brazier	Living people, 1953 births, English Roman Catholics, UK MPs 1997–2001
St Botolph Building	Buildings and structures in London, 2010 establishments in England
GR 8 (galaxy)	Dwarf galaxies
Wacław Potocki	1621 births, 1696 deaths, Polish poets
New7Wonders of the World	Seven Wonders of the World, 2000 establishments, 2007 disestablishments, Culture, Buildings and structures
Esociformes	Ray-finned fish
Matilda (name)	Given names
Bethany (name)	Given names
Santiago, Cape Verde	Islands of Cape Verde
Jackson, Nebraska	Villages in Nebraska, 1860 establishments in Nebraska Territory
Hayride	Amusement rides
Robert Graves	1895 births, 1985 deaths, English novelists, English poets
Sushil Chhetri	Living people, Nepalese movie actors, People from Kathmandu
Anastasia of Sirmium	Christian saints
Protacanthopterygii	Ray-finned fish
Hapsa Hatarnai	Ceremonies, Assam
Roggliswil	Municipalities of Lucerne
Schötz	Municipalities of Lucerne
Babiker Awadalla	1917 births, 2019 deaths, Prime Ministers of Sudan, Centenarians
Tom Hayden	1939 births, 2016 deaths, American civil rights activists, American human rights activists, American LGBT rights activists, American political activists, Cardiovascular disease deaths in California, Deaths from stroke, Politicians from Los Angeles, California, Politicians from Detroit, Michigan, US Democratic Party politicians, Writers from Los Angeles, California, Writers from Detroit, Michigan, State legislators of the United States
Chung Won-shik	1928 births, 2020 deaths, Deaths from kidney disease, Prime Ministers of South Korea, South Korean writers, Korean educators, People from Seoul
Elmer Ferguson Memorial Award	Hockey Hall of Fame, Ice hockey trophies and awards
Foster Hewitt Memorial Award	Foster Hewitt Memorial Award winners, Ice hockey trophies and awards, National Hockey League broadcasters, Hockey Hall of Fame
Bob McKenzie	1956 births, Canadian journalists, Elmer Ferguson Award winners, Living people, National Hockey League broadcasters, Olympic Games broadcasters, People from Toronto
Elmer Ferguson	1885 births, 1972 deaths, Elmer Ferguson Award winners, National Hockey League broadcasters, People from Prince Edward Island
Bad (Bodo culture)	Indian culture
List of Garja gods	Religion in India
Gil Vicente	1470 births, 1540 deaths, Poets, Playwrights, Portuguese writers
Ardèche (river)	Rivers of France, Ardèche, Occitanie
Stéphane Dion	1955 births, Living people, Ambassadors of Canada, Politicians from Quebec, Members of the House of Commons of Canada from Quebec, Government ministers, People from Quebec City, Privy Councillors (Canada), Leaders of the Opposition (Canada)
Federica Mogherini	1973 births, Living people, Civil servants, European Union politicians, Politicians from Rome
Fumio Kishida	1957 births, Living people, Japanese politicians, People from Hiroshima
Paolo Gentiloni	1954 births, Living people, Prime Ministers of Italy, Politicians from Rome
Lenín Moreno	1953 births, Living people, Activists, Crime victims, People with disabilities, Presidents of Ecuador, Vice Presidents of Ecuador
Rafto Prize	Awards
Hagramayao Jinahari	Indian movies, 1995 crime movies
Battle of Kororāreka	Battles involving New Zealand, Battles involving the United Kingdom, Maori, 19th century in Oceania, 1845, 1840s in the United Kingdom
Alayaron (movie)	1986 movies
List of Bodo religions	Religion in India, India-related lists, Religion-related lists
Circinus galaxy	Galaxies
Children's Day	Childhood, 1856 establishments in the United States, 1954 establishments in Europe, 1950s establishments in the United Kingdom
Seyfert galaxy	Galaxies
Relativistic jet	Relativity, Black holes, Electromagnetic radiation
I Zw 36	Dwarf galaxies
Cadmium nitrate	Cadmium compounds
Palladium(II) nitrate	Chemical compounds
Yuriko Koike	1952 births, Living people, People from Hyōgo Prefecture, Governors of Japanese prefectures, Japanese politicians, Translators
Americium dioxide	Chemical compounds
Phoenix Dwarf	Galaxies
Iggy Arbuckle	2007 television series debuts
CJ the DJ	Australian television series, 2009 television series debuts, 2009 establishments in Australia, 2010 television series endings, 2010s disestablishments in Australia, English-language television programs
Parabolic trough	Energy
I Zwicky 18	Dwarf galaxies
Ufhusen	Municipalities of Lucerne
Wauwil	Municipalities of Lucerne
Wikon	Municipalities of Lucerne
Willisau	2006 establishments in Switzerland, Municipalities of Lucerne, Cities in Switzerland
Zell, Lucerne	Municipalities of Lucerne
Kulmerau	Former municipalities of Lucerne, Villages in Lucerne
Wilihof	Villages in Lucerne, Former municipalities of Lucerne
Willisau Land	Villages in Lucerne, Former municipalities of Lucerne
Willisau Stadt	Villages in Lucerne, Former municipalities of Lucerne
Schinznach	Municipalities of Aargau, 2014 establishments in Switzerland
Border states (American Civil War)	Origins of the American Civil War
The ZhuZhus	American animated television series, American children's television series, American fantasy television series, Canadian animated television series, Canadian children's television series, Disney Channel shows, English-language television programs, 2016 television series debuts, 2019 television series endings

